time,subj_course_id,sec_code,sec_id,prof,available,waitlist,total,enrolled_ct
1649763211340,COGS 2,A01,083966,Boyle; Mary E. T.,28,0,30,2
1649763217378,COGS 9,A01,083968,Staff,59,0,60,1
1649763223417,COGS 14B,A01,083970,Staff,50,0,50,0
1649763229516,COGS 100,A01,083972,Staff,58,0,60,2
1649763241578,COGS 101C,A01,083976,Staff,30,0,30,0
1649763247622,COGS 102A,A01,083978,Johnson; Christine M.,30,0,30,0
1649763253662,COGS 107B,A01,083980,Staff,46,0,50,4
1649763259712,COGS 115,A01,083982,Staff,27,0,30,3
1649763265744,COGS 118B,A01,083367,Staff,26,0,40,14
1649763271782,COGS 172,A01,083984,Provenzano; Emily Kara,25,0,30,5
1649763277814,COGS 177,A00,083368,Staff,22,0,30,8
1649763283846,COGS 186,A01,083986,Staff,31,0,40,9
1649763289881,COGS 187A,A01,083988,Boyle; Mary E. T.,56,0,60,4
1649763295912,CSE 8A,A50,084003,Miranda; Gregory Joseph,13,0,15,2
1649763301952,CSE 11,A01,084005,Miranda; Gregory Joseph,52,0,55,3
1649763307989,CSE 20,A01,084007,Staff,17,0,20,3
1649763314019,CSE 21,A01,084009,Staff,50,0,50,0
1649763320051,CSE 30,A01,083370,Cao; Yingjun,38,0,40,2
1649763326083,CSE 100,A01,083372,Cao; Yingjun,37,0,40,3
1649763332114,CSE 101,A01,084011,Staff,25,0,40,15
1649763338142,CSE 141,A01,083374,Eldon; John,46,0,75,29
1649763344176,CSE 141L,A01,083376,Eldon; John,48,0,75,27
1649763350203,CSE 175,A01,084013,Kumar; Rakesh,25,0,25,0
1649763356235,ECE 5,A01,084049,Morris; Karcher William,19,0,20,1
1649763362274,ECE 100,A01,084051,Baghdadchi; Saharnaz,18,0,20,2
1649763362274,ECE 100,A02,091916,Baghdadchi; Saharnaz,20,0,20,0
1649763368309,ECE 101,A01,084053,Baghdadchi; Saharnaz,33,0,37,4
1649763368309,ECE 101,A02,084054,Baghdadchi; Saharnaz,37,0,37,0
1649763374347,ECE 107,A01,083390,Staff,36,0,40,4
1649763380382,ECE 148,A01,084056,Silberman; Jack,10,0,12,2
1649763386414,ECE 180,A00,083391,Abi Samra; Nicholas Camill,28,0,30,2
1649763386414,ECE 180,B00,083392,Abi Samra; Nicholas Camill,28,0,30,2
1649763392449,MATH 10B,A01,084110,Staff,26,0,30,4
1649763392449,MATH 10B,A02,084111,Staff,30,0,30,0
1649763392449,MATH 10B,A03,084112,Staff,30,0,30,0
1649763398476,MATH 10C,A01,083443,Staff,28,0,30,2
1649763398476,MATH 10C,A02,083444,Staff,27,0,30,3
1649763398476,MATH 10C,B01,084114,Staff,29,0,30,1
1649763398476,MATH 10C,B02,084115,Staff,30,0,30,0
1649763404528,MATH 18,A01,084117,Harel; Guershon,28,0,30,2
1649763404528,MATH 18,A02,084119,Harel; Guershon,29,0,30,1
1649763404528,MATH 18,A03,084120,Harel; Guershon,30,0,30,0
1649763404528,MATH 18,A04,084121,Harel; Guershon,30,0,30,0
1649763410562,MATH 20B,A01,084124,Um; Ko Woon,34,0,35,1
1649763410562,MATH 20B,B01,084126,Um; Ko Woon,35,0,35,0
1649763416591,MATH 20C,A01,083446,Hammock; Frances H,29,0,30,1
1649763416591,MATH 20C,A02,083447,Hammock; Frances H,30,0,30,0
1649763416591,MATH 20C,A03,083448,Hammock; Frances H,30,0,30,0
1649763416591,MATH 20C,A04,083449,Hammock; Frances H,30,0,30,0
1649763416591,MATH 20C,B01,083451,Hammock; Frances H,30,0,30,0
1649763416591,MATH 20C,B02,083452,Hammock; Frances H,30,0,30,0
1649763416591,MATH 20C,B03,083453,Hammock; Frances H,30,0,30,0
1649763416591,MATH 20C,B04,083454,Hammock; Frances H,30,0,30,0
1649763426984,MATH 20D,A01,084128,Staff,30,0,30,0
1649763426984,MATH 20D,A02,084129,Staff,30,0,30,0
1649763426984,MATH 20D,A03,084130,Staff,29,0,30,1
1649763426984,MATH 20D,B01,084133,Staff,30,0,30,0
1649763426984,MATH 20D,B02,084134,Staff,30,0,30,0
1649763426984,MATH 20D,B03,084135,Staff,30,0,30,0
1649763433050,MATH 20E,A01,084138,Staff,30,0,30,0
1649763433050,MATH 20E,A02,084139,Staff,29,0,30,1
1649763433050,MATH 20E,A03,084140,Staff,30,0,30,0
1649763433050,MATH 20E,A04,084141,Staff,30,0,30,0
1649763441008,MATH 102,A01,084143,Harel; Guershon,27,0,30,3
1649763441008,MATH 102,A02,084144,Harel; Guershon,29,0,30,1
1649763447037,MATH 103B,A01,083456,Staff,22,0,30,8
1649763447037,MATH 103B,A02,083457,Staff,28,0,30,2
1649763453075,MATH 109,A01,084146,Salehi Golsefidy; Alireza,30,0,30,0
1649763453075,MATH 109,A02,084147,Salehi Golsefidy; Alireza,29,0,30,1
1649763459108,MATH 120A,A01,085445,Eggers; John Dietrich,32,0,35,3
1649763459108,MATH 120A,A02,085446,Eggers; John Dietrich,34,0,35,1
1649763465144,MATH 142B,A01,084149,Verstraete; Jacques Allan,26,0,30,4
1649763465144,MATH 142B,A02,084150,Verstraete; Jacques Allan,28,0,30,2
1649763471182,MATH 170A,A01,083459,Nie; Jiawang,22,0,30,8
1649763471182,MATH 170A,A02,083460,Nie; Jiawang,28,0,30,2
1649763471182,MATH 170A,A03,083461,Nie; Jiawang,30,0,30,0
1649763477216,MATH 193B,A01,083463,Staff,25,0,30,5
1649763477216,MATH 193B,A02,083464,Staff,29,0,30,1
1649763477216,MATH 193B,A03,083465,Staff,30,0,30,0
1649763483307,COGS 2,A01,083966,Boyle; Mary E. T.,28,0,30,2
1649763489338,COGS 9,A01,083968,Staff,59,0,60,1
1649763495369,COGS 14B,A01,083970,Staff,50,0,50,0
1649763501400,COGS 100,A01,083972,Staff,58,0,60,2
1649763513458,COGS 101C,A01,083976,Staff,30,0,30,0
1649763519494,COGS 102A,A01,083978,Johnson; Christine M.,30,0,30,0
1649763525529,COGS 107B,A01,083980,Staff,46,0,50,4
1649763531559,COGS 115,A01,083982,Staff,27,0,30,3
1649763537601,COGS 118B,A01,083367,Staff,26,0,40,14
1649763543632,COGS 172,A01,083984,Provenzano; Emily Kara,25,0,30,5
1649763549666,COGS 177,A00,083368,Staff,22,0,30,8
1649763555702,COGS 186,A01,083986,Staff,31,0,40,9
1649763561737,COGS 187A,A01,083988,Boyle; Mary E. T.,56,0,60,4
1649763567767,CSE 8A,A50,084003,Miranda; Gregory Joseph,13,0,15,2
1649763573799,CSE 11,A01,084005,Miranda; Gregory Joseph,52,0,55,3
1649763579839,CSE 20,A01,084007,Staff,17,0,20,3
1649763585870,CSE 21,A01,084009,Staff,50,0,50,0
1649763591909,CSE 30,A01,083370,Cao; Yingjun,38,0,40,2
1649763597946,CSE 100,A01,083372,Cao; Yingjun,37,0,40,3
1649763603983,CSE 101,A01,084011,Staff,25,0,40,15
1649763610019,CSE 141,A01,083374,Eldon; John,46,0,75,29
1649763616050,CSE 141L,A01,083376,Eldon; John,48,0,75,27
1649763622080,CSE 175,A01,084013,Kumar; Rakesh,25,0,25,0
1649763628112,ECE 5,A01,084049,Morris; Karcher William,19,0,20,1
1649763634144,ECE 100,A01,084051,Baghdadchi; Saharnaz,18,0,20,2
1649763634144,ECE 100,A02,091916,Baghdadchi; Saharnaz,20,0,20,0
1649763640179,ECE 101,A01,084053,Baghdadchi; Saharnaz,33,0,37,4
1649763640179,ECE 101,A02,084054,Baghdadchi; Saharnaz,37,0,37,0
1649763646215,ECE 107,A01,083390,Staff,36,0,40,4
1649763652247,ECE 148,A01,084056,Silberman; Jack,10,0,12,2
1649763658277,ECE 180,A00,083391,Abi Samra; Nicholas Camill,28,0,30,2
1649763658277,ECE 180,B00,083392,Abi Samra; Nicholas Camill,28,0,30,2
1649763664308,MATH 10B,A01,084110,Staff,26,0,30,4
1649763664308,MATH 10B,A02,084111,Staff,30,0,30,0
1649763664308,MATH 10B,A03,084112,Staff,30,0,30,0
1649763670339,MATH 10C,A01,083443,Staff,28,0,30,2
1649763670339,MATH 10C,A02,083444,Staff,27,0,30,3
1649763670339,MATH 10C,B01,084114,Staff,29,0,30,1
1649763670339,MATH 10C,B02,084115,Staff,30,0,30,0
1649763676373,MATH 18,A01,084117,Harel; Guershon,28,0,30,2
1649763676373,MATH 18,A02,084119,Harel; Guershon,29,0,30,1
1649763676373,MATH 18,A03,084120,Harel; Guershon,30,0,30,0
1649763676373,MATH 18,A04,084121,Harel; Guershon,30,0,30,0
1649763682403,MATH 20B,A01,084124,Um; Ko Woon,34,0,35,1
1649763682403,MATH 20B,B01,084126,Um; Ko Woon,35,0,35,0
1649763688445,MATH 20C,A01,083446,Hammock; Frances H,29,0,30,1
1649763688445,MATH 20C,A02,083447,Hammock; Frances H,30,0,30,0
1649763688445,MATH 20C,A03,083448,Hammock; Frances H,30,0,30,0
1649763688445,MATH 20C,A04,083449,Hammock; Frances H,30,0,30,0
1649763688445,MATH 20C,B01,083451,Hammock; Frances H,30,0,30,0
1649763688445,MATH 20C,B02,083452,Hammock; Frances H,30,0,30,0
1649763688445,MATH 20C,B03,083453,Hammock; Frances H,30,0,30,0
1649763688445,MATH 20C,B04,083454,Hammock; Frances H,30,0,30,0
1649763694477,MATH 20D,A01,084128,Staff,30,0,30,0
1649763694477,MATH 20D,A02,084129,Staff,30,0,30,0
1649763694477,MATH 20D,A03,084130,Staff,29,0,30,1
1649763694477,MATH 20D,B01,084133,Staff,30,0,30,0
1649763694477,MATH 20D,B02,084134,Staff,30,0,30,0
1649763694477,MATH 20D,B03,084135,Staff,30,0,30,0
1649763700503,MATH 20E,A01,084138,Staff,30,0,30,0
1649763700503,MATH 20E,A02,084139,Staff,29,0,30,1
1649763700503,MATH 20E,A03,084140,Staff,30,0,30,0
1649763700503,MATH 20E,A04,084141,Staff,30,0,30,0
1649763706533,MATH 102,A01,084143,Harel; Guershon,27,0,30,3
1649763706533,MATH 102,A02,084144,Harel; Guershon,29,0,30,1
1649763712563,MATH 103B,A01,083456,Staff,22,0,30,8
1649763712563,MATH 103B,A02,083457,Staff,28,0,30,2
1649763718593,MATH 109,A01,084146,Salehi Golsefidy; Alireza,30,0,30,0
1649763718593,MATH 109,A02,084147,Salehi Golsefidy; Alireza,29,0,30,1
1649763724629,MATH 120A,A01,085445,Eggers; John Dietrich,32,0,35,3
1649763724629,MATH 120A,A02,085446,Eggers; John Dietrich,34,0,35,1
1649763730657,MATH 142B,A01,084149,Verstraete; Jacques Allan,26,0,30,4
1649763730657,MATH 142B,A02,084150,Verstraete; Jacques Allan,28,0,30,2
1649763736692,MATH 170A,A01,083459,Nie; Jiawang,22,0,30,8
1649763736692,MATH 170A,A02,083460,Nie; Jiawang,28,0,30,2
1649763736692,MATH 170A,A03,083461,Nie; Jiawang,30,0,30,0
1649763742727,MATH 193B,A01,083463,Staff,25,0,30,5
1649763742727,MATH 193B,A02,083464,Staff,29,0,30,1
1649763742727,MATH 193B,A03,083465,Staff,30,0,30,0
1649763748799,COGS 2,A01,083966,Boyle; Mary E. T.,28,0,30,2
1649763754828,COGS 9,A01,083968,Staff,59,0,60,1
1649763760865,COGS 14B,A01,083970,Staff,50,0,50,0
1649763766894,COGS 100,A01,083972,Staff,58,0,60,2
1649763778980,COGS 101C,A01,083976,Staff,30,0,30,0
1649763785010,COGS 102A,A01,083978,Johnson; Christine M.,30,0,30,0
1649763791130,COGS 107B,A01,083980,Staff,46,0,50,4
1649763797164,COGS 115,A01,083982,Staff,27,0,30,3
1649763803192,COGS 118B,A01,083367,Staff,26,0,40,14
1649763809219,COGS 172,A01,083984,Provenzano; Emily Kara,25,0,30,5
1649763815248,COGS 177,A00,083368,Staff,22,0,30,8
1649763821279,COGS 186,A01,083986,Staff,31,0,40,9
1649763827310,COGS 187A,A01,083988,Boyle; Mary E. T.,56,0,60,4
1649763833340,CSE 8A,A50,084003,Miranda; Gregory Joseph,13,0,15,2
1649763839367,CSE 11,A01,084005,Miranda; Gregory Joseph,52,0,55,3
1649763845396,CSE 20,A01,084007,Staff,17,0,20,3
1649763851425,CSE 21,A01,084009,Staff,50,0,50,0
1649763857466,CSE 30,A01,083370,Cao; Yingjun,38,0,40,2
1649763863495,CSE 100,A01,083372,Cao; Yingjun,37,0,40,3
1649763869525,CSE 101,A01,084011,Staff,25,0,40,15
1649763875554,CSE 141,A01,083374,Eldon; John,46,0,75,29
1649763881598,CSE 141L,A01,083376,Eldon; John,48,0,75,27
1649763887629,CSE 175,A01,084013,Kumar; Rakesh,25,0,25,0
1649763893659,ECE 5,A01,084049,Morris; Karcher William,19,0,20,1
1649763899690,ECE 100,A01,084051,Baghdadchi; Saharnaz,18,0,20,2
1649763899690,ECE 100,A02,091916,Baghdadchi; Saharnaz,20,0,20,0
1649763905719,ECE 101,A01,084053,Baghdadchi; Saharnaz,33,0,37,4
1649763905719,ECE 101,A02,084054,Baghdadchi; Saharnaz,37,0,37,0
1649763911749,ECE 107,A01,083390,Staff,36,0,40,4
1649763917781,ECE 148,A01,084056,Silberman; Jack,10,0,12,2
1649763923813,ECE 180,A00,083391,Abi Samra; Nicholas Camill,28,0,30,2
1649763923813,ECE 180,B00,083392,Abi Samra; Nicholas Camill,28,0,30,2
1649763929844,MATH 10B,A01,084110,Staff,26,0,30,4
1649763929844,MATH 10B,A02,084111,Staff,30,0,30,0
1649763929844,MATH 10B,A03,084112,Staff,30,0,30,0
1649763935874,MATH 10C,A01,083443,Staff,28,0,30,2
1649763935874,MATH 10C,A02,083444,Staff,27,0,30,3
1649763935874,MATH 10C,B01,084114,Staff,29,0,30,1
1649763935874,MATH 10C,B02,084115,Staff,30,0,30,0
1649763941905,MATH 18,A01,084117,Harel; Guershon,28,0,30,2
1649763941905,MATH 18,A02,084119,Harel; Guershon,29,0,30,1
1649763941905,MATH 18,A03,084120,Harel; Guershon,30,0,30,0
1649763941905,MATH 18,A04,084121,Harel; Guershon,30,0,30,0
1649763947942,MATH 20B,A01,084124,Um; Ko Woon,34,0,35,1
1649763947942,MATH 20B,B01,084126,Um; Ko Woon,35,0,35,0
1649763953971,MATH 20C,A01,083446,Hammock; Frances H,29,0,30,1
1649763953971,MATH 20C,A02,083447,Hammock; Frances H,30,0,30,0
1649763953971,MATH 20C,A03,083448,Hammock; Frances H,30,0,30,0
1649763953971,MATH 20C,A04,083449,Hammock; Frances H,30,0,30,0
1649763953971,MATH 20C,B01,083451,Hammock; Frances H,30,0,30,0
1649763953971,MATH 20C,B02,083452,Hammock; Frances H,30,0,30,0
1649763953971,MATH 20C,B03,083453,Hammock; Frances H,30,0,30,0
1649763953971,MATH 20C,B04,083454,Hammock; Frances H,30,0,30,0
1649763960003,MATH 20D,A01,084128,Staff,30,0,30,0
1649763960003,MATH 20D,A02,084129,Staff,30,0,30,0
1649763960003,MATH 20D,A03,084130,Staff,29,0,30,1
1649763960003,MATH 20D,B01,084133,Staff,30,0,30,0
1649763960003,MATH 20D,B02,084134,Staff,30,0,30,0
1649763960003,MATH 20D,B03,084135,Staff,30,0,30,0
1649763966034,MATH 20E,A01,084138,Staff,30,0,30,0
1649763966034,MATH 20E,A02,084139,Staff,29,0,30,1
1649763966034,MATH 20E,A03,084140,Staff,30,0,30,0
1649763966034,MATH 20E,A04,084141,Staff,30,0,30,0
1649763972063,MATH 102,A01,084143,Harel; Guershon,27,0,30,3
1649763972063,MATH 102,A02,084144,Harel; Guershon,29,0,30,1
1649763978090,MATH 103B,A01,083456,Staff,22,0,30,8
1649763978090,MATH 103B,A02,083457,Staff,28,0,30,2
1649763984123,MATH 109,A01,084146,Salehi Golsefidy; Alireza,30,0,30,0
1649763984123,MATH 109,A02,084147,Salehi Golsefidy; Alireza,29,0,30,1
1649763990155,MATH 120A,A01,085445,Eggers; John Dietrich,32,0,35,3
1649763990155,MATH 120A,A02,085446,Eggers; John Dietrich,34,0,35,1
1649763996188,MATH 142B,A01,084149,Verstraete; Jacques Allan,26,0,30,4
1649763996188,MATH 142B,A02,084150,Verstraete; Jacques Allan,28,0,30,2
1649764002219,MATH 170A,A01,083459,Nie; Jiawang,22,0,30,8
1649764002219,MATH 170A,A02,083460,Nie; Jiawang,28,0,30,2
1649764002219,MATH 170A,A03,083461,Nie; Jiawang,30,0,30,0
1649764008249,MATH 193B,A01,083463,Staff,25,0,30,5
1649764008249,MATH 193B,A02,083464,Staff,29,0,30,1
1649764008249,MATH 193B,A03,083465,Staff,30,0,30,0
1649764014333,COGS 2,A01,083966,Boyle; Mary E. T.,28,0,30,2
1649764020363,COGS 9,A01,083968,Staff,59,0,60,1
1649764026396,COGS 14B,A01,083970,Staff,50,0,50,0
1649764032425,COGS 100,A01,083972,Staff,58,0,60,2
1649764044488,COGS 101C,A01,083976,Staff,30,0,30,0
1649764050522,COGS 102A,A01,083978,Johnson; Christine M.,30,0,30,0
1649764056555,COGS 107B,A01,083980,Staff,46,0,50,4
1649764062586,COGS 115,A01,083982,Staff,27,0,30,3
1649764068619,COGS 118B,A01,083367,Staff,26,0,40,14
1649764074649,COGS 172,A01,083984,Provenzano; Emily Kara,25,0,30,5
1649764080678,COGS 177,A00,083368,Staff,22,0,30,8
1649764086704,COGS 186,A01,083986,Staff,31,0,40,9
1649764092766,COGS 187A,A01,083988,Boyle; Mary E. T.,56,0,60,4
1649764098808,CSE 8A,A50,084003,Miranda; Gregory Joseph,13,0,15,2
1649764104840,CSE 11,A01,084005,Miranda; Gregory Joseph,52,0,55,3
1649764110871,CSE 20,A01,084007,Staff,17,0,20,3
1649764116901,CSE 21,A01,084009,Staff,50,0,50,0
1649764122934,CSE 30,A01,083370,Cao; Yingjun,38,0,40,2
1649764128965,CSE 100,A01,083372,Cao; Yingjun,37,0,40,3
1649764135002,CSE 101,A01,084011,Staff,25,0,40,15
1649764141033,CSE 141,A01,083374,Eldon; John,46,0,75,29
1649764147064,CSE 141L,A01,083376,Eldon; John,48,0,75,27
1649764153095,CSE 175,A01,084013,Kumar; Rakesh,25,0,25,0
1649764159125,ECE 5,A01,084049,Morris; Karcher William,19,0,20,1
1649764165156,ECE 100,A01,084051,Baghdadchi; Saharnaz,18,0,20,2
1649764165156,ECE 100,A02,091916,Baghdadchi; Saharnaz,20,0,20,0
1649764171184,ECE 101,A01,084053,Baghdadchi; Saharnaz,33,0,37,4
1649764171184,ECE 101,A02,084054,Baghdadchi; Saharnaz,37,0,37,0
1649764177214,ECE 107,A01,083390,Staff,36,0,40,4
1649764183246,ECE 148,A01,084056,Silberman; Jack,10,0,12,2
1649764189272,ECE 180,A00,083391,Abi Samra; Nicholas Camill,28,0,30,2
1649764189272,ECE 180,B00,083392,Abi Samra; Nicholas Camill,28,0,30,2
1649764195305,MATH 10B,A01,084110,Staff,26,0,30,4
1649764195305,MATH 10B,A02,084111,Staff,30,0,30,0
1649764195305,MATH 10B,A03,084112,Staff,30,0,30,0
1649764201336,MATH 10C,A01,083443,Staff,28,0,30,2
1649764201336,MATH 10C,A02,083444,Staff,27,0,30,3
1649764201336,MATH 10C,B01,084114,Staff,29,0,30,1
1649764201336,MATH 10C,B02,084115,Staff,30,0,30,0
1649764207367,MATH 18,A01,084117,Harel; Guershon,28,0,30,2
1649764207367,MATH 18,A02,084119,Harel; Guershon,29,0,30,1
1649764207367,MATH 18,A03,084120,Harel; Guershon,30,0,30,0
1649764207367,MATH 18,A04,084121,Harel; Guershon,30,0,30,0
1649764213401,MATH 20B,A01,084124,Um; Ko Woon,34,0,35,1
1649764213401,MATH 20B,B01,084126,Um; Ko Woon,35,0,35,0
1649764219437,MATH 20C,A01,083446,Hammock; Frances H,29,0,30,1
1649764219437,MATH 20C,A02,083447,Hammock; Frances H,30,0,30,0
1649764219437,MATH 20C,A03,083448,Hammock; Frances H,30,0,30,0
1649764219437,MATH 20C,A04,083449,Hammock; Frances H,30,0,30,0
1649764219437,MATH 20C,B01,083451,Hammock; Frances H,30,0,30,0
1649764219437,MATH 20C,B02,083452,Hammock; Frances H,30,0,30,0
1649764219437,MATH 20C,B03,083453,Hammock; Frances H,30,0,30,0
1649764219437,MATH 20C,B04,083454,Hammock; Frances H,30,0,30,0
1649764225469,MATH 20D,A01,084128,Staff,30,0,30,0
1649764225469,MATH 20D,A02,084129,Staff,30,0,30,0
1649764225469,MATH 20D,A03,084130,Staff,29,0,30,1
1649764225469,MATH 20D,B01,084133,Staff,30,0,30,0
1649764225469,MATH 20D,B02,084134,Staff,30,0,30,0
1649764225469,MATH 20D,B03,084135,Staff,30,0,30,0
1649764231501,MATH 20E,A01,084138,Staff,30,0,30,0
1649764231501,MATH 20E,A02,084139,Staff,29,0,30,1
1649764231501,MATH 20E,A03,084140,Staff,30,0,30,0
1649764231501,MATH 20E,A04,084141,Staff,30,0,30,0
1649764237528,MATH 102,A01,084143,Harel; Guershon,27,0,30,3
1649764237528,MATH 102,A02,084144,Harel; Guershon,29,0,30,1
1649764243558,MATH 103B,A01,083456,Staff,22,0,30,8
1649764243558,MATH 103B,A02,083457,Staff,28,0,30,2
1649764249591,MATH 109,A01,084146,Salehi Golsefidy; Alireza,30,0,30,0
1649764249591,MATH 109,A02,084147,Salehi Golsefidy; Alireza,29,0,30,1
1649764255621,MATH 120A,A01,085445,Eggers; John Dietrich,32,0,35,3
1649764255621,MATH 120A,A02,085446,Eggers; John Dietrich,34,0,35,1
1649764261648,MATH 142B,A01,084149,Verstraete; Jacques Allan,26,0,30,4
1649764261648,MATH 142B,A02,084150,Verstraete; Jacques Allan,28,0,30,2
1649764267685,MATH 170A,A01,083459,Nie; Jiawang,22,0,30,8
1649764267685,MATH 170A,A02,083460,Nie; Jiawang,28,0,30,2
1649764267685,MATH 170A,A03,083461,Nie; Jiawang,30,0,30,0
1649764273713,MATH 193B,A01,083463,Staff,25,0,30,5
1649764273713,MATH 193B,A02,083464,Staff,29,0,30,1
1649764273713,MATH 193B,A03,083465,Staff,30,0,30,0
1649764279783,COGS 2,A01,083966,Boyle; Mary E. T.,28,0,30,2
1649764285813,COGS 9,A01,083968,Staff,59,0,60,1
1649764291844,COGS 14B,A01,083970,Staff,50,0,50,0
1649764297873,COGS 100,A01,083972,Staff,58,0,60,2
1649764309936,COGS 101C,A01,083976,Staff,30,0,30,0
1649764315967,COGS 102A,A01,083978,Johnson; Christine M.,30,0,30,0
1649764321998,COGS 107B,A01,083980,Staff,46,0,50,4
1649764328024,COGS 115,A01,083982,Staff,27,0,30,3
1649764334052,COGS 118B,A01,083367,Staff,26,0,40,14
1649764340080,COGS 172,A01,083984,Provenzano; Emily Kara,25,0,30,5
1649764346108,COGS 177,A00,083368,Staff,22,0,30,8
1649764352135,COGS 186,A01,083986,Staff,31,0,40,9
1649764358163,COGS 187A,A01,083988,Boyle; Mary E. T.,56,0,60,4
1649764364188,CSE 8A,A50,084003,Miranda; Gregory Joseph,13,0,15,2
1649764370242,CSE 11,A01,084005,Miranda; Gregory Joseph,52,0,55,3
1649764376270,CSE 20,A01,084007,Staff,17,0,20,3
1649764382300,CSE 21,A01,084009,Staff,50,0,50,0
1649764388418,CSE 30,A01,083370,Cao; Yingjun,38,0,40,2
1649764394447,CSE 100,A01,083372,Cao; Yingjun,37,0,40,3
1649764400474,CSE 101,A01,084011,Staff,25,0,40,15
1649764406503,CSE 141,A01,083374,Eldon; John,46,0,75,29
1649764412534,CSE 141L,A01,083376,Eldon; John,48,0,75,27
1649764418561,CSE 175,A01,084013,Kumar; Rakesh,25,0,25,0
1649764424589,ECE 5,A01,084049,Morris; Karcher William,19,0,20,1
1649764430620,ECE 100,A01,084051,Baghdadchi; Saharnaz,18,0,20,2
1649764430620,ECE 100,A02,091916,Baghdadchi; Saharnaz,20,0,20,0
1649764436656,ECE 101,A01,084053,Baghdadchi; Saharnaz,33,0,37,4
1649764436656,ECE 101,A02,084054,Baghdadchi; Saharnaz,37,0,37,0
1649764442700,ECE 107,A01,083390,Staff,36,0,40,4
1649764448731,ECE 148,A01,084056,Silberman; Jack,10,0,12,2
1649764454759,ECE 180,A00,083391,Abi Samra; Nicholas Camill,28,0,30,2
1649764454759,ECE 180,B00,083392,Abi Samra; Nicholas Camill,28,0,30,2
1649764460798,MATH 10B,A01,084110,Staff,26,0,30,4
1649764460798,MATH 10B,A02,084111,Staff,30,0,30,0
1649764460798,MATH 10B,A03,084112,Staff,30,0,30,0
1649764466827,MATH 10C,A01,083443,Staff,28,0,30,2
1649764466827,MATH 10C,A02,083444,Staff,27,0,30,3
1649764466827,MATH 10C,B01,084114,Staff,29,0,30,1
1649764466827,MATH 10C,B02,084115,Staff,30,0,30,0
1649764472873,MATH 18,A01,084117,Harel; Guershon,28,0,30,2
1649764472873,MATH 18,A02,084119,Harel; Guershon,29,0,30,1
1649764472873,MATH 18,A03,084120,Harel; Guershon,30,0,30,0
1649764472873,MATH 18,A04,084121,Harel; Guershon,30,0,30,0
1649764478902,MATH 20B,A01,084124,Um; Ko Woon,34,0,35,1
1649764478902,MATH 20B,B01,084126,Um; Ko Woon,35,0,35,0
1649764484933,MATH 20C,A01,083446,Hammock; Frances H,29,0,30,1
1649764484933,MATH 20C,A02,083447,Hammock; Frances H,30,0,30,0
1649764484933,MATH 20C,A03,083448,Hammock; Frances H,30,0,30,0
1649764484933,MATH 20C,A04,083449,Hammock; Frances H,30,0,30,0
1649764484933,MATH 20C,B01,083451,Hammock; Frances H,30,0,30,0
1649764484933,MATH 20C,B02,083452,Hammock; Frances H,30,0,30,0
1649764484933,MATH 20C,B03,083453,Hammock; Frances H,30,0,30,0
1649764484933,MATH 20C,B04,083454,Hammock; Frances H,30,0,30,0
1649764490967,MATH 20D,A01,084128,Staff,30,0,30,0
1649764490967,MATH 20D,A02,084129,Staff,30,0,30,0
1649764490967,MATH 20D,A03,084130,Staff,29,0,30,1
1649764490967,MATH 20D,B01,084133,Staff,30,0,30,0
1649764490967,MATH 20D,B02,084134,Staff,30,0,30,0
1649764490967,MATH 20D,B03,084135,Staff,30,0,30,0
1649764496995,MATH 20E,A01,084138,Staff,30,0,30,0
1649764496995,MATH 20E,A02,084139,Staff,29,0,30,1
1649764496995,MATH 20E,A03,084140,Staff,30,0,30,0
1649764496995,MATH 20E,A04,084141,Staff,30,0,30,0
1649764503024,MATH 102,A01,084143,Harel; Guershon,27,0,30,3
1649764503024,MATH 102,A02,084144,Harel; Guershon,29,0,30,1
1649764509053,MATH 103B,A01,083456,Staff,22,0,30,8
1649764509053,MATH 103B,A02,083457,Staff,28,0,30,2
1649764515084,MATH 109,A01,084146,Salehi Golsefidy; Alireza,30,0,30,0
1649764515084,MATH 109,A02,084147,Salehi Golsefidy; Alireza,29,0,30,1
1649764521114,MATH 120A,A01,085445,Eggers; John Dietrich,32,0,35,3
1649764521114,MATH 120A,A02,085446,Eggers; John Dietrich,34,0,35,1
1649764527145,MATH 142B,A01,084149,Verstraete; Jacques Allan,26,0,30,4
1649764527145,MATH 142B,A02,084150,Verstraete; Jacques Allan,28,0,30,2
1649764533171,MATH 170A,A01,083459,Nie; Jiawang,22,0,30,8
1649764533171,MATH 170A,A02,083460,Nie; Jiawang,28,0,30,2
1649764533171,MATH 170A,A03,083461,Nie; Jiawang,30,0,30,0
1649764539200,MATH 193B,A01,083463,Staff,25,0,30,5
1649764539200,MATH 193B,A02,083464,Staff,29,0,30,1
1649764539200,MATH 193B,A03,083465,Staff,30,0,30,0
1649764545259,COGS 2,A01,083966,Boyle; Mary E. T.,28,0,30,2
1649764551287,COGS 9,A01,083968,Staff,59,0,60,1
1649764557313,COGS 14B,A01,083970,Staff,50,0,50,0
1649764563343,COGS 100,A01,083972,Staff,58,0,60,2
1649764575396,COGS 101C,A01,083976,Staff,30,0,30,0
1649764581424,COGS 102A,A01,083978,Johnson; Christine M.,30,0,30,0
1649764587449,COGS 107B,A01,083980,Staff,46,0,50,4
1649764593479,COGS 115,A01,083982,Staff,27,0,30,3
1649764599508,COGS 118B,A01,083367,Staff,26,0,40,14
1649764605537,COGS 172,A01,083984,Provenzano; Emily Kara,25,0,30,5
1649764611568,COGS 177,A00,083368,Staff,22,0,30,8
1649764617596,COGS 186,A01,083986,Staff,31,0,40,9
1649764623622,COGS 187A,A01,083988,Boyle; Mary E. T.,56,0,60,4
1649764629652,CSE 8A,A50,084003,Miranda; Gregory Joseph,13,0,15,2
1649764635684,CSE 11,A01,084005,Miranda; Gregory Joseph,52,0,55,3
1649764641712,CSE 20,A01,084007,Staff,17,0,20,3
1649764647741,CSE 21,A01,084009,Staff,50,0,50,0
1649764653774,CSE 30,A01,083370,Cao; Yingjun,38,0,40,2
1649764659803,CSE 100,A01,083372,Cao; Yingjun,37,0,40,3
1649764665832,CSE 101,A01,084011,Staff,25,0,40,15
1649764671863,CSE 141,A01,083374,Eldon; John,46,0,75,29
1649764677895,CSE 141L,A01,083376,Eldon; John,48,0,75,27
1649764683925,CSE 175,A01,084013,Kumar; Rakesh,25,0,25,0
1649764689957,ECE 5,A01,084049,Morris; Karcher William,19,0,20,1
1649764695981,ECE 100,A01,084051,Baghdadchi; Saharnaz,18,0,20,2
1649764695981,ECE 100,A02,091916,Baghdadchi; Saharnaz,20,0,20,0
1649764702012,ECE 101,A01,084053,Baghdadchi; Saharnaz,33,0,37,4
1649764702012,ECE 101,A02,084054,Baghdadchi; Saharnaz,37,0,37,0
1649764708044,ECE 107,A01,083390,Staff,36,0,40,4
1649764714082,ECE 148,A01,084056,Silberman; Jack,10,0,12,2
1649764720110,ECE 180,A00,083391,Abi Samra; Nicholas Camill,28,0,30,2
1649764720110,ECE 180,B00,083392,Abi Samra; Nicholas Camill,28,0,30,2
1649764726136,MATH 10B,A01,084110,Staff,26,0,30,4
1649764726136,MATH 10B,A02,084111,Staff,30,0,30,0
1649764726136,MATH 10B,A03,084112,Staff,30,0,30,0
1649764732165,MATH 10C,A01,083443,Staff,28,0,30,2
1649764732165,MATH 10C,A02,083444,Staff,27,0,30,3
1649764732165,MATH 10C,B01,084114,Staff,29,0,30,1
1649764732165,MATH 10C,B02,084115,Staff,30,0,30,0
1649764738192,MATH 18,A01,084117,Harel; Guershon,28,0,30,2
1649764738192,MATH 18,A02,084119,Harel; Guershon,29,0,30,1
1649764738192,MATH 18,A03,084120,Harel; Guershon,30,0,30,0
1649764738192,MATH 18,A04,084121,Harel; Guershon,30,0,30,0
1649764744226,MATH 20B,A01,084124,Um; Ko Woon,34,0,35,1
1649764744226,MATH 20B,B01,084126,Um; Ko Woon,35,0,35,0
1649764750257,MATH 20C,A01,083446,Hammock; Frances H,29,0,30,1
1649764750257,MATH 20C,A02,083447,Hammock; Frances H,30,0,30,0
1649764750257,MATH 20C,A03,083448,Hammock; Frances H,30,0,30,0
1649764750257,MATH 20C,A04,083449,Hammock; Frances H,30,0,30,0
1649764750257,MATH 20C,B01,083451,Hammock; Frances H,30,0,30,0
1649764750257,MATH 20C,B02,083452,Hammock; Frances H,30,0,30,0
1649764750257,MATH 20C,B03,083453,Hammock; Frances H,30,0,30,0
1649764750257,MATH 20C,B04,083454,Hammock; Frances H,30,0,30,0
1649764756286,MATH 20D,A01,084128,Staff,30,0,30,0
1649764756286,MATH 20D,A02,084129,Staff,30,0,30,0
1649764756286,MATH 20D,A03,084130,Staff,29,0,30,1
1649764756286,MATH 20D,B01,084133,Staff,30,0,30,0
1649764756286,MATH 20D,B02,084134,Staff,30,0,30,0
1649764756286,MATH 20D,B03,084135,Staff,30,0,30,0
1649764762318,MATH 20E,A01,084138,Staff,30,0,30,0
1649764762318,MATH 20E,A02,084139,Staff,29,0,30,1
1649764762318,MATH 20E,A03,084140,Staff,30,0,30,0
1649764762318,MATH 20E,A04,084141,Staff,30,0,30,0
1649764768349,MATH 102,A01,084143,Harel; Guershon,27,0,30,3
1649764768349,MATH 102,A02,084144,Harel; Guershon,29,0,30,1
1649764774376,MATH 103B,A01,083456,Staff,22,0,30,8
1649764774376,MATH 103B,A02,083457,Staff,28,0,30,2
1649764780402,MATH 109,A01,084146,Salehi Golsefidy; Alireza,30,0,30,0
1649764780402,MATH 109,A02,084147,Salehi Golsefidy; Alireza,29,0,30,1
1649764786430,MATH 120A,A01,085445,Eggers; John Dietrich,32,0,35,3
1649764786430,MATH 120A,A02,085446,Eggers; John Dietrich,34,0,35,1
1649764792464,MATH 142B,A01,084149,Verstraete; Jacques Allan,26,0,30,4
1649764792464,MATH 142B,A02,084150,Verstraete; Jacques Allan,28,0,30,2
1649764798491,MATH 170A,A01,083459,Nie; Jiawang,22,0,30,8
1649764798491,MATH 170A,A02,083460,Nie; Jiawang,28,0,30,2
1649764798491,MATH 170A,A03,083461,Nie; Jiawang,30,0,30,0
1649764804518,MATH 193B,A01,083463,Staff,25,0,30,5
1649764804518,MATH 193B,A02,083464,Staff,29,0,30,1
1649764804518,MATH 193B,A03,083465,Staff,30,0,30,0
1649764810594,COGS 2,A01,083966,Boyle; Mary E. T.,28,0,30,2
1649764816625,COGS 9,A01,083968,Staff,59,0,60,1
1649764822659,COGS 14B,A01,083970,Staff,50,0,50,0
1649764828686,COGS 100,A01,083972,Staff,58,0,60,2
1649764840739,COGS 101C,A01,083976,Staff,30,0,30,0
1649764846766,COGS 102A,A01,083978,Johnson; Christine M.,30,0,30,0
1649764852796,COGS 107B,A01,083980,Staff,46,0,50,4
1649764858824,COGS 115,A01,083982,Staff,27,0,30,3
1649764864854,COGS 118B,A01,083367,Staff,26,0,40,14
1649764870894,COGS 172,A01,083984,Provenzano; Emily Kara,25,0,30,5
1649764876919,COGS 177,A00,083368,Staff,22,0,30,8
1649764882946,COGS 186,A01,083986,Staff,31,0,40,9
1649764888977,COGS 187A,A01,083988,Boyle; Mary E. T.,56,0,60,4
1649764895005,CSE 8A,A50,084003,Miranda; Gregory Joseph,13,0,15,2
1649764901031,CSE 11,A01,084005,Miranda; Gregory Joseph,52,0,55,3
1649764907065,CSE 20,A01,084007,Staff,17,0,20,3
1649764913108,CSE 21,A01,084009,Staff,50,0,50,0
1649764919136,CSE 30,A01,083370,Cao; Yingjun,38,0,40,2
1649764925162,CSE 100,A01,083372,Cao; Yingjun,37,0,40,3
1649764931193,CSE 101,A01,084011,Staff,25,0,40,15
1649764937221,CSE 141,A01,083374,Eldon; John,46,0,75,29
1649764943252,CSE 141L,A01,083376,Eldon; John,48,0,75,27
1649764949276,CSE 175,A01,084013,Kumar; Rakesh,25,0,25,0
1649764955303,ECE 5,A01,084049,Morris; Karcher William,19,0,20,1
1649764961334,ECE 100,A01,084051,Baghdadchi; Saharnaz,18,0,20,2
1649764961334,ECE 100,A02,091916,Baghdadchi; Saharnaz,20,0,20,0
1649764967365,ECE 101,A01,084053,Baghdadchi; Saharnaz,33,0,37,4
1649764967365,ECE 101,A02,084054,Baghdadchi; Saharnaz,37,0,37,0
1649764973390,ECE 107,A01,083390,Staff,36,0,40,4
1649764979427,ECE 148,A01,084056,Silberman; Jack,10,0,12,2
1649764985555,ECE 180,A00,083391,Abi Samra; Nicholas Camill,28,0,30,2
1649764985555,ECE 180,B00,083392,Abi Samra; Nicholas Camill,28,0,30,2
1649764991582,MATH 10B,A01,084110,Staff,26,0,30,4
1649764991582,MATH 10B,A02,084111,Staff,30,0,30,0
1649764991582,MATH 10B,A03,084112,Staff,30,0,30,0
1649764997609,MATH 10C,A01,083443,Staff,28,0,30,2
1649764997609,MATH 10C,A02,083444,Staff,27,0,30,3
1649764997609,MATH 10C,B01,084114,Staff,29,0,30,1
1649764997609,MATH 10C,B02,084115,Staff,30,0,30,0
1649765003652,MATH 18,A01,084117,Harel; Guershon,28,0,30,2
1649765003652,MATH 18,A02,084119,Harel; Guershon,29,0,30,1
1649765003652,MATH 18,A03,084120,Harel; Guershon,30,0,30,0
1649765003652,MATH 18,A04,084121,Harel; Guershon,30,0,30,0
1649765009681,MATH 20B,A01,084124,Um; Ko Woon,34,0,35,1
1649765009681,MATH 20B,B01,084126,Um; Ko Woon,35,0,35,0
1649765015716,MATH 20C,A01,083446,Hammock; Frances H,29,0,30,1
1649765015716,MATH 20C,A02,083447,Hammock; Frances H,30,0,30,0
1649765015716,MATH 20C,A03,083448,Hammock; Frances H,30,0,30,0
1649765015716,MATH 20C,A04,083449,Hammock; Frances H,30,0,30,0
1649765015716,MATH 20C,B01,083451,Hammock; Frances H,30,0,30,0
1649765015716,MATH 20C,B02,083452,Hammock; Frances H,30,0,30,0
1649765015716,MATH 20C,B03,083453,Hammock; Frances H,30,0,30,0
1649765015716,MATH 20C,B04,083454,Hammock; Frances H,30,0,30,0
1649765021749,MATH 20D,A01,084128,Staff,30,0,30,0
1649765021749,MATH 20D,A02,084129,Staff,30,0,30,0
1649765021749,MATH 20D,A03,084130,Staff,29,0,30,1
1649765021749,MATH 20D,B01,084133,Staff,30,0,30,0
1649765021749,MATH 20D,B02,084134,Staff,30,0,30,0
1649765021749,MATH 20D,B03,084135,Staff,30,0,30,0
1649765027782,MATH 20E,A01,084138,Staff,30,0,30,0
1649765027782,MATH 20E,A02,084139,Staff,29,0,30,1
1649765027782,MATH 20E,A03,084140,Staff,30,0,30,0
1649765027782,MATH 20E,A04,084141,Staff,30,0,30,0
1649765033814,MATH 102,A01,084143,Harel; Guershon,27,0,30,3
1649765033814,MATH 102,A02,084144,Harel; Guershon,29,0,30,1
1649765039844,MATH 103B,A01,083456,Staff,22,0,30,8
1649765039844,MATH 103B,A02,083457,Staff,28,0,30,2
1649765045880,MATH 109,A01,084146,Salehi Golsefidy; Alireza,30,0,30,0
1649765045880,MATH 109,A02,084147,Salehi Golsefidy; Alireza,29,0,30,1
1649765051906,MATH 120A,A01,085445,Eggers; John Dietrich,32,0,35,3
1649765051906,MATH 120A,A02,085446,Eggers; John Dietrich,34,0,35,1
1649765057942,MATH 142B,A01,084149,Verstraete; Jacques Allan,26,0,30,4
1649765057942,MATH 142B,A02,084150,Verstraete; Jacques Allan,28,0,30,2
1649765063983,MATH 170A,A01,083459,Nie; Jiawang,22,0,30,8
1649765063983,MATH 170A,A02,083460,Nie; Jiawang,28,0,30,2
1649765063983,MATH 170A,A03,083461,Nie; Jiawang,30,0,30,0
1649765070031,MATH 193B,A01,083463,Staff,25,0,30,5
1649765070031,MATH 193B,A02,083464,Staff,29,0,30,1
1649765070031,MATH 193B,A03,083465,Staff,30,0,30,0
1649765076092,COGS 2,A01,083966,Boyle; Mary E. T.,28,0,30,2
1649765082122,COGS 9,A01,083968,Staff,59,0,60,1
1649765088153,COGS 14B,A01,083970,Staff,50,0,50,0
1649765094182,COGS 100,A01,083972,Staff,58,0,60,2
1649765106236,COGS 101C,A01,083976,Staff,30,0,30,0
1649765112261,COGS 102A,A01,083978,Johnson; Christine M.,30,0,30,0
1649765118289,COGS 107B,A01,083980,Staff,46,0,50,4
1649765124320,COGS 115,A01,083982,Staff,27,0,30,3
1649765130344,COGS 118B,A01,083367,Staff,26,0,40,14
1649765136376,COGS 172,A01,083984,Provenzano; Emily Kara,25,0,30,5
1649765142413,COGS 177,A00,083368,Staff,22,0,30,8
1649765148438,COGS 186,A01,083986,Staff,31,0,40,9
1649765154466,COGS 187A,A01,083988,Boyle; Mary E. T.,56,0,60,4
1649765160498,CSE 8A,A50,084003,Miranda; Gregory Joseph,13,0,15,2
1649765166535,CSE 11,A01,084005,Miranda; Gregory Joseph,52,0,55,3
1649765172571,CSE 20,A01,084007,Staff,17,0,20,3
1649765178596,CSE 21,A01,084009,Staff,50,0,50,0
1649765184630,CSE 30,A01,083370,Cao; Yingjun,38,0,40,2
1649765190655,CSE 100,A01,083372,Cao; Yingjun,37,0,40,3
1649765196686,CSE 101,A01,084011,Staff,25,0,40,15
1649765202711,CSE 141,A01,083374,Eldon; John,46,0,75,29
1649765208740,CSE 141L,A01,083376,Eldon; John,48,0,75,27
1649765214768,CSE 175,A01,084013,Kumar; Rakesh,25,0,25,0
1649765220808,ECE 5,A01,084049,Morris; Karcher William,19,0,20,1
1649765226840,ECE 100,A01,084051,Baghdadchi; Saharnaz,18,0,20,2
1649765226840,ECE 100,A02,091916,Baghdadchi; Saharnaz,20,0,20,0
1649765232871,ECE 101,A01,084053,Baghdadchi; Saharnaz,33,0,37,4
1649765232871,ECE 101,A02,084054,Baghdadchi; Saharnaz,37,0,37,0
1649765238901,ECE 107,A01,083390,Staff,36,0,40,4
1649765244927,ECE 148,A01,084056,Silberman; Jack,10,0,12,2
1649765250957,ECE 180,A00,083391,Abi Samra; Nicholas Camill,28,0,30,2
1649765250957,ECE 180,B00,083392,Abi Samra; Nicholas Camill,28,0,30,2
1649765256993,MATH 10B,A01,084110,Staff,26,0,30,4
1649765256993,MATH 10B,A02,084111,Staff,30,0,30,0
1649765256993,MATH 10B,A03,084112,Staff,30,0,30,0
1649765263022,MATH 10C,A01,083443,Staff,28,0,30,2
1649765263022,MATH 10C,A02,083444,Staff,27,0,30,3
1649765263022,MATH 10C,B01,084114,Staff,29,0,30,1
1649765263022,MATH 10C,B02,084115,Staff,30,0,30,0
1649765269050,MATH 18,A01,084117,Harel; Guershon,28,0,30,2
1649765269050,MATH 18,A02,084119,Harel; Guershon,29,0,30,1
1649765269050,MATH 18,A03,084120,Harel; Guershon,30,0,30,0
1649765269050,MATH 18,A04,084121,Harel; Guershon,30,0,30,0
1649765275078,MATH 20B,A01,084124,Um; Ko Woon,34,0,35,1
1649765275078,MATH 20B,B01,084126,Um; Ko Woon,35,0,35,0
1649765281108,MATH 20C,A01,083446,Hammock; Frances H,29,0,30,1
1649765281108,MATH 20C,A02,083447,Hammock; Frances H,30,0,30,0
1649765281108,MATH 20C,A03,083448,Hammock; Frances H,30,0,30,0
1649765281108,MATH 20C,A04,083449,Hammock; Frances H,30,0,30,0
1649765281108,MATH 20C,B01,083451,Hammock; Frances H,30,0,30,0
1649765281108,MATH 20C,B02,083452,Hammock; Frances H,30,0,30,0
1649765281108,MATH 20C,B03,083453,Hammock; Frances H,30,0,30,0
1649765281108,MATH 20C,B04,083454,Hammock; Frances H,30,0,30,0
1649765287135,MATH 20D,A01,084128,Staff,30,0,30,0
1649765287135,MATH 20D,A02,084129,Staff,30,0,30,0
1649765287135,MATH 20D,A03,084130,Staff,29,0,30,1
1649765287135,MATH 20D,B01,084133,Staff,30,0,30,0
1649765287135,MATH 20D,B02,084134,Staff,30,0,30,0
1649765287135,MATH 20D,B03,084135,Staff,30,0,30,0
1649765293165,MATH 20E,A01,084138,Staff,30,0,30,0
1649765293165,MATH 20E,A02,084139,Staff,29,0,30,1
1649765293165,MATH 20E,A03,084140,Staff,30,0,30,0
1649765293165,MATH 20E,A04,084141,Staff,30,0,30,0
1649765299201,MATH 102,A01,084143,Harel; Guershon,27,0,30,3
1649765299201,MATH 102,A02,084144,Harel; Guershon,29,0,30,1
1649765305232,MATH 103B,A01,083456,Staff,22,0,30,8
1649765305232,MATH 103B,A02,083457,Staff,28,0,30,2
1649765311262,MATH 109,A01,084146,Salehi Golsefidy; Alireza,30,0,30,0
1649765311262,MATH 109,A02,084147,Salehi Golsefidy; Alireza,29,0,30,1
1649765317291,MATH 120A,A01,085445,Eggers; John Dietrich,32,0,35,3
1649765317291,MATH 120A,A02,085446,Eggers; John Dietrich,34,0,35,1
1649765323319,MATH 142B,A01,084149,Verstraete; Jacques Allan,26,0,30,4
1649765323319,MATH 142B,A02,084150,Verstraete; Jacques Allan,28,0,30,2
1649765329350,MATH 170A,A01,083459,Nie; Jiawang,22,0,30,8
1649765329350,MATH 170A,A02,083460,Nie; Jiawang,28,0,30,2
1649765329350,MATH 170A,A03,083461,Nie; Jiawang,30,0,30,0
1649765335376,MATH 193B,A01,083463,Staff,25,0,30,5
1649765335376,MATH 193B,A02,083464,Staff,29,0,30,1
1649765335376,MATH 193B,A03,083465,Staff,30,0,30,0
1649765341435,COGS 2,A01,083966,Boyle; Mary E. T.,28,0,30,2
1649765347461,COGS 9,A01,083968,Staff,59,0,60,1
1649765353491,COGS 14B,A01,083970,Staff,50,0,50,0
1649765359522,COGS 100,A01,083972,Staff,58,0,60,2
1649765371574,COGS 101C,A01,083976,Staff,30,0,30,0
1649765377607,COGS 102A,A01,083978,Johnson; Christine M.,30,0,30,0
1649765383639,COGS 107B,A01,083980,Staff,46,0,50,4
1649765389663,COGS 115,A01,083982,Staff,27,0,30,3
1649765395692,COGS 118B,A01,083367,Staff,26,0,40,14
1649765401718,COGS 172,A01,083984,Provenzano; Emily Kara,25,0,30,5
1649765407746,COGS 177,A00,083368,Staff,22,0,30,8
1649765413777,COGS 186,A01,083986,Staff,31,0,40,9
1649765419814,COGS 187A,A01,083988,Boyle; Mary E. T.,56,0,60,4
1649765425846,CSE 8A,A50,084003,Miranda; Gregory Joseph,13,0,15,2
1649765431873,CSE 11,A01,084005,Miranda; Gregory Joseph,52,0,55,3
1649765437901,CSE 20,A01,084007,Staff,17,0,20,3
1649765443936,CSE 21,A01,084009,Staff,50,0,50,0
1649765449963,CSE 30,A01,083370,Cao; Yingjun,38,0,40,2
1649765455990,CSE 100,A01,083372,Cao; Yingjun,37,0,40,3
1649765462016,CSE 101,A01,084011,Staff,25,0,40,15
1649765468046,CSE 141,A01,083374,Eldon; John,46,0,75,29
1649765474071,CSE 141L,A01,083376,Eldon; John,48,0,75,27
1649765480098,CSE 175,A01,084013,Kumar; Rakesh,25,0,25,0
1649765486130,ECE 5,A01,084049,Morris; Karcher William,19,0,20,1
1649765492158,ECE 100,A01,084051,Baghdadchi; Saharnaz,18,0,20,2
1649765492158,ECE 100,A02,091916,Baghdadchi; Saharnaz,20,0,20,0
1649765498185,ECE 101,A01,084053,Baghdadchi; Saharnaz,33,0,37,4
1649765498185,ECE 101,A02,084054,Baghdadchi; Saharnaz,37,0,37,0
1649765504214,ECE 107,A01,083390,Staff,36,0,40,4
1649765510242,ECE 148,A01,084056,Silberman; Jack,10,0,12,2
1649765516270,ECE 180,A00,083391,Abi Samra; Nicholas Camill,28,0,30,2
1649765516270,ECE 180,B00,083392,Abi Samra; Nicholas Camill,28,0,30,2
1649765522299,MATH 10B,A01,084110,Staff,26,0,30,4
1649765522299,MATH 10B,A02,084111,Staff,30,0,30,0
1649765522299,MATH 10B,A03,084112,Staff,30,0,30,0
1649765528328,MATH 10C,A01,083443,Staff,28,0,30,2
1649765528328,MATH 10C,A02,083444,Staff,27,0,30,3
1649765528328,MATH 10C,B01,084114,Staff,29,0,30,1
1649765528328,MATH 10C,B02,084115,Staff,30,0,30,0
1649765534354,MATH 18,A01,084117,Harel; Guershon,28,0,30,2
1649765534354,MATH 18,A02,084119,Harel; Guershon,29,0,30,1
1649765534354,MATH 18,A03,084120,Harel; Guershon,30,0,30,0
1649765534354,MATH 18,A04,084121,Harel; Guershon,30,0,30,0
1649765540379,MATH 20B,A01,084124,Um; Ko Woon,34,0,35,1
1649765540379,MATH 20B,B01,084126,Um; Ko Woon,35,0,35,0
1649765546413,MATH 20C,A01,083446,Hammock; Frances H,29,0,30,1
1649765546413,MATH 20C,A02,083447,Hammock; Frances H,30,0,30,0
1649765546413,MATH 20C,A03,083448,Hammock; Frances H,30,0,30,0
1649765546413,MATH 20C,A04,083449,Hammock; Frances H,30,0,30,0
1649765546413,MATH 20C,B01,083451,Hammock; Frances H,30,0,30,0
1649765546413,MATH 20C,B02,083452,Hammock; Frances H,30,0,30,0
1649765546413,MATH 20C,B03,083453,Hammock; Frances H,30,0,30,0
1649765546413,MATH 20C,B04,083454,Hammock; Frances H,30,0,30,0
1649765552438,MATH 20D,A01,084128,Staff,30,0,30,0
1649765552438,MATH 20D,A02,084129,Staff,30,0,30,0
1649765552438,MATH 20D,A03,084130,Staff,29,0,30,1
1649765552438,MATH 20D,B01,084133,Staff,30,0,30,0
1649765552438,MATH 20D,B02,084134,Staff,30,0,30,0
1649765552438,MATH 20D,B03,084135,Staff,30,0,30,0
1649765558462,MATH 20E,A01,084138,Staff,30,0,30,0
1649765558462,MATH 20E,A02,084139,Staff,29,0,30,1
1649765558462,MATH 20E,A03,084140,Staff,30,0,30,0
1649765558462,MATH 20E,A04,084141,Staff,30,0,30,0
1649765564489,MATH 102,A01,084143,Harel; Guershon,27,0,30,3
1649765564489,MATH 102,A02,084144,Harel; Guershon,29,0,30,1
1649765570520,MATH 103B,A01,083456,Staff,22,0,30,8
1649765570520,MATH 103B,A02,083457,Staff,28,0,30,2
1649765576549,MATH 109,A01,084146,Salehi Golsefidy; Alireza,30,0,30,0
1649765576549,MATH 109,A02,084147,Salehi Golsefidy; Alireza,29,0,30,1
1649765582666,MATH 120A,A01,085445,Eggers; John Dietrich,32,0,35,3
1649765582666,MATH 120A,A02,085446,Eggers; John Dietrich,34,0,35,1
1649765588695,MATH 142B,A01,084149,Verstraete; Jacques Allan,26,0,30,4
1649765588695,MATH 142B,A02,084150,Verstraete; Jacques Allan,28,0,30,2
1649765594728,MATH 170A,A01,083459,Nie; Jiawang,22,0,30,8
1649765594728,MATH 170A,A02,083460,Nie; Jiawang,28,0,30,2
1649765594728,MATH 170A,A03,083461,Nie; Jiawang,30,0,30,0
1649765600756,MATH 193B,A01,083463,Staff,25,0,30,5
1649765600756,MATH 193B,A02,083464,Staff,29,0,30,1
1649765600756,MATH 193B,A03,083465,Staff,30,0,30,0
1649765606817,COGS 2,A01,083966,Boyle; Mary E. T.,28,0,30,2
1649765612846,COGS 9,A01,083968,Staff,59,0,60,1
1649765618873,COGS 14B,A01,083970,Staff,50,0,50,0
1649765624902,COGS 100,A01,083972,Staff,58,0,60,2
1649765636957,COGS 101C,A01,083976,Staff,30,0,30,0
1649765642984,COGS 102A,A01,083978,Johnson; Christine M.,30,0,30,0
1649765649014,COGS 107B,A01,083980,Staff,46,0,50,4
1649765655041,COGS 115,A01,083982,Staff,27,0,30,3
1649765661075,COGS 118B,A01,083367,Staff,26,0,40,14
1649765667111,COGS 172,A01,083984,Provenzano; Emily Kara,25,0,30,5
1649765673137,COGS 177,A00,083368,Staff,22,0,30,8
1649765679163,COGS 186,A01,083986,Staff,31,0,40,9
1649765685186,COGS 187A,A01,083988,Boyle; Mary E. T.,56,0,60,4
1649765691218,CSE 8A,A50,084003,Miranda; Gregory Joseph,13,0,15,2
1649765697248,CSE 11,A01,084005,Miranda; Gregory Joseph,52,0,55,3
1649765703283,CSE 20,A01,084007,Staff,17,0,20,3
1649765709314,CSE 21,A01,084009,Staff,50,0,50,0
1649765715355,CSE 30,A01,083370,Cao; Yingjun,38,0,40,2
1649765721386,CSE 100,A01,083372,Cao; Yingjun,37,0,40,3
1649765727413,CSE 101,A01,084011,Staff,25,0,40,15
1649765733443,CSE 141,A01,083374,Eldon; John,46,0,75,29
1649765739474,CSE 141L,A01,083376,Eldon; John,48,0,75,27
1649765745505,CSE 175,A01,084013,Kumar; Rakesh,25,0,25,0
1649765751531,ECE 5,A01,084049,Morris; Karcher William,19,0,20,1
1649765757568,ECE 100,A01,084051,Baghdadchi; Saharnaz,18,0,20,2
1649765757568,ECE 100,A02,091916,Baghdadchi; Saharnaz,20,0,20,0
1649765763594,ECE 101,A01,084053,Baghdadchi; Saharnaz,33,0,37,4
1649765763594,ECE 101,A02,084054,Baghdadchi; Saharnaz,37,0,37,0
1649765769625,ECE 107,A01,083390,Staff,36,0,40,4
1649765775653,ECE 148,A01,084056,Silberman; Jack,10,0,12,2
1649765781682,ECE 180,A00,083391,Abi Samra; Nicholas Camill,28,0,30,2
1649765781682,ECE 180,B00,083392,Abi Samra; Nicholas Camill,28,0,30,2
1649765787708,MATH 10B,A01,084110,Staff,26,0,30,4
1649765787708,MATH 10B,A02,084111,Staff,30,0,30,0
1649765787708,MATH 10B,A03,084112,Staff,30,0,30,0
1649765793733,MATH 10C,A01,083443,Staff,28,0,30,2
1649765793733,MATH 10C,A02,083444,Staff,27,0,30,3
1649765793733,MATH 10C,B01,084114,Staff,29,0,30,1
1649765793733,MATH 10C,B02,084115,Staff,30,0,30,0
1649765799764,MATH 18,A01,084117,Harel; Guershon,28,0,30,2
1649765799764,MATH 18,A02,084119,Harel; Guershon,29,0,30,1
1649765799764,MATH 18,A03,084120,Harel; Guershon,30,0,30,0
1649765799764,MATH 18,A04,084121,Harel; Guershon,30,0,30,0
1649765805800,MATH 20B,A01,084124,Um; Ko Woon,34,0,35,1
1649765805800,MATH 20B,B01,084126,Um; Ko Woon,35,0,35,0
1649765811832,MATH 20C,A01,083446,Hammock; Frances H,29,0,30,1
1649765811832,MATH 20C,A02,083447,Hammock; Frances H,30,0,30,0
1649765811832,MATH 20C,A03,083448,Hammock; Frances H,30,0,30,0
1649765811832,MATH 20C,A04,083449,Hammock; Frances H,30,0,30,0
1649765811832,MATH 20C,B01,083451,Hammock; Frances H,30,0,30,0
1649765811832,MATH 20C,B02,083452,Hammock; Frances H,30,0,30,0
1649765811832,MATH 20C,B03,083453,Hammock; Frances H,30,0,30,0
1649765811832,MATH 20C,B04,083454,Hammock; Frances H,30,0,30,0
1649765817863,MATH 20D,A01,084128,Staff,30,0,30,0
1649765817863,MATH 20D,A02,084129,Staff,30,0,30,0
1649765817863,MATH 20D,A03,084130,Staff,29,0,30,1
1649765817863,MATH 20D,B01,084133,Staff,30,0,30,0
1649765817863,MATH 20D,B02,084134,Staff,30,0,30,0
1649765817863,MATH 20D,B03,084135,Staff,30,0,30,0
1649765823891,MATH 20E,A01,084138,Staff,30,0,30,0
1649765823891,MATH 20E,A02,084139,Staff,29,0,30,1
1649765823891,MATH 20E,A03,084140,Staff,30,0,30,0
1649765823891,MATH 20E,A04,084141,Staff,30,0,30,0
1649765829920,MATH 102,A01,084143,Harel; Guershon,27,0,30,3
1649765829920,MATH 102,A02,084144,Harel; Guershon,29,0,30,1
1649765835962,MATH 103B,A01,083456,Staff,22,0,30,8
1649765835962,MATH 103B,A02,083457,Staff,28,0,30,2
1649765841991,MATH 109,A01,084146,Salehi Golsefidy; Alireza,30,0,30,0
1649765841991,MATH 109,A02,084147,Salehi Golsefidy; Alireza,29,0,30,1
1649765848018,MATH 120A,A01,085445,Eggers; John Dietrich,32,0,35,3
1649765848018,MATH 120A,A02,085446,Eggers; John Dietrich,34,0,35,1
1649765854049,MATH 142B,A01,084149,Verstraete; Jacques Allan,26,0,30,4
1649765854049,MATH 142B,A02,084150,Verstraete; Jacques Allan,28,0,30,2
1649765860076,MATH 170A,A01,083459,Nie; Jiawang,22,0,30,8
1649765860076,MATH 170A,A02,083460,Nie; Jiawang,28,0,30,2
1649765860076,MATH 170A,A03,083461,Nie; Jiawang,30,0,30,0
1649765866120,MATH 193B,A01,083463,Staff,25,0,30,5
1649765866120,MATH 193B,A02,083464,Staff,29,0,30,1
1649765866120,MATH 193B,A03,083465,Staff,30,0,30,0
1649765872179,COGS 2,A01,083966,Boyle; Mary E. T.,28,0,30,2
1649765878212,COGS 9,A01,083968,Staff,59,0,60,1
1649765884240,COGS 14B,A01,083970,Staff,50,0,50,0
1649765890268,COGS 100,A01,083972,Staff,58,0,60,2
1649765902324,COGS 101C,A01,083976,Staff,30,0,30,0
1649765908360,COGS 102A,A01,083978,Johnson; Christine M.,30,0,30,0
1649765914386,COGS 107B,A01,083980,Staff,46,0,50,4
1649765920413,COGS 115,A01,083982,Staff,27,0,30,3
1649765926447,COGS 118B,A01,083367,Staff,26,0,40,14
1649765932479,COGS 172,A01,083984,Provenzano; Emily Kara,25,0,30,5
1649765938509,COGS 177,A00,083368,Staff,22,0,30,8
1649765944543,COGS 186,A01,083986,Staff,31,0,40,9
1649765950576,COGS 187A,A01,083988,Boyle; Mary E. T.,56,0,60,4
1649765956604,CSE 8A,A50,084003,Miranda; Gregory Joseph,13,0,15,2
1649765962630,CSE 11,A01,084005,Miranda; Gregory Joseph,52,0,55,3
1649765968654,CSE 20,A01,084007,Staff,17,0,20,3
1649765974686,CSE 21,A01,084009,Staff,50,0,50,0
1649765980716,CSE 30,A01,083370,Cao; Yingjun,38,0,40,2
1649765986742,CSE 100,A01,083372,Cao; Yingjun,37,0,40,3
1649765992792,CSE 101,A01,084011,Staff,25,0,40,15
1649765998819,CSE 141,A01,083374,Eldon; John,46,0,75,29
1649766004858,CSE 141L,A01,083376,Eldon; John,48,0,75,27
1649766010889,CSE 175,A01,084013,Kumar; Rakesh,25,0,25,0
1649766016921,ECE 5,A01,084049,Morris; Karcher William,19,0,20,1
1649766022955,ECE 100,A01,084051,Baghdadchi; Saharnaz,18,0,20,2
1649766022955,ECE 100,A02,091916,Baghdadchi; Saharnaz,20,0,20,0
1649766028984,ECE 101,A01,084053,Baghdadchi; Saharnaz,33,0,37,4
1649766028984,ECE 101,A02,084054,Baghdadchi; Saharnaz,37,0,37,0
1649766035011,ECE 107,A01,083390,Staff,36,0,40,4
1649766041040,ECE 148,A01,084056,Silberman; Jack,10,0,12,2
1649766047064,ECE 180,A00,083391,Abi Samra; Nicholas Camill,28,0,30,2
1649766047064,ECE 180,B00,083392,Abi Samra; Nicholas Camill,28,0,30,2
1649766053095,MATH 10B,A01,084110,Staff,26,0,30,4
1649766053095,MATH 10B,A02,084111,Staff,30,0,30,0
1649766053095,MATH 10B,A03,084112,Staff,30,0,30,0
1649766059123,MATH 10C,A01,083443,Staff,28,0,30,2
1649766059123,MATH 10C,A02,083444,Staff,27,0,30,3
1649766059123,MATH 10C,B01,084114,Staff,29,0,30,1
1649766059123,MATH 10C,B02,084115,Staff,30,0,30,0
1649766065150,MATH 18,A01,084117,Harel; Guershon,28,0,30,2
1649766065150,MATH 18,A02,084119,Harel; Guershon,29,0,30,1
1649766065150,MATH 18,A03,084120,Harel; Guershon,30,0,30,0
1649766065150,MATH 18,A04,084121,Harel; Guershon,30,0,30,0
1649766071175,MATH 20B,A01,084124,Um; Ko Woon,34,0,35,1
1649766071175,MATH 20B,B01,084126,Um; Ko Woon,35,0,35,0
1649766077203,MATH 20C,A01,083446,Hammock; Frances H,29,0,30,1
1649766077203,MATH 20C,A02,083447,Hammock; Frances H,30,0,30,0
1649766077203,MATH 20C,A03,083448,Hammock; Frances H,30,0,30,0
1649766077203,MATH 20C,A04,083449,Hammock; Frances H,30,0,30,0
1649766077203,MATH 20C,B01,083451,Hammock; Frances H,30,0,30,0
1649766077203,MATH 20C,B02,083452,Hammock; Frances H,30,0,30,0
1649766077203,MATH 20C,B03,083453,Hammock; Frances H,30,0,30,0
1649766077203,MATH 20C,B04,083454,Hammock; Frances H,30,0,30,0
1649766083237,MATH 20D,A01,084128,Staff,30,0,30,0
1649766083237,MATH 20D,A02,084129,Staff,30,0,30,0
1649766083237,MATH 20D,A03,084130,Staff,29,0,30,1
1649766083237,MATH 20D,B01,084133,Staff,30,0,30,0
1649766083237,MATH 20D,B02,084134,Staff,30,0,30,0
1649766083237,MATH 20D,B03,084135,Staff,30,0,30,0
1649766089260,MATH 20E,A01,084138,Staff,30,0,30,0
1649766089260,MATH 20E,A02,084139,Staff,29,0,30,1
1649766089260,MATH 20E,A03,084140,Staff,30,0,30,0
1649766089260,MATH 20E,A04,084141,Staff,30,0,30,0
1649766095285,MATH 102,A01,084143,Harel; Guershon,27,0,30,3
1649766095285,MATH 102,A02,084144,Harel; Guershon,29,0,30,1
1649766101325,MATH 103B,A01,083456,Staff,22,0,30,8
1649766101325,MATH 103B,A02,083457,Staff,28,0,30,2
1649766107351,MATH 109,A01,084146,Salehi Golsefidy; Alireza,30,0,30,0
1649766107351,MATH 109,A02,084147,Salehi Golsefidy; Alireza,29,0,30,1
1649766113385,MATH 120A,A01,085445,Eggers; John Dietrich,32,0,35,3
1649766113385,MATH 120A,A02,085446,Eggers; John Dietrich,34,0,35,1
1649766119412,MATH 142B,A01,084149,Verstraete; Jacques Allan,26,0,30,4
1649766119412,MATH 142B,A02,084150,Verstraete; Jacques Allan,28,0,30,2
1649766125447,MATH 170A,A01,083459,Nie; Jiawang,22,0,30,8
1649766125447,MATH 170A,A02,083460,Nie; Jiawang,28,0,30,2
1649766125447,MATH 170A,A03,083461,Nie; Jiawang,30,0,30,0
1649766131479,MATH 193B,A01,083463,Staff,25,0,30,5
1649766131479,MATH 193B,A02,083464,Staff,29,0,30,1
1649766131479,MATH 193B,A03,083465,Staff,30,0,30,0
1649766137552,COGS 2,A01,083966,Boyle; Mary E. T.,28,0,30,2
1649766143582,COGS 9,A01,083968,Staff,59,0,60,1
1649766149608,COGS 14B,A01,083970,Staff,50,0,50,0
1649766155637,COGS 100,A01,083972,Staff,58,0,60,2
1649766167693,COGS 101C,A01,083976,Staff,30,0,30,0
1649766173809,COGS 102A,A01,083978,Johnson; Christine M.,30,0,30,0
1649766179851,COGS 107B,A01,083980,Staff,46,0,50,4
1649766185877,COGS 115,A01,083982,Staff,27,0,30,3
1649766191908,COGS 118B,A01,083367,Staff,26,0,40,14
1649766197934,COGS 172,A01,083984,Provenzano; Emily Kara,25,0,30,5
1649766203962,COGS 177,A00,083368,Staff,22,0,30,8
1649766209992,COGS 186,A01,083986,Staff,31,0,40,9
1649766216018,COGS 187A,A01,083988,Boyle; Mary E. T.,56,0,60,4
1649766222048,CSE 8A,A50,084003,Miranda; Gregory Joseph,13,0,15,2
1649766228079,CSE 11,A01,084005,Miranda; Gregory Joseph,52,0,55,3
1649766234108,CSE 20,A01,084007,Staff,17,0,20,3
1649766240139,CSE 21,A01,084009,Staff,50,0,50,0
1649766246180,CSE 30,A01,083370,Cao; Yingjun,38,0,40,2
1649766252213,CSE 100,A01,083372,Cao; Yingjun,37,0,40,3
1649766258253,CSE 101,A01,084011,Staff,25,0,40,15
1649766264280,CSE 141,A01,083374,Eldon; John,46,0,75,29
1649766270307,CSE 141L,A01,083376,Eldon; John,48,0,75,27
1649766276337,CSE 175,A01,084013,Kumar; Rakesh,25,0,25,0
1649766282369,ECE 5,A01,084049,Morris; Karcher William,19,0,20,1
1649766288403,ECE 100,A01,084051,Baghdadchi; Saharnaz,18,0,20,2
1649766288403,ECE 100,A02,091916,Baghdadchi; Saharnaz,20,0,20,0
1649766294436,ECE 101,A01,084053,Baghdadchi; Saharnaz,33,0,37,4
1649766294436,ECE 101,A02,084054,Baghdadchi; Saharnaz,37,0,37,0
1649766300465,ECE 107,A01,083390,Staff,36,0,40,4
1649766306499,ECE 148,A01,084056,Silberman; Jack,10,0,12,2
1649766312528,ECE 180,A00,083391,Abi Samra; Nicholas Camill,28,0,30,2
1649766312528,ECE 180,B00,083392,Abi Samra; Nicholas Camill,28,0,30,2
1649766318553,MATH 10B,A01,084110,Staff,26,0,30,4
1649766318553,MATH 10B,A02,084111,Staff,30,0,30,0
1649766318553,MATH 10B,A03,084112,Staff,30,0,30,0
1649766324578,MATH 10C,A01,083443,Staff,28,0,30,2
1649766324578,MATH 10C,A02,083444,Staff,27,0,30,3
1649766324578,MATH 10C,B01,084114,Staff,29,0,30,1
1649766324578,MATH 10C,B02,084115,Staff,30,0,30,0
1649766330605,MATH 18,A01,084117,Harel; Guershon,28,0,30,2
1649766330605,MATH 18,A02,084119,Harel; Guershon,29,0,30,1
1649766330605,MATH 18,A03,084120,Harel; Guershon,30,0,30,0
1649766330605,MATH 18,A04,084121,Harel; Guershon,30,0,30,0
1649766336636,MATH 20B,A01,084124,Um; Ko Woon,34,0,35,1
1649766336636,MATH 20B,B01,084126,Um; Ko Woon,35,0,35,0
1649766342664,MATH 20C,A01,083446,Hammock; Frances H,29,0,30,1
1649766342664,MATH 20C,A02,083447,Hammock; Frances H,30,0,30,0
1649766342664,MATH 20C,A03,083448,Hammock; Frances H,30,0,30,0
1649766342664,MATH 20C,A04,083449,Hammock; Frances H,30,0,30,0
1649766342664,MATH 20C,B01,083451,Hammock; Frances H,30,0,30,0
1649766342664,MATH 20C,B02,083452,Hammock; Frances H,30,0,30,0
1649766342664,MATH 20C,B03,083453,Hammock; Frances H,30,0,30,0
1649766342664,MATH 20C,B04,083454,Hammock; Frances H,30,0,30,0
1649766348695,MATH 20D,A01,084128,Staff,30,0,30,0
1649766348695,MATH 20D,A02,084129,Staff,30,0,30,0
1649766348695,MATH 20D,A03,084130,Staff,29,0,30,1
1649766348695,MATH 20D,B01,084133,Staff,30,0,30,0
1649766348695,MATH 20D,B02,084134,Staff,30,0,30,0
1649766348695,MATH 20D,B03,084135,Staff,30,0,30,0
1649766354721,MATH 20E,A01,084138,Staff,30,0,30,0
1649766354721,MATH 20E,A02,084139,Staff,29,0,30,1
1649766354721,MATH 20E,A03,084140,Staff,30,0,30,0
1649766354721,MATH 20E,A04,084141,Staff,30,0,30,0
1649766360755,MATH 102,A01,084143,Harel; Guershon,27,0,30,3
1649766360755,MATH 102,A02,084144,Harel; Guershon,29,0,30,1
1649766366802,MATH 103B,A01,083456,Staff,22,0,30,8
1649766366802,MATH 103B,A02,083457,Staff,28,0,30,2
1649766372833,MATH 109,A01,084146,Salehi Golsefidy; Alireza,30,0,30,0
1649766372833,MATH 109,A02,084147,Salehi Golsefidy; Alireza,29,0,30,1
1649766378860,MATH 120A,A01,085445,Eggers; John Dietrich,32,0,35,3
1649766378860,MATH 120A,A02,085446,Eggers; John Dietrich,34,0,35,1
1649766384886,MATH 142B,A01,084149,Verstraete; Jacques Allan,26,0,30,4
1649766384886,MATH 142B,A02,084150,Verstraete; Jacques Allan,28,0,30,2
1649766390920,MATH 170A,A01,083459,Nie; Jiawang,22,0,30,8
1649766390920,MATH 170A,A02,083460,Nie; Jiawang,28,0,30,2
1649766390920,MATH 170A,A03,083461,Nie; Jiawang,30,0,30,0
1649766396951,MATH 193B,A01,083463,Staff,25,0,30,5
1649766396951,MATH 193B,A02,083464,Staff,29,0,30,1
1649766396951,MATH 193B,A03,083465,Staff,30,0,30,0
1649766403030,COGS 2,A01,083966,Boyle; Mary E. T.,28,0,30,2
1649766409061,COGS 9,A01,083968,Staff,59,0,60,1
1649766415090,COGS 14B,A01,083970,Staff,50,0,50,0
1649766421115,COGS 100,A01,083972,Staff,58,0,60,2
1649766433168,COGS 101C,A01,083976,Staff,30,0,30,0
1649766439194,COGS 102A,A01,083978,Johnson; Christine M.,30,0,30,0
1649766445222,COGS 107B,A01,083980,Staff,46,0,50,4
1649766451246,COGS 115,A01,083982,Staff,27,0,30,3
1649766457278,COGS 118B,A01,083367,Staff,26,0,40,14
1649766463309,COGS 172,A01,083984,Provenzano; Emily Kara,25,0,30,5
1649766469336,COGS 177,A00,083368,Staff,22,0,30,8
1649766475366,COGS 186,A01,083986,Staff,31,0,40,9
1649766481393,COGS 187A,A01,083988,Boyle; Mary E. T.,56,0,60,4
1649766487421,CSE 8A,A50,084003,Miranda; Gregory Joseph,13,0,15,2
1649766493452,CSE 11,A01,084005,Miranda; Gregory Joseph,52,0,55,3
1649766499482,CSE 20,A01,084007,Staff,17,0,20,3
1649766505515,CSE 21,A01,084009,Staff,50,0,50,0
1649766511548,CSE 30,A01,083370,Cao; Yingjun,38,0,40,2
1649766517574,CSE 100,A01,083372,Cao; Yingjun,37,0,40,3
1649766523606,CSE 101,A01,084011,Staff,25,0,40,15
1649766529634,CSE 141,A01,083374,Eldon; John,46,0,75,29
1649766535667,CSE 141L,A01,083376,Eldon; John,48,0,75,27
1649766541699,CSE 175,A01,084013,Kumar; Rakesh,25,0,25,0
1649766547728,ECE 5,A01,084049,Morris; Karcher William,19,0,20,1
1649766553767,ECE 100,A01,084051,Baghdadchi; Saharnaz,18,0,20,2
1649766553767,ECE 100,A02,091916,Baghdadchi; Saharnaz,20,0,20,0
1649766559795,ECE 101,A01,084053,Baghdadchi; Saharnaz,33,0,37,4
1649766559795,ECE 101,A02,084054,Baghdadchi; Saharnaz,37,0,37,0
1649766565823,ECE 107,A01,083390,Staff,36,0,40,4
1649766571855,ECE 148,A01,084056,Silberman; Jack,10,0,12,2
1649766577884,ECE 180,A00,083391,Abi Samra; Nicholas Camill,28,0,30,2
1649766577884,ECE 180,B00,083392,Abi Samra; Nicholas Camill,28,0,30,2
1649766583916,MATH 10B,A01,084110,Staff,26,0,30,4
1649766583916,MATH 10B,A02,084111,Staff,30,0,30,0
1649766583916,MATH 10B,A03,084112,Staff,30,0,30,0
1649766589953,MATH 10C,A01,083443,Staff,28,0,30,2
1649766589953,MATH 10C,A02,083444,Staff,27,0,30,3
1649766589953,MATH 10C,B01,084114,Staff,29,0,30,1
1649766589953,MATH 10C,B02,084115,Staff,30,0,30,0
1649766595982,MATH 18,A01,084117,Harel; Guershon,28,0,30,2
1649766595982,MATH 18,A02,084119,Harel; Guershon,29,0,30,1
1649766595982,MATH 18,A03,084120,Harel; Guershon,30,0,30,0
1649766595982,MATH 18,A04,084121,Harel; Guershon,30,0,30,0
1649766602029,MATH 20B,A01,084124,Um; Ko Woon,34,0,35,1
1649766602029,MATH 20B,B01,084126,Um; Ko Woon,35,0,35,0
1649766608058,MATH 20C,A01,083446,Hammock; Frances H,29,0,30,1
1649766608058,MATH 20C,A02,083447,Hammock; Frances H,30,0,30,0
1649766608058,MATH 20C,A03,083448,Hammock; Frances H,30,0,30,0
1649766608058,MATH 20C,A04,083449,Hammock; Frances H,30,0,30,0
1649766608058,MATH 20C,B01,083451,Hammock; Frances H,30,0,30,0
1649766608058,MATH 20C,B02,083452,Hammock; Frances H,30,0,30,0
1649766608058,MATH 20C,B03,083453,Hammock; Frances H,30,0,30,0
1649766608058,MATH 20C,B04,083454,Hammock; Frances H,30,0,30,0
1649766614093,MATH 20D,A01,084128,Staff,30,0,30,0
1649766614093,MATH 20D,A02,084129,Staff,30,0,30,0
1649766614093,MATH 20D,A03,084130,Staff,29,0,30,1
1649766614093,MATH 20D,B01,084133,Staff,30,0,30,0
1649766614093,MATH 20D,B02,084134,Staff,30,0,30,0
1649766614093,MATH 20D,B03,084135,Staff,30,0,30,0
1649766620124,MATH 20E,A01,084138,Staff,30,0,30,0
1649766620124,MATH 20E,A02,084139,Staff,29,0,30,1
1649766620124,MATH 20E,A03,084140,Staff,30,0,30,0
1649766620124,MATH 20E,A04,084141,Staff,30,0,30,0
1649766626156,MATH 102,A01,084143,Harel; Guershon,27,0,30,3
1649766626156,MATH 102,A02,084144,Harel; Guershon,29,0,30,1
1649766632187,MATH 103B,A01,083456,Staff,22,0,30,8
1649766632187,MATH 103B,A02,083457,Staff,28,0,30,2
1649766638220,MATH 109,A01,084146,Salehi Golsefidy; Alireza,30,0,30,0
1649766638220,MATH 109,A02,084147,Salehi Golsefidy; Alireza,29,0,30,1
1649766644252,MATH 120A,A01,085445,Eggers; John Dietrich,32,0,35,3
1649766644252,MATH 120A,A02,085446,Eggers; John Dietrich,34,0,35,1
1649766650284,MATH 142B,A01,084149,Verstraete; Jacques Allan,26,0,30,4
1649766650284,MATH 142B,A02,084150,Verstraete; Jacques Allan,28,0,30,2
1649766656312,MATH 170A,A01,083459,Nie; Jiawang,22,0,30,8
1649766656312,MATH 170A,A02,083460,Nie; Jiawang,28,0,30,2
1649766656312,MATH 170A,A03,083461,Nie; Jiawang,30,0,30,0
1649766662344,MATH 193B,A01,083463,Staff,25,0,30,5
1649766662344,MATH 193B,A02,083464,Staff,29,0,30,1
1649766662344,MATH 193B,A03,083465,Staff,30,0,30,0
1649766668410,COGS 2,A01,083966,Boyle; Mary E. T.,28,0,30,2
1649766674436,COGS 9,A01,083968,Staff,59,0,60,1
1649766680476,COGS 14B,A01,083970,Staff,50,0,50,0
1649766686502,COGS 100,A01,083972,Staff,58,0,60,2
1649766698551,COGS 101C,A01,083976,Staff,30,0,30,0
1649766704575,COGS 102A,A01,083978,Johnson; Christine M.,30,0,30,0
1649766710599,COGS 107B,A01,083980,Staff,46,0,50,4
1649766716627,COGS 115,A01,083982,Staff,27,0,30,3
1649766722653,COGS 118B,A01,083367,Staff,26,0,40,14
1649766728683,COGS 172,A01,083984,Provenzano; Emily Kara,25,0,30,5
1649766734707,COGS 177,A00,083368,Staff,22,0,30,8
1649766740737,COGS 186,A01,083986,Staff,31,0,40,9
1649766746767,COGS 187A,A01,083988,Boyle; Mary E. T.,56,0,60,4
1649766752794,CSE 8A,A50,084003,Miranda; Gregory Joseph,13,0,15,2
1649766758820,CSE 11,A01,084005,Miranda; Gregory Joseph,52,0,55,3
1649766764847,CSE 20,A01,084007,Staff,17,0,20,3
1649766770948,CSE 21,A01,084009,Staff,50,0,50,0
1649766776978,CSE 30,A01,083370,Cao; Yingjun,38,0,40,2
1649766783008,CSE 100,A01,083372,Cao; Yingjun,37,0,40,3
1649766789036,CSE 101,A01,084011,Staff,25,0,40,15
1649766795063,CSE 141,A01,083374,Eldon; John,46,0,75,29
1649766801089,CSE 141L,A01,083376,Eldon; John,48,0,75,27
1649766807119,CSE 175,A01,084013,Kumar; Rakesh,25,0,25,0
1649766813148,ECE 5,A01,084049,Morris; Karcher William,19,0,20,1
1649766819184,ECE 100,A01,084051,Baghdadchi; Saharnaz,18,0,20,2
1649766819184,ECE 100,A02,091916,Baghdadchi; Saharnaz,20,0,20,0
1649766825208,ECE 101,A01,084053,Baghdadchi; Saharnaz,33,0,37,4
1649766825208,ECE 101,A02,084054,Baghdadchi; Saharnaz,37,0,37,0
1649766831233,ECE 107,A01,083390,Staff,36,0,40,4
1649766837263,ECE 148,A01,084056,Silberman; Jack,10,0,12,2
1649766843296,ECE 180,A00,083391,Abi Samra; Nicholas Camill,28,0,30,2
1649766843296,ECE 180,B00,083392,Abi Samra; Nicholas Camill,28,0,30,2
1649766849332,MATH 10B,A01,084110,Staff,26,0,30,4
1649766849332,MATH 10B,A02,084111,Staff,30,0,30,0
1649766849332,MATH 10B,A03,084112,Staff,30,0,30,0
1649766855359,MATH 10C,A01,083443,Staff,28,0,30,2
1649766855359,MATH 10C,A02,083444,Staff,27,0,30,3
1649766855359,MATH 10C,B01,084114,Staff,29,0,30,1
1649766855359,MATH 10C,B02,084115,Staff,30,0,30,0
1649766861385,MATH 18,A01,084117,Harel; Guershon,28,0,30,2
1649766861385,MATH 18,A02,084119,Harel; Guershon,29,0,30,1
1649766861385,MATH 18,A03,084120,Harel; Guershon,30,0,30,0
1649766861385,MATH 18,A04,084121,Harel; Guershon,30,0,30,0
1649766867413,MATH 20B,A01,084124,Um; Ko Woon,34,0,35,1
1649766867413,MATH 20B,B01,084126,Um; Ko Woon,35,0,35,0
1649766873439,MATH 20C,A01,083446,Hammock; Frances H,29,0,30,1
1649766873439,MATH 20C,A02,083447,Hammock; Frances H,30,0,30,0
1649766873439,MATH 20C,A03,083448,Hammock; Frances H,30,0,30,0
1649766873439,MATH 20C,A04,083449,Hammock; Frances H,30,0,30,0
1649766873439,MATH 20C,B01,083451,Hammock; Frances H,30,0,30,0
1649766873439,MATH 20C,B02,083452,Hammock; Frances H,30,0,30,0
1649766873439,MATH 20C,B03,083453,Hammock; Frances H,30,0,30,0
1649766873439,MATH 20C,B04,083454,Hammock; Frances H,30,0,30,0
1649766879470,MATH 20D,A01,084128,Staff,30,0,30,0
1649766879470,MATH 20D,A02,084129,Staff,30,0,30,0
1649766879470,MATH 20D,A03,084130,Staff,29,0,30,1
1649766879470,MATH 20D,B01,084133,Staff,30,0,30,0
1649766879470,MATH 20D,B02,084134,Staff,30,0,30,0
1649766879470,MATH 20D,B03,084135,Staff,30,0,30,0
1649766885501,MATH 20E,A01,084138,Staff,30,0,30,0
1649766885501,MATH 20E,A02,084139,Staff,29,0,30,1
1649766885501,MATH 20E,A03,084140,Staff,30,0,30,0
1649766885501,MATH 20E,A04,084141,Staff,30,0,30,0
1649766891550,MATH 102,A01,084143,Harel; Guershon,27,0,30,3
1649766891550,MATH 102,A02,084144,Harel; Guershon,29,0,30,1
1649766897583,MATH 103B,A01,083456,Staff,22,0,30,8
1649766897583,MATH 103B,A02,083457,Staff,28,0,30,2
1649766903628,MATH 109,A01,084146,Salehi Golsefidy; Alireza,30,0,30,0
1649766903628,MATH 109,A02,084147,Salehi Golsefidy; Alireza,29,0,30,1
1649766909675,MATH 120A,A01,085445,Eggers; John Dietrich,32,0,35,3
1649766909675,MATH 120A,A02,085446,Eggers; John Dietrich,34,0,35,1
1649766915707,MATH 142B,A01,084149,Verstraete; Jacques Allan,26,0,30,4
1649766915707,MATH 142B,A02,084150,Verstraete; Jacques Allan,28,0,30,2
1649766921746,MATH 170A,A01,083459,Nie; Jiawang,22,0,30,8
1649766921746,MATH 170A,A02,083460,Nie; Jiawang,28,0,30,2
1649766921746,MATH 170A,A03,083461,Nie; Jiawang,30,0,30,0
1649766927770,MATH 193B,A01,083463,Staff,25,0,30,5
1649766927770,MATH 193B,A02,083464,Staff,29,0,30,1
1649766927770,MATH 193B,A03,083465,Staff,30,0,30,0
1649766933851,COGS 2,A01,083966,Boyle; Mary E. T.,28,0,30,2
1649766939877,COGS 9,A01,083968,Staff,59,0,60,1
1649766945906,COGS 14B,A01,083970,Staff,50,0,50,0
1649766951932,COGS 100,A01,083972,Staff,58,0,60,2
1649766963987,COGS 101C,A01,083976,Staff,30,0,30,0
1649766970018,COGS 102A,A01,083978,Johnson; Christine M.,30,0,30,0
1649766976056,COGS 107B,A01,083980,Staff,46,0,50,4
1649766982080,COGS 115,A01,083982,Staff,27,0,30,3
1649766988106,COGS 118B,A01,083367,Staff,26,0,40,14
1649766994134,COGS 172,A01,083984,Provenzano; Emily Kara,25,0,30,5
1649767000159,COGS 177,A00,083368,Staff,22,0,30,8
1649767006189,COGS 186,A01,083986,Staff,31,0,40,9
1649767012214,COGS 187A,A01,083988,Boyle; Mary E. T.,56,0,60,4
1649767018242,CSE 8A,A50,084003,Miranda; Gregory Joseph,13,0,15,2
1649767024273,CSE 11,A01,084005,Miranda; Gregory Joseph,52,0,55,3
1649767030309,CSE 20,A01,084007,Staff,17,0,20,3
1649767036340,CSE 21,A01,084009,Staff,50,0,50,0
1649767042368,CSE 30,A01,083370,Cao; Yingjun,38,0,40,2
1649767048393,CSE 100,A01,083372,Cao; Yingjun,37,0,40,3
1649767054420,CSE 101,A01,084011,Staff,25,0,40,15
1649767060444,CSE 141,A01,083374,Eldon; John,46,0,75,29
1649767066479,CSE 141L,A01,083376,Eldon; John,48,0,75,27
1649767072505,CSE 175,A01,084013,Kumar; Rakesh,25,0,25,0
1649767078539,ECE 5,A01,084049,Morris; Karcher William,19,0,20,1
1649767084565,ECE 100,A01,084051,Baghdadchi; Saharnaz,18,0,20,2
1649767084565,ECE 100,A02,091916,Baghdadchi; Saharnaz,20,0,20,0
1649767090592,ECE 101,A01,084053,Baghdadchi; Saharnaz,33,0,37,4
1649767090592,ECE 101,A02,084054,Baghdadchi; Saharnaz,37,0,37,0
1649767096624,ECE 107,A01,083390,Staff,36,0,40,4
1649767102653,ECE 148,A01,084056,Silberman; Jack,10,0,12,2
1649767108681,ECE 180,A00,083391,Abi Samra; Nicholas Camill,28,0,30,2
1649767108681,ECE 180,B00,083392,Abi Samra; Nicholas Camill,28,0,30,2
1649767114708,MATH 10B,A01,084110,Staff,26,0,30,4
1649767114708,MATH 10B,A02,084111,Staff,30,0,30,0
1649767114708,MATH 10B,A03,084112,Staff,30,0,30,0
1649767120735,MATH 10C,A01,083443,Staff,28,0,30,2
1649767120735,MATH 10C,A02,083444,Staff,27,0,30,3
1649767120735,MATH 10C,B01,084114,Staff,29,0,30,1
1649767120735,MATH 10C,B02,084115,Staff,30,0,30,0
1649767126762,MATH 18,A01,084117,Harel; Guershon,28,0,30,2
1649767126762,MATH 18,A02,084119,Harel; Guershon,29,0,30,1
1649767126762,MATH 18,A03,084120,Harel; Guershon,30,0,30,0
1649767126762,MATH 18,A04,084121,Harel; Guershon,30,0,30,0
1649767132796,MATH 20B,A01,084124,Um; Ko Woon,34,0,35,1
1649767132796,MATH 20B,B01,084126,Um; Ko Woon,35,0,35,0
1649767138824,MATH 20C,A01,083446,Hammock; Frances H,29,0,30,1
1649767138824,MATH 20C,A02,083447,Hammock; Frances H,30,0,30,0
1649767138824,MATH 20C,A03,083448,Hammock; Frances H,30,0,30,0
1649767138824,MATH 20C,A04,083449,Hammock; Frances H,30,0,30,0
1649767138824,MATH 20C,B01,083451,Hammock; Frances H,30,0,30,0
1649767138824,MATH 20C,B02,083452,Hammock; Frances H,30,0,30,0
1649767138824,MATH 20C,B03,083453,Hammock; Frances H,30,0,30,0
1649767138824,MATH 20C,B04,083454,Hammock; Frances H,30,0,30,0
1649767144856,MATH 20D,A01,084128,Staff,30,0,30,0
1649767144856,MATH 20D,A02,084129,Staff,30,0,30,0
1649767144856,MATH 20D,A03,084130,Staff,29,0,30,1
1649767144856,MATH 20D,B01,084133,Staff,30,0,30,0
1649767144856,MATH 20D,B02,084134,Staff,30,0,30,0
1649767144856,MATH 20D,B03,084135,Staff,30,0,30,0
1649767150891,MATH 20E,A01,084138,Staff,30,0,30,0
1649767150891,MATH 20E,A02,084139,Staff,29,0,30,1
1649767150891,MATH 20E,A03,084140,Staff,30,0,30,0
1649767150891,MATH 20E,A04,084141,Staff,30,0,30,0
1649767156915,MATH 102,A01,084143,Harel; Guershon,27,0,30,3
1649767156915,MATH 102,A02,084144,Harel; Guershon,29,0,30,1
1649767162945,MATH 103B,A01,083456,Staff,22,0,30,8
1649767162945,MATH 103B,A02,083457,Staff,28,0,30,2
1649767168972,MATH 109,A01,084146,Salehi Golsefidy; Alireza,30,0,30,0
1649767168972,MATH 109,A02,084147,Salehi Golsefidy; Alireza,29,0,30,1
1649767175003,MATH 120A,A01,085445,Eggers; John Dietrich,32,0,35,3
1649767175003,MATH 120A,A02,085446,Eggers; John Dietrich,34,0,35,1
1649767181029,MATH 142B,A01,084149,Verstraete; Jacques Allan,26,0,30,4
1649767181029,MATH 142B,A02,084150,Verstraete; Jacques Allan,28,0,30,2
1649767187061,MATH 170A,A01,083459,Nie; Jiawang,22,0,30,8
1649767187061,MATH 170A,A02,083460,Nie; Jiawang,28,0,30,2
1649767187061,MATH 170A,A03,083461,Nie; Jiawang,30,0,30,0
1649767193088,MATH 193B,A01,083463,Staff,25,0,30,5
1649767193088,MATH 193B,A02,083464,Staff,29,0,30,1
1649767193088,MATH 193B,A03,083465,Staff,30,0,30,0
1649767199162,COGS 2,A01,083966,Boyle; Mary E. T.,28,0,30,2
1649767205187,COGS 9,A01,083968,Staff,59,0,60,1
1649767211215,COGS 14B,A01,083970,Staff,50,0,50,0
1649767217243,COGS 100,A01,083972,Staff,58,0,60,2
1649767229294,COGS 101C,A01,083976,Staff,30,0,30,0
1649767235320,COGS 102A,A01,083978,Johnson; Christine M.,30,0,30,0
1649767241344,COGS 107B,A01,083980,Staff,46,0,50,4
1649767247367,COGS 115,A01,083982,Staff,27,0,30,3
1649767253390,COGS 118B,A01,083367,Staff,26,0,40,14
1649767259423,COGS 172,A01,083984,Provenzano; Emily Kara,25,0,30,5
1649767265454,COGS 177,A00,083368,Staff,22,0,30,8
1649767271486,COGS 186,A01,083986,Staff,31,0,40,9
1649767277512,COGS 187A,A01,083988,Boyle; Mary E. T.,56,0,60,4
1649767283538,CSE 8A,A50,084003,Miranda; Gregory Joseph,13,0,15,2
1649767289564,CSE 11,A01,084005,Miranda; Gregory Joseph,52,0,55,3
1649767295592,CSE 20,A01,084007,Staff,17,0,20,3
1649767301618,CSE 21,A01,084009,Staff,50,0,50,0
1649767307645,CSE 30,A01,083370,Cao; Yingjun,38,0,40,2
1649767313679,CSE 100,A01,083372,Cao; Yingjun,37,0,40,3
1649767319706,CSE 101,A01,084011,Staff,25,0,40,15
1649767325732,CSE 141,A01,083374,Eldon; John,46,0,75,29
1649767331761,CSE 141L,A01,083376,Eldon; John,48,0,75,27
1649767337790,CSE 175,A01,084013,Kumar; Rakesh,25,0,25,0
1649767343822,ECE 5,A01,084049,Morris; Karcher William,19,0,20,1
1649767349849,ECE 100,A01,084051,Baghdadchi; Saharnaz,18,0,20,2
1649767349849,ECE 100,A02,091916,Baghdadchi; Saharnaz,20,0,20,0
1649767355878,ECE 101,A01,084053,Baghdadchi; Saharnaz,33,0,37,4
1649767355878,ECE 101,A02,084054,Baghdadchi; Saharnaz,37,0,37,0
1649767361905,ECE 107,A01,083390,Staff,36,0,40,4
1649767368019,ECE 148,A01,084056,Silberman; Jack,10,0,12,2
1649767374051,ECE 180,A00,083391,Abi Samra; Nicholas Camill,28,0,30,2
1649767374051,ECE 180,B00,083392,Abi Samra; Nicholas Camill,28,0,30,2
1649767380106,MATH 10B,A01,084110,Staff,26,0,30,4
1649767380106,MATH 10B,A02,084111,Staff,30,0,30,0
1649767380106,MATH 10B,A03,084112,Staff,30,0,30,0
1649767386132,MATH 10C,A01,083443,Staff,28,0,30,2
1649767386132,MATH 10C,A02,083444,Staff,27,0,30,3
1649767386132,MATH 10C,B01,084114,Staff,29,0,30,1
1649767386132,MATH 10C,B02,084115,Staff,30,0,30,0
1649767392164,MATH 18,A01,084117,Harel; Guershon,28,0,30,2
1649767392164,MATH 18,A02,084119,Harel; Guershon,29,0,30,1
1649767392164,MATH 18,A03,084120,Harel; Guershon,30,0,30,0
1649767392164,MATH 18,A04,084121,Harel; Guershon,30,0,30,0
1649767398191,MATH 20B,A01,084124,Um; Ko Woon,34,0,35,1
1649767398191,MATH 20B,B01,084126,Um; Ko Woon,35,0,35,0
1649767404218,MATH 20C,A01,083446,Hammock; Frances H,29,0,30,1
1649767404218,MATH 20C,A02,083447,Hammock; Frances H,30,0,30,0
1649767404218,MATH 20C,A03,083448,Hammock; Frances H,30,0,30,0
1649767404218,MATH 20C,A04,083449,Hammock; Frances H,30,0,30,0
1649767404218,MATH 20C,B01,083451,Hammock; Frances H,30,0,30,0
1649767404218,MATH 20C,B02,083452,Hammock; Frances H,30,0,30,0
1649767404218,MATH 20C,B03,083453,Hammock; Frances H,30,0,30,0
1649767404218,MATH 20C,B04,083454,Hammock; Frances H,30,0,30,0
1649767410251,MATH 20D,A01,084128,Staff,30,0,30,0
1649767410251,MATH 20D,A02,084129,Staff,30,0,30,0
1649767410251,MATH 20D,A03,084130,Staff,29,0,30,1
1649767410251,MATH 20D,B01,084133,Staff,30,0,30,0
1649767410251,MATH 20D,B02,084134,Staff,30,0,30,0
1649767410251,MATH 20D,B03,084135,Staff,30,0,30,0
1649767416281,MATH 20E,A01,084138,Staff,30,0,30,0
1649767416281,MATH 20E,A02,084139,Staff,29,0,30,1
1649767416281,MATH 20E,A03,084140,Staff,30,0,30,0
1649767416281,MATH 20E,A04,084141,Staff,30,0,30,0
1649767422317,MATH 102,A01,084143,Harel; Guershon,27,0,30,3
1649767422317,MATH 102,A02,084144,Harel; Guershon,29,0,30,1
1649767428343,MATH 103B,A01,083456,Staff,22,0,30,8
1649767428343,MATH 103B,A02,083457,Staff,28,0,30,2
1649767434377,MATH 109,A01,084146,Salehi Golsefidy; Alireza,30,0,30,0
1649767434377,MATH 109,A02,084147,Salehi Golsefidy; Alireza,29,0,30,1
1649767440404,MATH 120A,A01,085445,Eggers; John Dietrich,32,0,35,3
1649767440404,MATH 120A,A02,085446,Eggers; John Dietrich,34,0,35,1
1649767446434,MATH 142B,A01,084149,Verstraete; Jacques Allan,26,0,30,4
1649767446434,MATH 142B,A02,084150,Verstraete; Jacques Allan,28,0,30,2
1649767452465,MATH 170A,A01,083459,Nie; Jiawang,22,0,30,8
1649767452465,MATH 170A,A02,083460,Nie; Jiawang,28,0,30,2
1649767452465,MATH 170A,A03,083461,Nie; Jiawang,30,0,30,0
1649767458493,MATH 193B,A01,083463,Staff,25,0,30,5
1649767458493,MATH 193B,A02,083464,Staff,29,0,30,1
1649767458493,MATH 193B,A03,083465,Staff,30,0,30,0
1649767464560,COGS 2,A01,083966,Boyle; Mary E. T.,28,0,30,2
1649767470597,COGS 9,A01,083968,Staff,59,0,60,1
1649767476622,COGS 14B,A01,083970,Staff,50,0,50,0
1649767482654,COGS 100,A01,083972,Staff,58,0,60,2
1649767494706,COGS 101C,A01,083976,Staff,30,0,30,0
1649767500732,COGS 102A,A01,083978,Johnson; Christine M.,30,0,30,0
1649767506759,COGS 107B,A01,083980,Staff,46,0,50,4
1649767512783,COGS 115,A01,083982,Staff,27,0,30,3
1649767518812,COGS 118B,A01,083367,Staff,26,0,40,14
1649767524839,COGS 172,A01,083984,Provenzano; Emily Kara,25,0,30,5
1649767530863,COGS 177,A00,083368,Staff,22,0,30,8
1649767536897,COGS 186,A01,083986,Staff,31,0,40,9
1649767542934,COGS 187A,A01,083988,Boyle; Mary E. T.,56,0,60,4
1649767548964,CSE 8A,A50,084003,Miranda; Gregory Joseph,13,0,15,2
1649767554994,CSE 11,A01,084005,Miranda; Gregory Joseph,52,0,55,3
1649767561019,CSE 20,A01,084007,Staff,17,0,20,3
1649767567050,CSE 21,A01,084009,Staff,50,0,50,0
1649767573080,CSE 30,A01,083370,Cao; Yingjun,38,0,40,2
1649767579104,CSE 100,A01,083372,Cao; Yingjun,37,0,40,3
1649767585132,CSE 101,A01,084011,Staff,25,0,40,15
1649767591158,CSE 141,A01,083374,Eldon; John,46,0,75,29
1649767597192,CSE 141L,A01,083376,Eldon; John,48,0,75,27
1649767603226,CSE 175,A01,084013,Kumar; Rakesh,25,0,25,0
1649767609254,ECE 5,A01,084049,Morris; Karcher William,19,0,20,1
1649767615293,ECE 100,A01,084051,Baghdadchi; Saharnaz,18,0,20,2
1649767615293,ECE 100,A02,091916,Baghdadchi; Saharnaz,20,0,20,0
1649767621320,ECE 101,A01,084053,Baghdadchi; Saharnaz,33,0,37,4
1649767621320,ECE 101,A02,084054,Baghdadchi; Saharnaz,37,0,37,0
1649767627346,ECE 107,A01,083390,Staff,36,0,40,4
1649767633373,ECE 148,A01,084056,Silberman; Jack,10,0,12,2
1649767639405,ECE 180,A00,083391,Abi Samra; Nicholas Camill,28,0,30,2
1649767639405,ECE 180,B00,083392,Abi Samra; Nicholas Camill,28,0,30,2
1649767645439,MATH 10B,A01,084110,Staff,26,0,30,4
1649767645439,MATH 10B,A02,084111,Staff,30,0,30,0
1649767645439,MATH 10B,A03,084112,Staff,30,0,30,0
1649767651464,MATH 10C,A01,083443,Staff,28,0,30,2
1649767651464,MATH 10C,A02,083444,Staff,27,0,30,3
1649767651464,MATH 10C,B01,084114,Staff,29,0,30,1
1649767651464,MATH 10C,B02,084115,Staff,30,0,30,0
1649767657497,MATH 18,A01,084117,Harel; Guershon,28,0,30,2
1649767657497,MATH 18,A02,084119,Harel; Guershon,29,0,30,1
1649767657497,MATH 18,A03,084120,Harel; Guershon,30,0,30,0
1649767657497,MATH 18,A04,084121,Harel; Guershon,30,0,30,0
1649767663523,MATH 20B,A01,084124,Um; Ko Woon,34,0,35,1
1649767663523,MATH 20B,B01,084126,Um; Ko Woon,35,0,35,0
1649767669553,MATH 20C,A01,083446,Hammock; Frances H,29,0,30,1
1649767669553,MATH 20C,A02,083447,Hammock; Frances H,30,0,30,0
1649767669553,MATH 20C,A03,083448,Hammock; Frances H,30,0,30,0
1649767669553,MATH 20C,A04,083449,Hammock; Frances H,30,0,30,0
1649767669553,MATH 20C,B01,083451,Hammock; Frances H,30,0,30,0
1649767669553,MATH 20C,B02,083452,Hammock; Frances H,30,0,30,0
1649767669553,MATH 20C,B03,083453,Hammock; Frances H,30,0,30,0
1649767669553,MATH 20C,B04,083454,Hammock; Frances H,30,0,30,0
1649767675596,MATH 20D,A01,084128,Staff,30,0,30,0
1649767675596,MATH 20D,A02,084129,Staff,30,0,30,0
1649767675596,MATH 20D,A03,084130,Staff,29,0,30,1
1649767675596,MATH 20D,B01,084133,Staff,30,0,30,0
1649767675596,MATH 20D,B02,084134,Staff,30,0,30,0
1649767675596,MATH 20D,B03,084135,Staff,30,0,30,0
1649767681628,MATH 20E,A01,084138,Staff,30,0,30,0
1649767681628,MATH 20E,A02,084139,Staff,29,0,30,1
1649767681628,MATH 20E,A03,084140,Staff,30,0,30,0
1649767681628,MATH 20E,A04,084141,Staff,30,0,30,0
1649767687660,MATH 102,A01,084143,Harel; Guershon,27,0,30,3
1649767687660,MATH 102,A02,084144,Harel; Guershon,29,0,30,1
1649767693687,MATH 103B,A01,083456,Staff,22,0,30,8
1649767693687,MATH 103B,A02,083457,Staff,28,0,30,2
1649767699721,MATH 109,A01,084146,Salehi Golsefidy; Alireza,30,0,30,0
1649767699721,MATH 109,A02,084147,Salehi Golsefidy; Alireza,29,0,30,1
1649767705754,MATH 120A,A01,085445,Eggers; John Dietrich,32,0,35,3
1649767705754,MATH 120A,A02,085446,Eggers; John Dietrich,34,0,35,1
1649767711782,MATH 142B,A01,084149,Verstraete; Jacques Allan,26,0,30,4
1649767711782,MATH 142B,A02,084150,Verstraete; Jacques Allan,28,0,30,2
1649767717808,MATH 170A,A01,083459,Nie; Jiawang,22,0,30,8
1649767717808,MATH 170A,A02,083460,Nie; Jiawang,28,0,30,2
1649767717808,MATH 170A,A03,083461,Nie; Jiawang,30,0,30,0
1649767723840,MATH 193B,A01,083463,Staff,25,0,30,5
1649767723840,MATH 193B,A02,083464,Staff,29,0,30,1
1649767723840,MATH 193B,A03,083465,Staff,30,0,30,0
1649767729943,COGS 2,A01,083966,Boyle; Mary E. T.,28,0,30,2
1649767735981,COGS 9,A01,083968,Staff,59,0,60,1
1649767742012,COGS 14B,A01,083970,Staff,50,0,50,0
1649767748050,COGS 100,A01,083972,Staff,58,0,60,2
1649767760104,COGS 101C,A01,083976,Staff,30,0,30,0
1649767766133,COGS 102A,A01,083978,Johnson; Christine M.,30,0,30,0
1649767772165,COGS 107B,A01,083980,Staff,46,0,50,4
1649767778196,COGS 115,A01,083982,Staff,27,0,30,3
1649767784233,COGS 118B,A01,083367,Staff,26,0,40,14
1649767790266,COGS 172,A01,083984,Provenzano; Emily Kara,25,0,30,5
1649767796295,COGS 177,A00,083368,Staff,22,0,30,8
1649767802325,COGS 186,A01,083986,Staff,31,0,40,9
1649767808349,COGS 187A,A01,083988,Boyle; Mary E. T.,56,0,60,4
1649767814385,CSE 8A,A50,084003,Miranda; Gregory Joseph,13,0,15,2
1649767820415,CSE 11,A01,084005,Miranda; Gregory Joseph,52,0,55,3
1649767826448,CSE 20,A01,084007,Staff,17,0,20,3
1649767832481,CSE 21,A01,084009,Staff,50,0,50,0
1649767838505,CSE 30,A01,083370,Cao; Yingjun,38,0,40,2
1649767844529,CSE 100,A01,083372,Cao; Yingjun,37,0,40,3
1649767850557,CSE 101,A01,084011,Staff,25,0,40,15
1649767856584,CSE 141,A01,083374,Eldon; John,46,0,75,29
1649767862614,CSE 141L,A01,083376,Eldon; John,48,0,75,27
1649767868656,CSE 175,A01,084013,Kumar; Rakesh,25,0,25,0
1649767874685,ECE 5,A01,084049,Morris; Karcher William,19,0,20,1
1649767880712,ECE 100,A01,084051,Baghdadchi; Saharnaz,18,0,20,2
1649767880712,ECE 100,A02,091916,Baghdadchi; Saharnaz,20,0,20,0
1649767886738,ECE 101,A01,084053,Baghdadchi; Saharnaz,33,0,37,4
1649767886738,ECE 101,A02,084054,Baghdadchi; Saharnaz,37,0,37,0
1649767892771,ECE 107,A01,083390,Staff,36,0,40,4
1649767898804,ECE 148,A01,084056,Silberman; Jack,10,0,12,2
1649767904835,ECE 180,A00,083391,Abi Samra; Nicholas Camill,28,0,30,2
1649767904835,ECE 180,B00,083392,Abi Samra; Nicholas Camill,28,0,30,2
1649767910883,MATH 10B,A01,084110,Staff,26,0,30,4
1649767910883,MATH 10B,A02,084111,Staff,30,0,30,0
1649767910883,MATH 10B,A03,084112,Staff,30,0,30,0
1649767916910,MATH 10C,A01,083443,Staff,28,0,30,2
1649767916910,MATH 10C,A02,083444,Staff,27,0,30,3
1649767916910,MATH 10C,B01,084114,Staff,29,0,30,1
1649767916910,MATH 10C,B02,084115,Staff,30,0,30,0
1649767922946,MATH 18,A01,084117,Harel; Guershon,28,0,30,2
1649767922946,MATH 18,A02,084119,Harel; Guershon,29,0,30,1
1649767922946,MATH 18,A03,084120,Harel; Guershon,30,0,30,0
1649767922946,MATH 18,A04,084121,Harel; Guershon,30,0,30,0
1649767928977,MATH 20B,A01,084124,Um; Ko Woon,34,0,35,1
1649767928977,MATH 20B,B01,084126,Um; Ko Woon,35,0,35,0
1649767935012,MATH 20C,A01,083446,Hammock; Frances H,29,0,30,1
1649767935012,MATH 20C,A02,083447,Hammock; Frances H,30,0,30,0
1649767935012,MATH 20C,A03,083448,Hammock; Frances H,30,0,30,0
1649767935012,MATH 20C,A04,083449,Hammock; Frances H,30,0,30,0
1649767935012,MATH 20C,B01,083451,Hammock; Frances H,30,0,30,0
1649767935012,MATH 20C,B02,083452,Hammock; Frances H,30,0,30,0
1649767935012,MATH 20C,B03,083453,Hammock; Frances H,30,0,30,0
1649767935012,MATH 20C,B04,083454,Hammock; Frances H,30,0,30,0
1649767941038,MATH 20D,A01,084128,Staff,30,0,30,0
1649767941038,MATH 20D,A02,084129,Staff,30,0,30,0
1649767941038,MATH 20D,A03,084130,Staff,29,0,30,1
1649767941038,MATH 20D,B01,084133,Staff,30,0,30,0
1649767941038,MATH 20D,B02,084134,Staff,30,0,30,0
1649767941038,MATH 20D,B03,084135,Staff,30,0,30,0
1649767947063,MATH 20E,A01,084138,Staff,30,0,30,0
1649767947063,MATH 20E,A02,084139,Staff,29,0,30,1
1649767947063,MATH 20E,A03,084140,Staff,30,0,30,0
1649767947063,MATH 20E,A04,084141,Staff,30,0,30,0
1649767953087,MATH 102,A01,084143,Harel; Guershon,27,0,30,3
1649767953087,MATH 102,A02,084144,Harel; Guershon,29,0,30,1
1649767959118,MATH 103B,A01,083456,Staff,22,0,30,8
1649767959118,MATH 103B,A02,083457,Staff,28,0,30,2
1649767965241,MATH 109,A01,084146,Salehi Golsefidy; Alireza,30,0,30,0
1649767965241,MATH 109,A02,084147,Salehi Golsefidy; Alireza,29,0,30,1
1649767971271,MATH 120A,A01,085445,Eggers; John Dietrich,32,0,35,3
1649767971271,MATH 120A,A02,085446,Eggers; John Dietrich,34,0,35,1
1649767977297,MATH 142B,A01,084149,Verstraete; Jacques Allan,26,0,30,4
1649767977297,MATH 142B,A02,084150,Verstraete; Jacques Allan,28,0,30,2
1649767983323,MATH 170A,A01,083459,Nie; Jiawang,22,0,30,8
1649767983323,MATH 170A,A02,083460,Nie; Jiawang,28,0,30,2
1649767983323,MATH 170A,A03,083461,Nie; Jiawang,30,0,30,0
1649767989352,MATH 193B,A01,083463,Staff,25,0,30,5
1649767989352,MATH 193B,A02,083464,Staff,29,0,30,1
1649767989352,MATH 193B,A03,083465,Staff,30,0,30,0
1649767995413,COGS 2,A01,083966,Boyle; Mary E. T.,28,0,30,2
1649768001439,COGS 9,A01,083968,Staff,59,0,60,1
1649768007466,COGS 14B,A01,083970,Staff,50,0,50,0
1649768013498,COGS 100,A01,083972,Staff,58,0,60,2
1649768025552,COGS 101C,A01,083976,Staff,30,0,30,0
1649768031578,COGS 102A,A01,083978,Johnson; Christine M.,30,0,30,0
1649768037607,COGS 107B,A01,083980,Staff,46,0,50,4
1649768043641,COGS 115,A01,083982,Staff,27,0,30,3
1649768049669,COGS 118B,A01,083367,Staff,26,0,40,14
1649768055699,COGS 172,A01,083984,Provenzano; Emily Kara,25,0,30,5
1649768061729,COGS 177,A00,083368,Staff,22,0,30,8
1649768067754,COGS 186,A01,083986,Staff,31,0,40,9
1649768073786,COGS 187A,A01,083988,Boyle; Mary E. T.,56,0,60,4
1649768079814,CSE 8A,A50,084003,Miranda; Gregory Joseph,13,0,15,2
1649768085844,CSE 11,A01,084005,Miranda; Gregory Joseph,52,0,55,3
1649768091869,CSE 20,A01,084007,Staff,17,0,20,3
1649768097894,CSE 21,A01,084009,Staff,50,0,50,0
1649768103929,CSE 30,A01,083370,Cao; Yingjun,38,0,40,2
1649768109959,CSE 100,A01,083372,Cao; Yingjun,37,0,40,3
1649768115985,CSE 101,A01,084011,Staff,25,0,40,15
1649768122010,CSE 141,A01,083374,Eldon; John,46,0,75,29
1649768128037,CSE 141L,A01,083376,Eldon; John,48,0,75,27
1649768134065,CSE 175,A01,084013,Kumar; Rakesh,25,0,25,0
1649768140092,ECE 5,A01,084049,Morris; Karcher William,19,0,20,1
1649768146120,ECE 100,A01,084051,Baghdadchi; Saharnaz,18,0,20,2
1649768146120,ECE 100,A02,091916,Baghdadchi; Saharnaz,20,0,20,0
1649768152145,ECE 101,A01,084053,Baghdadchi; Saharnaz,33,0,37,4
1649768152145,ECE 101,A02,084054,Baghdadchi; Saharnaz,37,0,37,0
1649768158172,ECE 107,A01,083390,Staff,36,0,40,4
1649768164199,ECE 148,A01,084056,Silberman; Jack,10,0,12,2
1649768170235,ECE 180,A00,083391,Abi Samra; Nicholas Camill,28,0,30,2
1649768170235,ECE 180,B00,083392,Abi Samra; Nicholas Camill,28,0,30,2
1649768176268,MATH 10B,A01,084110,Staff,26,0,30,4
1649768176268,MATH 10B,A02,084111,Staff,30,0,30,0
1649768176268,MATH 10B,A03,084112,Staff,30,0,30,0
1649768182293,MATH 10C,A01,083443,Staff,28,0,30,2
1649768182293,MATH 10C,A02,083444,Staff,27,0,30,3
1649768182293,MATH 10C,B01,084114,Staff,29,0,30,1
1649768182293,MATH 10C,B02,084115,Staff,30,0,30,0
1649768188319,MATH 18,A01,084117,Harel; Guershon,28,0,30,2
1649768188319,MATH 18,A02,084119,Harel; Guershon,29,0,30,1
1649768188319,MATH 18,A03,084120,Harel; Guershon,30,0,30,0
1649768188319,MATH 18,A04,084121,Harel; Guershon,30,0,30,0
1649768194346,MATH 20B,A01,084124,Um; Ko Woon,34,0,35,1
1649768194346,MATH 20B,B01,084126,Um; Ko Woon,35,0,35,0
1649768200373,MATH 20C,A01,083446,Hammock; Frances H,29,0,30,1
1649768200373,MATH 20C,A02,083447,Hammock; Frances H,30,0,30,0
1649768200373,MATH 20C,A03,083448,Hammock; Frances H,30,0,30,0
1649768200373,MATH 20C,A04,083449,Hammock; Frances H,30,0,30,0
1649768200373,MATH 20C,B01,083451,Hammock; Frances H,30,0,30,0
1649768200373,MATH 20C,B02,083452,Hammock; Frances H,30,0,30,0
1649768200373,MATH 20C,B03,083453,Hammock; Frances H,30,0,30,0
1649768200373,MATH 20C,B04,083454,Hammock; Frances H,30,0,30,0
1649768206399,MATH 20D,A01,084128,Staff,30,0,30,0
1649768206399,MATH 20D,A02,084129,Staff,30,0,30,0
1649768206399,MATH 20D,A03,084130,Staff,29,0,30,1
1649768206399,MATH 20D,B01,084133,Staff,30,0,30,0
1649768206399,MATH 20D,B02,084134,Staff,30,0,30,0
1649768206399,MATH 20D,B03,084135,Staff,30,0,30,0
1649768212430,MATH 20E,A01,084138,Staff,30,0,30,0
1649768212430,MATH 20E,A02,084139,Staff,29,0,30,1
1649768212430,MATH 20E,A03,084140,Staff,30,0,30,0
1649768212430,MATH 20E,A04,084141,Staff,30,0,30,0
1649768218458,MATH 102,A01,084143,Harel; Guershon,27,0,30,3
1649768218458,MATH 102,A02,084144,Harel; Guershon,29,0,30,1
1649768224488,MATH 103B,A01,083456,Staff,22,0,30,8
1649768224488,MATH 103B,A02,083457,Staff,28,0,30,2
1649768230514,MATH 109,A01,084146,Salehi Golsefidy; Alireza,30,0,30,0
1649768230514,MATH 109,A02,084147,Salehi Golsefidy; Alireza,29,0,30,1
1649768236537,MATH 120A,A01,085445,Eggers; John Dietrich,32,0,35,3
1649768236537,MATH 120A,A02,085446,Eggers; John Dietrich,34,0,35,1
1649768242564,MATH 142B,A01,084149,Verstraete; Jacques Allan,26,0,30,4
1649768242564,MATH 142B,A02,084150,Verstraete; Jacques Allan,28,0,30,2
1649768248592,MATH 170A,A01,083459,Nie; Jiawang,22,0,30,8
1649768248592,MATH 170A,A02,083460,Nie; Jiawang,28,0,30,2
1649768248592,MATH 170A,A03,083461,Nie; Jiawang,30,0,30,0
1649768254618,MATH 193B,A01,083463,Staff,25,0,30,5
1649768254618,MATH 193B,A02,083464,Staff,29,0,30,1
1649768254618,MATH 193B,A03,083465,Staff,30,0,30,0
1649768260682,COGS 2,A01,083966,Boyle; Mary E. T.,28,0,30,2
1649768266706,COGS 9,A01,083968,Staff,59,0,60,1
1649768272736,COGS 14B,A01,083970,Staff,50,0,50,0
1649768278764,COGS 100,A01,083972,Staff,58,0,60,2
1649768290817,COGS 101C,A01,083976,Staff,30,0,30,0
1649768296846,COGS 102A,A01,083978,Johnson; Christine M.,30,0,30,0
1649768302872,COGS 107B,A01,083980,Staff,46,0,50,4
1649768308900,COGS 115,A01,083982,Staff,27,0,30,3
1649768314929,COGS 118B,A01,083367,Staff,26,0,40,14
1649768320956,COGS 172,A01,083984,Provenzano; Emily Kara,25,0,30,5
1649768326984,COGS 177,A00,083368,Staff,22,0,30,8
1649768333010,COGS 186,A01,083986,Staff,31,0,40,9
1649768339035,COGS 187A,A01,083988,Boyle; Mary E. T.,56,0,60,4
1649768345067,CSE 8A,A50,084003,Miranda; Gregory Joseph,13,0,15,2
1649768351096,CSE 11,A01,084005,Miranda; Gregory Joseph,52,0,55,3
1649768357126,CSE 20,A01,084007,Staff,17,0,20,3
1649768363155,CSE 21,A01,084009,Staff,50,0,50,0
1649768369185,CSE 30,A01,083370,Cao; Yingjun,38,0,40,2
1649768375213,CSE 100,A01,083372,Cao; Yingjun,37,0,40,3
1649768381240,CSE 101,A01,084011,Staff,25,0,40,15
1649768387263,CSE 141,A01,083374,Eldon; John,46,0,75,29
1649768393295,CSE 141L,A01,083376,Eldon; John,48,0,75,27
1649768399331,CSE 175,A01,084013,Kumar; Rakesh,25,0,25,0
1649768405356,ECE 5,A01,084049,Morris; Karcher William,19,0,20,1
1649768411388,ECE 100,A01,084051,Baghdadchi; Saharnaz,18,0,20,2
1649768411388,ECE 100,A02,091916,Baghdadchi; Saharnaz,20,0,20,0
1649768417422,ECE 101,A01,084053,Baghdadchi; Saharnaz,33,0,37,4
1649768417422,ECE 101,A02,084054,Baghdadchi; Saharnaz,37,0,37,0
1649768423450,ECE 107,A01,083390,Staff,36,0,40,4
1649768429480,ECE 148,A01,084056,Silberman; Jack,10,0,12,2
1649768435503,ECE 180,A00,083391,Abi Samra; Nicholas Camill,28,0,30,2
1649768435503,ECE 180,B00,083392,Abi Samra; Nicholas Camill,28,0,30,2
1649768441531,MATH 10B,A01,084110,Staff,26,0,30,4
1649768441531,MATH 10B,A02,084111,Staff,30,0,30,0
1649768441531,MATH 10B,A03,084112,Staff,30,0,30,0
1649768447558,MATH 10C,A01,083443,Staff,28,0,30,2
1649768447558,MATH 10C,A02,083444,Staff,27,0,30,3
1649768447558,MATH 10C,B01,084114,Staff,29,0,30,1
1649768447558,MATH 10C,B02,084115,Staff,30,0,30,0
1649768453587,MATH 18,A01,084117,Harel; Guershon,28,0,30,2
1649768453587,MATH 18,A02,084119,Harel; Guershon,29,0,30,1
1649768453587,MATH 18,A03,084120,Harel; Guershon,30,0,30,0
1649768453587,MATH 18,A04,084121,Harel; Guershon,30,0,30,0
1649768459613,MATH 20B,A01,084124,Um; Ko Woon,34,0,35,1
1649768459613,MATH 20B,B01,084126,Um; Ko Woon,35,0,35,0
1649768465641,MATH 20C,A01,083446,Hammock; Frances H,29,0,30,1
1649768465641,MATH 20C,A02,083447,Hammock; Frances H,30,0,30,0
1649768465641,MATH 20C,A03,083448,Hammock; Frances H,30,0,30,0
1649768465641,MATH 20C,A04,083449,Hammock; Frances H,30,0,30,0
1649768465641,MATH 20C,B01,083451,Hammock; Frances H,30,0,30,0
1649768465641,MATH 20C,B02,083452,Hammock; Frances H,30,0,30,0
1649768465641,MATH 20C,B03,083453,Hammock; Frances H,30,0,30,0
1649768465641,MATH 20C,B04,083454,Hammock; Frances H,30,0,30,0
1649768471676,MATH 20D,A01,084128,Staff,30,0,30,0
1649768471676,MATH 20D,A02,084129,Staff,30,0,30,0
1649768471676,MATH 20D,A03,084130,Staff,29,0,30,1
1649768471676,MATH 20D,B01,084133,Staff,30,0,30,0
1649768471676,MATH 20D,B02,084134,Staff,30,0,30,0
1649768471676,MATH 20D,B03,084135,Staff,30,0,30,0
1649768477708,MATH 20E,A01,084138,Staff,30,0,30,0
1649768477708,MATH 20E,A02,084139,Staff,29,0,30,1
1649768477708,MATH 20E,A03,084140,Staff,30,0,30,0
1649768477708,MATH 20E,A04,084141,Staff,30,0,30,0
1649768483733,MATH 102,A01,084143,Harel; Guershon,27,0,30,3
1649768483733,MATH 102,A02,084144,Harel; Guershon,29,0,30,1
1649768489763,MATH 103B,A01,083456,Staff,22,0,30,8
1649768489763,MATH 103B,A02,083457,Staff,28,0,30,2
1649768495791,MATH 109,A01,084146,Salehi Golsefidy; Alireza,30,0,30,0
1649768495791,MATH 109,A02,084147,Salehi Golsefidy; Alireza,29,0,30,1
1649768501822,MATH 120A,A01,085445,Eggers; John Dietrich,32,0,35,3
1649768501822,MATH 120A,A02,085446,Eggers; John Dietrich,34,0,35,1
1649768507851,MATH 142B,A01,084149,Verstraete; Jacques Allan,26,0,30,4
1649768507851,MATH 142B,A02,084150,Verstraete; Jacques Allan,28,0,30,2
1649768513877,MATH 170A,A01,083459,Nie; Jiawang,22,0,30,8
1649768513877,MATH 170A,A02,083460,Nie; Jiawang,28,0,30,2
1649768513877,MATH 170A,A03,083461,Nie; Jiawang,30,0,30,0
1649768519902,MATH 193B,A01,083463,Staff,25,0,30,5
1649768519902,MATH 193B,A02,083464,Staff,29,0,30,1
1649768519902,MATH 193B,A03,083465,Staff,30,0,30,0
1649768525976,COGS 2,A01,083966,Boyle; Mary E. T.,28,0,30,2
1649768532002,COGS 9,A01,083968,Staff,59,0,60,1
1649768538027,COGS 14B,A01,083970,Staff,50,0,50,0
1649768544054,COGS 100,A01,083972,Staff,58,0,60,2
1649768556195,COGS 101C,A01,083976,Staff,30,0,30,0
1649768562225,COGS 102A,A01,083978,Johnson; Christine M.,30,0,30,0
1649768568252,COGS 107B,A01,083980,Staff,46,0,50,4
1649768574283,COGS 115,A01,083982,Staff,27,0,30,3
1649768580310,COGS 118B,A01,083367,Staff,26,0,40,14
1649768586336,COGS 172,A01,083984,Provenzano; Emily Kara,25,0,30,5
1649768592361,COGS 177,A00,083368,Staff,22,0,30,8
1649768598388,COGS 186,A01,083986,Staff,31,0,40,9
1649768604412,COGS 187A,A01,083988,Boyle; Mary E. T.,56,0,60,4
1649768610440,CSE 8A,A50,084003,Miranda; Gregory Joseph,13,0,15,2
1649768616464,CSE 11,A01,084005,Miranda; Gregory Joseph,52,0,55,3
1649768622491,CSE 20,A01,084007,Staff,17,0,20,3
1649768628520,CSE 21,A01,084009,Staff,50,0,50,0
1649768634544,CSE 30,A01,083370,Cao; Yingjun,38,0,40,2
1649768640579,CSE 100,A01,083372,Cao; Yingjun,37,0,40,3
1649768646611,CSE 101,A01,084011,Staff,25,0,40,15
1649768652637,CSE 141,A01,083374,Eldon; John,46,0,75,29
1649768658666,CSE 141L,A01,083376,Eldon; John,48,0,75,27
1649768664697,CSE 175,A01,084013,Kumar; Rakesh,25,0,25,0
1649768670722,ECE 5,A01,084049,Morris; Karcher William,19,0,20,1
1649768676748,ECE 100,A01,084051,Baghdadchi; Saharnaz,18,0,20,2
1649768676748,ECE 100,A02,091916,Baghdadchi; Saharnaz,20,0,20,0
1649768682781,ECE 101,A01,084053,Baghdadchi; Saharnaz,33,0,37,4
1649768682781,ECE 101,A02,084054,Baghdadchi; Saharnaz,37,0,37,0
1649768688807,ECE 107,A01,083390,Staff,36,0,40,4
1649768694832,ECE 148,A01,084056,Silberman; Jack,10,0,12,2
1649768700856,ECE 180,A00,083391,Abi Samra; Nicholas Camill,28,0,30,2
1649768700856,ECE 180,B00,083392,Abi Samra; Nicholas Camill,28,0,30,2
1649768706884,MATH 10B,A01,084110,Staff,26,0,30,4
1649768706884,MATH 10B,A02,084111,Staff,30,0,30,0
1649768706884,MATH 10B,A03,084112,Staff,30,0,30,0
1649768712911,MATH 10C,A01,083443,Staff,28,0,30,2
1649768712911,MATH 10C,A02,083444,Staff,27,0,30,3
1649768712911,MATH 10C,B01,084114,Staff,29,0,30,1
1649768712911,MATH 10C,B02,084115,Staff,30,0,30,0
1649768718936,MATH 18,A01,084117,Harel; Guershon,28,0,30,2
1649768718936,MATH 18,A02,084119,Harel; Guershon,29,0,30,1
1649768718936,MATH 18,A03,084120,Harel; Guershon,30,0,30,0
1649768718936,MATH 18,A04,084121,Harel; Guershon,30,0,30,0
1649768724969,MATH 20B,A01,084124,Um; Ko Woon,34,0,35,1
1649768724969,MATH 20B,B01,084126,Um; Ko Woon,35,0,35,0
1649768730996,MATH 20C,A01,083446,Hammock; Frances H,29,0,30,1
1649768730996,MATH 20C,A02,083447,Hammock; Frances H,30,0,30,0
1649768730996,MATH 20C,A03,083448,Hammock; Frances H,30,0,30,0
1649768730996,MATH 20C,A04,083449,Hammock; Frances H,30,0,30,0
1649768730996,MATH 20C,B01,083451,Hammock; Frances H,30,0,30,0
1649768730996,MATH 20C,B02,083452,Hammock; Frances H,30,0,30,0
1649768730996,MATH 20C,B03,083453,Hammock; Frances H,30,0,30,0
1649768730996,MATH 20C,B04,083454,Hammock; Frances H,30,0,30,0
1649768737020,MATH 20D,A01,084128,Staff,30,0,30,0
1649768737020,MATH 20D,A02,084129,Staff,30,0,30,0
1649768737020,MATH 20D,A03,084130,Staff,29,0,30,1
1649768737020,MATH 20D,B01,084133,Staff,30,0,30,0
1649768737020,MATH 20D,B02,084134,Staff,30,0,30,0
1649768737020,MATH 20D,B03,084135,Staff,30,0,30,0
1649768743049,MATH 20E,A01,084138,Staff,30,0,30,0
1649768743049,MATH 20E,A02,084139,Staff,29,0,30,1
1649768743049,MATH 20E,A03,084140,Staff,30,0,30,0
1649768743049,MATH 20E,A04,084141,Staff,30,0,30,0
1649768749077,MATH 102,A01,084143,Harel; Guershon,27,0,30,3
1649768749077,MATH 102,A02,084144,Harel; Guershon,29,0,30,1
1649768755104,MATH 103B,A01,083456,Staff,22,0,30,8
1649768755104,MATH 103B,A02,083457,Staff,28,0,30,2
1649768761137,MATH 109,A01,084146,Salehi Golsefidy; Alireza,30,0,30,0
1649768761137,MATH 109,A02,084147,Salehi Golsefidy; Alireza,29,0,30,1
1649768767168,MATH 120A,A01,085445,Eggers; John Dietrich,32,0,35,3
1649768767168,MATH 120A,A02,085446,Eggers; John Dietrich,34,0,35,1
1649768773193,MATH 142B,A01,084149,Verstraete; Jacques Allan,26,0,30,4
1649768773193,MATH 142B,A02,084150,Verstraete; Jacques Allan,28,0,30,2
1649768779221,MATH 170A,A01,083459,Nie; Jiawang,22,0,30,8
1649768779221,MATH 170A,A02,083460,Nie; Jiawang,28,0,30,2
1649768779221,MATH 170A,A03,083461,Nie; Jiawang,30,0,30,0
1649768785249,MATH 193B,A01,083463,Staff,25,0,30,5
1649768785249,MATH 193B,A02,083464,Staff,29,0,30,1
1649768785249,MATH 193B,A03,083465,Staff,30,0,30,0
1649768791309,COGS 2,A01,083966,Boyle; Mary E. T.,28,0,30,2
1649768797335,COGS 9,A01,083968,Staff,59,0,60,1
1649768803359,COGS 14B,A01,083970,Staff,50,0,50,0
1649768809384,COGS 100,A01,083972,Staff,58,0,60,2
1649768821437,COGS 101C,A01,083976,Staff,30,0,30,0
1649768827465,COGS 102A,A01,083978,Johnson; Christine M.,30,0,30,0
1649768833490,COGS 107B,A01,083980,Staff,46,0,50,4
1649768839517,COGS 115,A01,083982,Staff,27,0,30,3
1649768845544,COGS 118B,A01,083367,Staff,26,0,40,14
1649768851572,COGS 172,A01,083984,Provenzano; Emily Kara,25,0,30,5
1649768857596,COGS 177,A00,083368,Staff,22,0,30,8
1649768863625,COGS 186,A01,083986,Staff,31,0,40,9
1649768869648,COGS 187A,A01,083988,Boyle; Mary E. T.,56,0,60,4
1649768875674,CSE 8A,A50,084003,Miranda; Gregory Joseph,13,0,15,2
1649768881703,CSE 11,A01,084005,Miranda; Gregory Joseph,52,0,55,3
1649768887726,CSE 20,A01,084007,Staff,17,0,20,3
1649768893754,CSE 21,A01,084009,Staff,50,0,50,0
1649768899780,CSE 30,A01,083370,Cao; Yingjun,38,0,40,2
1649768905809,CSE 100,A01,083372,Cao; Yingjun,37,0,40,3
1649768911832,CSE 101,A01,084011,Staff,25,0,40,15
1649768917859,CSE 141,A01,083374,Eldon; John,46,0,75,29
1649768923886,CSE 141L,A01,083376,Eldon; John,48,0,75,27
1649768929917,CSE 175,A01,084013,Kumar; Rakesh,25,0,25,0
1649768935942,ECE 5,A01,084049,Morris; Karcher William,19,0,20,1
1649768941965,ECE 100,A01,084051,Baghdadchi; Saharnaz,18,0,20,2
1649768941965,ECE 100,A02,091916,Baghdadchi; Saharnaz,20,0,20,0
1649768947990,ECE 101,A01,084053,Baghdadchi; Saharnaz,33,0,37,4
1649768947990,ECE 101,A02,084054,Baghdadchi; Saharnaz,37,0,37,0
1649768954023,ECE 107,A01,083390,Staff,36,0,40,4
1649768960049,ECE 148,A01,084056,Silberman; Jack,10,0,12,2
1649768966077,ECE 180,A00,083391,Abi Samra; Nicholas Camill,28,0,30,2
1649768966077,ECE 180,B00,083392,Abi Samra; Nicholas Camill,28,0,30,2
1649768972104,MATH 10B,A01,084110,Staff,26,0,30,4
1649768972104,MATH 10B,A02,084111,Staff,30,0,30,0
1649768972104,MATH 10B,A03,084112,Staff,30,0,30,0
1649768978128,MATH 10C,A01,083443,Staff,28,0,30,2
1649768978128,MATH 10C,A02,083444,Staff,27,0,30,3
1649768978128,MATH 10C,B01,084114,Staff,29,0,30,1
1649768978128,MATH 10C,B02,084115,Staff,30,0,30,0
1649768984153,MATH 18,A01,084117,Harel; Guershon,28,0,30,2
1649768984153,MATH 18,A02,084119,Harel; Guershon,29,0,30,1
1649768984153,MATH 18,A03,084120,Harel; Guershon,30,0,30,0
1649768984153,MATH 18,A04,084121,Harel; Guershon,30,0,30,0
1649768990185,MATH 20B,A01,084124,Um; Ko Woon,34,0,35,1
1649768990185,MATH 20B,B01,084126,Um; Ko Woon,35,0,35,0
1649768996212,MATH 20C,A01,083446,Hammock; Frances H,29,0,30,1
1649768996212,MATH 20C,A02,083447,Hammock; Frances H,30,0,30,0
1649768996212,MATH 20C,A03,083448,Hammock; Frances H,30,0,30,0
1649768996212,MATH 20C,A04,083449,Hammock; Frances H,30,0,30,0
1649768996212,MATH 20C,B01,083451,Hammock; Frances H,30,0,30,0
1649768996212,MATH 20C,B02,083452,Hammock; Frances H,30,0,30,0
1649768996212,MATH 20C,B03,083453,Hammock; Frances H,30,0,30,0
1649768996212,MATH 20C,B04,083454,Hammock; Frances H,30,0,30,0
1649769002242,MATH 20D,A01,084128,Staff,30,0,30,0
1649769002242,MATH 20D,A02,084129,Staff,30,0,30,0
1649769002242,MATH 20D,A03,084130,Staff,29,0,30,1
1649769002242,MATH 20D,B01,084133,Staff,30,0,30,0
1649769002242,MATH 20D,B02,084134,Staff,30,0,30,0
1649769002242,MATH 20D,B03,084135,Staff,30,0,30,0
1649769008272,MATH 20E,A01,084138,Staff,30,0,30,0
1649769008272,MATH 20E,A02,084139,Staff,29,0,30,1
1649769008272,MATH 20E,A03,084140,Staff,30,0,30,0
1649769008272,MATH 20E,A04,084141,Staff,30,0,30,0
1649769014303,MATH 102,A01,084143,Harel; Guershon,27,0,30,3
1649769014303,MATH 102,A02,084144,Harel; Guershon,29,0,30,1
1649769020327,MATH 103B,A01,083456,Staff,22,0,30,8
1649769020327,MATH 103B,A02,083457,Staff,28,0,30,2
1649769026353,MATH 109,A01,084146,Salehi Golsefidy; Alireza,30,0,30,0
1649769026353,MATH 109,A02,084147,Salehi Golsefidy; Alireza,29,0,30,1
1649769032376,MATH 120A,A01,085445,Eggers; John Dietrich,32,0,35,3
1649769032376,MATH 120A,A02,085446,Eggers; John Dietrich,34,0,35,1
1649769038401,MATH 142B,A01,084149,Verstraete; Jacques Allan,26,0,30,4
1649769038401,MATH 142B,A02,084150,Verstraete; Jacques Allan,28,0,30,2
1649769044425,MATH 170A,A01,083459,Nie; Jiawang,22,0,30,8
1649769044425,MATH 170A,A02,083460,Nie; Jiawang,28,0,30,2
1649769044425,MATH 170A,A03,083461,Nie; Jiawang,30,0,30,0
1649769050449,MATH 193B,A01,083463,Staff,25,0,30,5
1649769050449,MATH 193B,A02,083464,Staff,29,0,30,1
1649769050449,MATH 193B,A03,083465,Staff,30,0,30,0
1649769056514,COGS 2,A01,083966,Boyle; Mary E. T.,28,0,30,2
1649769062543,COGS 9,A01,083968,Staff,59,0,60,1
1649769068571,COGS 14B,A01,083970,Staff,50,0,50,0
1649769074602,COGS 100,A01,083972,Staff,58,0,60,2
1649769086659,COGS 101C,A01,083976,Staff,30,0,30,0
1649769092685,COGS 102A,A01,083978,Johnson; Christine M.,30,0,30,0
1649769098711,COGS 107B,A01,083980,Staff,46,0,50,4
1649769104737,COGS 115,A01,083982,Staff,27,0,30,3
1649769110761,COGS 118B,A01,083367,Staff,26,0,40,14
1649769116787,COGS 172,A01,083984,Provenzano; Emily Kara,25,0,30,5
1649769122812,COGS 177,A00,083368,Staff,22,0,30,8
1649769128839,COGS 186,A01,083986,Staff,31,0,40,9
1649769134865,COGS 187A,A01,083988,Boyle; Mary E. T.,56,0,60,4
1649769140892,CSE 8A,A50,084003,Miranda; Gregory Joseph,13,0,15,2
1649769146926,CSE 11,A01,084005,Miranda; Gregory Joseph,52,0,55,3
1649769153051,CSE 20,A01,084007,Staff,17,0,20,3
1649769159078,CSE 21,A01,084009,Staff,50,0,50,0
1649769165104,CSE 30,A01,083370,Cao; Yingjun,38,0,40,2
1649769171131,CSE 100,A01,083372,Cao; Yingjun,37,0,40,3
1649769177159,CSE 101,A01,084011,Staff,25,0,40,15
1649769183188,CSE 141,A01,083374,Eldon; John,46,0,75,29
1649769189218,CSE 141L,A01,083376,Eldon; John,48,0,75,27
1649769195243,CSE 175,A01,084013,Kumar; Rakesh,25,0,25,0
1649769201274,ECE 5,A01,084049,Morris; Karcher William,19,0,20,1
1649769207300,ECE 100,A01,084051,Baghdadchi; Saharnaz,18,0,20,2
1649769207300,ECE 100,A02,091916,Baghdadchi; Saharnaz,20,0,20,0
1649769213327,ECE 101,A01,084053,Baghdadchi; Saharnaz,33,0,37,4
1649769213327,ECE 101,A02,084054,Baghdadchi; Saharnaz,37,0,37,0
1649769219351,ECE 107,A01,083390,Staff,36,0,40,4
1649769225377,ECE 148,A01,084056,Silberman; Jack,10,0,12,2
1649769231402,ECE 180,A00,083391,Abi Samra; Nicholas Camill,28,0,30,2
1649769231402,ECE 180,B00,083392,Abi Samra; Nicholas Camill,28,0,30,2
1649769237429,MATH 10B,A01,084110,Staff,26,0,30,4
1649769237429,MATH 10B,A02,084111,Staff,30,0,30,0
1649769237429,MATH 10B,A03,084112,Staff,30,0,30,0
1649769243459,MATH 10C,A01,083443,Staff,28,0,30,2
1649769243459,MATH 10C,A02,083444,Staff,27,0,30,3
1649769243459,MATH 10C,B01,084114,Staff,29,0,30,1
1649769243459,MATH 10C,B02,084115,Staff,30,0,30,0
1649769249490,MATH 18,A01,084117,Harel; Guershon,28,0,30,2
1649769249490,MATH 18,A02,084119,Harel; Guershon,29,0,30,1
1649769249490,MATH 18,A03,084120,Harel; Guershon,30,0,30,0
1649769249490,MATH 18,A04,084121,Harel; Guershon,30,0,30,0
1649769255518,MATH 20B,A01,084124,Um; Ko Woon,34,0,35,1
1649769255518,MATH 20B,B01,084126,Um; Ko Woon,35,0,35,0
1649769261554,MATH 20C,A01,083446,Hammock; Frances H,29,0,30,1
1649769261554,MATH 20C,A02,083447,Hammock; Frances H,30,0,30,0
1649769261554,MATH 20C,A03,083448,Hammock; Frances H,30,0,30,0
1649769261554,MATH 20C,A04,083449,Hammock; Frances H,30,0,30,0
1649769261554,MATH 20C,B01,083451,Hammock; Frances H,30,0,30,0
1649769261554,MATH 20C,B02,083452,Hammock; Frances H,30,0,30,0
1649769261554,MATH 20C,B03,083453,Hammock; Frances H,30,0,30,0
1649769261554,MATH 20C,B04,083454,Hammock; Frances H,30,0,30,0
1649769267581,MATH 20D,A01,084128,Staff,30,0,30,0
1649769267581,MATH 20D,A02,084129,Staff,30,0,30,0
1649769267581,MATH 20D,A03,084130,Staff,29,0,30,1
1649769267581,MATH 20D,B01,084133,Staff,30,0,30,0
1649769267581,MATH 20D,B02,084134,Staff,30,0,30,0
1649769267581,MATH 20D,B03,084135,Staff,30,0,30,0
1649769273607,MATH 20E,A01,084138,Staff,30,0,30,0
1649769273607,MATH 20E,A02,084139,Staff,29,0,30,1
1649769273607,MATH 20E,A03,084140,Staff,30,0,30,0
1649769273607,MATH 20E,A04,084141,Staff,30,0,30,0
1649769279631,MATH 102,A01,084143,Harel; Guershon,27,0,30,3
1649769279631,MATH 102,A02,084144,Harel; Guershon,29,0,30,1
1649769285660,MATH 103B,A01,083456,Staff,22,0,30,8
1649769285660,MATH 103B,A02,083457,Staff,28,0,30,2
1649769291686,MATH 109,A01,084146,Salehi Golsefidy; Alireza,30,0,30,0
1649769291686,MATH 109,A02,084147,Salehi Golsefidy; Alireza,29,0,30,1
1649769297712,MATH 120A,A01,085445,Eggers; John Dietrich,32,0,35,3
1649769297712,MATH 120A,A02,085446,Eggers; John Dietrich,34,0,35,1
1649769303742,MATH 142B,A01,084149,Verstraete; Jacques Allan,26,0,30,4
1649769303742,MATH 142B,A02,084150,Verstraete; Jacques Allan,28,0,30,2
1649769309766,MATH 170A,A01,083459,Nie; Jiawang,22,0,30,8
1649769309766,MATH 170A,A02,083460,Nie; Jiawang,28,0,30,2
1649769309766,MATH 170A,A03,083461,Nie; Jiawang,30,0,30,0
1649769315802,MATH 193B,A01,083463,Staff,25,0,30,5
1649769315802,MATH 193B,A02,083464,Staff,29,0,30,1
1649769315802,MATH 193B,A03,083465,Staff,30,0,30,0
1649769321912,COGS 2,A01,083966,Boyle; Mary E. T.,28,0,30,2
1649769327943,COGS 9,A01,083968,Staff,59,0,60,1
1649769333976,COGS 14B,A01,083970,Staff,50,0,50,0
1649769340002,COGS 100,A01,083972,Staff,58,0,60,2
1649769352060,COGS 101C,A01,083976,Staff,30,0,30,0
1649769358088,COGS 102A,A01,083978,Johnson; Christine M.,30,0,30,0
1649769364117,COGS 107B,A01,083980,Staff,46,0,50,4
1649769370143,COGS 115,A01,083982,Staff,27,0,30,3
1649769376167,COGS 118B,A01,083367,Staff,26,0,40,14
1649769382192,COGS 172,A01,083984,Provenzano; Emily Kara,25,0,30,5
1649769388228,COGS 177,A00,083368,Staff,22,0,30,8
1649769394256,COGS 186,A01,083986,Staff,31,0,40,9
1649769400284,COGS 187A,A01,083988,Boyle; Mary E. T.,56,0,60,4
1649769406321,CSE 8A,A50,084003,Miranda; Gregory Joseph,13,0,15,2
1649769412349,CSE 11,A01,084005,Miranda; Gregory Joseph,52,0,55,3
1649769418375,CSE 20,A01,084007,Staff,17,0,20,3
1649769424400,CSE 21,A01,084009,Staff,50,0,50,0
1649769430427,CSE 30,A01,083370,Cao; Yingjun,38,0,40,2
1649769436461,CSE 100,A01,083372,Cao; Yingjun,37,0,40,3
1649769442487,CSE 101,A01,084011,Staff,25,0,40,15
1649769448514,CSE 141,A01,083374,Eldon; John,46,0,75,29
1649769454544,CSE 141L,A01,083376,Eldon; John,48,0,75,27
1649769460576,CSE 175,A01,084013,Kumar; Rakesh,25,0,25,0
1649769466604,ECE 5,A01,084049,Morris; Karcher William,19,0,20,1
1649769472628,ECE 100,A01,084051,Baghdadchi; Saharnaz,18,0,20,2
1649769472628,ECE 100,A02,091916,Baghdadchi; Saharnaz,20,0,20,0
1649769478656,ECE 101,A01,084053,Baghdadchi; Saharnaz,33,0,37,4
1649769478656,ECE 101,A02,084054,Baghdadchi; Saharnaz,37,0,37,0
1649769484685,ECE 107,A01,083390,Staff,36,0,40,4
1649769490718,ECE 148,A01,084056,Silberman; Jack,10,0,12,2
1649769496749,ECE 180,A00,083391,Abi Samra; Nicholas Camill,28,0,30,2
1649769496749,ECE 180,B00,083392,Abi Samra; Nicholas Camill,28,0,30,2
1649769502778,MATH 10B,A01,084110,Staff,26,0,30,4
1649769502778,MATH 10B,A02,084111,Staff,30,0,30,0
1649769502778,MATH 10B,A03,084112,Staff,30,0,30,0
1649769508801,MATH 10C,A01,083443,Staff,28,0,30,2
1649769508801,MATH 10C,A02,083444,Staff,27,0,30,3
1649769508801,MATH 10C,B01,084114,Staff,29,0,30,1
1649769508801,MATH 10C,B02,084115,Staff,30,0,30,0
1649769514825,MATH 18,A01,084117,Harel; Guershon,28,0,30,2
1649769514825,MATH 18,A02,084119,Harel; Guershon,29,0,30,1
1649769514825,MATH 18,A03,084120,Harel; Guershon,30,0,30,0
1649769514825,MATH 18,A04,084121,Harel; Guershon,30,0,30,0
1649769520857,MATH 20B,A01,084124,Um; Ko Woon,34,0,35,1
1649769520857,MATH 20B,B01,084126,Um; Ko Woon,35,0,35,0
1649769526894,MATH 20C,A01,083446,Hammock; Frances H,29,0,30,1
1649769526894,MATH 20C,A02,083447,Hammock; Frances H,30,0,30,0
1649769526894,MATH 20C,A03,083448,Hammock; Frances H,30,0,30,0
1649769526894,MATH 20C,A04,083449,Hammock; Frances H,30,0,30,0
1649769526894,MATH 20C,B01,083451,Hammock; Frances H,30,0,30,0
1649769526894,MATH 20C,B02,083452,Hammock; Frances H,30,0,30,0
1649769526894,MATH 20C,B03,083453,Hammock; Frances H,30,0,30,0
1649769526894,MATH 20C,B04,083454,Hammock; Frances H,30,0,30,0
1649769532922,MATH 20D,A01,084128,Staff,30,0,30,0
1649769532922,MATH 20D,A02,084129,Staff,30,0,30,0
1649769532922,MATH 20D,A03,084130,Staff,29,0,30,1
1649769532922,MATH 20D,B01,084133,Staff,30,0,30,0
1649769532922,MATH 20D,B02,084134,Staff,30,0,30,0
1649769532922,MATH 20D,B03,084135,Staff,30,0,30,0
1649769538948,MATH 20E,A01,084138,Staff,30,0,30,0
1649769538948,MATH 20E,A02,084139,Staff,29,0,30,1
1649769538948,MATH 20E,A03,084140,Staff,30,0,30,0
1649769538948,MATH 20E,A04,084141,Staff,30,0,30,0
1649769544975,MATH 102,A01,084143,Harel; Guershon,27,0,30,3
1649769544975,MATH 102,A02,084144,Harel; Guershon,29,0,30,1
1649769551002,MATH 103B,A01,083456,Staff,22,0,30,8
1649769551002,MATH 103B,A02,083457,Staff,28,0,30,2
1649769557035,MATH 109,A01,084146,Salehi Golsefidy; Alireza,30,0,30,0
1649769557035,MATH 109,A02,084147,Salehi Golsefidy; Alireza,29,0,30,1
1649769563067,MATH 120A,A01,085445,Eggers; John Dietrich,32,0,35,3
1649769563067,MATH 120A,A02,085446,Eggers; John Dietrich,34,0,35,1
1649769569092,MATH 142B,A01,084149,Verstraete; Jacques Allan,26,0,30,4
1649769569092,MATH 142B,A02,084150,Verstraete; Jacques Allan,28,0,30,2
1649769575121,MATH 170A,A01,083459,Nie; Jiawang,22,0,30,8
1649769575121,MATH 170A,A02,083460,Nie; Jiawang,28,0,30,2
1649769575121,MATH 170A,A03,083461,Nie; Jiawang,30,0,30,0
1649769581151,MATH 193B,A01,083463,Staff,25,0,30,5
1649769581151,MATH 193B,A02,083464,Staff,29,0,30,1
1649769581151,MATH 193B,A03,083465,Staff,30,0,30,0
1649769587231,COGS 2,A01,083966,Boyle; Mary E. T.,28,0,30,2
1649769593259,COGS 9,A01,083968,Staff,59,0,60,1
1649769599284,COGS 14B,A01,083970,Staff,50,0,50,0
1649769605310,COGS 100,A01,083972,Staff,58,0,60,2
1649769617365,COGS 101C,A01,083976,Staff,30,0,30,0
1649769623391,COGS 102A,A01,083978,Johnson; Christine M.,30,0,30,0
1649769629417,COGS 107B,A01,083980,Staff,46,0,50,4
1649769635445,COGS 115,A01,083982,Staff,27,0,30,3
1649769641475,COGS 118B,A01,083367,Staff,26,0,40,14
1649769647500,COGS 172,A01,083984,Provenzano; Emily Kara,25,0,30,5
1649769653534,COGS 177,A00,083368,Staff,22,0,30,8
1649769659559,COGS 186,A01,083986,Staff,31,0,40,9
1649769665589,COGS 187A,A01,083988,Boyle; Mary E. T.,56,0,60,4
1649769671615,CSE 8A,A50,084003,Miranda; Gregory Joseph,13,0,15,2
1649769677640,CSE 11,A01,084005,Miranda; Gregory Joseph,52,0,55,3
1649769683668,CSE 20,A01,084007,Staff,17,0,20,3
1649769689694,CSE 21,A01,084009,Staff,50,0,50,0
1649769695722,CSE 30,A01,083370,Cao; Yingjun,38,0,40,2
1649769701747,CSE 100,A01,083372,Cao; Yingjun,37,0,40,3
1649769707773,CSE 101,A01,084011,Staff,25,0,40,15
1649769713802,CSE 141,A01,083374,Eldon; John,46,0,75,29
1649769719828,CSE 141L,A01,083376,Eldon; John,48,0,75,27
1649769725855,CSE 175,A01,084013,Kumar; Rakesh,25,0,25,0
1649769731882,ECE 5,A01,084049,Morris; Karcher William,19,0,20,1
1649769737913,ECE 100,A01,084051,Baghdadchi; Saharnaz,18,0,20,2
1649769737913,ECE 100,A02,091916,Baghdadchi; Saharnaz,20,0,20,0
1649769743948,ECE 101,A01,084053,Baghdadchi; Saharnaz,33,0,37,4
1649769743948,ECE 101,A02,084054,Baghdadchi; Saharnaz,37,0,37,0
1649769750070,ECE 107,A01,083390,Staff,36,0,40,4
1649769756096,ECE 148,A01,084056,Silberman; Jack,10,0,12,2
1649769762125,ECE 180,A00,083391,Abi Samra; Nicholas Camill,28,0,30,2
1649769762125,ECE 180,B00,083392,Abi Samra; Nicholas Camill,28,0,30,2
1649769768150,MATH 10B,A01,084110,Staff,26,0,30,4
1649769768150,MATH 10B,A02,084111,Staff,30,0,30,0
1649769768150,MATH 10B,A03,084112,Staff,30,0,30,0
1649769774176,MATH 10C,A01,083443,Staff,28,0,30,2
1649769774176,MATH 10C,A02,083444,Staff,27,0,30,3
1649769774176,MATH 10C,B01,084114,Staff,29,0,30,1
1649769774176,MATH 10C,B02,084115,Staff,30,0,30,0
1649769780205,MATH 18,A01,084117,Harel; Guershon,28,0,30,2
1649769780205,MATH 18,A02,084119,Harel; Guershon,29,0,30,1
1649769780205,MATH 18,A03,084120,Harel; Guershon,30,0,30,0
1649769780205,MATH 18,A04,084121,Harel; Guershon,30,0,30,0
1649769786239,MATH 20B,A01,084124,Um; Ko Woon,34,0,35,1
1649769786239,MATH 20B,B01,084126,Um; Ko Woon,35,0,35,0
1649769792274,MATH 20C,A01,083446,Hammock; Frances H,29,0,30,1
1649769792274,MATH 20C,A02,083447,Hammock; Frances H,30,0,30,0
1649769792274,MATH 20C,A03,083448,Hammock; Frances H,30,0,30,0
1649769792274,MATH 20C,A04,083449,Hammock; Frances H,30,0,30,0
1649769792274,MATH 20C,B01,083451,Hammock; Frances H,30,0,30,0
1649769792274,MATH 20C,B02,083452,Hammock; Frances H,30,0,30,0
1649769792274,MATH 20C,B03,083453,Hammock; Frances H,30,0,30,0
1649769792274,MATH 20C,B04,083454,Hammock; Frances H,30,0,30,0
1649769798304,MATH 20D,A01,084128,Staff,30,0,30,0
1649769798304,MATH 20D,A02,084129,Staff,30,0,30,0
1649769798304,MATH 20D,A03,084130,Staff,29,0,30,1
1649769798304,MATH 20D,B01,084133,Staff,30,0,30,0
1649769798304,MATH 20D,B02,084134,Staff,30,0,30,0
1649769798304,MATH 20D,B03,084135,Staff,30,0,30,0
1649769804330,MATH 20E,A01,084138,Staff,30,0,30,0
1649769804330,MATH 20E,A02,084139,Staff,29,0,30,1
1649769804330,MATH 20E,A03,084140,Staff,30,0,30,0
1649769804330,MATH 20E,A04,084141,Staff,30,0,30,0
1649769810355,MATH 102,A01,084143,Harel; Guershon,27,0,30,3
1649769810355,MATH 102,A02,084144,Harel; Guershon,29,0,30,1
1649769816382,MATH 103B,A01,083456,Staff,22,0,30,8
1649769816382,MATH 103B,A02,083457,Staff,28,0,30,2
1649769822407,MATH 109,A01,084146,Salehi Golsefidy; Alireza,30,0,30,0
1649769822407,MATH 109,A02,084147,Salehi Golsefidy; Alireza,29,0,30,1
1649769828438,MATH 120A,A01,085445,Eggers; John Dietrich,32,0,35,3
1649769828438,MATH 120A,A02,085446,Eggers; John Dietrich,34,0,35,1
1649769834463,MATH 142B,A01,084149,Verstraete; Jacques Allan,26,0,30,4
1649769834463,MATH 142B,A02,084150,Verstraete; Jacques Allan,28,0,30,2
1649769840489,MATH 170A,A01,083459,Nie; Jiawang,22,0,30,8
1649769840489,MATH 170A,A02,083460,Nie; Jiawang,28,0,30,2
1649769840489,MATH 170A,A03,083461,Nie; Jiawang,30,0,30,0
1649769846526,MATH 193B,A01,083463,Staff,25,0,30,5
1649769846526,MATH 193B,A02,083464,Staff,29,0,30,1
1649769846526,MATH 193B,A03,083465,Staff,30,0,30,0
1649769852593,COGS 2,A01,083966,Boyle; Mary E. T.,28,0,30,2
1649769858622,COGS 9,A01,083968,Staff,59,0,60,1
1649769864649,COGS 14B,A01,083970,Staff,50,0,50,0
1649769870676,COGS 100,A01,083972,Staff,58,0,60,2
1649769882736,COGS 101C,A01,083976,Staff,30,0,30,0
1649769888762,COGS 102A,A01,083978,Johnson; Christine M.,30,0,30,0
1649769894792,COGS 107B,A01,083980,Staff,46,0,50,4
1649769900821,COGS 115,A01,083982,Staff,27,0,30,3
1649769906846,COGS 118B,A01,083367,Staff,26,0,40,14
1649769912874,COGS 172,A01,083984,Provenzano; Emily Kara,25,0,30,5
1649769918903,COGS 177,A00,083368,Staff,22,0,30,8
1649769924932,COGS 186,A01,083986,Staff,31,0,40,9
1649769930958,COGS 187A,A01,083988,Boyle; Mary E. T.,56,0,60,4
1649769936988,CSE 8A,A50,084003,Miranda; Gregory Joseph,13,0,15,2
1649769943019,CSE 11,A01,084005,Miranda; Gregory Joseph,52,0,55,3
1649769949048,CSE 20,A01,084007,Staff,17,0,20,3
1649769955081,CSE 21,A01,084009,Staff,50,0,50,0
1649769961105,CSE 30,A01,083370,Cao; Yingjun,38,0,40,2
1649769967130,CSE 100,A01,083372,Cao; Yingjun,37,0,40,3
1649769973160,CSE 101,A01,084011,Staff,25,0,40,15
1649769979189,CSE 141,A01,083374,Eldon; John,46,0,75,29
1649769985214,CSE 141L,A01,083376,Eldon; John,48,0,75,27
1649769991245,CSE 175,A01,084013,Kumar; Rakesh,25,0,25,0
1649769997272,ECE 5,A01,084049,Morris; Karcher William,19,0,20,1
1649770003300,ECE 100,A01,084051,Baghdadchi; Saharnaz,18,0,20,2
1649770003300,ECE 100,A02,091916,Baghdadchi; Saharnaz,20,0,20,0
1649770009325,ECE 101,A01,084053,Baghdadchi; Saharnaz,33,0,37,4
1649770009325,ECE 101,A02,084054,Baghdadchi; Saharnaz,37,0,37,0
1649770015350,ECE 107,A01,083390,Staff,36,0,40,4
1649770021376,ECE 148,A01,084056,Silberman; Jack,10,0,12,2
1649770027402,ECE 180,A00,083391,Abi Samra; Nicholas Camill,28,0,30,2
1649770027402,ECE 180,B00,083392,Abi Samra; Nicholas Camill,28,0,30,2
1649770033428,MATH 10B,A01,084110,Staff,26,0,30,4
1649770033428,MATH 10B,A02,084111,Staff,30,0,30,0
1649770033428,MATH 10B,A03,084112,Staff,30,0,30,0
1649770039455,MATH 10C,A01,083443,Staff,28,0,30,2
1649770039455,MATH 10C,A02,083444,Staff,27,0,30,3
1649770039455,MATH 10C,B01,084114,Staff,29,0,30,1
1649770039455,MATH 10C,B02,084115,Staff,30,0,30,0
1649770045480,MATH 18,A01,084117,Harel; Guershon,28,0,30,2
1649770045480,MATH 18,A02,084119,Harel; Guershon,29,0,30,1
1649770045480,MATH 18,A03,084120,Harel; Guershon,30,0,30,0
1649770045480,MATH 18,A04,084121,Harel; Guershon,30,0,30,0
1649770051507,MATH 20B,A01,084124,Um; Ko Woon,34,0,35,1
1649770051507,MATH 20B,B01,084126,Um; Ko Woon,35,0,35,0
1649770057538,MATH 20C,A01,083446,Hammock; Frances H,29,0,30,1
1649770057538,MATH 20C,A02,083447,Hammock; Frances H,30,0,30,0
1649770057538,MATH 20C,A03,083448,Hammock; Frances H,30,0,30,0
1649770057538,MATH 20C,A04,083449,Hammock; Frances H,30,0,30,0
1649770057538,MATH 20C,B01,083451,Hammock; Frances H,30,0,30,0
1649770057538,MATH 20C,B02,083452,Hammock; Frances H,30,0,30,0
1649770057538,MATH 20C,B03,083453,Hammock; Frances H,30,0,30,0
1649770057538,MATH 20C,B04,083454,Hammock; Frances H,30,0,30,0
1649770063565,MATH 20D,A01,084128,Staff,30,0,30,0
1649770063565,MATH 20D,A02,084129,Staff,30,0,30,0
1649770063565,MATH 20D,A03,084130,Staff,29,0,30,1
1649770063565,MATH 20D,B01,084133,Staff,30,0,30,0
1649770063565,MATH 20D,B02,084134,Staff,30,0,30,0
1649770063565,MATH 20D,B03,084135,Staff,30,0,30,0
1649770069627,MATH 20E,A01,084138,Staff,30,0,30,0
1649770069627,MATH 20E,A02,084139,Staff,29,0,30,1
1649770069627,MATH 20E,A03,084140,Staff,30,0,30,0
1649770069627,MATH 20E,A04,084141,Staff,30,0,30,0
1649770075657,MATH 102,A01,084143,Harel; Guershon,27,0,30,3
1649770075657,MATH 102,A02,084144,Harel; Guershon,29,0,30,1
1649770081688,MATH 103B,A01,083456,Staff,22,0,30,8
1649770081688,MATH 103B,A02,083457,Staff,28,0,30,2
1649770087724,MATH 109,A01,084146,Salehi Golsefidy; Alireza,30,0,30,0
1649770087724,MATH 109,A02,084147,Salehi Golsefidy; Alireza,29,0,30,1
1649770093756,MATH 120A,A01,085445,Eggers; John Dietrich,32,0,35,3
1649770093756,MATH 120A,A02,085446,Eggers; John Dietrich,34,0,35,1
1649770099786,MATH 142B,A01,084149,Verstraete; Jacques Allan,26,0,30,4
1649770099786,MATH 142B,A02,084150,Verstraete; Jacques Allan,28,0,30,2
1649770105814,MATH 170A,A01,083459,Nie; Jiawang,22,0,30,8
1649770105814,MATH 170A,A02,083460,Nie; Jiawang,28,0,30,2
1649770105814,MATH 170A,A03,083461,Nie; Jiawang,30,0,30,0
1649770111844,MATH 193B,A01,083463,Staff,25,0,30,5
1649770111844,MATH 193B,A02,083464,Staff,29,0,30,1
1649770111844,MATH 193B,A03,083465,Staff,30,0,30,0
1649770117919,COGS 2,A01,083966,Boyle; Mary E. T.,28,0,30,2
1649770123944,COGS 9,A01,083968,Staff,59,0,60,1
1649770129972,COGS 14B,A01,083970,Staff,50,0,50,0
1649770135997,COGS 100,A01,083972,Staff,58,0,60,2
1649770148052,COGS 101C,A01,083976,Staff,30,0,30,0
1649770154081,COGS 102A,A01,083978,Johnson; Christine M.,30,0,30,0
1649770160105,COGS 107B,A01,083980,Staff,46,0,50,4
1649770166134,COGS 115,A01,083982,Staff,27,0,30,3
1649770172159,COGS 118B,A01,083367,Staff,26,0,40,14
1649770178186,COGS 172,A01,083984,Provenzano; Emily Kara,25,0,30,5
1649770184215,COGS 177,A00,083368,Staff,22,0,30,8
1649770190240,COGS 186,A01,083986,Staff,31,0,40,9
1649770196265,COGS 187A,A01,083988,Boyle; Mary E. T.,56,0,60,4
1649770202299,CSE 8A,A50,084003,Miranda; Gregory Joseph,13,0,15,2
1649770208325,CSE 11,A01,084005,Miranda; Gregory Joseph,52,0,55,3
1649770214354,CSE 20,A01,084007,Staff,17,0,20,3
1649770220379,CSE 21,A01,084009,Staff,50,0,50,0
1649770226401,CSE 30,A01,083370,Cao; Yingjun,38,0,40,2
1649770232428,CSE 100,A01,083372,Cao; Yingjun,37,0,40,3
1649770238455,CSE 101,A01,084011,Staff,25,0,40,15
1649770244478,CSE 141,A01,083374,Eldon; John,46,0,75,29
1649770250509,CSE 141L,A01,083376,Eldon; John,48,0,75,27
1649770256537,CSE 175,A01,084013,Kumar; Rakesh,25,0,25,0
1649770262562,ECE 5,A01,084049,Morris; Karcher William,19,0,20,1
1649770268585,ECE 100,A01,084051,Baghdadchi; Saharnaz,18,0,20,2
1649770268585,ECE 100,A02,091916,Baghdadchi; Saharnaz,20,0,20,0
1649770274611,ECE 101,A01,084053,Baghdadchi; Saharnaz,33,0,37,4
1649770274611,ECE 101,A02,084054,Baghdadchi; Saharnaz,37,0,37,0
1649770280641,ECE 107,A01,083390,Staff,36,0,40,4
1649770286666,ECE 148,A01,084056,Silberman; Jack,10,0,12,2
1649770292699,ECE 180,A00,083391,Abi Samra; Nicholas Camill,28,0,30,2
1649770292699,ECE 180,B00,083392,Abi Samra; Nicholas Camill,28,0,30,2
1649770298724,MATH 10B,A01,084110,Staff,26,0,30,4
1649770298724,MATH 10B,A02,084111,Staff,30,0,30,0
1649770298724,MATH 10B,A03,084112,Staff,30,0,30,0
1649770304751,MATH 10C,A01,083443,Staff,28,0,30,2
1649770304751,MATH 10C,A02,083444,Staff,27,0,30,3
1649770304751,MATH 10C,B01,084114,Staff,29,0,30,1
1649770304751,MATH 10C,B02,084115,Staff,30,0,30,0
1649770310786,MATH 18,A01,084117,Harel; Guershon,28,0,30,2
1649770310786,MATH 18,A02,084119,Harel; Guershon,29,0,30,1
1649770310786,MATH 18,A03,084120,Harel; Guershon,30,0,30,0
1649770310786,MATH 18,A04,084121,Harel; Guershon,30,0,30,0
1649770316814,MATH 20B,A01,084124,Um; Ko Woon,34,0,35,1
1649770316814,MATH 20B,B01,084126,Um; Ko Woon,35,0,35,0
1649770322844,MATH 20C,A01,083446,Hammock; Frances H,29,0,30,1
1649770322844,MATH 20C,A02,083447,Hammock; Frances H,30,0,30,0
1649770322844,MATH 20C,A03,083448,Hammock; Frances H,30,0,30,0
1649770322844,MATH 20C,A04,083449,Hammock; Frances H,30,0,30,0
1649770322844,MATH 20C,B01,083451,Hammock; Frances H,30,0,30,0
1649770322844,MATH 20C,B02,083452,Hammock; Frances H,30,0,30,0
1649770322844,MATH 20C,B03,083453,Hammock; Frances H,30,0,30,0
1649770322844,MATH 20C,B04,083454,Hammock; Frances H,30,0,30,0
1649770328874,MATH 20D,A01,084128,Staff,30,0,30,0
1649770328874,MATH 20D,A02,084129,Staff,30,0,30,0
1649770328874,MATH 20D,A03,084130,Staff,29,0,30,1
1649770328874,MATH 20D,B01,084133,Staff,30,0,30,0
1649770328874,MATH 20D,B02,084134,Staff,30,0,30,0
1649770328874,MATH 20D,B03,084135,Staff,30,0,30,0
1649770334898,MATH 20E,A01,084138,Staff,30,0,30,0
1649770334898,MATH 20E,A02,084139,Staff,29,0,30,1
1649770334898,MATH 20E,A03,084140,Staff,30,0,30,0
1649770334898,MATH 20E,A04,084141,Staff,30,0,30,0
1649770340924,MATH 102,A01,084143,Harel; Guershon,27,0,30,3
1649770340924,MATH 102,A02,084144,Harel; Guershon,29,0,30,1
1649770347041,MATH 103B,A01,083456,Staff,22,0,30,8
1649770347041,MATH 103B,A02,083457,Staff,28,0,30,2
1649770353063,MATH 109,A01,084146,Salehi Golsefidy; Alireza,30,0,30,0
1649770353063,MATH 109,A02,084147,Salehi Golsefidy; Alireza,29,0,30,1
1649770359097,MATH 120A,A01,085445,Eggers; John Dietrich,32,0,35,3
1649770359097,MATH 120A,A02,085446,Eggers; John Dietrich,34,0,35,1
1649770365127,MATH 142B,A01,084149,Verstraete; Jacques Allan,26,0,30,4
1649770365127,MATH 142B,A02,084150,Verstraete; Jacques Allan,28,0,30,2
1649770371152,MATH 170A,A01,083459,Nie; Jiawang,22,0,30,8
1649770371152,MATH 170A,A02,083460,Nie; Jiawang,28,0,30,2
1649770371152,MATH 170A,A03,083461,Nie; Jiawang,30,0,30,0
1649770377176,MATH 193B,A01,083463,Staff,25,0,30,5
1649770377176,MATH 193B,A02,083464,Staff,29,0,30,1
1649770377176,MATH 193B,A03,083465,Staff,30,0,30,0
1649770383240,COGS 2,A01,083966,Boyle; Mary E. T.,28,0,30,2
1649770389264,COGS 9,A01,083968,Staff,59,0,60,1
1649770395301,COGS 14B,A01,083970,Staff,50,0,50,0
1649770401329,COGS 100,A01,083972,Staff,58,0,60,2
1649770413381,COGS 101C,A01,083976,Staff,30,0,30,0
1649770419408,COGS 102A,A01,083978,Johnson; Christine M.,30,0,30,0
1649770425433,COGS 107B,A01,083980,Staff,46,0,50,4
1649770431457,COGS 115,A01,083982,Staff,27,0,30,3
1649770437489,COGS 118B,A01,083367,Staff,26,0,40,14
1649770443518,COGS 172,A01,083984,Provenzano; Emily Kara,25,0,30,5
1649770449542,COGS 177,A00,083368,Staff,22,0,30,8
1649770455572,COGS 186,A01,083986,Staff,31,0,40,9
1649770461602,COGS 187A,A01,083988,Boyle; Mary E. T.,56,0,60,4
1649770467629,CSE 8A,A50,084003,Miranda; Gregory Joseph,13,0,15,2
1649770473655,CSE 11,A01,084005,Miranda; Gregory Joseph,52,0,55,3
1649770479769,CSE 20,A01,084007,Staff,17,0,20,3
1649770485792,CSE 21,A01,084009,Staff,50,0,50,0
1649770491817,CSE 30,A01,083370,Cao; Yingjun,38,0,40,2
1649770497842,CSE 100,A01,083372,Cao; Yingjun,37,0,40,3
1649770503873,CSE 101,A01,084011,Staff,25,0,40,15
1649770509900,CSE 141,A01,083374,Eldon; John,46,0,75,29
1649770515930,CSE 141L,A01,083376,Eldon; John,48,0,75,27
1649770521957,CSE 175,A01,084013,Kumar; Rakesh,25,0,25,0
1649770527985,ECE 5,A01,084049,Morris; Karcher William,19,0,20,1
1649770534012,ECE 100,A01,084051,Baghdadchi; Saharnaz,18,0,20,2
1649770534012,ECE 100,A02,091916,Baghdadchi; Saharnaz,20,0,20,0
1649770540038,ECE 101,A01,084053,Baghdadchi; Saharnaz,33,0,37,4
1649770540038,ECE 101,A02,084054,Baghdadchi; Saharnaz,37,0,37,0
1649770546064,ECE 107,A01,083390,Staff,36,0,40,4
1649770552087,ECE 148,A01,084056,Silberman; Jack,10,0,12,2
1649770558112,ECE 180,A00,083391,Abi Samra; Nicholas Camill,28,0,30,2
1649770558112,ECE 180,B00,083392,Abi Samra; Nicholas Camill,28,0,30,2
1649770564135,MATH 10B,A01,084110,Staff,26,0,30,4
1649770564135,MATH 10B,A02,084111,Staff,30,0,30,0
1649770564135,MATH 10B,A03,084112,Staff,30,0,30,0
1649770570168,MATH 10C,A01,083443,Staff,28,0,30,2
1649770570168,MATH 10C,A02,083444,Staff,27,0,30,3
1649770570168,MATH 10C,B01,084114,Staff,29,0,30,1
1649770570168,MATH 10C,B02,084115,Staff,30,0,30,0
1649770576198,MATH 18,A01,084117,Harel; Guershon,28,0,30,2
1649770576198,MATH 18,A02,084119,Harel; Guershon,29,0,30,1
1649770576198,MATH 18,A03,084120,Harel; Guershon,30,0,30,0
1649770576198,MATH 18,A04,084121,Harel; Guershon,30,0,30,0
1649770582223,MATH 20B,A01,084124,Um; Ko Woon,34,0,35,1
1649770582223,MATH 20B,B01,084126,Um; Ko Woon,35,0,35,0
1649770588259,MATH 20C,A01,083446,Hammock; Frances H,29,0,30,1
1649770588259,MATH 20C,A02,083447,Hammock; Frances H,30,0,30,0
1649770588259,MATH 20C,A03,083448,Hammock; Frances H,30,0,30,0
1649770588259,MATH 20C,A04,083449,Hammock; Frances H,30,0,30,0
1649770588259,MATH 20C,B01,083451,Hammock; Frances H,30,0,30,0
1649770588259,MATH 20C,B02,083452,Hammock; Frances H,30,0,30,0
1649770588259,MATH 20C,B03,083453,Hammock; Frances H,30,0,30,0
1649770588259,MATH 20C,B04,083454,Hammock; Frances H,30,0,30,0
1649770594285,MATH 20D,A01,084128,Staff,30,0,30,0
1649770594285,MATH 20D,A02,084129,Staff,30,0,30,0
1649770594285,MATH 20D,A03,084130,Staff,29,0,30,1
1649770594285,MATH 20D,B01,084133,Staff,30,0,30,0
1649770594285,MATH 20D,B02,084134,Staff,30,0,30,0
1649770594285,MATH 20D,B03,084135,Staff,30,0,30,0
1649770600314,MATH 20E,A01,084138,Staff,30,0,30,0
1649770600314,MATH 20E,A02,084139,Staff,29,0,30,1
1649770600314,MATH 20E,A03,084140,Staff,30,0,30,0
1649770600314,MATH 20E,A04,084141,Staff,30,0,30,0
1649770606345,MATH 102,A01,084143,Harel; Guershon,27,0,30,3
1649770606345,MATH 102,A02,084144,Harel; Guershon,29,0,30,1
1649770612370,MATH 103B,A01,083456,Staff,22,0,30,8
1649770612370,MATH 103B,A02,083457,Staff,28,0,30,2
1649770618399,MATH 109,A01,084146,Salehi Golsefidy; Alireza,30,0,30,0
1649770618399,MATH 109,A02,084147,Salehi Golsefidy; Alireza,29,0,30,1
1649770624429,MATH 120A,A01,085445,Eggers; John Dietrich,32,0,35,3
1649770624429,MATH 120A,A02,085446,Eggers; John Dietrich,34,0,35,1
1649770630456,MATH 142B,A01,084149,Verstraete; Jacques Allan,26,0,30,4
1649770630456,MATH 142B,A02,084150,Verstraete; Jacques Allan,28,0,30,2
1649770636484,MATH 170A,A01,083459,Nie; Jiawang,22,0,30,8
1649770636484,MATH 170A,A02,083460,Nie; Jiawang,28,0,30,2
1649770636484,MATH 170A,A03,083461,Nie; Jiawang,30,0,30,0
1649770642509,MATH 193B,A01,083463,Staff,25,0,30,5
1649770642509,MATH 193B,A02,083464,Staff,29,0,30,1
1649770642509,MATH 193B,A03,083465,Staff,30,0,30,0
1649770648568,COGS 2,A01,083966,Boyle; Mary E. T.,28,0,30,2
1649770654598,COGS 9,A01,083968,Staff,59,0,60,1
1649770660632,COGS 14B,A01,083970,Staff,50,0,50,0
1649770666663,COGS 100,A01,083972,Staff,58,0,60,2
1649770678714,COGS 101C,A01,083976,Staff,30,0,30,0
1649770684748,COGS 102A,A01,083978,Johnson; Christine M.,30,0,30,0
1649770690772,COGS 107B,A01,083980,Staff,46,0,50,4
1649770696800,COGS 115,A01,083982,Staff,27,0,30,3
1649770702829,COGS 118B,A01,083367,Staff,26,0,40,14
1649770708853,COGS 172,A01,083984,Provenzano; Emily Kara,25,0,30,5
1649770714878,COGS 177,A00,083368,Staff,22,0,30,8
1649770720903,COGS 186,A01,083986,Staff,31,0,40,9
1649770726931,COGS 187A,A01,083988,Boyle; Mary E. T.,56,0,60,4
1649770732959,CSE 8A,A50,084003,Miranda; Gregory Joseph,13,0,15,2
1649770738982,CSE 11,A01,084005,Miranda; Gregory Joseph,52,0,55,3
1649770745007,CSE 20,A01,084007,Staff,17,0,20,3
1649770751031,CSE 21,A01,084009,Staff,50,0,50,0
1649770757055,CSE 30,A01,083370,Cao; Yingjun,38,0,40,2
1649770763083,CSE 100,A01,083372,Cao; Yingjun,37,0,40,3
1649770769111,CSE 101,A01,084011,Staff,25,0,40,15
1649770775139,CSE 141,A01,083374,Eldon; John,46,0,75,29
1649770781169,CSE 141L,A01,083376,Eldon; John,48,0,75,27
1649770787193,CSE 175,A01,084013,Kumar; Rakesh,25,0,25,0
1649770793218,ECE 5,A01,084049,Morris; Karcher William,19,0,20,1
1649770799241,ECE 100,A01,084051,Baghdadchi; Saharnaz,18,0,20,2
1649770799241,ECE 100,A02,091916,Baghdadchi; Saharnaz,20,0,20,0
1649770805268,ECE 101,A01,084053,Baghdadchi; Saharnaz,33,0,37,4
1649770805268,ECE 101,A02,084054,Baghdadchi; Saharnaz,37,0,37,0
1649770811297,ECE 107,A01,083390,Staff,36,0,40,4
1649770817326,ECE 148,A01,084056,Silberman; Jack,10,0,12,2
1649770823352,ECE 180,A00,083391,Abi Samra; Nicholas Camill,28,0,30,2
1649770823352,ECE 180,B00,083392,Abi Samra; Nicholas Camill,28,0,30,2
1649770829376,MATH 10B,A01,084110,Staff,26,0,30,4
1649770829376,MATH 10B,A02,084111,Staff,30,0,30,0
1649770829376,MATH 10B,A03,084112,Staff,30,0,30,0
1649770835399,MATH 10C,A01,083443,Staff,28,0,30,2
1649770835399,MATH 10C,A02,083444,Staff,27,0,30,3
1649770835399,MATH 10C,B01,084114,Staff,29,0,30,1
1649770835399,MATH 10C,B02,084115,Staff,30,0,30,0
1649770841424,MATH 18,A01,084117,Harel; Guershon,28,0,30,2
1649770841424,MATH 18,A02,084119,Harel; Guershon,29,0,30,1
1649770841424,MATH 18,A03,084120,Harel; Guershon,30,0,30,0
1649770841424,MATH 18,A04,084121,Harel; Guershon,30,0,30,0
1649770847449,MATH 20B,A01,084124,Um; Ko Woon,34,0,35,1
1649770847449,MATH 20B,B01,084126,Um; Ko Woon,35,0,35,0
1649770853474,MATH 20C,A01,083446,Hammock; Frances H,29,0,30,1
1649770853474,MATH 20C,A02,083447,Hammock; Frances H,30,0,30,0
1649770853474,MATH 20C,A03,083448,Hammock; Frances H,30,0,30,0
1649770853474,MATH 20C,A04,083449,Hammock; Frances H,30,0,30,0
1649770853474,MATH 20C,B01,083451,Hammock; Frances H,30,0,30,0
1649770853474,MATH 20C,B02,083452,Hammock; Frances H,30,0,30,0
1649770853474,MATH 20C,B03,083453,Hammock; Frances H,30,0,30,0
1649770853474,MATH 20C,B04,083454,Hammock; Frances H,30,0,30,0
1649770859507,MATH 20D,A01,084128,Staff,30,0,30,0
1649770859507,MATH 20D,A02,084129,Staff,30,0,30,0
1649770859507,MATH 20D,A03,084130,Staff,29,0,30,1
1649770859507,MATH 20D,B01,084133,Staff,30,0,30,0
1649770859507,MATH 20D,B02,084134,Staff,30,0,30,0
1649770859507,MATH 20D,B03,084135,Staff,30,0,30,0
1649770865532,MATH 20E,A01,084138,Staff,30,0,30,0
1649770865532,MATH 20E,A02,084139,Staff,29,0,30,1
1649770865532,MATH 20E,A03,084140,Staff,30,0,30,0
1649770865532,MATH 20E,A04,084141,Staff,30,0,30,0
1649770871569,MATH 102,A01,084143,Harel; Guershon,27,0,30,3
1649770871569,MATH 102,A02,084144,Harel; Guershon,29,0,30,1
1649770877598,MATH 103B,A01,083456,Staff,22,0,30,8
1649770877598,MATH 103B,A02,083457,Staff,28,0,30,2
1649770883622,MATH 109,A01,084146,Salehi Golsefidy; Alireza,30,0,30,0
1649770883622,MATH 109,A02,084147,Salehi Golsefidy; Alireza,29,0,30,1
1649770889648,MATH 120A,A01,085445,Eggers; John Dietrich,32,0,35,3
1649770889648,MATH 120A,A02,085446,Eggers; John Dietrich,34,0,35,1
1649770895677,MATH 142B,A01,084149,Verstraete; Jacques Allan,26,0,30,4
1649770895677,MATH 142B,A02,084150,Verstraete; Jacques Allan,28,0,30,2
1649770901706,MATH 170A,A01,083459,Nie; Jiawang,22,0,30,8
1649770901706,MATH 170A,A02,083460,Nie; Jiawang,28,0,30,2
1649770901706,MATH 170A,A03,083461,Nie; Jiawang,30,0,30,0
1649770907740,MATH 193B,A01,083463,Staff,25,0,30,5
1649770907740,MATH 193B,A02,083464,Staff,29,0,30,1
1649770907740,MATH 193B,A03,083465,Staff,30,0,30,0
1649770913810,COGS 2,A01,083966,Boyle; Mary E. T.,28,0,30,2
1649770919835,COGS 9,A01,083968,Staff,59,0,60,1
1649770925861,COGS 14B,A01,083970,Staff,50,0,50,0
1649770931887,COGS 100,A01,083972,Staff,58,0,60,2
1649770944028,COGS 101C,A01,083976,Staff,30,0,30,0
1649770950054,COGS 102A,A01,083978,Johnson; Christine M.,30,0,30,0
1649770956081,COGS 107B,A01,083980,Staff,46,0,50,4
1649770962104,COGS 115,A01,083982,Staff,27,0,30,3
1649770968132,COGS 118B,A01,083367,Staff,26,0,40,14
1649770974158,COGS 172,A01,083984,Provenzano; Emily Kara,25,0,30,5
1649770980183,COGS 177,A00,083368,Staff,22,0,30,8
1649770986207,COGS 186,A01,083986,Staff,31,0,40,9
1649770992233,COGS 187A,A01,083988,Boyle; Mary E. T.,56,0,60,4
1649770998263,CSE 8A,A50,084003,Miranda; Gregory Joseph,13,0,15,2
1649771004288,CSE 11,A01,084005,Miranda; Gregory Joseph,52,0,55,3
1649771010316,CSE 20,A01,084007,Staff,17,0,20,3
1649771016341,CSE 21,A01,084009,Staff,50,0,50,0
1649771022370,CSE 30,A01,083370,Cao; Yingjun,38,0,40,2
1649771028393,CSE 100,A01,083372,Cao; Yingjun,37,0,40,3
1649771034423,CSE 101,A01,084011,Staff,25,0,40,15
1649771040449,CSE 141,A01,083374,Eldon; John,46,0,75,29
1649771046473,CSE 141L,A01,083376,Eldon; John,48,0,75,27
1649771052498,CSE 175,A01,084013,Kumar; Rakesh,25,0,25,0
1649771058523,ECE 5,A01,084049,Morris; Karcher William,19,0,20,1
1649771064551,ECE 100,A01,084051,Baghdadchi; Saharnaz,18,0,20,2
1649771064551,ECE 100,A02,091916,Baghdadchi; Saharnaz,20,0,20,0
1649771070577,ECE 101,A01,084053,Baghdadchi; Saharnaz,33,0,37,4
1649771070577,ECE 101,A02,084054,Baghdadchi; Saharnaz,37,0,37,0
1649771076606,ECE 107,A01,083390,Staff,36,0,40,4
1649771082632,ECE 148,A01,084056,Silberman; Jack,10,0,12,2
1649771088657,ECE 180,A00,083391,Abi Samra; Nicholas Camill,28,0,30,2
1649771088657,ECE 180,B00,083392,Abi Samra; Nicholas Camill,28,0,30,2
1649771094682,MATH 10B,A01,084110,Staff,26,0,30,4
1649771094682,MATH 10B,A02,084111,Staff,30,0,30,0
1649771094682,MATH 10B,A03,084112,Staff,30,0,30,0
1649771100707,MATH 10C,A01,083443,Staff,28,0,30,2
1649771100707,MATH 10C,A02,083444,Staff,27,0,30,3
1649771100707,MATH 10C,B01,084114,Staff,29,0,30,1
1649771100707,MATH 10C,B02,084115,Staff,30,0,30,0
1649771106731,MATH 18,A01,084117,Harel; Guershon,28,0,30,2
1649771106731,MATH 18,A02,084119,Harel; Guershon,29,0,30,1
1649771106731,MATH 18,A03,084120,Harel; Guershon,30,0,30,0
1649771106731,MATH 18,A04,084121,Harel; Guershon,30,0,30,0
1649771112761,MATH 20B,A01,084124,Um; Ko Woon,34,0,35,1
1649771112761,MATH 20B,B01,084126,Um; Ko Woon,35,0,35,0
1649771118788,MATH 20C,A01,083446,Hammock; Frances H,29,0,30,1
1649771118788,MATH 20C,A02,083447,Hammock; Frances H,30,0,30,0
1649771118788,MATH 20C,A03,083448,Hammock; Frances H,30,0,30,0
1649771118788,MATH 20C,A04,083449,Hammock; Frances H,30,0,30,0
1649771118788,MATH 20C,B01,083451,Hammock; Frances H,30,0,30,0
1649771118788,MATH 20C,B02,083452,Hammock; Frances H,30,0,30,0
1649771118788,MATH 20C,B03,083453,Hammock; Frances H,30,0,30,0
1649771118788,MATH 20C,B04,083454,Hammock; Frances H,30,0,30,0
1649771124812,MATH 20D,A01,084128,Staff,30,0,30,0
1649771124812,MATH 20D,A02,084129,Staff,30,0,30,0
1649771124812,MATH 20D,A03,084130,Staff,29,0,30,1
1649771124812,MATH 20D,B01,084133,Staff,30,0,30,0
1649771124812,MATH 20D,B02,084134,Staff,30,0,30,0
1649771124812,MATH 20D,B03,084135,Staff,30,0,30,0
1649771130848,MATH 20E,A01,084138,Staff,30,0,30,0
1649771130848,MATH 20E,A02,084139,Staff,29,0,30,1
1649771130848,MATH 20E,A03,084140,Staff,30,0,30,0
1649771130848,MATH 20E,A04,084141,Staff,30,0,30,0
1649771136874,MATH 102,A01,084143,Harel; Guershon,27,0,30,3
1649771136874,MATH 102,A02,084144,Harel; Guershon,29,0,30,1
1649771142898,MATH 103B,A01,083456,Staff,22,0,30,8
1649771142898,MATH 103B,A02,083457,Staff,28,0,30,2
1649771148931,MATH 109,A01,084146,Salehi Golsefidy; Alireza,30,0,30,0
1649771148931,MATH 109,A02,084147,Salehi Golsefidy; Alireza,29,0,30,1
1649771154965,MATH 120A,A01,085445,Eggers; John Dietrich,32,0,35,3
1649771154965,MATH 120A,A02,085446,Eggers; John Dietrich,34,0,35,1
1649771160991,MATH 142B,A01,084149,Verstraete; Jacques Allan,26,0,30,4
1649771160991,MATH 142B,A02,084150,Verstraete; Jacques Allan,28,0,30,2
1649771167020,MATH 170A,A01,083459,Nie; Jiawang,22,0,30,8
1649771167020,MATH 170A,A02,083460,Nie; Jiawang,28,0,30,2
1649771167020,MATH 170A,A03,083461,Nie; Jiawang,30,0,30,0
1649771173049,MATH 193B,A01,083463,Staff,25,0,30,5
1649771173049,MATH 193B,A02,083464,Staff,29,0,30,1
1649771173049,MATH 193B,A03,083465,Staff,30,0,30,0
1649771179104,COGS 2,A01,083966,Boyle; Mary E. T.,28,0,30,2
1649771185133,COGS 9,A01,083968,Staff,59,0,60,1
1649771191161,COGS 14B,A01,083970,Staff,50,0,50,0
1649771197186,COGS 100,A01,083972,Staff,58,0,60,2
1649771209235,COGS 101C,A01,083976,Staff,30,0,30,0
1649771215260,COGS 102A,A01,083978,Johnson; Christine M.,30,0,30,0
1649771221288,COGS 107B,A01,083980,Staff,46,0,50,4
1649771227316,COGS 115,A01,083982,Staff,27,0,30,3
1649771233339,COGS 118B,A01,083367,Staff,26,0,40,14
1649771239362,COGS 172,A01,083984,Provenzano; Emily Kara,25,0,30,5
1649771245390,COGS 177,A00,083368,Staff,22,0,30,8
1649771251417,COGS 186,A01,083986,Staff,31,0,40,9
1649771257442,COGS 187A,A01,083988,Boyle; Mary E. T.,56,0,60,4
1649771263467,CSE 8A,A50,084003,Miranda; Gregory Joseph,13,0,15,2
1649771269492,CSE 11,A01,084005,Miranda; Gregory Joseph,52,0,55,3
1649771275524,CSE 20,A01,084007,Staff,17,0,20,3
1649771281552,CSE 21,A01,084009,Staff,50,0,50,0
1649771287575,CSE 30,A01,083370,Cao; Yingjun,38,0,40,2
1649771293603,CSE 100,A01,083372,Cao; Yingjun,37,0,40,3
1649771299628,CSE 101,A01,084011,Staff,25,0,40,15
1649771305660,CSE 141,A01,083374,Eldon; John,46,0,75,29
1649771311689,CSE 141L,A01,083376,Eldon; John,48,0,75,27
1649771317715,CSE 175,A01,084013,Kumar; Rakesh,25,0,25,0
1649771323739,ECE 5,A01,084049,Morris; Karcher William,19,0,20,1
1649771329764,ECE 100,A01,084051,Baghdadchi; Saharnaz,18,0,20,2
1649771329764,ECE 100,A02,091916,Baghdadchi; Saharnaz,20,0,20,0
1649771335790,ECE 101,A01,084053,Baghdadchi; Saharnaz,33,0,37,4
1649771335790,ECE 101,A02,084054,Baghdadchi; Saharnaz,37,0,37,0
1649771341818,ECE 107,A01,083390,Staff,36,0,40,4
1649771347844,ECE 148,A01,084056,Silberman; Jack,10,0,12,2
1649771353873,ECE 180,A00,083391,Abi Samra; Nicholas Camill,28,0,30,2
1649771353873,ECE 180,B00,083392,Abi Samra; Nicholas Camill,28,0,30,2
1649771359897,MATH 10B,A01,084110,Staff,26,0,30,4
1649771359897,MATH 10B,A02,084111,Staff,30,0,30,0
1649771359897,MATH 10B,A03,084112,Staff,30,0,30,0
1649771365927,MATH 10C,A01,083443,Staff,28,0,30,2
1649771365927,MATH 10C,A02,083444,Staff,27,0,30,3
1649771365927,MATH 10C,B01,084114,Staff,29,0,30,1
1649771365927,MATH 10C,B02,084115,Staff,30,0,30,0
1649771371954,MATH 18,A01,084117,Harel; Guershon,28,0,30,2
1649771371954,MATH 18,A02,084119,Harel; Guershon,29,0,30,1
1649771371954,MATH 18,A03,084120,Harel; Guershon,30,0,30,0
1649771371954,MATH 18,A04,084121,Harel; Guershon,30,0,30,0
1649771377980,MATH 20B,A01,084124,Um; Ko Woon,34,0,35,1
1649771377980,MATH 20B,B01,084126,Um; Ko Woon,35,0,35,0
1649771384005,MATH 20C,A01,083446,Hammock; Frances H,29,0,30,1
1649771384005,MATH 20C,A02,083447,Hammock; Frances H,30,0,30,0
1649771384005,MATH 20C,A03,083448,Hammock; Frances H,30,0,30,0
1649771384005,MATH 20C,A04,083449,Hammock; Frances H,30,0,30,0
1649771384005,MATH 20C,B01,083451,Hammock; Frances H,30,0,30,0
1649771384005,MATH 20C,B02,083452,Hammock; Frances H,30,0,30,0
1649771384005,MATH 20C,B03,083453,Hammock; Frances H,30,0,30,0
1649771384005,MATH 20C,B04,083454,Hammock; Frances H,30,0,30,0
1649771390030,MATH 20D,A01,084128,Staff,30,0,30,0
1649771390030,MATH 20D,A02,084129,Staff,30,0,30,0
1649771390030,MATH 20D,A03,084130,Staff,29,0,30,1
1649771390030,MATH 20D,B01,084133,Staff,30,0,30,0
1649771390030,MATH 20D,B02,084134,Staff,30,0,30,0
1649771390030,MATH 20D,B03,084135,Staff,30,0,30,0
1649771396055,MATH 20E,A01,084138,Staff,30,0,30,0
1649771396055,MATH 20E,A02,084139,Staff,29,0,30,1
1649771396055,MATH 20E,A03,084140,Staff,30,0,30,0
1649771396055,MATH 20E,A04,084141,Staff,30,0,30,0
1649771402088,MATH 102,A01,084143,Harel; Guershon,27,0,30,3
1649771402088,MATH 102,A02,084144,Harel; Guershon,29,0,30,1
1649771408116,MATH 103B,A01,083456,Staff,22,0,30,8
1649771408116,MATH 103B,A02,083457,Staff,28,0,30,2
1649771414145,MATH 109,A01,084146,Salehi Golsefidy; Alireza,30,0,30,0
1649771414145,MATH 109,A02,084147,Salehi Golsefidy; Alireza,29,0,30,1
1649771420169,MATH 120A,A01,085445,Eggers; John Dietrich,32,0,35,3
1649771420169,MATH 120A,A02,085446,Eggers; John Dietrich,34,0,35,1
1649771426192,MATH 142B,A01,084149,Verstraete; Jacques Allan,26,0,30,4
1649771426192,MATH 142B,A02,084150,Verstraete; Jacques Allan,28,0,30,2
1649771432221,MATH 170A,A01,083459,Nie; Jiawang,22,0,30,8
1649771432221,MATH 170A,A02,083460,Nie; Jiawang,28,0,30,2
1649771432221,MATH 170A,A03,083461,Nie; Jiawang,30,0,30,0
1649771438244,MATH 193B,A01,083463,Staff,25,0,30,5
1649771438244,MATH 193B,A02,083464,Staff,29,0,30,1
1649771438244,MATH 193B,A03,083465,Staff,30,0,30,0
1649771444314,COGS 2,A01,083966,Boyle; Mary E. T.,28,0,30,2
1649771450335,COGS 9,A01,083968,Staff,59,0,60,1
1649771456372,COGS 14B,A01,083970,Staff,50,0,50,0
1649771462398,COGS 100,A01,083972,Staff,58,0,60,2
1649771474447,COGS 101C,A01,083976,Staff,30,0,30,0
1649771480477,COGS 102A,A01,083978,Johnson; Christine M.,30,0,30,0
1649771486511,COGS 107B,A01,083980,Staff,46,0,50,4
1649771492535,COGS 115,A01,083982,Staff,27,0,30,3
1649771498560,COGS 118B,A01,083367,Staff,26,0,40,14
1649771504585,COGS 172,A01,083984,Provenzano; Emily Kara,25,0,30,5
1649771510619,COGS 177,A00,083368,Staff,22,0,30,8
1649771516665,COGS 186,A01,083986,Staff,31,0,40,9
1649771522689,COGS 187A,A01,083988,Boyle; Mary E. T.,56,0,60,4
1649771528715,CSE 8A,A50,084003,Miranda; Gregory Joseph,13,0,15,2
1649771534842,CSE 11,A01,084005,Miranda; Gregory Joseph,52,0,55,3
1649771540870,CSE 20,A01,084007,Staff,17,0,20,3
1649771546907,CSE 21,A01,084009,Staff,50,0,50,0
1649771552934,CSE 30,A01,083370,Cao; Yingjun,38,0,40,2
1649771558960,CSE 100,A01,083372,Cao; Yingjun,37,0,40,3
1649771564982,CSE 101,A01,084011,Staff,25,0,40,15
1649771571007,CSE 141,A01,083374,Eldon; John,46,0,75,29
1649771577032,CSE 141L,A01,083376,Eldon; John,48,0,75,27
1649771583061,CSE 175,A01,084013,Kumar; Rakesh,25,0,25,0
1649771589087,ECE 5,A01,084049,Morris; Karcher William,19,0,20,1
1649771595112,ECE 100,A01,084051,Baghdadchi; Saharnaz,18,0,20,2
1649771595112,ECE 100,A02,091916,Baghdadchi; Saharnaz,20,0,20,0
1649771601137,ECE 101,A01,084053,Baghdadchi; Saharnaz,33,0,37,4
1649771601137,ECE 101,A02,084054,Baghdadchi; Saharnaz,37,0,37,0
1649771607163,ECE 107,A01,083390,Staff,36,0,40,4
1649771613189,ECE 148,A01,084056,Silberman; Jack,10,0,12,2
1649771619213,ECE 180,A00,083391,Abi Samra; Nicholas Camill,28,0,30,2
1649771619213,ECE 180,B00,083392,Abi Samra; Nicholas Camill,28,0,30,2
1649771625238,MATH 10B,A01,084110,Staff,26,0,30,4
1649771625238,MATH 10B,A02,084111,Staff,30,0,30,0
1649771625238,MATH 10B,A03,084112,Staff,30,0,30,0
1649771631264,MATH 10C,A01,083443,Staff,28,0,30,2
1649771631264,MATH 10C,A02,083444,Staff,27,0,30,3
1649771631264,MATH 10C,B01,084114,Staff,29,0,30,1
1649771631264,MATH 10C,B02,084115,Staff,30,0,30,0
1649771637288,MATH 18,A01,084117,Harel; Guershon,28,0,30,2
1649771637288,MATH 18,A02,084119,Harel; Guershon,29,0,30,1
1649771637288,MATH 18,A03,084120,Harel; Guershon,30,0,30,0
1649771637288,MATH 18,A04,084121,Harel; Guershon,30,0,30,0
1649771643313,MATH 20B,A01,084124,Um; Ko Woon,34,0,35,1
1649771643313,MATH 20B,B01,084126,Um; Ko Woon,35,0,35,0
1649771649346,MATH 20C,A01,083446,Hammock; Frances H,29,0,30,1
1649771649346,MATH 20C,A02,083447,Hammock; Frances H,30,0,30,0
1649771649346,MATH 20C,A03,083448,Hammock; Frances H,30,0,30,0
1649771649346,MATH 20C,A04,083449,Hammock; Frances H,30,0,30,0
1649771649346,MATH 20C,B01,083451,Hammock; Frances H,30,0,30,0
1649771649346,MATH 20C,B02,083452,Hammock; Frances H,30,0,30,0
1649771649346,MATH 20C,B03,083453,Hammock; Frances H,30,0,30,0
1649771649346,MATH 20C,B04,083454,Hammock; Frances H,30,0,30,0
1649771655370,MATH 20D,A01,084128,Staff,30,0,30,0
1649771655370,MATH 20D,A02,084129,Staff,30,0,30,0
1649771655370,MATH 20D,A03,084130,Staff,29,0,30,1
1649771655370,MATH 20D,B01,084133,Staff,30,0,30,0
1649771655370,MATH 20D,B02,084134,Staff,30,0,30,0
1649771655370,MATH 20D,B03,084135,Staff,30,0,30,0
1649771661397,MATH 20E,A01,084138,Staff,30,0,30,0
1649771661397,MATH 20E,A02,084139,Staff,29,0,30,1
1649771661397,MATH 20E,A03,084140,Staff,30,0,30,0
1649771661397,MATH 20E,A04,084141,Staff,30,0,30,0
1649771667426,MATH 102,A01,084143,Harel; Guershon,27,0,30,3
1649771667426,MATH 102,A02,084144,Harel; Guershon,29,0,30,1
1649771673455,MATH 103B,A01,083456,Staff,22,0,30,8
1649771673455,MATH 103B,A02,083457,Staff,28,0,30,2
1649771679480,MATH 109,A01,084146,Salehi Golsefidy; Alireza,30,0,30,0
1649771679480,MATH 109,A02,084147,Salehi Golsefidy; Alireza,29,0,30,1
1649771685506,MATH 120A,A01,085445,Eggers; John Dietrich,32,0,35,3
1649771685506,MATH 120A,A02,085446,Eggers; John Dietrich,34,0,35,1
1649771691531,MATH 142B,A01,084149,Verstraete; Jacques Allan,26,0,30,4
1649771691531,MATH 142B,A02,084150,Verstraete; Jacques Allan,28,0,30,2
1649771697557,MATH 170A,A01,083459,Nie; Jiawang,22,0,30,8
1649771697557,MATH 170A,A02,083460,Nie; Jiawang,28,0,30,2
1649771697557,MATH 170A,A03,083461,Nie; Jiawang,30,0,30,0
1649771703584,MATH 193B,A01,083463,Staff,25,0,30,5
1649771703584,MATH 193B,A02,083464,Staff,29,0,30,1
1649771703584,MATH 193B,A03,083465,Staff,30,0,30,0
1649771709647,COGS 2,A01,083966,Boyle; Mary E. T.,28,0,30,2
1649771715684,COGS 9,A01,083968,Staff,59,0,60,1
1649771721715,COGS 14B,A01,083970,Staff,50,0,50,0
1649771727749,COGS 100,A01,083972,Staff,58,0,60,2
1649771739803,COGS 101C,A01,083976,Staff,30,0,30,0
1649771745833,COGS 102A,A01,083978,Johnson; Christine M.,30,0,30,0
1649771751861,COGS 107B,A01,083980,Staff,46,0,50,4
1649771757886,COGS 115,A01,083982,Staff,27,0,30,3
1649771763909,COGS 118B,A01,083367,Staff,26,0,40,14
1649771769940,COGS 172,A01,083984,Provenzano; Emily Kara,25,0,30,5
1649771775974,COGS 177,A00,083368,Staff,22,0,30,8
1649771782000,COGS 186,A01,083986,Staff,31,0,40,9
1649771788032,COGS 187A,A01,083988,Boyle; Mary E. T.,56,0,60,4
1649771794055,CSE 8A,A50,084003,Miranda; Gregory Joseph,13,0,15,2
1649771800080,CSE 11,A01,084005,Miranda; Gregory Joseph,52,0,55,3
1649771806105,CSE 20,A01,084007,Staff,17,0,20,3
1649771812130,CSE 21,A01,084009,Staff,50,0,50,0
1649771818164,CSE 30,A01,083370,Cao; Yingjun,38,0,40,2
1649771824192,CSE 100,A01,083372,Cao; Yingjun,37,0,40,3
1649771830218,CSE 101,A01,084011,Staff,25,0,40,15
1649771836243,CSE 141,A01,083374,Eldon; John,46,0,75,29
1649771842271,CSE 141L,A01,083376,Eldon; John,48,0,75,27
1649771848303,CSE 175,A01,084013,Kumar; Rakesh,25,0,25,0
1649771854328,ECE 5,A01,084049,Morris; Karcher William,19,0,20,1
1649771860356,ECE 100,A01,084051,Baghdadchi; Saharnaz,18,0,20,2
1649771860356,ECE 100,A02,091916,Baghdadchi; Saharnaz,20,0,20,0
1649771866382,ECE 101,A01,084053,Baghdadchi; Saharnaz,33,0,37,4
1649771866382,ECE 101,A02,084054,Baghdadchi; Saharnaz,37,0,37,0
1649771872406,ECE 107,A01,083390,Staff,36,0,40,4
1649771878435,ECE 148,A01,084056,Silberman; Jack,10,0,12,2
1649771884463,ECE 180,A00,083391,Abi Samra; Nicholas Camill,28,0,30,2
1649771884463,ECE 180,B00,083392,Abi Samra; Nicholas Camill,28,0,30,2
1649771890488,MATH 10B,A01,084110,Staff,26,0,30,4
1649771890488,MATH 10B,A02,084111,Staff,30,0,30,0
1649771890488,MATH 10B,A03,084112,Staff,30,0,30,0
1649771896517,MATH 10C,A01,083443,Staff,28,0,30,2
1649771896517,MATH 10C,A02,083444,Staff,27,0,30,3
1649771896517,MATH 10C,B01,084114,Staff,29,0,30,1
1649771896517,MATH 10C,B02,084115,Staff,30,0,30,0
1649771902543,MATH 18,A01,084117,Harel; Guershon,28,0,30,2
1649771902543,MATH 18,A02,084119,Harel; Guershon,29,0,30,1
1649771902543,MATH 18,A03,084120,Harel; Guershon,30,0,30,0
1649771902543,MATH 18,A04,084121,Harel; Guershon,30,0,30,0
1649771908574,MATH 20B,A01,084124,Um; Ko Woon,34,0,35,1
1649771908574,MATH 20B,B01,084126,Um; Ko Woon,35,0,35,0
1649771914602,MATH 20C,A01,083446,Hammock; Frances H,29,0,30,1
1649771914602,MATH 20C,A02,083447,Hammock; Frances H,30,0,30,0
1649771914602,MATH 20C,A03,083448,Hammock; Frances H,30,0,30,0
1649771914602,MATH 20C,A04,083449,Hammock; Frances H,30,0,30,0
1649771914602,MATH 20C,B01,083451,Hammock; Frances H,30,0,30,0
1649771914602,MATH 20C,B02,083452,Hammock; Frances H,30,0,30,0
1649771914602,MATH 20C,B03,083453,Hammock; Frances H,30,0,30,0
1649771914602,MATH 20C,B04,083454,Hammock; Frances H,30,0,30,0
1649771920627,MATH 20D,A01,084128,Staff,30,0,30,0
1649771920627,MATH 20D,A02,084129,Staff,30,0,30,0
1649771920627,MATH 20D,A03,084130,Staff,29,0,30,1
1649771920627,MATH 20D,B01,084133,Staff,30,0,30,0
1649771920627,MATH 20D,B02,084134,Staff,30,0,30,0
1649771920627,MATH 20D,B03,084135,Staff,30,0,30,0
1649771926650,MATH 20E,A01,084138,Staff,30,0,30,0
1649771926650,MATH 20E,A02,084139,Staff,29,0,30,1
1649771926650,MATH 20E,A03,084140,Staff,30,0,30,0
1649771926650,MATH 20E,A04,084141,Staff,30,0,30,0
1649771932679,MATH 102,A01,084143,Harel; Guershon,27,0,30,3
1649771932679,MATH 102,A02,084144,Harel; Guershon,29,0,30,1
1649771938704,MATH 103B,A01,083456,Staff,22,0,30,8
1649771938704,MATH 103B,A02,083457,Staff,28,0,30,2
1649771944728,MATH 109,A01,084146,Salehi Golsefidy; Alireza,30,0,30,0
1649771944728,MATH 109,A02,084147,Salehi Golsefidy; Alireza,29,0,30,1
1649771950758,MATH 120A,A01,085445,Eggers; John Dietrich,32,0,35,3
1649771950758,MATH 120A,A02,085446,Eggers; John Dietrich,34,0,35,1
1649771956782,MATH 142B,A01,084149,Verstraete; Jacques Allan,26,0,30,4
1649771956782,MATH 142B,A02,084150,Verstraete; Jacques Allan,28,0,30,2
1649771962806,MATH 170A,A01,083459,Nie; Jiawang,22,0,30,8
1649771962806,MATH 170A,A02,083460,Nie; Jiawang,28,0,30,2
1649771962806,MATH 170A,A03,083461,Nie; Jiawang,30,0,30,0
1649771968832,MATH 193B,A01,083463,Staff,25,0,30,5
1649771968832,MATH 193B,A02,083464,Staff,29,0,30,1
1649771968832,MATH 193B,A03,083465,Staff,30,0,30,0
1649771974891,COGS 2,A01,083966,Boyle; Mary E. T.,28,0,30,2
1649771980914,COGS 9,A01,083968,Staff,59,0,60,1
1649771986943,COGS 14B,A01,083970,Staff,50,0,50,0
1649771992974,COGS 100,A01,083972,Staff,58,0,60,2
1649772005034,COGS 101C,A01,083976,Staff,30,0,30,0
1649772011060,COGS 102A,A01,083978,Johnson; Christine M.,30,0,30,0
1649772017084,COGS 107B,A01,083980,Staff,46,0,50,4
1649772023122,COGS 115,A01,083982,Staff,27,0,30,3
1649772029154,COGS 118B,A01,083367,Staff,26,0,40,14
1649772035178,COGS 172,A01,083984,Provenzano; Emily Kara,25,0,30,5
1649772041206,COGS 177,A00,083368,Staff,22,0,30,8
1649772047231,COGS 186,A01,083986,Staff,31,0,40,9
1649772053259,COGS 187A,A01,083988,Boyle; Mary E. T.,56,0,60,4
1649772059284,CSE 8A,A50,084003,Miranda; Gregory Joseph,13,0,15,2
1649772065315,CSE 11,A01,084005,Miranda; Gregory Joseph,52,0,55,3
1649772071339,CSE 20,A01,084007,Staff,17,0,20,3
1649772077369,CSE 21,A01,084009,Staff,50,0,50,0
1649772083399,CSE 30,A01,083370,Cao; Yingjun,38,0,40,2
1649772089427,CSE 100,A01,083372,Cao; Yingjun,37,0,40,3
1649772095452,CSE 101,A01,084011,Staff,25,0,40,15
1649772101478,CSE 141,A01,083374,Eldon; John,46,0,75,29
1649772107507,CSE 141L,A01,083376,Eldon; John,48,0,75,27
1649772113534,CSE 175,A01,084013,Kumar; Rakesh,25,0,25,0
1649772119559,ECE 5,A01,084049,Morris; Karcher William,19,0,20,1
1649772125607,ECE 100,A01,084051,Baghdadchi; Saharnaz,18,0,20,2
1649772125607,ECE 100,A02,091916,Baghdadchi; Saharnaz,20,0,20,0
1649772131725,ECE 101,A01,084053,Baghdadchi; Saharnaz,33,0,37,4
1649772131725,ECE 101,A02,084054,Baghdadchi; Saharnaz,37,0,37,0
1649772137750,ECE 107,A01,083390,Staff,36,0,40,4
1649772143781,ECE 148,A01,084056,Silberman; Jack,10,0,12,2
1649772149810,ECE 180,A00,083391,Abi Samra; Nicholas Camill,28,0,30,2
1649772149810,ECE 180,B00,083392,Abi Samra; Nicholas Camill,28,0,30,2
1649772155837,MATH 10B,A01,084110,Staff,26,0,30,4
1649772155837,MATH 10B,A02,084111,Staff,30,0,30,0
1649772155837,MATH 10B,A03,084112,Staff,30,0,30,0
1649772161866,MATH 10C,A01,083443,Staff,28,0,30,2
1649772161866,MATH 10C,A02,083444,Staff,27,0,30,3
1649772161866,MATH 10C,B01,084114,Staff,29,0,30,1
1649772161866,MATH 10C,B02,084115,Staff,30,0,30,0
1649772167895,MATH 18,A01,084117,Harel; Guershon,28,0,30,2
1649772167895,MATH 18,A02,084119,Harel; Guershon,29,0,30,1
1649772167895,MATH 18,A03,084120,Harel; Guershon,30,0,30,0
1649772167895,MATH 18,A04,084121,Harel; Guershon,30,0,30,0
1649772173921,MATH 20B,A01,084124,Um; Ko Woon,34,0,35,1
1649772173921,MATH 20B,B01,084126,Um; Ko Woon,35,0,35,0
1649772179947,MATH 20C,A01,083446,Hammock; Frances H,29,0,30,1
1649772179947,MATH 20C,A02,083447,Hammock; Frances H,30,0,30,0
1649772179947,MATH 20C,A03,083448,Hammock; Frances H,30,0,30,0
1649772179947,MATH 20C,A04,083449,Hammock; Frances H,30,0,30,0
1649772179947,MATH 20C,B01,083451,Hammock; Frances H,30,0,30,0
1649772179947,MATH 20C,B02,083452,Hammock; Frances H,30,0,30,0
1649772179947,MATH 20C,B03,083453,Hammock; Frances H,30,0,30,0
1649772179947,MATH 20C,B04,083454,Hammock; Frances H,30,0,30,0
1649772185974,MATH 20D,A01,084128,Staff,30,0,30,0
1649772185974,MATH 20D,A02,084129,Staff,30,0,30,0
1649772185974,MATH 20D,A03,084130,Staff,29,0,30,1
1649772185974,MATH 20D,B01,084133,Staff,30,0,30,0
1649772185974,MATH 20D,B02,084134,Staff,30,0,30,0
1649772185974,MATH 20D,B03,084135,Staff,30,0,30,0
1649772191998,MATH 20E,A01,084138,Staff,30,0,30,0
1649772191998,MATH 20E,A02,084139,Staff,29,0,30,1
1649772191998,MATH 20E,A03,084140,Staff,30,0,30,0
1649772191998,MATH 20E,A04,084141,Staff,30,0,30,0
1649772198043,MATH 102,A01,084143,Harel; Guershon,27,0,30,3
1649772198043,MATH 102,A02,084144,Harel; Guershon,29,0,30,1
1649772204069,MATH 103B,A01,083456,Staff,22,0,30,8
1649772204069,MATH 103B,A02,083457,Staff,28,0,30,2
1649772210094,MATH 109,A01,084146,Salehi Golsefidy; Alireza,30,0,30,0
1649772210094,MATH 109,A02,084147,Salehi Golsefidy; Alireza,29,0,30,1
1649772216118,MATH 120A,A01,085445,Eggers; John Dietrich,32,0,35,3
1649772216118,MATH 120A,A02,085446,Eggers; John Dietrich,34,0,35,1
1649772222153,MATH 142B,A01,084149,Verstraete; Jacques Allan,26,0,30,4
1649772222153,MATH 142B,A02,084150,Verstraete; Jacques Allan,28,0,30,2
1649772228179,MATH 170A,A01,083459,Nie; Jiawang,22,0,30,8
1649772228179,MATH 170A,A02,083460,Nie; Jiawang,28,0,30,2
1649772228179,MATH 170A,A03,083461,Nie; Jiawang,30,0,30,0
1649772234207,MATH 193B,A01,083463,Staff,25,0,30,5
1649772234207,MATH 193B,A02,083464,Staff,29,0,30,1
1649772234207,MATH 193B,A03,083465,Staff,30,0,30,0
1649772240272,COGS 2,A01,083966,Boyle; Mary E. T.,28,0,30,2
1649772246303,COGS 9,A01,083968,Staff,59,0,60,1
1649772252326,COGS 14B,A01,083970,Staff,50,0,50,0
1649772258361,COGS 100,A01,083972,Staff,58,0,60,2
1649772270416,COGS 101C,A01,083976,Staff,30,0,30,0
1649772276458,COGS 102A,A01,083978,Johnson; Christine M.,30,0,30,0
1649772282487,COGS 107B,A01,083980,Staff,46,0,50,4
1649772288515,COGS 115,A01,083982,Staff,27,0,30,3
1649772294545,COGS 118B,A01,083367,Staff,26,0,40,14
1649772300583,COGS 172,A01,083984,Provenzano; Emily Kara,25,0,30,5
1649772306612,COGS 177,A00,083368,Staff,22,0,30,8
1649772312638,COGS 186,A01,083986,Staff,31,0,40,9
1649772318662,COGS 187A,A01,083988,Boyle; Mary E. T.,56,0,60,4
1649772324687,CSE 8A,A50,084003,Miranda; Gregory Joseph,13,0,15,2
1649772330723,CSE 11,A01,084005,Miranda; Gregory Joseph,52,0,55,3
1649772336750,CSE 20,A01,084007,Staff,17,0,20,3
1649772342791,CSE 21,A01,084009,Staff,50,0,50,0
1649772348816,CSE 30,A01,083370,Cao; Yingjun,38,0,40,2
1649772354844,CSE 100,A01,083372,Cao; Yingjun,37,0,40,3
1649772360873,CSE 101,A01,084011,Staff,25,0,40,15
1649772366901,CSE 141,A01,083374,Eldon; John,46,0,75,29
1649772372927,CSE 141L,A01,083376,Eldon; John,48,0,75,27
1649772378954,CSE 175,A01,084013,Kumar; Rakesh,25,0,25,0
1649772384984,ECE 5,A01,084049,Morris; Karcher William,19,0,20,1
1649772391011,ECE 100,A01,084051,Baghdadchi; Saharnaz,18,0,20,2
1649772391011,ECE 100,A02,091916,Baghdadchi; Saharnaz,20,0,20,0
1649772397040,ECE 101,A01,084053,Baghdadchi; Saharnaz,33,0,37,4
1649772397040,ECE 101,A02,084054,Baghdadchi; Saharnaz,37,0,37,0
1649772403065,ECE 107,A01,083390,Staff,36,0,40,4
1649772409098,ECE 148,A01,084056,Silberman; Jack,10,0,12,2
1649772415147,ECE 180,A00,083391,Abi Samra; Nicholas Camill,28,0,30,2
1649772415147,ECE 180,B00,083392,Abi Samra; Nicholas Camill,28,0,30,2
1649772421184,MATH 10B,A01,084110,Staff,26,0,30,4
1649772421184,MATH 10B,A02,084111,Staff,30,0,30,0
1649772421184,MATH 10B,A03,084112,Staff,30,0,30,0
1649772427220,MATH 10C,A01,083443,Staff,28,0,30,2
1649772427220,MATH 10C,A02,083444,Staff,27,0,30,3
1649772427220,MATH 10C,B01,084114,Staff,29,0,30,1
1649772427220,MATH 10C,B02,084115,Staff,30,0,30,0
1649772433276,MATH 18,A01,084117,Harel; Guershon,28,0,30,2
1649772433276,MATH 18,A02,084119,Harel; Guershon,29,0,30,1
1649772433276,MATH 18,A03,084120,Harel; Guershon,30,0,30,0
1649772433276,MATH 18,A04,084121,Harel; Guershon,30,0,30,0
1649772439332,MATH 20B,A01,084124,Um; Ko Woon,34,0,35,1
1649772439332,MATH 20B,B01,084126,Um; Ko Woon,35,0,35,0
1649772445371,MATH 20C,A01,083446,Hammock; Frances H,29,0,30,1
1649772445371,MATH 20C,A02,083447,Hammock; Frances H,30,0,30,0
1649772445371,MATH 20C,A03,083448,Hammock; Frances H,30,0,30,0
1649772445371,MATH 20C,A04,083449,Hammock; Frances H,30,0,30,0
1649772445371,MATH 20C,B01,083451,Hammock; Frances H,30,0,30,0
1649772445371,MATH 20C,B02,083452,Hammock; Frances H,30,0,30,0
1649772445371,MATH 20C,B03,083453,Hammock; Frances H,30,0,30,0
1649772445371,MATH 20C,B04,083454,Hammock; Frances H,30,0,30,0
1649772451403,MATH 20D,A01,084128,Staff,30,0,30,0
1649772451403,MATH 20D,A02,084129,Staff,30,0,30,0
1649772451403,MATH 20D,A03,084130,Staff,29,0,30,1
1649772451403,MATH 20D,B01,084133,Staff,30,0,30,0
1649772451403,MATH 20D,B02,084134,Staff,30,0,30,0
1649772451403,MATH 20D,B03,084135,Staff,30,0,30,0
1649772457427,MATH 20E,A01,084138,Staff,30,0,30,0
1649772457427,MATH 20E,A02,084139,Staff,29,0,30,1
1649772457427,MATH 20E,A03,084140,Staff,30,0,30,0
1649772457427,MATH 20E,A04,084141,Staff,30,0,30,0
1649772463471,MATH 102,A01,084143,Harel; Guershon,27,0,30,3
1649772463471,MATH 102,A02,084144,Harel; Guershon,29,0,30,1
1649772469497,MATH 103B,A01,083456,Staff,22,0,30,8
1649772469497,MATH 103B,A02,083457,Staff,28,0,30,2
1649772475524,MATH 109,A01,084146,Salehi Golsefidy; Alireza,30,0,30,0
1649772475524,MATH 109,A02,084147,Salehi Golsefidy; Alireza,29,0,30,1
1649772481549,MATH 120A,A01,085445,Eggers; John Dietrich,32,0,35,3
1649772481549,MATH 120A,A02,085446,Eggers; John Dietrich,34,0,35,1
1649772487580,MATH 142B,A01,084149,Verstraete; Jacques Allan,26,0,30,4
1649772487580,MATH 142B,A02,084150,Verstraete; Jacques Allan,28,0,30,2
1649772493607,MATH 170A,A01,083459,Nie; Jiawang,22,0,30,8
1649772493607,MATH 170A,A02,083460,Nie; Jiawang,28,0,30,2
1649772493607,MATH 170A,A03,083461,Nie; Jiawang,30,0,30,0
1649772499631,MATH 193B,A01,083463,Staff,25,0,30,5
1649772499631,MATH 193B,A02,083464,Staff,29,0,30,1
1649772499631,MATH 193B,A03,083465,Staff,30,0,30,0
1649772505688,COGS 2,A01,083966,Boyle; Mary E. T.,28,0,30,2
1649772511714,COGS 9,A01,083968,Staff,59,0,60,1
1649772517742,COGS 14B,A01,083970,Staff,50,0,50,0
1649772523771,COGS 100,A01,083972,Staff,58,0,60,2
1649772535824,COGS 101C,A01,083976,Staff,30,0,30,0
1649772541849,COGS 102A,A01,083978,Johnson; Christine M.,30,0,30,0
1649772547874,COGS 107B,A01,083980,Staff,46,0,50,4
1649772553903,COGS 115,A01,083982,Staff,27,0,30,3
1649772559931,COGS 118B,A01,083367,Staff,26,0,40,14
1649772565957,COGS 172,A01,083984,Provenzano; Emily Kara,25,0,30,5
1649772571983,COGS 177,A00,083368,Staff,22,0,30,8
1649772578009,COGS 186,A01,083986,Staff,31,0,40,9
1649772584037,COGS 187A,A01,083988,Boyle; Mary E. T.,56,0,60,4
1649772590068,CSE 8A,A50,084003,Miranda; Gregory Joseph,13,0,15,2
1649772596097,CSE 11,A01,084005,Miranda; Gregory Joseph,52,0,55,3
1649772602121,CSE 20,A01,084007,Staff,17,0,20,3
1649772608151,CSE 21,A01,084009,Staff,50,0,50,0
1649772614176,CSE 30,A01,083370,Cao; Yingjun,38,0,40,2
1649772620198,CSE 100,A01,083372,Cao; Yingjun,37,0,40,3
1649772626224,CSE 101,A01,084011,Staff,25,0,40,15
1649772632247,CSE 141,A01,083374,Eldon; John,46,0,75,29
1649772638276,CSE 141L,A01,083376,Eldon; John,48,0,75,27
1649772644304,CSE 175,A01,084013,Kumar; Rakesh,25,0,25,0
1649772650343,ECE 5,A01,084049,Morris; Karcher William,19,0,20,1
1649772656366,ECE 100,A01,084051,Baghdadchi; Saharnaz,18,0,20,2
1649772656366,ECE 100,A02,091916,Baghdadchi; Saharnaz,20,0,20,0
1649772662396,ECE 101,A01,084053,Baghdadchi; Saharnaz,33,0,37,4
1649772662396,ECE 101,A02,084054,Baghdadchi; Saharnaz,37,0,37,0
1649772668434,ECE 107,A01,083390,Staff,36,0,40,4
1649772674458,ECE 148,A01,084056,Silberman; Jack,10,0,12,2
1649772680484,ECE 180,A00,083391,Abi Samra; Nicholas Camill,28,0,30,2
1649772680484,ECE 180,B00,083392,Abi Samra; Nicholas Camill,28,0,30,2
1649772686516,MATH 10B,A01,084110,Staff,26,0,30,4
1649772686516,MATH 10B,A02,084111,Staff,30,0,30,0
1649772686516,MATH 10B,A03,084112,Staff,30,0,30,0
1649772692546,MATH 10C,A01,083443,Staff,28,0,30,2
1649772692546,MATH 10C,A02,083444,Staff,27,0,30,3
1649772692546,MATH 10C,B01,084114,Staff,29,0,30,1
1649772692546,MATH 10C,B02,084115,Staff,30,0,30,0
1649772698575,MATH 18,A01,084117,Harel; Guershon,28,0,30,2
1649772698575,MATH 18,A02,084119,Harel; Guershon,29,0,30,1
1649772698575,MATH 18,A03,084120,Harel; Guershon,30,0,30,0
1649772698575,MATH 18,A04,084121,Harel; Guershon,30,0,30,0
1649772704604,MATH 20B,A01,084124,Um; Ko Woon,34,0,35,1
1649772704604,MATH 20B,B01,084126,Um; Ko Woon,35,0,35,0
1649772710630,MATH 20C,A01,083446,Hammock; Frances H,29,0,30,1
1649772710630,MATH 20C,A02,083447,Hammock; Frances H,30,0,30,0
1649772710630,MATH 20C,A03,083448,Hammock; Frances H,30,0,30,0
1649772710630,MATH 20C,A04,083449,Hammock; Frances H,30,0,30,0
1649772710630,MATH 20C,B01,083451,Hammock; Frances H,30,0,30,0
1649772710630,MATH 20C,B02,083452,Hammock; Frances H,30,0,30,0
1649772710630,MATH 20C,B03,083453,Hammock; Frances H,30,0,30,0
1649772710630,MATH 20C,B04,083454,Hammock; Frances H,30,0,30,0
1649772716657,MATH 20D,A01,084128,Staff,30,0,30,0
1649772716657,MATH 20D,A02,084129,Staff,30,0,30,0
1649772716657,MATH 20D,A03,084130,Staff,29,0,30,1
1649772716657,MATH 20D,B01,084133,Staff,30,0,30,0
1649772716657,MATH 20D,B02,084134,Staff,30,0,30,0
1649772716657,MATH 20D,B03,084135,Staff,30,0,30,0
1649772722682,MATH 20E,A01,084138,Staff,30,0,30,0
1649772722682,MATH 20E,A02,084139,Staff,29,0,30,1
1649772722682,MATH 20E,A03,084140,Staff,30,0,30,0
1649772722682,MATH 20E,A04,084141,Staff,30,0,30,0
1649772728806,MATH 102,A01,084143,Harel; Guershon,27,0,30,3
1649772728806,MATH 102,A02,084144,Harel; Guershon,29,0,30,1
1649772734834,MATH 103B,A01,083456,Staff,22,0,30,8
1649772734834,MATH 103B,A02,083457,Staff,28,0,30,2
1649772740860,MATH 109,A01,084146,Salehi Golsefidy; Alireza,30,0,30,0
1649772740860,MATH 109,A02,084147,Salehi Golsefidy; Alireza,29,0,30,1
1649772746886,MATH 120A,A01,085445,Eggers; John Dietrich,32,0,35,3
1649772746886,MATH 120A,A02,085446,Eggers; John Dietrich,34,0,35,1
1649772752915,MATH 142B,A01,084149,Verstraete; Jacques Allan,26,0,30,4
1649772752915,MATH 142B,A02,084150,Verstraete; Jacques Allan,28,0,30,2
1649772758943,MATH 170A,A01,083459,Nie; Jiawang,22,0,30,8
1649772758943,MATH 170A,A02,083460,Nie; Jiawang,28,0,30,2
1649772758943,MATH 170A,A03,083461,Nie; Jiawang,30,0,30,0
1649772764968,MATH 193B,A01,083463,Staff,25,0,30,5
1649772764968,MATH 193B,A02,083464,Staff,29,0,30,1
1649772764968,MATH 193B,A03,083465,Staff,30,0,30,0
1649772771028,COGS 2,A01,083966,Boyle; Mary E. T.,28,0,30,2
1649772777053,COGS 9,A01,083968,Staff,59,0,60,1
1649772783082,COGS 14B,A01,083970,Staff,50,0,50,0
1649772789105,COGS 100,A01,083972,Staff,58,0,60,2
1649772801166,COGS 101C,A01,083976,Staff,30,0,30,0
1649772807200,COGS 102A,A01,083978,Johnson; Christine M.,30,0,30,0
1649772813229,COGS 107B,A01,083980,Staff,46,0,50,4
1649772819255,COGS 115,A01,083982,Staff,27,0,30,3
1649772825284,COGS 118B,A01,083367,Staff,26,0,40,14
1649772831315,COGS 172,A01,083984,Provenzano; Emily Kara,25,0,30,5
1649772837343,COGS 177,A00,083368,Staff,22,0,30,8
1649772843369,COGS 186,A01,083986,Staff,31,0,40,9
1649772849395,COGS 187A,A01,083988,Boyle; Mary E. T.,56,0,60,4
1649772855422,CSE 8A,A50,084003,Miranda; Gregory Joseph,13,0,15,2
1649772861448,CSE 11,A01,084005,Miranda; Gregory Joseph,52,0,55,3
1649772867474,CSE 20,A01,084007,Staff,17,0,20,3
1649772873498,CSE 21,A01,084009,Staff,50,0,50,0
1649772879529,CSE 30,A01,083370,Cao; Yingjun,38,0,40,2
1649772885553,CSE 100,A01,083372,Cao; Yingjun,37,0,40,3
1649772891577,CSE 101,A01,084011,Staff,25,0,40,15
1649772897601,CSE 141,A01,083374,Eldon; John,46,0,75,29
1649772903626,CSE 141L,A01,083376,Eldon; John,48,0,75,27
1649772909659,CSE 175,A01,084013,Kumar; Rakesh,25,0,25,0
1649772915689,ECE 5,A01,084049,Morris; Karcher William,19,0,20,1
1649772921717,ECE 100,A01,084051,Baghdadchi; Saharnaz,18,0,20,2
1649772921717,ECE 100,A02,091916,Baghdadchi; Saharnaz,20,0,20,0
1649772927742,ECE 101,A01,084053,Baghdadchi; Saharnaz,33,0,37,4
1649772927742,ECE 101,A02,084054,Baghdadchi; Saharnaz,37,0,37,0
1649772933766,ECE 107,A01,083390,Staff,36,0,40,4
1649772939793,ECE 148,A01,084056,Silberman; Jack,10,0,12,2
1649772945820,ECE 180,A00,083391,Abi Samra; Nicholas Camill,28,0,30,2
1649772945820,ECE 180,B00,083392,Abi Samra; Nicholas Camill,28,0,30,2
1649772951849,MATH 10B,A01,084110,Staff,26,0,30,4
1649772951849,MATH 10B,A02,084111,Staff,30,0,30,0
1649772951849,MATH 10B,A03,084112,Staff,30,0,30,0
1649772957879,MATH 10C,A01,083443,Staff,28,0,30,2
1649772957879,MATH 10C,A02,083444,Staff,27,0,30,3
1649772957879,MATH 10C,B01,084114,Staff,29,0,30,1
1649772957879,MATH 10C,B02,084115,Staff,30,0,30,0
1649772963908,MATH 18,A01,084117,Harel; Guershon,28,0,30,2
1649772963908,MATH 18,A02,084119,Harel; Guershon,29,0,30,1
1649772963908,MATH 18,A03,084120,Harel; Guershon,30,0,30,0
1649772963908,MATH 18,A04,084121,Harel; Guershon,30,0,30,0
1649772969938,MATH 20B,A01,084124,Um; Ko Woon,34,0,35,1
1649772969938,MATH 20B,B01,084126,Um; Ko Woon,35,0,35,0
1649772975987,MATH 20C,A01,083446,Hammock; Frances H,29,0,30,1
1649772975987,MATH 20C,A02,083447,Hammock; Frances H,30,0,30,0
1649772975987,MATH 20C,A03,083448,Hammock; Frances H,30,0,30,0
1649772975987,MATH 20C,A04,083449,Hammock; Frances H,30,0,30,0
1649772975987,MATH 20C,B01,083451,Hammock; Frances H,30,0,30,0
1649772975987,MATH 20C,B02,083452,Hammock; Frances H,30,0,30,0
1649772975987,MATH 20C,B03,083453,Hammock; Frances H,30,0,30,0
1649772975987,MATH 20C,B04,083454,Hammock; Frances H,30,0,30,0
1649772982018,MATH 20D,A01,084128,Staff,30,0,30,0
1649772982018,MATH 20D,A02,084129,Staff,30,0,30,0
1649772982018,MATH 20D,A03,084130,Staff,29,0,30,1
1649772982018,MATH 20D,B01,084133,Staff,30,0,30,0
1649772982018,MATH 20D,B02,084134,Staff,30,0,30,0
1649772982018,MATH 20D,B03,084135,Staff,30,0,30,0
1649772988042,MATH 20E,A01,084138,Staff,30,0,30,0
1649772988042,MATH 20E,A02,084139,Staff,29,0,30,1
1649772988042,MATH 20E,A03,084140,Staff,30,0,30,0
1649772988042,MATH 20E,A04,084141,Staff,30,0,30,0
1649772994072,MATH 102,A01,084143,Harel; Guershon,27,0,30,3
1649772994072,MATH 102,A02,084144,Harel; Guershon,29,0,30,1
1649773000096,MATH 103B,A01,083456,Staff,22,0,30,8
1649773000096,MATH 103B,A02,083457,Staff,28,0,30,2
1649773006125,MATH 109,A01,084146,Salehi Golsefidy; Alireza,30,0,30,0
1649773006125,MATH 109,A02,084147,Salehi Golsefidy; Alireza,29,0,30,1
1649773012148,MATH 120A,A01,085445,Eggers; John Dietrich,32,0,35,3
1649773012148,MATH 120A,A02,085446,Eggers; John Dietrich,34,0,35,1
1649773018177,MATH 142B,A01,084149,Verstraete; Jacques Allan,26,0,30,4
1649773018177,MATH 142B,A02,084150,Verstraete; Jacques Allan,28,0,30,2
1649773024210,MATH 170A,A01,083459,Nie; Jiawang,22,0,30,8
1649773024210,MATH 170A,A02,083460,Nie; Jiawang,28,0,30,2
1649773024210,MATH 170A,A03,083461,Nie; Jiawang,30,0,30,0
1649773030239,MATH 193B,A01,083463,Staff,25,0,30,5
1649773030239,MATH 193B,A02,083464,Staff,29,0,30,1
1649773030239,MATH 193B,A03,083465,Staff,30,0,30,0
1649773036308,COGS 2,A01,083966,Boyle; Mary E. T.,28,0,30,2
1649773042332,COGS 9,A01,083968,Staff,59,0,60,1
1649773048361,COGS 14B,A01,083970,Staff,50,0,50,0
1649773054390,COGS 100,A01,083972,Staff,58,0,60,2
1649773066437,COGS 101C,A01,083976,Staff,30,0,30,0
1649773072463,COGS 102A,A01,083978,Johnson; Christine M.,30,0,30,0
1649773078496,COGS 107B,A01,083980,Staff,46,0,50,4
1649773084521,COGS 115,A01,083982,Staff,27,0,30,3
1649773090546,COGS 118B,A01,083367,Staff,26,0,40,14
1649773096571,COGS 172,A01,083984,Provenzano; Emily Kara,25,0,30,5
1649773102599,COGS 177,A00,083368,Staff,22,0,30,8
1649773108622,COGS 186,A01,083986,Staff,31,0,40,9
1649773114663,COGS 187A,A01,083988,Boyle; Mary E. T.,56,0,60,4
1649773120692,CSE 8A,A50,084003,Miranda; Gregory Joseph,13,0,15,2
1649773126725,CSE 11,A01,084005,Miranda; Gregory Joseph,52,0,55,3
1649773132753,CSE 20,A01,084007,Staff,17,0,20,3
1649773138781,CSE 21,A01,084009,Staff,50,0,50,0
1649773144818,CSE 30,A01,083370,Cao; Yingjun,38,0,40,2
1649773150843,CSE 100,A01,083372,Cao; Yingjun,37,0,40,3
1649773156873,CSE 101,A01,084011,Staff,25,0,40,15
1649773162910,CSE 141,A01,083374,Eldon; John,46,0,75,29
1649773168936,CSE 141L,A01,083376,Eldon; John,48,0,75,27
1649773174963,CSE 175,A01,084013,Kumar; Rakesh,25,0,25,0
1649773180988,ECE 5,A01,084049,Morris; Karcher William,19,0,20,1
1649773187026,ECE 100,A01,084051,Baghdadchi; Saharnaz,18,0,20,2
1649773187026,ECE 100,A02,091916,Baghdadchi; Saharnaz,20,0,20,0
1649773193051,ECE 101,A01,084053,Baghdadchi; Saharnaz,33,0,37,4
1649773193051,ECE 101,A02,084054,Baghdadchi; Saharnaz,37,0,37,0
1649773199075,ECE 107,A01,083390,Staff,36,0,40,4
1649773205101,ECE 148,A01,084056,Silberman; Jack,10,0,12,2
1649773211126,ECE 180,A00,083391,Abi Samra; Nicholas Camill,28,0,30,2
1649773211126,ECE 180,B00,083392,Abi Samra; Nicholas Camill,28,0,30,2
1649773217155,MATH 10B,A01,084110,Staff,26,0,30,4
1649773217155,MATH 10B,A02,084111,Staff,30,0,30,0
1649773217155,MATH 10B,A03,084112,Staff,30,0,30,0
1649773223182,MATH 10C,A01,083443,Staff,28,0,30,2
1649773223182,MATH 10C,A02,083444,Staff,27,0,30,3
1649773223182,MATH 10C,B01,084114,Staff,29,0,30,1
1649773223182,MATH 10C,B02,084115,Staff,30,0,30,0
1649773229212,MATH 18,A01,084117,Harel; Guershon,28,0,30,2
1649773229212,MATH 18,A02,084119,Harel; Guershon,29,0,30,1
1649773229212,MATH 18,A03,084120,Harel; Guershon,30,0,30,0
1649773229212,MATH 18,A04,084121,Harel; Guershon,30,0,30,0
1649773235240,MATH 20B,A01,084124,Um; Ko Woon,34,0,35,1
1649773235240,MATH 20B,B01,084126,Um; Ko Woon,35,0,35,0
1649773241265,MATH 20C,A01,083446,Hammock; Frances H,29,0,30,1
1649773241265,MATH 20C,A02,083447,Hammock; Frances H,30,0,30,0
1649773241265,MATH 20C,A03,083448,Hammock; Frances H,30,0,30,0
1649773241265,MATH 20C,A04,083449,Hammock; Frances H,30,0,30,0
1649773241265,MATH 20C,B01,083451,Hammock; Frances H,30,0,30,0
1649773241265,MATH 20C,B02,083452,Hammock; Frances H,30,0,30,0
1649773241265,MATH 20C,B03,083453,Hammock; Frances H,30,0,30,0
1649773241265,MATH 20C,B04,083454,Hammock; Frances H,30,0,30,0
1649773247295,MATH 20D,A01,084128,Staff,30,0,30,0
1649773247295,MATH 20D,A02,084129,Staff,30,0,30,0
1649773247295,MATH 20D,A03,084130,Staff,29,0,30,1
1649773247295,MATH 20D,B01,084133,Staff,30,0,30,0
1649773247295,MATH 20D,B02,084134,Staff,30,0,30,0
1649773247295,MATH 20D,B03,084135,Staff,30,0,30,0
1649773253321,MATH 20E,A01,084138,Staff,30,0,30,0
1649773253321,MATH 20E,A02,084139,Staff,29,0,30,1
1649773253321,MATH 20E,A03,084140,Staff,30,0,30,0
1649773253321,MATH 20E,A04,084141,Staff,30,0,30,0
1649773259352,MATH 102,A01,084143,Harel; Guershon,27,0,30,3
1649773259352,MATH 102,A02,084144,Harel; Guershon,29,0,30,1
1649773265382,MATH 103B,A01,083456,Staff,22,0,30,8
1649773265382,MATH 103B,A02,083457,Staff,28,0,30,2
1649773271407,MATH 109,A01,084146,Salehi Golsefidy; Alireza,30,0,30,0
1649773271407,MATH 109,A02,084147,Salehi Golsefidy; Alireza,29,0,30,1
1649773277434,MATH 120A,A01,085445,Eggers; John Dietrich,32,0,35,3
1649773277434,MATH 120A,A02,085446,Eggers; John Dietrich,34,0,35,1
1649773283457,MATH 142B,A01,084149,Verstraete; Jacques Allan,26,0,30,4
1649773283457,MATH 142B,A02,084150,Verstraete; Jacques Allan,28,0,30,2
1649773289481,MATH 170A,A01,083459,Nie; Jiawang,22,0,30,8
1649773289481,MATH 170A,A02,083460,Nie; Jiawang,28,0,30,2
1649773289481,MATH 170A,A03,083461,Nie; Jiawang,30,0,30,0
1649773295518,MATH 193B,A01,083463,Staff,25,0,30,5
1649773295518,MATH 193B,A02,083464,Staff,29,0,30,1
1649773295518,MATH 193B,A03,083465,Staff,30,0,30,0
1649773301576,COGS 2,A01,083966,Boyle; Mary E. T.,28,0,30,2
1649773307604,COGS 9,A01,083968,Staff,59,0,60,1
1649773313629,COGS 14B,A01,083970,Staff,50,0,50,0
1649773319761,COGS 100,A01,083972,Staff,58,0,60,2
1649773331812,COGS 101C,A01,083976,Staff,30,0,30,0
1649773337837,COGS 102A,A01,083978,Johnson; Christine M.,30,0,30,0
1649773343868,COGS 107B,A01,083980,Staff,46,0,50,4
1649773349893,COGS 115,A01,083982,Staff,27,0,30,3
1649773355922,COGS 118B,A01,083367,Staff,26,0,40,14
1649773361947,COGS 172,A01,083984,Provenzano; Emily Kara,25,0,30,5
1649773367986,COGS 177,A00,083368,Staff,22,0,30,8
1649773374014,COGS 186,A01,083986,Staff,31,0,40,9
1649773380040,COGS 187A,A01,083988,Boyle; Mary E. T.,56,0,60,4
1649773386066,CSE 8A,A50,084003,Miranda; Gregory Joseph,13,0,15,2
1649773392094,CSE 11,A01,084005,Miranda; Gregory Joseph,52,0,55,3
1649773398122,CSE 20,A01,084007,Staff,17,0,20,3
1649773404150,CSE 21,A01,084009,Staff,50,0,50,0
1649773410182,CSE 30,A01,083370,Cao; Yingjun,38,0,40,2
1649773416211,CSE 100,A01,083372,Cao; Yingjun,37,0,40,3
1649773422240,CSE 101,A01,084011,Staff,25,0,40,15
1649773428265,CSE 141,A01,083374,Eldon; John,46,0,75,29
1649773434289,CSE 141L,A01,083376,Eldon; John,48,0,75,27
1649773440314,CSE 175,A01,084013,Kumar; Rakesh,25,0,25,0
1649773446337,ECE 5,A01,084049,Morris; Karcher William,19,0,20,1
1649773452363,ECE 100,A01,084051,Baghdadchi; Saharnaz,18,0,20,2
1649773452363,ECE 100,A02,091916,Baghdadchi; Saharnaz,20,0,20,0
1649773458390,ECE 101,A01,084053,Baghdadchi; Saharnaz,33,0,37,4
1649773458390,ECE 101,A02,084054,Baghdadchi; Saharnaz,37,0,37,0
1649773464420,ECE 107,A01,083390,Staff,36,0,40,4
1649773470445,ECE 148,A01,084056,Silberman; Jack,10,0,12,2
1649773476491,ECE 180,A00,083391,Abi Samra; Nicholas Camill,28,0,30,2
1649773476491,ECE 180,B00,083392,Abi Samra; Nicholas Camill,28,0,30,2
1649773482521,MATH 10B,A01,084110,Staff,26,0,30,4
1649773482521,MATH 10B,A02,084111,Staff,30,0,30,0
1649773482521,MATH 10B,A03,084112,Staff,30,0,30,0
1649773488545,MATH 10C,A01,083443,Staff,28,0,30,2
1649773488545,MATH 10C,A02,083444,Staff,27,0,30,3
1649773488545,MATH 10C,B01,084114,Staff,29,0,30,1
1649773488545,MATH 10C,B02,084115,Staff,30,0,30,0
1649773494570,MATH 18,A01,084117,Harel; Guershon,28,0,30,2
1649773494570,MATH 18,A02,084119,Harel; Guershon,29,0,30,1
1649773494570,MATH 18,A03,084120,Harel; Guershon,30,0,30,0
1649773494570,MATH 18,A04,084121,Harel; Guershon,30,0,30,0
1649773500603,MATH 20B,A01,084124,Um; Ko Woon,34,0,35,1
1649773500603,MATH 20B,B01,084126,Um; Ko Woon,35,0,35,0
1649773506634,MATH 20C,A01,083446,Hammock; Frances H,29,0,30,1
1649773506634,MATH 20C,A02,083447,Hammock; Frances H,30,0,30,0
1649773506634,MATH 20C,A03,083448,Hammock; Frances H,30,0,30,0
1649773506634,MATH 20C,A04,083449,Hammock; Frances H,30,0,30,0
1649773506634,MATH 20C,B01,083451,Hammock; Frances H,30,0,30,0
1649773506634,MATH 20C,B02,083452,Hammock; Frances H,30,0,30,0
1649773506634,MATH 20C,B03,083453,Hammock; Frances H,30,0,30,0
1649773506634,MATH 20C,B04,083454,Hammock; Frances H,30,0,30,0
1649773512669,MATH 20D,A01,084128,Staff,30,0,30,0
1649773512669,MATH 20D,A02,084129,Staff,30,0,30,0
1649773512669,MATH 20D,A03,084130,Staff,29,0,30,1
1649773512669,MATH 20D,B01,084133,Staff,30,0,30,0
1649773512669,MATH 20D,B02,084134,Staff,30,0,30,0
1649773512669,MATH 20D,B03,084135,Staff,30,0,30,0
1649773518696,MATH 20E,A01,084138,Staff,30,0,30,0
1649773518696,MATH 20E,A02,084139,Staff,29,0,30,1
1649773518696,MATH 20E,A03,084140,Staff,30,0,30,0
1649773518696,MATH 20E,A04,084141,Staff,30,0,30,0
1649773524725,MATH 102,A01,084143,Harel; Guershon,27,0,30,3
1649773524725,MATH 102,A02,084144,Harel; Guershon,29,0,30,1
1649773530749,MATH 103B,A01,083456,Staff,22,0,30,8
1649773530749,MATH 103B,A02,083457,Staff,28,0,30,2
1649773536779,MATH 109,A01,084146,Salehi Golsefidy; Alireza,30,0,30,0
1649773536779,MATH 109,A02,084147,Salehi Golsefidy; Alireza,29,0,30,1
1649773542804,MATH 120A,A01,085445,Eggers; John Dietrich,32,0,35,3
1649773542804,MATH 120A,A02,085446,Eggers; John Dietrich,34,0,35,1
1649773548841,MATH 142B,A01,084149,Verstraete; Jacques Allan,26,0,30,4
1649773548841,MATH 142B,A02,084150,Verstraete; Jacques Allan,28,0,30,2
1649773554870,MATH 170A,A01,083459,Nie; Jiawang,22,0,30,8
1649773554870,MATH 170A,A02,083460,Nie; Jiawang,28,0,30,2
1649773554870,MATH 170A,A03,083461,Nie; Jiawang,30,0,30,0
1649773560895,MATH 193B,A01,083463,Staff,25,0,30,5
1649773560895,MATH 193B,A02,083464,Staff,29,0,30,1
1649773560895,MATH 193B,A03,083465,Staff,30,0,30,0
1649773566953,COGS 2,A01,083966,Boyle; Mary E. T.,28,0,30,2
1649773572981,COGS 9,A01,083968,Staff,59,0,60,1
1649773579007,COGS 14B,A01,083970,Staff,50,0,50,0
1649773585032,COGS 100,A01,083972,Staff,58,0,60,2
1649773597081,COGS 101C,A01,083976,Staff,30,0,30,0
1649773603109,COGS 102A,A01,083978,Johnson; Christine M.,30,0,30,0
1649773609134,COGS 107B,A01,083980,Staff,46,0,50,4
1649773615164,COGS 115,A01,083982,Staff,27,0,30,3
1649773621192,COGS 118B,A01,083367,Staff,26,0,40,14
1649773627220,COGS 172,A01,083984,Provenzano; Emily Kara,25,0,30,5
1649773633245,COGS 177,A00,083368,Staff,22,0,30,8
1649773639270,COGS 186,A01,083986,Staff,31,0,40,9
1649773645295,COGS 187A,A01,083988,Boyle; Mary E. T.,56,0,60,4
1649773651325,CSE 8A,A50,084003,Miranda; Gregory Joseph,13,0,15,2
1649773657355,CSE 11,A01,084005,Miranda; Gregory Joseph,52,0,55,3
1649773663384,CSE 20,A01,084007,Staff,17,0,20,3
1649773669408,CSE 21,A01,084009,Staff,50,0,50,0
1649773675445,CSE 30,A01,083370,Cao; Yingjun,38,0,40,2
1649773681471,CSE 100,A01,083372,Cao; Yingjun,37,0,40,3
1649773687500,CSE 101,A01,084011,Staff,25,0,40,15
1649773693525,CSE 141,A01,083374,Eldon; John,46,0,75,29
1649773699550,CSE 141L,A01,083376,Eldon; John,48,0,75,27
1649773705576,CSE 175,A01,084013,Kumar; Rakesh,25,0,25,0
1649773711600,ECE 5,A01,084049,Morris; Karcher William,19,0,20,1
1649773717628,ECE 100,A01,084051,Baghdadchi; Saharnaz,18,0,20,2
1649773717628,ECE 100,A02,091916,Baghdadchi; Saharnaz,20,0,20,0
1649773723654,ECE 101,A01,084053,Baghdadchi; Saharnaz,33,0,37,4
1649773723654,ECE 101,A02,084054,Baghdadchi; Saharnaz,37,0,37,0
1649773729679,ECE 107,A01,083390,Staff,36,0,40,4
1649773735704,ECE 148,A01,084056,Silberman; Jack,10,0,12,2
1649773741732,ECE 180,A00,083391,Abi Samra; Nicholas Camill,28,0,30,2
1649773741732,ECE 180,B00,083392,Abi Samra; Nicholas Camill,28,0,30,2
1649773747757,MATH 10B,A01,084110,Staff,26,0,30,4
1649773747757,MATH 10B,A02,084111,Staff,30,0,30,0
1649773747757,MATH 10B,A03,084112,Staff,30,0,30,0
1649773753783,MATH 10C,A01,083443,Staff,28,0,30,2
1649773753783,MATH 10C,A02,083444,Staff,27,0,30,3
1649773753783,MATH 10C,B01,084114,Staff,29,0,30,1
1649773753783,MATH 10C,B02,084115,Staff,30,0,30,0
1649773759809,MATH 18,A01,084117,Harel; Guershon,28,0,30,2
1649773759809,MATH 18,A02,084119,Harel; Guershon,29,0,30,1
1649773759809,MATH 18,A03,084120,Harel; Guershon,30,0,30,0
1649773759809,MATH 18,A04,084121,Harel; Guershon,30,0,30,0
1649773765836,MATH 20B,A01,084124,Um; Ko Woon,34,0,35,1
1649773765836,MATH 20B,B01,084126,Um; Ko Woon,35,0,35,0
1649773771871,MATH 20C,A01,083446,Hammock; Frances H,29,0,30,1
1649773771871,MATH 20C,A02,083447,Hammock; Frances H,30,0,30,0
1649773771871,MATH 20C,A03,083448,Hammock; Frances H,30,0,30,0
1649773771871,MATH 20C,A04,083449,Hammock; Frances H,30,0,30,0
1649773771871,MATH 20C,B01,083451,Hammock; Frances H,30,0,30,0
1649773771871,MATH 20C,B02,083452,Hammock; Frances H,30,0,30,0
1649773771871,MATH 20C,B03,083453,Hammock; Frances H,30,0,30,0
1649773771871,MATH 20C,B04,083454,Hammock; Frances H,30,0,30,0
1649773777896,MATH 20D,A01,084128,Staff,30,0,30,0
1649773777896,MATH 20D,A02,084129,Staff,30,0,30,0
1649773777896,MATH 20D,A03,084130,Staff,29,0,30,1
1649773777896,MATH 20D,B01,084133,Staff,30,0,30,0
1649773777896,MATH 20D,B02,084134,Staff,30,0,30,0
1649773777896,MATH 20D,B03,084135,Staff,30,0,30,0
1649773783923,MATH 20E,A01,084138,Staff,30,0,30,0
1649773783923,MATH 20E,A02,084139,Staff,29,0,30,1
1649773783923,MATH 20E,A03,084140,Staff,30,0,30,0
1649773783923,MATH 20E,A04,084141,Staff,30,0,30,0
1649773789951,MATH 102,A01,084143,Harel; Guershon,27,0,30,3
1649773789951,MATH 102,A02,084144,Harel; Guershon,29,0,30,1
1649773795980,MATH 103B,A01,083456,Staff,22,0,30,8
1649773795980,MATH 103B,A02,083457,Staff,28,0,30,2
1649773802005,MATH 109,A01,084146,Salehi Golsefidy; Alireza,30,0,30,0
1649773802005,MATH 109,A02,084147,Salehi Golsefidy; Alireza,29,0,30,1
1649773808031,MATH 120A,A01,085445,Eggers; John Dietrich,32,0,35,3
1649773808031,MATH 120A,A02,085446,Eggers; John Dietrich,34,0,35,1
1649773814058,MATH 142B,A01,084149,Verstraete; Jacques Allan,26,0,30,4
1649773814058,MATH 142B,A02,084150,Verstraete; Jacques Allan,28,0,30,2
1649773820087,MATH 170A,A01,083459,Nie; Jiawang,22,0,30,8
1649773820087,MATH 170A,A02,083460,Nie; Jiawang,28,0,30,2
1649773820087,MATH 170A,A03,083461,Nie; Jiawang,30,0,30,0
1649773826110,MATH 193B,A01,083463,Staff,25,0,30,5
1649773826110,MATH 193B,A02,083464,Staff,29,0,30,1
1649773826110,MATH 193B,A03,083465,Staff,30,0,30,0
1649773832170,COGS 2,A01,083966,Boyle; Mary E. T.,28,0,30,2
1649773838198,COGS 9,A01,083968,Staff,59,0,60,1
1649773844225,COGS 14B,A01,083970,Staff,50,0,50,0
1649773850251,COGS 100,A01,083972,Staff,58,0,60,2
1649773862303,COGS 101C,A01,083976,Staff,30,0,30,0
1649773868329,COGS 102A,A01,083978,Johnson; Christine M.,30,0,30,0
1649773874353,COGS 107B,A01,083980,Staff,46,0,50,4
1649773880379,COGS 115,A01,083982,Staff,27,0,30,3
1649773886404,COGS 118B,A01,083367,Staff,26,0,40,14
1649773892433,COGS 172,A01,083984,Provenzano; Emily Kara,25,0,30,5
1649773898456,COGS 177,A00,083368,Staff,22,0,30,8
1649773904479,COGS 186,A01,083986,Staff,31,0,40,9
1649773910503,COGS 187A,A01,083988,Boyle; Mary E. T.,56,0,60,4
1649773916615,CSE 8A,A50,084003,Miranda; Gregory Joseph,13,0,15,2
1649773922642,CSE 11,A01,084005,Miranda; Gregory Joseph,52,0,55,3
1649773928667,CSE 20,A01,084007,Staff,17,0,20,3
1649773934695,CSE 21,A01,084009,Staff,50,0,50,0
1649773940725,CSE 30,A01,083370,Cao; Yingjun,38,0,40,2
1649773946749,CSE 100,A01,083372,Cao; Yingjun,37,0,40,3
1649773952774,CSE 101,A01,084011,Staff,25,0,40,15
1649773958803,CSE 141,A01,083374,Eldon; John,46,0,75,29
1649773964841,CSE 141L,A01,083376,Eldon; John,48,0,75,27
1649773970865,CSE 175,A01,084013,Kumar; Rakesh,25,0,25,0
1649773976900,ECE 5,A01,084049,Morris; Karcher William,19,0,20,1
1649773982936,ECE 100,A01,084051,Baghdadchi; Saharnaz,18,0,20,2
1649773982936,ECE 100,A02,091916,Baghdadchi; Saharnaz,20,0,20,0
1649773988971,ECE 101,A01,084053,Baghdadchi; Saharnaz,33,0,37,4
1649773988971,ECE 101,A02,084054,Baghdadchi; Saharnaz,37,0,37,0
1649773994995,ECE 107,A01,083390,Staff,36,0,40,4
1649774001020,ECE 148,A01,084056,Silberman; Jack,10,0,12,2
1649774007049,ECE 180,A00,083391,Abi Samra; Nicholas Camill,28,0,30,2
1649774007049,ECE 180,B00,083392,Abi Samra; Nicholas Camill,28,0,30,2
1649774013078,MATH 10B,A01,084110,Staff,26,0,30,4
1649774013078,MATH 10B,A02,084111,Staff,30,0,30,0
1649774013078,MATH 10B,A03,084112,Staff,30,0,30,0
1649774019113,MATH 10C,A01,083443,Staff,28,0,30,2
1649774019113,MATH 10C,A02,083444,Staff,27,0,30,3
1649774019113,MATH 10C,B01,084114,Staff,29,0,30,1
1649774019113,MATH 10C,B02,084115,Staff,30,0,30,0
1649774025141,MATH 18,A01,084117,Harel; Guershon,28,0,30,2
1649774025141,MATH 18,A02,084119,Harel; Guershon,29,0,30,1
1649774025141,MATH 18,A03,084120,Harel; Guershon,30,0,30,0
1649774025141,MATH 18,A04,084121,Harel; Guershon,30,0,30,0
1649774031166,MATH 20B,A01,084124,Um; Ko Woon,34,0,35,1
1649774031166,MATH 20B,B01,084126,Um; Ko Woon,35,0,35,0
1649774037190,MATH 20C,A01,083446,Hammock; Frances H,29,0,30,1
1649774037190,MATH 20C,A02,083447,Hammock; Frances H,30,0,30,0
1649774037190,MATH 20C,A03,083448,Hammock; Frances H,30,0,30,0
1649774037190,MATH 20C,A04,083449,Hammock; Frances H,30,0,30,0
1649774037190,MATH 20C,B01,083451,Hammock; Frances H,30,0,30,0
1649774037190,MATH 20C,B02,083452,Hammock; Frances H,30,0,30,0
1649774037190,MATH 20C,B03,083453,Hammock; Frances H,30,0,30,0
1649774037190,MATH 20C,B04,083454,Hammock; Frances H,30,0,30,0
1649774043217,MATH 20D,A01,084128,Staff,30,0,30,0
1649774043217,MATH 20D,A02,084129,Staff,30,0,30,0
1649774043217,MATH 20D,A03,084130,Staff,29,0,30,1
1649774043217,MATH 20D,B01,084133,Staff,30,0,30,0
1649774043217,MATH 20D,B02,084134,Staff,30,0,30,0
1649774043217,MATH 20D,B03,084135,Staff,30,0,30,0
1649774049245,MATH 20E,A01,084138,Staff,30,0,30,0
1649774049245,MATH 20E,A02,084139,Staff,29,0,30,1
1649774049245,MATH 20E,A03,084140,Staff,30,0,30,0
1649774049245,MATH 20E,A04,084141,Staff,30,0,30,0
1649774055278,MATH 102,A01,084143,Harel; Guershon,27,0,30,3
1649774055278,MATH 102,A02,084144,Harel; Guershon,29,0,30,1
1649774061304,MATH 103B,A01,083456,Staff,22,0,30,8
1649774061304,MATH 103B,A02,083457,Staff,28,0,30,2
1649774067331,MATH 109,A01,084146,Salehi Golsefidy; Alireza,30,0,30,0
1649774067331,MATH 109,A02,084147,Salehi Golsefidy; Alireza,29,0,30,1
1649774073362,MATH 120A,A01,085445,Eggers; John Dietrich,32,0,35,3
1649774073362,MATH 120A,A02,085446,Eggers; John Dietrich,34,0,35,1
1649774079386,MATH 142B,A01,084149,Verstraete; Jacques Allan,26,0,30,4
1649774079386,MATH 142B,A02,084150,Verstraete; Jacques Allan,28,0,30,2
1649774085422,MATH 170A,A01,083459,Nie; Jiawang,22,0,30,8
1649774085422,MATH 170A,A02,083460,Nie; Jiawang,28,0,30,2
1649774085422,MATH 170A,A03,083461,Nie; Jiawang,30,0,30,0
1649774091452,MATH 193B,A01,083463,Staff,25,0,30,5
1649774091452,MATH 193B,A02,083464,Staff,29,0,30,1
1649774091452,MATH 193B,A03,083465,Staff,30,0,30,0
1649774097525,COGS 2,A01,083966,Boyle; Mary E. T.,28,0,30,2
1649774103554,COGS 9,A01,083968,Staff,59,0,60,1
1649774109582,COGS 14B,A01,083970,Staff,50,0,50,0
1649774115606,COGS 100,A01,083972,Staff,58,0,60,2
1649774127668,COGS 101C,A01,083976,Staff,30,0,30,0
1649774133700,COGS 102A,A01,083978,Johnson; Christine M.,30,0,30,0
1649774139725,COGS 107B,A01,083980,Staff,46,0,50,4
1649774145750,COGS 115,A01,083982,Staff,27,0,30,3
1649774151781,COGS 118B,A01,083367,Staff,26,0,40,14
1649774157807,COGS 172,A01,083984,Provenzano; Emily Kara,25,0,30,5
1649774163831,COGS 177,A00,083368,Staff,22,0,30,8
1649774169875,COGS 186,A01,083986,Staff,31,0,40,9
1649774175901,COGS 187A,A01,083988,Boyle; Mary E. T.,56,0,60,4
1649774181932,CSE 8A,A50,084003,Miranda; Gregory Joseph,13,0,15,2
1649774187957,CSE 11,A01,084005,Miranda; Gregory Joseph,52,0,55,3
1649774193986,CSE 20,A01,084007,Staff,17,0,20,3
1649774200013,CSE 21,A01,084009,Staff,50,0,50,0
1649774206038,CSE 30,A01,083370,Cao; Yingjun,38,0,40,2
1649774212062,CSE 100,A01,083372,Cao; Yingjun,37,0,40,3
1649774218095,CSE 101,A01,084011,Staff,25,0,40,15
1649774224120,CSE 141,A01,083374,Eldon; John,46,0,75,29
1649774230148,CSE 141L,A01,083376,Eldon; John,48,0,75,27
1649774236176,CSE 175,A01,084013,Kumar; Rakesh,25,0,25,0
1649774242202,ECE 5,A01,084049,Morris; Karcher William,19,0,20,1
1649774248228,ECE 100,A01,084051,Baghdadchi; Saharnaz,18,0,20,2
1649774248228,ECE 100,A02,091916,Baghdadchi; Saharnaz,20,0,20,0
1649774254253,ECE 101,A01,084053,Baghdadchi; Saharnaz,33,0,37,4
1649774254253,ECE 101,A02,084054,Baghdadchi; Saharnaz,37,0,37,0
1649774260283,ECE 107,A01,083390,Staff,36,0,40,4
1649774266317,ECE 148,A01,084056,Silberman; Jack,10,0,12,2
1649774272345,ECE 180,A00,083391,Abi Samra; Nicholas Camill,28,0,30,2
1649774272345,ECE 180,B00,083392,Abi Samra; Nicholas Camill,28,0,30,2
1649774278371,MATH 10B,A01,084110,Staff,26,0,30,4
1649774278371,MATH 10B,A02,084111,Staff,30,0,30,0
1649774278371,MATH 10B,A03,084112,Staff,30,0,30,0
1649774284412,MATH 10C,A01,083443,Staff,28,0,30,2
1649774284412,MATH 10C,A02,083444,Staff,27,0,30,3
1649774284412,MATH 10C,B01,084114,Staff,29,0,30,1
1649774284412,MATH 10C,B02,084115,Staff,30,0,30,0
1649774290443,MATH 18,A01,084117,Harel; Guershon,28,0,30,2
1649774290443,MATH 18,A02,084119,Harel; Guershon,29,0,30,1
1649774290443,MATH 18,A03,084120,Harel; Guershon,30,0,30,0
1649774290443,MATH 18,A04,084121,Harel; Guershon,30,0,30,0
1649774296480,MATH 20B,A01,084124,Um; Ko Woon,34,0,35,1
1649774296480,MATH 20B,B01,084126,Um; Ko Woon,35,0,35,0
1649774302506,MATH 20C,A01,083446,Hammock; Frances H,29,0,30,1
1649774302506,MATH 20C,A02,083447,Hammock; Frances H,30,0,30,0
1649774302506,MATH 20C,A03,083448,Hammock; Frances H,30,0,30,0
1649774302506,MATH 20C,A04,083449,Hammock; Frances H,30,0,30,0
1649774302506,MATH 20C,B01,083451,Hammock; Frances H,30,0,30,0
1649774302506,MATH 20C,B02,083452,Hammock; Frances H,30,0,30,0
1649774302506,MATH 20C,B03,083453,Hammock; Frances H,30,0,30,0
1649774302506,MATH 20C,B04,083454,Hammock; Frances H,30,0,30,0
1649774308531,MATH 20D,A01,084128,Staff,30,0,30,0
1649774308531,MATH 20D,A02,084129,Staff,30,0,30,0
1649774308531,MATH 20D,A03,084130,Staff,29,0,30,1
1649774308531,MATH 20D,B01,084133,Staff,30,0,30,0
1649774308531,MATH 20D,B02,084134,Staff,30,0,30,0
1649774308531,MATH 20D,B03,084135,Staff,30,0,30,0
1649774314562,MATH 20E,A01,084138,Staff,30,0,30,0
1649774314562,MATH 20E,A02,084139,Staff,29,0,30,1
1649774314562,MATH 20E,A03,084140,Staff,30,0,30,0
1649774314562,MATH 20E,A04,084141,Staff,30,0,30,0
1649774320590,MATH 102,A01,084143,Harel; Guershon,27,0,30,3
1649774320590,MATH 102,A02,084144,Harel; Guershon,29,0,30,1
1649774326620,MATH 103B,A01,083456,Staff,22,0,30,8
1649774326620,MATH 103B,A02,083457,Staff,28,0,30,2
1649774332648,MATH 109,A01,084146,Salehi Golsefidy; Alireza,30,0,30,0
1649774332648,MATH 109,A02,084147,Salehi Golsefidy; Alireza,29,0,30,1
1649774338684,MATH 120A,A01,085445,Eggers; John Dietrich,32,0,35,3
1649774338684,MATH 120A,A02,085446,Eggers; John Dietrich,34,0,35,1
1649774344710,MATH 142B,A01,084149,Verstraete; Jacques Allan,26,0,30,4
1649774344710,MATH 142B,A02,084150,Verstraete; Jacques Allan,28,0,30,2
1649774350735,MATH 170A,A01,083459,Nie; Jiawang,22,0,30,8
1649774350735,MATH 170A,A02,083460,Nie; Jiawang,28,0,30,2
1649774350735,MATH 170A,A03,083461,Nie; Jiawang,30,0,30,0
1649774356765,MATH 193B,A01,083463,Staff,25,0,30,5
1649774356765,MATH 193B,A02,083464,Staff,29,0,30,1
1649774356765,MATH 193B,A03,083465,Staff,30,0,30,0
1649774362838,COGS 2,A01,083966,Boyle; Mary E. T.,28,0,30,2
1649774368865,COGS 9,A01,083968,Staff,59,0,60,1
1649774374891,COGS 14B,A01,083970,Staff,50,0,50,0
1649774380918,COGS 100,A01,083972,Staff,58,0,60,2
1649774392967,COGS 101C,A01,083976,Staff,30,0,30,0
1649774398999,COGS 102A,A01,083978,Johnson; Christine M.,29,0,30,1
1649774405028,COGS 107B,A01,083980,Staff,46,0,50,4
1649774411053,COGS 115,A01,083982,Staff,27,0,30,3
1649774417083,COGS 118B,A01,083367,Staff,26,0,40,14
1649774423109,COGS 172,A01,083984,Provenzano; Emily Kara,25,0,30,5
1649774429133,COGS 177,A00,083368,Staff,22,0,30,8
1649774435161,COGS 186,A01,083986,Staff,31,0,40,9
1649774441184,COGS 187A,A01,083988,Boyle; Mary E. T.,56,0,60,4
1649774447216,CSE 8A,A50,084003,Miranda; Gregory Joseph,13,0,15,2
1649774453241,CSE 11,A01,084005,Miranda; Gregory Joseph,52,0,55,3
1649774459265,CSE 20,A01,084007,Staff,17,0,20,3
1649774465290,CSE 21,A01,084009,Staff,50,0,50,0
1649774471313,CSE 30,A01,083370,Cao; Yingjun,38,0,40,2
1649774477340,CSE 100,A01,083372,Cao; Yingjun,37,0,40,3
1649774483367,CSE 101,A01,084011,Staff,25,0,40,15
1649774489390,CSE 141,A01,083374,Eldon; John,46,0,75,29
1649774495417,CSE 141L,A01,083376,Eldon; John,48,0,75,27
1649774501447,CSE 175,A01,084013,Kumar; Rakesh,25,0,25,0
1649774507473,ECE 5,A01,084049,Morris; Karcher William,19,0,20,1
1649774513610,ECE 100,A01,084051,Baghdadchi; Saharnaz,18,0,20,2
1649774513610,ECE 100,A02,091916,Baghdadchi; Saharnaz,20,0,20,0
1649774519636,ECE 101,A01,084053,Baghdadchi; Saharnaz,33,0,37,4
1649774519636,ECE 101,A02,084054,Baghdadchi; Saharnaz,37,0,37,0
1649774525668,ECE 107,A01,083390,Staff,36,0,40,4
1649774531698,ECE 148,A01,084056,Silberman; Jack,10,0,12,2
1649774537720,ECE 180,A00,083391,Abi Samra; Nicholas Camill,28,0,30,2
1649774537720,ECE 180,B00,083392,Abi Samra; Nicholas Camill,28,0,30,2
1649774543744,MATH 10B,A01,084110,Staff,26,0,30,4
1649774543744,MATH 10B,A02,084111,Staff,30,0,30,0
1649774543744,MATH 10B,A03,084112,Staff,30,0,30,0
1649774549773,MATH 10C,A01,083443,Staff,28,0,30,2
1649774549773,MATH 10C,A02,083444,Staff,27,0,30,3
1649774549773,MATH 10C,B01,084114,Staff,29,0,30,1
1649774549773,MATH 10C,B02,084115,Staff,30,0,30,0
1649774555799,MATH 18,A01,084117,Harel; Guershon,28,0,30,2
1649774555799,MATH 18,A02,084119,Harel; Guershon,29,0,30,1
1649774555799,MATH 18,A03,084120,Harel; Guershon,30,0,30,0
1649774555799,MATH 18,A04,084121,Harel; Guershon,30,0,30,0
1649774561827,MATH 20B,A01,084124,Um; Ko Woon,34,0,35,1
1649774561827,MATH 20B,B01,084126,Um; Ko Woon,35,0,35,0
1649774567852,MATH 20C,A01,083446,Hammock; Frances H,29,0,30,1
1649774567852,MATH 20C,A02,083447,Hammock; Frances H,30,0,30,0
1649774567852,MATH 20C,A03,083448,Hammock; Frances H,30,0,30,0
1649774567852,MATH 20C,A04,083449,Hammock; Frances H,30,0,30,0
1649774567852,MATH 20C,B01,083451,Hammock; Frances H,30,0,30,0
1649774567852,MATH 20C,B02,083452,Hammock; Frances H,30,0,30,0
1649774567852,MATH 20C,B03,083453,Hammock; Frances H,30,0,30,0
1649774567852,MATH 20C,B04,083454,Hammock; Frances H,30,0,30,0
1649774573877,MATH 20D,A01,084128,Staff,30,0,30,0
1649774573877,MATH 20D,A02,084129,Staff,30,0,30,0
1649774573877,MATH 20D,A03,084130,Staff,29,0,30,1
1649774573877,MATH 20D,B01,084133,Staff,30,0,30,0
1649774573877,MATH 20D,B02,084134,Staff,30,0,30,0
1649774573877,MATH 20D,B03,084135,Staff,30,0,30,0
1649774579906,MATH 20E,A01,084138,Staff,30,0,30,0
1649774579906,MATH 20E,A02,084139,Staff,29,0,30,1
1649774579906,MATH 20E,A03,084140,Staff,30,0,30,0
1649774579906,MATH 20E,A04,084141,Staff,30,0,30,0
1649774585943,MATH 102,A01,084143,Harel; Guershon,27,0,30,3
1649774585943,MATH 102,A02,084144,Harel; Guershon,29,0,30,1
1649774591973,MATH 103B,A01,083456,Staff,22,0,30,8
1649774591973,MATH 103B,A02,083457,Staff,28,0,30,2
1649774597996,MATH 109,A01,084146,Salehi Golsefidy; Alireza,30,0,30,0
1649774597996,MATH 109,A02,084147,Salehi Golsefidy; Alireza,29,0,30,1
1649774604023,MATH 120A,A01,085445,Eggers; John Dietrich,32,0,35,3
1649774604023,MATH 120A,A02,085446,Eggers; John Dietrich,34,0,35,1
1649774610051,MATH 142B,A01,084149,Verstraete; Jacques Allan,26,0,30,4
1649774610051,MATH 142B,A02,084150,Verstraete; Jacques Allan,28,0,30,2
1649774616078,MATH 170A,A01,083459,Nie; Jiawang,22,0,30,8
1649774616078,MATH 170A,A02,083460,Nie; Jiawang,28,0,30,2
1649774616078,MATH 170A,A03,083461,Nie; Jiawang,30,0,30,0
1649774622104,MATH 193B,A01,083463,Staff,25,0,30,5
1649774622104,MATH 193B,A02,083464,Staff,29,0,30,1
1649774622104,MATH 193B,A03,083465,Staff,30,0,30,0
1649774628157,COGS 2,A01,083966,Boyle; Mary E. T.,28,0,30,2
1649774634180,COGS 9,A01,083968,Staff,59,0,60,1
1649774640209,COGS 14B,A01,083970,Staff,50,0,50,0
1649774646237,COGS 100,A01,083972,Staff,58,0,60,2
1649774658291,COGS 101C,A01,083976,Staff,30,0,30,0
1649774664313,COGS 102A,A01,083978,Johnson; Christine M.,29,0,30,1
1649774670337,COGS 107B,A01,083980,Staff,46,0,50,4
1649774676362,COGS 115,A01,083982,Staff,27,0,30,3
1649774682389,COGS 118B,A01,083367,Staff,26,0,40,14
1649774688417,COGS 172,A01,083984,Provenzano; Emily Kara,25,0,30,5
1649774694450,COGS 177,A00,083368,Staff,22,0,30,8
1649774700479,COGS 186,A01,083986,Staff,31,0,40,9
1649774706507,COGS 187A,A01,083988,Boyle; Mary E. T.,56,0,60,4
1649774712534,CSE 8A,A50,084003,Miranda; Gregory Joseph,13,0,15,2
1649774718559,CSE 11,A01,084005,Miranda; Gregory Joseph,52,0,55,3
1649774724582,CSE 20,A01,084007,Staff,17,0,20,3
1649774730613,CSE 21,A01,084009,Staff,50,0,50,0
1649774736638,CSE 30,A01,083370,Cao; Yingjun,38,0,40,2
1649774742664,CSE 100,A01,083372,Cao; Yingjun,37,0,40,3
1649774748689,CSE 101,A01,084011,Staff,25,0,40,15
1649774754712,CSE 141,A01,083374,Eldon; John,46,0,75,29
1649774760742,CSE 141L,A01,083376,Eldon; John,48,0,75,27
1649774766771,CSE 175,A01,084013,Kumar; Rakesh,25,0,25,0
1649774772805,ECE 5,A01,084049,Morris; Karcher William,19,0,20,1
1649774778831,ECE 100,A01,084051,Baghdadchi; Saharnaz,18,0,20,2
1649774778831,ECE 100,A02,091916,Baghdadchi; Saharnaz,20,0,20,0
1649774784857,ECE 101,A01,084053,Baghdadchi; Saharnaz,33,0,37,4
1649774784857,ECE 101,A02,084054,Baghdadchi; Saharnaz,37,0,37,0
1649774790880,ECE 107,A01,083390,Staff,36,0,40,4
1649774796904,ECE 148,A01,084056,Silberman; Jack,10,0,12,2
1649774802930,ECE 180,A00,083391,Abi Samra; Nicholas Camill,28,0,30,2
1649774802930,ECE 180,B00,083392,Abi Samra; Nicholas Camill,28,0,30,2
1649774808954,MATH 10B,A01,084110,Staff,26,0,30,4
1649774808954,MATH 10B,A02,084111,Staff,30,0,30,0
1649774808954,MATH 10B,A03,084112,Staff,30,0,30,0
1649774814977,MATH 10C,A01,083443,Staff,28,0,30,2
1649774814977,MATH 10C,A02,083444,Staff,27,0,30,3
1649774814977,MATH 10C,B01,084114,Staff,29,0,30,1
1649774814977,MATH 10C,B02,084115,Staff,30,0,30,0
1649774821005,MATH 18,A01,084117,Harel; Guershon,28,0,30,2
1649774821005,MATH 18,A02,084119,Harel; Guershon,29,0,30,1
1649774821005,MATH 18,A03,084120,Harel; Guershon,30,0,30,0
1649774821005,MATH 18,A04,084121,Harel; Guershon,30,0,30,0
1649774827033,MATH 20B,A01,084124,Um; Ko Woon,34,0,35,1
1649774827033,MATH 20B,B01,084126,Um; Ko Woon,35,0,35,0
1649774833063,MATH 20C,A01,083446,Hammock; Frances H,29,0,30,1
1649774833063,MATH 20C,A02,083447,Hammock; Frances H,30,0,30,0
1649774833063,MATH 20C,A03,083448,Hammock; Frances H,30,0,30,0
1649774833063,MATH 20C,A04,083449,Hammock; Frances H,30,0,30,0
1649774833063,MATH 20C,B01,083451,Hammock; Frances H,30,0,30,0
1649774833063,MATH 20C,B02,083452,Hammock; Frances H,30,0,30,0
1649774833063,MATH 20C,B03,083453,Hammock; Frances H,30,0,30,0
1649774833063,MATH 20C,B04,083454,Hammock; Frances H,30,0,30,0
1649774839087,MATH 20D,A01,084128,Staff,30,0,30,0
1649774839087,MATH 20D,A02,084129,Staff,30,0,30,0
1649774839087,MATH 20D,A03,084130,Staff,29,0,30,1
1649774839087,MATH 20D,B01,084133,Staff,30,0,30,0
1649774839087,MATH 20D,B02,084134,Staff,30,0,30,0
1649774839087,MATH 20D,B03,084135,Staff,30,0,30,0
1649774845115,MATH 20E,A01,084138,Staff,30,0,30,0
1649774845115,MATH 20E,A02,084139,Staff,29,0,30,1
1649774845115,MATH 20E,A03,084140,Staff,30,0,30,0
1649774845115,MATH 20E,A04,084141,Staff,30,0,30,0
1649774851142,MATH 102,A01,084143,Harel; Guershon,27,0,30,3
1649774851142,MATH 102,A02,084144,Harel; Guershon,29,0,30,1
1649774857166,MATH 103B,A01,083456,Staff,22,0,30,8
1649774857166,MATH 103B,A02,083457,Staff,28,0,30,2
1649774863190,MATH 109,A01,084146,Salehi Golsefidy; Alireza,30,0,30,0
1649774863190,MATH 109,A02,084147,Salehi Golsefidy; Alireza,29,0,30,1
1649774869214,MATH 120A,A01,085445,Eggers; John Dietrich,32,0,35,3
1649774869214,MATH 120A,A02,085446,Eggers; John Dietrich,34,0,35,1
1649774875240,MATH 142B,A01,084149,Verstraete; Jacques Allan,26,0,30,4
1649774875240,MATH 142B,A02,084150,Verstraete; Jacques Allan,28,0,30,2
1649774881264,MATH 170A,A01,083459,Nie; Jiawang,22,0,30,8
1649774881264,MATH 170A,A02,083460,Nie; Jiawang,28,0,30,2
1649774881264,MATH 170A,A03,083461,Nie; Jiawang,30,0,30,0
1649774887289,MATH 193B,A01,083463,Staff,25,0,30,5
1649774887289,MATH 193B,A02,083464,Staff,29,0,30,1
1649774887289,MATH 193B,A03,083465,Staff,30,0,30,0
1649774893349,COGS 2,A01,083966,Boyle; Mary E. T.,28,0,30,2
1649774899377,COGS 9,A01,083968,Staff,59,0,60,1
1649774905409,COGS 14B,A01,083970,Staff,50,0,50,0
1649774911439,COGS 100,A01,083972,Staff,58,0,60,2
1649774923489,COGS 101C,A01,083976,Staff,30,0,30,0
1649774929517,COGS 102A,A01,083978,Johnson; Christine M.,29,0,30,1
1649774935548,COGS 107B,A01,083980,Staff,46,0,50,4
1649774941571,COGS 115,A01,083982,Staff,27,0,30,3
1649774947597,COGS 118B,A01,083367,Staff,26,0,40,14
1649774953627,COGS 172,A01,083984,Provenzano; Emily Kara,25,0,30,5
1649774959743,COGS 177,A00,083368,Staff,22,0,30,8
1649774965773,COGS 186,A01,083986,Staff,31,0,40,9
1649774971802,COGS 187A,A01,083988,Boyle; Mary E. T.,56,0,60,4
1649774977829,CSE 8A,A50,084003,Miranda; Gregory Joseph,13,0,15,2
1649774983852,CSE 11,A01,084005,Miranda; Gregory Joseph,52,0,55,3
1649774989875,CSE 20,A01,084007,Staff,17,0,20,3
1649774995903,CSE 21,A01,084009,Staff,50,0,50,0
1649775001932,CSE 30,A01,083370,Cao; Yingjun,38,0,40,2
1649775007957,CSE 100,A01,083372,Cao; Yingjun,37,0,40,3
1649775013985,CSE 101,A01,084011,Staff,25,0,40,15
1649775020008,CSE 141,A01,083374,Eldon; John,46,0,75,29
1649775026032,CSE 141L,A01,083376,Eldon; John,48,0,75,27
1649775032056,CSE 175,A01,084013,Kumar; Rakesh,25,0,25,0
1649775038088,ECE 5,A01,084049,Morris; Karcher William,19,0,20,1
1649775044121,ECE 100,A01,084051,Baghdadchi; Saharnaz,18,0,20,2
1649775044121,ECE 100,A02,091916,Baghdadchi; Saharnaz,20,0,20,0
1649775050149,ECE 101,A01,084053,Baghdadchi; Saharnaz,33,0,37,4
1649775050149,ECE 101,A02,084054,Baghdadchi; Saharnaz,37,0,37,0
1649775056174,ECE 107,A01,083390,Staff,36,0,40,4
1649775062206,ECE 148,A01,084056,Silberman; Jack,10,0,12,2
1649775068232,ECE 180,A00,083391,Abi Samra; Nicholas Camill,28,0,30,2
1649775068232,ECE 180,B00,083392,Abi Samra; Nicholas Camill,28,0,30,2
1649775074268,MATH 10B,A01,084110,Staff,26,0,30,4
1649775074268,MATH 10B,A02,084111,Staff,30,0,30,0
1649775074268,MATH 10B,A03,084112,Staff,30,0,30,0
1649775080292,MATH 10C,A01,083443,Staff,28,0,30,2
1649775080292,MATH 10C,A02,083444,Staff,27,0,30,3
1649775080292,MATH 10C,B01,084114,Staff,29,0,30,1
1649775080292,MATH 10C,B02,084115,Staff,30,0,30,0
1649775086320,MATH 18,A01,084117,Harel; Guershon,28,0,30,2
1649775086320,MATH 18,A02,084119,Harel; Guershon,29,0,30,1
1649775086320,MATH 18,A03,084120,Harel; Guershon,30,0,30,0
1649775086320,MATH 18,A04,084121,Harel; Guershon,30,0,30,0
1649775092344,MATH 20B,A01,084124,Um; Ko Woon,34,0,35,1
1649775092344,MATH 20B,B01,084126,Um; Ko Woon,35,0,35,0
1649775098368,MATH 20C,A01,083446,Hammock; Frances H,29,0,30,1
1649775098368,MATH 20C,A02,083447,Hammock; Frances H,30,0,30,0
1649775098368,MATH 20C,A03,083448,Hammock; Frances H,30,0,30,0
1649775098368,MATH 20C,A04,083449,Hammock; Frances H,30,0,30,0
1649775098368,MATH 20C,B01,083451,Hammock; Frances H,30,0,30,0
1649775098368,MATH 20C,B02,083452,Hammock; Frances H,30,0,30,0
1649775098368,MATH 20C,B03,083453,Hammock; Frances H,30,0,30,0
1649775098368,MATH 20C,B04,083454,Hammock; Frances H,30,0,30,0
1649775104396,MATH 20D,A01,084128,Staff,30,0,30,0
1649775104396,MATH 20D,A02,084129,Staff,30,0,30,0
1649775104396,MATH 20D,A03,084130,Staff,29,0,30,1
1649775104396,MATH 20D,B01,084133,Staff,30,0,30,0
1649775104396,MATH 20D,B02,084134,Staff,30,0,30,0
1649775104396,MATH 20D,B03,084135,Staff,30,0,30,0
1649775110516,MATH 20E,A01,084138,Staff,30,0,30,0
1649775110516,MATH 20E,A02,084139,Staff,29,0,30,1
1649775110516,MATH 20E,A03,084140,Staff,30,0,30,0
1649775110516,MATH 20E,A04,084141,Staff,30,0,30,0
1649775116546,MATH 102,A01,084143,Harel; Guershon,27,0,30,3
1649775116546,MATH 102,A02,084144,Harel; Guershon,29,0,30,1
1649775122574,MATH 103B,A01,083456,Staff,22,0,30,8
1649775122574,MATH 103B,A02,083457,Staff,28,0,30,2
1649775128597,MATH 109,A01,084146,Salehi Golsefidy; Alireza,30,0,30,0
1649775128597,MATH 109,A02,084147,Salehi Golsefidy; Alireza,29,0,30,1
1649775134623,MATH 120A,A01,085445,Eggers; John Dietrich,32,0,35,3
1649775134623,MATH 120A,A02,085446,Eggers; John Dietrich,34,0,35,1
1649775140651,MATH 142B,A01,084149,Verstraete; Jacques Allan,26,0,30,4
1649775140651,MATH 142B,A02,084150,Verstraete; Jacques Allan,28,0,30,2
1649775146679,MATH 170A,A01,083459,Nie; Jiawang,22,0,30,8
1649775146679,MATH 170A,A02,083460,Nie; Jiawang,28,0,30,2
1649775146679,MATH 170A,A03,083461,Nie; Jiawang,30,0,30,0
1649775152703,MATH 193B,A01,083463,Staff,25,0,30,5
1649775152703,MATH 193B,A02,083464,Staff,29,0,30,1
1649775152703,MATH 193B,A03,083465,Staff,30,0,30,0
1649775158764,COGS 2,A01,083966,Boyle; Mary E. T.,28,0,30,2
1649775164792,COGS 9,A01,083968,Staff,59,0,60,1
1649775170819,COGS 14B,A01,083970,Staff,50,0,50,0
1649775176843,COGS 100,A01,083972,Staff,58,0,60,2
1649775188898,COGS 101C,A01,083976,Staff,30,0,30,0
1649775194926,COGS 102A,A01,083978,Johnson; Christine M.,29,0,30,1
1649775200949,COGS 107B,A01,083980,Staff,46,0,50,4
1649775206976,COGS 115,A01,083982,Staff,27,0,30,3
1649775213013,COGS 118B,A01,083367,Staff,26,0,40,14
1649775219041,COGS 172,A01,083984,Provenzano; Emily Kara,25,0,30,5
1649775225063,COGS 177,A00,083368,Staff,22,0,30,8
1649775231099,COGS 186,A01,083986,Staff,31,0,40,9
1649775237127,COGS 187A,A01,083988,Boyle; Mary E. T.,56,0,60,4
1649775243157,CSE 8A,A50,084003,Miranda; Gregory Joseph,13,0,15,2
1649775249183,CSE 11,A01,084005,Miranda; Gregory Joseph,52,0,55,3
1649775255214,CSE 20,A01,084007,Staff,17,0,20,3
1649775261256,CSE 21,A01,084009,Staff,50,0,50,0
1649775267281,CSE 30,A01,083370,Cao; Yingjun,38,0,40,2
1649775273305,CSE 100,A01,083372,Cao; Yingjun,37,0,40,3
1649775279331,CSE 101,A01,084011,Staff,25,0,40,15
1649775285368,CSE 141,A01,083374,Eldon; John,46,0,75,29
1649775291420,CSE 141L,A01,083376,Eldon; John,48,0,75,27
1649775297445,CSE 175,A01,084013,Kumar; Rakesh,25,0,25,0
1649775303480,ECE 5,A01,084049,Morris; Karcher William,19,0,20,1
1649775309507,ECE 100,A01,084051,Baghdadchi; Saharnaz,18,0,20,2
1649775309507,ECE 100,A02,091916,Baghdadchi; Saharnaz,20,0,20,0
1649775315540,ECE 101,A01,084053,Baghdadchi; Saharnaz,33,0,37,4
1649775315540,ECE 101,A02,084054,Baghdadchi; Saharnaz,37,0,37,0
1649775321565,ECE 107,A01,083390,Staff,36,0,40,4
1649775327591,ECE 148,A01,084056,Silberman; Jack,10,0,12,2
1649775333616,ECE 180,A00,083391,Abi Samra; Nicholas Camill,28,0,30,2
1649775333616,ECE 180,B00,083392,Abi Samra; Nicholas Camill,28,0,30,2
1649775339641,MATH 10B,A01,084110,Staff,26,0,30,4
1649775339641,MATH 10B,A02,084111,Staff,30,0,30,0
1649775339641,MATH 10B,A03,084112,Staff,30,0,30,0
1649775345674,MATH 10C,A01,083443,Staff,28,0,30,2
1649775345674,MATH 10C,A02,083444,Staff,27,0,30,3
1649775345674,MATH 10C,B01,084114,Staff,29,0,30,1
1649775345674,MATH 10C,B02,084115,Staff,30,0,30,0
1649775351701,MATH 18,A01,084117,Harel; Guershon,28,0,30,2
1649775351701,MATH 18,A02,084119,Harel; Guershon,29,0,30,1
1649775351701,MATH 18,A03,084120,Harel; Guershon,30,0,30,0
1649775351701,MATH 18,A04,084121,Harel; Guershon,30,0,30,0
1649775357728,MATH 20B,A01,084124,Um; Ko Woon,34,0,35,1
1649775357728,MATH 20B,B01,084126,Um; Ko Woon,35,0,35,0
1649775363755,MATH 20C,A01,083446,Hammock; Frances H,29,0,30,1
1649775363755,MATH 20C,A02,083447,Hammock; Frances H,30,0,30,0
1649775363755,MATH 20C,A03,083448,Hammock; Frances H,30,0,30,0
1649775363755,MATH 20C,A04,083449,Hammock; Frances H,30,0,30,0
1649775363755,MATH 20C,B01,083451,Hammock; Frances H,30,0,30,0
1649775363755,MATH 20C,B02,083452,Hammock; Frances H,30,0,30,0
1649775363755,MATH 20C,B03,083453,Hammock; Frances H,30,0,30,0
1649775363755,MATH 20C,B04,083454,Hammock; Frances H,30,0,30,0
1649775369786,MATH 20D,A01,084128,Staff,30,0,30,0
1649775369786,MATH 20D,A02,084129,Staff,30,0,30,0
1649775369786,MATH 20D,A03,084130,Staff,29,0,30,1
1649775369786,MATH 20D,B01,084133,Staff,30,0,30,0
1649775369786,MATH 20D,B02,084134,Staff,30,0,30,0
1649775369786,MATH 20D,B03,084135,Staff,30,0,30,0
1649775375820,MATH 20E,A01,084138,Staff,30,0,30,0
1649775375820,MATH 20E,A02,084139,Staff,29,0,30,1
1649775375820,MATH 20E,A03,084140,Staff,30,0,30,0
1649775375820,MATH 20E,A04,084141,Staff,30,0,30,0
1649775381852,MATH 102,A01,084143,Harel; Guershon,27,0,30,3
1649775381852,MATH 102,A02,084144,Harel; Guershon,29,0,30,1
1649775387881,MATH 103B,A01,083456,Staff,22,0,30,8
1649775387881,MATH 103B,A02,083457,Staff,28,0,30,2
1649775393907,MATH 109,A01,084146,Salehi Golsefidy; Alireza,30,0,30,0
1649775393907,MATH 109,A02,084147,Salehi Golsefidy; Alireza,29,0,30,1
1649775399933,MATH 120A,A01,085445,Eggers; John Dietrich,32,0,35,3
1649775399933,MATH 120A,A02,085446,Eggers; John Dietrich,34,0,35,1
1649775405959,MATH 142B,A01,084149,Verstraete; Jacques Allan,26,0,30,4
1649775405959,MATH 142B,A02,084150,Verstraete; Jacques Allan,28,0,30,2
1649775411984,MATH 170A,A01,083459,Nie; Jiawang,22,0,30,8
1649775411984,MATH 170A,A02,083460,Nie; Jiawang,28,0,30,2
1649775411984,MATH 170A,A03,083461,Nie; Jiawang,30,0,30,0
1649775418009,MATH 193B,A01,083463,Staff,25,0,30,5
1649775418009,MATH 193B,A02,083464,Staff,29,0,30,1
1649775418009,MATH 193B,A03,083465,Staff,30,0,30,0
1649775424075,COGS 2,A01,083966,Boyle; Mary E. T.,28,0,30,2
1649775430103,COGS 9,A01,083968,Staff,59,0,60,1
1649775436127,COGS 14B,A01,083970,Staff,50,0,50,0
1649775442151,COGS 100,A01,083972,Staff,58,0,60,2
1649775454204,COGS 101C,A01,083976,Staff,30,0,30,0
1649775460243,COGS 102A,A01,083978,Johnson; Christine M.,29,0,30,1
1649775466267,COGS 107B,A01,083980,Staff,46,0,50,4
1649775472291,COGS 115,A01,083982,Staff,27,0,30,3
1649775478322,COGS 118B,A01,083367,Staff,26,0,40,14
1649775484351,COGS 172,A01,083984,Provenzano; Emily Kara,25,0,30,5
1649775490380,COGS 177,A00,083368,Staff,22,0,30,8
1649775496409,COGS 186,A01,083986,Staff,31,0,40,9
1649775502437,COGS 187A,A01,083988,Boyle; Mary E. T.,56,0,60,4
1649775508465,CSE 8A,A50,084003,Miranda; Gregory Joseph,13,0,15,2
1649775514493,CSE 11,A01,084005,Miranda; Gregory Joseph,52,0,55,3
1649775520531,CSE 20,A01,084007,Staff,17,0,20,3
1649775526556,CSE 21,A01,084009,Staff,50,0,50,0
1649775532586,CSE 30,A01,083370,Cao; Yingjun,38,0,40,2
1649775538613,CSE 100,A01,083372,Cao; Yingjun,37,0,40,3
1649775544636,CSE 101,A01,084011,Staff,25,0,40,15
1649775550669,CSE 141,A01,083374,Eldon; John,46,0,75,29
1649775556701,CSE 141L,A01,083376,Eldon; John,48,0,75,27
1649775562727,CSE 175,A01,084013,Kumar; Rakesh,25,0,25,0
1649775568750,ECE 5,A01,084049,Morris; Karcher William,19,0,20,1
1649775574778,ECE 100,A01,084051,Baghdadchi; Saharnaz,18,0,20,2
1649775574778,ECE 100,A02,091916,Baghdadchi; Saharnaz,20,0,20,0
1649775580807,ECE 101,A01,084053,Baghdadchi; Saharnaz,33,0,37,4
1649775580807,ECE 101,A02,084054,Baghdadchi; Saharnaz,37,0,37,0
1649775586831,ECE 107,A01,083390,Staff,36,0,40,4
1649775592855,ECE 148,A01,084056,Silberman; Jack,10,0,12,2
1649775598886,ECE 180,A00,083391,Abi Samra; Nicholas Camill,28,0,30,2
1649775598886,ECE 180,B00,083392,Abi Samra; Nicholas Camill,28,0,30,2
1649775604919,MATH 10B,A01,084110,Staff,26,0,30,4
1649775604919,MATH 10B,A02,084111,Staff,30,0,30,0
1649775604919,MATH 10B,A03,084112,Staff,30,0,30,0
1649775610952,MATH 10C,A01,083443,Staff,28,0,30,2
1649775610952,MATH 10C,A02,083444,Staff,27,0,30,3
1649775610952,MATH 10C,B01,084114,Staff,29,0,30,1
1649775610952,MATH 10C,B02,084115,Staff,30,0,30,0
1649775616977,MATH 18,A01,084117,Harel; Guershon,28,0,30,2
1649775616977,MATH 18,A02,084119,Harel; Guershon,29,0,30,1
1649775616977,MATH 18,A03,084120,Harel; Guershon,30,0,30,0
1649775616977,MATH 18,A04,084121,Harel; Guershon,30,0,30,0
1649775623001,MATH 20B,A01,084124,Um; Ko Woon,34,0,35,1
1649775623001,MATH 20B,B01,084126,Um; Ko Woon,35,0,35,0
1649775629040,MATH 20C,A01,083446,Hammock; Frances H,29,0,30,1
1649775629040,MATH 20C,A02,083447,Hammock; Frances H,30,0,30,0
1649775629040,MATH 20C,A03,083448,Hammock; Frances H,30,0,30,0
1649775629040,MATH 20C,A04,083449,Hammock; Frances H,30,0,30,0
1649775629040,MATH 20C,B01,083451,Hammock; Frances H,30,0,30,0
1649775629040,MATH 20C,B02,083452,Hammock; Frances H,30,0,30,0
1649775629040,MATH 20C,B03,083453,Hammock; Frances H,30,0,30,0
1649775629040,MATH 20C,B04,083454,Hammock; Frances H,30,0,30,0
1649775635070,MATH 20D,A01,084128,Staff,30,0,30,0
1649775635070,MATH 20D,A02,084129,Staff,30,0,30,0
1649775635070,MATH 20D,A03,084130,Staff,29,0,30,1
1649775635070,MATH 20D,B01,084133,Staff,30,0,30,0
1649775635070,MATH 20D,B02,084134,Staff,30,0,30,0
1649775635070,MATH 20D,B03,084135,Staff,30,0,30,0
1649775641099,MATH 20E,A01,084138,Staff,30,0,30,0
1649775641099,MATH 20E,A02,084139,Staff,29,0,30,1
1649775641099,MATH 20E,A03,084140,Staff,30,0,30,0
1649775641099,MATH 20E,A04,084141,Staff,30,0,30,0
1649775647124,MATH 102,A01,084143,Harel; Guershon,27,0,30,3
1649775647124,MATH 102,A02,084144,Harel; Guershon,29,0,30,1
1649775653150,MATH 103B,A01,083456,Staff,22,0,30,8
1649775653150,MATH 103B,A02,083457,Staff,28,0,30,2
1649775659180,MATH 109,A01,084146,Salehi Golsefidy; Alireza,30,0,30,0
1649775659180,MATH 109,A02,084147,Salehi Golsefidy; Alireza,29,0,30,1
1649775665209,MATH 120A,A01,085445,Eggers; John Dietrich,32,0,35,3
1649775665209,MATH 120A,A02,085446,Eggers; John Dietrich,34,0,35,1
1649775671234,MATH 142B,A01,084149,Verstraete; Jacques Allan,26,0,30,4
1649775671234,MATH 142B,A02,084150,Verstraete; Jacques Allan,28,0,30,2
1649775677258,MATH 170A,A01,083459,Nie; Jiawang,22,0,30,8
1649775677258,MATH 170A,A02,083460,Nie; Jiawang,28,0,30,2
1649775677258,MATH 170A,A03,083461,Nie; Jiawang,30,0,30,0
1649775683288,MATH 193B,A01,083463,Staff,25,0,30,5
1649775683288,MATH 193B,A02,083464,Staff,29,0,30,1
1649775683288,MATH 193B,A03,083465,Staff,30,0,30,0
1649775689340,COGS 2,A01,083966,Boyle; Mary E. T.,28,0,30,2
1649775695371,COGS 9,A01,083968,Staff,59,0,60,1
1649775701501,COGS 14B,A01,083970,Staff,50,0,50,0
1649775707533,COGS 100,A01,083972,Staff,58,0,60,2
1649775719589,COGS 101C,A01,083976,Staff,30,0,30,0
1649775725613,COGS 102A,A01,083978,Johnson; Christine M.,29,0,30,1
1649775731657,COGS 107B,A01,083980,Staff,46,0,50,4
1649775737683,COGS 115,A01,083982,Staff,27,0,30,3
1649775743707,COGS 118B,A01,083367,Staff,26,0,40,14
1649775749733,COGS 172,A01,083984,Provenzano; Emily Kara,25,0,30,5
1649775755764,COGS 177,A00,083368,Staff,22,0,30,8
1649775761787,COGS 186,A01,083986,Staff,31,0,40,9
1649775767815,COGS 187A,A01,083988,Boyle; Mary E. T.,56,0,60,4
1649775773840,CSE 8A,A50,084003,Miranda; Gregory Joseph,13,0,15,2
1649775779866,CSE 11,A01,084005,Miranda; Gregory Joseph,52,0,55,3
1649775785892,CSE 20,A01,084007,Staff,17,0,20,3
1649775791919,CSE 21,A01,084009,Staff,50,0,50,0
1649775797995,CSE 30,A01,083370,Cao; Yingjun,38,0,40,2
1649775804034,CSE 100,A01,083372,Cao; Yingjun,37,0,40,3
1649775810064,CSE 101,A01,084011,Staff,25,0,40,15
1649775816095,CSE 141,A01,083374,Eldon; John,46,0,75,29
1649775822124,CSE 141L,A01,083376,Eldon; John,48,0,75,27
1649775828161,CSE 175,A01,084013,Kumar; Rakesh,25,0,25,0
1649775834187,ECE 5,A01,084049,Morris; Karcher William,19,0,20,1
1649775840221,ECE 100,A01,084051,Baghdadchi; Saharnaz,18,0,20,2
1649775840221,ECE 100,A02,091916,Baghdadchi; Saharnaz,20,0,20,0
1649775846248,ECE 101,A01,084053,Baghdadchi; Saharnaz,33,0,37,4
1649775846248,ECE 101,A02,084054,Baghdadchi; Saharnaz,37,0,37,0
1649775852279,ECE 107,A01,083390,Staff,36,0,40,4
1649775858311,ECE 148,A01,084056,Silberman; Jack,10,0,12,2
1649775864342,ECE 180,A00,083391,Abi Samra; Nicholas Camill,28,0,30,2
1649775864342,ECE 180,B00,083392,Abi Samra; Nicholas Camill,28,0,30,2
1649775870365,MATH 10B,A01,084110,Staff,26,0,30,4
1649775870365,MATH 10B,A02,084111,Staff,30,0,30,0
1649775870365,MATH 10B,A03,084112,Staff,30,0,30,0
1649775876391,MATH 10C,A01,083443,Staff,28,0,30,2
1649775876391,MATH 10C,A02,083444,Staff,27,0,30,3
1649775876391,MATH 10C,B01,084114,Staff,29,0,30,1
1649775876391,MATH 10C,B02,084115,Staff,30,0,30,0
1649775882425,MATH 18,A01,084117,Harel; Guershon,28,0,30,2
1649775882425,MATH 18,A02,084119,Harel; Guershon,29,0,30,1
1649775882425,MATH 18,A03,084120,Harel; Guershon,30,0,30,0
1649775882425,MATH 18,A04,084121,Harel; Guershon,30,0,30,0
1649775888456,MATH 20B,A01,084124,Um; Ko Woon,34,0,35,1
1649775888456,MATH 20B,B01,084126,Um; Ko Woon,35,0,35,0
1649775894485,MATH 20C,A01,083446,Hammock; Frances H,29,0,30,1
1649775894485,MATH 20C,A02,083447,Hammock; Frances H,30,0,30,0
1649775894485,MATH 20C,A03,083448,Hammock; Frances H,30,0,30,0
1649775894485,MATH 20C,A04,083449,Hammock; Frances H,30,0,30,0
1649775894485,MATH 20C,B01,083451,Hammock; Frances H,30,0,30,0
1649775894485,MATH 20C,B02,083452,Hammock; Frances H,30,0,30,0
1649775894485,MATH 20C,B03,083453,Hammock; Frances H,30,0,30,0
1649775894485,MATH 20C,B04,083454,Hammock; Frances H,30,0,30,0
1649775900519,MATH 20D,A01,084128,Staff,30,0,30,0
1649775900519,MATH 20D,A02,084129,Staff,30,0,30,0
1649775900519,MATH 20D,A03,084130,Staff,29,0,30,1
1649775900519,MATH 20D,B01,084133,Staff,30,0,30,0
1649775900519,MATH 20D,B02,084134,Staff,30,0,30,0
1649775900519,MATH 20D,B03,084135,Staff,30,0,30,0
1649775906543,MATH 20E,A01,084138,Staff,30,0,30,0
1649775906543,MATH 20E,A02,084139,Staff,29,0,30,1
1649775906543,MATH 20E,A03,084140,Staff,30,0,30,0
1649775906543,MATH 20E,A04,084141,Staff,30,0,30,0
1649775912571,MATH 102,A01,084143,Harel; Guershon,27,0,30,3
1649775912571,MATH 102,A02,084144,Harel; Guershon,29,0,30,1
1649775918594,MATH 103B,A01,083456,Staff,22,0,30,8
1649775918594,MATH 103B,A02,083457,Staff,28,0,30,2
1649775924634,MATH 109,A01,084146,Salehi Golsefidy; Alireza,30,0,30,0
1649775924634,MATH 109,A02,084147,Salehi Golsefidy; Alireza,29,0,30,1
1649775930679,MATH 120A,A01,085445,Eggers; John Dietrich,32,0,35,3
1649775930679,MATH 120A,A02,085446,Eggers; John Dietrich,34,0,35,1
1649775936708,MATH 142B,A01,084149,Verstraete; Jacques Allan,26,0,30,4
1649775936708,MATH 142B,A02,084150,Verstraete; Jacques Allan,28,0,30,2
1649775942740,MATH 170A,A01,083459,Nie; Jiawang,22,0,30,8
1649775942740,MATH 170A,A02,083460,Nie; Jiawang,28,0,30,2
1649775942740,MATH 170A,A03,083461,Nie; Jiawang,30,0,30,0
1649775948764,MATH 193B,A01,083463,Staff,25,0,30,5
1649775948764,MATH 193B,A02,083464,Staff,29,0,30,1
1649775948764,MATH 193B,A03,083465,Staff,30,0,30,0
1649775954820,COGS 2,A01,083966,Boyle; Mary E. T.,28,0,30,2
1649775960859,COGS 9,A01,083968,Staff,59,0,60,1
1649775966893,COGS 14B,A01,083970,Staff,50,0,50,0
1649775972921,COGS 100,A01,083972,Staff,58,0,60,2
1649775984988,COGS 101C,A01,083976,Staff,30,0,30,0
1649775991015,COGS 102A,A01,083978,Johnson; Christine M.,29,0,30,1
1649775997041,COGS 107B,A01,083980,Staff,46,0,50,4
1649776003065,COGS 115,A01,083982,Staff,27,0,30,3
1649776009091,COGS 118B,A01,083367,Staff,26,0,40,14
1649776015121,COGS 172,A01,083984,Provenzano; Emily Kara,25,0,30,5
1649776021152,COGS 177,A00,083368,Staff,22,0,30,8
1649776027178,COGS 186,A01,083986,Staff,31,0,40,9
1649776033203,COGS 187A,A01,083988,Boyle; Mary E. T.,56,0,60,4
1649776039229,CSE 8A,A50,084003,Miranda; Gregory Joseph,13,0,15,2
1649776045260,CSE 11,A01,084005,Miranda; Gregory Joseph,52,0,55,3
1649776051284,CSE 20,A01,084007,Staff,17,0,20,3
1649776057310,CSE 21,A01,084009,Staff,50,0,50,0
1649776063339,CSE 30,A01,083370,Cao; Yingjun,38,0,40,2
1649776069364,CSE 100,A01,083372,Cao; Yingjun,37,0,40,3
1649776075397,CSE 101,A01,084011,Staff,25,0,40,15
1649776081424,CSE 141,A01,083374,Eldon; John,46,0,75,29
1649776087453,CSE 141L,A01,083376,Eldon; John,48,0,75,27
1649776093478,CSE 175,A01,084013,Kumar; Rakesh,25,0,25,0
1649776099505,ECE 5,A01,084049,Morris; Karcher William,19,0,20,1
1649776105536,ECE 100,A01,084051,Baghdadchi; Saharnaz,18,0,20,2
1649776105536,ECE 100,A02,091916,Baghdadchi; Saharnaz,20,0,20,0
1649776111562,ECE 101,A01,084053,Baghdadchi; Saharnaz,33,0,37,4
1649776111562,ECE 101,A02,084054,Baghdadchi; Saharnaz,37,0,37,0
1649776117588,ECE 107,A01,083390,Staff,36,0,40,4
1649776123613,ECE 148,A01,084056,Silberman; Jack,10,0,12,2
1649776129649,ECE 180,A00,083391,Abi Samra; Nicholas Camill,28,0,30,2
1649776129649,ECE 180,B00,083392,Abi Samra; Nicholas Camill,28,0,30,2
1649776135678,MATH 10B,A01,084110,Staff,26,0,30,4
1649776135678,MATH 10B,A02,084111,Staff,30,0,30,0
1649776135678,MATH 10B,A03,084112,Staff,30,0,30,0
1649776141704,MATH 10C,A01,083443,Staff,28,0,30,2
1649776141704,MATH 10C,A02,083444,Staff,27,0,30,3
1649776141704,MATH 10C,B01,084114,Staff,29,0,30,1
1649776141704,MATH 10C,B02,084115,Staff,30,0,30,0
1649776147728,MATH 18,A01,084117,Harel; Guershon,28,0,30,2
1649776147728,MATH 18,A02,084119,Harel; Guershon,29,0,30,1
1649776147728,MATH 18,A03,084120,Harel; Guershon,30,0,30,0
1649776147728,MATH 18,A04,084121,Harel; Guershon,30,0,30,0
1649776153757,MATH 20B,A01,084124,Um; Ko Woon,34,0,35,1
1649776153757,MATH 20B,B01,084126,Um; Ko Woon,35,0,35,0
1649776159789,MATH 20C,A01,083446,Hammock; Frances H,29,0,30,1
1649776159789,MATH 20C,A02,083447,Hammock; Frances H,30,0,30,0
1649776159789,MATH 20C,A03,083448,Hammock; Frances H,30,0,30,0
1649776159789,MATH 20C,A04,083449,Hammock; Frances H,30,0,30,0
1649776159789,MATH 20C,B01,083451,Hammock; Frances H,30,0,30,0
1649776159789,MATH 20C,B02,083452,Hammock; Frances H,30,0,30,0
1649776159789,MATH 20C,B03,083453,Hammock; Frances H,30,0,30,0
1649776159789,MATH 20C,B04,083454,Hammock; Frances H,30,0,30,0
1649776165816,MATH 20D,A01,084128,Staff,30,0,30,0
1649776165816,MATH 20D,A02,084129,Staff,30,0,30,0
1649776165816,MATH 20D,A03,084130,Staff,29,0,30,1
1649776165816,MATH 20D,B01,084133,Staff,30,0,30,0
1649776165816,MATH 20D,B02,084134,Staff,30,0,30,0
1649776165816,MATH 20D,B03,084135,Staff,30,0,30,0
1649776171844,MATH 20E,A01,084138,Staff,30,0,30,0
1649776171844,MATH 20E,A02,084139,Staff,29,0,30,1
1649776171844,MATH 20E,A03,084140,Staff,30,0,30,0
1649776171844,MATH 20E,A04,084141,Staff,30,0,30,0
1649776177872,MATH 102,A01,084143,Harel; Guershon,27,0,30,3
1649776177872,MATH 102,A02,084144,Harel; Guershon,29,0,30,1
1649776183895,MATH 103B,A01,083456,Staff,22,0,30,8
1649776183895,MATH 103B,A02,083457,Staff,28,0,30,2
1649776189926,MATH 109,A01,084146,Salehi Golsefidy; Alireza,30,0,30,0
1649776189926,MATH 109,A02,084147,Salehi Golsefidy; Alireza,29,0,30,1
1649776195957,MATH 120A,A01,085445,Eggers; John Dietrich,32,0,35,3
1649776195957,MATH 120A,A02,085446,Eggers; John Dietrich,34,0,35,1
1649776201983,MATH 142B,A01,084149,Verstraete; Jacques Allan,26,0,30,4
1649776201983,MATH 142B,A02,084150,Verstraete; Jacques Allan,28,0,30,2
1649776208018,MATH 170A,A01,083459,Nie; Jiawang,22,0,30,8
1649776208018,MATH 170A,A02,083460,Nie; Jiawang,28,0,30,2
1649776208018,MATH 170A,A03,083461,Nie; Jiawang,30,0,30,0
1649776214043,MATH 193B,A01,083463,Staff,25,0,30,5
1649776214043,MATH 193B,A02,083464,Staff,29,0,30,1
1649776214043,MATH 193B,A03,083465,Staff,30,0,30,0
1649776220100,COGS 2,A01,083966,Boyle; Mary E. T.,28,0,30,2
1649776226129,COGS 9,A01,083968,Staff,59,0,60,1
1649776232159,COGS 14B,A01,083970,Staff,50,0,50,0
1649776238188,COGS 100,A01,083972,Staff,58,0,60,2
1649776250246,COGS 101C,A01,083976,Staff,30,0,30,0
1649776256273,COGS 102A,A01,083978,Johnson; Christine M.,29,0,30,1
1649776262310,COGS 107B,A01,083980,Staff,46,0,50,4
1649776268334,COGS 115,A01,083982,Staff,27,0,30,3
1649776274358,COGS 118B,A01,083367,Staff,26,0,40,14
1649776280389,COGS 172,A01,083984,Provenzano; Emily Kara,25,0,30,5
1649776286415,COGS 177,A00,083368,Staff,22,0,30,8
1649776292442,COGS 186,A01,083986,Staff,31,0,40,9
1649776298586,COGS 187A,A01,083988,Boyle; Mary E. T.,56,0,60,4
1649776304615,CSE 8A,A50,084003,Miranda; Gregory Joseph,13,0,15,2
1649776310651,CSE 11,A01,084005,Miranda; Gregory Joseph,52,0,55,3
1649776316676,CSE 20,A01,084007,Staff,17,0,20,3
1649776322708,CSE 21,A01,084009,Staff,50,0,50,0
1649776328734,CSE 30,A01,083370,Cao; Yingjun,38,0,40,2
1649776334764,CSE 100,A01,083372,Cao; Yingjun,37,0,40,3
1649776340789,CSE 101,A01,084011,Staff,25,0,40,15
1649776346823,CSE 141,A01,083374,Eldon; John,46,0,75,29
1649776352847,CSE 141L,A01,083376,Eldon; John,48,0,75,27
1649776358883,CSE 175,A01,084013,Kumar; Rakesh,25,0,25,0
1649776364910,ECE 5,A01,084049,Morris; Karcher William,19,0,20,1
1649776370942,ECE 100,A01,084051,Baghdadchi; Saharnaz,18,0,20,2
1649776370942,ECE 100,A02,091916,Baghdadchi; Saharnaz,20,0,20,0
1649776376976,ECE 101,A01,084053,Baghdadchi; Saharnaz,33,0,37,4
1649776376976,ECE 101,A02,084054,Baghdadchi; Saharnaz,37,0,37,0
1649776383000,ECE 107,A01,083390,Staff,36,0,40,4
1649776389025,ECE 148,A01,084056,Silberman; Jack,10,0,12,2
1649776395049,ECE 180,A00,083391,Abi Samra; Nicholas Camill,28,0,30,2
1649776395049,ECE 180,B00,083392,Abi Samra; Nicholas Camill,28,0,30,2
1649776401074,MATH 10B,A01,084110,Staff,26,0,30,4
1649776401074,MATH 10B,A02,084111,Staff,30,0,30,0
1649776401074,MATH 10B,A03,084112,Staff,30,0,30,0
1649776407103,MATH 10C,A01,083443,Staff,28,0,30,2
1649776407103,MATH 10C,A02,083444,Staff,27,0,30,3
1649776407103,MATH 10C,B01,084114,Staff,28,0,30,2
1649776407103,MATH 10C,B02,084115,Staff,30,0,30,0
1649776413133,MATH 18,A01,084117,Harel; Guershon,28,0,30,2
1649776413133,MATH 18,A02,084119,Harel; Guershon,29,0,30,1
1649776413133,MATH 18,A03,084120,Harel; Guershon,30,0,30,0
1649776413133,MATH 18,A04,084121,Harel; Guershon,30,0,30,0
1649776419169,MATH 20B,A01,084124,Um; Ko Woon,34,0,35,1
1649776419169,MATH 20B,B01,084126,Um; Ko Woon,35,0,35,0
1649776425195,MATH 20C,A01,083446,Hammock; Frances H,29,0,30,1
1649776425195,MATH 20C,A02,083447,Hammock; Frances H,30,0,30,0
1649776425195,MATH 20C,A03,083448,Hammock; Frances H,30,0,30,0
1649776425195,MATH 20C,A04,083449,Hammock; Frances H,30,0,30,0
1649776425195,MATH 20C,B01,083451,Hammock; Frances H,30,0,30,0
1649776425195,MATH 20C,B02,083452,Hammock; Frances H,30,0,30,0
1649776425195,MATH 20C,B03,083453,Hammock; Frances H,30,0,30,0
1649776425195,MATH 20C,B04,083454,Hammock; Frances H,30,0,30,0
1649776431224,MATH 20D,A01,084128,Staff,30,0,30,0
1649776431224,MATH 20D,A02,084129,Staff,30,0,30,0
1649776431224,MATH 20D,A03,084130,Staff,29,0,30,1
1649776431224,MATH 20D,B01,084133,Staff,30,0,30,0
1649776431224,MATH 20D,B02,084134,Staff,30,0,30,0
1649776431224,MATH 20D,B03,084135,Staff,30,0,30,0
1649776437250,MATH 20E,A01,084138,Staff,30,0,30,0
1649776437250,MATH 20E,A02,084139,Staff,29,0,30,1
1649776437250,MATH 20E,A03,084140,Staff,30,0,30,0
1649776437250,MATH 20E,A04,084141,Staff,30,0,30,0
1649776443275,MATH 102,A01,084143,Harel; Guershon,27,0,30,3
1649776443275,MATH 102,A02,084144,Harel; Guershon,29,0,30,1
1649776449302,MATH 103B,A01,083456,Staff,22,0,30,8
1649776449302,MATH 103B,A02,083457,Staff,28,0,30,2
1649776455341,MATH 109,A01,084146,Salehi Golsefidy; Alireza,30,0,30,0
1649776455341,MATH 109,A02,084147,Salehi Golsefidy; Alireza,29,0,30,1
1649776461370,MATH 120A,A01,085445,Eggers; John Dietrich,32,0,35,3
1649776461370,MATH 120A,A02,085446,Eggers; John Dietrich,34,0,35,1
1649776467409,MATH 142B,A01,084149,Verstraete; Jacques Allan,26,0,30,4
1649776467409,MATH 142B,A02,084150,Verstraete; Jacques Allan,28,0,30,2
1649776473435,MATH 170A,A01,083459,Nie; Jiawang,22,0,30,8
1649776473435,MATH 170A,A02,083460,Nie; Jiawang,28,0,30,2
1649776473435,MATH 170A,A03,083461,Nie; Jiawang,30,0,30,0
1649776479459,MATH 193B,A01,083463,Staff,25,0,30,5
1649776479459,MATH 193B,A02,083464,Staff,29,0,30,1
1649776479459,MATH 193B,A03,083465,Staff,30,0,30,0
1649776485528,COGS 2,A01,083966,Boyle; Mary E. T.,28,0,30,2
1649776491557,COGS 9,A01,083968,Staff,59,0,60,1
1649776497593,COGS 14B,A01,083970,Staff,50,0,50,0
1649776503618,COGS 100,A01,083972,Staff,58,0,60,2
1649776515669,COGS 101C,A01,083976,Staff,30,0,30,0
1649776521696,COGS 102A,A01,083978,Johnson; Christine M.,29,0,30,1
1649776527720,COGS 107B,A01,083980,Staff,46,0,50,4
1649776533748,COGS 115,A01,083982,Staff,27,0,30,3
1649776539769,COGS 118B,A01,083367,Staff,26,0,40,14
1649776545802,COGS 172,A01,083984,Provenzano; Emily Kara,25,0,30,5
1649776551830,COGS 177,A00,083368,Staff,22,0,30,8
1649776557863,COGS 186,A01,083986,Staff,31,0,40,9
1649776563888,COGS 187A,A01,083988,Boyle; Mary E. T.,56,0,60,4
1649776569915,CSE 8A,A50,084003,Miranda; Gregory Joseph,13,0,15,2
1649776575945,CSE 11,A01,084005,Miranda; Gregory Joseph,52,0,55,3
1649776581969,CSE 20,A01,084007,Staff,17,0,20,3
1649776587994,CSE 21,A01,084009,Staff,50,0,50,0
1649776594033,CSE 30,A01,083370,Cao; Yingjun,38,0,40,2
1649776600064,CSE 100,A01,083372,Cao; Yingjun,37,0,40,3
1649776606094,CSE 101,A01,084011,Staff,25,0,40,15
1649776612133,CSE 141,A01,083374,Eldon; John,46,0,75,29
1649776618168,CSE 141L,A01,083376,Eldon; John,48,0,75,27
1649776624208,CSE 175,A01,084013,Kumar; Rakesh,25,0,25,0
1649776630230,ECE 5,A01,084049,Morris; Karcher William,19,0,20,1
1649776636271,ECE 100,A01,084051,Baghdadchi; Saharnaz,18,0,20,2
1649776636271,ECE 100,A02,091916,Baghdadchi; Saharnaz,20,0,20,0
1649776642295,ECE 101,A01,084053,Baghdadchi; Saharnaz,33,0,37,4
1649776642295,ECE 101,A02,084054,Baghdadchi; Saharnaz,37,0,37,0
1649776648334,ECE 107,A01,083390,Staff,36,0,40,4
1649776654363,ECE 148,A01,084056,Silberman; Jack,10,0,12,2
1649776660401,ECE 180,A00,083391,Abi Samra; Nicholas Camill,28,0,30,2
1649776660401,ECE 180,B00,083392,Abi Samra; Nicholas Camill,28,0,30,2
1649776666431,MATH 10B,A01,084110,Staff,26,0,30,4
1649776666431,MATH 10B,A02,084111,Staff,30,0,30,0
1649776666431,MATH 10B,A03,084112,Staff,30,0,30,0
1649776672457,MATH 10C,A01,083443,Staff,28,0,30,2
1649776672457,MATH 10C,A02,083444,Staff,27,0,30,3
1649776672457,MATH 10C,B01,084114,Staff,28,0,30,2
1649776672457,MATH 10C,B02,084115,Staff,30,0,30,0
1649776678481,MATH 18,A01,084117,Harel; Guershon,28,0,30,2
1649776678481,MATH 18,A02,084119,Harel; Guershon,29,0,30,1
1649776678481,MATH 18,A03,084120,Harel; Guershon,30,0,30,0
1649776678481,MATH 18,A04,084121,Harel; Guershon,30,0,30,0
1649776684510,MATH 20B,A01,084124,Um; Ko Woon,34,0,35,1
1649776684510,MATH 20B,B01,084126,Um; Ko Woon,35,0,35,0
1649776690543,MATH 20C,A01,083446,Hammock; Frances H,29,0,30,1
1649776690543,MATH 20C,A02,083447,Hammock; Frances H,30,0,30,0
1649776690543,MATH 20C,A03,083448,Hammock; Frances H,30,0,30,0
1649776690543,MATH 20C,A04,083449,Hammock; Frances H,30,0,30,0
1649776690543,MATH 20C,B01,083451,Hammock; Frances H,30,0,30,0
1649776690543,MATH 20C,B02,083452,Hammock; Frances H,30,0,30,0
1649776690543,MATH 20C,B03,083453,Hammock; Frances H,30,0,30,0
1649776690543,MATH 20C,B04,083454,Hammock; Frances H,30,0,30,0
1649776696575,MATH 20D,A01,084128,Staff,30,0,30,0
1649776696575,MATH 20D,A02,084129,Staff,30,0,30,0
1649776696575,MATH 20D,A03,084130,Staff,29,0,30,1
1649776696575,MATH 20D,B01,084133,Staff,30,0,30,0
1649776696575,MATH 20D,B02,084134,Staff,30,0,30,0
1649776696575,MATH 20D,B03,084135,Staff,30,0,30,0
1649776702600,MATH 20E,A01,084138,Staff,30,0,30,0
1649776702600,MATH 20E,A02,084139,Staff,29,0,30,1
1649776702600,MATH 20E,A03,084140,Staff,30,0,30,0
1649776702600,MATH 20E,A04,084141,Staff,30,0,30,0
1649776708633,MATH 102,A01,084143,Harel; Guershon,27,0,30,3
1649776708633,MATH 102,A02,084144,Harel; Guershon,29,0,30,1
1649776714657,MATH 103B,A01,083456,Staff,22,0,30,8
1649776714657,MATH 103B,A02,083457,Staff,28,0,30,2
1649776720691,MATH 109,A01,084146,Salehi Golsefidy; Alireza,30,0,30,0
1649776720691,MATH 109,A02,084147,Salehi Golsefidy; Alireza,29,0,30,1
1649776726737,MATH 120A,A01,085445,Eggers; John Dietrich,32,0,35,3
1649776726737,MATH 120A,A02,085446,Eggers; John Dietrich,34,0,35,1
1649776732776,MATH 142B,A01,084149,Verstraete; Jacques Allan,26,0,30,4
1649776732776,MATH 142B,A02,084150,Verstraete; Jacques Allan,28,0,30,2
1649776738802,MATH 170A,A01,083459,Nie; Jiawang,22,0,30,8
1649776738802,MATH 170A,A02,083460,Nie; Jiawang,28,0,30,2
1649776738802,MATH 170A,A03,083461,Nie; Jiawang,30,0,30,0
1649776744826,MATH 193B,A01,083463,Staff,25,0,30,5
1649776744826,MATH 193B,A02,083464,Staff,29,0,30,1
1649776744826,MATH 193B,A03,083465,Staff,30,0,30,0
1649776750884,COGS 2,A01,083966,Boyle; Mary E. T.,28,0,30,2
1649776756918,COGS 9,A01,083968,Staff,59,0,60,1
1649776762945,COGS 14B,A01,083970,Staff,50,0,50,0
1649776768974,COGS 100,A01,083972,Staff,58,0,60,2
1649776781036,COGS 101C,A01,083976,Staff,30,0,30,0
1649776787069,COGS 102A,A01,083978,Johnson; Christine M.,29,0,30,1
1649776793097,COGS 107B,A01,083980,Staff,46,0,50,4
1649776799122,COGS 115,A01,083982,Staff,27,0,30,3
1649776805145,COGS 118B,A01,083367,Staff,26,0,40,14
1649776811182,COGS 172,A01,083984,Provenzano; Emily Kara,25,0,30,5
1649776817218,COGS 177,A00,083368,Staff,22,0,30,8
1649776823257,COGS 186,A01,083986,Staff,31,0,40,9
1649776829285,COGS 187A,A01,083988,Boyle; Mary E. T.,56,0,60,4
1649776835310,CSE 8A,A50,084003,Miranda; Gregory Joseph,13,0,15,2
1649776841335,CSE 11,A01,084005,Miranda; Gregory Joseph,52,0,55,3
1649776847359,CSE 20,A01,084007,Staff,17,0,20,3
1649776853387,CSE 21,A01,084009,Staff,50,0,50,0
1649776859419,CSE 30,A01,083370,Cao; Yingjun,38,0,40,2
1649776865447,CSE 100,A01,083372,Cao; Yingjun,36,0,40,4
1649776871473,CSE 101,A01,084011,Staff,25,0,40,15
1649776877495,CSE 141,A01,083374,Eldon; John,46,0,75,29
1649776883533,CSE 141L,A01,083376,Eldon; John,48,0,75,27
1649776889570,CSE 175,A01,084013,Kumar; Rakesh,25,0,25,0
1649776895685,ECE 5,A01,084049,Morris; Karcher William,19,0,20,1
1649776901719,ECE 100,A01,084051,Baghdadchi; Saharnaz,18,0,20,2
1649776901719,ECE 100,A02,091916,Baghdadchi; Saharnaz,20,0,20,0
1649776907743,ECE 101,A01,084053,Baghdadchi; Saharnaz,33,0,37,4
1649776907743,ECE 101,A02,084054,Baghdadchi; Saharnaz,37,0,37,0
1649776913770,ECE 107,A01,083390,Staff,36,0,40,4
1649776919796,ECE 148,A01,084056,Silberman; Jack,10,0,12,2
1649776925820,ECE 180,A00,083391,Abi Samra; Nicholas Camill,28,0,30,2
1649776925820,ECE 180,B00,083392,Abi Samra; Nicholas Camill,28,0,30,2
1649776931859,MATH 10B,A01,084110,Staff,26,0,30,4
1649776931859,MATH 10B,A02,084111,Staff,30,0,30,0
1649776931859,MATH 10B,A03,084112,Staff,30,0,30,0
1649776937893,MATH 10C,A01,083443,Staff,28,0,30,2
1649776937893,MATH 10C,A02,083444,Staff,27,0,30,3
1649776937893,MATH 10C,B01,084114,Staff,28,0,30,2
1649776937893,MATH 10C,B02,084115,Staff,30,0,30,0
1649776943923,MATH 18,A01,084117,Harel; Guershon,28,0,30,2
1649776943923,MATH 18,A02,084119,Harel; Guershon,29,0,30,1
1649776943923,MATH 18,A03,084120,Harel; Guershon,30,0,30,0
1649776943923,MATH 18,A04,084121,Harel; Guershon,30,0,30,0
1649776949955,MATH 20B,A01,084124,Um; Ko Woon,34,0,35,1
1649776949955,MATH 20B,B01,084126,Um; Ko Woon,35,0,35,0
1649776955986,MATH 20C,A01,083446,Hammock; Frances H,29,0,30,1
1649776955986,MATH 20C,A02,083447,Hammock; Frances H,30,0,30,0
1649776955986,MATH 20C,A03,083448,Hammock; Frances H,30,0,30,0
1649776955986,MATH 20C,A04,083449,Hammock; Frances H,30,0,30,0
1649776955986,MATH 20C,B01,083451,Hammock; Frances H,30,0,30,0
1649776955986,MATH 20C,B02,083452,Hammock; Frances H,30,0,30,0
1649776955986,MATH 20C,B03,083453,Hammock; Frances H,30,0,30,0
1649776955986,MATH 20C,B04,083454,Hammock; Frances H,30,0,30,0
1649776962016,MATH 20D,A01,084128,Staff,30,0,30,0
1649776962016,MATH 20D,A02,084129,Staff,30,0,30,0
1649776962016,MATH 20D,A03,084130,Staff,29,0,30,1
1649776962016,MATH 20D,B01,084133,Staff,30,0,30,0
1649776962016,MATH 20D,B02,084134,Staff,30,0,30,0
1649776962016,MATH 20D,B03,084135,Staff,30,0,30,0
1649776968044,MATH 20E,A01,084138,Staff,30,0,30,0
1649776968044,MATH 20E,A02,084139,Staff,29,0,30,1
1649776968044,MATH 20E,A03,084140,Staff,30,0,30,0
1649776968044,MATH 20E,A04,084141,Staff,30,0,30,0
1649776974073,MATH 102,A01,084143,Harel; Guershon,27,0,30,3
1649776974073,MATH 102,A02,084144,Harel; Guershon,29,0,30,1
1649776980101,MATH 103B,A01,083456,Staff,21,0,30,9
1649776980101,MATH 103B,A02,083457,Staff,28,0,30,2
1649776986126,MATH 109,A01,084146,Salehi Golsefidy; Alireza,30,0,30,0
1649776986126,MATH 109,A02,084147,Salehi Golsefidy; Alireza,29,0,30,1
1649776992152,MATH 120A,A01,085445,Eggers; John Dietrich,32,0,35,3
1649776992152,MATH 120A,A02,085446,Eggers; John Dietrich,34,0,35,1
1649776998182,MATH 142B,A01,084149,Verstraete; Jacques Allan,26,0,30,4
1649776998182,MATH 142B,A02,084150,Verstraete; Jacques Allan,28,0,30,2
1649777004213,MATH 170A,A01,083459,Nie; Jiawang,21,0,30,9
1649777004213,MATH 170A,A02,083460,Nie; Jiawang,28,0,30,2
1649777004213,MATH 170A,A03,083461,Nie; Jiawang,30,0,30,0
1649777010243,MATH 193B,A01,083463,Staff,25,0,30,5
1649777010243,MATH 193B,A02,083464,Staff,29,0,30,1
1649777010243,MATH 193B,A03,083465,Staff,30,0,30,0
1649777016299,COGS 2,A01,083966,Boyle; Mary E. T.,28,0,30,2
1649777022324,COGS 9,A01,083968,Staff,59,0,60,1
1649777028353,COGS 14B,A01,083970,Staff,50,0,50,0
1649777034400,COGS 100,A01,083972,Staff,58,0,60,2
1649777046449,COGS 101C,A01,083976,Staff,29,0,30,1
1649777052481,COGS 102A,A01,083978,Johnson; Christine M.,29,0,30,1
1649777058512,COGS 107B,A01,083980,Staff,46,0,50,4
1649777064537,COGS 115,A01,083982,Staff,27,0,30,3
1649777070570,COGS 118B,A01,083367,Staff,24,0,40,16
1649777076597,COGS 172,A01,083984,Provenzano; Emily Kara,25,0,30,5
1649777082625,COGS 177,A00,083368,Staff,22,0,30,8
1649777088655,COGS 186,A01,083986,Staff,31,0,40,9
1649777094684,COGS 187A,A01,083988,Boyle; Mary E. T.,56,0,60,4
1649777100712,CSE 8A,A50,084003,Miranda; Gregory Joseph,13,0,15,2
1649777106736,CSE 11,A01,084005,Miranda; Gregory Joseph,52,0,55,3
1649777112765,CSE 20,A01,084007,Staff,17,0,20,3
1649777118791,CSE 21,A01,084009,Staff,50,0,50,0
1649777124814,CSE 30,A01,083370,Cao; Yingjun,38,0,40,2
1649777130842,CSE 100,A01,083372,Cao; Yingjun,36,0,40,4
1649777136880,CSE 101,A01,084011,Staff,25,0,40,15
1649777142904,CSE 141,A01,083374,Eldon; John,45,0,75,30
1649777148927,CSE 141L,A01,083376,Eldon; John,47,0,75,28
1649777154951,CSE 175,A01,084013,Kumar; Rakesh,25,0,25,0
1649777160975,CSE 190,A00,092508,Staff,0,0,0,0
1649777167000,ECE 5,A01,084049,Morris; Karcher William,19,0,20,1
1649777173026,ECE 100,A01,084051,Baghdadchi; Saharnaz,18,0,20,2
1649777173026,ECE 100,A02,091916,Baghdadchi; Saharnaz,20,0,20,0
1649777179054,ECE 101,A01,084053,Baghdadchi; Saharnaz,33,0,37,4
1649777179054,ECE 101,A02,084054,Baghdadchi; Saharnaz,37,0,37,0
1649777185084,ECE 107,A01,083390,Staff,36,0,40,4
1649777191110,ECE 148,A01,084056,Silberman; Jack,10,0,12,2
1649777197137,ECE 180,A00,083391,Abi Samra; Nicholas Camill,28,0,30,2
1649777197137,ECE 180,B00,083392,Abi Samra; Nicholas Camill,28,0,30,2
1649777203160,MATH 10B,A01,084110,Staff,26,0,30,4
1649777203160,MATH 10B,A02,084111,Staff,30,0,30,0
1649777203160,MATH 10B,A03,084112,Staff,30,0,30,0
1649777209187,MATH 10C,A01,083443,Staff,28,0,30,2
1649777209187,MATH 10C,A02,083444,Staff,27,0,30,3
1649777209187,MATH 10C,B01,084114,Staff,28,0,30,2
1649777209187,MATH 10C,B02,084115,Staff,30,0,30,0
1649777215216,MATH 18,A01,084117,Harel; Guershon,28,0,30,2
1649777215216,MATH 18,A02,084119,Harel; Guershon,29,0,30,1
1649777215216,MATH 18,A03,084120,Harel; Guershon,30,0,30,0
1649777215216,MATH 18,A04,084121,Harel; Guershon,30,0,30,0
1649777221241,MATH 20B,A01,084124,Um; Ko Woon,34,0,35,1
1649777221241,MATH 20B,B01,084126,Um; Ko Woon,35,0,35,0
1649777227273,MATH 20C,A01,083446,Hammock; Frances H,29,0,30,1
1649777227273,MATH 20C,A02,083447,Hammock; Frances H,30,0,30,0
1649777227273,MATH 20C,A03,083448,Hammock; Frances H,30,0,30,0
1649777227273,MATH 20C,A04,083449,Hammock; Frances H,30,0,30,0
1649777227273,MATH 20C,B01,083451,Hammock; Frances H,30,0,30,0
1649777227273,MATH 20C,B02,083452,Hammock; Frances H,30,0,30,0
1649777227273,MATH 20C,B03,083453,Hammock; Frances H,30,0,30,0
1649777227273,MATH 20C,B04,083454,Hammock; Frances H,30,0,30,0
1649777233301,MATH 20D,A01,084128,Staff,30,0,30,0
1649777233301,MATH 20D,A02,084129,Staff,30,0,30,0
1649777233301,MATH 20D,A03,084130,Staff,29,0,30,1
1649777233301,MATH 20D,B01,084133,Staff,30,0,30,0
1649777233301,MATH 20D,B02,084134,Staff,30,0,30,0
1649777233301,MATH 20D,B03,084135,Staff,30,0,30,0
1649777239328,MATH 20E,A01,084138,Staff,30,0,30,0
1649777239328,MATH 20E,A02,084139,Staff,29,0,30,1
1649777239328,MATH 20E,A03,084140,Staff,30,0,30,0
1649777239328,MATH 20E,A04,084141,Staff,30,0,30,0
1649777245353,MATH 102,A01,084143,Harel; Guershon,27,0,30,3
1649777245353,MATH 102,A02,084144,Harel; Guershon,29,0,30,1
1649777251382,MATH 103B,A01,083456,Staff,21,0,30,9
1649777251382,MATH 103B,A02,083457,Staff,28,0,30,2
1649777257405,MATH 109,A01,084146,Salehi Golsefidy; Alireza,30,0,30,0
1649777257405,MATH 109,A02,084147,Salehi Golsefidy; Alireza,29,0,30,1
1649777263428,MATH 120A,A01,085445,Eggers; John Dietrich,32,0,35,3
1649777263428,MATH 120A,A02,085446,Eggers; John Dietrich,34,0,35,1
1649777269452,MATH 142B,A01,084149,Verstraete; Jacques Allan,26,0,30,4
1649777269452,MATH 142B,A02,084150,Verstraete; Jacques Allan,28,0,30,2
1649777275491,MATH 170A,A01,083459,Nie; Jiawang,21,0,30,9
1649777275491,MATH 170A,A02,083460,Nie; Jiawang,28,0,30,2
1649777275491,MATH 170A,A03,083461,Nie; Jiawang,30,0,30,0
1649777281521,MATH 193B,A01,083463,Staff,25,0,30,5
1649777281521,MATH 193B,A02,083464,Staff,29,0,30,1
1649777281521,MATH 193B,A03,083465,Staff,30,0,30,0
1649777287581,COGS 2,A01,083966,Boyle; Mary E. T.,28,0,30,2
1649777293605,COGS 9,A01,083968,Staff,59,0,60,1
1649777299632,COGS 14B,A01,083970,Staff,50,0,50,0
1649777305657,COGS 100,A01,083972,Staff,58,0,60,2
1649777317715,COGS 101C,A01,083976,Staff,29,0,30,1
1649777323751,COGS 102A,A01,083978,Johnson; Christine M.,29,0,30,1
1649777329792,COGS 107B,A01,083980,Staff,46,0,50,4
1649777335816,COGS 115,A01,083982,Staff,27,0,30,3
1649777341840,COGS 118B,A01,083367,Staff,24,0,40,16
1649777347866,COGS 172,A01,083984,Provenzano; Emily Kara,25,0,30,5
1649777353893,COGS 177,A00,083368,Staff,22,0,30,8
1649777359921,COGS 186,A01,083986,Staff,31,0,40,9
1649777365945,COGS 187A,A01,083988,Boyle; Mary E. T.,56,0,60,4
1649777371974,CSE 8A,A50,084003,Miranda; Gregory Joseph,13,0,15,2
1649777378006,CSE 11,A01,084005,Miranda; Gregory Joseph,52,0,55,3
1649777384032,CSE 20,A01,084007,Staff,17,0,20,3
1649777390059,CSE 21,A01,084009,Staff,50,0,50,0
1649777396090,CSE 30,A01,083370,Cao; Yingjun,38,0,40,2
1649777402133,CSE 100,A01,083372,Cao; Yingjun,36,0,40,4
1649777408156,CSE 101,A01,084011,Staff,25,0,40,15
1649777414182,CSE 141,A01,083374,Eldon; John,45,0,75,30
1649777420206,CSE 141L,A01,083376,Eldon; John,47,0,75,28
1649777426230,CSE 175,A01,084013,Kumar; Rakesh,25,0,25,0
1649777432257,CSE 190,A00,092508,Staff,0,0,0,0
1649777438301,ECE 5,A01,084049,Morris; Karcher William,19,0,20,1
1649777444331,ECE 100,A01,084051,Baghdadchi; Saharnaz,18,0,20,2
1649777444331,ECE 100,A02,091916,Baghdadchi; Saharnaz,20,0,20,0
1649777450357,ECE 101,A01,084053,Baghdadchi; Saharnaz,33,0,37,4
1649777450357,ECE 101,A02,084054,Baghdadchi; Saharnaz,37,0,37,0
1649777456389,ECE 107,A01,083390,Staff,36,0,40,4
1649777462413,ECE 148,A01,084056,Silberman; Jack,10,0,12,2
1649777468454,ECE 180,A00,083391,Abi Samra; Nicholas Camill,28,0,30,2
1649777468454,ECE 180,B00,083392,Abi Samra; Nicholas Camill,28,0,30,2
1649777474481,MATH 10B,A01,084110,Staff,26,0,30,4
1649777474481,MATH 10B,A02,084111,Staff,30,0,30,0
1649777474481,MATH 10B,A03,084112,Staff,30,0,30,0
1649777480519,MATH 10C,A01,083443,Staff,28,0,30,2
1649777480519,MATH 10C,A02,083444,Staff,27,0,30,3
1649777480519,MATH 10C,B01,084114,Staff,28,0,30,2
1649777480519,MATH 10C,B02,084115,Staff,30,0,30,0
1649777486543,MATH 18,A01,084117,Harel; Guershon,28,0,30,2
1649777486543,MATH 18,A02,084119,Harel; Guershon,29,0,30,1
1649777486543,MATH 18,A03,084120,Harel; Guershon,30,0,30,0
1649777486543,MATH 18,A04,084121,Harel; Guershon,30,0,30,0
1649777492639,MATH 20B,A01,084124,Um; Ko Woon,34,0,35,1
1649777492639,MATH 20B,B01,084126,Um; Ko Woon,35,0,35,0
1649777498666,MATH 20C,A01,083446,Hammock; Frances H,29,0,30,1
1649777498666,MATH 20C,A02,083447,Hammock; Frances H,30,0,30,0
1649777498666,MATH 20C,A03,083448,Hammock; Frances H,30,0,30,0
1649777498666,MATH 20C,A04,083449,Hammock; Frances H,30,0,30,0
1649777498666,MATH 20C,B01,083451,Hammock; Frances H,30,0,30,0
1649777498666,MATH 20C,B02,083452,Hammock; Frances H,30,0,30,0
1649777498666,MATH 20C,B03,083453,Hammock; Frances H,30,0,30,0
1649777498666,MATH 20C,B04,083454,Hammock; Frances H,30,0,30,0
1649777504691,MATH 20D,A01,084128,Staff,30,0,30,0
1649777504691,MATH 20D,A02,084129,Staff,30,0,30,0
1649777504691,MATH 20D,A03,084130,Staff,29,0,30,1
1649777504691,MATH 20D,B01,084133,Staff,30,0,30,0
1649777504691,MATH 20D,B02,084134,Staff,30,0,30,0
1649777504691,MATH 20D,B03,084135,Staff,30,0,30,0
1649777510720,MATH 20E,A01,084138,Staff,30,0,30,0
1649777510720,MATH 20E,A02,084139,Staff,29,0,30,1
1649777510720,MATH 20E,A03,084140,Staff,30,0,30,0
1649777510720,MATH 20E,A04,084141,Staff,30,0,30,0
1649777516745,MATH 102,A01,084143,Harel; Guershon,27,0,30,3
1649777516745,MATH 102,A02,084144,Harel; Guershon,29,0,30,1
1649777522771,MATH 103B,A01,083456,Staff,21,0,30,9
1649777522771,MATH 103B,A02,083457,Staff,28,0,30,2
1649777528795,MATH 109,A01,084146,Salehi Golsefidy; Alireza,30,0,30,0
1649777528795,MATH 109,A02,084147,Salehi Golsefidy; Alireza,29,0,30,1
1649777534820,MATH 120A,A01,085445,Eggers; John Dietrich,32,0,35,3
1649777534820,MATH 120A,A02,085446,Eggers; John Dietrich,33,0,35,2
1649777540848,MATH 142B,A01,084149,Verstraete; Jacques Allan,26,0,30,4
1649777540848,MATH 142B,A02,084150,Verstraete; Jacques Allan,28,0,30,2
1649777546876,MATH 170A,A01,083459,Nie; Jiawang,21,0,30,9
1649777546876,MATH 170A,A02,083460,Nie; Jiawang,28,0,30,2
1649777546876,MATH 170A,A03,083461,Nie; Jiawang,30,0,30,0
1649777552901,MATH 193B,A01,083463,Staff,25,0,30,5
1649777552901,MATH 193B,A02,083464,Staff,29,0,30,1
1649777552901,MATH 193B,A03,083465,Staff,30,0,30,0
1649777558966,COGS 2,A01,083966,Boyle; Mary E. T.,28,0,30,2
1649777564994,COGS 9,A01,083968,Staff,59,0,60,1
1649777571022,COGS 14B,A01,083970,Staff,50,0,50,0
1649777577048,COGS 100,A01,083972,Staff,58,0,60,2
1649777589096,COGS 101C,A01,083976,Staff,29,0,30,1
1649777595119,COGS 102A,A01,083978,Johnson; Christine M.,29,0,30,1
1649777601143,COGS 107B,A01,083980,Staff,46,0,50,4
1649777607172,COGS 115,A01,083982,Staff,27,0,30,3
1649777613199,COGS 118B,A01,083367,Staff,23,0,40,17
1649777619235,COGS 172,A01,083984,Provenzano; Emily Kara,25,0,30,5
1649777625262,COGS 177,A00,083368,Staff,22,0,30,8
1649777631292,COGS 186,A01,083986,Staff,30,0,40,10
1649777637316,COGS 187A,A01,083988,Boyle; Mary E. T.,56,0,60,4
1649777643346,CSE 8A,A50,084003,Miranda; Gregory Joseph,13,0,15,2
1649777649378,CSE 11,A01,084005,Miranda; Gregory Joseph,52,0,55,3
1649777655407,CSE 20,A01,084007,Staff,17,0,20,3
1649777661431,CSE 21,A01,084009,Staff,50,0,50,0
1649777667454,CSE 30,A01,083370,Cao; Yingjun,37,0,40,3
1649777673489,CSE 100,A01,083372,Cao; Yingjun,36,0,40,4
1649777679515,CSE 101,A01,084011,Staff,25,0,40,15
1649777685539,CSE 141,A01,083374,Eldon; John,45,0,75,30
1649777691567,CSE 141L,A01,083376,Eldon; John,47,0,75,28
1649777697614,CSE 175,A01,084013,Kumar; Rakesh,25,0,25,0
1649777703650,CSE 190,A00,092508,Staff,0,0,0,0
1649777709678,ECE 5,A01,084049,Morris; Karcher William,19,0,20,1
1649777715703,ECE 100,A01,084051,Baghdadchi; Saharnaz,18,0,20,2
1649777715703,ECE 100,A02,091916,Baghdadchi; Saharnaz,20,0,20,0
1649777721732,ECE 101,A01,084053,Baghdadchi; Saharnaz,33,0,37,4
1649777721732,ECE 101,A02,084054,Baghdadchi; Saharnaz,37,0,37,0
1649777727754,ECE 107,A01,083390,Staff,36,0,40,4
1649777733785,ECE 148,A01,084056,Silberman; Jack,10,0,12,2
1649777739815,ECE 180,A00,083391,Abi Samra; Nicholas Camill,28,0,30,2
1649777739815,ECE 180,B00,083392,Abi Samra; Nicholas Camill,28,0,30,2
1649777745845,MATH 10B,A01,084110,Staff,26,0,30,4
1649777745845,MATH 10B,A02,084111,Staff,30,0,30,0
1649777745845,MATH 10B,A03,084112,Staff,30,0,30,0
1649777751874,MATH 10C,A01,083443,Staff,28,0,30,2
1649777751874,MATH 10C,A02,083444,Staff,27,0,30,3
1649777751874,MATH 10C,B01,084114,Staff,28,0,30,2
1649777751874,MATH 10C,B02,084115,Staff,30,0,30,0
1649777757912,MATH 18,A01,084117,Harel; Guershon,28,0,30,2
1649777757912,MATH 18,A02,084119,Harel; Guershon,29,0,30,1
1649777757912,MATH 18,A03,084120,Harel; Guershon,30,0,30,0
1649777757912,MATH 18,A04,084121,Harel; Guershon,30,0,30,0
1649777763943,MATH 20B,A01,084124,Um; Ko Woon,34,0,35,1
1649777763943,MATH 20B,B01,084126,Um; Ko Woon,35,0,35,0
1649777769982,MATH 20C,A01,083446,Hammock; Frances H,29,0,30,1
1649777769982,MATH 20C,A02,083447,Hammock; Frances H,30,0,30,0
1649777769982,MATH 20C,A03,083448,Hammock; Frances H,30,0,30,0
1649777769982,MATH 20C,A04,083449,Hammock; Frances H,30,0,30,0
1649777769982,MATH 20C,B01,083451,Hammock; Frances H,30,0,30,0
1649777769982,MATH 20C,B02,083452,Hammock; Frances H,30,0,30,0
1649777769982,MATH 20C,B03,083453,Hammock; Frances H,30,0,30,0
1649777769982,MATH 20C,B04,083454,Hammock; Frances H,30,0,30,0
1649777776013,MATH 20D,A01,084128,Staff,30,0,30,0
1649777776013,MATH 20D,A02,084129,Staff,30,0,30,0
1649777776013,MATH 20D,A03,084130,Staff,29,0,30,1
1649777776013,MATH 20D,B01,084133,Staff,30,0,30,0
1649777776013,MATH 20D,B02,084134,Staff,30,0,30,0
1649777776013,MATH 20D,B03,084135,Staff,30,0,30,0
1649777782038,MATH 20E,A01,084138,Staff,30,0,30,0
1649777782038,MATH 20E,A02,084139,Staff,29,0,30,1
1649777782038,MATH 20E,A03,084140,Staff,30,0,30,0
1649777782038,MATH 20E,A04,084141,Staff,30,0,30,0
1649777788063,MATH 102,A01,084143,Harel; Guershon,27,0,30,3
1649777788063,MATH 102,A02,084144,Harel; Guershon,29,0,30,1
1649777794089,MATH 103B,A01,083456,Staff,21,0,30,9
1649777794089,MATH 103B,A02,083457,Staff,28,0,30,2
1649777800118,MATH 109,A01,084146,Salehi Golsefidy; Alireza,30,0,30,0
1649777800118,MATH 109,A02,084147,Salehi Golsefidy; Alireza,29,0,30,1
1649777806149,MATH 120A,A01,085445,Eggers; John Dietrich,32,0,35,3
1649777806149,MATH 120A,A02,085446,Eggers; John Dietrich,33,0,35,2
1649777812185,MATH 142B,A01,084149,Verstraete; Jacques Allan,26,0,30,4
1649777812185,MATH 142B,A02,084150,Verstraete; Jacques Allan,28,0,30,2
1649777818210,MATH 170A,A01,083459,Nie; Jiawang,21,0,30,9
1649777818210,MATH 170A,A02,083460,Nie; Jiawang,28,0,30,2
1649777818210,MATH 170A,A03,083461,Nie; Jiawang,30,0,30,0
1649777824235,MATH 193B,A01,083463,Staff,25,0,30,5
1649777824235,MATH 193B,A02,083464,Staff,29,0,30,1
1649777824235,MATH 193B,A03,083465,Staff,30,0,30,0
1649777830318,COGS 2,A01,083966,Boyle; Mary E. T.,28,0,30,2
1649777836343,COGS 9,A01,083968,Staff,59,0,60,1
1649777842381,COGS 14B,A01,083970,Staff,50,0,50,0
1649777848410,COGS 100,A01,083972,Staff,58,0,60,2
1649777860459,COGS 101C,A01,083976,Staff,29,0,30,1
1649777866489,COGS 102A,A01,083978,Johnson; Christine M.,29,0,30,1
1649777872513,COGS 107B,A01,083980,Staff,46,0,50,4
1649777878538,COGS 115,A01,083982,Staff,27,0,30,3
1649777884565,COGS 118B,A01,083367,Staff,22,0,40,18
1649777890596,COGS 172,A01,083984,Provenzano; Emily Kara,25,0,30,5
1649777896625,COGS 177,A00,083368,Staff,22,0,30,8
1649777902652,COGS 186,A01,083986,Staff,30,0,40,10
1649777908682,COGS 187A,A01,083988,Boyle; Mary E. T.,56,0,60,4
1649777914708,CSE 8A,A50,084003,Miranda; Gregory Joseph,13,0,15,2
1649777920731,CSE 11,A01,084005,Miranda; Gregory Joseph,52,0,55,3
1649777926761,CSE 20,A01,084007,Staff,17,0,20,3
1649777932784,CSE 21,A01,084009,Staff,50,0,50,0
1649777938809,CSE 30,A01,083370,Cao; Yingjun,37,0,40,3
1649777944840,CSE 100,A01,083372,Cao; Yingjun,36,0,40,4
1649777950869,CSE 101,A01,084011,Staff,25,0,40,15
1649777956893,CSE 141,A01,083374,Eldon; John,45,0,75,30
1649777962922,CSE 141L,A01,083376,Eldon; John,47,0,75,28
1649777968946,CSE 175,A01,084013,Kumar; Rakesh,25,0,25,0
1649777974969,CSE 190,A00,092508,Staff,0,0,0,0
1649777980999,ECE 5,A01,084049,Morris; Karcher William,19,0,20,1
1649777987025,ECE 100,A01,084051,Baghdadchi; Saharnaz,18,0,20,2
1649777987025,ECE 100,A02,091916,Baghdadchi; Saharnaz,20,0,20,0
1649777993054,ECE 101,A01,084053,Baghdadchi; Saharnaz,33,0,37,4
1649777993054,ECE 101,A02,084054,Baghdadchi; Saharnaz,37,0,37,0
1649777999086,ECE 107,A01,083390,Staff,36,0,40,4
1649778005118,ECE 148,A01,084056,Silberman; Jack,10,0,12,2
1649778011148,ECE 180,A00,083391,Abi Samra; Nicholas Camill,28,0,30,2
1649778011148,ECE 180,B00,083392,Abi Samra; Nicholas Camill,28,0,30,2
1649778017178,MATH 10B,A01,084110,Staff,26,0,30,4
1649778017178,MATH 10B,A02,084111,Staff,30,0,30,0
1649778017178,MATH 10B,A03,084112,Staff,30,0,30,0
1649778023212,MATH 10C,A01,083443,Staff,28,0,30,2
1649778023212,MATH 10C,A02,083444,Staff,27,0,30,3
1649778023212,MATH 10C,B01,084114,Staff,28,0,30,2
1649778023212,MATH 10C,B02,084115,Staff,30,0,30,0
1649778029241,MATH 18,A01,084117,Harel; Guershon,28,0,30,2
1649778029241,MATH 18,A02,084119,Harel; Guershon,29,0,30,1
1649778029241,MATH 18,A03,084120,Harel; Guershon,30,0,30,0
1649778029241,MATH 18,A04,084121,Harel; Guershon,30,0,30,0
1649778035274,MATH 20B,A01,084124,Um; Ko Woon,34,0,35,1
1649778035274,MATH 20B,B01,084126,Um; Ko Woon,35,0,35,0
1649778041304,MATH 20C,A01,083446,Hammock; Frances H,29,0,30,1
1649778041304,MATH 20C,A02,083447,Hammock; Frances H,30,0,30,0
1649778041304,MATH 20C,A03,083448,Hammock; Frances H,30,0,30,0
1649778041304,MATH 20C,A04,083449,Hammock; Frances H,30,0,30,0
1649778041304,MATH 20C,B01,083451,Hammock; Frances H,30,0,30,0
1649778041304,MATH 20C,B02,083452,Hammock; Frances H,30,0,30,0
1649778041304,MATH 20C,B03,083453,Hammock; Frances H,30,0,30,0
1649778041304,MATH 20C,B04,083454,Hammock; Frances H,30,0,30,0
1649778047330,MATH 20D,A01,084128,Staff,30,0,30,0
1649778047330,MATH 20D,A02,084129,Staff,30,0,30,0
1649778047330,MATH 20D,A03,084130,Staff,29,0,30,1
1649778047330,MATH 20D,B01,084133,Staff,30,0,30,0
1649778047330,MATH 20D,B02,084134,Staff,30,0,30,0
1649778047330,MATH 20D,B03,084135,Staff,30,0,30,0
1649778053357,MATH 20E,A01,084138,Staff,30,0,30,0
1649778053357,MATH 20E,A02,084139,Staff,29,0,30,1
1649778053357,MATH 20E,A03,084140,Staff,30,0,30,0
1649778053357,MATH 20E,A04,084141,Staff,30,0,30,0
1649778059390,MATH 102,A01,084143,Harel; Guershon,27,0,30,3
1649778059390,MATH 102,A02,084144,Harel; Guershon,29,0,30,1
1649778065414,MATH 103B,A01,083456,Staff,21,0,30,9
1649778065414,MATH 103B,A02,083457,Staff,28,0,30,2
1649778071439,MATH 109,A01,084146,Salehi Golsefidy; Alireza,30,0,30,0
1649778071439,MATH 109,A02,084147,Salehi Golsefidy; Alireza,29,0,30,1
1649778077470,MATH 120A,A01,085445,Eggers; John Dietrich,32,0,35,3
1649778077470,MATH 120A,A02,085446,Eggers; John Dietrich,33,0,35,2
1649778083510,MATH 142B,A01,084149,Verstraete; Jacques Allan,26,0,30,4
1649778083510,MATH 142B,A02,084150,Verstraete; Jacques Allan,28,0,30,2
1649778089633,MATH 170A,A01,083459,Nie; Jiawang,21,0,30,9
1649778089633,MATH 170A,A02,083460,Nie; Jiawang,28,0,30,2
1649778089633,MATH 170A,A03,083461,Nie; Jiawang,30,0,30,0
1649778095664,MATH 193B,A01,083463,Staff,25,0,30,5
1649778095664,MATH 193B,A02,083464,Staff,29,0,30,1
1649778095664,MATH 193B,A03,083465,Staff,30,0,30,0
1649778101734,COGS 2,A01,083966,Boyle; Mary E. T.,28,0,30,2
1649778107772,COGS 9,A01,083968,Staff,59,0,60,1
1649778113814,COGS 14B,A01,083970,Staff,50,0,50,0
1649778119842,COGS 100,A01,083972,Staff,58,0,60,2
1649778131891,COGS 101C,A01,083976,Staff,29,0,30,1
1649778137915,COGS 102A,A01,083978,Johnson; Christine M.,29,0,30,1
1649778143937,COGS 107B,A01,083980,Staff,46,0,50,4
1649778149975,COGS 115,A01,083982,Staff,27,0,30,3
1649778156002,COGS 118B,A01,083367,Staff,22,0,40,18
1649778162027,COGS 172,A01,083984,Provenzano; Emily Kara,25,0,30,5
1649778168050,COGS 177,A00,083368,Staff,22,0,30,8
1649778174075,COGS 186,A01,083986,Staff,30,0,40,10
1649778180099,COGS 187A,A01,083988,Boyle; Mary E. T.,56,0,60,4
1649778186134,CSE 8A,A50,084003,Miranda; Gregory Joseph,13,0,15,2
1649778192161,CSE 11,A01,084005,Miranda; Gregory Joseph,52,0,55,3
1649778198184,CSE 20,A01,084007,Staff,17,0,20,3
1649778204231,CSE 21,A01,084009,Staff,50,0,50,0
1649778210262,CSE 30,A01,083370,Cao; Yingjun,37,0,40,3
1649778216285,CSE 100,A01,083372,Cao; Yingjun,36,0,40,4
1649778222312,CSE 101,A01,084011,Staff,25,0,40,15
1649778228335,CSE 141,A01,083374,Eldon; John,45,0,75,30
1649778234362,CSE 141L,A01,083376,Eldon; John,47,0,75,28
1649778240391,CSE 175,A01,084013,Kumar; Rakesh,25,0,25,0
1649778246415,CSE 190,A00,092508,Staff,0,0,0,0
1649778252448,ECE 5,A01,084049,Morris; Karcher William,19,0,20,1
1649778258479,ECE 100,A01,084051,Baghdadchi; Saharnaz,18,0,20,2
1649778258479,ECE 100,A02,091916,Baghdadchi; Saharnaz,20,0,20,0
1649778264517,ECE 101,A01,084053,Baghdadchi; Saharnaz,33,0,37,4
1649778264517,ECE 101,A02,084054,Baghdadchi; Saharnaz,37,0,37,0
1649778270541,ECE 107,A01,083390,Staff,36,0,40,4
1649778276567,ECE 148,A01,084056,Silberman; Jack,10,0,12,2
1649778282600,ECE 180,A00,083391,Abi Samra; Nicholas Camill,28,0,30,2
1649778282600,ECE 180,B00,083392,Abi Samra; Nicholas Camill,28,0,30,2
1649778288625,MATH 10B,A01,084110,Staff,26,0,30,4
1649778288625,MATH 10B,A02,084111,Staff,30,0,30,0
1649778288625,MATH 10B,A03,084112,Staff,30,0,30,0
1649778294650,MATH 10C,A01,083443,Staff,28,0,30,2
1649778294650,MATH 10C,A02,083444,Staff,27,0,30,3
1649778294650,MATH 10C,B01,084114,Staff,28,0,30,2
1649778294650,MATH 10C,B02,084115,Staff,30,0,30,0
1649778300679,MATH 18,A01,084117,Harel; Guershon,28,0,30,2
1649778300679,MATH 18,A02,084119,Harel; Guershon,29,0,30,1
1649778300679,MATH 18,A03,084120,Harel; Guershon,30,0,30,0
1649778300679,MATH 18,A04,084121,Harel; Guershon,30,0,30,0
1649778306709,MATH 20B,A01,084124,Um; Ko Woon,34,0,35,1
1649778306709,MATH 20B,B01,084126,Um; Ko Woon,35,0,35,0
1649778312741,MATH 20C,A01,083446,Hammock; Frances H,29,0,30,1
1649778312741,MATH 20C,A02,083447,Hammock; Frances H,30,0,30,0
1649778312741,MATH 20C,A03,083448,Hammock; Frances H,30,0,30,0
1649778312741,MATH 20C,A04,083449,Hammock; Frances H,30,0,30,0
1649778312741,MATH 20C,B01,083451,Hammock; Frances H,30,0,30,0
1649778312741,MATH 20C,B02,083452,Hammock; Frances H,30,0,30,0
1649778312741,MATH 20C,B03,083453,Hammock; Frances H,30,0,30,0
1649778312741,MATH 20C,B04,083454,Hammock; Frances H,30,0,30,0
1649778318775,MATH 20D,A01,084128,Staff,30,0,30,0
1649778318775,MATH 20D,A02,084129,Staff,30,0,30,0
1649778318775,MATH 20D,A03,084130,Staff,29,0,30,1
1649778318775,MATH 20D,B01,084133,Staff,30,0,30,0
1649778318775,MATH 20D,B02,084134,Staff,30,0,30,0
1649778318775,MATH 20D,B03,084135,Staff,30,0,30,0
1649778324810,MATH 20E,A01,084138,Staff,30,0,30,0
1649778324810,MATH 20E,A02,084139,Staff,29,0,30,1
1649778324810,MATH 20E,A03,084140,Staff,30,0,30,0
1649778324810,MATH 20E,A04,084141,Staff,30,0,30,0
1649778330838,MATH 102,A01,084143,Harel; Guershon,27,0,30,3
1649778330838,MATH 102,A02,084144,Harel; Guershon,29,0,30,1
1649778336865,MATH 103B,A01,083456,Staff,21,0,30,9
1649778336865,MATH 103B,A02,083457,Staff,28,0,30,2
1649778342895,MATH 109,A01,084146,Salehi Golsefidy; Alireza,30,0,30,0
1649778342895,MATH 109,A02,084147,Salehi Golsefidy; Alireza,29,0,30,1
1649778348918,MATH 120A,A01,085445,Eggers; John Dietrich,32,0,35,3
1649778348918,MATH 120A,A02,085446,Eggers; John Dietrich,33,0,35,2
1649778354947,MATH 142B,A01,084149,Verstraete; Jacques Allan,26,0,30,4
1649778354947,MATH 142B,A02,084150,Verstraete; Jacques Allan,28,0,30,2
1649778360976,MATH 170A,A01,083459,Nie; Jiawang,21,0,30,9
1649778360976,MATH 170A,A02,083460,Nie; Jiawang,28,0,30,2
1649778360976,MATH 170A,A03,083461,Nie; Jiawang,30,0,30,0
1649778367000,MATH 193B,A01,083463,Staff,25,0,30,5
1649778367000,MATH 193B,A02,083464,Staff,29,0,30,1
1649778367000,MATH 193B,A03,083465,Staff,30,0,30,0
1649778373064,COGS 2,A01,083966,Boyle; Mary E. T.,28,0,30,2
1649778379089,COGS 9,A01,083968,Staff,59,0,60,1
1649778385115,COGS 14B,A01,083970,Staff,50,0,50,0
1649778391139,COGS 100,A01,083972,Staff,58,0,60,2
1649778403206,COGS 101C,A01,083976,Staff,29,0,30,1
1649778409232,COGS 102A,A01,083978,Johnson; Christine M.,29,0,30,1
1649778415268,COGS 107B,A01,083980,Staff,46,0,50,4
1649778421291,COGS 115,A01,083982,Staff,27,0,30,3
1649778427320,COGS 118B,A01,083367,Staff,22,0,40,18
1649778433349,COGS 172,A01,083984,Provenzano; Emily Kara,25,0,30,5
1649778439373,COGS 177,A00,083368,Staff,22,0,30,8
1649778445398,COGS 186,A01,083986,Staff,30,0,40,10
1649778451423,COGS 187A,A01,083988,Boyle; Mary E. T.,56,0,60,4
1649778457452,CSE 8A,A50,084003,Miranda; Gregory Joseph,13,0,15,2
1649778463479,CSE 11,A01,084005,Miranda; Gregory Joseph,52,0,55,3
1649778469506,CSE 20,A01,084007,Staff,17,0,20,3
1649778475544,CSE 21,A01,084009,Staff,50,0,50,0
1649778481569,CSE 30,A01,083370,Cao; Yingjun,37,0,40,3
1649778487592,CSE 100,A01,083372,Cao; Yingjun,36,0,40,4
1649778493620,CSE 101,A01,084011,Staff,25,0,40,15
1649778499645,CSE 141,A01,083374,Eldon; John,45,0,75,30
1649778505673,CSE 141L,A01,083376,Eldon; John,47,0,75,28
1649778511708,CSE 175,A01,084013,Kumar; Rakesh,25,0,25,0
1649778517741,CSE 190,A00,092508,Staff,0,0,0,0
1649778523769,ECE 5,A01,084049,Morris; Karcher William,19,0,20,1
1649778529803,ECE 100,A01,084051,Baghdadchi; Saharnaz,18,0,20,2
1649778529803,ECE 100,A02,091916,Baghdadchi; Saharnaz,20,0,20,0
1649778535833,ECE 101,A01,084053,Baghdadchi; Saharnaz,33,0,37,4
1649778535833,ECE 101,A02,084054,Baghdadchi; Saharnaz,37,0,37,0
1649778541862,ECE 107,A01,083390,Staff,36,0,40,4
1649778547893,ECE 148,A01,084056,Silberman; Jack,10,0,12,2
1649778553921,ECE 180,A00,083391,Abi Samra; Nicholas Camill,28,0,30,2
1649778553921,ECE 180,B00,083392,Abi Samra; Nicholas Camill,28,0,30,2
1649778559947,MATH 10B,A01,084110,Staff,26,0,30,4
1649778559947,MATH 10B,A02,084111,Staff,30,0,30,0
1649778559947,MATH 10B,A03,084112,Staff,30,0,30,0
1649778565985,MATH 10C,A01,083443,Staff,28,0,30,2
1649778565985,MATH 10C,A02,083444,Staff,27,0,30,3
1649778565985,MATH 10C,B01,084114,Staff,28,0,30,2
1649778565985,MATH 10C,B02,084115,Staff,30,0,30,0
1649778572009,MATH 18,A01,084117,Harel; Guershon,28,0,30,2
1649778572009,MATH 18,A02,084119,Harel; Guershon,29,0,30,1
1649778572009,MATH 18,A03,084120,Harel; Guershon,30,0,30,0
1649778572009,MATH 18,A04,084121,Harel; Guershon,30,0,30,0
1649778578039,MATH 20B,A01,084124,Um; Ko Woon,34,0,35,1
1649778578039,MATH 20B,B01,084126,Um; Ko Woon,35,0,35,0
1649778584072,MATH 20C,A01,083446,Hammock; Frances H,29,0,30,1
1649778584072,MATH 20C,A02,083447,Hammock; Frances H,30,0,30,0
1649778584072,MATH 20C,A03,083448,Hammock; Frances H,30,0,30,0
1649778584072,MATH 20C,A04,083449,Hammock; Frances H,30,0,30,0
1649778584072,MATH 20C,B01,083451,Hammock; Frances H,30,0,30,0
1649778584072,MATH 20C,B02,083452,Hammock; Frances H,30,0,30,0
1649778584072,MATH 20C,B03,083453,Hammock; Frances H,30,0,30,0
1649778584072,MATH 20C,B04,083454,Hammock; Frances H,30,0,30,0
1649778590103,MATH 20D,A01,084128,Staff,30,0,30,0
1649778590103,MATH 20D,A02,084129,Staff,30,0,30,0
1649778590103,MATH 20D,A03,084130,Staff,29,0,30,1
1649778590103,MATH 20D,B01,084133,Staff,30,0,30,0
1649778590103,MATH 20D,B02,084134,Staff,30,0,30,0
1649778590103,MATH 20D,B03,084135,Staff,30,0,30,0
1649778596132,MATH 20E,A01,084138,Staff,30,0,30,0
1649778596132,MATH 20E,A02,084139,Staff,29,0,30,1
1649778596132,MATH 20E,A03,084140,Staff,30,0,30,0
1649778596132,MATH 20E,A04,084141,Staff,30,0,30,0
1649778602168,MATH 102,A01,084143,Harel; Guershon,27,0,30,3
1649778602168,MATH 102,A02,084144,Harel; Guershon,29,0,30,1
1649778608192,MATH 103B,A01,083456,Staff,21,0,30,9
1649778608192,MATH 103B,A02,083457,Staff,28,0,30,2
1649778614218,MATH 109,A01,084146,Salehi Golsefidy; Alireza,30,0,30,0
1649778614218,MATH 109,A02,084147,Salehi Golsefidy; Alireza,29,0,30,1
1649778620249,MATH 120A,A01,085445,Eggers; John Dietrich,32,0,35,3
1649778620249,MATH 120A,A02,085446,Eggers; John Dietrich,33,0,35,2
1649778626273,MATH 142B,A01,084149,Verstraete; Jacques Allan,26,0,30,4
1649778626273,MATH 142B,A02,084150,Verstraete; Jacques Allan,28,0,30,2
1649778632304,MATH 170A,A01,083459,Nie; Jiawang,21,0,30,9
1649778632304,MATH 170A,A02,083460,Nie; Jiawang,28,0,30,2
1649778632304,MATH 170A,A03,083461,Nie; Jiawang,30,0,30,0
1649778638327,MATH 193B,A01,083463,Staff,25,0,30,5
1649778638327,MATH 193B,A02,083464,Staff,29,0,30,1
1649778638327,MATH 193B,A03,083465,Staff,30,0,30,0
1649778644393,COGS 2,A01,083966,Boyle; Mary E. T.,28,0,30,2
1649778650419,COGS 9,A01,083968,Staff,59,0,60,1
1649778656448,COGS 14B,A01,083970,Staff,50,0,50,0
1649778662474,COGS 100,A01,083972,Staff,58,0,60,2
1649778674529,COGS 101C,A01,083976,Staff,29,0,30,1
1649778680660,COGS 102A,A01,083978,Johnson; Christine M.,29,0,30,1
1649778686685,COGS 107B,A01,083980,Staff,46,0,50,4
1649778692718,COGS 115,A01,083982,Staff,27,0,30,3
1649778698744,COGS 118B,A01,083367,Staff,22,0,40,18
1649778704775,COGS 172,A01,083984,Provenzano; Emily Kara,25,0,30,5
1649778710801,COGS 177,A00,083368,Staff,22,0,30,8
1649778716847,COGS 186,A01,083986,Staff,30,0,40,10
1649778722881,COGS 187A,A01,083988,Boyle; Mary E. T.,56,0,60,4
1649778728910,CSE 8A,A50,084003,Miranda; Gregory Joseph,13,0,15,2
1649778734944,CSE 11,A01,084005,Miranda; Gregory Joseph,52,0,55,3
1649778740974,CSE 20,A01,084007,Staff,17,0,20,3
1649778747007,CSE 21,A01,084009,Staff,50,0,50,0
1649778753033,CSE 30,A01,083370,Cao; Yingjun,37,0,40,3
1649778759062,CSE 100,A01,083372,Cao; Yingjun,36,0,40,4
1649778765085,CSE 101,A01,084011,Staff,25,0,40,15
1649778771112,CSE 141,A01,083374,Eldon; John,45,0,75,30
1649778777135,CSE 141L,A01,083376,Eldon; John,47,0,75,28
1649778783158,CSE 175,A01,084013,Kumar; Rakesh,25,0,25,0
1649778789182,CSE 190,A00,092508,Staff,0,0,0,0
1649778795211,ECE 5,A01,084049,Morris; Karcher William,19,0,20,1
1649778801244,ECE 100,A01,084051,Baghdadchi; Saharnaz,18,0,20,2
1649778801244,ECE 100,A02,091916,Baghdadchi; Saharnaz,20,0,20,0
1649778807280,ECE 101,A01,084053,Baghdadchi; Saharnaz,33,0,37,4
1649778807280,ECE 101,A02,084054,Baghdadchi; Saharnaz,37,0,37,0
1649778813307,ECE 107,A01,083390,Staff,36,0,40,4
1649778819344,ECE 148,A01,084056,Silberman; Jack,10,0,12,2
1649778825367,ECE 180,A00,083391,Abi Samra; Nicholas Camill,28,0,30,2
1649778825367,ECE 180,B00,083392,Abi Samra; Nicholas Camill,28,0,30,2
1649778831399,MATH 10B,A01,084110,Staff,26,0,30,4
1649778831399,MATH 10B,A02,084111,Staff,30,0,30,0
1649778831399,MATH 10B,A03,084112,Staff,30,0,30,0
1649778837438,MATH 10C,A01,083443,Staff,28,0,30,2
1649778837438,MATH 10C,A02,083444,Staff,27,0,30,3
1649778837438,MATH 10C,B01,084114,Staff,28,0,30,2
1649778837438,MATH 10C,B02,084115,Staff,30,0,30,0
1649778843466,MATH 18,A01,084117,Harel; Guershon,28,0,30,2
1649778843466,MATH 18,A02,084119,Harel; Guershon,29,0,30,1
1649778843466,MATH 18,A03,084120,Harel; Guershon,30,0,30,0
1649778843466,MATH 18,A04,084121,Harel; Guershon,30,0,30,0
1649778849501,MATH 20B,A01,084124,Um; Ko Woon,34,0,35,1
1649778849501,MATH 20B,B01,084126,Um; Ko Woon,35,0,35,0
1649778855531,MATH 20C,A01,083446,Hammock; Frances H,29,0,30,1
1649778855531,MATH 20C,A02,083447,Hammock; Frances H,30,0,30,0
1649778855531,MATH 20C,A03,083448,Hammock; Frances H,30,0,30,0
1649778855531,MATH 20C,A04,083449,Hammock; Frances H,30,0,30,0
1649778855531,MATH 20C,B01,083451,Hammock; Frances H,30,0,30,0
1649778855531,MATH 20C,B02,083452,Hammock; Frances H,30,0,30,0
1649778855531,MATH 20C,B03,083453,Hammock; Frances H,30,0,30,0
1649778855531,MATH 20C,B04,083454,Hammock; Frances H,30,0,30,0
1649778861560,MATH 20D,A01,084128,Staff,30,0,30,0
1649778861560,MATH 20D,A02,084129,Staff,30,0,30,0
1649778861560,MATH 20D,A03,084130,Staff,29,0,30,1
1649778861560,MATH 20D,B01,084133,Staff,30,0,30,0
1649778861560,MATH 20D,B02,084134,Staff,30,0,30,0
1649778861560,MATH 20D,B03,084135,Staff,30,0,30,0
1649778867584,MATH 20E,A01,084138,Staff,30,0,30,0
1649778867584,MATH 20E,A02,084139,Staff,29,0,30,1
1649778867584,MATH 20E,A03,084140,Staff,30,0,30,0
1649778867584,MATH 20E,A04,084141,Staff,30,0,30,0
1649778873613,MATH 102,A01,084143,Harel; Guershon,27,0,30,3
1649778873613,MATH 102,A02,084144,Harel; Guershon,29,0,30,1
1649778879646,MATH 103B,A01,083456,Staff,21,0,30,9
1649778879646,MATH 103B,A02,083457,Staff,28,0,30,2
1649778885681,MATH 109,A01,084146,Salehi Golsefidy; Alireza,30,0,30,0
1649778885681,MATH 109,A02,084147,Salehi Golsefidy; Alireza,29,0,30,1
1649778891708,MATH 120A,A01,085445,Eggers; John Dietrich,32,0,35,3
1649778891708,MATH 120A,A02,085446,Eggers; John Dietrich,33,0,35,2
1649778897736,MATH 142B,A01,084149,Verstraete; Jacques Allan,26,0,30,4
1649778897736,MATH 142B,A02,084150,Verstraete; Jacques Allan,28,0,30,2
1649778903761,MATH 170A,A01,083459,Nie; Jiawang,21,0,30,9
1649778903761,MATH 170A,A02,083460,Nie; Jiawang,28,0,30,2
1649778903761,MATH 170A,A03,083461,Nie; Jiawang,30,0,30,0
1649778909789,MATH 193B,A01,083463,Staff,25,0,30,5
1649778909789,MATH 193B,A02,083464,Staff,29,0,30,1
1649778909789,MATH 193B,A03,083465,Staff,30,0,30,0
1649778915869,COGS 2,A01,083966,Boyle; Mary E. T.,28,0,30,2
1649778921893,COGS 9,A01,083968,Staff,59,0,60,1
1649778927919,COGS 14B,A01,083970,Staff,50,0,50,0
1649778933946,COGS 100,A01,083972,Staff,58,0,60,2
1649778945999,COGS 101C,A01,083976,Staff,29,0,30,1
1649778952025,COGS 102A,A01,083978,Johnson; Christine M.,29,0,30,1
1649778958050,COGS 107B,A01,083980,Staff,46,0,50,4
1649778964074,COGS 115,A01,083982,Staff,27,0,30,3
1649778970097,COGS 118B,A01,083367,Staff,22,0,40,18
1649778976129,COGS 172,A01,083984,Provenzano; Emily Kara,25,0,30,5
1649778982157,COGS 177,A00,083368,Staff,22,0,30,8
1649778988183,COGS 186,A01,083986,Staff,30,0,40,10
1649778994207,COGS 187A,A01,083988,Boyle; Mary E. T.,56,0,60,4
1649779000242,CSE 8A,A50,084003,Miranda; Gregory Joseph,13,0,15,2
1649779006264,CSE 11,A01,084005,Miranda; Gregory Joseph,52,0,55,3
1649779012299,CSE 20,A01,084007,Staff,17,0,20,3
1649779018324,CSE 21,A01,084009,Staff,50,0,50,0
1649779024356,CSE 30,A01,083370,Cao; Yingjun,37,0,40,3
1649779030386,CSE 100,A01,083372,Cao; Yingjun,36,0,40,4
1649779036413,CSE 101,A01,084011,Staff,25,0,40,15
1649779042438,CSE 141,A01,083374,Eldon; John,45,0,75,30
1649779048467,CSE 141L,A01,083376,Eldon; John,47,0,75,28
1649779054503,CSE 175,A01,084013,Kumar; Rakesh,25,0,25,0
1649779060536,CSE 190,A00,092508,Staff,0,0,0,0
1649779066567,ECE 5,A01,084049,Morris; Karcher William,19,0,20,1
1649779072596,ECE 100,A01,084051,Baghdadchi; Saharnaz,18,0,20,2
1649779072596,ECE 100,A02,091916,Baghdadchi; Saharnaz,20,0,20,0
1649779078621,ECE 101,A01,084053,Baghdadchi; Saharnaz,33,0,37,4
1649779078621,ECE 101,A02,084054,Baghdadchi; Saharnaz,37,0,37,0
1649779084652,ECE 107,A01,083390,Staff,36,0,40,4
1649779090677,ECE 148,A01,084056,Silberman; Jack,10,0,12,2
1649779096701,ECE 180,A00,083391,Abi Samra; Nicholas Camill,28,0,30,2
1649779096701,ECE 180,B00,083392,Abi Samra; Nicholas Camill,28,0,30,2
1649779102729,MATH 10B,A01,084110,Staff,26,0,30,4
1649779102729,MATH 10B,A02,084111,Staff,30,0,30,0
1649779102729,MATH 10B,A03,084112,Staff,30,0,30,0
1649779108759,MATH 10C,A01,083443,Staff,28,0,30,2
1649779108759,MATH 10C,A02,083444,Staff,27,0,30,3
1649779108759,MATH 10C,B01,084114,Staff,28,0,30,2
1649779108759,MATH 10C,B02,084115,Staff,30,0,30,0
1649779114801,MATH 18,A01,084117,Harel; Guershon,28,0,30,2
1649779114801,MATH 18,A02,084119,Harel; Guershon,29,0,30,1
1649779114801,MATH 18,A03,084120,Harel; Guershon,30,0,30,0
1649779114801,MATH 18,A04,084121,Harel; Guershon,30,0,30,0
1649779120839,MATH 20B,A01,084124,Um; Ko Woon,34,0,35,1
1649779120839,MATH 20B,B01,084126,Um; Ko Woon,35,0,35,0
1649779126866,MATH 20C,A01,083446,Hammock; Frances H,29,0,30,1
1649779126866,MATH 20C,A02,083447,Hammock; Frances H,30,0,30,0
1649779126866,MATH 20C,A03,083448,Hammock; Frances H,30,0,30,0
1649779126866,MATH 20C,A04,083449,Hammock; Frances H,30,0,30,0
1649779126866,MATH 20C,B01,083451,Hammock; Frances H,30,0,30,0
1649779126866,MATH 20C,B02,083452,Hammock; Frances H,30,0,30,0
1649779126866,MATH 20C,B03,083453,Hammock; Frances H,30,0,30,0
1649779126866,MATH 20C,B04,083454,Hammock; Frances H,30,0,30,0
1649779132896,MATH 20D,A01,084128,Staff,30,0,30,0
1649779132896,MATH 20D,A02,084129,Staff,30,0,30,0
1649779132896,MATH 20D,A03,084130,Staff,29,0,30,1
1649779132896,MATH 20D,B01,084133,Staff,30,0,30,0
1649779132896,MATH 20D,B02,084134,Staff,30,0,30,0
1649779132896,MATH 20D,B03,084135,Staff,30,0,30,0
1649779138922,MATH 20E,A01,084138,Staff,30,0,30,0
1649779138922,MATH 20E,A02,084139,Staff,29,0,30,1
1649779138922,MATH 20E,A03,084140,Staff,30,0,30,0
1649779138922,MATH 20E,A04,084141,Staff,30,0,30,0
1649779144957,MATH 102,A01,084143,Harel; Guershon,27,0,30,3
1649779144957,MATH 102,A02,084144,Harel; Guershon,29,0,30,1
1649779150981,MATH 103B,A01,083456,Staff,21,0,30,9
1649779150981,MATH 103B,A02,083457,Staff,28,0,30,2
1649779157009,MATH 109,A01,084146,Salehi Golsefidy; Alireza,30,0,30,0
1649779157009,MATH 109,A02,084147,Salehi Golsefidy; Alireza,29,0,30,1
1649779163037,MATH 120A,A01,085445,Eggers; John Dietrich,32,0,35,3
1649779163037,MATH 120A,A02,085446,Eggers; John Dietrich,33,0,35,2
1649779169064,MATH 142B,A01,084149,Verstraete; Jacques Allan,26,0,30,4
1649779169064,MATH 142B,A02,084150,Verstraete; Jacques Allan,28,0,30,2
1649779175089,MATH 170A,A01,083459,Nie; Jiawang,21,0,30,9
1649779175089,MATH 170A,A02,083460,Nie; Jiawang,28,0,30,2
1649779175089,MATH 170A,A03,083461,Nie; Jiawang,30,0,30,0
1649779181118,MATH 193B,A01,083463,Staff,25,0,30,5
1649779181118,MATH 193B,A02,083464,Staff,29,0,30,1
1649779181118,MATH 193B,A03,083465,Staff,30,0,30,0
1649779187183,COGS 2,A01,083966,Boyle; Mary E. T.,28,0,30,2
1649779193208,COGS 9,A01,083968,Staff,59,0,60,1
1649779199246,COGS 14B,A01,083970,Staff,50,0,50,0
1649779205280,COGS 100,A01,083972,Staff,58,0,60,2
1649779217352,COGS 101C,A01,083976,Staff,29,0,30,1
1649779223380,COGS 102A,A01,083978,Johnson; Christine M.,29,0,30,1
1649779229408,COGS 107B,A01,083980,Staff,46,0,50,4
1649779235434,COGS 115,A01,083982,Staff,27,0,30,3
1649779241468,COGS 118B,A01,083367,Staff,22,0,40,18
1649779247510,COGS 172,A01,083984,Provenzano; Emily Kara,25,0,30,5
1649779253536,COGS 177,A00,083368,Staff,22,0,30,8
1649779259564,COGS 186,A01,083986,Staff,30,0,40,10
1649779265592,COGS 187A,A01,083988,Boyle; Mary E. T.,56,0,60,4
1649779271623,CSE 8A,A50,084003,Miranda; Gregory Joseph,13,0,15,2
1649779277758,CSE 11,A01,084005,Miranda; Gregory Joseph,52,0,55,3
1649779283792,CSE 20,A01,084007,Staff,17,0,20,3
1649779289822,CSE 21,A01,084009,Staff,50,0,50,0
1649779295850,CSE 30,A01,083370,Cao; Yingjun,37,0,40,3
1649779301875,CSE 100,A01,083372,Cao; Yingjun,36,0,40,4
1649779307906,CSE 101,A01,084011,Staff,25,0,40,15
1649779313930,CSE 141,A01,083374,Eldon; John,45,0,75,30
1649779319959,CSE 141L,A01,083376,Eldon; John,47,0,75,28
1649779325988,CSE 175,A01,084013,Kumar; Rakesh,25,0,25,0
1649779332013,CSE 190,A00,092508,Staff,15,0,15,0
1649779338038,ECE 5,A01,084049,Morris; Karcher William,19,0,20,1
1649779344068,ECE 100,A01,084051,Baghdadchi; Saharnaz,18,0,20,2
1649779344068,ECE 100,A02,091916,Baghdadchi; Saharnaz,20,0,20,0
1649779350100,ECE 101,A01,084053,Baghdadchi; Saharnaz,33,0,37,4
1649779350100,ECE 101,A02,084054,Baghdadchi; Saharnaz,37,0,37,0
1649779356125,ECE 107,A01,083390,Staff,36,0,40,4
1649779362157,ECE 148,A01,084056,Silberman; Jack,10,0,12,2
1649779368182,ECE 180,A00,083391,Abi Samra; Nicholas Camill,28,0,30,2
1649779368182,ECE 180,B00,083392,Abi Samra; Nicholas Camill,28,0,30,2
1649779374223,MATH 10B,A01,084110,Staff,26,0,30,4
1649779374223,MATH 10B,A02,084111,Staff,30,0,30,0
1649779374223,MATH 10B,A03,084112,Staff,30,0,30,0
1649779380256,MATH 10C,A01,083443,Staff,28,0,30,2
1649779380256,MATH 10C,A02,083444,Staff,27,0,30,3
1649779380256,MATH 10C,B01,084114,Staff,28,0,30,2
1649779380256,MATH 10C,B02,084115,Staff,30,0,30,0
1649779386290,MATH 18,A01,084117,Harel; Guershon,28,0,30,2
1649779386290,MATH 18,A02,084119,Harel; Guershon,29,0,30,1
1649779386290,MATH 18,A03,084120,Harel; Guershon,30,0,30,0
1649779386290,MATH 18,A04,084121,Harel; Guershon,30,0,30,0
1649779392317,MATH 20B,A01,084124,Um; Ko Woon,34,0,35,1
1649779392317,MATH 20B,B01,084126,Um; Ko Woon,35,0,35,0
1649779398347,MATH 20C,A01,083446,Hammock; Frances H,29,0,30,1
1649779398347,MATH 20C,A02,083447,Hammock; Frances H,30,0,30,0
1649779398347,MATH 20C,A03,083448,Hammock; Frances H,30,0,30,0
1649779398347,MATH 20C,A04,083449,Hammock; Frances H,30,0,30,0
1649779398347,MATH 20C,B01,083451,Hammock; Frances H,30,0,30,0
1649779398347,MATH 20C,B02,083452,Hammock; Frances H,30,0,30,0
1649779398347,MATH 20C,B03,083453,Hammock; Frances H,30,0,30,0
1649779398347,MATH 20C,B04,083454,Hammock; Frances H,30,0,30,0
1649779404369,MATH 20D,A01,084128,Staff,30,0,30,0
1649779404369,MATH 20D,A02,084129,Staff,30,0,30,0
1649779404369,MATH 20D,A03,084130,Staff,29,0,30,1
1649779404369,MATH 20D,B01,084133,Staff,30,0,30,0
1649779404369,MATH 20D,B02,084134,Staff,30,0,30,0
1649779404369,MATH 20D,B03,084135,Staff,30,0,30,0
1649779410395,MATH 20E,A01,084138,Staff,30,0,30,0
1649779410395,MATH 20E,A02,084139,Staff,29,0,30,1
1649779410395,MATH 20E,A03,084140,Staff,30,0,30,0
1649779410395,MATH 20E,A04,084141,Staff,30,0,30,0
1649779416437,MATH 102,A01,084143,Harel; Guershon,27,0,30,3
1649779416437,MATH 102,A02,084144,Harel; Guershon,29,0,30,1
1649779422464,MATH 103B,A01,083456,Staff,21,0,30,9
1649779422464,MATH 103B,A02,083457,Staff,28,0,30,2
1649779428499,MATH 109,A01,084146,Salehi Golsefidy; Alireza,30,0,30,0
1649779428499,MATH 109,A02,084147,Salehi Golsefidy; Alireza,29,0,30,1
1649779434522,MATH 120A,A01,085445,Eggers; John Dietrich,32,0,35,3
1649779434522,MATH 120A,A02,085446,Eggers; John Dietrich,33,0,35,2
1649779440545,MATH 142B,A01,084149,Verstraete; Jacques Allan,26,0,30,4
1649779440545,MATH 142B,A02,084150,Verstraete; Jacques Allan,28,0,30,2
1649779446576,MATH 170A,A01,083459,Nie; Jiawang,21,0,30,9
1649779446576,MATH 170A,A02,083460,Nie; Jiawang,28,0,30,2
1649779446576,MATH 170A,A03,083461,Nie; Jiawang,30,0,30,0
1649779452599,MATH 193B,A01,083463,Staff,25,0,30,5
1649779452599,MATH 193B,A02,083464,Staff,29,0,30,1
1649779452599,MATH 193B,A03,083465,Staff,30,0,30,0
1649779458665,COGS 2,A01,083966,Boyle; Mary E. T.,28,0,30,2
1649779464688,COGS 9,A01,083968,Staff,59,0,60,1
1649779470713,COGS 14B,A01,083970,Staff,50,0,50,0
1649779476736,COGS 100,A01,083972,Staff,58,0,60,2
1649779488786,COGS 101C,A01,083976,Staff,29,0,30,1
1649779494818,COGS 102A,A01,083978,Johnson; Christine M.,29,0,30,1
1649779500842,COGS 107B,A01,083980,Staff,46,0,50,4
1649779506868,COGS 115,A01,083982,Staff,27,0,30,3
1649779512891,COGS 118B,A01,083367,Staff,22,0,40,18
1649779518920,COGS 172,A01,083984,Provenzano; Emily Kara,25,0,30,5
1649779524949,COGS 177,A00,083368,Staff,22,0,30,8
1649779530980,COGS 186,A01,083986,Staff,30,0,40,10
1649779537011,COGS 187A,A01,083988,Boyle; Mary E. T.,56,0,60,4
1649779543057,CSE 8A,A50,084003,Miranda; Gregory Joseph,13,0,15,2
1649779549080,CSE 11,A01,084005,Miranda; Gregory Joseph,52,0,55,3
1649779555120,CSE 20,A01,084007,Staff,17,0,20,3
1649779561156,CSE 21,A01,084009,Staff,50,0,50,0
1649779567192,CSE 30,A01,083370,Cao; Yingjun,37,0,40,3
1649779573215,CSE 100,A01,083372,Cao; Yingjun,36,0,40,4
1649779579240,CSE 101,A01,084011,Staff,25,0,40,15
1649779585264,CSE 141,A01,083374,Eldon; John,44,0,75,31
1649779591288,CSE 141L,A01,083376,Eldon; John,46,0,75,29
1649779597328,CSE 175,A01,084013,Kumar; Rakesh,25,0,25,0
1649779603363,CSE 190,A00,092508,Staff,15,0,15,0
1649779609386,ECE 5,A01,084049,Morris; Karcher William,19,0,20,1
1649779615413,ECE 100,A01,084051,Baghdadchi; Saharnaz,18,0,20,2
1649779615413,ECE 100,A02,091916,Baghdadchi; Saharnaz,20,0,20,0
1649779621441,ECE 101,A01,084053,Baghdadchi; Saharnaz,33,0,37,4
1649779621441,ECE 101,A02,084054,Baghdadchi; Saharnaz,37,0,37,0
1649779627466,ECE 107,A01,083390,Staff,36,0,40,4
1649779633489,ECE 148,A01,084056,Silberman; Jack,10,0,12,2
1649779639516,ECE 180,A00,083391,Abi Samra; Nicholas Camill,28,0,30,2
1649779639516,ECE 180,B00,083392,Abi Samra; Nicholas Camill,28,0,30,2
1649779645544,MATH 10B,A01,084110,Staff,26,0,30,4
1649779645544,MATH 10B,A02,084111,Staff,30,0,30,0
1649779645544,MATH 10B,A03,084112,Staff,30,0,30,0
1649779651574,MATH 10C,A01,083443,Staff,28,0,30,2
1649779651574,MATH 10C,A02,083444,Staff,27,0,30,3
1649779651574,MATH 10C,B01,084114,Staff,28,0,30,2
1649779651574,MATH 10C,B02,084115,Staff,30,0,30,0
1649779657600,MATH 18,A01,084117,Harel; Guershon,28,0,30,2
1649779657600,MATH 18,A02,084119,Harel; Guershon,29,0,30,1
1649779657600,MATH 18,A03,084120,Harel; Guershon,30,0,30,0
1649779657600,MATH 18,A04,084121,Harel; Guershon,30,0,30,0
1649779663625,MATH 20B,A01,084124,Um; Ko Woon,34,0,35,1
1649779663625,MATH 20B,B01,084126,Um; Ko Woon,35,0,35,0
1649779669664,MATH 20C,A01,083446,Hammock; Frances H,29,0,30,1
1649779669664,MATH 20C,A02,083447,Hammock; Frances H,30,0,30,0
1649779669664,MATH 20C,A03,083448,Hammock; Frances H,30,0,30,0
1649779669664,MATH 20C,A04,083449,Hammock; Frances H,30,0,30,0
1649779669664,MATH 20C,B01,083451,Hammock; Frances H,30,0,30,0
1649779669664,MATH 20C,B02,083452,Hammock; Frances H,30,0,30,0
1649779669664,MATH 20C,B03,083453,Hammock; Frances H,30,0,30,0
1649779669664,MATH 20C,B04,083454,Hammock; Frances H,30,0,30,0
1649779675700,MATH 20D,A01,084128,Staff,30,0,30,0
1649779675700,MATH 20D,A02,084129,Staff,30,0,30,0
1649779675700,MATH 20D,A03,084130,Staff,29,0,30,1
1649779675700,MATH 20D,B01,084133,Staff,30,0,30,0
1649779675700,MATH 20D,B02,084134,Staff,30,0,30,0
1649779675700,MATH 20D,B03,084135,Staff,30,0,30,0
1649779681728,MATH 20E,A01,084138,Staff,30,0,30,0
1649779681728,MATH 20E,A02,084139,Staff,29,0,30,1
1649779681728,MATH 20E,A03,084140,Staff,30,0,30,0
1649779681728,MATH 20E,A04,084141,Staff,30,0,30,0
1649779687752,MATH 102,A01,084143,Harel; Guershon,27,0,30,3
1649779687752,MATH 102,A02,084144,Harel; Guershon,29,0,30,1
1649779693774,MATH 103B,A01,083456,Staff,21,0,30,9
1649779693774,MATH 103B,A02,083457,Staff,28,0,30,2
1649779699809,MATH 109,A01,084146,Salehi Golsefidy; Alireza,30,0,30,0
1649779699809,MATH 109,A02,084147,Salehi Golsefidy; Alireza,29,0,30,1
1649779705833,MATH 120A,A01,085445,Eggers; John Dietrich,32,0,35,3
1649779705833,MATH 120A,A02,085446,Eggers; John Dietrich,33,0,35,2
1649779711862,MATH 142B,A01,084149,Verstraete; Jacques Allan,26,0,30,4
1649779711862,MATH 142B,A02,084150,Verstraete; Jacques Allan,28,0,30,2
1649779717890,MATH 170A,A01,083459,Nie; Jiawang,21,0,30,9
1649779717890,MATH 170A,A02,083460,Nie; Jiawang,28,0,30,2
1649779717890,MATH 170A,A03,083461,Nie; Jiawang,30,0,30,0
1649779723914,MATH 193B,A01,083463,Staff,25,0,30,5
1649779723914,MATH 193B,A02,083464,Staff,29,0,30,1
1649779723914,MATH 193B,A03,083465,Staff,30,0,30,0
1649779729974,COGS 2,A01,083966,Boyle; Mary E. T.,28,0,30,2
1649779736003,COGS 9,A01,083968,Staff,59,0,60,1
1649779742048,COGS 14B,A01,083970,Staff,50,0,50,0
1649779748075,COGS 100,A01,083972,Staff,58,0,60,2
1649779760124,COGS 101C,A01,083976,Staff,29,0,30,1
1649779766160,COGS 102A,A01,083978,Johnson; Christine M.,29,0,30,1
1649779772186,COGS 107B,A01,083980,Staff,46,0,50,4
1649779778221,COGS 115,A01,083982,Staff,27,0,30,3
1649779784245,COGS 118B,A01,083367,Staff,22,0,40,18
1649779790276,COGS 172,A01,083984,Provenzano; Emily Kara,25,0,30,5
1649779796298,COGS 177,A00,083368,Staff,22,0,30,8
1649779802326,COGS 186,A01,083986,Staff,30,0,40,10
1649779808364,COGS 187A,A01,083988,Boyle; Mary E. T.,56,0,60,4
1649779814392,CSE 8A,A50,084003,Miranda; Gregory Joseph,13,0,15,2
1649779820416,CSE 11,A01,084005,Miranda; Gregory Joseph,52,0,55,3
1649779826453,CSE 20,A01,084007,Staff,17,0,20,3
1649779832475,CSE 21,A01,084009,Staff,50,0,50,0
1649779838501,CSE 30,A01,083370,Cao; Yingjun,37,0,40,3
1649779844525,CSE 100,A01,083372,Cao; Yingjun,36,0,40,4
1649779850555,CSE 101,A01,084011,Staff,25,0,40,15
1649779856579,CSE 141,A01,083374,Eldon; John,44,0,75,31
1649779862605,CSE 141L,A01,083376,Eldon; John,46,0,75,29
1649779868628,CSE 175,A01,084013,Kumar; Rakesh,25,0,25,0
1649779874760,CSE 190,A00,092508,Staff,15,0,15,0
1649779880790,ECE 5,A01,084049,Morris; Karcher William,19,0,20,1
1649779886815,ECE 100,A01,084051,Baghdadchi; Saharnaz,18,0,20,2
1649779886815,ECE 100,A02,091916,Baghdadchi; Saharnaz,20,0,20,0
1649779892843,ECE 101,A01,084053,Baghdadchi; Saharnaz,33,0,37,4
1649779892843,ECE 101,A02,084054,Baghdadchi; Saharnaz,37,0,37,0
1649779898871,ECE 107,A01,083390,Staff,36,0,40,4
1649779904905,ECE 148,A01,084056,Silberman; Jack,10,0,12,2
1649779910944,ECE 180,A00,083391,Abi Samra; Nicholas Camill,28,0,30,2
1649779910944,ECE 180,B00,083392,Abi Samra; Nicholas Camill,28,0,30,2
1649779916970,MATH 10B,A01,084110,Staff,26,0,30,4
1649779916970,MATH 10B,A02,084111,Staff,30,0,30,0
1649779916970,MATH 10B,A03,084112,Staff,30,0,30,0
1649779922993,MATH 10C,A01,083443,Staff,28,0,30,2
1649779922993,MATH 10C,A02,083444,Staff,27,0,30,3
1649779922993,MATH 10C,B01,084114,Staff,28,0,30,2
1649779922993,MATH 10C,B02,084115,Staff,30,0,30,0
1649779929017,MATH 18,A01,084117,Harel; Guershon,28,0,30,2
1649779929017,MATH 18,A02,084119,Harel; Guershon,29,0,30,1
1649779929017,MATH 18,A03,084120,Harel; Guershon,30,0,30,0
1649779929017,MATH 18,A04,084121,Harel; Guershon,30,0,30,0
1649779935040,MATH 20B,A01,084124,Um; Ko Woon,34,0,35,1
1649779935040,MATH 20B,B01,084126,Um; Ko Woon,35,0,35,0
1649779941072,MATH 20C,A01,083446,Hammock; Frances H,29,0,30,1
1649779941072,MATH 20C,A02,083447,Hammock; Frances H,30,0,30,0
1649779941072,MATH 20C,A03,083448,Hammock; Frances H,30,0,30,0
1649779941072,MATH 20C,A04,083449,Hammock; Frances H,30,0,30,0
1649779941072,MATH 20C,B01,083451,Hammock; Frances H,30,0,30,0
1649779941072,MATH 20C,B02,083452,Hammock; Frances H,30,0,30,0
1649779941072,MATH 20C,B03,083453,Hammock; Frances H,30,0,30,0
1649779941072,MATH 20C,B04,083454,Hammock; Frances H,30,0,30,0
1649779947098,MATH 20D,A01,084128,Staff,30,0,30,0
1649779947098,MATH 20D,A02,084129,Staff,30,0,30,0
1649779947098,MATH 20D,A03,084130,Staff,29,0,30,1
1649779947098,MATH 20D,B01,084133,Staff,30,0,30,0
1649779947098,MATH 20D,B02,084134,Staff,30,0,30,0
1649779947098,MATH 20D,B03,084135,Staff,30,0,30,0
1649779953121,MATH 20E,A01,084138,Staff,30,0,30,0
1649779953121,MATH 20E,A02,084139,Staff,29,0,30,1
1649779953121,MATH 20E,A03,084140,Staff,30,0,30,0
1649779953121,MATH 20E,A04,084141,Staff,30,0,30,0
1649779959152,MATH 102,A01,084143,Harel; Guershon,27,0,30,3
1649779959152,MATH 102,A02,084144,Harel; Guershon,29,0,30,1
1649779965180,MATH 103B,A01,083456,Staff,21,0,30,9
1649779965180,MATH 103B,A02,083457,Staff,28,0,30,2
1649779971206,MATH 109,A01,084146,Salehi Golsefidy; Alireza,30,0,30,0
1649779971206,MATH 109,A02,084147,Salehi Golsefidy; Alireza,29,0,30,1
1649779977231,MATH 120A,A01,085445,Eggers; John Dietrich,32,0,35,3
1649779977231,MATH 120A,A02,085446,Eggers; John Dietrich,33,0,35,2
1649779983260,MATH 142B,A01,084149,Verstraete; Jacques Allan,26,0,30,4
1649779983260,MATH 142B,A02,084150,Verstraete; Jacques Allan,28,0,30,2
1649779989289,MATH 170A,A01,083459,Nie; Jiawang,21,0,30,9
1649779989289,MATH 170A,A02,083460,Nie; Jiawang,28,0,30,2
1649779989289,MATH 170A,A03,083461,Nie; Jiawang,30,0,30,0
1649779995314,MATH 193B,A01,083463,Staff,25,0,30,5
1649779995314,MATH 193B,A02,083464,Staff,29,0,30,1
1649779995314,MATH 193B,A03,083465,Staff,30,0,30,0
1649780001368,COGS 2,A01,083966,Boyle; Mary E. T.,28,0,30,2
1649780007396,COGS 9,A01,083968,Staff,59,0,60,1
1649780013423,COGS 14B,A01,083970,Staff,50,0,50,0
1649780019450,COGS 100,A01,083972,Staff,58,0,60,2
1649780031527,COGS 101C,A01,083976,Staff,29,0,30,1
1649780037556,COGS 102A,A01,083978,Johnson; Christine M.,29,0,30,1
1649780043582,COGS 107B,A01,083980,Staff,46,0,50,4
1649780049610,COGS 115,A01,083982,Staff,27,0,30,3
1649780055635,COGS 118B,A01,083367,Staff,22,0,40,18
1649780061669,COGS 172,A01,083984,Provenzano; Emily Kara,25,0,30,5
1649780067696,COGS 177,A00,083368,Staff,22,0,30,8
1649780073722,COGS 186,A01,083986,Staff,30,0,40,10
1649780079750,COGS 187A,A01,083988,Boyle; Mary E. T.,56,0,60,4
1649780085777,CSE 8A,A50,084003,Miranda; Gregory Joseph,13,0,15,2
1649780091807,CSE 11,A01,084005,Miranda; Gregory Joseph,52,0,55,3
1649780097833,CSE 20,A01,084007,Staff,17,0,20,3
1649780103861,CSE 21,A01,084009,Staff,50,0,50,0
1649780109902,CSE 30,A01,083370,Cao; Yingjun,37,0,40,3
1649780115930,CSE 100,A01,083372,Cao; Yingjun,36,0,40,4
1649780121956,CSE 101,A01,084011,Staff,25,0,40,15
1649780127981,CSE 141,A01,083374,Eldon; John,43,0,75,32
1649780134008,CSE 141L,A01,083376,Eldon; John,45,0,75,30
1649780140032,CSE 175,A01,084013,Kumar; Rakesh,25,0,25,0
1649780146061,CSE 190,A00,092508,Staff,15,0,15,0
1649780152092,ECE 5,A01,084049,Morris; Karcher William,19,0,20,1
1649780158126,ECE 100,A01,084051,Baghdadchi; Saharnaz,18,0,20,2
1649780158126,ECE 100,A02,091916,Baghdadchi; Saharnaz,20,0,20,0
1649780164168,ECE 101,A01,084053,Baghdadchi; Saharnaz,33,0,37,4
1649780164168,ECE 101,A02,084054,Baghdadchi; Saharnaz,37,0,37,0
1649780170198,ECE 107,A01,083390,Staff,36,0,40,4
1649780176242,ECE 148,A01,084056,Silberman; Jack,10,0,12,2
1649780182267,ECE 180,A00,083391,Abi Samra; Nicholas Camill,28,0,30,2
1649780182267,ECE 180,B00,083392,Abi Samra; Nicholas Camill,28,0,30,2
1649780188300,MATH 10B,A01,084110,Staff,26,0,30,4
1649780188300,MATH 10B,A02,084111,Staff,30,0,30,0
1649780188300,MATH 10B,A03,084112,Staff,30,0,30,0
1649780194325,MATH 10C,A01,083443,Staff,28,0,30,2
1649780194325,MATH 10C,A02,083444,Staff,27,0,30,3
1649780194325,MATH 10C,B01,084114,Staff,28,0,30,2
1649780194325,MATH 10C,B02,084115,Staff,30,0,30,0
1649780200349,MATH 18,A01,084117,Harel; Guershon,28,0,30,2
1649780200349,MATH 18,A02,084119,Harel; Guershon,29,0,30,1
1649780200349,MATH 18,A03,084120,Harel; Guershon,30,0,30,0
1649780200349,MATH 18,A04,084121,Harel; Guershon,30,0,30,0
1649780206375,MATH 20B,A01,084124,Um; Ko Woon,34,0,35,1
1649780206375,MATH 20B,B01,084126,Um; Ko Woon,35,0,35,0
1649780212411,MATH 20C,A01,083446,Hammock; Frances H,29,0,30,1
1649780212411,MATH 20C,A02,083447,Hammock; Frances H,30,0,30,0
1649780212411,MATH 20C,A03,083448,Hammock; Frances H,30,0,30,0
1649780212411,MATH 20C,A04,083449,Hammock; Frances H,30,0,30,0
1649780212411,MATH 20C,B01,083451,Hammock; Frances H,30,0,30,0
1649780212411,MATH 20C,B02,083452,Hammock; Frances H,30,0,30,0
1649780212411,MATH 20C,B03,083453,Hammock; Frances H,30,0,30,0
1649780212411,MATH 20C,B04,083454,Hammock; Frances H,30,0,30,0
1649780218459,MATH 20D,A01,084128,Staff,30,0,30,0
1649780218459,MATH 20D,A02,084129,Staff,30,0,30,0
1649780218459,MATH 20D,A03,084130,Staff,29,0,30,1
1649780218459,MATH 20D,B01,084133,Staff,30,0,30,0
1649780218459,MATH 20D,B02,084134,Staff,30,0,30,0
1649780218459,MATH 20D,B03,084135,Staff,30,0,30,0
1649780224497,MATH 20E,A01,084138,Staff,30,0,30,0
1649780224497,MATH 20E,A02,084139,Staff,29,0,30,1
1649780224497,MATH 20E,A03,084140,Staff,30,0,30,0
1649780224497,MATH 20E,A04,084141,Staff,30,0,30,0
1649780230526,MATH 102,A01,084143,Harel; Guershon,27,0,30,3
1649780230526,MATH 102,A02,084144,Harel; Guershon,29,0,30,1
1649780236561,MATH 103B,A01,083456,Staff,21,0,30,9
1649780236561,MATH 103B,A02,083457,Staff,28,0,30,2
1649780242599,MATH 109,A01,084146,Salehi Golsefidy; Alireza,30,0,30,0
1649780242599,MATH 109,A02,084147,Salehi Golsefidy; Alireza,29,0,30,1
1649780248628,MATH 120A,A01,085445,Eggers; John Dietrich,32,0,35,3
1649780248628,MATH 120A,A02,085446,Eggers; John Dietrich,33,0,35,2
1649780254665,MATH 142B,A01,084149,Verstraete; Jacques Allan,26,0,30,4
1649780254665,MATH 142B,A02,084150,Verstraete; Jacques Allan,28,0,30,2
1649780260692,MATH 170A,A01,083459,Nie; Jiawang,21,0,30,9
1649780260692,MATH 170A,A02,083460,Nie; Jiawang,28,0,30,2
1649780260692,MATH 170A,A03,083461,Nie; Jiawang,30,0,30,0
1649780266721,MATH 193B,A01,083463,Staff,25,0,30,5
1649780266721,MATH 193B,A02,083464,Staff,29,0,30,1
1649780266721,MATH 193B,A03,083465,Staff,30,0,30,0
1649780272799,COGS 2,A01,083966,Boyle; Mary E. T.,28,0,30,2
1649780278829,COGS 9,A01,083968,Staff,59,0,60,1
1649780284867,COGS 14B,A01,083970,Staff,50,0,50,0
1649780290890,COGS 100,A01,083972,Staff,58,0,60,2
1649780302941,COGS 101C,A01,083976,Staff,29,0,30,1
1649780308970,COGS 102A,A01,083978,Johnson; Christine M.,29,0,30,1
1649780315003,COGS 107B,A01,083980,Staff,46,0,50,4
1649780321027,COGS 115,A01,083982,Staff,27,0,30,3
1649780327052,COGS 118B,A01,083367,Staff,22,0,40,18
1649780333088,COGS 172,A01,083984,Provenzano; Emily Kara,25,0,30,5
1649780339117,COGS 177,A00,083368,Staff,22,0,30,8
1649780345150,COGS 186,A01,083986,Staff,30,0,40,10
1649780351179,COGS 187A,A01,083988,Boyle; Mary E. T.,56,0,60,4
1649780357204,CSE 8A,A50,084003,Miranda; Gregory Joseph,13,0,15,2
1649780363234,CSE 11,A01,084005,Miranda; Gregory Joseph,52,0,55,3
1649780369264,CSE 20,A01,084007,Staff,17,0,20,3
1649780375290,CSE 21,A01,084009,Staff,50,0,50,0
1649780381329,CSE 30,A01,083370,Cao; Yingjun,37,0,40,3
1649780387356,CSE 100,A01,083372,Cao; Yingjun,36,0,40,4
1649780393383,CSE 101,A01,084011,Staff,25,0,40,15
1649780399415,CSE 141,A01,083374,Eldon; John,43,0,75,32
1649780405441,CSE 141L,A01,083376,Eldon; John,45,0,75,30
1649780411465,CSE 175,A01,084013,Kumar; Rakesh,25,0,25,0
1649780417496,CSE 190,A00,092508,Staff,15,0,15,0
1649780423522,ECE 5,A01,084049,Morris; Karcher William,19,0,20,1
1649780429556,ECE 100,A01,084051,Baghdadchi; Saharnaz,18,0,20,2
1649780429556,ECE 100,A02,091916,Baghdadchi; Saharnaz,20,0,20,0
1649780435584,ECE 101,A01,084053,Baghdadchi; Saharnaz,33,0,37,4
1649780435584,ECE 101,A02,084054,Baghdadchi; Saharnaz,37,0,37,0
1649780441606,ECE 107,A01,083390,Staff,36,0,40,4
1649780447636,ECE 148,A01,084056,Silberman; Jack,10,0,12,2
1649780453670,ECE 180,A00,083391,Abi Samra; Nicholas Camill,28,0,30,2
1649780453670,ECE 180,B00,083392,Abi Samra; Nicholas Camill,28,0,30,2
1649780459705,MATH 10B,A01,084110,Staff,26,0,30,4
1649780459705,MATH 10B,A02,084111,Staff,30,0,30,0
1649780459705,MATH 10B,A03,084112,Staff,30,0,30,0
1649780465731,MATH 10C,A01,083443,Staff,28,0,30,2
1649780465731,MATH 10C,A02,083444,Staff,27,0,30,3
1649780465731,MATH 10C,B01,084114,Staff,28,0,30,2
1649780465731,MATH 10C,B02,084115,Staff,30,0,30,0
1649780471873,MATH 18,A01,084117,Harel; Guershon,28,0,30,2
1649780471873,MATH 18,A02,084119,Harel; Guershon,29,0,30,1
1649780471873,MATH 18,A03,084120,Harel; Guershon,30,0,30,0
1649780471873,MATH 18,A04,084121,Harel; Guershon,30,0,30,0
1649780477900,MATH 20B,A01,084124,Um; Ko Woon,34,0,35,1
1649780477900,MATH 20B,B01,084126,Um; Ko Woon,35,0,35,0
1649780483933,MATH 20C,A01,083446,Hammock; Frances H,29,0,30,1
1649780483933,MATH 20C,A02,083447,Hammock; Frances H,30,0,30,0
1649780483933,MATH 20C,A03,083448,Hammock; Frances H,30,0,30,0
1649780483933,MATH 20C,A04,083449,Hammock; Frances H,30,0,30,0
1649780483933,MATH 20C,B01,083451,Hammock; Frances H,30,0,30,0
1649780483933,MATH 20C,B02,083452,Hammock; Frances H,30,0,30,0
1649780483933,MATH 20C,B03,083453,Hammock; Frances H,30,0,30,0
1649780483933,MATH 20C,B04,083454,Hammock; Frances H,30,0,30,0
1649780489972,MATH 20D,A01,084128,Staff,30,0,30,0
1649780489972,MATH 20D,A02,084129,Staff,30,0,30,0
1649780489972,MATH 20D,A03,084130,Staff,29,0,30,1
1649780489972,MATH 20D,B01,084133,Staff,30,0,30,0
1649780489972,MATH 20D,B02,084134,Staff,30,0,30,0
1649780489972,MATH 20D,B03,084135,Staff,30,0,30,0
1649780496011,MATH 20E,A01,084138,Staff,30,0,30,0
1649780496011,MATH 20E,A02,084139,Staff,29,0,30,1
1649780496011,MATH 20E,A03,084140,Staff,30,0,30,0
1649780496011,MATH 20E,A04,084141,Staff,30,0,30,0
1649780502047,MATH 102,A01,084143,Harel; Guershon,27,0,30,3
1649780502047,MATH 102,A02,084144,Harel; Guershon,29,0,30,1
1649780508070,MATH 103B,A01,083456,Staff,21,0,30,9
1649780508070,MATH 103B,A02,083457,Staff,28,0,30,2
1649780514095,MATH 109,A01,084146,Salehi Golsefidy; Alireza,30,0,30,0
1649780514095,MATH 109,A02,084147,Salehi Golsefidy; Alireza,29,0,30,1
1649780520125,MATH 120A,A01,085445,Eggers; John Dietrich,32,0,35,3
1649780520125,MATH 120A,A02,085446,Eggers; John Dietrich,33,0,35,2
1649780526158,MATH 142B,A01,084149,Verstraete; Jacques Allan,26,0,30,4
1649780526158,MATH 142B,A02,084150,Verstraete; Jacques Allan,28,0,30,2
1649780532183,MATH 170A,A01,083459,Nie; Jiawang,21,0,30,9
1649780532183,MATH 170A,A02,083460,Nie; Jiawang,28,0,30,2
1649780532183,MATH 170A,A03,083461,Nie; Jiawang,30,0,30,0
1649780538210,MATH 193B,A01,083463,Staff,25,0,30,5
1649780538210,MATH 193B,A02,083464,Staff,29,0,30,1
1649780538210,MATH 193B,A03,083465,Staff,30,0,30,0
1649780544276,COGS 2,A01,083966,Boyle; Mary E. T.,28,0,30,2
1649780550301,COGS 9,A01,083968,Staff,59,0,60,1
1649780556329,COGS 14B,A01,083970,Staff,49,0,50,1
1649780562353,COGS 100,A01,083972,Staff,58,0,60,2
1649780574409,COGS 101C,A01,083976,Staff,29,0,30,1
1649780580438,COGS 102A,A01,083978,Johnson; Christine M.,29,0,30,1
1649780586463,COGS 107B,A01,083980,Staff,46,0,50,4
1649780592500,COGS 115,A01,083982,Staff,27,0,30,3
1649780598528,COGS 118B,A01,083367,Staff,22,0,40,18
1649780604552,COGS 172,A01,083984,Provenzano; Emily Kara,25,0,30,5
1649780610589,COGS 177,A00,083368,Staff,22,0,30,8
1649780616617,COGS 186,A01,083986,Staff,30,0,40,10
1649780622640,COGS 187A,A01,083988,Boyle; Mary E. T.,56,0,60,4
1649780628669,CSE 8A,A50,084003,Miranda; Gregory Joseph,13,0,15,2
1649780634694,CSE 11,A01,084005,Miranda; Gregory Joseph,52,0,55,3
1649780640723,CSE 20,A01,084007,Staff,17,0,20,3
1649780646746,CSE 21,A01,084009,Staff,50,0,50,0
1649780652793,CSE 30,A01,083370,Cao; Yingjun,37,0,40,3
1649780658824,CSE 100,A01,083372,Cao; Yingjun,36,0,40,4
1649780664847,CSE 101,A01,084011,Staff,25,0,40,15
1649780670876,CSE 141,A01,083374,Eldon; John,43,0,75,32
1649780676903,CSE 141L,A01,083376,Eldon; John,45,0,75,30
1649780682928,CSE 175,A01,084013,Kumar; Rakesh,25,0,25,0
1649780688958,CSE 190,A00,092508,Staff,15,0,15,0
1649780694987,ECE 5,A01,084049,Morris; Karcher William,19,0,20,1
1649780701015,ECE 100,A01,084051,Baghdadchi; Saharnaz,18,0,20,2
1649780701015,ECE 100,A02,091916,Baghdadchi; Saharnaz,20,0,20,0
1649780707043,ECE 101,A01,084053,Baghdadchi; Saharnaz,33,0,37,4
1649780707043,ECE 101,A02,084054,Baghdadchi; Saharnaz,37,0,37,0
1649780713068,ECE 107,A01,083390,Staff,36,0,40,4
1649780719142,ECE 148,A01,084056,Silberman; Jack,10,0,12,2
1649780725176,ECE 180,A00,083391,Abi Samra; Nicholas Camill,28,0,30,2
1649780725176,ECE 180,B00,083392,Abi Samra; Nicholas Camill,28,0,30,2
1649780731218,MATH 10B,A01,084110,Staff,26,0,30,4
1649780731218,MATH 10B,A02,084111,Staff,30,0,30,0
1649780731218,MATH 10B,A03,084112,Staff,30,0,30,0
1649780737242,MATH 10C,A01,083443,Staff,28,0,30,2
1649780737242,MATH 10C,A02,083444,Staff,27,0,30,3
1649780737242,MATH 10C,B01,084114,Staff,28,0,30,2
1649780737242,MATH 10C,B02,084115,Staff,30,0,30,0
1649780743267,MATH 18,A01,084117,Harel; Guershon,28,0,30,2
1649780743267,MATH 18,A02,084119,Harel; Guershon,29,0,30,1
1649780743267,MATH 18,A03,084120,Harel; Guershon,30,0,30,0
1649780743267,MATH 18,A04,084121,Harel; Guershon,30,0,30,0
1649780749294,MATH 20B,A01,084124,Um; Ko Woon,34,0,35,1
1649780749294,MATH 20B,B01,084126,Um; Ko Woon,35,0,35,0
1649780755335,MATH 20C,A01,083446,Hammock; Frances H,29,0,30,1
1649780755335,MATH 20C,A02,083447,Hammock; Frances H,30,0,30,0
1649780755335,MATH 20C,A03,083448,Hammock; Frances H,30,0,30,0
1649780755335,MATH 20C,A04,083449,Hammock; Frances H,30,0,30,0
1649780755335,MATH 20C,B01,083451,Hammock; Frances H,30,0,30,0
1649780755335,MATH 20C,B02,083452,Hammock; Frances H,30,0,30,0
1649780755335,MATH 20C,B03,083453,Hammock; Frances H,30,0,30,0
1649780755335,MATH 20C,B04,083454,Hammock; Frances H,30,0,30,0
1649780761366,MATH 20D,A01,084128,Staff,30,0,30,0
1649780761366,MATH 20D,A02,084129,Staff,30,0,30,0
1649780761366,MATH 20D,A03,084130,Staff,29,0,30,1
1649780761366,MATH 20D,B01,084133,Staff,30,0,30,0
1649780761366,MATH 20D,B02,084134,Staff,30,0,30,0
1649780761366,MATH 20D,B03,084135,Staff,30,0,30,0
1649780767393,MATH 20E,A01,084138,Staff,30,0,30,0
1649780767393,MATH 20E,A02,084139,Staff,29,0,30,1
1649780767393,MATH 20E,A03,084140,Staff,30,0,30,0
1649780767393,MATH 20E,A04,084141,Staff,30,0,30,0
1649780773422,MATH 102,A01,084143,Harel; Guershon,27,0,30,3
1649780773422,MATH 102,A02,084144,Harel; Guershon,29,0,30,1
1649780779448,MATH 103B,A01,083456,Staff,21,0,30,9
1649780779448,MATH 103B,A02,083457,Staff,28,0,30,2
1649780785473,MATH 109,A01,084146,Salehi Golsefidy; Alireza,30,0,30,0
1649780785473,MATH 109,A02,084147,Salehi Golsefidy; Alireza,29,0,30,1
1649780791509,MATH 120A,A01,085445,Eggers; John Dietrich,32,0,35,3
1649780791509,MATH 120A,A02,085446,Eggers; John Dietrich,33,0,35,2
1649780797542,MATH 142B,A01,084149,Verstraete; Jacques Allan,26,0,30,4
1649780797542,MATH 142B,A02,084150,Verstraete; Jacques Allan,28,0,30,2
1649780803569,MATH 170A,A01,083459,Nie; Jiawang,21,0,30,9
1649780803569,MATH 170A,A02,083460,Nie; Jiawang,28,0,30,2
1649780803569,MATH 170A,A03,083461,Nie; Jiawang,30,0,30,0
1649780809596,MATH 193B,A01,083463,Staff,25,0,30,5
1649780809596,MATH 193B,A02,083464,Staff,29,0,30,1
1649780809596,MATH 193B,A03,083465,Staff,30,0,30,0
1649780815660,COGS 2,A01,083966,Boyle; Mary E. T.,28,0,30,2
1649780821686,COGS 9,A01,083968,Staff,59,0,60,1
1649780827720,COGS 14B,A01,083970,Staff,49,0,50,1
1649780833749,COGS 100,A01,083972,Staff,58,0,60,2
1649780845823,COGS 101C,A01,083976,Staff,29,0,30,1
1649780851852,COGS 102A,A01,083978,Johnson; Christine M.,29,0,30,1
1649780857886,COGS 107B,A01,083980,Staff,46,0,50,4
1649780863920,COGS 115,A01,083982,Staff,27,0,30,3
1649780869954,COGS 118B,A01,083367,Staff,22,0,40,18
1649780875978,COGS 172,A01,083984,Provenzano; Emily Kara,25,0,30,5
1649780882002,COGS 177,A00,083368,Staff,22,0,30,8
1649780888028,COGS 186,A01,083986,Staff,30,0,40,10
1649780894058,COGS 187A,A01,083988,Boyle; Mary E. T.,56,0,60,4
1649780900091,CSE 8A,A50,084003,Miranda; Gregory Joseph,13,0,15,2
1649780906125,CSE 11,A01,084005,Miranda; Gregory Joseph,52,0,55,3
1649780912152,CSE 20,A01,084007,Staff,17,0,20,3
1649780918177,CSE 21,A01,084009,Staff,50,0,50,0
1649780924201,CSE 30,A01,083370,Cao; Yingjun,37,0,40,3
1649780930228,CSE 100,A01,083372,Cao; Yingjun,36,0,40,4
1649780936251,CSE 101,A01,084011,Staff,25,0,40,15
1649780942273,CSE 141,A01,083374,Eldon; John,43,0,75,32
1649780948303,CSE 141L,A01,083376,Eldon; John,45,0,75,30
1649780954330,CSE 175,A01,084013,Kumar; Rakesh,25,0,25,0
1649780960364,CSE 190,A00,092508,Staff,15,0,15,0
1649780966394,ECE 5,A01,084049,Morris; Karcher William,19,0,20,1
1649780972431,ECE 100,A01,084051,Baghdadchi; Saharnaz,18,0,20,2
1649780972431,ECE 100,A02,091916,Baghdadchi; Saharnaz,20,0,20,0
1649780978453,ECE 101,A01,084053,Baghdadchi; Saharnaz,33,0,37,4
1649780978453,ECE 101,A02,084054,Baghdadchi; Saharnaz,37,0,37,0
1649780984481,ECE 107,A01,083390,Staff,36,0,40,4
1649780990521,ECE 148,A01,084056,Silberman; Jack,10,0,12,2
1649780996544,ECE 180,A00,083391,Abi Samra; Nicholas Camill,28,0,30,2
1649780996544,ECE 180,B00,083392,Abi Samra; Nicholas Camill,28,0,30,2
1649781002577,MATH 10B,A01,084110,Staff,26,0,30,4
1649781002577,MATH 10B,A02,084111,Staff,30,0,30,0
1649781002577,MATH 10B,A03,084112,Staff,30,0,30,0
1649781008605,MATH 10C,A01,083443,Staff,28,0,30,2
1649781008605,MATH 10C,A02,083444,Staff,27,0,30,3
1649781008605,MATH 10C,B01,084114,Staff,28,0,30,2
1649781008605,MATH 10C,B02,084115,Staff,30,0,30,0
1649781014635,MATH 18,A01,084117,Harel; Guershon,28,0,30,2
1649781014635,MATH 18,A02,084119,Harel; Guershon,29,0,30,1
1649781014635,MATH 18,A03,084120,Harel; Guershon,30,0,30,0
1649781014635,MATH 18,A04,084121,Harel; Guershon,30,0,30,0
1649781020676,MATH 20B,A01,084124,Um; Ko Woon,34,0,35,1
1649781020676,MATH 20B,B01,084126,Um; Ko Woon,35,0,35,0
1649781026722,MATH 20C,A01,083446,Hammock; Frances H,29,0,30,1
1649781026722,MATH 20C,A02,083447,Hammock; Frances H,30,0,30,0
1649781026722,MATH 20C,A03,083448,Hammock; Frances H,30,0,30,0
1649781026722,MATH 20C,A04,083449,Hammock; Frances H,30,0,30,0
1649781026722,MATH 20C,B01,083451,Hammock; Frances H,30,0,30,0
1649781026722,MATH 20C,B02,083452,Hammock; Frances H,30,0,30,0
1649781026722,MATH 20C,B03,083453,Hammock; Frances H,30,0,30,0
1649781026722,MATH 20C,B04,083454,Hammock; Frances H,30,0,30,0
1649781032746,MATH 20D,A01,084128,Staff,30,0,30,0
1649781032746,MATH 20D,A02,084129,Staff,30,0,30,0
1649781032746,MATH 20D,A03,084130,Staff,29,0,30,1
1649781032746,MATH 20D,B01,084133,Staff,30,0,30,0
1649781032746,MATH 20D,B02,084134,Staff,30,0,30,0
1649781032746,MATH 20D,B03,084135,Staff,30,0,30,0
1649781038783,MATH 20E,A01,084138,Staff,30,0,30,0
1649781038783,MATH 20E,A02,084139,Staff,29,0,30,1
1649781038783,MATH 20E,A03,084140,Staff,30,0,30,0
1649781038783,MATH 20E,A04,084141,Staff,30,0,30,0
1649781044807,MATH 102,A01,084143,Harel; Guershon,27,0,30,3
1649781044807,MATH 102,A02,084144,Harel; Guershon,29,0,30,1
1649781050830,MATH 103B,A01,083456,Staff,21,0,30,9
1649781050830,MATH 103B,A02,083457,Staff,28,0,30,2
1649781056859,MATH 109,A01,084146,Salehi Golsefidy; Alireza,30,0,30,0
1649781056859,MATH 109,A02,084147,Salehi Golsefidy; Alireza,29,0,30,1
1649781062887,MATH 120A,A01,085445,Eggers; John Dietrich,32,0,35,3
1649781062887,MATH 120A,A02,085446,Eggers; John Dietrich,33,0,35,2
1649781069024,MATH 142B,A01,084149,Verstraete; Jacques Allan,26,0,30,4
1649781069024,MATH 142B,A02,084150,Verstraete; Jacques Allan,28,0,30,2
1649781075052,MATH 170A,A01,083459,Nie; Jiawang,21,0,30,9
1649781075052,MATH 170A,A02,083460,Nie; Jiawang,28,0,30,2
1649781075052,MATH 170A,A03,083461,Nie; Jiawang,30,0,30,0
1649781081081,MATH 193B,A01,083463,Staff,25,0,30,5
1649781081081,MATH 193B,A02,083464,Staff,29,0,30,1
1649781081081,MATH 193B,A03,083465,Staff,30,0,30,0
1649781087139,COGS 2,A01,083966,Boyle; Mary E. T.,28,0,30,2
1649781093164,COGS 9,A01,083968,Staff,59,0,60,1
1649781099195,COGS 14B,A01,083970,Staff,49,0,50,1
1649781105222,COGS 100,A01,083972,Staff,58,0,60,2
1649781117272,COGS 101C,A01,083976,Staff,29,0,30,1
1649781123297,COGS 102A,A01,083978,Johnson; Christine M.,29,0,30,1
1649781129326,COGS 107B,A01,083980,Staff,46,0,50,4
1649781135350,COGS 115,A01,083982,Staff,27,0,30,3
1649781141388,COGS 118B,A01,083367,Staff,22,0,40,18
1649781147416,COGS 172,A01,083984,Provenzano; Emily Kara,25,0,30,5
1649781153439,COGS 177,A00,083368,Staff,22,0,30,8
1649781159464,COGS 186,A01,083986,Staff,30,0,40,10
1649781165489,COGS 187A,A01,083988,Boyle; Mary E. T.,56,0,60,4
1649781171513,CSE 8A,A50,084003,Miranda; Gregory Joseph,13,0,15,2
1649781177537,CSE 11,A01,084005,Miranda; Gregory Joseph,52,0,55,3
1649781183571,CSE 20,A01,084007,Staff,17,0,20,3
1649781189599,CSE 21,A01,084009,Staff,49,0,50,1
1649781195622,CSE 30,A01,083370,Cao; Yingjun,37,0,40,3
1649781201646,CSE 100,A01,083372,Cao; Yingjun,36,0,40,4
1649781207677,CSE 101,A01,084011,Staff,25,0,40,15
1649781213705,CSE 141,A01,083374,Eldon; John,43,0,75,32
1649781219728,CSE 141L,A01,083376,Eldon; John,45,0,75,30
1649781225763,CSE 175,A01,084013,Kumar; Rakesh,25,0,25,0
1649781231796,CSE 190,A00,092508,Staff,15,0,15,0
1649781237826,ECE 5,A01,084049,Morris; Karcher William,18,0,20,2
1649781243849,ECE 100,A01,084051,Baghdadchi; Saharnaz,18,0,20,2
1649781243849,ECE 100,A02,091916,Baghdadchi; Saharnaz,19,0,20,1
1649781249875,ECE 101,A01,084053,Baghdadchi; Saharnaz,33,0,37,4
1649781249875,ECE 101,A02,084054,Baghdadchi; Saharnaz,37,0,37,0
1649781255910,ECE 107,A01,083390,Staff,36,0,40,4
1649781261936,ECE 148,A01,084056,Silberman; Jack,10,0,12,2
1649781267960,ECE 180,A00,083391,Abi Samra; Nicholas Camill,28,0,30,2
1649781267960,ECE 180,B00,083392,Abi Samra; Nicholas Camill,27,0,30,3
1649781273998,MATH 10B,A01,084110,Staff,26,0,30,4
1649781273998,MATH 10B,A02,084111,Staff,30,0,30,0
1649781273998,MATH 10B,A03,084112,Staff,30,0,30,0
1649781280022,MATH 10C,A01,083443,Staff,28,0,30,2
1649781280022,MATH 10C,A02,083444,Staff,27,0,30,3
1649781280022,MATH 10C,B01,084114,Staff,28,0,30,2
1649781280022,MATH 10C,B02,084115,Staff,30,0,30,0
1649781286061,MATH 18,A01,084117,Harel; Guershon,28,0,30,2
1649781286061,MATH 18,A02,084119,Harel; Guershon,29,0,30,1
1649781286061,MATH 18,A03,084120,Harel; Guershon,30,0,30,0
1649781286061,MATH 18,A04,084121,Harel; Guershon,30,0,30,0
1649781292086,MATH 20B,A01,084124,Um; Ko Woon,34,0,35,1
1649781292086,MATH 20B,B01,084126,Um; Ko Woon,35,0,35,0
1649781298122,MATH 20C,A01,083446,Hammock; Frances H,29,0,30,1
1649781298122,MATH 20C,A02,083447,Hammock; Frances H,30,0,30,0
1649781298122,MATH 20C,A03,083448,Hammock; Frances H,30,0,30,0
1649781298122,MATH 20C,A04,083449,Hammock; Frances H,30,0,30,0
1649781298122,MATH 20C,B01,083451,Hammock; Frances H,30,0,30,0
1649781298122,MATH 20C,B02,083452,Hammock; Frances H,30,0,30,0
1649781298122,MATH 20C,B03,083453,Hammock; Frances H,30,0,30,0
1649781298122,MATH 20C,B04,083454,Hammock; Frances H,30,0,30,0
1649781304145,MATH 20D,A01,084128,Staff,30,0,30,0
1649781304145,MATH 20D,A02,084129,Staff,30,0,30,0
1649781304145,MATH 20D,A03,084130,Staff,29,0,30,1
1649781304145,MATH 20D,B01,084133,Staff,30,0,30,0
1649781304145,MATH 20D,B02,084134,Staff,30,0,30,0
1649781304145,MATH 20D,B03,084135,Staff,30,0,30,0
1649781310173,MATH 20E,A01,084138,Staff,30,0,30,0
1649781310173,MATH 20E,A02,084139,Staff,29,0,30,1
1649781310173,MATH 20E,A03,084140,Staff,30,0,30,0
1649781310173,MATH 20E,A04,084141,Staff,30,0,30,0
1649781316203,MATH 102,A01,084143,Harel; Guershon,27,0,30,3
1649781316203,MATH 102,A02,084144,Harel; Guershon,29,0,30,1
1649781322230,MATH 103B,A01,083456,Staff,21,0,30,9
1649781322230,MATH 103B,A02,083457,Staff,28,0,30,2
1649781328259,MATH 109,A01,084146,Salehi Golsefidy; Alireza,30,0,30,0
1649781328259,MATH 109,A02,084147,Salehi Golsefidy; Alireza,29,0,30,1
1649781334287,MATH 120A,A01,085445,Eggers; John Dietrich,32,0,35,3
1649781334287,MATH 120A,A02,085446,Eggers; John Dietrich,33,0,35,2
1649781340309,MATH 142B,A01,084149,Verstraete; Jacques Allan,26,0,30,4
1649781340309,MATH 142B,A02,084150,Verstraete; Jacques Allan,28,0,30,2
1649781346333,MATH 170A,A01,083459,Nie; Jiawang,21,0,30,9
1649781346333,MATH 170A,A02,083460,Nie; Jiawang,28,0,30,2
1649781346333,MATH 170A,A03,083461,Nie; Jiawang,30,0,30,0
1649781352358,MATH 193B,A01,083463,Staff,25,0,30,5
1649781352358,MATH 193B,A02,083464,Staff,29,0,30,1
1649781352358,MATH 193B,A03,083465,Staff,30,0,30,0
1649781358414,COGS 2,A01,083966,Boyle; Mary E. T.,28,0,30,2
1649781364521,COGS 9,A01,083968,Staff,59,0,60,1
1649781370559,COGS 14B,A01,083970,Staff,49,0,50,1
1649781376591,COGS 100,A01,083972,Staff,58,0,60,2
1649781388644,COGS 101C,A01,083976,Staff,29,0,30,1
1649781394668,COGS 102A,A01,083978,Johnson; Christine M.,29,0,30,1
1649781400695,COGS 107B,A01,083980,Staff,46,0,50,4
1649781406720,COGS 115,A01,083982,Staff,27,0,30,3
1649781412747,COGS 118B,A01,083367,Staff,22,0,40,18
1649781418775,COGS 172,A01,083984,Provenzano; Emily Kara,25,0,30,5
1649781424797,COGS 177,A00,083368,Staff,22,0,30,8
1649781430821,COGS 186,A01,083986,Staff,30,0,40,10
1649781436850,COGS 187A,A01,083988,Boyle; Mary E. T.,56,0,60,4
1649781442879,CSE 8A,A50,084003,Miranda; Gregory Joseph,13,0,15,2
1649781448906,CSE 11,A01,084005,Miranda; Gregory Joseph,52,0,55,3
1649781454932,CSE 20,A01,084007,Staff,17,0,20,3
1649781460960,CSE 21,A01,084009,Staff,49,0,50,1
1649781466987,CSE 30,A01,083370,Cao; Yingjun,37,0,40,3
1649781473019,CSE 100,A01,083372,Cao; Yingjun,36,0,40,4
1649781479052,CSE 101,A01,084011,Staff,25,0,40,15
1649781485085,CSE 141,A01,083374,Eldon; John,43,0,75,32
1649781491117,CSE 141L,A01,083376,Eldon; John,45,0,75,30
1649781497148,CSE 175,A01,084013,Kumar; Rakesh,25,0,25,0
1649781503173,CSE 190,A00,092508,Staff,15,0,15,0
1649781509201,ECE 5,A01,084049,Morris; Karcher William,18,0,20,2
1649781515228,ECE 100,A01,084051,Baghdadchi; Saharnaz,18,0,20,2
1649781515228,ECE 100,A02,091916,Baghdadchi; Saharnaz,19,0,20,1
1649781521263,ECE 101,A01,084053,Baghdadchi; Saharnaz,33,0,37,4
1649781521263,ECE 101,A02,084054,Baghdadchi; Saharnaz,37,0,37,0
1649781527289,ECE 107,A01,083390,Staff,36,0,40,4
1649781533322,ECE 148,A01,084056,Silberman; Jack,10,0,12,2
1649781539355,ECE 180,A00,083391,Abi Samra; Nicholas Camill,27,0,30,3
1649781539355,ECE 180,B00,083392,Abi Samra; Nicholas Camill,27,0,30,3
1649781545378,MATH 10B,A01,084110,Staff,26,0,30,4
1649781545378,MATH 10B,A02,084111,Staff,30,0,30,0
1649781545378,MATH 10B,A03,084112,Staff,30,0,30,0
1649781551400,MATH 10C,A01,083443,Staff,28,0,30,2
1649781551400,MATH 10C,A02,083444,Staff,27,0,30,3
1649781551400,MATH 10C,B01,084114,Staff,28,0,30,2
1649781551400,MATH 10C,B02,084115,Staff,30,0,30,0
1649781557431,MATH 18,A01,084117,Harel; Guershon,28,0,30,2
1649781557431,MATH 18,A02,084119,Harel; Guershon,29,0,30,1
1649781557431,MATH 18,A03,084120,Harel; Guershon,30,0,30,0
1649781557431,MATH 18,A04,084121,Harel; Guershon,30,0,30,0
1649781563456,MATH 20B,A01,084124,Um; Ko Woon,34,0,35,1
1649781563456,MATH 20B,B01,084126,Um; Ko Woon,35,0,35,0
1649781569482,MATH 20C,A01,083446,Hammock; Frances H,29,0,30,1
1649781569482,MATH 20C,A02,083447,Hammock; Frances H,30,0,30,0
1649781569482,MATH 20C,A03,083448,Hammock; Frances H,30,0,30,0
1649781569482,MATH 20C,A04,083449,Hammock; Frances H,30,0,30,0
1649781569482,MATH 20C,B01,083451,Hammock; Frances H,30,0,30,0
1649781569482,MATH 20C,B02,083452,Hammock; Frances H,30,0,30,0
1649781569482,MATH 20C,B03,083453,Hammock; Frances H,30,0,30,0
1649781569482,MATH 20C,B04,083454,Hammock; Frances H,30,0,30,0
1649781575505,MATH 20D,A01,084128,Staff,30,0,30,0
1649781575505,MATH 20D,A02,084129,Staff,30,0,30,0
1649781575505,MATH 20D,A03,084130,Staff,29,0,30,1
1649781575505,MATH 20D,B01,084133,Staff,30,0,30,0
1649781575505,MATH 20D,B02,084134,Staff,30,0,30,0
1649781575505,MATH 20D,B03,084135,Staff,30,0,30,0
1649781581531,MATH 20E,A01,084138,Staff,30,0,30,0
1649781581531,MATH 20E,A02,084139,Staff,29,0,30,1
1649781581531,MATH 20E,A03,084140,Staff,30,0,30,0
1649781581531,MATH 20E,A04,084141,Staff,30,0,30,0
1649781587563,MATH 102,A01,084143,Harel; Guershon,27,0,30,3
1649781587563,MATH 102,A02,084144,Harel; Guershon,29,0,30,1
1649781593589,MATH 103B,A01,083456,Staff,21,0,30,9
1649781593589,MATH 103B,A02,083457,Staff,28,0,30,2
1649781599620,MATH 109,A01,084146,Salehi Golsefidy; Alireza,30,0,30,0
1649781599620,MATH 109,A02,084147,Salehi Golsefidy; Alireza,29,0,30,1
1649781605651,MATH 120A,A01,085445,Eggers; John Dietrich,32,0,35,3
1649781605651,MATH 120A,A02,085446,Eggers; John Dietrich,33,0,35,2
1649781611678,MATH 142B,A01,084149,Verstraete; Jacques Allan,26,0,30,4
1649781611678,MATH 142B,A02,084150,Verstraete; Jacques Allan,28,0,30,2
1649781617703,MATH 170A,A01,083459,Nie; Jiawang,21,0,30,9
1649781617703,MATH 170A,A02,083460,Nie; Jiawang,28,0,30,2
1649781617703,MATH 170A,A03,083461,Nie; Jiawang,30,0,30,0
1649781623726,MATH 193B,A01,083463,Staff,25,0,30,5
1649781623726,MATH 193B,A02,083464,Staff,29,0,30,1
1649781623726,MATH 193B,A03,083465,Staff,30,0,30,0
1649781629793,COGS 2,A01,083966,Boyle; Mary E. T.,28,0,30,2
1649781635820,COGS 9,A01,083968,Staff,59,0,60,1
1649781641848,COGS 14B,A01,083970,Staff,49,0,50,1
1649781647871,COGS 100,A01,083972,Staff,58,0,60,2
1649781660012,COGS 101C,A01,083976,Staff,29,0,30,1
1649781666039,COGS 102A,A01,083978,Johnson; Christine M.,29,0,30,1
1649781672064,COGS 107B,A01,083980,Staff,46,0,50,4
1649781678086,COGS 115,A01,083982,Staff,27,0,30,3
1649781684120,COGS 118B,A01,083367,Staff,22,0,40,18
1649781690147,COGS 172,A01,083984,Provenzano; Emily Kara,25,0,30,5
1649781696178,COGS 177,A00,083368,Staff,22,0,30,8
1649781702207,COGS 186,A01,083986,Staff,30,0,40,10
1649781708230,COGS 187A,A01,083988,Boyle; Mary E. T.,56,0,60,4
1649781714262,CSE 8A,A50,084003,Miranda; Gregory Joseph,13,0,15,2
1649781720291,CSE 11,A01,084005,Miranda; Gregory Joseph,52,0,55,3
1649781726320,CSE 20,A01,084007,Staff,17,0,20,3
1649781732349,CSE 21,A01,084009,Staff,49,0,50,1
1649781738372,CSE 30,A01,083370,Cao; Yingjun,37,0,40,3
1649781744405,CSE 100,A01,083372,Cao; Yingjun,36,0,40,4
1649781750429,CSE 101,A01,084011,Staff,25,0,40,15
1649781756459,CSE 141,A01,083374,Eldon; John,43,0,75,32
1649781762483,CSE 141L,A01,083376,Eldon; John,45,0,75,30
1649781768510,CSE 175,A01,084013,Kumar; Rakesh,25,0,25,0
1649781774544,CSE 190,A00,092508,Staff,15,0,15,0
1649781780569,ECE 5,A01,084049,Morris; Karcher William,18,0,20,2
1649781786598,ECE 100,A01,084051,Baghdadchi; Saharnaz,18,0,20,2
1649781786598,ECE 100,A02,091916,Baghdadchi; Saharnaz,19,0,20,1
1649781792628,ECE 101,A01,084053,Baghdadchi; Saharnaz,33,0,37,4
1649781792628,ECE 101,A02,084054,Baghdadchi; Saharnaz,37,0,37,0
1649781798657,ECE 107,A01,083390,Staff,36,0,40,4
1649781804684,ECE 148,A01,084056,Silberman; Jack,10,0,12,2
1649781810723,ECE 180,A00,083391,Abi Samra; Nicholas Camill,27,0,30,3
1649781810723,ECE 180,B00,083392,Abi Samra; Nicholas Camill,27,0,30,3
1649781816753,MATH 10B,A01,084110,Staff,26,0,30,4
1649781816753,MATH 10B,A02,084111,Staff,30,0,30,0
1649781816753,MATH 10B,A03,084112,Staff,30,0,30,0
1649781822779,MATH 10C,A01,083443,Staff,28,0,30,2
1649781822779,MATH 10C,A02,083444,Staff,27,0,30,3
1649781822779,MATH 10C,B01,084114,Staff,28,0,30,2
1649781822779,MATH 10C,B02,084115,Staff,30,0,30,0
1649781828808,MATH 18,A01,084117,Harel; Guershon,28,0,30,2
1649781828808,MATH 18,A02,084119,Harel; Guershon,29,0,30,1
1649781828808,MATH 18,A03,084120,Harel; Guershon,30,0,30,0
1649781828808,MATH 18,A04,084121,Harel; Guershon,30,0,30,0
1649781834837,MATH 20B,A01,084124,Um; Ko Woon,34,0,35,1
1649781834837,MATH 20B,B01,084126,Um; Ko Woon,35,0,35,0
1649781840862,MATH 20C,A01,083446,Hammock; Frances H,29,0,30,1
1649781840862,MATH 20C,A02,083447,Hammock; Frances H,30,0,30,0
1649781840862,MATH 20C,A03,083448,Hammock; Frances H,30,0,30,0
1649781840862,MATH 20C,A04,083449,Hammock; Frances H,30,0,30,0
1649781840862,MATH 20C,B01,083451,Hammock; Frances H,30,0,30,0
1649781840862,MATH 20C,B02,083452,Hammock; Frances H,30,0,30,0
1649781840862,MATH 20C,B03,083453,Hammock; Frances H,30,0,30,0
1649781840862,MATH 20C,B04,083454,Hammock; Frances H,30,0,30,0
1649781846891,MATH 20D,A01,084128,Staff,30,0,30,0
1649781846891,MATH 20D,A02,084129,Staff,30,0,30,0
1649781846891,MATH 20D,A03,084130,Staff,29,0,30,1
1649781846891,MATH 20D,B01,084133,Staff,30,0,30,0
1649781846891,MATH 20D,B02,084134,Staff,30,0,30,0
1649781846891,MATH 20D,B03,084135,Staff,30,0,30,0
1649781852926,MATH 20E,A01,084138,Staff,30,0,30,0
1649781852926,MATH 20E,A02,084139,Staff,29,0,30,1
1649781852926,MATH 20E,A03,084140,Staff,30,0,30,0
1649781852926,MATH 20E,A04,084141,Staff,30,0,30,0
1649781858948,MATH 102,A01,084143,Harel; Guershon,27,0,30,3
1649781858948,MATH 102,A02,084144,Harel; Guershon,29,0,30,1
1649781864987,MATH 103B,A01,083456,Staff,21,0,30,9
1649781864987,MATH 103B,A02,083457,Staff,28,0,30,2
1649781871015,MATH 109,A01,084146,Salehi Golsefidy; Alireza,30,0,30,0
1649781871015,MATH 109,A02,084147,Salehi Golsefidy; Alireza,29,0,30,1
1649781877042,MATH 120A,A01,085445,Eggers; John Dietrich,32,0,35,3
1649781877042,MATH 120A,A02,085446,Eggers; John Dietrich,33,0,35,2
1649781883072,MATH 142B,A01,084149,Verstraete; Jacques Allan,26,0,30,4
1649781883072,MATH 142B,A02,084150,Verstraete; Jacques Allan,28,0,30,2
1649781889097,MATH 170A,A01,083459,Nie; Jiawang,21,0,30,9
1649781889097,MATH 170A,A02,083460,Nie; Jiawang,28,0,30,2
1649781889097,MATH 170A,A03,083461,Nie; Jiawang,30,0,30,0
1649781895128,MATH 193B,A01,083463,Staff,25,0,30,5
1649781895128,MATH 193B,A02,083464,Staff,29,0,30,1
1649781895128,MATH 193B,A03,083465,Staff,30,0,30,0
1649781901182,COGS 2,A01,083966,Boyle; Mary E. T.,28,0,30,2
1649781907212,COGS 9,A01,083968,Staff,59,0,60,1
1649781913239,COGS 14B,A01,083970,Staff,49,0,50,1
1649781919264,COGS 100,A01,083972,Staff,58,0,60,2
1649781931314,COGS 101C,A01,083976,Staff,29,0,30,1
1649781937337,COGS 102A,A01,083978,Johnson; Christine M.,29,0,30,1
1649781943377,COGS 107B,A01,083980,Staff,46,0,50,4
1649781949406,COGS 115,A01,083982,Staff,27,0,30,3
1649781955437,COGS 118B,A01,083367,Staff,22,0,40,18
1649781961466,COGS 172,A01,083984,Provenzano; Emily Kara,25,0,30,5
1649781967489,COGS 177,A00,083368,Staff,22,0,30,8
1649781973518,COGS 186,A01,083986,Staff,30,0,40,10
1649781979550,COGS 187A,A01,083988,Boyle; Mary E. T.,56,0,60,4
1649781985576,CSE 8A,A50,084003,Miranda; Gregory Joseph,13,0,15,2
1649781991602,CSE 11,A01,084005,Miranda; Gregory Joseph,52,0,55,3
1649781997627,CSE 20,A01,084007,Staff,17,0,20,3
1649782003653,CSE 21,A01,084009,Staff,49,0,50,1
1649782009676,CSE 30,A01,083370,Cao; Yingjun,37,0,40,3
1649782015702,CSE 100,A01,083372,Cao; Yingjun,36,0,40,4
1649782021726,CSE 101,A01,084011,Staff,25,0,40,15
1649782027754,CSE 141,A01,083374,Eldon; John,43,0,75,32
1649782033778,CSE 141L,A01,083376,Eldon; John,45,0,75,30
1649782039802,CSE 175,A01,084013,Kumar; Rakesh,25,0,25,0
1649782045836,CSE 190,A00,092508,Staff,15,0,15,0
1649782051859,ECE 5,A01,084049,Morris; Karcher William,18,0,20,2
1649782057887,ECE 100,A01,084051,Baghdadchi; Saharnaz,18,0,20,2
1649782057887,ECE 100,A02,091916,Baghdadchi; Saharnaz,19,0,20,1
1649782063911,ECE 101,A01,084053,Baghdadchi; Saharnaz,33,0,37,4
1649782063911,ECE 101,A02,084054,Baghdadchi; Saharnaz,37,0,37,0
1649782069939,ECE 107,A01,083390,Staff,36,0,40,4
1649782075966,ECE 148,A01,084056,Silberman; Jack,10,0,12,2
1649782081993,ECE 180,A00,083391,Abi Samra; Nicholas Camill,27,0,30,3
1649782081993,ECE 180,B00,083392,Abi Samra; Nicholas Camill,27,0,30,3
1649782088018,MATH 10B,A01,084110,Staff,26,0,30,4
1649782088018,MATH 10B,A02,084111,Staff,30,0,30,0
1649782088018,MATH 10B,A03,084112,Staff,30,0,30,0
1649782094044,MATH 10C,A01,083443,Staff,28,0,30,2
1649782094044,MATH 10C,A02,083444,Staff,27,0,30,3
1649782094044,MATH 10C,B01,084114,Staff,28,0,30,2
1649782094044,MATH 10C,B02,084115,Staff,30,0,30,0
1649782100073,MATH 18,A01,084117,Harel; Guershon,28,0,30,2
1649782100073,MATH 18,A02,084119,Harel; Guershon,29,0,30,1
1649782100073,MATH 18,A03,084120,Harel; Guershon,30,0,30,0
1649782100073,MATH 18,A04,084121,Harel; Guershon,30,0,30,0
1649782106102,MATH 20B,A01,084124,Um; Ko Woon,34,0,35,1
1649782106102,MATH 20B,B01,084126,Um; Ko Woon,35,0,35,0
1649782112125,MATH 20C,A01,083446,Hammock; Frances H,29,0,30,1
1649782112125,MATH 20C,A02,083447,Hammock; Frances H,30,0,30,0
1649782112125,MATH 20C,A03,083448,Hammock; Frances H,30,0,30,0
1649782112125,MATH 20C,A04,083449,Hammock; Frances H,30,0,30,0
1649782112125,MATH 20C,B01,083451,Hammock; Frances H,30,0,30,0
1649782112125,MATH 20C,B02,083452,Hammock; Frances H,30,0,30,0
1649782112125,MATH 20C,B03,083453,Hammock; Frances H,30,0,30,0
1649782112125,MATH 20C,B04,083454,Hammock; Frances H,30,0,30,0
1649782118155,MATH 20D,A01,084128,Staff,30,0,30,0
1649782118155,MATH 20D,A02,084129,Staff,30,0,30,0
1649782118155,MATH 20D,A03,084130,Staff,29,0,30,1
1649782118155,MATH 20D,B01,084133,Staff,30,0,30,0
1649782118155,MATH 20D,B02,084134,Staff,30,0,30,0
1649782118155,MATH 20D,B03,084135,Staff,30,0,30,0
1649782124178,MATH 20E,A01,084138,Staff,30,0,30,0
1649782124178,MATH 20E,A02,084139,Staff,29,0,30,1
1649782124178,MATH 20E,A03,084140,Staff,30,0,30,0
1649782124178,MATH 20E,A04,084141,Staff,30,0,30,0
1649782130203,MATH 102,A01,084143,Harel; Guershon,27,0,30,3
1649782130203,MATH 102,A02,084144,Harel; Guershon,29,0,30,1
1649782136244,MATH 103B,A01,083456,Staff,21,0,30,9
1649782136244,MATH 103B,A02,083457,Staff,28,0,30,2
1649782142271,MATH 109,A01,084146,Salehi Golsefidy; Alireza,30,0,30,0
1649782142271,MATH 109,A02,084147,Salehi Golsefidy; Alireza,29,0,30,1
1649782148292,MATH 120A,A01,085445,Eggers; John Dietrich,32,0,35,3
1649782148292,MATH 120A,A02,085446,Eggers; John Dietrich,33,0,35,2
1649782154321,MATH 142B,A01,084149,Verstraete; Jacques Allan,26,0,30,4
1649782154321,MATH 142B,A02,084150,Verstraete; Jacques Allan,28,0,30,2
1649782160345,MATH 170A,A01,083459,Nie; Jiawang,21,0,30,9
1649782160345,MATH 170A,A02,083460,Nie; Jiawang,28,0,30,2
1649782160345,MATH 170A,A03,083461,Nie; Jiawang,30,0,30,0
1649782166368,MATH 193B,A01,083463,Staff,25,0,30,5
1649782166368,MATH 193B,A02,083464,Staff,29,0,30,1
1649782166368,MATH 193B,A03,083465,Staff,30,0,30,0
1649782172429,COGS 2,A01,083966,Boyle; Mary E. T.,28,0,30,2
1649782178451,COGS 9,A01,083968,Staff,59,0,60,1
1649782184479,COGS 14B,A01,083970,Staff,49,0,50,1
1649782190504,COGS 100,A01,083972,Staff,58,0,60,2
1649782202569,COGS 101C,A01,083976,Staff,29,0,30,1
1649782208592,COGS 102A,A01,083978,Johnson; Christine M.,29,0,30,1
1649782214615,COGS 107B,A01,083980,Staff,46,0,50,4
1649782220638,COGS 115,A01,083982,Staff,27,0,30,3
1649782226662,COGS 118B,A01,083367,Staff,22,0,40,18
1649782232697,COGS 172,A01,083984,Provenzano; Emily Kara,25,0,30,5
1649782238723,COGS 177,A00,083368,Staff,22,0,30,8
1649782244747,COGS 186,A01,083986,Staff,30,0,40,10
1649782250870,COGS 187A,A01,083988,Boyle; Mary E. T.,56,0,60,4
1649782256899,CSE 8A,A50,084003,Miranda; Gregory Joseph,13,0,15,2
1649782262924,CSE 11,A01,084005,Miranda; Gregory Joseph,52,0,55,3
1649782268954,CSE 20,A01,084007,Staff,17,0,20,3
1649782274982,CSE 21,A01,084009,Staff,49,0,50,1
1649782281005,CSE 30,A01,083370,Cao; Yingjun,37,0,40,3
1649782287029,CSE 100,A01,083372,Cao; Yingjun,36,0,40,4
1649782293061,CSE 101,A01,084011,Staff,25,0,40,15
1649782299088,CSE 141,A01,083374,Eldon; John,42,0,75,33
1649782305116,CSE 141L,A01,083376,Eldon; John,44,0,75,31
1649782311151,CSE 175,A01,084013,Kumar; Rakesh,25,0,25,0
1649782317174,CSE 190,A00,092508,Staff,15,0,15,0
1649782323196,ECE 5,A01,084049,Morris; Karcher William,18,0,20,2
1649782329219,ECE 100,A01,084051,Baghdadchi; Saharnaz,18,0,20,2
1649782329219,ECE 100,A02,091916,Baghdadchi; Saharnaz,19,0,20,1
1649782335249,ECE 101,A01,084053,Baghdadchi; Saharnaz,33,0,37,4
1649782335249,ECE 101,A02,084054,Baghdadchi; Saharnaz,37,0,37,0
1649782341273,ECE 107,A01,083390,Staff,36,0,40,4
1649782347295,ECE 148,A01,084056,Silberman; Jack,10,0,12,2
1649782353325,ECE 180,A00,083391,Abi Samra; Nicholas Camill,27,0,30,3
1649782353325,ECE 180,B00,083392,Abi Samra; Nicholas Camill,27,0,30,3
1649782359352,MATH 10B,A01,084110,Staff,26,0,30,4
1649782359352,MATH 10B,A02,084111,Staff,30,0,30,0
1649782359352,MATH 10B,A03,084112,Staff,30,0,30,0
1649782365383,MATH 10C,A01,083443,Staff,28,0,30,2
1649782365383,MATH 10C,A02,083444,Staff,27,0,30,3
1649782365383,MATH 10C,B01,084114,Staff,28,0,30,2
1649782365383,MATH 10C,B02,084115,Staff,30,0,30,0
1649782371406,MATH 18,A01,084117,Harel; Guershon,28,0,30,2
1649782371406,MATH 18,A02,084119,Harel; Guershon,29,0,30,1
1649782371406,MATH 18,A03,084120,Harel; Guershon,30,0,30,0
1649782371406,MATH 18,A04,084121,Harel; Guershon,30,0,30,0
1649782377430,MATH 20B,A01,084124,Um; Ko Woon,34,0,35,1
1649782377430,MATH 20B,B01,084126,Um; Ko Woon,35,0,35,0
1649782383469,MATH 20C,A01,083446,Hammock; Frances H,29,0,30,1
1649782383469,MATH 20C,A02,083447,Hammock; Frances H,30,0,30,0
1649782383469,MATH 20C,A03,083448,Hammock; Frances H,30,0,30,0
1649782383469,MATH 20C,A04,083449,Hammock; Frances H,30,0,30,0
1649782383469,MATH 20C,B01,083451,Hammock; Frances H,30,0,30,0
1649782383469,MATH 20C,B02,083452,Hammock; Frances H,30,0,30,0
1649782383469,MATH 20C,B03,083453,Hammock; Frances H,30,0,30,0
1649782383469,MATH 20C,B04,083454,Hammock; Frances H,30,0,30,0
1649782389492,MATH 20D,A01,084128,Staff,30,0,30,0
1649782389492,MATH 20D,A02,084129,Staff,30,0,30,0
1649782389492,MATH 20D,A03,084130,Staff,29,0,30,1
1649782389492,MATH 20D,B01,084133,Staff,30,0,30,0
1649782389492,MATH 20D,B02,084134,Staff,30,0,30,0
1649782389492,MATH 20D,B03,084135,Staff,30,0,30,0
1649782395515,MATH 20E,A01,084138,Staff,30,0,30,0
1649782395515,MATH 20E,A02,084139,Staff,29,0,30,1
1649782395515,MATH 20E,A03,084140,Staff,30,0,30,0
1649782395515,MATH 20E,A04,084141,Staff,30,0,30,0
1649782401543,MATH 102,A01,084143,Harel; Guershon,27,0,30,3
1649782401543,MATH 102,A02,084144,Harel; Guershon,29,0,30,1
1649782407566,MATH 103B,A01,083456,Staff,21,0,30,9
1649782407566,MATH 103B,A02,083457,Staff,28,0,30,2
1649782413592,MATH 109,A01,084146,Salehi Golsefidy; Alireza,30,0,30,0
1649782413592,MATH 109,A02,084147,Salehi Golsefidy; Alireza,29,0,30,1
1649782419627,MATH 120A,A01,085445,Eggers; John Dietrich,32,0,35,3
1649782419627,MATH 120A,A02,085446,Eggers; John Dietrich,33,0,35,2
1649782425650,MATH 142B,A01,084149,Verstraete; Jacques Allan,26,0,30,4
1649782425650,MATH 142B,A02,084150,Verstraete; Jacques Allan,27,0,30,3
1649782431677,MATH 170A,A01,083459,Nie; Jiawang,21,0,30,9
1649782431677,MATH 170A,A02,083460,Nie; Jiawang,28,0,30,2
1649782431677,MATH 170A,A03,083461,Nie; Jiawang,30,0,30,0
1649782437707,MATH 193B,A01,083463,Staff,25,0,30,5
1649782437707,MATH 193B,A02,083464,Staff,29,0,30,1
1649782437707,MATH 193B,A03,083465,Staff,30,0,30,0
1649782443775,COGS 2,A01,083966,Boyle; Mary E. T.,28,0,30,2
1649782449801,COGS 9,A01,083968,Staff,59,0,60,1
1649782455844,COGS 14B,A01,083970,Staff,49,0,50,1
1649782461868,COGS 100,A01,083972,Staff,58,0,60,2
1649782473922,COGS 101C,A01,083976,Staff,29,0,30,1
1649782479950,COGS 102A,A01,083978,Johnson; Christine M.,29,0,30,1
1649782485980,COGS 107B,A01,083980,Staff,46,0,50,4
1649782492007,COGS 115,A01,083982,Staff,27,0,30,3
1649782498028,COGS 118B,A01,083367,Staff,22,0,40,18
1649782504056,COGS 172,A01,083984,Provenzano; Emily Kara,25,0,30,5
1649782510079,COGS 177,A00,083368,Staff,22,0,30,8
1649782516105,COGS 186,A01,083986,Staff,30,0,40,10
1649782522129,COGS 187A,A01,083988,Boyle; Mary E. T.,56,0,60,4
1649782528156,CSE 8A,A50,084003,Miranda; Gregory Joseph,13,0,15,2
1649782534196,CSE 11,A01,084005,Miranda; Gregory Joseph,52,0,55,3
1649782540233,CSE 20,A01,084007,Staff,17,0,20,3
1649782546260,CSE 21,A01,084009,Staff,49,0,50,1
1649782552282,CSE 30,A01,083370,Cao; Yingjun,37,0,40,3
1649782558309,CSE 100,A01,083372,Cao; Yingjun,36,0,40,4
1649782564339,CSE 101,A01,084011,Staff,25,0,40,15
1649782570371,CSE 141,A01,083374,Eldon; John,42,0,75,33
1649782576397,CSE 141L,A01,083376,Eldon; John,44,0,75,31
1649782582425,CSE 175,A01,084013,Kumar; Rakesh,25,0,25,0
1649782588465,CSE 190,A00,092508,Staff,15,0,15,0
1649782594493,ECE 5,A01,084049,Morris; Karcher William,18,0,20,2
1649782600517,ECE 100,A01,084051,Baghdadchi; Saharnaz,18,0,20,2
1649782600517,ECE 100,A02,091916,Baghdadchi; Saharnaz,19,0,20,1
1649782606540,ECE 101,A01,084053,Baghdadchi; Saharnaz,33,0,37,4
1649782606540,ECE 101,A02,084054,Baghdadchi; Saharnaz,37,0,37,0
1649782612569,ECE 107,A01,083390,Staff,36,0,40,4
1649782618592,ECE 148,A01,084056,Silberman; Jack,9,0,12,3
1649782624627,ECE 180,A00,083391,Abi Samra; Nicholas Camill,27,0,30,3
1649782624627,ECE 180,B00,083392,Abi Samra; Nicholas Camill,27,0,30,3
1649782630650,MATH 10B,A01,084110,Staff,26,0,30,4
1649782630650,MATH 10B,A02,084111,Staff,30,0,30,0
1649782630650,MATH 10B,A03,084112,Staff,30,0,30,0
1649782636687,MATH 10C,A01,083443,Staff,28,0,30,2
1649782636687,MATH 10C,A02,083444,Staff,27,0,30,3
1649782636687,MATH 10C,B01,084114,Staff,28,0,30,2
1649782636687,MATH 10C,B02,084115,Staff,30,0,30,0
1649782642710,MATH 18,A01,084117,Harel; Guershon,28,0,30,2
1649782642710,MATH 18,A02,084119,Harel; Guershon,29,0,30,1
1649782642710,MATH 18,A03,084120,Harel; Guershon,30,0,30,0
1649782642710,MATH 18,A04,084121,Harel; Guershon,30,0,30,0
1649782648737,MATH 20B,A01,084124,Um; Ko Woon,34,0,35,1
1649782648737,MATH 20B,B01,084126,Um; Ko Woon,35,0,35,0
1649782654765,MATH 20C,A01,083446,Hammock; Frances H,29,0,30,1
1649782654765,MATH 20C,A02,083447,Hammock; Frances H,30,0,30,0
1649782654765,MATH 20C,A03,083448,Hammock; Frances H,30,0,30,0
1649782654765,MATH 20C,A04,083449,Hammock; Frances H,30,0,30,0
1649782654765,MATH 20C,B01,083451,Hammock; Frances H,30,0,30,0
1649782654765,MATH 20C,B02,083452,Hammock; Frances H,30,0,30,0
1649782654765,MATH 20C,B03,083453,Hammock; Frances H,30,0,30,0
1649782654765,MATH 20C,B04,083454,Hammock; Frances H,30,0,30,0
1649782660789,MATH 20D,A01,084128,Staff,30,0,30,0
1649782660789,MATH 20D,A02,084129,Staff,30,0,30,0
1649782660789,MATH 20D,A03,084130,Staff,29,0,30,1
1649782660789,MATH 20D,B01,084133,Staff,30,0,30,0
1649782660789,MATH 20D,B02,084134,Staff,30,0,30,0
1649782660789,MATH 20D,B03,084135,Staff,30,0,30,0
1649782666818,MATH 20E,A01,084138,Staff,30,0,30,0
1649782666818,MATH 20E,A02,084139,Staff,29,0,30,1
1649782666818,MATH 20E,A03,084140,Staff,30,0,30,0
1649782666818,MATH 20E,A04,084141,Staff,30,0,30,0
1649782672840,MATH 102,A01,084143,Harel; Guershon,27,0,30,3
1649782672840,MATH 102,A02,084144,Harel; Guershon,29,0,30,1
1649782678864,MATH 103B,A01,083456,Staff,21,0,30,9
1649782678864,MATH 103B,A02,083457,Staff,28,0,30,2
1649782684895,MATH 109,A01,084146,Salehi Golsefidy; Alireza,30,0,30,0
1649782684895,MATH 109,A02,084147,Salehi Golsefidy; Alireza,29,0,30,1
1649782690919,MATH 120A,A01,085445,Eggers; John Dietrich,32,0,35,3
1649782690919,MATH 120A,A02,085446,Eggers; John Dietrich,33,0,35,2
1649782696948,MATH 142B,A01,084149,Verstraete; Jacques Allan,26,0,30,4
1649782696948,MATH 142B,A02,084150,Verstraete; Jacques Allan,27,0,30,3
1649782702980,MATH 170A,A01,083459,Nie; Jiawang,21,0,30,9
1649782702980,MATH 170A,A02,083460,Nie; Jiawang,28,0,30,2
1649782702980,MATH 170A,A03,083461,Nie; Jiawang,30,0,30,0
1649782709015,MATH 193B,A01,083463,Staff,25,0,30,5
1649782709015,MATH 193B,A02,083464,Staff,29,0,30,1
1649782709015,MATH 193B,A03,083465,Staff,30,0,30,0
1649782715072,COGS 2,A01,083966,Boyle; Mary E. T.,28,0,30,2
1649782721095,COGS 9,A01,083968,Staff,59,0,60,1
1649782727132,COGS 14B,A01,083970,Staff,49,0,50,1
1649782733155,COGS 100,A01,083972,Staff,58,0,60,2
1649782745208,COGS 101C,A01,083976,Staff,29,0,30,1
1649782751230,COGS 102A,A01,083978,Johnson; Christine M.,29,0,30,1
1649782757254,COGS 107B,A01,083980,Staff,46,0,50,4
1649782763285,COGS 115,A01,083982,Staff,27,0,30,3
1649782769310,COGS 118B,A01,083367,Staff,22,0,40,18
1649782775333,COGS 172,A01,083984,Provenzano; Emily Kara,25,0,30,5
1649782781356,COGS 177,A00,083368,Staff,22,0,30,8
1649782787379,COGS 186,A01,083986,Staff,30,0,40,10
1649782793410,COGS 187A,A01,083988,Boyle; Mary E. T.,56,0,60,4
1649782799433,CSE 8A,A50,084003,Miranda; Gregory Joseph,13,0,15,2
1649782805456,CSE 11,A01,084005,Miranda; Gregory Joseph,52,0,55,3
1649782811491,CSE 20,A01,084007,Staff,17,0,20,3
1649782817514,CSE 21,A01,084009,Staff,49,0,50,1
1649782823537,CSE 30,A01,083370,Cao; Yingjun,37,0,40,3
1649782829564,CSE 100,A01,083372,Cao; Yingjun,36,0,40,4
1649782835589,CSE 101,A01,084011,Staff,25,0,40,15
1649782841621,CSE 141,A01,083374,Eldon; John,42,0,75,33
1649782847744,CSE 141L,A01,083376,Eldon; John,44,0,75,31
1649782853790,CSE 175,A01,084013,Kumar; Rakesh,25,0,25,0
1649782859812,CSE 190,A00,092508,Staff,15,0,15,0
1649782865837,ECE 5,A01,084049,Morris; Karcher William,18,0,20,2
1649782871864,ECE 100,A01,084051,Baghdadchi; Saharnaz,18,0,20,2
1649782871864,ECE 100,A02,091916,Baghdadchi; Saharnaz,19,0,20,1
1649782877891,ECE 101,A01,084053,Baghdadchi; Saharnaz,33,0,37,4
1649782877891,ECE 101,A02,084054,Baghdadchi; Saharnaz,37,0,37,0
1649782883932,ECE 107,A01,083390,Staff,36,0,40,4
1649782889963,ECE 148,A01,084056,Silberman; Jack,9,0,12,3
1649782895987,ECE 180,A00,083391,Abi Samra; Nicholas Camill,27,0,30,3
1649782895987,ECE 180,B00,083392,Abi Samra; Nicholas Camill,27,0,30,3
1649782902014,MATH 10B,A01,084110,Staff,26,0,30,4
1649782902014,MATH 10B,A02,084111,Staff,30,0,30,0
1649782902014,MATH 10B,A03,084112,Staff,30,0,30,0
1649782908041,MATH 10C,A01,083443,Staff,28,0,30,2
1649782908041,MATH 10C,A02,083444,Staff,26,0,30,4
1649782908041,MATH 10C,B01,084114,Staff,28,0,30,2
1649782908041,MATH 10C,B02,084115,Staff,30,0,30,0
1649782914064,MATH 18,A01,084117,Harel; Guershon,28,0,30,2
1649782914064,MATH 18,A02,084119,Harel; Guershon,29,0,30,1
1649782914064,MATH 18,A03,084120,Harel; Guershon,30,0,30,0
1649782914064,MATH 18,A04,084121,Harel; Guershon,30,0,30,0
1649782920089,MATH 20B,A01,084124,Um; Ko Woon,34,0,35,1
1649782920089,MATH 20B,B01,084126,Um; Ko Woon,35,0,35,0
1649782926117,MATH 20C,A01,083446,Hammock; Frances H,29,0,30,1
1649782926117,MATH 20C,A02,083447,Hammock; Frances H,30,0,30,0
1649782926117,MATH 20C,A03,083448,Hammock; Frances H,30,0,30,0
1649782926117,MATH 20C,A04,083449,Hammock; Frances H,30,0,30,0
1649782926117,MATH 20C,B01,083451,Hammock; Frances H,30,0,30,0
1649782926117,MATH 20C,B02,083452,Hammock; Frances H,30,0,30,0
1649782926117,MATH 20C,B03,083453,Hammock; Frances H,30,0,30,0
1649782926117,MATH 20C,B04,083454,Hammock; Frances H,30,0,30,0
1649782932141,MATH 20D,A01,084128,Staff,30,0,30,0
1649782932141,MATH 20D,A02,084129,Staff,30,0,30,0
1649782932141,MATH 20D,A03,084130,Staff,29,0,30,1
1649782932141,MATH 20D,B01,084133,Staff,30,0,30,0
1649782932141,MATH 20D,B02,084134,Staff,30,0,30,0
1649782932141,MATH 20D,B03,084135,Staff,30,0,30,0
1649782938166,MATH 20E,A01,084138,Staff,30,0,30,0
1649782938166,MATH 20E,A02,084139,Staff,29,0,30,1
1649782938166,MATH 20E,A03,084140,Staff,30,0,30,0
1649782938166,MATH 20E,A04,084141,Staff,30,0,30,0
1649782944201,MATH 102,A01,084143,Harel; Guershon,27,0,30,3
1649782944201,MATH 102,A02,084144,Harel; Guershon,29,0,30,1
1649782950224,MATH 103B,A01,083456,Staff,21,0,30,9
1649782950224,MATH 103B,A02,083457,Staff,28,0,30,2
1649782956251,MATH 109,A01,084146,Salehi Golsefidy; Alireza,30,0,30,0
1649782956251,MATH 109,A02,084147,Salehi Golsefidy; Alireza,29,0,30,1
1649782962274,MATH 120A,A01,085445,Eggers; John Dietrich,32,0,35,3
1649782962274,MATH 120A,A02,085446,Eggers; John Dietrich,33,0,35,2
1649782968299,MATH 142B,A01,084149,Verstraete; Jacques Allan,26,0,30,4
1649782968299,MATH 142B,A02,084150,Verstraete; Jacques Allan,27,0,30,3
1649782974338,MATH 170A,A01,083459,Nie; Jiawang,21,0,30,9
1649782974338,MATH 170A,A02,083460,Nie; Jiawang,28,0,30,2
1649782974338,MATH 170A,A03,083461,Nie; Jiawang,30,0,30,0
1649782980367,MATH 193B,A01,083463,Staff,25,0,30,5
1649782980367,MATH 193B,A02,083464,Staff,29,0,30,1
1649782980367,MATH 193B,A03,083465,Staff,30,0,30,0
1649782986431,COGS 2,A01,083966,Boyle; Mary E. T.,28,0,30,2
1649782992453,COGS 9,A01,083968,Staff,59,0,60,1
1649782998477,COGS 14B,A01,083970,Staff,49,0,50,1
1649783004501,COGS 100,A01,083972,Staff,58,0,60,2
1649783016551,COGS 101C,A01,083976,Staff,29,0,30,1
1649783022580,COGS 102A,A01,083978,Johnson; Christine M.,29,0,30,1
1649783028607,COGS 107B,A01,083980,Staff,46,0,50,4
1649783040684,COGS 115,A01,083982,Staff,27,0,30,3
1649783046707,COGS 118B,A01,083367,Staff,22,0,40,18
1649783052733,COGS 172,A01,083984,Provenzano; Emily Kara,25,0,30,5
1649783058763,COGS 177,A00,083368,Staff,21,0,30,9
1649783064787,COGS 186,A01,083986,Staff,30,0,40,10
1649783070811,COGS 187A,A01,083988,Boyle; Mary E. T.,56,0,60,4
1649783076833,CSE 8A,A50,084003,Miranda; Gregory Joseph,13,0,15,2
1649783082860,CSE 11,A01,084005,Miranda; Gregory Joseph,52,0,55,3
1649783088883,CSE 20,A01,084007,Staff,17,0,20,3
1649783094939,CSE 21,A01,084009,Staff,48,0,50,2
1649783100963,CSE 30,A01,083370,Cao; Yingjun,36,0,40,4
1649783106990,CSE 100,A01,083372,Cao; Yingjun,36,0,40,4
1649783113014,CSE 101,A01,084011,Staff,25,0,40,15
1649783119038,CSE 141,A01,083374,Eldon; John,42,0,75,33
1649783125060,CSE 141L,A01,083376,Eldon; John,44,0,75,31
1649783131082,CSE 175,A01,084013,Kumar; Rakesh,25,0,25,0
1649783137107,CSE 190,A00,092508,Staff,15,0,15,0
1649783143135,ECE 5,A01,084049,Morris; Karcher William,18,0,20,2
1649783149159,ECE 100,A01,084051,Baghdadchi; Saharnaz,18,0,20,2
1649783149159,ECE 100,A02,091916,Baghdadchi; Saharnaz,19,0,20,1
1649783155189,ECE 101,A01,084053,Baghdadchi; Saharnaz,33,0,37,4
1649783155189,ECE 101,A02,084054,Baghdadchi; Saharnaz,37,0,37,0
1649783161222,ECE 107,A01,083390,Staff,36,0,40,4
1649783167251,ECE 148,A01,084056,Silberman; Jack,9,0,12,3
1649783173277,ECE 180,A00,083391,Abi Samra; Nicholas Camill,27,0,30,3
1649783173277,ECE 180,B00,083392,Abi Samra; Nicholas Camill,27,0,30,3
1649783179305,MATH 10B,A01,084110,Staff,26,0,30,4
1649783179305,MATH 10B,A02,084111,Staff,30,0,30,0
1649783179305,MATH 10B,A03,084112,Staff,30,0,30,0
1649783185329,MATH 10C,A01,083443,Staff,27,0,30,3
1649783185329,MATH 10C,A02,083444,Staff,26,0,30,4
1649783185329,MATH 10C,B01,084114,Staff,28,0,30,2
1649783185329,MATH 10C,B02,084115,Staff,30,0,30,0
1649783191357,MATH 18,A01,084117,Harel; Guershon,28,0,30,2
1649783191357,MATH 18,A02,084119,Harel; Guershon,29,0,30,1
1649783191357,MATH 18,A03,084120,Harel; Guershon,30,0,30,0
1649783191357,MATH 18,A04,084121,Harel; Guershon,30,0,30,0
1649783197386,MATH 20B,A01,084124,Um; Ko Woon,34,0,35,1
1649783197386,MATH 20B,B01,084126,Um; Ko Woon,35,0,35,0
1649783203412,MATH 20C,A01,083446,Hammock; Frances H,29,0,30,1
1649783203412,MATH 20C,A02,083447,Hammock; Frances H,30,0,30,0
1649783203412,MATH 20C,A03,083448,Hammock; Frances H,30,0,30,0
1649783203412,MATH 20C,A04,083449,Hammock; Frances H,30,0,30,0
1649783203412,MATH 20C,B01,083451,Hammock; Frances H,30,0,30,0
1649783203412,MATH 20C,B02,083452,Hammock; Frances H,30,0,30,0
1649783203412,MATH 20C,B03,083453,Hammock; Frances H,30,0,30,0
1649783203412,MATH 20C,B04,083454,Hammock; Frances H,30,0,30,0
1649783209437,MATH 20D,A01,084128,Staff,30,0,30,0
1649783209437,MATH 20D,A02,084129,Staff,30,0,30,0
1649783209437,MATH 20D,A03,084130,Staff,29,0,30,1
1649783209437,MATH 20D,B01,084133,Staff,30,0,30,0
1649783209437,MATH 20D,B02,084134,Staff,30,0,30,0
1649783209437,MATH 20D,B03,084135,Staff,30,0,30,0
1649783215460,MATH 20E,A01,084138,Staff,30,0,30,0
1649783215460,MATH 20E,A02,084139,Staff,29,0,30,1
1649783215460,MATH 20E,A03,084140,Staff,30,0,30,0
1649783215460,MATH 20E,A04,084141,Staff,30,0,30,0
1649783221483,MATH 102,A01,084143,Harel; Guershon,27,0,30,3
1649783221483,MATH 102,A02,084144,Harel; Guershon,29,0,30,1
1649783227510,MATH 103B,A01,083456,Staff,21,0,30,9
1649783227510,MATH 103B,A02,083457,Staff,28,0,30,2
1649783233560,MATH 109,A01,084146,Salehi Golsefidy; Alireza,30,0,30,0
1649783233560,MATH 109,A02,084147,Salehi Golsefidy; Alireza,29,0,30,1
1649783239592,MATH 120A,A01,085445,Eggers; John Dietrich,32,0,35,3
1649783239592,MATH 120A,A02,085446,Eggers; John Dietrich,33,0,35,2
1649783245620,MATH 142B,A01,084149,Verstraete; Jacques Allan,26,0,30,4
1649783245620,MATH 142B,A02,084150,Verstraete; Jacques Allan,27,0,30,3
1649783251650,MATH 170A,A01,083459,Nie; Jiawang,21,0,30,9
1649783251650,MATH 170A,A02,083460,Nie; Jiawang,28,0,30,2
1649783251650,MATH 170A,A03,083461,Nie; Jiawang,30,0,30,0
1649783257676,MATH 193B,A01,083463,Staff,25,0,30,5
1649783257676,MATH 193B,A02,083464,Staff,29,0,30,1
1649783257676,MATH 193B,A03,083465,Staff,30,0,30,0
1649783263726,COGS 2,A01,083966,Boyle; Mary E. T.,28,0,30,2
1649783269749,COGS 9,A01,083968,Staff,59,0,60,1
1649783275775,COGS 14B,A01,083970,Staff,49,0,50,1
1649783281798,COGS 100,A01,083972,Staff,58,0,60,2
1649783293845,COGS 101C,A01,083976,Staff,29,0,30,1
1649783299867,COGS 102A,A01,083978,Johnson; Christine M.,29,0,30,1
1649783305894,COGS 107B,A01,083980,Staff,46,0,50,4
1649783311920,COGS 115,A01,083982,Staff,27,0,30,3
1649783317945,COGS 118B,A01,083367,Staff,22,0,40,18
1649783323980,COGS 172,A01,083984,Provenzano; Emily Kara,25,0,30,5
1649783330004,COGS 177,A00,083368,Staff,21,0,30,9
1649783336030,COGS 186,A01,083986,Staff,30,0,40,10
1649783342052,COGS 187A,A01,083988,Boyle; Mary E. T.,56,0,60,4
1649783348087,CSE 8A,A50,084003,Miranda; Gregory Joseph,13,0,15,2
1649783354122,CSE 11,A01,084005,Miranda; Gregory Joseph,52,0,55,3
1649783360147,CSE 20,A01,084007,Staff,17,0,20,3
1649783366177,CSE 21,A01,084009,Staff,48,0,50,2
1649783372205,CSE 30,A01,083370,Cao; Yingjun,36,0,40,4
1649783378227,CSE 100,A01,083372,Cao; Yingjun,36,0,40,4
1649783384257,CSE 101,A01,084011,Staff,25,0,40,15
1649783390283,CSE 141,A01,083374,Eldon; John,42,0,75,33
1649783396308,CSE 141L,A01,083376,Eldon; John,44,0,75,31
1649783402344,CSE 175,A01,084013,Kumar; Rakesh,25,0,25,0
1649783408374,CSE 190,A00,092508,Staff,15,0,15,0
1649783414408,ECE 5,A01,084049,Morris; Karcher William,18,0,20,2
1649783420435,ECE 100,A01,084051,Baghdadchi; Saharnaz,18,0,20,2
1649783420435,ECE 100,A02,091916,Baghdadchi; Saharnaz,19,0,20,1
1649783426461,ECE 101,A01,084053,Baghdadchi; Saharnaz,33,0,37,4
1649783426461,ECE 101,A02,084054,Baghdadchi; Saharnaz,37,0,37,0
1649783432484,ECE 107,A01,083390,Staff,36,0,40,4
1649783438506,ECE 148,A01,084056,Silberman; Jack,9,0,12,3
1649783444533,ECE 180,A00,083391,Abi Samra; Nicholas Camill,27,0,30,3
1649783444533,ECE 180,B00,083392,Abi Samra; Nicholas Camill,27,0,30,3
1649783450646,MATH 10B,A01,084110,Staff,26,0,30,4
1649783450646,MATH 10B,A02,084111,Staff,30,0,30,0
1649783450646,MATH 10B,A03,084112,Staff,30,0,30,0
1649783456669,MATH 10C,A01,083443,Staff,27,0,30,3
1649783456669,MATH 10C,A02,083444,Staff,26,0,30,4
1649783456669,MATH 10C,B01,084114,Staff,28,0,30,2
1649783456669,MATH 10C,B02,084115,Staff,30,0,30,0
1649783462692,MATH 18,A01,084117,Harel; Guershon,28,0,30,2
1649783462692,MATH 18,A02,084119,Harel; Guershon,29,0,30,1
1649783462692,MATH 18,A03,084120,Harel; Guershon,30,0,30,0
1649783462692,MATH 18,A04,084121,Harel; Guershon,30,0,30,0
1649783468717,MATH 20B,A01,084124,Um; Ko Woon,34,0,35,1
1649783468717,MATH 20B,B01,084126,Um; Ko Woon,35,0,35,0
1649783474752,MATH 20C,A01,083446,Hammock; Frances H,29,0,30,1
1649783474752,MATH 20C,A02,083447,Hammock; Frances H,30,0,30,0
1649783474752,MATH 20C,A03,083448,Hammock; Frances H,30,0,30,0
1649783474752,MATH 20C,A04,083449,Hammock; Frances H,30,0,30,0
1649783474752,MATH 20C,B01,083451,Hammock; Frances H,30,0,30,0
1649783474752,MATH 20C,B02,083452,Hammock; Frances H,30,0,30,0
1649783474752,MATH 20C,B03,083453,Hammock; Frances H,30,0,30,0
1649783474752,MATH 20C,B04,083454,Hammock; Frances H,30,0,30,0
1649783480783,MATH 20D,A01,084128,Staff,30,0,30,0
1649783480783,MATH 20D,A02,084129,Staff,30,0,30,0
1649783480783,MATH 20D,A03,084130,Staff,29,0,30,1
1649783480783,MATH 20D,B01,084133,Staff,30,0,30,0
1649783480783,MATH 20D,B02,084134,Staff,30,0,30,0
1649783480783,MATH 20D,B03,084135,Staff,30,0,30,0
1649783486808,MATH 20E,A01,084138,Staff,30,0,30,0
1649783486808,MATH 20E,A02,084139,Staff,29,0,30,1
1649783486808,MATH 20E,A03,084140,Staff,30,0,30,0
1649783486808,MATH 20E,A04,084141,Staff,30,0,30,0
1649783492833,MATH 102,A01,084143,Harel; Guershon,27,0,30,3
1649783492833,MATH 102,A02,084144,Harel; Guershon,29,0,30,1
1649783498859,MATH 103B,A01,083456,Staff,21,0,30,9
1649783498859,MATH 103B,A02,083457,Staff,28,0,30,2
1649783504887,MATH 109,A01,084146,Salehi Golsefidy; Alireza,30,0,30,0
1649783504887,MATH 109,A02,084147,Salehi Golsefidy; Alireza,29,0,30,1
1649783510912,MATH 120A,A01,085445,Eggers; John Dietrich,32,0,35,3
1649783510912,MATH 120A,A02,085446,Eggers; John Dietrich,33,0,35,2
1649783516950,MATH 142B,A01,084149,Verstraete; Jacques Allan,26,0,30,4
1649783516950,MATH 142B,A02,084150,Verstraete; Jacques Allan,27,0,30,3
1649783522977,MATH 170A,A01,083459,Nie; Jiawang,21,0,30,9
1649783522977,MATH 170A,A02,083460,Nie; Jiawang,28,0,30,2
1649783522977,MATH 170A,A03,083461,Nie; Jiawang,30,0,30,0
1649783528999,MATH 193B,A01,083463,Staff,25,0,30,5
1649783528999,MATH 193B,A02,083464,Staff,29,0,30,1
1649783528999,MATH 193B,A03,083465,Staff,30,0,30,0
1649783535058,COGS 2,A01,083966,Boyle; Mary E. T.,28,0,30,2
1649783541081,COGS 9,A01,083968,Staff,59,0,60,1
1649783547108,COGS 14B,A01,083970,Staff,49,0,50,1
1649783553130,COGS 100,A01,083972,Staff,58,0,60,2
1649783565183,COGS 101C,A01,083976,Staff,29,0,30,1
1649783571208,COGS 102A,A01,083978,Johnson; Christine M.,29,0,30,1
1649783577238,COGS 107B,A01,083980,Staff,46,0,50,4
1649783583262,COGS 115,A01,083982,Staff,27,0,30,3
1649783589285,COGS 118B,A01,083367,Staff,22,0,40,18
1649783595314,COGS 172,A01,083984,Provenzano; Emily Kara,25,0,30,5
1649783601337,COGS 177,A00,083368,Staff,21,0,30,9
1649783607369,COGS 186,A01,083986,Staff,30,0,40,10
1649783613391,COGS 187A,A01,083988,Boyle; Mary E. T.,56,0,60,4
1649783619414,CSE 8A,A50,084003,Miranda; Gregory Joseph,13,0,15,2
1649783625445,CSE 11,A01,084005,Miranda; Gregory Joseph,52,0,55,3
1649783631469,CSE 20,A01,084007,Staff,17,0,20,3
1649783637501,CSE 21,A01,084009,Staff,47,0,50,3
1649783643529,CSE 30,A01,083370,Cao; Yingjun,36,0,40,4
1649783649554,CSE 100,A01,083372,Cao; Yingjun,36,0,40,4
1649783655578,CSE 101,A01,084011,Staff,25,0,40,15
1649783661618,CSE 141,A01,083374,Eldon; John,42,0,75,33
1649783667643,CSE 141L,A01,083376,Eldon; John,44,0,75,31
1649783673669,CSE 175,A01,084013,Kumar; Rakesh,25,0,25,0
1649783679692,CSE 190,A00,092508,Staff,15,0,15,0
1649783685723,ECE 5,A01,084049,Morris; Karcher William,18,0,20,2
1649783691747,ECE 100,A01,084051,Baghdadchi; Saharnaz,18,0,20,2
1649783691747,ECE 100,A02,091916,Baghdadchi; Saharnaz,19,0,20,1
1649783697821,ECE 101,A01,084053,Baghdadchi; Saharnaz,33,0,37,4
1649783697821,ECE 101,A02,084054,Baghdadchi; Saharnaz,37,0,37,0
1649783703844,ECE 107,A01,083390,Staff,36,0,40,4
1649783709882,ECE 148,A01,084056,Silberman; Jack,9,0,12,3
1649783715906,ECE 180,A00,083391,Abi Samra; Nicholas Camill,27,0,30,3
1649783715906,ECE 180,B00,083392,Abi Samra; Nicholas Camill,27,0,30,3
1649783721929,MATH 10B,A01,084110,Staff,26,0,30,4
1649783721929,MATH 10B,A02,084111,Staff,30,0,30,0
1649783721929,MATH 10B,A03,084112,Staff,30,0,30,0
1649783727971,MATH 10C,A01,083443,Staff,27,0,30,3
1649783727971,MATH 10C,A02,083444,Staff,26,0,30,4
1649783727971,MATH 10C,B01,084114,Staff,28,0,30,2
1649783727971,MATH 10C,B02,084115,Staff,30,0,30,0
1649783733998,MATH 18,A01,084117,Harel; Guershon,28,0,30,2
1649783733998,MATH 18,A02,084119,Harel; Guershon,29,0,30,1
1649783733998,MATH 18,A03,084120,Harel; Guershon,30,0,30,0
1649783733998,MATH 18,A04,084121,Harel; Guershon,30,0,30,0
1649783740022,MATH 20B,A01,084124,Um; Ko Woon,34,0,35,1
1649783740022,MATH 20B,B01,084126,Um; Ko Woon,35,0,35,0
1649783746061,MATH 20C,A01,083446,Hammock; Frances H,29,0,30,1
1649783746061,MATH 20C,A02,083447,Hammock; Frances H,30,0,30,0
1649783746061,MATH 20C,A03,083448,Hammock; Frances H,30,0,30,0
1649783746061,MATH 20C,A04,083449,Hammock; Frances H,30,0,30,0
1649783746061,MATH 20C,B01,083451,Hammock; Frances H,30,0,30,0
1649783746061,MATH 20C,B02,083452,Hammock; Frances H,30,0,30,0
1649783746061,MATH 20C,B03,083453,Hammock; Frances H,30,0,30,0
1649783746061,MATH 20C,B04,083454,Hammock; Frances H,30,0,30,0
1649783752097,MATH 20D,A01,084128,Staff,30,0,30,0
1649783752097,MATH 20D,A02,084129,Staff,30,0,30,0
1649783752097,MATH 20D,A03,084130,Staff,29,0,30,1
1649783752097,MATH 20D,B01,084133,Staff,30,0,30,0
1649783752097,MATH 20D,B02,084134,Staff,30,0,30,0
1649783752097,MATH 20D,B03,084135,Staff,30,0,30,0
1649783758129,MATH 20E,A01,084138,Staff,30,0,30,0
1649783758129,MATH 20E,A02,084139,Staff,29,0,30,1
1649783758129,MATH 20E,A03,084140,Staff,30,0,30,0
1649783758129,MATH 20E,A04,084141,Staff,30,0,30,0
1649783764167,MATH 102,A01,084143,Harel; Guershon,27,0,30,3
1649783764167,MATH 102,A02,084144,Harel; Guershon,29,0,30,1
1649783770193,MATH 103B,A01,083456,Staff,21,0,30,9
1649783770193,MATH 103B,A02,083457,Staff,28,0,30,2
1649783776217,MATH 109,A01,084146,Salehi Golsefidy; Alireza,30,0,30,0
1649783776217,MATH 109,A02,084147,Salehi Golsefidy; Alireza,29,0,30,1
1649783782244,MATH 120A,A01,085445,Eggers; John Dietrich,32,0,35,3
1649783782244,MATH 120A,A02,085446,Eggers; John Dietrich,33,0,35,2
1649783788283,MATH 142B,A01,084149,Verstraete; Jacques Allan,26,0,30,4
1649783788283,MATH 142B,A02,084150,Verstraete; Jacques Allan,27,0,30,3
1649783794309,MATH 170A,A01,083459,Nie; Jiawang,21,0,30,9
1649783794309,MATH 170A,A02,083460,Nie; Jiawang,28,0,30,2
1649783794309,MATH 170A,A03,083461,Nie; Jiawang,30,0,30,0
1649783800335,MATH 193B,A01,083463,Staff,25,0,30,5
1649783800335,MATH 193B,A02,083464,Staff,29,0,30,1
1649783800335,MATH 193B,A03,083465,Staff,30,0,30,0
1649783806401,COGS 2,A01,083966,Boyle; Mary E. T.,28,0,30,2
1649783812426,COGS 9,A01,083968,Staff,59,0,60,1
1649783818454,COGS 14B,A01,083970,Staff,49,0,50,1
1649783824480,COGS 100,A01,083972,Staff,58,0,60,2
1649783836525,COGS 101C,A01,083976,Staff,29,0,30,1
1649783842562,COGS 102A,A01,083978,Johnson; Christine M.,29,0,30,1
1649783848585,COGS 107B,A01,083980,Staff,46,0,50,4
1649783854608,COGS 115,A01,083982,Staff,27,0,30,3
1649783860631,COGS 118B,A01,083367,Staff,22,0,40,18
1649783866656,COGS 172,A01,083984,Provenzano; Emily Kara,25,0,30,5
1649783872679,COGS 177,A00,083368,Staff,21,0,30,9
1649783878703,COGS 186,A01,083986,Staff,30,0,40,10
1649783884731,COGS 187A,A01,083988,Boyle; Mary E. T.,56,0,60,4
1649783890754,CSE 8A,A50,084003,Miranda; Gregory Joseph,12,0,15,3
1649783896786,CSE 11,A01,084005,Miranda; Gregory Joseph,52,0,55,3
1649783902809,CSE 20,A01,084007,Staff,17,0,20,3
1649783908836,CSE 21,A01,084009,Staff,47,0,50,3
1649783914860,CSE 30,A01,083370,Cao; Yingjun,36,0,40,4
1649783920891,CSE 100,A01,083372,Cao; Yingjun,36,0,40,4
1649783926920,CSE 101,A01,084011,Staff,25,0,40,15
1649783932952,CSE 141,A01,083374,Eldon; John,42,0,75,33
1649783938977,CSE 141L,A01,083376,Eldon; John,44,0,75,31
1649783945006,CSE 175,A01,084013,Kumar; Rakesh,25,0,25,0
1649783951037,CSE 190,A00,092508,Staff,15,0,15,0
1649783957064,ECE 5,A01,084049,Morris; Karcher William,18,0,20,2
1649783963098,ECE 100,A01,084051,Baghdadchi; Saharnaz,18,0,20,2
1649783963098,ECE 100,A02,091916,Baghdadchi; Saharnaz,19,0,20,1
1649783969130,ECE 101,A01,084053,Baghdadchi; Saharnaz,33,0,37,4
1649783969130,ECE 101,A02,084054,Baghdadchi; Saharnaz,37,0,37,0
1649783975152,ECE 107,A01,083390,Staff,36,0,40,4
1649783981179,ECE 148,A01,084056,Silberman; Jack,9,0,12,3
1649783987205,ECE 180,A00,083391,Abi Samra; Nicholas Camill,27,0,30,3
1649783987205,ECE 180,B00,083392,Abi Samra; Nicholas Camill,27,0,30,3
1649783993232,MATH 10B,A01,084110,Staff,26,0,30,4
1649783993232,MATH 10B,A02,084111,Staff,30,0,30,0
1649783993232,MATH 10B,A03,084112,Staff,30,0,30,0
1649783999259,MATH 10C,A01,083443,Staff,27,0,30,3
1649783999259,MATH 10C,A02,083444,Staff,26,0,30,4
1649783999259,MATH 10C,B01,084114,Staff,28,0,30,2
1649783999259,MATH 10C,B02,084115,Staff,30,0,30,0
1649784005282,MATH 18,A01,084117,Harel; Guershon,28,0,30,2
1649784005282,MATH 18,A02,084119,Harel; Guershon,29,0,30,1
1649784005282,MATH 18,A03,084120,Harel; Guershon,30,0,30,0
1649784005282,MATH 18,A04,084121,Harel; Guershon,30,0,30,0
1649784011309,MATH 20B,A01,084124,Um; Ko Woon,34,0,35,1
1649784011309,MATH 20B,B01,084126,Um; Ko Woon,35,0,35,0
1649784017334,MATH 20C,A01,083446,Hammock; Frances H,29,0,30,1
1649784017334,MATH 20C,A02,083447,Hammock; Frances H,30,0,30,0
1649784017334,MATH 20C,A03,083448,Hammock; Frances H,30,0,30,0
1649784017334,MATH 20C,A04,083449,Hammock; Frances H,30,0,30,0
1649784017334,MATH 20C,B01,083451,Hammock; Frances H,30,0,30,0
1649784017334,MATH 20C,B02,083452,Hammock; Frances H,30,0,30,0
1649784017334,MATH 20C,B03,083453,Hammock; Frances H,30,0,30,0
1649784017334,MATH 20C,B04,083454,Hammock; Frances H,30,0,30,0
1649784023367,MATH 20D,A01,084128,Staff,30,0,30,0
1649784023367,MATH 20D,A02,084129,Staff,30,0,30,0
1649784023367,MATH 20D,A03,084130,Staff,29,0,30,1
1649784023367,MATH 20D,B01,084133,Staff,30,0,30,0
1649784023367,MATH 20D,B02,084134,Staff,30,0,30,0
1649784023367,MATH 20D,B03,084135,Staff,30,0,30,0
1649784029403,MATH 20E,A01,084138,Staff,30,0,30,0
1649784029403,MATH 20E,A02,084139,Staff,29,0,30,1
1649784029403,MATH 20E,A03,084140,Staff,30,0,30,0
1649784029403,MATH 20E,A04,084141,Staff,30,0,30,0
1649784035427,MATH 102,A01,084143,Harel; Guershon,27,0,30,3
1649784035427,MATH 102,A02,084144,Harel; Guershon,29,0,30,1
1649784041461,MATH 103B,A01,083456,Staff,21,0,30,9
1649784041461,MATH 103B,A02,083457,Staff,28,0,30,2
1649784047574,MATH 109,A01,084146,Salehi Golsefidy; Alireza,30,0,30,0
1649784047574,MATH 109,A02,084147,Salehi Golsefidy; Alireza,29,0,30,1
1649784053602,MATH 120A,A01,085445,Eggers; John Dietrich,32,0,35,3
1649784053602,MATH 120A,A02,085446,Eggers; John Dietrich,33,0,35,2
1649784059624,MATH 142B,A01,084149,Verstraete; Jacques Allan,26,0,30,4
1649784059624,MATH 142B,A02,084150,Verstraete; Jacques Allan,27,0,30,3
1649784065657,MATH 170A,A01,083459,Nie; Jiawang,21,0,30,9
1649784065657,MATH 170A,A02,083460,Nie; Jiawang,28,0,30,2
1649784065657,MATH 170A,A03,083461,Nie; Jiawang,30,0,30,0
1649784071681,MATH 193B,A01,083463,Staff,25,0,30,5
1649784071681,MATH 193B,A02,083464,Staff,29,0,30,1
1649784071681,MATH 193B,A03,083465,Staff,30,0,30,0
1649784077750,COGS 2,A01,083966,Boyle; Mary E. T.,28,0,30,2
1649784083773,COGS 9,A01,083968,Staff,59,0,60,1
1649784089801,COGS 14B,A01,083970,Staff,49,0,50,1
1649784095825,COGS 100,A01,083972,Staff,58,0,60,2
1649784107879,COGS 101C,A01,083976,Staff,29,0,30,1
1649784113906,COGS 102A,A01,083978,Johnson; Christine M.,29,0,30,1
1649784119932,COGS 107B,A01,083980,Staff,46,0,50,4
1649784125956,COGS 115,A01,083982,Staff,27,0,30,3
1649784131987,COGS 118B,A01,083367,Staff,22,0,40,18
1649784138019,COGS 172,A01,083984,Provenzano; Emily Kara,25,0,30,5
1649784144043,COGS 177,A00,083368,Staff,20,0,30,10
1649784150069,COGS 186,A01,083986,Staff,30,0,40,10
1649784156092,COGS 187A,A01,083988,Boyle; Mary E. T.,56,0,60,4
1649784162115,CSE 8A,A50,084003,Miranda; Gregory Joseph,12,0,15,3
1649784168138,CSE 11,A01,084005,Miranda; Gregory Joseph,52,0,55,3
1649784174178,CSE 20,A01,084007,Staff,17,0,20,3
1649784180221,CSE 21,A01,084009,Staff,47,0,50,3
1649784186253,CSE 30,A01,083370,Cao; Yingjun,36,0,40,4
1649784192276,CSE 100,A01,083372,Cao; Yingjun,36,0,40,4
1649784198309,CSE 101,A01,084011,Staff,25,0,40,15
1649784204361,CSE 141,A01,083374,Eldon; John,40,0,75,35
1649784210392,CSE 141L,A01,083376,Eldon; John,42,0,75,33
1649784216424,CSE 175,A01,084013,Kumar; Rakesh,25,0,25,0
1649784222458,CSE 190,A00,092508,Staff,15,0,15,0
1649784228487,ECE 5,A01,084049,Morris; Karcher William,18,0,20,2
1649784234515,ECE 100,A01,084051,Baghdadchi; Saharnaz,18,0,20,2
1649784234515,ECE 100,A02,091916,Baghdadchi; Saharnaz,19,0,20,1
1649784240542,ECE 101,A01,084053,Baghdadchi; Saharnaz,33,0,37,4
1649784240542,ECE 101,A02,084054,Baghdadchi; Saharnaz,37,0,37,0
1649784246573,ECE 107,A01,083390,Staff,36,0,40,4
1649784252602,ECE 148,A01,084056,Silberman; Jack,9,0,12,3
1649784258624,ECE 180,A00,083391,Abi Samra; Nicholas Camill,27,0,30,3
1649784258624,ECE 180,B00,083392,Abi Samra; Nicholas Camill,27,0,30,3
1649784264652,MATH 10B,A01,084110,Staff,26,0,30,4
1649784264652,MATH 10B,A02,084111,Staff,30,0,30,0
1649784264652,MATH 10B,A03,084112,Staff,30,0,30,0
1649784270678,MATH 10C,A01,083443,Staff,27,0,30,3
1649784270678,MATH 10C,A02,083444,Staff,26,0,30,4
1649784270678,MATH 10C,B01,084114,Staff,28,0,30,2
1649784270678,MATH 10C,B02,084115,Staff,30,0,30,0
1649784276708,MATH 18,A01,084117,Harel; Guershon,28,0,30,2
1649784276708,MATH 18,A02,084119,Harel; Guershon,29,0,30,1
1649784276708,MATH 18,A03,084120,Harel; Guershon,30,0,30,0
1649784276708,MATH 18,A04,084121,Harel; Guershon,30,0,30,0
1649784282737,MATH 20B,A01,084124,Um; Ko Woon,34,0,35,1
1649784282737,MATH 20B,B01,084126,Um; Ko Woon,35,0,35,0
1649784288761,MATH 20C,A01,083446,Hammock; Frances H,29,0,30,1
1649784288761,MATH 20C,A02,083447,Hammock; Frances H,30,0,30,0
1649784288761,MATH 20C,A03,083448,Hammock; Frances H,30,0,30,0
1649784288761,MATH 20C,A04,083449,Hammock; Frances H,30,0,30,0
1649784288761,MATH 20C,B01,083451,Hammock; Frances H,30,0,30,0
1649784288761,MATH 20C,B02,083452,Hammock; Frances H,30,0,30,0
1649784288761,MATH 20C,B03,083453,Hammock; Frances H,30,0,30,0
1649784288761,MATH 20C,B04,083454,Hammock; Frances H,30,0,30,0
1649784294792,MATH 20D,A01,084128,Staff,30,0,30,0
1649784294792,MATH 20D,A02,084129,Staff,30,0,30,0
1649784294792,MATH 20D,A03,084130,Staff,29,0,30,1
1649784294792,MATH 20D,B01,084133,Staff,30,0,30,0
1649784294792,MATH 20D,B02,084134,Staff,30,0,30,0
1649784294792,MATH 20D,B03,084135,Staff,30,0,30,0
1649784300822,MATH 20E,A01,084138,Staff,30,0,30,0
1649784300822,MATH 20E,A02,084139,Staff,29,0,30,1
1649784300822,MATH 20E,A03,084140,Staff,30,0,30,0
1649784300822,MATH 20E,A04,084141,Staff,30,0,30,0
1649784306846,MATH 102,A01,084143,Harel; Guershon,27,0,30,3
1649784306846,MATH 102,A02,084144,Harel; Guershon,29,0,30,1
1649784312871,MATH 103B,A01,083456,Staff,21,0,30,9
1649784312871,MATH 103B,A02,083457,Staff,28,0,30,2
1649784318897,MATH 109,A01,084146,Salehi Golsefidy; Alireza,30,0,30,0
1649784318897,MATH 109,A02,084147,Salehi Golsefidy; Alireza,29,0,30,1
1649784325011,MATH 120A,A01,085445,Eggers; John Dietrich,32,0,35,3
1649784325011,MATH 120A,A02,085446,Eggers; John Dietrich,33,0,35,2
1649784331036,MATH 142B,A01,084149,Verstraete; Jacques Allan,26,0,30,4
1649784331036,MATH 142B,A02,084150,Verstraete; Jacques Allan,27,0,30,3
1649784337065,MATH 170A,A01,083459,Nie; Jiawang,21,0,30,9
1649784337065,MATH 170A,A02,083460,Nie; Jiawang,28,0,30,2
1649784337065,MATH 170A,A03,083461,Nie; Jiawang,30,0,30,0
1649784343097,MATH 193B,A01,083463,Staff,25,0,30,5
1649784343097,MATH 193B,A02,083464,Staff,29,0,30,1
1649784343097,MATH 193B,A03,083465,Staff,30,0,30,0
1649784349145,COGS 2,A01,083966,Boyle; Mary E. T.,28,0,30,2
1649784355181,COGS 9,A01,083968,Staff,59,0,60,1
1649784361204,COGS 14B,A01,083970,Staff,49,0,50,1
1649784367236,COGS 100,A01,083972,Staff,58,0,60,2
1649784379284,COGS 101C,A01,083976,Staff,29,0,30,1
1649784385307,COGS 102A,A01,083978,Johnson; Christine M.,29,0,30,1
1649784391333,COGS 107B,A01,083980,Staff,46,0,50,4
1649784397359,COGS 115,A01,083982,Staff,27,0,30,3
1649784403388,COGS 118B,A01,083367,Staff,22,0,40,18
1649784409415,COGS 172,A01,083984,Provenzano; Emily Kara,25,0,30,5
1649784415444,COGS 177,A00,083368,Staff,20,0,30,10
1649784421475,COGS 186,A01,083986,Staff,30,0,40,10
1649784427498,COGS 187A,A01,083988,Boyle; Mary E. T.,56,0,60,4
1649784433524,CSE 8A,A50,084003,Miranda; Gregory Joseph,12,0,15,3
1649784439548,CSE 11,A01,084005,Miranda; Gregory Joseph,52,0,55,3
1649784445573,CSE 20,A01,084007,Staff,17,0,20,3
1649784451601,CSE 21,A01,084009,Staff,47,0,50,3
1649784457626,CSE 30,A01,083370,Cao; Yingjun,36,0,40,4
1649784463650,CSE 100,A01,083372,Cao; Yingjun,36,0,40,4
1649784469676,CSE 101,A01,084011,Staff,25,0,40,15
1649784475698,CSE 141,A01,083374,Eldon; John,40,0,75,35
1649784481724,CSE 141L,A01,083376,Eldon; John,42,0,75,33
1649784487760,CSE 175,A01,084013,Kumar; Rakesh,25,0,25,0
1649784493784,CSE 190,A00,092508,Staff,15,0,15,0
1649784499814,ECE 5,A01,084049,Morris; Karcher William,18,0,20,2
1649784505844,ECE 100,A01,084051,Baghdadchi; Saharnaz,18,0,20,2
1649784505844,ECE 100,A02,091916,Baghdadchi; Saharnaz,19,0,20,1
1649784511873,ECE 101,A01,084053,Baghdadchi; Saharnaz,33,0,37,4
1649784511873,ECE 101,A02,084054,Baghdadchi; Saharnaz,37,0,37,0
1649784517899,ECE 107,A01,083390,Staff,36,0,40,4
1649784523930,ECE 148,A01,084056,Silberman; Jack,8,0,12,4
1649784529954,ECE 180,A00,083391,Abi Samra; Nicholas Camill,27,0,30,3
1649784529954,ECE 180,B00,083392,Abi Samra; Nicholas Camill,27,0,30,3
1649784535981,MATH 10B,A01,084110,Staff,26,0,30,4
1649784535981,MATH 10B,A02,084111,Staff,30,0,30,0
1649784535981,MATH 10B,A03,084112,Staff,30,0,30,0
1649784542007,MATH 10C,A01,083443,Staff,27,0,30,3
1649784542007,MATH 10C,A02,083444,Staff,26,0,30,4
1649784542007,MATH 10C,B01,084114,Staff,28,0,30,2
1649784542007,MATH 10C,B02,084115,Staff,30,0,30,0
1649784548049,MATH 18,A01,084117,Harel; Guershon,28,0,30,2
1649784548049,MATH 18,A02,084119,Harel; Guershon,29,0,30,1
1649784548049,MATH 18,A03,084120,Harel; Guershon,30,0,30,0
1649784548049,MATH 18,A04,084121,Harel; Guershon,30,0,30,0
1649784554085,MATH 20B,A01,084124,Um; Ko Woon,34,0,35,1
1649784554085,MATH 20B,B01,084126,Um; Ko Woon,35,0,35,0
1649784560109,MATH 20C,A01,083446,Hammock; Frances H,29,0,30,1
1649784560109,MATH 20C,A02,083447,Hammock; Frances H,30,0,30,0
1649784560109,MATH 20C,A03,083448,Hammock; Frances H,30,0,30,0
1649784560109,MATH 20C,A04,083449,Hammock; Frances H,30,0,30,0
1649784560109,MATH 20C,B01,083451,Hammock; Frances H,30,0,30,0
1649784560109,MATH 20C,B02,083452,Hammock; Frances H,30,0,30,0
1649784560109,MATH 20C,B03,083453,Hammock; Frances H,30,0,30,0
1649784560109,MATH 20C,B04,083454,Hammock; Frances H,30,0,30,0
1649784566134,MATH 20D,A01,084128,Staff,30,0,30,0
1649784566134,MATH 20D,A02,084129,Staff,30,0,30,0
1649784566134,MATH 20D,A03,084130,Staff,29,0,30,1
1649784566134,MATH 20D,B01,084133,Staff,30,0,30,0
1649784566134,MATH 20D,B02,084134,Staff,30,0,30,0
1649784566134,MATH 20D,B03,084135,Staff,30,0,30,0
1649784572166,MATH 20E,A01,084138,Staff,30,0,30,0
1649784572166,MATH 20E,A02,084139,Staff,29,0,30,1
1649784572166,MATH 20E,A03,084140,Staff,30,0,30,0
1649784572166,MATH 20E,A04,084141,Staff,30,0,30,0
1649784578198,MATH 102,A01,084143,Harel; Guershon,27,0,30,3
1649784578198,MATH 102,A02,084144,Harel; Guershon,29,0,30,1
1649784584235,MATH 103B,A01,083456,Staff,21,0,30,9
1649784584235,MATH 103B,A02,083457,Staff,28,0,30,2
1649784590258,MATH 109,A01,084146,Salehi Golsefidy; Alireza,30,0,30,0
1649784590258,MATH 109,A02,084147,Salehi Golsefidy; Alireza,29,0,30,1
1649784596287,MATH 120A,A01,085445,Eggers; John Dietrich,32,0,35,3
1649784596287,MATH 120A,A02,085446,Eggers; John Dietrich,33,0,35,2
1649784602312,MATH 142B,A01,084149,Verstraete; Jacques Allan,26,0,30,4
1649784602312,MATH 142B,A02,084150,Verstraete; Jacques Allan,27,0,30,3
1649784608334,MATH 170A,A01,083459,Nie; Jiawang,21,0,30,9
1649784608334,MATH 170A,A02,083460,Nie; Jiawang,28,0,30,2
1649784608334,MATH 170A,A03,083461,Nie; Jiawang,30,0,30,0
1649784614359,MATH 193B,A01,083463,Staff,25,0,30,5
1649784614359,MATH 193B,A02,083464,Staff,29,0,30,1
1649784614359,MATH 193B,A03,083465,Staff,30,0,30,0
1649784620420,COGS 2,A01,083966,Boyle; Mary E. T.,28,0,30,2
1649784626443,COGS 9,A01,083968,Staff,59,0,60,1
1649784632466,COGS 14B,A01,083970,Staff,49,0,50,1
1649784638589,COGS 100,A01,083972,Staff,58,0,60,2
1649784650641,COGS 101C,A01,083976,Staff,29,0,30,1
1649784656672,COGS 102A,A01,083978,Johnson; Christine M.,29,0,30,1
1649784662696,COGS 107B,A01,083980,Staff,46,0,50,4
1649784668721,COGS 115,A01,083982,Staff,27,0,30,3
1649784674753,COGS 118B,A01,083367,Staff,22,0,40,18
1649784680781,COGS 172,A01,083984,Provenzano; Emily Kara,25,0,30,5
1649784686803,COGS 177,A00,083368,Staff,20,0,30,10
1649784692829,COGS 186,A01,083986,Staff,30,0,40,10
1649784698852,COGS 187A,A01,083988,Boyle; Mary E. T.,56,0,60,4
1649784704876,CSE 8A,A50,084003,Miranda; Gregory Joseph,12,0,15,3
1649784710900,CSE 11,A01,084005,Miranda; Gregory Joseph,52,0,55,3
1649784716924,CSE 20,A01,084007,Staff,17,0,20,3
1649784722950,CSE 21,A01,084009,Staff,47,0,50,3
1649784728976,CSE 30,A01,083370,Cao; Yingjun,36,0,40,4
1649784735004,CSE 100,A01,083372,Cao; Yingjun,36,0,40,4
1649784741027,CSE 101,A01,084011,Staff,25,0,40,15
1649784747058,CSE 141,A01,083374,Eldon; John,40,0,75,35
1649784753080,CSE 141L,A01,083376,Eldon; John,42,0,75,33
1649784759115,CSE 175,A01,084013,Kumar; Rakesh,25,0,25,0
1649784765138,CSE 190,A00,092508,Staff,15,0,15,0
1649784771161,ECE 5,A01,084049,Morris; Karcher William,18,0,20,2
1649784777187,ECE 100,A01,084051,Baghdadchi; Saharnaz,18,0,20,2
1649784777187,ECE 100,A02,091916,Baghdadchi; Saharnaz,19,0,20,1
1649784783213,ECE 101,A01,084053,Baghdadchi; Saharnaz,33,0,37,4
1649784783213,ECE 101,A02,084054,Baghdadchi; Saharnaz,37,0,37,0
1649784789237,ECE 107,A01,083390,Staff,35,0,40,5
1649784795263,ECE 148,A01,084056,Silberman; Jack,8,0,12,4
1649784801295,ECE 180,A00,083391,Abi Samra; Nicholas Camill,27,0,30,3
1649784801295,ECE 180,B00,083392,Abi Samra; Nicholas Camill,27,0,30,3
1649784807323,MATH 10B,A01,084110,Staff,26,0,30,4
1649784807323,MATH 10B,A02,084111,Staff,30,0,30,0
1649784807323,MATH 10B,A03,084112,Staff,30,0,30,0
1649784813354,MATH 10C,A01,083443,Staff,27,0,30,3
1649784813354,MATH 10C,A02,083444,Staff,26,0,30,4
1649784813354,MATH 10C,B01,084114,Staff,28,0,30,2
1649784813354,MATH 10C,B02,084115,Staff,30,0,30,0
1649784819378,MATH 18,A01,084117,Harel; Guershon,28,0,30,2
1649784819378,MATH 18,A02,084119,Harel; Guershon,29,0,30,1
1649784819378,MATH 18,A03,084120,Harel; Guershon,30,0,30,0
1649784819378,MATH 18,A04,084121,Harel; Guershon,30,0,30,0
1649784825417,MATH 20B,A01,084124,Um; Ko Woon,34,0,35,1
1649784825417,MATH 20B,B01,084126,Um; Ko Woon,35,0,35,0
1649784831457,MATH 20C,A01,083446,Hammock; Frances H,29,0,30,1
1649784831457,MATH 20C,A02,083447,Hammock; Frances H,30,0,30,0
1649784831457,MATH 20C,A03,083448,Hammock; Frances H,30,0,30,0
1649784831457,MATH 20C,A04,083449,Hammock; Frances H,30,0,30,0
1649784831457,MATH 20C,B01,083451,Hammock; Frances H,30,0,30,0
1649784831457,MATH 20C,B02,083452,Hammock; Frances H,30,0,30,0
1649784831457,MATH 20C,B03,083453,Hammock; Frances H,30,0,30,0
1649784831457,MATH 20C,B04,083454,Hammock; Frances H,30,0,30,0
1649784837484,MATH 20D,A01,084128,Staff,30,0,30,0
1649784837484,MATH 20D,A02,084129,Staff,30,0,30,0
1649784837484,MATH 20D,A03,084130,Staff,29,0,30,1
1649784837484,MATH 20D,B01,084133,Staff,30,0,30,0
1649784837484,MATH 20D,B02,084134,Staff,30,0,30,0
1649784837484,MATH 20D,B03,084135,Staff,30,0,30,0
1649784843513,MATH 20E,A01,084138,Staff,30,0,30,0
1649784843513,MATH 20E,A02,084139,Staff,29,0,30,1
1649784843513,MATH 20E,A03,084140,Staff,30,0,30,0
1649784843513,MATH 20E,A04,084141,Staff,30,0,30,0
1649784849541,MATH 102,A01,084143,Harel; Guershon,27,0,30,3
1649784849541,MATH 102,A02,084144,Harel; Guershon,29,0,30,1
1649784855570,MATH 103B,A01,083456,Staff,21,0,30,9
1649784855570,MATH 103B,A02,083457,Staff,28,0,30,2
1649784861597,MATH 109,A01,084146,Salehi Golsefidy; Alireza,30,0,30,0
1649784861597,MATH 109,A02,084147,Salehi Golsefidy; Alireza,29,0,30,1
1649784867624,MATH 120A,A01,085445,Eggers; John Dietrich,32,0,35,3
1649784867624,MATH 120A,A02,085446,Eggers; John Dietrich,33,0,35,2
1649784873677,MATH 142B,A01,084149,Verstraete; Jacques Allan,26,0,30,4
1649784873677,MATH 142B,A02,084150,Verstraete; Jacques Allan,27,0,30,3
1649784879700,MATH 170A,A01,083459,Nie; Jiawang,21,0,30,9
1649784879700,MATH 170A,A02,083460,Nie; Jiawang,28,0,30,2
1649784879700,MATH 170A,A03,083461,Nie; Jiawang,30,0,30,0
1649784885727,MATH 193B,A01,083463,Staff,25,0,30,5
1649784885727,MATH 193B,A02,083464,Staff,29,0,30,1
1649784885727,MATH 193B,A03,083465,Staff,30,0,30,0
1649784891788,COGS 2,A01,083966,Boyle; Mary E. T.,28,0,30,2
1649784897811,COGS 9,A01,083968,Staff,59,0,60,1
1649784903838,COGS 14B,A01,083970,Staff,49,0,50,1
1649784909867,COGS 100,A01,083972,Staff,58,0,60,2
1649784921922,COGS 101C,A01,083976,Staff,29,0,30,1
1649784927947,COGS 102A,A01,083978,Johnson; Christine M.,29,0,30,1
1649784933970,COGS 107B,A01,083980,Staff,46,0,50,4
1649784939999,COGS 115,A01,083982,Staff,27,0,30,3
1649784946022,COGS 118B,A01,083367,Staff,22,0,40,18
1649784952046,COGS 172,A01,083984,Provenzano; Emily Kara,25,0,30,5
1649784958070,COGS 177,A00,083368,Staff,20,0,30,10
1649784964096,COGS 186,A01,083986,Staff,30,0,40,10
1649784970128,COGS 187A,A01,083988,Boyle; Mary E. T.,56,0,60,4
1649784976156,CSE 8A,A50,084003,Miranda; Gregory Joseph,12,0,15,3
1649784982184,CSE 11,A01,084005,Miranda; Gregory Joseph,52,0,55,3
1649784988208,CSE 20,A01,084007,Staff,17,0,20,3
1649784994233,CSE 21,A01,084009,Staff,47,0,50,3
1649785000256,CSE 30,A01,083370,Cao; Yingjun,36,0,40,4
1649785006281,CSE 100,A01,083372,Cao; Yingjun,36,0,40,4
1649785012308,CSE 101,A01,084011,Staff,25,0,40,15
1649785018331,CSE 141,A01,083374,Eldon; John,40,0,75,35
1649785024358,CSE 141L,A01,083376,Eldon; John,42,0,75,33
1649785030393,CSE 175,A01,084013,Kumar; Rakesh,25,0,25,0
1649785036419,CSE 190,A00,092508,Staff,15,0,15,0
1649785042443,ECE 5,A01,084049,Morris; Karcher William,18,0,20,2
1649785048482,ECE 100,A01,084051,Baghdadchi; Saharnaz,18,0,20,2
1649785048482,ECE 100,A02,091916,Baghdadchi; Saharnaz,19,0,20,1
1649785054506,ECE 101,A01,084053,Baghdadchi; Saharnaz,33,0,37,4
1649785054506,ECE 101,A02,084054,Baghdadchi; Saharnaz,37,0,37,0
1649785060533,ECE 107,A01,083390,Staff,35,0,40,5
1649785066557,ECE 148,A01,084056,Silberman; Jack,8,0,12,4
1649785072582,ECE 180,A00,083391,Abi Samra; Nicholas Camill,27,0,30,3
1649785072582,ECE 180,B00,083392,Abi Samra; Nicholas Camill,27,0,30,3
1649785078613,MATH 10B,A01,084110,Staff,26,0,30,4
1649785078613,MATH 10B,A02,084111,Staff,30,0,30,0
1649785078613,MATH 10B,A03,084112,Staff,30,0,30,0
1649785084637,MATH 10C,A01,083443,Staff,27,0,30,3
1649785084637,MATH 10C,A02,083444,Staff,26,0,30,4
1649785084637,MATH 10C,B01,084114,Staff,28,0,30,2
1649785084637,MATH 10C,B02,084115,Staff,30,0,30,0
1649785090661,MATH 18,A01,084117,Harel; Guershon,28,0,30,2
1649785090661,MATH 18,A02,084119,Harel; Guershon,29,0,30,1
1649785090661,MATH 18,A03,084120,Harel; Guershon,30,0,30,0
1649785090661,MATH 18,A04,084121,Harel; Guershon,30,0,30,0
1649785096690,MATH 20B,A01,084124,Um; Ko Woon,34,0,35,1
1649785096690,MATH 20B,B01,084126,Um; Ko Woon,35,0,35,0
1649785102715,MATH 20C,A01,083446,Hammock; Frances H,29,0,30,1
1649785102715,MATH 20C,A02,083447,Hammock; Frances H,30,0,30,0
1649785102715,MATH 20C,A03,083448,Hammock; Frances H,30,0,30,0
1649785102715,MATH 20C,A04,083449,Hammock; Frances H,30,0,30,0
1649785102715,MATH 20C,B01,083451,Hammock; Frances H,30,0,30,0
1649785102715,MATH 20C,B02,083452,Hammock; Frances H,30,0,30,0
1649785102715,MATH 20C,B03,083453,Hammock; Frances H,30,0,30,0
1649785102715,MATH 20C,B04,083454,Hammock; Frances H,30,0,30,0
1649785108757,MATH 20D,A01,084128,Staff,30,0,30,0
1649785108757,MATH 20D,A02,084129,Staff,30,0,30,0
1649785108757,MATH 20D,A03,084130,Staff,29,0,30,1
1649785108757,MATH 20D,B01,084133,Staff,30,0,30,0
1649785108757,MATH 20D,B02,084134,Staff,30,0,30,0
1649785108757,MATH 20D,B03,084135,Staff,30,0,30,0
1649785114790,MATH 20E,A01,084138,Staff,30,0,30,0
1649785114790,MATH 20E,A02,084139,Staff,29,0,30,1
1649785114790,MATH 20E,A03,084140,Staff,30,0,30,0
1649785114790,MATH 20E,A04,084141,Staff,30,0,30,0
1649785120813,MATH 102,A01,084143,Harel; Guershon,27,0,30,3
1649785120813,MATH 102,A02,084144,Harel; Guershon,29,0,30,1
1649785126841,MATH 103B,A01,083456,Staff,21,0,30,9
1649785126841,MATH 103B,A02,083457,Staff,28,0,30,2
1649785132869,MATH 109,A01,084146,Salehi Golsefidy; Alireza,30,0,30,0
1649785132869,MATH 109,A02,084147,Salehi Golsefidy; Alireza,29,0,30,1
1649785138892,MATH 120A,A01,085445,Eggers; John Dietrich,32,0,35,3
1649785138892,MATH 120A,A02,085446,Eggers; John Dietrich,33,0,35,2
1649785144918,MATH 142B,A01,084149,Verstraete; Jacques Allan,26,0,30,4
1649785144918,MATH 142B,A02,084150,Verstraete; Jacques Allan,27,0,30,3
1649785150948,MATH 170A,A01,083459,Nie; Jiawang,21,0,30,9
1649785150948,MATH 170A,A02,083460,Nie; Jiawang,28,0,30,2
1649785150948,MATH 170A,A03,083461,Nie; Jiawang,30,0,30,0
1649785156998,MATH 193B,A01,083463,Staff,25,0,30,5
1649785156998,MATH 193B,A02,083464,Staff,29,0,30,1
1649785156998,MATH 193B,A03,083465,Staff,30,0,30,0
1649785163053,COGS 2,A01,083966,Boyle; Mary E. T.,28,0,30,2
1649785169093,COGS 9,A01,083968,Staff,59,0,60,1
1649785175117,COGS 14B,A01,083970,Staff,49,0,50,1
1649785181149,COGS 100,A01,083972,Staff,58,0,60,2
1649785193207,COGS 101C,A01,083976,Staff,29,0,30,1
1649785199239,COGS 102A,A01,083978,Johnson; Christine M.,29,0,30,1
1649785205263,COGS 107B,A01,083980,Staff,46,0,50,4
1649785211288,COGS 115,A01,083982,Staff,27,0,30,3
1649785217320,COGS 118B,A01,083367,Staff,22,0,40,18
1649785223342,COGS 172,A01,083984,Provenzano; Emily Kara,25,0,30,5
1649785229365,COGS 177,A00,083368,Staff,20,0,30,10
1649785235487,COGS 186,A01,083986,Staff,30,0,40,10
1649785241536,COGS 187A,A01,083988,Boyle; Mary E. T.,56,0,60,4
1649785247564,CSE 8A,A50,084003,Miranda; Gregory Joseph,12,0,15,3
1649785253589,CSE 11,A01,084005,Miranda; Gregory Joseph,52,0,55,3
1649785259613,CSE 20,A01,084007,Staff,17,0,20,3
1649785265637,CSE 21,A01,084009,Staff,47,0,50,3
1649785271677,CSE 30,A01,083370,Cao; Yingjun,36,0,40,4
1649785277699,CSE 100,A01,083372,Cao; Yingjun,36,0,40,4
1649785283732,CSE 101,A01,084011,Staff,25,0,40,15
1649785289761,CSE 141,A01,083374,Eldon; John,40,0,75,35
1649785295786,CSE 141L,A01,083376,Eldon; John,42,0,75,33
1649785301812,CSE 175,A01,084013,Kumar; Rakesh,25,0,25,0
1649785307838,CSE 190,A00,092508,Staff,15,0,15,0
1649785313865,ECE 5,A01,084049,Morris; Karcher William,18,0,20,2
1649785319887,ECE 100,A01,084051,Baghdadchi; Saharnaz,18,0,20,2
1649785319887,ECE 100,A02,091916,Baghdadchi; Saharnaz,19,0,20,1
1649785325921,ECE 101,A01,084053,Baghdadchi; Saharnaz,33,0,37,4
1649785325921,ECE 101,A02,084054,Baghdadchi; Saharnaz,37,0,37,0
1649785331945,ECE 107,A01,083390,Staff,35,0,40,5
1649785337973,ECE 148,A01,084056,Silberman; Jack,8,0,12,4
1649785344001,ECE 180,A00,083391,Abi Samra; Nicholas Camill,27,0,30,3
1649785344001,ECE 180,B00,083392,Abi Samra; Nicholas Camill,27,0,30,3
1649785350023,MATH 10B,A01,084110,Staff,26,0,30,4
1649785350023,MATH 10B,A02,084111,Staff,30,0,30,0
1649785350023,MATH 10B,A03,084112,Staff,30,0,30,0
1649785356050,MATH 10C,A01,083443,Staff,27,0,30,3
1649785356050,MATH 10C,A02,083444,Staff,26,0,30,4
1649785356050,MATH 10C,B01,084114,Staff,28,0,30,2
1649785356050,MATH 10C,B02,084115,Staff,30,0,30,0
1649785362085,MATH 18,A01,084117,Harel; Guershon,28,0,30,2
1649785362085,MATH 18,A02,084119,Harel; Guershon,29,0,30,1
1649785362085,MATH 18,A03,084120,Harel; Guershon,30,0,30,0
1649785362085,MATH 18,A04,084121,Harel; Guershon,30,0,30,0
1649785368112,MATH 20B,A01,084124,Um; Ko Woon,34,0,35,1
1649785368112,MATH 20B,B01,084126,Um; Ko Woon,35,0,35,0
1649785374138,MATH 20C,A01,083446,Hammock; Frances H,29,0,30,1
1649785374138,MATH 20C,A02,083447,Hammock; Frances H,30,0,30,0
1649785374138,MATH 20C,A03,083448,Hammock; Frances H,30,0,30,0
1649785374138,MATH 20C,A04,083449,Hammock; Frances H,30,0,30,0
1649785374138,MATH 20C,B01,083451,Hammock; Frances H,30,0,30,0
1649785374138,MATH 20C,B02,083452,Hammock; Frances H,30,0,30,0
1649785374138,MATH 20C,B03,083453,Hammock; Frances H,30,0,30,0
1649785374138,MATH 20C,B04,083454,Hammock; Frances H,30,0,30,0
1649785380165,MATH 20D,A01,084128,Staff,30,0,30,0
1649785380165,MATH 20D,A02,084129,Staff,30,0,30,0
1649785380165,MATH 20D,A03,084130,Staff,29,0,30,1
1649785380165,MATH 20D,B01,084133,Staff,30,0,30,0
1649785380165,MATH 20D,B02,084134,Staff,30,0,30,0
1649785380165,MATH 20D,B03,084135,Staff,30,0,30,0
1649785386186,MATH 20E,A01,084138,Staff,30,0,30,0
1649785386186,MATH 20E,A02,084139,Staff,29,0,30,1
1649785386186,MATH 20E,A03,084140,Staff,30,0,30,0
1649785386186,MATH 20E,A04,084141,Staff,30,0,30,0
1649785392212,MATH 102,A01,084143,Harel; Guershon,27,0,30,3
1649785392212,MATH 102,A02,084144,Harel; Guershon,29,0,30,1
1649785398241,MATH 103B,A01,083456,Staff,21,0,30,9
1649785398241,MATH 103B,A02,083457,Staff,28,0,30,2
1649785404265,MATH 109,A01,084146,Salehi Golsefidy; Alireza,30,0,30,0
1649785404265,MATH 109,A02,084147,Salehi Golsefidy; Alireza,29,0,30,1
1649785410294,MATH 120A,A01,085445,Eggers; John Dietrich,32,0,35,3
1649785410294,MATH 120A,A02,085446,Eggers; John Dietrich,33,0,35,2
1649785416321,MATH 142B,A01,084149,Verstraete; Jacques Allan,26,0,30,4
1649785416321,MATH 142B,A02,084150,Verstraete; Jacques Allan,27,0,30,3
1649785422348,MATH 170A,A01,083459,Nie; Jiawang,21,0,30,9
1649785422348,MATH 170A,A02,083460,Nie; Jiawang,28,0,30,2
1649785422348,MATH 170A,A03,083461,Nie; Jiawang,30,0,30,0
1649785428384,MATH 193B,A01,083463,Staff,25,0,30,5
1649785428384,MATH 193B,A02,083464,Staff,29,0,30,1
1649785428384,MATH 193B,A03,083465,Staff,30,0,30,0
1649785434438,COGS 2,A01,083966,Boyle; Mary E. T.,28,0,30,2
1649785440471,COGS 9,A01,083968,Staff,59,0,60,1
1649785446494,COGS 14B,A01,083970,Staff,49,0,50,1
1649785452522,COGS 100,A01,083972,Staff,58,0,60,2
1649785464577,COGS 101C,A01,083976,Staff,29,0,30,1
1649785470607,COGS 102A,A01,083978,Johnson; Christine M.,29,0,30,1
1649785476634,COGS 107B,A01,083980,Staff,46,0,50,4
1649785482659,COGS 115,A01,083982,Staff,27,0,30,3
1649785488685,COGS 118B,A01,083367,Staff,21,0,40,19
1649785494708,COGS 172,A01,083984,Provenzano; Emily Kara,25,0,30,5
1649785500730,COGS 177,A00,083368,Staff,20,0,30,10
1649785506770,COGS 186,A01,083986,Staff,28,0,40,12
1649785512795,COGS 187A,A01,083988,Boyle; Mary E. T.,55,0,60,5
1649785518826,CSE 8A,A50,084003,Miranda; Gregory Joseph,12,0,15,3
1649785524850,CSE 11,A01,084005,Miranda; Gregory Joseph,52,0,55,3
1649785530878,CSE 20,A01,084007,Staff,17,0,20,3
1649785536903,CSE 21,A01,084009,Staff,47,0,50,3
1649785542929,CSE 30,A01,083370,Cao; Yingjun,36,0,40,4
1649785548953,CSE 100,A01,083372,Cao; Yingjun,36,0,40,4
1649785554976,CSE 101,A01,084011,Staff,23,0,40,17
1649785561001,CSE 141,A01,083374,Eldon; John,39,0,75,36
1649785567027,CSE 141L,A01,083376,Eldon; John,41,0,75,34
1649785573054,CSE 175,A01,084013,Kumar; Rakesh,25,0,25,0
1649785579080,CSE 190,A00,092508,Staff,15,0,15,0
1649785585116,ECE 5,A01,084049,Morris; Karcher William,18,0,20,2
1649785591148,ECE 100,A01,084051,Baghdadchi; Saharnaz,18,0,20,2
1649785591148,ECE 100,A02,091916,Baghdadchi; Saharnaz,19,0,20,1
1649785597179,ECE 101,A01,084053,Baghdadchi; Saharnaz,33,0,37,4
1649785597179,ECE 101,A02,084054,Baghdadchi; Saharnaz,37,0,37,0
1649785603210,ECE 107,A01,083390,Staff,35,0,40,5
1649785609234,ECE 148,A01,084056,Silberman; Jack,8,0,12,4
1649785615256,ECE 180,A00,083391,Abi Samra; Nicholas Camill,27,0,30,3
1649785615256,ECE 180,B00,083392,Abi Samra; Nicholas Camill,27,0,30,3
1649785621281,MATH 10B,A01,084110,Staff,26,0,30,4
1649785621281,MATH 10B,A02,084111,Staff,30,0,30,0
1649785621281,MATH 10B,A03,084112,Staff,30,0,30,0
1649785627318,MATH 10C,A01,083443,Staff,27,0,30,3
1649785627318,MATH 10C,A02,083444,Staff,26,0,30,4
1649785627318,MATH 10C,B01,084114,Staff,28,0,30,2
1649785627318,MATH 10C,B02,084115,Staff,30,0,30,0
1649785633359,MATH 18,A01,084117,Harel; Guershon,28,0,30,2
1649785633359,MATH 18,A02,084119,Harel; Guershon,29,0,30,1
1649785633359,MATH 18,A03,084120,Harel; Guershon,30,0,30,0
1649785633359,MATH 18,A04,084121,Harel; Guershon,30,0,30,0
1649785639392,MATH 20B,A01,084124,Um; Ko Woon,34,0,35,1
1649785639392,MATH 20B,B01,084126,Um; Ko Woon,35,0,35,0
1649785645417,MATH 20C,A01,083446,Hammock; Frances H,29,0,30,1
1649785645417,MATH 20C,A02,083447,Hammock; Frances H,30,0,30,0
1649785645417,MATH 20C,A03,083448,Hammock; Frances H,30,0,30,0
1649785645417,MATH 20C,A04,083449,Hammock; Frances H,30,0,30,0
1649785645417,MATH 20C,B01,083451,Hammock; Frances H,30,0,30,0
1649785645417,MATH 20C,B02,083452,Hammock; Frances H,30,0,30,0
1649785645417,MATH 20C,B03,083453,Hammock; Frances H,30,0,30,0
1649785645417,MATH 20C,B04,083454,Hammock; Frances H,30,0,30,0
1649785651441,MATH 20D,A01,084128,Staff,30,0,30,0
1649785651441,MATH 20D,A02,084129,Staff,30,0,30,0
1649785651441,MATH 20D,A03,084130,Staff,29,0,30,1
1649785651441,MATH 20D,B01,084133,Staff,30,0,30,0
1649785651441,MATH 20D,B02,084134,Staff,30,0,30,0
1649785651441,MATH 20D,B03,084135,Staff,30,0,30,0
1649785657468,MATH 20E,A01,084138,Staff,30,0,30,0
1649785657468,MATH 20E,A02,084139,Staff,29,0,30,1
1649785657468,MATH 20E,A03,084140,Staff,30,0,30,0
1649785657468,MATH 20E,A04,084141,Staff,30,0,30,0
1649785663495,MATH 102,A01,084143,Harel; Guershon,27,0,30,3
1649785663495,MATH 102,A02,084144,Harel; Guershon,29,0,30,1
1649785669519,MATH 103B,A01,083456,Staff,20,0,30,10
1649785669519,MATH 103B,A02,083457,Staff,28,0,30,2
1649785675541,MATH 109,A01,084146,Salehi Golsefidy; Alireza,30,0,30,0
1649785675541,MATH 109,A02,084147,Salehi Golsefidy; Alireza,29,0,30,1
1649785681567,MATH 120A,A01,085445,Eggers; John Dietrich,32,0,35,3
1649785681567,MATH 120A,A02,085446,Eggers; John Dietrich,33,0,35,2
1649785687590,MATH 142B,A01,084149,Verstraete; Jacques Allan,26,0,30,4
1649785687590,MATH 142B,A02,084150,Verstraete; Jacques Allan,27,0,30,3
1649785693616,MATH 170A,A01,083459,Nie; Jiawang,21,0,30,9
1649785693616,MATH 170A,A02,083460,Nie; Jiawang,28,0,30,2
1649785693616,MATH 170A,A03,083461,Nie; Jiawang,30,0,30,0
1649785699640,MATH 193B,A01,083463,Staff,25,0,30,5
1649785699640,MATH 193B,A02,083464,Staff,29,0,30,1
1649785699640,MATH 193B,A03,083465,Staff,30,0,30,0
1649785705736,COGS 2,A01,083966,Boyle; Mary E. T.,28,0,30,2
1649785711760,COGS 9,A01,083968,Staff,59,0,60,1
1649785717781,COGS 14B,A01,083970,Staff,49,0,50,1
1649785723804,COGS 100,A01,083972,Staff,58,0,60,2
1649785735857,COGS 101C,A01,083976,Staff,29,0,30,1
1649785741879,COGS 102A,A01,083978,Johnson; Christine M.,29,0,30,1
1649785747918,COGS 107B,A01,083980,Staff,46,0,50,4
1649785753941,COGS 115,A01,083982,Staff,27,0,30,3
1649785759965,COGS 118B,A01,083367,Staff,21,0,40,19
1649785765987,COGS 172,A01,083984,Provenzano; Emily Kara,25,0,30,5
1649785772011,COGS 177,A00,083368,Staff,20,0,30,10
1649785778035,COGS 186,A01,083986,Staff,28,0,40,12
1649785784058,COGS 187A,A01,083988,Boyle; Mary E. T.,55,0,60,5
1649785790081,CSE 8A,A50,084003,Miranda; Gregory Joseph,12,0,15,3
1649785796107,CSE 11,A01,084005,Miranda; Gregory Joseph,52,0,55,3
1649785802134,CSE 20,A01,084007,Staff,17,0,20,3
1649785808162,CSE 21,A01,084009,Staff,47,0,50,3
1649785814190,CSE 30,A01,083370,Cao; Yingjun,36,0,40,4
1649785820213,CSE 100,A01,083372,Cao; Yingjun,36,0,40,4
1649785826241,CSE 101,A01,084011,Staff,23,0,40,17
1649785832346,CSE 141,A01,083374,Eldon; John,39,0,75,36
1649785838368,CSE 141L,A01,083376,Eldon; John,41,0,75,34
1649785844390,CSE 175,A01,084013,Kumar; Rakesh,25,0,25,0
1649785850418,CSE 190,A00,092508,Staff,15,0,15,0
1649785856450,ECE 5,A01,084049,Morris; Karcher William,18,0,20,2
1649785862475,ECE 100,A01,084051,Baghdadchi; Saharnaz,18,0,20,2
1649785862475,ECE 100,A02,091916,Baghdadchi; Saharnaz,19,0,20,1
1649785868502,ECE 101,A01,084053,Baghdadchi; Saharnaz,33,0,37,4
1649785868502,ECE 101,A02,084054,Baghdadchi; Saharnaz,37,0,37,0
1649785874528,ECE 107,A01,083390,Staff,35,0,40,5
1649785880564,ECE 148,A01,084056,Silberman; Jack,8,0,12,4
1649785886586,ECE 180,A00,083391,Abi Samra; Nicholas Camill,27,0,30,3
1649785886586,ECE 180,B00,083392,Abi Samra; Nicholas Camill,27,0,30,3
1649785892611,MATH 10B,A01,084110,Staff,26,0,30,4
1649785892611,MATH 10B,A02,084111,Staff,30,0,30,0
1649785892611,MATH 10B,A03,084112,Staff,30,0,30,0
1649785898634,MATH 10C,A01,083443,Staff,26,0,30,4
1649785898634,MATH 10C,A02,083444,Staff,26,0,30,4
1649785898634,MATH 10C,B01,084114,Staff,28,0,30,2
1649785898634,MATH 10C,B02,084115,Staff,30,0,30,0
1649785904657,MATH 18,A01,084117,Harel; Guershon,28,0,30,2
1649785904657,MATH 18,A02,084119,Harel; Guershon,29,0,30,1
1649785904657,MATH 18,A03,084120,Harel; Guershon,30,0,30,0
1649785904657,MATH 18,A04,084121,Harel; Guershon,30,0,30,0
1649785910682,MATH 20B,A01,084124,Um; Ko Woon,34,0,35,1
1649785910682,MATH 20B,B01,084126,Um; Ko Woon,35,0,35,0
1649785916719,MATH 20C,A01,083446,Hammock; Frances H,29,0,30,1
1649785916719,MATH 20C,A02,083447,Hammock; Frances H,30,0,30,0
1649785916719,MATH 20C,A03,083448,Hammock; Frances H,30,0,30,0
1649785916719,MATH 20C,A04,083449,Hammock; Frances H,30,0,30,0
1649785916719,MATH 20C,B01,083451,Hammock; Frances H,30,0,30,0
1649785916719,MATH 20C,B02,083452,Hammock; Frances H,30,0,30,0
1649785916719,MATH 20C,B03,083453,Hammock; Frances H,30,0,30,0
1649785916719,MATH 20C,B04,083454,Hammock; Frances H,30,0,30,0
1649785922742,MATH 20D,A01,084128,Staff,30,0,30,0
1649785922742,MATH 20D,A02,084129,Staff,30,0,30,0
1649785922742,MATH 20D,A03,084130,Staff,29,0,30,1
1649785922742,MATH 20D,B01,084133,Staff,30,0,30,0
1649785922742,MATH 20D,B02,084134,Staff,30,0,30,0
1649785922742,MATH 20D,B03,084135,Staff,30,0,30,0
1649785928765,MATH 20E,A01,084138,Staff,30,0,30,0
1649785928765,MATH 20E,A02,084139,Staff,29,0,30,1
1649785928765,MATH 20E,A03,084140,Staff,30,0,30,0
1649785928765,MATH 20E,A04,084141,Staff,30,0,30,0
1649785934788,MATH 102,A01,084143,Harel; Guershon,27,0,30,3
1649785934788,MATH 102,A02,084144,Harel; Guershon,29,0,30,1
1649785940813,MATH 103B,A01,083456,Staff,20,0,30,10
1649785940813,MATH 103B,A02,083457,Staff,28,0,30,2
1649785946835,MATH 109,A01,084146,Salehi Golsefidy; Alireza,30,0,30,0
1649785946835,MATH 109,A02,084147,Salehi Golsefidy; Alireza,29,0,30,1
1649785952862,MATH 120A,A01,085445,Eggers; John Dietrich,32,0,35,3
1649785952862,MATH 120A,A02,085446,Eggers; John Dietrich,33,0,35,2
1649785958887,MATH 142B,A01,084149,Verstraete; Jacques Allan,26,0,30,4
1649785958887,MATH 142B,A02,084150,Verstraete; Jacques Allan,27,0,30,3
1649785964913,MATH 170A,A01,083459,Nie; Jiawang,21,0,30,9
1649785964913,MATH 170A,A02,083460,Nie; Jiawang,28,0,30,2
1649785964913,MATH 170A,A03,083461,Nie; Jiawang,30,0,30,0
1649785970944,MATH 193B,A01,083463,Staff,25,0,30,5
1649785970944,MATH 193B,A02,083464,Staff,29,0,30,1
1649785970944,MATH 193B,A03,083465,Staff,30,0,30,0
1649785977004,COGS 2,A01,083966,Boyle; Mary E. T.,28,0,30,2
1649785983031,COGS 9,A01,083968,Staff,59,0,60,1
1649785989057,COGS 14B,A01,083970,Staff,49,0,50,1
1649785995081,COGS 100,A01,083972,Staff,58,0,60,2
1649786007129,COGS 101C,A01,083976,Staff,29,0,30,1
1649786013155,COGS 102A,A01,083978,Johnson; Christine M.,29,0,30,1
1649786019178,COGS 107B,A01,083980,Staff,46,0,50,4
1649786025201,COGS 115,A01,083982,Staff,27,0,30,3
1649786031228,COGS 118B,A01,083367,Staff,21,0,40,19
1649786037252,COGS 172,A01,083984,Provenzano; Emily Kara,25,0,30,5
1649786043278,COGS 177,A00,083368,Staff,20,0,30,10
1649786049316,COGS 186,A01,083986,Staff,28,0,40,12
1649786055348,COGS 187A,A01,083988,Boyle; Mary E. T.,54,0,60,6
1649786061371,CSE 8A,A50,084003,Miranda; Gregory Joseph,12,0,15,3
1649786067401,CSE 11,A01,084005,Miranda; Gregory Joseph,52,0,55,3
1649786073424,CSE 20,A01,084007,Staff,17,0,20,3
1649786079451,CSE 21,A01,084009,Staff,47,0,50,3
1649786085484,CSE 30,A01,083370,Cao; Yingjun,36,0,40,4
1649786091507,CSE 100,A01,083372,Cao; Yingjun,36,0,40,4
1649786097535,CSE 101,A01,084011,Staff,23,0,40,17
1649786103560,CSE 141,A01,083374,Eldon; John,38,0,75,37
1649786109592,CSE 141L,A01,083376,Eldon; John,40,0,75,35
1649786115630,CSE 175,A01,084013,Kumar; Rakesh,25,0,25,0
1649786121653,CSE 190,A00,092508,Staff,15,0,15,0
1649786127679,ECE 5,A01,084049,Morris; Karcher William,18,0,20,2
1649786133702,ECE 100,A01,084051,Baghdadchi; Saharnaz,18,0,20,2
1649786133702,ECE 100,A02,091916,Baghdadchi; Saharnaz,19,0,20,1
1649786139728,ECE 101,A01,084053,Baghdadchi; Saharnaz,33,0,37,4
1649786139728,ECE 101,A02,084054,Baghdadchi; Saharnaz,37,0,37,0
1649786145756,ECE 107,A01,083390,Staff,35,0,40,5
1649786151785,ECE 148,A01,084056,Silberman; Jack,8,0,12,4
1649786157808,ECE 180,A00,083391,Abi Samra; Nicholas Camill,27,0,30,3
1649786157808,ECE 180,B00,083392,Abi Samra; Nicholas Camill,27,0,30,3
1649786163835,MATH 10B,A01,084110,Staff,26,0,30,4
1649786163835,MATH 10B,A02,084111,Staff,30,0,30,0
1649786163835,MATH 10B,A03,084112,Staff,30,0,30,0
1649786169859,MATH 10C,A01,083443,Staff,26,0,30,4
1649786169859,MATH 10C,A02,083444,Staff,26,0,30,4
1649786169859,MATH 10C,B01,084114,Staff,28,0,30,2
1649786169859,MATH 10C,B02,084115,Staff,30,0,30,0
1649786175901,MATH 18,A01,084117,Harel; Guershon,28,0,30,2
1649786175901,MATH 18,A02,084119,Harel; Guershon,29,0,30,1
1649786175901,MATH 18,A03,084120,Harel; Guershon,30,0,30,0
1649786175901,MATH 18,A04,084121,Harel; Guershon,30,0,30,0
1649786181930,MATH 20B,A01,084124,Um; Ko Woon,34,0,35,1
1649786181930,MATH 20B,B01,084126,Um; Ko Woon,35,0,35,0
1649786187955,MATH 20C,A01,083446,Hammock; Frances H,29,0,30,1
1649786187955,MATH 20C,A02,083447,Hammock; Frances H,30,0,30,0
1649786187955,MATH 20C,A03,083448,Hammock; Frances H,30,0,30,0
1649786187955,MATH 20C,A04,083449,Hammock; Frances H,30,0,30,0
1649786187955,MATH 20C,B01,083451,Hammock; Frances H,30,0,30,0
1649786187955,MATH 20C,B02,083452,Hammock; Frances H,30,0,30,0
1649786187955,MATH 20C,B03,083453,Hammock; Frances H,30,0,30,0
1649786187955,MATH 20C,B04,083454,Hammock; Frances H,30,0,30,0
1649786193989,MATH 20D,A01,084128,Staff,30,0,30,0
1649786193989,MATH 20D,A02,084129,Staff,30,0,30,0
1649786193989,MATH 20D,A03,084130,Staff,29,0,30,1
1649786193989,MATH 20D,B01,084133,Staff,30,0,30,0
1649786193989,MATH 20D,B02,084134,Staff,30,0,30,0
1649786193989,MATH 20D,B03,084135,Staff,30,0,30,0
1649786200013,MATH 20E,A01,084138,Staff,30,0,30,0
1649786200013,MATH 20E,A02,084139,Staff,29,0,30,1
1649786200013,MATH 20E,A03,084140,Staff,30,0,30,0
1649786200013,MATH 20E,A04,084141,Staff,30,0,30,0
1649786206043,MATH 102,A01,084143,Harel; Guershon,27,0,30,3
1649786206043,MATH 102,A02,084144,Harel; Guershon,29,0,30,1
1649786212076,MATH 103B,A01,083456,Staff,20,0,30,10
1649786212076,MATH 103B,A02,083457,Staff,28,0,30,2
1649786218118,MATH 109,A01,084146,Salehi Golsefidy; Alireza,30,0,30,0
1649786218118,MATH 109,A02,084147,Salehi Golsefidy; Alireza,29,0,30,1
1649786224150,MATH 120A,A01,085445,Eggers; John Dietrich,32,0,35,3
1649786224150,MATH 120A,A02,085446,Eggers; John Dietrich,33,0,35,2
1649786230178,MATH 142B,A01,084149,Verstraete; Jacques Allan,26,0,30,4
1649786230178,MATH 142B,A02,084150,Verstraete; Jacques Allan,27,0,30,3
1649786236202,MATH 170A,A01,083459,Nie; Jiawang,21,0,30,9
1649786236202,MATH 170A,A02,083460,Nie; Jiawang,28,0,30,2
1649786236202,MATH 170A,A03,083461,Nie; Jiawang,30,0,30,0
1649786242228,MATH 193B,A01,083463,Staff,25,0,30,5
1649786242228,MATH 193B,A02,083464,Staff,29,0,30,1
1649786242228,MATH 193B,A03,083465,Staff,30,0,30,0
1649786248296,COGS 2,A01,083966,Boyle; Mary E. T.,28,0,30,2
1649786254322,COGS 9,A01,083968,Staff,59,0,60,1
1649786260354,COGS 14B,A01,083970,Staff,49,0,50,1
1649786266377,COGS 100,A01,083972,Staff,58,0,60,2
1649786278434,COGS 101C,A01,083976,Staff,29,0,30,1
1649786284472,COGS 102A,A01,083978,Johnson; Christine M.,29,0,30,1
1649786290496,COGS 107B,A01,083980,Staff,46,0,50,4
1649786296528,COGS 115,A01,083982,Staff,27,0,30,3
1649786302551,COGS 118B,A01,083367,Staff,21,0,40,19
1649786308590,COGS 172,A01,083984,Provenzano; Emily Kara,25,0,30,5
1649786314614,COGS 177,A00,083368,Staff,20,0,30,10
1649786320650,COGS 186,A01,083986,Staff,28,0,40,12
1649786326686,COGS 187A,A01,083988,Boyle; Mary E. T.,54,0,60,6
1649786332717,CSE 8A,A50,084003,Miranda; Gregory Joseph,12,0,15,3
1649786338739,CSE 11,A01,084005,Miranda; Gregory Joseph,52,0,55,3
1649786344761,CSE 20,A01,084007,Staff,17,0,20,3
1649786350790,CSE 21,A01,084009,Staff,47,0,50,3
1649786356822,CSE 30,A01,083370,Cao; Yingjun,36,0,40,4
1649786362861,CSE 100,A01,083372,Cao; Yingjun,36,0,40,4
1649786368884,CSE 101,A01,084011,Staff,23,0,40,17
1649786374908,CSE 141,A01,083374,Eldon; John,37,0,75,38
1649786380933,CSE 141L,A01,083376,Eldon; John,39,0,75,36
1649786386957,CSE 175,A01,084013,Kumar; Rakesh,25,0,25,0
1649786392983,CSE 190,A00,092508,Staff,15,0,15,0
1649786399008,ECE 5,A01,084049,Morris; Karcher William,18,0,20,2
1649786405036,ECE 100,A01,084051,Baghdadchi; Saharnaz,18,0,20,2
1649786405036,ECE 100,A02,091916,Baghdadchi; Saharnaz,19,0,20,1
1649786411066,ECE 101,A01,084053,Baghdadchi; Saharnaz,33,0,37,4
1649786411066,ECE 101,A02,084054,Baghdadchi; Saharnaz,37,0,37,0
1649786417101,ECE 107,A01,083390,Staff,35,0,40,5
1649786423131,ECE 148,A01,084056,Silberman; Jack,8,0,12,4
1649786429266,ECE 180,A00,083391,Abi Samra; Nicholas Camill,27,0,30,3
1649786429266,ECE 180,B00,083392,Abi Samra; Nicholas Camill,26,0,30,4
1649786435299,MATH 10B,A01,084110,Staff,26,0,30,4
1649786435299,MATH 10B,A02,084111,Staff,30,0,30,0
1649786435299,MATH 10B,A03,084112,Staff,30,0,30,0
1649786441333,MATH 10C,A01,083443,Staff,26,0,30,4
1649786441333,MATH 10C,A02,083444,Staff,26,0,30,4
1649786441333,MATH 10C,B01,084114,Staff,28,0,30,2
1649786441333,MATH 10C,B02,084115,Staff,30,0,30,0
1649786447365,MATH 18,A01,084117,Harel; Guershon,28,0,30,2
1649786447365,MATH 18,A02,084119,Harel; Guershon,29,0,30,1
1649786447365,MATH 18,A03,084120,Harel; Guershon,30,0,30,0
1649786447365,MATH 18,A04,084121,Harel; Guershon,30,0,30,0
1649786453395,MATH 20B,A01,084124,Um; Ko Woon,34,0,35,1
1649786453395,MATH 20B,B01,084126,Um; Ko Woon,35,0,35,0
1649786459418,MATH 20C,A01,083446,Hammock; Frances H,29,0,30,1
1649786459418,MATH 20C,A02,083447,Hammock; Frances H,30,0,30,0
1649786459418,MATH 20C,A03,083448,Hammock; Frances H,30,0,30,0
1649786459418,MATH 20C,A04,083449,Hammock; Frances H,30,0,30,0
1649786459418,MATH 20C,B01,083451,Hammock; Frances H,30,0,30,0
1649786459418,MATH 20C,B02,083452,Hammock; Frances H,30,0,30,0
1649786459418,MATH 20C,B03,083453,Hammock; Frances H,30,0,30,0
1649786459418,MATH 20C,B04,083454,Hammock; Frances H,30,0,30,0
1649786465461,MATH 20D,A01,084128,Staff,30,0,30,0
1649786465461,MATH 20D,A02,084129,Staff,30,0,30,0
1649786465461,MATH 20D,A03,084130,Staff,29,0,30,1
1649786465461,MATH 20D,B01,084133,Staff,30,0,30,0
1649786465461,MATH 20D,B02,084134,Staff,30,0,30,0
1649786465461,MATH 20D,B03,084135,Staff,30,0,30,0
1649786471496,MATH 20E,A01,084138,Staff,30,0,30,0
1649786471496,MATH 20E,A02,084139,Staff,29,0,30,1
1649786471496,MATH 20E,A03,084140,Staff,30,0,30,0
1649786471496,MATH 20E,A04,084141,Staff,30,0,30,0
1649786477522,MATH 102,A01,084143,Harel; Guershon,27,0,30,3
1649786477522,MATH 102,A02,084144,Harel; Guershon,29,0,30,1
1649786483553,MATH 103B,A01,083456,Staff,20,0,30,10
1649786483553,MATH 103B,A02,083457,Staff,28,0,30,2
1649786489580,MATH 109,A01,084146,Salehi Golsefidy; Alireza,30,0,30,0
1649786489580,MATH 109,A02,084147,Salehi Golsefidy; Alireza,29,0,30,1
1649786495606,MATH 120A,A01,085445,Eggers; John Dietrich,32,0,35,3
1649786495606,MATH 120A,A02,085446,Eggers; John Dietrich,33,0,35,2
1649786501640,MATH 142B,A01,084149,Verstraete; Jacques Allan,26,0,30,4
1649786501640,MATH 142B,A02,084150,Verstraete; Jacques Allan,27,0,30,3
1649786507675,MATH 170A,A01,083459,Nie; Jiawang,21,0,30,9
1649786507675,MATH 170A,A02,083460,Nie; Jiawang,28,0,30,2
1649786507675,MATH 170A,A03,083461,Nie; Jiawang,30,0,30,0
1649786513709,MATH 193B,A01,083463,Staff,25,0,30,5
1649786513709,MATH 193B,A02,083464,Staff,29,0,30,1
1649786513709,MATH 193B,A03,083465,Staff,30,0,30,0
1649786519772,COGS 2,A01,083966,Boyle; Mary E. T.,28,0,30,2
1649786525804,COGS 9,A01,083968,Staff,59,0,60,1
1649786531829,COGS 14B,A01,083970,Staff,49,0,50,1
1649786537857,COGS 100,A01,083972,Staff,58,0,60,2
1649786549914,COGS 101C,A01,083976,Staff,29,0,30,1
1649786555943,COGS 102A,A01,083978,Johnson; Christine M.,29,0,30,1
1649786561969,COGS 107B,A01,083980,Staff,46,0,50,4
1649786567996,COGS 115,A01,083982,Staff,27,0,30,3
1649786574021,COGS 118B,A01,083367,Staff,21,0,40,19
1649786580044,COGS 172,A01,083984,Provenzano; Emily Kara,25,0,30,5
1649786586067,COGS 177,A00,083368,Staff,20,0,30,10
1649786592093,COGS 186,A01,083986,Staff,28,0,40,12
1649786598119,COGS 187A,A01,083988,Boyle; Mary E. T.,54,0,60,6
1649786604158,CSE 8A,A50,084003,Miranda; Gregory Joseph,12,0,15,3
1649786610200,CSE 11,A01,084005,Miranda; Gregory Joseph,52,0,55,3
1649786616227,CSE 20,A01,084007,Staff,17,0,20,3
1649786622253,CSE 21,A01,084009,Staff,47,0,50,3
1649786628286,CSE 30,A01,083370,Cao; Yingjun,36,0,40,4
1649786634310,CSE 100,A01,083372,Cao; Yingjun,36,0,40,4
1649786640334,CSE 101,A01,084011,Staff,23,0,40,17
1649786646362,CSE 141,A01,083374,Eldon; John,36,0,75,39
1649786652385,CSE 141L,A01,083376,Eldon; John,38,0,75,37
1649786658420,CSE 175,A01,084013,Kumar; Rakesh,25,0,25,0
1649786664442,CSE 190,A00,092508,Staff,15,0,15,0
1649786670468,ECE 5,A01,084049,Morris; Karcher William,18,0,20,2
1649786676493,ECE 100,A01,084051,Baghdadchi; Saharnaz,18,0,20,2
1649786676493,ECE 100,A02,091916,Baghdadchi; Saharnaz,19,0,20,1
1649786682517,ECE 101,A01,084053,Baghdadchi; Saharnaz,33,0,37,4
1649786682517,ECE 101,A02,084054,Baghdadchi; Saharnaz,37,0,37,0
1649786688544,ECE 107,A01,083390,Staff,35,0,40,5
1649786694571,ECE 148,A01,084056,Silberman; Jack,8,0,12,4
1649786700601,ECE 180,A00,083391,Abi Samra; Nicholas Camill,27,0,30,3
1649786700601,ECE 180,B00,083392,Abi Samra; Nicholas Camill,26,0,30,4
1649786706629,MATH 10B,A01,084110,Staff,26,0,30,4
1649786706629,MATH 10B,A02,084111,Staff,30,0,30,0
1649786706629,MATH 10B,A03,084112,Staff,30,0,30,0
1649786712653,MATH 10C,A01,083443,Staff,26,0,30,4
1649786712653,MATH 10C,A02,083444,Staff,26,0,30,4
1649786712653,MATH 10C,B01,084114,Staff,28,0,30,2
1649786712653,MATH 10C,B02,084115,Staff,30,0,30,0
1649786718689,MATH 18,A01,084117,Harel; Guershon,28,0,30,2
1649786718689,MATH 18,A02,084119,Harel; Guershon,29,0,30,1
1649786718689,MATH 18,A03,084120,Harel; Guershon,30,0,30,0
1649786718689,MATH 18,A04,084121,Harel; Guershon,30,0,30,0
1649786724713,MATH 20B,A01,084124,Um; Ko Woon,34,0,35,1
1649786724713,MATH 20B,B01,084126,Um; Ko Woon,35,0,35,0
1649786730750,MATH 20C,A01,083446,Hammock; Frances H,29,0,30,1
1649786730750,MATH 20C,A02,083447,Hammock; Frances H,30,0,30,0
1649786730750,MATH 20C,A03,083448,Hammock; Frances H,30,0,30,0
1649786730750,MATH 20C,A04,083449,Hammock; Frances H,30,0,30,0
1649786730750,MATH 20C,B01,083451,Hammock; Frances H,30,0,30,0
1649786730750,MATH 20C,B02,083452,Hammock; Frances H,30,0,30,0
1649786730750,MATH 20C,B03,083453,Hammock; Frances H,30,0,30,0
1649786730750,MATH 20C,B04,083454,Hammock; Frances H,30,0,30,0
1649786736775,MATH 20D,A01,084128,Staff,30,0,30,0
1649786736775,MATH 20D,A02,084129,Staff,30,0,30,0
1649786736775,MATH 20D,A03,084130,Staff,29,0,30,1
1649786736775,MATH 20D,B01,084133,Staff,30,0,30,0
1649786736775,MATH 20D,B02,084134,Staff,30,0,30,0
1649786736775,MATH 20D,B03,084135,Staff,30,0,30,0
1649786742805,MATH 20E,A01,084138,Staff,30,0,30,0
1649786742805,MATH 20E,A02,084139,Staff,29,0,30,1
1649786742805,MATH 20E,A03,084140,Staff,30,0,30,0
1649786742805,MATH 20E,A04,084141,Staff,30,0,30,0
1649786748833,MATH 102,A01,084143,Harel; Guershon,27,0,30,3
1649786748833,MATH 102,A02,084144,Harel; Guershon,29,0,30,1
1649786754856,MATH 103B,A01,083456,Staff,19,0,30,11
1649786754856,MATH 103B,A02,083457,Staff,28,0,30,2
1649786760888,MATH 109,A01,084146,Salehi Golsefidy; Alireza,30,0,30,0
1649786760888,MATH 109,A02,084147,Salehi Golsefidy; Alireza,29,0,30,1
1649786766914,MATH 120A,A01,085445,Eggers; John Dietrich,32,0,35,3
1649786766914,MATH 120A,A02,085446,Eggers; John Dietrich,33,0,35,2
1649786772938,MATH 142B,A01,084149,Verstraete; Jacques Allan,26,0,30,4
1649786772938,MATH 142B,A02,084150,Verstraete; Jacques Allan,27,0,30,3
1649786778965,MATH 170A,A01,083459,Nie; Jiawang,21,0,30,9
1649786778965,MATH 170A,A02,083460,Nie; Jiawang,28,0,30,2
1649786778965,MATH 170A,A03,083461,Nie; Jiawang,30,0,30,0
1649786784998,MATH 193B,A01,083463,Staff,25,0,30,5
1649786784998,MATH 193B,A02,083464,Staff,29,0,30,1
1649786784998,MATH 193B,A03,083465,Staff,30,0,30,0
1649786791059,COGS 2,A01,083966,Boyle; Mary E. T.,28,0,30,2
1649786797085,COGS 9,A01,083968,Staff,59,0,60,1
1649786803107,COGS 14B,A01,083970,Staff,49,0,50,1
1649786809137,COGS 100,A01,083972,Staff,58,0,60,2
1649786821206,COGS 101C,A01,083976,Staff,29,0,30,1
1649786827231,COGS 102A,A01,083978,Johnson; Christine M.,29,0,30,1
1649786833259,COGS 107B,A01,083980,Staff,46,0,50,4
1649786839282,COGS 115,A01,083982,Staff,27,0,30,3
1649786845308,COGS 118B,A01,083367,Staff,21,0,40,19
1649786851341,COGS 172,A01,083984,Provenzano; Emily Kara,25,0,30,5
1649786857363,COGS 177,A00,083368,Staff,19,0,30,11
1649786863399,COGS 186,A01,083986,Staff,28,0,40,12
1649786869422,COGS 187A,A01,083988,Boyle; Mary E. T.,54,0,60,6
1649786875445,CSE 8A,A50,084003,Miranda; Gregory Joseph,12,0,15,3
1649786881475,CSE 11,A01,084005,Miranda; Gregory Joseph,52,0,55,3
1649786887510,CSE 20,A01,084007,Staff,17,0,20,3
1649786893534,CSE 21,A01,084009,Staff,47,0,50,3
1649786899558,CSE 30,A01,083370,Cao; Yingjun,35,0,40,5
1649786905586,CSE 100,A01,083372,Cao; Yingjun,36,0,40,4
1649786911610,CSE 101,A01,084011,Staff,23,0,40,17
1649786917636,CSE 141,A01,083374,Eldon; John,36,0,75,39
1649786923665,CSE 141L,A01,083376,Eldon; John,38,0,75,37
1649786929691,CSE 175,A01,084013,Kumar; Rakesh,25,0,25,0
1649786935718,CSE 190,A00,092508,Staff,15,0,15,0
1649786941747,ECE 5,A01,084049,Morris; Karcher William,18,0,20,2
1649786947770,ECE 100,A01,084051,Baghdadchi; Saharnaz,18,0,20,2
1649786947770,ECE 100,A02,091916,Baghdadchi; Saharnaz,19,0,20,1
1649786953804,ECE 101,A01,084053,Baghdadchi; Saharnaz,33,0,37,4
1649786953804,ECE 101,A02,084054,Baghdadchi; Saharnaz,37,0,37,0
1649786959830,ECE 107,A01,083390,Staff,35,0,40,5
1649786965861,ECE 148,A01,084056,Silberman; Jack,8,0,12,4
1649786971896,ECE 180,A00,083391,Abi Samra; Nicholas Camill,27,0,30,3
1649786971896,ECE 180,B00,083392,Abi Samra; Nicholas Camill,26,0,30,4
1649786977926,MATH 10B,A01,084110,Staff,26,0,30,4
1649786977926,MATH 10B,A02,084111,Staff,30,0,30,0
1649786977926,MATH 10B,A03,084112,Staff,30,0,30,0
1649786983949,MATH 10C,A01,083443,Staff,26,0,30,4
1649786983949,MATH 10C,A02,083444,Staff,26,0,30,4
1649786983949,MATH 10C,B01,084114,Staff,28,0,30,2
1649786983949,MATH 10C,B02,084115,Staff,30,0,30,0
1649786989976,MATH 18,A01,084117,Harel; Guershon,28,0,30,2
1649786989976,MATH 18,A02,084119,Harel; Guershon,29,0,30,1
1649786989976,MATH 18,A03,084120,Harel; Guershon,30,0,30,0
1649786989976,MATH 18,A04,084121,Harel; Guershon,30,0,30,0
1649786996000,MATH 20B,A01,084124,Um; Ko Woon,34,0,35,1
1649786996000,MATH 20B,B01,084126,Um; Ko Woon,35,0,35,0
1649787002036,MATH 20C,A01,083446,Hammock; Frances H,29,0,30,1
1649787002036,MATH 20C,A02,083447,Hammock; Frances H,30,0,30,0
1649787002036,MATH 20C,A03,083448,Hammock; Frances H,30,0,30,0
1649787002036,MATH 20C,A04,083449,Hammock; Frances H,30,0,30,0
1649787002036,MATH 20C,B01,083451,Hammock; Frances H,30,0,30,0
1649787002036,MATH 20C,B02,083452,Hammock; Frances H,30,0,30,0
1649787002036,MATH 20C,B03,083453,Hammock; Frances H,30,0,30,0
1649787002036,MATH 20C,B04,083454,Hammock; Frances H,30,0,30,0
1649787008061,MATH 20D,A01,084128,Staff,30,0,30,0
1649787008061,MATH 20D,A02,084129,Staff,30,0,30,0
1649787008061,MATH 20D,A03,084130,Staff,29,0,30,1
1649787008061,MATH 20D,B01,084133,Staff,30,0,30,0
1649787008061,MATH 20D,B02,084134,Staff,30,0,30,0
1649787008061,MATH 20D,B03,084135,Staff,30,0,30,0
1649787014086,MATH 20E,A01,084138,Staff,30,0,30,0
1649787014086,MATH 20E,A02,084139,Staff,29,0,30,1
1649787014086,MATH 20E,A03,084140,Staff,30,0,30,0
1649787014086,MATH 20E,A04,084141,Staff,30,0,30,0
1649787020113,MATH 102,A01,084143,Harel; Guershon,27,0,30,3
1649787020113,MATH 102,A02,084144,Harel; Guershon,29,0,30,1
1649787026228,MATH 103B,A01,083456,Staff,19,0,30,11
1649787026228,MATH 103B,A02,083457,Staff,28,0,30,2
1649787032254,MATH 109,A01,084146,Salehi Golsefidy; Alireza,30,0,30,0
1649787032254,MATH 109,A02,084147,Salehi Golsefidy; Alireza,29,0,30,1
1649787038277,MATH 120A,A01,085445,Eggers; John Dietrich,32,0,35,3
1649787038277,MATH 120A,A02,085446,Eggers; John Dietrich,33,0,35,2
1649787044300,MATH 142B,A01,084149,Verstraete; Jacques Allan,26,0,30,4
1649787044300,MATH 142B,A02,084150,Verstraete; Jacques Allan,27,0,30,3
1649787050337,MATH 170A,A01,083459,Nie; Jiawang,21,0,30,9
1649787050337,MATH 170A,A02,083460,Nie; Jiawang,28,0,30,2
1649787050337,MATH 170A,A03,083461,Nie; Jiawang,30,0,30,0
1649787056360,MATH 193B,A01,083463,Staff,25,0,30,5
1649787056360,MATH 193B,A02,083464,Staff,29,0,30,1
1649787056360,MATH 193B,A03,083465,Staff,30,0,30,0
1649787062412,COGS 2,A01,083966,Boyle; Mary E. T.,28,0,30,2
1649787068437,COGS 9,A01,083968,Staff,59,0,60,1
1649787074463,COGS 14B,A01,083970,Staff,49,0,50,1
1649787080486,COGS 100,A01,083972,Staff,58,0,60,2
1649787092538,COGS 101C,A01,083976,Staff,29,0,30,1
1649787098577,COGS 102A,A01,083978,Johnson; Christine M.,29,0,30,1
1649787104608,COGS 107B,A01,083980,Staff,46,0,50,4
1649787110644,COGS 115,A01,083982,Staff,27,0,30,3
1649787116672,COGS 118B,A01,083367,Staff,21,0,40,19
1649787122706,COGS 172,A01,083984,Provenzano; Emily Kara,25,0,30,5
1649787128745,COGS 177,A00,083368,Staff,19,0,30,11
1649787134781,COGS 186,A01,083986,Staff,28,0,40,12
1649787140815,COGS 187A,A01,083988,Boyle; Mary E. T.,54,0,60,6
1649787146848,CSE 8A,A50,084003,Miranda; Gregory Joseph,12,0,15,3
1649787152879,CSE 11,A01,084005,Miranda; Gregory Joseph,52,0,55,3
1649787158907,CSE 20,A01,084007,Staff,17,0,20,3
1649787164929,CSE 21,A01,084009,Staff,47,0,50,3
1649787170960,CSE 30,A01,083370,Cao; Yingjun,35,0,40,5
1649787177002,CSE 100,A01,083372,Cao; Yingjun,36,0,40,4
1649787183026,CSE 101,A01,084011,Staff,23,0,40,17
1649787189049,CSE 141,A01,083374,Eldon; John,36,0,75,39
1649787195096,CSE 141L,A01,083376,Eldon; John,38,0,75,37
1649787201123,CSE 175,A01,084013,Kumar; Rakesh,25,0,25,0
1649787207152,CSE 190,A00,092508,Staff,15,0,15,0
1649787213191,ECE 5,A01,084049,Morris; Karcher William,18,0,20,2
1649787219217,ECE 100,A01,084051,Baghdadchi; Saharnaz,18,0,20,2
1649787219217,ECE 100,A02,091916,Baghdadchi; Saharnaz,19,0,20,1
1649787225250,ECE 101,A01,084053,Baghdadchi; Saharnaz,33,0,37,4
1649787225250,ECE 101,A02,084054,Baghdadchi; Saharnaz,37,0,37,0
1649787231293,ECE 107,A01,083390,Staff,35,0,40,5
1649787237326,ECE 148,A01,084056,Silberman; Jack,8,0,12,4
1649787243350,ECE 180,A00,083391,Abi Samra; Nicholas Camill,27,0,30,3
1649787243350,ECE 180,B00,083392,Abi Samra; Nicholas Camill,26,0,30,4
1649787249386,MATH 10B,A01,084110,Staff,25,0,30,5
1649787249386,MATH 10B,A02,084111,Staff,30,0,30,0
1649787249386,MATH 10B,A03,084112,Staff,30,0,30,0
1649787255422,MATH 10C,A01,083443,Staff,26,0,30,4
1649787255422,MATH 10C,A02,083444,Staff,26,0,30,4
1649787255422,MATH 10C,B01,084114,Staff,28,0,30,2
1649787255422,MATH 10C,B02,084115,Staff,30,0,30,0
1649787261452,MATH 18,A01,084117,Harel; Guershon,28,0,30,2
1649787261452,MATH 18,A02,084119,Harel; Guershon,29,0,30,1
1649787261452,MATH 18,A03,084120,Harel; Guershon,30,0,30,0
1649787261452,MATH 18,A04,084121,Harel; Guershon,30,0,30,0
1649787267487,MATH 20B,A01,084124,Um; Ko Woon,34,0,35,1
1649787267487,MATH 20B,B01,084126,Um; Ko Woon,35,0,35,0
1649787273517,MATH 20C,A01,083446,Hammock; Frances H,29,0,30,1
1649787273517,MATH 20C,A02,083447,Hammock; Frances H,30,0,30,0
1649787273517,MATH 20C,A03,083448,Hammock; Frances H,30,0,30,0
1649787273517,MATH 20C,A04,083449,Hammock; Frances H,30,0,30,0
1649787273517,MATH 20C,B01,083451,Hammock; Frances H,30,0,30,0
1649787273517,MATH 20C,B02,083452,Hammock; Frances H,30,0,30,0
1649787273517,MATH 20C,B03,083453,Hammock; Frances H,30,0,30,0
1649787273517,MATH 20C,B04,083454,Hammock; Frances H,30,0,30,0
1649787279548,MATH 20D,A01,084128,Staff,30,0,30,0
1649787279548,MATH 20D,A02,084129,Staff,30,0,30,0
1649787279548,MATH 20D,A03,084130,Staff,29,0,30,1
1649787279548,MATH 20D,B01,084133,Staff,30,0,30,0
1649787279548,MATH 20D,B02,084134,Staff,30,0,30,0
1649787279548,MATH 20D,B03,084135,Staff,30,0,30,0
1649787285579,MATH 20E,A01,084138,Staff,30,0,30,0
1649787285579,MATH 20E,A02,084139,Staff,29,0,30,1
1649787285579,MATH 20E,A03,084140,Staff,30,0,30,0
1649787285579,MATH 20E,A04,084141,Staff,30,0,30,0
1649787291604,MATH 102,A01,084143,Harel; Guershon,27,0,30,3
1649787291604,MATH 102,A02,084144,Harel; Guershon,29,0,30,1
1649787297627,MATH 103B,A01,083456,Staff,19,0,30,11
1649787297627,MATH 103B,A02,083457,Staff,28,0,30,2
1649787303665,MATH 109,A01,084146,Salehi Golsefidy; Alireza,30,0,30,0
1649787303665,MATH 109,A02,084147,Salehi Golsefidy; Alireza,29,0,30,1
1649787309694,MATH 120A,A01,085445,Eggers; John Dietrich,32,0,35,3
1649787309694,MATH 120A,A02,085446,Eggers; John Dietrich,33,0,35,2
1649787315717,MATH 142B,A01,084149,Verstraete; Jacques Allan,26,0,30,4
1649787315717,MATH 142B,A02,084150,Verstraete; Jacques Allan,27,0,30,3
1649787321741,MATH 170A,A01,083459,Nie; Jiawang,21,0,30,9
1649787321741,MATH 170A,A02,083460,Nie; Jiawang,28,0,30,2
1649787321741,MATH 170A,A03,083461,Nie; Jiawang,30,0,30,0
1649787327769,MATH 193B,A01,083463,Staff,25,0,30,5
1649787327769,MATH 193B,A02,083464,Staff,29,0,30,1
1649787327769,MATH 193B,A03,083465,Staff,30,0,30,0
1649787333838,COGS 2,A01,083966,Boyle; Mary E. T.,28,0,30,2
1649787339863,COGS 9,A01,083968,Staff,59,0,60,1
1649787345887,COGS 14B,A01,083970,Staff,49,0,50,1
1649787351920,COGS 100,A01,083972,Staff,58,0,60,2
1649787363978,COGS 101C,A01,083976,Staff,29,0,30,1
1649787370010,COGS 102A,A01,083978,Johnson; Christine M.,29,0,30,1
1649787376034,COGS 107B,A01,083980,Staff,46,0,50,4
1649787382060,COGS 115,A01,083982,Staff,27,0,30,3
1649787388084,COGS 118B,A01,083367,Staff,21,0,40,19
1649787394113,COGS 172,A01,083984,Provenzano; Emily Kara,25,0,30,5
1649787400137,COGS 177,A00,083368,Staff,19,0,30,11
1649787406163,COGS 186,A01,083986,Staff,28,0,40,12
1649787412197,COGS 187A,A01,083988,Boyle; Mary E. T.,54,0,60,6
1649787418226,CSE 8A,A50,084003,Miranda; Gregory Joseph,12,0,15,3
1649787424255,CSE 11,A01,084005,Miranda; Gregory Joseph,52,0,55,3
1649787430288,CSE 20,A01,084007,Staff,17,0,20,3
1649787436321,CSE 21,A01,084009,Staff,47,0,50,3
1649787442344,CSE 30,A01,083370,Cao; Yingjun,35,0,40,5
1649787448375,CSE 100,A01,083372,Cao; Yingjun,36,0,40,4
1649787454412,CSE 101,A01,084011,Staff,23,0,40,17
1649787460449,CSE 141,A01,083374,Eldon; John,36,0,75,39
1649787466472,CSE 141L,A01,083376,Eldon; John,38,0,75,37
1649787472495,CSE 175,A01,084013,Kumar; Rakesh,25,0,25,0
1649787478517,CSE 190,A00,092508,Staff,15,0,15,0
1649787484540,ECE 5,A01,084049,Morris; Karcher William,18,0,20,2
1649787490585,ECE 100,A01,084051,Baghdadchi; Saharnaz,18,0,20,2
1649787490585,ECE 100,A02,091916,Baghdadchi; Saharnaz,19,0,20,1
1649787496610,ECE 101,A01,084053,Baghdadchi; Saharnaz,33,0,37,4
1649787496610,ECE 101,A02,084054,Baghdadchi; Saharnaz,37,0,37,0
1649787502639,ECE 107,A01,083390,Staff,35,0,40,5
1649787508671,ECE 148,A01,084056,Silberman; Jack,8,0,12,4
1649787514701,ECE 180,A00,083391,Abi Samra; Nicholas Camill,27,0,30,3
1649787514701,ECE 180,B00,083392,Abi Samra; Nicholas Camill,26,0,30,4
1649787520727,MATH 10B,A01,084110,Staff,25,0,30,5
1649787520727,MATH 10B,A02,084111,Staff,30,0,30,0
1649787520727,MATH 10B,A03,084112,Staff,30,0,30,0
1649787526756,MATH 10C,A01,083443,Staff,26,0,30,4
1649787526756,MATH 10C,A02,083444,Staff,26,0,30,4
1649787526756,MATH 10C,B01,084114,Staff,28,0,30,2
1649787526756,MATH 10C,B02,084115,Staff,30,0,30,0
1649787532778,MATH 18,A01,084117,Harel; Guershon,28,0,30,2
1649787532778,MATH 18,A02,084119,Harel; Guershon,29,0,30,1
1649787532778,MATH 18,A03,084120,Harel; Guershon,30,0,30,0
1649787532778,MATH 18,A04,084121,Harel; Guershon,30,0,30,0
1649787538811,MATH 20B,A01,084124,Um; Ko Woon,34,0,35,1
1649787538811,MATH 20B,B01,084126,Um; Ko Woon,35,0,35,0
1649787544835,MATH 20C,A01,083446,Hammock; Frances H,29,0,30,1
1649787544835,MATH 20C,A02,083447,Hammock; Frances H,30,0,30,0
1649787544835,MATH 20C,A03,083448,Hammock; Frances H,30,0,30,0
1649787544835,MATH 20C,A04,083449,Hammock; Frances H,30,0,30,0
1649787544835,MATH 20C,B01,083451,Hammock; Frances H,30,0,30,0
1649787544835,MATH 20C,B02,083452,Hammock; Frances H,30,0,30,0
1649787544835,MATH 20C,B03,083453,Hammock; Frances H,30,0,30,0
1649787544835,MATH 20C,B04,083454,Hammock; Frances H,30,0,30,0
1649787550857,MATH 20D,A01,084128,Staff,30,0,30,0
1649787550857,MATH 20D,A02,084129,Staff,30,0,30,0
1649787550857,MATH 20D,A03,084130,Staff,29,0,30,1
1649787550857,MATH 20D,B01,084133,Staff,30,0,30,0
1649787550857,MATH 20D,B02,084134,Staff,30,0,30,0
1649787550857,MATH 20D,B03,084135,Staff,30,0,30,0
1649787556883,MATH 20E,A01,084138,Staff,30,0,30,0
1649787556883,MATH 20E,A02,084139,Staff,29,0,30,1
1649787556883,MATH 20E,A03,084140,Staff,30,0,30,0
1649787556883,MATH 20E,A04,084141,Staff,30,0,30,0
1649787562911,MATH 102,A01,084143,Harel; Guershon,27,0,30,3
1649787562911,MATH 102,A02,084144,Harel; Guershon,29,0,30,1
1649787568936,MATH 103B,A01,083456,Staff,19,0,30,11
1649787568936,MATH 103B,A02,083457,Staff,28,0,30,2
1649787574965,MATH 109,A01,084146,Salehi Golsefidy; Alireza,30,0,30,0
1649787574965,MATH 109,A02,084147,Salehi Golsefidy; Alireza,29,0,30,1
1649787581008,MATH 120A,A01,085445,Eggers; John Dietrich,32,0,35,3
1649787581008,MATH 120A,A02,085446,Eggers; John Dietrich,33,0,35,2
1649787587032,MATH 142B,A01,084149,Verstraete; Jacques Allan,26,0,30,4
1649787587032,MATH 142B,A02,084150,Verstraete; Jacques Allan,27,0,30,3
1649787593074,MATH 170A,A01,083459,Nie; Jiawang,21,0,30,9
1649787593074,MATH 170A,A02,083460,Nie; Jiawang,28,0,30,2
1649787593074,MATH 170A,A03,083461,Nie; Jiawang,30,0,30,0
1649787599097,MATH 193B,A01,083463,Staff,25,0,30,5
1649787599097,MATH 193B,A02,083464,Staff,29,0,30,1
1649787599097,MATH 193B,A03,083465,Staff,30,0,30,0
1649787605163,COGS 2,A01,083966,Boyle; Mary E. T.,28,0,30,2
1649787611188,COGS 9,A01,083968,Staff,59,0,60,1
1649787617308,COGS 14B,A01,083970,Staff,49,0,50,1
1649787623333,COGS 100,A01,083972,Staff,58,0,60,2
1649787635377,COGS 101C,A01,083976,Staff,29,0,30,1
1649787641400,COGS 102A,A01,083978,Johnson; Christine M.,29,0,30,1
1649787647430,COGS 107B,A01,083980,Staff,46,0,50,4
1649787653453,COGS 115,A01,083982,Staff,27,0,30,3
1649787659484,COGS 118B,A01,083367,Staff,21,0,40,19
1649787665512,COGS 172,A01,083984,Provenzano; Emily Kara,25,0,30,5
1649787671535,COGS 177,A00,083368,Staff,19,0,30,11
1649787677566,COGS 186,A01,083986,Staff,28,0,40,12
1649787683593,COGS 187A,A01,083988,Boyle; Mary E. T.,54,0,60,6
1649787689623,CSE 8A,A50,084003,Miranda; Gregory Joseph,12,0,15,3
1649787695658,CSE 11,A01,084005,Miranda; Gregory Joseph,52,0,55,3
1649787701688,CSE 20,A01,084007,Staff,17,0,20,3
1649787707712,CSE 21,A01,084009,Staff,47,0,50,3
1649787713735,CSE 30,A01,083370,Cao; Yingjun,35,0,40,5
1649787719760,CSE 100,A01,083372,Cao; Yingjun,35,0,40,5
1649787725797,CSE 101,A01,084011,Staff,23,0,40,17
1649787731823,CSE 141,A01,083374,Eldon; John,36,0,75,39
1649787737846,CSE 141L,A01,083376,Eldon; John,38,0,75,37
1649787743872,CSE 175,A01,084013,Kumar; Rakesh,25,0,25,0
1649787749895,CSE 190,A00,092508,Staff,15,0,15,0
1649787755929,ECE 5,A01,084049,Morris; Karcher William,18,0,20,2
1649787761954,ECE 100,A01,084051,Baghdadchi; Saharnaz,18,0,20,2
1649787761954,ECE 100,A02,091916,Baghdadchi; Saharnaz,19,0,20,1
1649787767979,ECE 101,A01,084053,Baghdadchi; Saharnaz,33,0,37,4
1649787767979,ECE 101,A02,084054,Baghdadchi; Saharnaz,37,0,37,0
1649787774012,ECE 107,A01,083390,Staff,35,0,40,5
1649787780041,ECE 148,A01,084056,Silberman; Jack,8,0,12,4
1649787786066,ECE 180,A00,083391,Abi Samra; Nicholas Camill,27,0,30,3
1649787786066,ECE 180,B00,083392,Abi Samra; Nicholas Camill,26,0,30,4
1649787792093,MATH 10B,A01,084110,Staff,25,0,30,5
1649787792093,MATH 10B,A02,084111,Staff,30,0,30,0
1649787792093,MATH 10B,A03,084112,Staff,30,0,30,0
1649787798116,MATH 10C,A01,083443,Staff,26,0,30,4
1649787798116,MATH 10C,A02,083444,Staff,26,0,30,4
1649787798116,MATH 10C,B01,084114,Staff,28,0,30,2
1649787798116,MATH 10C,B02,084115,Staff,30,0,30,0
1649787804145,MATH 18,A01,084117,Harel; Guershon,28,0,30,2
1649787804145,MATH 18,A02,084119,Harel; Guershon,29,0,30,1
1649787804145,MATH 18,A03,084120,Harel; Guershon,30,0,30,0
1649787804145,MATH 18,A04,084121,Harel; Guershon,30,0,30,0
1649787810171,MATH 20B,A01,084124,Um; Ko Woon,34,0,35,1
1649787810171,MATH 20B,B01,084126,Um; Ko Woon,35,0,35,0
1649787816195,MATH 20C,A01,083446,Hammock; Frances H,29,0,30,1
1649787816195,MATH 20C,A02,083447,Hammock; Frances H,30,0,30,0
1649787816195,MATH 20C,A03,083448,Hammock; Frances H,30,0,30,0
1649787816195,MATH 20C,A04,083449,Hammock; Frances H,30,0,30,0
1649787816195,MATH 20C,B01,083451,Hammock; Frances H,30,0,30,0
1649787816195,MATH 20C,B02,083452,Hammock; Frances H,30,0,30,0
1649787816195,MATH 20C,B03,083453,Hammock; Frances H,30,0,30,0
1649787816195,MATH 20C,B04,083454,Hammock; Frances H,30,0,30,0
1649787822224,MATH 20D,A01,084128,Staff,30,0,30,0
1649787822224,MATH 20D,A02,084129,Staff,30,0,30,0
1649787822224,MATH 20D,A03,084130,Staff,29,0,30,1
1649787822224,MATH 20D,B01,084133,Staff,30,0,30,0
1649787822224,MATH 20D,B02,084134,Staff,30,0,30,0
1649787822224,MATH 20D,B03,084135,Staff,30,0,30,0
1649787828252,MATH 20E,A01,084138,Staff,30,0,30,0
1649787828252,MATH 20E,A02,084139,Staff,29,0,30,1
1649787828252,MATH 20E,A03,084140,Staff,30,0,30,0
1649787828252,MATH 20E,A04,084141,Staff,30,0,30,0
1649787834281,MATH 102,A01,084143,Harel; Guershon,27,0,30,3
1649787834281,MATH 102,A02,084144,Harel; Guershon,29,0,30,1
1649787840305,MATH 103B,A01,083456,Staff,19,0,30,11
1649787840305,MATH 103B,A02,083457,Staff,28,0,30,2
1649787846342,MATH 109,A01,084146,Salehi Golsefidy; Alireza,30,0,30,0
1649787846342,MATH 109,A02,084147,Salehi Golsefidy; Alireza,29,0,30,1
1649787852364,MATH 120A,A01,085445,Eggers; John Dietrich,32,0,35,3
1649787852364,MATH 120A,A02,085446,Eggers; John Dietrich,33,0,35,2
1649787858388,MATH 142B,A01,084149,Verstraete; Jacques Allan,26,0,30,4
1649787858388,MATH 142B,A02,084150,Verstraete; Jacques Allan,27,0,30,3
1649787864419,MATH 170A,A01,083459,Nie; Jiawang,21,0,30,9
1649787864419,MATH 170A,A02,083460,Nie; Jiawang,28,0,30,2
1649787864419,MATH 170A,A03,083461,Nie; Jiawang,30,0,30,0
1649787870445,MATH 193B,A01,083463,Staff,25,0,30,5
1649787870445,MATH 193B,A02,083464,Staff,29,0,30,1
1649787870445,MATH 193B,A03,083465,Staff,30,0,30,0
1649787876518,COGS 2,A01,083966,Boyle; Mary E. T.,28,0,30,2
1649787882543,COGS 9,A01,083968,Staff,59,0,60,1
1649787888566,COGS 14B,A01,083970,Staff,49,0,50,1
1649787894589,COGS 100,A01,083972,Staff,58,0,60,2
1649787906647,COGS 101C,A01,083976,Staff,29,0,30,1
1649787912670,COGS 102A,A01,083978,Johnson; Christine M.,29,0,30,1
1649787918694,COGS 107B,A01,083980,Staff,46,0,50,4
1649787924721,COGS 115,A01,083982,Staff,27,0,30,3
1649787930743,COGS 118B,A01,083367,Staff,21,0,40,19
1649787936768,COGS 172,A01,083984,Provenzano; Emily Kara,25,0,30,5
1649787942792,COGS 177,A00,083368,Staff,19,0,30,11
1649787948823,COGS 186,A01,083986,Staff,28,0,40,12
1649787954849,COGS 187A,A01,083988,Boyle; Mary E. T.,54,0,60,6
1649787960880,CSE 8A,A50,084003,Miranda; Gregory Joseph,12,0,15,3
1649787966918,CSE 11,A01,084005,Miranda; Gregory Joseph,52,0,55,3
1649787972940,CSE 20,A01,084007,Staff,17,0,20,3
1649787978966,CSE 21,A01,084009,Staff,47,0,50,3
1649787984988,CSE 30,A01,083370,Cao; Yingjun,35,0,40,5
1649787991014,CSE 100,A01,083372,Cao; Yingjun,35,0,40,5
1649787997042,CSE 101,A01,084011,Staff,23,0,40,17
1649788003074,CSE 141,A01,083374,Eldon; John,36,0,75,39
1649788009097,CSE 141L,A01,083376,Eldon; John,38,0,75,37
1649788015120,CSE 175,A01,084013,Kumar; Rakesh,25,0,25,0
1649788021144,CSE 190,A00,092508,Staff,15,0,15,0
1649788027179,ECE 5,A01,084049,Morris; Karcher William,18,0,20,2
1649788033203,ECE 100,A01,084051,Baghdadchi; Saharnaz,18,0,20,2
1649788033203,ECE 100,A02,091916,Baghdadchi; Saharnaz,19,0,20,1
1649788039225,ECE 101,A01,084053,Baghdadchi; Saharnaz,33,0,37,4
1649788039225,ECE 101,A02,084054,Baghdadchi; Saharnaz,37,0,37,0
1649788045249,ECE 107,A01,083390,Staff,35,0,40,5
1649788051271,ECE 148,A01,084056,Silberman; Jack,8,0,12,4
1649788057302,ECE 180,A00,083391,Abi Samra; Nicholas Camill,27,0,30,3
1649788057302,ECE 180,B00,083392,Abi Samra; Nicholas Camill,26,0,30,4
1649788063330,MATH 10B,A01,084110,Staff,25,0,30,5
1649788063330,MATH 10B,A02,084111,Staff,30,0,30,0
1649788063330,MATH 10B,A03,084112,Staff,30,0,30,0
1649788069358,MATH 10C,A01,083443,Staff,26,0,30,4
1649788069358,MATH 10C,A02,083444,Staff,26,0,30,4
1649788069358,MATH 10C,B01,084114,Staff,28,0,30,2
1649788069358,MATH 10C,B02,084115,Staff,30,0,30,0
1649788075391,MATH 18,A01,084117,Harel; Guershon,28,0,30,2
1649788075391,MATH 18,A02,084119,Harel; Guershon,29,0,30,1
1649788075391,MATH 18,A03,084120,Harel; Guershon,30,0,30,0
1649788075391,MATH 18,A04,084121,Harel; Guershon,30,0,30,0
1649788081416,MATH 20B,A01,084124,Um; Ko Woon,34,0,35,1
1649788081416,MATH 20B,B01,084126,Um; Ko Woon,35,0,35,0
1649788087445,MATH 20C,A01,083446,Hammock; Frances H,29,0,30,1
1649788087445,MATH 20C,A02,083447,Hammock; Frances H,30,0,30,0
1649788087445,MATH 20C,A03,083448,Hammock; Frances H,30,0,30,0
1649788087445,MATH 20C,A04,083449,Hammock; Frances H,30,0,30,0
1649788087445,MATH 20C,B01,083451,Hammock; Frances H,30,0,30,0
1649788087445,MATH 20C,B02,083452,Hammock; Frances H,30,0,30,0
1649788087445,MATH 20C,B03,083453,Hammock; Frances H,30,0,30,0
1649788087445,MATH 20C,B04,083454,Hammock; Frances H,30,0,30,0
1649788093469,MATH 20D,A01,084128,Staff,30,0,30,0
1649788093469,MATH 20D,A02,084129,Staff,30,0,30,0
1649788093469,MATH 20D,A03,084130,Staff,29,0,30,1
1649788093469,MATH 20D,B01,084133,Staff,30,0,30,0
1649788093469,MATH 20D,B02,084134,Staff,30,0,30,0
1649788093469,MATH 20D,B03,084135,Staff,30,0,30,0
1649788099506,MATH 20E,A01,084138,Staff,30,0,30,0
1649788099506,MATH 20E,A02,084139,Staff,29,0,30,1
1649788099506,MATH 20E,A03,084140,Staff,30,0,30,0
1649788099506,MATH 20E,A04,084141,Staff,30,0,30,0
1649788105529,MATH 102,A01,084143,Harel; Guershon,27,0,30,3
1649788105529,MATH 102,A02,084144,Harel; Guershon,29,0,30,1
1649788111554,MATH 103B,A01,083456,Staff,19,0,30,11
1649788111554,MATH 103B,A02,083457,Staff,28,0,30,2
1649788117585,MATH 109,A01,084146,Salehi Golsefidy; Alireza,30,0,30,0
1649788117585,MATH 109,A02,084147,Salehi Golsefidy; Alireza,29,0,30,1
1649788123609,MATH 120A,A01,085445,Eggers; John Dietrich,32,0,35,3
1649788123609,MATH 120A,A02,085446,Eggers; John Dietrich,33,0,35,2
1649788129636,MATH 142B,A01,084149,Verstraete; Jacques Allan,26,0,30,4
1649788129636,MATH 142B,A02,084150,Verstraete; Jacques Allan,27,0,30,3
1649788135662,MATH 170A,A01,083459,Nie; Jiawang,21,0,30,9
1649788135662,MATH 170A,A02,083460,Nie; Jiawang,28,0,30,2
1649788135662,MATH 170A,A03,083461,Nie; Jiawang,30,0,30,0
1649788141690,MATH 193B,A01,083463,Staff,25,0,30,5
1649788141690,MATH 193B,A02,083464,Staff,29,0,30,1
1649788141690,MATH 193B,A03,083465,Staff,30,0,30,0
1649788147761,COGS 2,A01,083966,Boyle; Mary E. T.,28,0,30,2
1649788153786,COGS 9,A01,083968,Staff,59,0,60,1
1649788159818,COGS 14B,A01,083970,Staff,49,0,50,1
1649788165842,COGS 100,A01,083972,Staff,58,0,60,2
1649788177890,COGS 101C,A01,083976,Staff,29,0,30,1
1649788183920,COGS 102A,A01,083978,Johnson; Christine M.,29,0,30,1
1649788189945,COGS 107B,A01,083980,Staff,46,0,50,4
1649788195978,COGS 115,A01,083982,Staff,27,0,30,3
1649788202010,COGS 118B,A01,083367,Staff,21,0,40,19
1649788208034,COGS 172,A01,083984,Provenzano; Emily Kara,25,0,30,5
1649788214145,COGS 177,A00,083368,Staff,19,0,30,11
1649788220172,COGS 186,A01,083986,Staff,28,0,40,12
1649788226196,COGS 187A,A01,083988,Boyle; Mary E. T.,54,0,60,6
1649788232220,CSE 8A,A50,084003,Miranda; Gregory Joseph,12,0,15,3
1649788238241,CSE 11,A01,084005,Miranda; Gregory Joseph,52,0,55,3
1649788244279,CSE 20,A01,084007,Staff,17,0,20,3
1649788250310,CSE 21,A01,084009,Staff,47,0,50,3
1649788256343,CSE 30,A01,083370,Cao; Yingjun,35,0,40,5
1649788262372,CSE 100,A01,083372,Cao; Yingjun,35,0,40,5
1649788268396,CSE 101,A01,084011,Staff,23,0,40,17
1649788274424,CSE 141,A01,083374,Eldon; John,36,0,75,39
1649788280455,CSE 141L,A01,083376,Eldon; John,38,0,75,37
1649788286477,CSE 175,A01,084013,Kumar; Rakesh,25,0,25,0
1649788292502,CSE 190,A00,092508,Staff,15,0,15,0
1649788298526,ECE 5,A01,084049,Morris; Karcher William,18,0,20,2
1649788304564,ECE 100,A01,084051,Baghdadchi; Saharnaz,18,0,20,2
1649788304564,ECE 100,A02,091916,Baghdadchi; Saharnaz,19,0,20,1
1649788310593,ECE 101,A01,084053,Baghdadchi; Saharnaz,33,0,37,4
1649788310593,ECE 101,A02,084054,Baghdadchi; Saharnaz,37,0,37,0
1649788316617,ECE 107,A01,083390,Staff,35,0,40,5
1649788322640,ECE 148,A01,084056,Silberman; Jack,8,0,12,4
1649788328675,ECE 180,A00,083391,Abi Samra; Nicholas Camill,27,0,30,3
1649788328675,ECE 180,B00,083392,Abi Samra; Nicholas Camill,26,0,30,4
1649788334702,MATH 10B,A01,084110,Staff,25,0,30,5
1649788334702,MATH 10B,A02,084111,Staff,30,0,30,0
1649788334702,MATH 10B,A03,084112,Staff,30,0,30,0
1649788340733,MATH 10C,A01,083443,Staff,26,0,30,4
1649788340733,MATH 10C,A02,083444,Staff,26,0,30,4
1649788340733,MATH 10C,B01,084114,Staff,28,0,30,2
1649788340733,MATH 10C,B02,084115,Staff,30,0,30,0
1649788346757,MATH 18,A01,084117,Harel; Guershon,28,0,30,2
1649788346757,MATH 18,A02,084119,Harel; Guershon,29,0,30,1
1649788346757,MATH 18,A03,084120,Harel; Guershon,30,0,30,0
1649788346757,MATH 18,A04,084121,Harel; Guershon,30,0,30,0
1649788352786,MATH 20B,A01,084124,Um; Ko Woon,34,0,35,1
1649788352786,MATH 20B,B01,084126,Um; Ko Woon,35,0,35,0
1649788358817,MATH 20C,A01,083446,Hammock; Frances H,29,0,30,1
1649788358817,MATH 20C,A02,083447,Hammock; Frances H,30,0,30,0
1649788358817,MATH 20C,A03,083448,Hammock; Frances H,30,0,30,0
1649788358817,MATH 20C,A04,083449,Hammock; Frances H,30,0,30,0
1649788358817,MATH 20C,B01,083451,Hammock; Frances H,30,0,30,0
1649788358817,MATH 20C,B02,083452,Hammock; Frances H,30,0,30,0
1649788358817,MATH 20C,B03,083453,Hammock; Frances H,30,0,30,0
1649788358817,MATH 20C,B04,083454,Hammock; Frances H,30,0,30,0
1649788364849,MATH 20D,A01,084128,Staff,30,0,30,0
1649788364849,MATH 20D,A02,084129,Staff,30,0,30,0
1649788364849,MATH 20D,A03,084130,Staff,29,0,30,1
1649788364849,MATH 20D,B01,084133,Staff,30,0,30,0
1649788364849,MATH 20D,B02,084134,Staff,30,0,30,0
1649788364849,MATH 20D,B03,084135,Staff,30,0,30,0
1649788370872,MATH 20E,A01,084138,Staff,30,0,30,0
1649788370872,MATH 20E,A02,084139,Staff,29,0,30,1
1649788370872,MATH 20E,A03,084140,Staff,30,0,30,0
1649788370872,MATH 20E,A04,084141,Staff,30,0,30,0
1649788376895,MATH 102,A01,084143,Harel; Guershon,27,0,30,3
1649788376895,MATH 102,A02,084144,Harel; Guershon,29,0,30,1
1649788382928,MATH 103B,A01,083456,Staff,19,0,30,11
1649788382928,MATH 103B,A02,083457,Staff,28,0,30,2
1649788388953,MATH 109,A01,084146,Salehi Golsefidy; Alireza,30,0,30,0
1649788388953,MATH 109,A02,084147,Salehi Golsefidy; Alireza,29,0,30,1
1649788394985,MATH 120A,A01,085445,Eggers; John Dietrich,32,0,35,3
1649788394985,MATH 120A,A02,085446,Eggers; John Dietrich,33,0,35,2
1649788401018,MATH 142B,A01,084149,Verstraete; Jacques Allan,26,0,30,4
1649788401018,MATH 142B,A02,084150,Verstraete; Jacques Allan,27,0,30,3
1649788407040,MATH 170A,A01,083459,Nie; Jiawang,21,0,30,9
1649788407040,MATH 170A,A02,083460,Nie; Jiawang,28,0,30,2
1649788407040,MATH 170A,A03,083461,Nie; Jiawang,30,0,30,0
1649788413071,MATH 193B,A01,083463,Staff,25,0,30,5
1649788413071,MATH 193B,A02,083464,Staff,28,0,30,2
1649788413071,MATH 193B,A03,083465,Staff,30,0,30,0
1649788419130,COGS 2,A01,083966,Boyle; Mary E. T.,28,0,30,2
1649788425155,COGS 9,A01,083968,Staff,59,0,60,1
1649788431177,COGS 14B,A01,083970,Staff,49,0,50,1
1649788437201,COGS 100,A01,083972,Staff,58,0,60,2
1649788449262,COGS 101C,A01,083976,Staff,29,0,30,1
1649788455288,COGS 102A,A01,083978,Johnson; Christine M.,29,0,30,1
1649788461311,COGS 107B,A01,083980,Staff,46,0,50,4
1649788467347,COGS 115,A01,083982,Staff,27,0,30,3
1649788473374,COGS 118B,A01,083367,Staff,21,0,40,19
1649788479405,COGS 172,A01,083984,Provenzano; Emily Kara,25,0,30,5
1649788485434,COGS 177,A00,083368,Staff,19,0,30,11
1649788491460,COGS 186,A01,083986,Staff,28,0,40,12
1649788497488,COGS 187A,A01,083988,Boyle; Mary E. T.,54,0,60,6
1649788503519,CSE 8A,A50,084003,Miranda; Gregory Joseph,12,0,15,3
1649788509549,CSE 11,A01,084005,Miranda; Gregory Joseph,52,0,55,3
1649788515589,CSE 20,A01,084007,Staff,17,0,20,3
1649788521610,CSE 21,A01,084009,Staff,47,0,50,3
1649788527643,CSE 30,A01,083370,Cao; Yingjun,35,0,40,5
1649788533671,CSE 100,A01,083372,Cao; Yingjun,35,0,40,5
1649788539695,CSE 101,A01,084011,Staff,23,0,40,17
1649788545724,CSE 141,A01,083374,Eldon; John,36,0,75,39
1649788551750,CSE 141L,A01,083376,Eldon; John,38,0,75,37
1649788557776,CSE 175,A01,084013,Kumar; Rakesh,25,0,25,0
1649788563797,CSE 190,A00,092508,Staff,15,0,15,0
1649788569828,ECE 5,A01,084049,Morris; Karcher William,18,0,20,2
1649788575854,ECE 100,A01,084051,Baghdadchi; Saharnaz,18,0,20,2
1649788575854,ECE 100,A02,091916,Baghdadchi; Saharnaz,19,0,20,1
1649788581887,ECE 101,A01,084053,Baghdadchi; Saharnaz,33,0,37,4
1649788581887,ECE 101,A02,084054,Baghdadchi; Saharnaz,37,0,37,0
1649788587910,ECE 107,A01,083390,Staff,35,0,40,5
1649788593933,ECE 148,A01,084056,Silberman; Jack,8,0,12,4
1649788599959,ECE 180,A00,083391,Abi Samra; Nicholas Camill,27,0,30,3
1649788599959,ECE 180,B00,083392,Abi Samra; Nicholas Camill,26,0,30,4
1649788605982,MATH 10B,A01,084110,Staff,25,0,30,5
1649788605982,MATH 10B,A02,084111,Staff,30,0,30,0
1649788605982,MATH 10B,A03,084112,Staff,30,0,30,0
1649788612024,MATH 10C,A01,083443,Staff,26,0,30,4
1649788612024,MATH 10C,A02,083444,Staff,26,0,30,4
1649788612024,MATH 10C,B01,084114,Staff,28,0,30,2
1649788612024,MATH 10C,B02,084115,Staff,30,0,30,0
1649788618047,MATH 18,A01,084117,Harel; Guershon,28,0,30,2
1649788618047,MATH 18,A02,084119,Harel; Guershon,29,0,30,1
1649788618047,MATH 18,A03,084120,Harel; Guershon,30,0,30,0
1649788618047,MATH 18,A04,084121,Harel; Guershon,30,0,30,0
1649788624084,MATH 20B,A01,084124,Um; Ko Woon,34,0,35,1
1649788624084,MATH 20B,B01,084126,Um; Ko Woon,35,0,35,0
1649788630116,MATH 20C,A01,083446,Hammock; Frances H,29,0,30,1
1649788630116,MATH 20C,A02,083447,Hammock; Frances H,30,0,30,0
1649788630116,MATH 20C,A03,083448,Hammock; Frances H,30,0,30,0
1649788630116,MATH 20C,A04,083449,Hammock; Frances H,30,0,30,0
1649788630116,MATH 20C,B01,083451,Hammock; Frances H,30,0,30,0
1649788630116,MATH 20C,B02,083452,Hammock; Frances H,30,0,30,0
1649788630116,MATH 20C,B03,083453,Hammock; Frances H,30,0,30,0
1649788630116,MATH 20C,B04,083454,Hammock; Frances H,30,0,30,0
1649788636151,MATH 20D,A01,084128,Staff,30,0,30,0
1649788636151,MATH 20D,A02,084129,Staff,30,0,30,0
1649788636151,MATH 20D,A03,084130,Staff,29,0,30,1
1649788636151,MATH 20D,B01,084133,Staff,30,0,30,0
1649788636151,MATH 20D,B02,084134,Staff,30,0,30,0
1649788636151,MATH 20D,B03,084135,Staff,30,0,30,0
1649788642172,MATH 20E,A01,084138,Staff,30,0,30,0
1649788642172,MATH 20E,A02,084139,Staff,29,0,30,1
1649788642172,MATH 20E,A03,084140,Staff,30,0,30,0
1649788642172,MATH 20E,A04,084141,Staff,30,0,30,0
1649788648196,MATH 102,A01,084143,Harel; Guershon,27,0,30,3
1649788648196,MATH 102,A02,084144,Harel; Guershon,29,0,30,1
1649788654221,MATH 103B,A01,083456,Staff,19,0,30,11
1649788654221,MATH 103B,A02,083457,Staff,28,0,30,2
1649788660252,MATH 109,A01,084146,Salehi Golsefidy; Alireza,30,0,30,0
1649788660252,MATH 109,A02,084147,Salehi Golsefidy; Alireza,29,0,30,1
1649788666277,MATH 120A,A01,085445,Eggers; John Dietrich,32,0,35,3
1649788666277,MATH 120A,A02,085446,Eggers; John Dietrich,33,0,35,2
1649788672305,MATH 142B,A01,084149,Verstraete; Jacques Allan,26,0,30,4
1649788672305,MATH 142B,A02,084150,Verstraete; Jacques Allan,27,0,30,3
1649788678330,MATH 170A,A01,083459,Nie; Jiawang,21,0,30,9
1649788678330,MATH 170A,A02,083460,Nie; Jiawang,28,0,30,2
1649788678330,MATH 170A,A03,083461,Nie; Jiawang,30,0,30,0
1649788684356,MATH 193B,A01,083463,Staff,25,0,30,5
1649788684356,MATH 193B,A02,083464,Staff,28,0,30,2
1649788684356,MATH 193B,A03,083465,Staff,30,0,30,0
1649788690427,COGS 2,A01,083966,Boyle; Mary E. T.,28,0,30,2
1649788696452,COGS 9,A01,083968,Staff,59,0,60,1
1649788702476,COGS 14B,A01,083970,Staff,49,0,50,1
1649788708501,COGS 100,A01,083972,Staff,58,0,60,2
1649788720552,COGS 101C,A01,083976,Staff,29,0,30,1
1649788726576,COGS 102A,A01,083978,Johnson; Christine M.,29,0,30,1
1649788732599,COGS 107B,A01,083980,Staff,46,0,50,4
1649788738624,COGS 115,A01,083982,Staff,27,0,30,3
1649788744651,COGS 118B,A01,083367,Staff,21,0,40,19
1649788750674,COGS 172,A01,083984,Provenzano; Emily Kara,25,0,30,5
1649788756701,COGS 177,A00,083368,Staff,19,0,30,11
1649788762730,COGS 186,A01,083986,Staff,28,0,40,12
1649788768764,COGS 187A,A01,083988,Boyle; Mary E. T.,54,0,60,6
1649788774795,CSE 8A,A50,084003,Miranda; Gregory Joseph,12,0,15,3
1649788780822,CSE 11,A01,084005,Miranda; Gregory Joseph,52,0,55,3
1649788786858,CSE 20,A01,084007,Staff,17,0,20,3
1649788792893,CSE 21,A01,084009,Staff,47,0,50,3
1649788798934,CSE 30,A01,083370,Cao; Yingjun,35,0,40,5
1649788804957,CSE 100,A01,083372,Cao; Yingjun,35,0,40,5
1649788811070,CSE 101,A01,084011,Staff,23,0,40,17
1649788817093,CSE 141,A01,083374,Eldon; John,36,0,75,39
1649788823125,CSE 141L,A01,083376,Eldon; John,38,0,75,37
1649788829163,CSE 175,A01,084013,Kumar; Rakesh,25,0,25,0
1649788835186,CSE 190,A00,092508,Staff,15,0,15,0
1649788841210,ECE 5,A01,084049,Morris; Karcher William,18,0,20,2
1649788847238,ECE 100,A01,084051,Baghdadchi; Saharnaz,18,0,20,2
1649788847238,ECE 100,A02,091916,Baghdadchi; Saharnaz,19,0,20,1
1649788853260,ECE 101,A01,084053,Baghdadchi; Saharnaz,33,0,37,4
1649788853260,ECE 101,A02,084054,Baghdadchi; Saharnaz,37,0,37,0
1649788859286,ECE 107,A01,083390,Staff,34,0,40,6
1649788865312,ECE 148,A01,084056,Silberman; Jack,8,0,12,4
1649788871335,ECE 180,A00,083391,Abi Samra; Nicholas Camill,27,0,30,3
1649788871335,ECE 180,B00,083392,Abi Samra; Nicholas Camill,26,0,30,4
1649788877360,MATH 10B,A01,084110,Staff,25,0,30,5
1649788877360,MATH 10B,A02,084111,Staff,30,0,30,0
1649788877360,MATH 10B,A03,084112,Staff,30,0,30,0
1649788883384,MATH 10C,A01,083443,Staff,26,0,30,4
1649788883384,MATH 10C,A02,083444,Staff,26,0,30,4
1649788883384,MATH 10C,B01,084114,Staff,28,0,30,2
1649788883384,MATH 10C,B02,084115,Staff,30,0,30,0
1649788889412,MATH 18,A01,084117,Harel; Guershon,28,0,30,2
1649788889412,MATH 18,A02,084119,Harel; Guershon,29,0,30,1
1649788889412,MATH 18,A03,084120,Harel; Guershon,30,0,30,0
1649788889412,MATH 18,A04,084121,Harel; Guershon,30,0,30,0
1649788895441,MATH 20B,A01,084124,Um; Ko Woon,34,0,35,1
1649788895441,MATH 20B,B01,084126,Um; Ko Woon,35,0,35,0
1649788901472,MATH 20C,A01,083446,Hammock; Frances H,29,0,30,1
1649788901472,MATH 20C,A02,083447,Hammock; Frances H,30,0,30,0
1649788901472,MATH 20C,A03,083448,Hammock; Frances H,30,0,30,0
1649788901472,MATH 20C,A04,083449,Hammock; Frances H,30,0,30,0
1649788901472,MATH 20C,B01,083451,Hammock; Frances H,30,0,30,0
1649788901472,MATH 20C,B02,083452,Hammock; Frances H,30,0,30,0
1649788901472,MATH 20C,B03,083453,Hammock; Frances H,30,0,30,0
1649788901472,MATH 20C,B04,083454,Hammock; Frances H,30,0,30,0
1649788907497,MATH 20D,A01,084128,Staff,30,0,30,0
1649788907497,MATH 20D,A02,084129,Staff,30,0,30,0
1649788907497,MATH 20D,A03,084130,Staff,29,0,30,1
1649788907497,MATH 20D,B01,084133,Staff,30,0,30,0
1649788907497,MATH 20D,B02,084134,Staff,30,0,30,0
1649788907497,MATH 20D,B03,084135,Staff,30,0,30,0
1649788913520,MATH 20E,A01,084138,Staff,30,0,30,0
1649788913520,MATH 20E,A02,084139,Staff,29,0,30,1
1649788913520,MATH 20E,A03,084140,Staff,30,0,30,0
1649788913520,MATH 20E,A04,084141,Staff,30,0,30,0
1649788919544,MATH 102,A01,084143,Harel; Guershon,27,0,30,3
1649788919544,MATH 102,A02,084144,Harel; Guershon,29,0,30,1
1649788925589,MATH 103B,A01,083456,Staff,19,0,30,11
1649788925589,MATH 103B,A02,083457,Staff,28,0,30,2
1649788931612,MATH 109,A01,084146,Salehi Golsefidy; Alireza,30,0,30,0
1649788931612,MATH 109,A02,084147,Salehi Golsefidy; Alireza,29,0,30,1
1649788937638,MATH 120A,A01,085445,Eggers; John Dietrich,32,0,35,3
1649788937638,MATH 120A,A02,085446,Eggers; John Dietrich,33,0,35,2
1649788943665,MATH 142B,A01,084149,Verstraete; Jacques Allan,26,0,30,4
1649788943665,MATH 142B,A02,084150,Verstraete; Jacques Allan,27,0,30,3
1649788949696,MATH 170A,A01,083459,Nie; Jiawang,21,0,30,9
1649788949696,MATH 170A,A02,083460,Nie; Jiawang,28,0,30,2
1649788949696,MATH 170A,A03,083461,Nie; Jiawang,30,0,30,0
1649788955725,MATH 193B,A01,083463,Staff,25,0,30,5
1649788955725,MATH 193B,A02,083464,Staff,28,0,30,2
1649788955725,MATH 193B,A03,083465,Staff,30,0,30,0
1649788961779,COGS 2,A01,083966,Boyle; Mary E. T.,28,0,30,2
1649788967812,COGS 9,A01,083968,Staff,59,0,60,1
1649788973843,COGS 14B,A01,083970,Staff,49,0,50,1
1649788979873,COGS 100,A01,083972,Staff,58,0,60,2
1649788991924,COGS 101C,A01,083976,Staff,29,0,30,1
1649788997949,COGS 102A,A01,083978,Johnson; Christine M.,29,0,30,1
1649789003975,COGS 107B,A01,083980,Staff,46,0,50,4
1649789009999,COGS 115,A01,083982,Staff,27,0,30,3
1649789016026,COGS 118B,A01,083367,Staff,21,0,40,19
1649789022055,COGS 172,A01,083984,Provenzano; Emily Kara,25,0,30,5
1649789028078,COGS 177,A00,083368,Staff,19,0,30,11
1649789034105,COGS 186,A01,083986,Staff,28,0,40,12
1649789040128,COGS 187A,A01,083988,Boyle; Mary E. T.,54,0,60,6
1649789046155,CSE 8A,A50,084003,Miranda; Gregory Joseph,12,0,15,3
1649789052178,CSE 11,A01,084005,Miranda; Gregory Joseph,52,0,55,3
1649789058220,CSE 20,A01,084007,Staff,17,0,20,3
1649789064242,CSE 21,A01,084009,Staff,47,0,50,3
1649789070274,CSE 30,A01,083370,Cao; Yingjun,35,0,40,5
1649789076299,CSE 100,A01,083372,Cao; Yingjun,35,0,40,5
1649789082324,CSE 101,A01,084011,Staff,23,0,40,17
1649789088348,CSE 141,A01,083374,Eldon; John,35,0,75,40
1649789094384,CSE 141L,A01,083376,Eldon; John,37,0,75,38
1649789100411,CSE 175,A01,084013,Kumar; Rakesh,25,0,25,0
1649789106433,CSE 190,A00,092508,Staff,15,0,15,0
1649789112456,ECE 5,A01,084049,Morris; Karcher William,18,0,20,2
1649789118482,ECE 100,A01,084051,Baghdadchi; Saharnaz,18,0,20,2
1649789118482,ECE 100,A02,091916,Baghdadchi; Saharnaz,19,0,20,1
1649789124509,ECE 101,A01,084053,Baghdadchi; Saharnaz,33,0,37,4
1649789124509,ECE 101,A02,084054,Baghdadchi; Saharnaz,37,0,37,0
1649789130536,ECE 107,A01,083390,Staff,34,0,40,6
1649789136559,ECE 148,A01,084056,Silberman; Jack,8,0,12,4
1649789142595,ECE 180,A00,083391,Abi Samra; Nicholas Camill,27,0,30,3
1649789142595,ECE 180,B00,083392,Abi Samra; Nicholas Camill,26,0,30,4
1649789148623,MATH 10B,A01,084110,Staff,25,0,30,5
1649789148623,MATH 10B,A02,084111,Staff,30,0,30,0
1649789148623,MATH 10B,A03,084112,Staff,30,0,30,0
1649789154645,MATH 10C,A01,083443,Staff,26,0,30,4
1649789154645,MATH 10C,A02,083444,Staff,26,0,30,4
1649789154645,MATH 10C,B01,084114,Staff,28,0,30,2
1649789154645,MATH 10C,B02,084115,Staff,30,0,30,0
1649789160678,MATH 18,A01,084117,Harel; Guershon,28,0,30,2
1649789160678,MATH 18,A02,084119,Harel; Guershon,29,0,30,1
1649789160678,MATH 18,A03,084120,Harel; Guershon,30,0,30,0
1649789160678,MATH 18,A04,084121,Harel; Guershon,30,0,30,0
1649789166703,MATH 20B,A01,084124,Um; Ko Woon,34,0,35,1
1649789166703,MATH 20B,B01,084126,Um; Ko Woon,35,0,35,0
1649789172731,MATH 20C,A01,083446,Hammock; Frances H,29,0,30,1
1649789172731,MATH 20C,A02,083447,Hammock; Frances H,30,0,30,0
1649789172731,MATH 20C,A03,083448,Hammock; Frances H,30,0,30,0
1649789172731,MATH 20C,A04,083449,Hammock; Frances H,30,0,30,0
1649789172731,MATH 20C,B01,083451,Hammock; Frances H,30,0,30,0
1649789172731,MATH 20C,B02,083452,Hammock; Frances H,30,0,30,0
1649789172731,MATH 20C,B03,083453,Hammock; Frances H,30,0,30,0
1649789172731,MATH 20C,B04,083454,Hammock; Frances H,30,0,30,0
1649789178769,MATH 20D,A01,084128,Staff,30,0,30,0
1649789178769,MATH 20D,A02,084129,Staff,30,0,30,0
1649789178769,MATH 20D,A03,084130,Staff,29,0,30,1
1649789178769,MATH 20D,B01,084133,Staff,30,0,30,0
1649789178769,MATH 20D,B02,084134,Staff,30,0,30,0
1649789178769,MATH 20D,B03,084135,Staff,30,0,30,0
1649789184793,MATH 20E,A01,084138,Staff,29,0,30,1
1649789184793,MATH 20E,A02,084139,Staff,29,0,30,1
1649789184793,MATH 20E,A03,084140,Staff,30,0,30,0
1649789184793,MATH 20E,A04,084141,Staff,30,0,30,0
1649789190818,MATH 102,A01,084143,Harel; Guershon,27,0,30,3
1649789190818,MATH 102,A02,084144,Harel; Guershon,29,0,30,1
1649789196842,MATH 103B,A01,083456,Staff,18,0,30,12
1649789196842,MATH 103B,A02,083457,Staff,28,0,30,2
1649789202869,MATH 109,A01,084146,Salehi Golsefidy; Alireza,30,0,30,0
1649789202869,MATH 109,A02,084147,Salehi Golsefidy; Alireza,29,0,30,1
1649789208898,MATH 120A,A01,085445,Eggers; John Dietrich,32,0,35,3
1649789208898,MATH 120A,A02,085446,Eggers; John Dietrich,33,0,35,2
1649789214926,MATH 142B,A01,084149,Verstraete; Jacques Allan,26,0,30,4
1649789214926,MATH 142B,A02,084150,Verstraete; Jacques Allan,27,0,30,3
1649789220949,MATH 170A,A01,083459,Nie; Jiawang,20,0,30,10
1649789220949,MATH 170A,A02,083460,Nie; Jiawang,28,0,30,2
1649789220949,MATH 170A,A03,083461,Nie; Jiawang,30,0,30,0
1649789226973,MATH 193B,A01,083463,Staff,25,0,30,5
1649789226973,MATH 193B,A02,083464,Staff,28,0,30,2
1649789226973,MATH 193B,A03,083465,Staff,30,0,30,0
1649789233032,COGS 2,A01,083966,Boyle; Mary E. T.,28,0,30,2
1649789239055,COGS 9,A01,083968,Staff,59,0,60,1
1649789245097,COGS 14B,A01,083970,Staff,49,0,50,1
1649789251121,COGS 100,A01,083972,Staff,58,0,60,2
1649789263184,COGS 101C,A01,083976,Staff,29,0,30,1
1649789269211,COGS 102A,A01,083978,Johnson; Christine M.,29,0,30,1
1649789275235,COGS 107B,A01,083980,Staff,46,0,50,4
1649789281267,COGS 115,A01,083982,Staff,27,0,30,3
1649789287295,COGS 118B,A01,083367,Staff,21,0,40,19
1649789293318,COGS 172,A01,083984,Provenzano; Emily Kara,25,0,30,5
1649789299351,COGS 177,A00,083368,Staff,19,0,30,11
1649789305391,COGS 186,A01,083986,Staff,28,0,40,12
1649789311414,COGS 187A,A01,083988,Boyle; Mary E. T.,54,0,60,6
1649789317437,CSE 8A,A50,084003,Miranda; Gregory Joseph,12,0,15,3
1649789323461,CSE 11,A01,084005,Miranda; Gregory Joseph,52,0,55,3
1649789329491,CSE 20,A01,084007,Staff,17,0,20,3
1649789335517,CSE 21,A01,084009,Staff,47,0,50,3
1649789341541,CSE 30,A01,083370,Cao; Yingjun,34,0,40,6
1649789347580,CSE 100,A01,083372,Cao; Yingjun,35,0,40,5
1649789353606,CSE 101,A01,084011,Staff,22,0,40,18
1649789359630,CSE 141,A01,083374,Eldon; John,34,0,75,41
1649789365655,CSE 141L,A01,083376,Eldon; John,36,0,75,39
1649789371678,CSE 175,A01,084013,Kumar; Rakesh,25,0,25,0
1649789377704,CSE 190,A00,092508,Staff,15,0,15,0
1649789383738,ECE 5,A01,084049,Morris; Karcher William,18,0,20,2
1649789389762,ECE 100,A01,084051,Baghdadchi; Saharnaz,18,0,20,2
1649789389762,ECE 100,A02,091916,Baghdadchi; Saharnaz,19,0,20,1
1649789395792,ECE 101,A01,084053,Baghdadchi; Saharnaz,33,0,37,4
1649789395792,ECE 101,A02,084054,Baghdadchi; Saharnaz,37,0,37,0
1649789401816,ECE 107,A01,083390,Staff,35,0,40,5
1649789407929,ECE 148,A01,084056,Silberman; Jack,8,0,12,4
1649789413961,ECE 180,A00,083391,Abi Samra; Nicholas Camill,27,0,30,3
1649789413961,ECE 180,B00,083392,Abi Samra; Nicholas Camill,26,0,30,4
1649789419985,MATH 10B,A01,084110,Staff,25,0,30,5
1649789419985,MATH 10B,A02,084111,Staff,30,0,30,0
1649789419985,MATH 10B,A03,084112,Staff,30,0,30,0
1649789426013,MATH 10C,A01,083443,Staff,26,0,30,4
1649789426013,MATH 10C,A02,083444,Staff,26,0,30,4
1649789426013,MATH 10C,B01,084114,Staff,28,0,30,2
1649789426013,MATH 10C,B02,084115,Staff,30,0,30,0
1649789432042,MATH 18,A01,084117,Harel; Guershon,28,0,30,2
1649789432042,MATH 18,A02,084119,Harel; Guershon,29,0,30,1
1649789432042,MATH 18,A03,084120,Harel; Guershon,30,0,30,0
1649789432042,MATH 18,A04,084121,Harel; Guershon,30,0,30,0
1649789438075,MATH 20B,A01,084124,Um; Ko Woon,34,0,35,1
1649789438075,MATH 20B,B01,084126,Um; Ko Woon,35,0,35,0
1649789444111,MATH 20C,A01,083446,Hammock; Frances H,29,0,30,1
1649789444111,MATH 20C,A02,083447,Hammock; Frances H,30,0,30,0
1649789444111,MATH 20C,A03,083448,Hammock; Frances H,30,0,30,0
1649789444111,MATH 20C,A04,083449,Hammock; Frances H,30,0,30,0
1649789444111,MATH 20C,B01,083451,Hammock; Frances H,30,0,30,0
1649789444111,MATH 20C,B02,083452,Hammock; Frances H,30,0,30,0
1649789444111,MATH 20C,B03,083453,Hammock; Frances H,30,0,30,0
1649789444111,MATH 20C,B04,083454,Hammock; Frances H,30,0,30,0
1649789450141,MATH 20D,A01,084128,Staff,30,0,30,0
1649789450141,MATH 20D,A02,084129,Staff,30,0,30,0
1649789450141,MATH 20D,A03,084130,Staff,29,0,30,1
1649789450141,MATH 20D,B01,084133,Staff,30,0,30,0
1649789450141,MATH 20D,B02,084134,Staff,30,0,30,0
1649789450141,MATH 20D,B03,084135,Staff,30,0,30,0
1649789456169,MATH 20E,A01,084138,Staff,29,0,30,1
1649789456169,MATH 20E,A02,084139,Staff,29,0,30,1
1649789456169,MATH 20E,A03,084140,Staff,30,0,30,0
1649789456169,MATH 20E,A04,084141,Staff,30,0,30,0
1649789462202,MATH 102,A01,084143,Harel; Guershon,27,0,30,3
1649789462202,MATH 102,A02,084144,Harel; Guershon,29,0,30,1
1649789468240,MATH 103B,A01,083456,Staff,18,0,30,12
1649789468240,MATH 103B,A02,083457,Staff,28,0,30,2
1649789474267,MATH 109,A01,084146,Salehi Golsefidy; Alireza,30,0,30,0
1649789474267,MATH 109,A02,084147,Salehi Golsefidy; Alireza,29,0,30,1
1649789480298,MATH 120A,A01,085445,Eggers; John Dietrich,32,0,35,3
1649789480298,MATH 120A,A02,085446,Eggers; John Dietrich,33,0,35,2
1649789486320,MATH 142B,A01,084149,Verstraete; Jacques Allan,26,0,30,4
1649789486320,MATH 142B,A02,084150,Verstraete; Jacques Allan,27,0,30,3
1649789492346,MATH 170A,A01,083459,Nie; Jiawang,20,0,30,10
1649789492346,MATH 170A,A02,083460,Nie; Jiawang,28,0,30,2
1649789492346,MATH 170A,A03,083461,Nie; Jiawang,30,0,30,0
1649789498369,MATH 193B,A01,083463,Staff,25,0,30,5
1649789498369,MATH 193B,A02,083464,Staff,28,0,30,2
1649789498369,MATH 193B,A03,083465,Staff,30,0,30,0
1649789504449,COGS 2,A01,083966,Boyle; Mary E. T.,28,0,30,2
1649789510481,COGS 9,A01,083968,Staff,59,0,60,1
1649789516511,COGS 14B,A01,083970,Staff,49,0,50,1
1649789522534,COGS 100,A01,083972,Staff,58,0,60,2
1649789534589,COGS 101C,A01,083976,Staff,29,0,30,1
1649789540613,COGS 102A,A01,083978,Johnson; Christine M.,29,0,30,1
1649789546640,COGS 107B,A01,083980,Staff,46,0,50,4
1649789552663,COGS 115,A01,083982,Staff,27,0,30,3
1649789558690,COGS 118B,A01,083367,Staff,21,0,40,19
1649789564725,COGS 172,A01,083984,Provenzano; Emily Kara,25,0,30,5
1649789570750,COGS 177,A00,083368,Staff,19,0,30,11
1649789576774,COGS 186,A01,083986,Staff,28,0,40,12
1649789593731,COGS 187A,A01,083988,Boyle; Mary E. T.,53,0,60,7
1649789599756,CSE 8A,A50,084003,Miranda; Gregory Joseph,12,0,15,3
1649789605779,CSE 11,A01,084005,Miranda; Gregory Joseph,52,0,55,3
1649789611812,CSE 20,A01,084007,Staff,17,0,20,3
1649789617836,CSE 21,A01,084009,Staff,47,0,50,3
1649789623863,CSE 30,A01,083370,Cao; Yingjun,34,0,40,6
1649789629889,CSE 100,A01,083372,Cao; Yingjun,35,0,40,5
1649789635911,CSE 101,A01,084011,Staff,22,0,40,18
1649789641943,CSE 141,A01,083374,Eldon; John,33,0,75,42
1649789647967,CSE 141L,A01,083376,Eldon; John,35,0,75,40
1649789653994,CSE 175,A01,084013,Kumar; Rakesh,25,0,25,0
1649789660017,CSE 190,A00,092508,Staff,15,0,15,0
1649789666041,ECE 5,A01,084049,Morris; Karcher William,18,0,20,2
1649789672065,ECE 100,A01,084051,Baghdadchi; Saharnaz,18,0,20,2
1649789672065,ECE 100,A02,091916,Baghdadchi; Saharnaz,19,0,20,1
1649789678089,ECE 101,A01,084053,Baghdadchi; Saharnaz,33,0,37,4
1649789678089,ECE 101,A02,084054,Baghdadchi; Saharnaz,37,0,37,0
1649789684116,ECE 107,A01,083390,Staff,35,0,40,5
1649789690140,ECE 148,A01,084056,Silberman; Jack,8,0,12,4
1649789696163,ECE 180,A00,083391,Abi Samra; Nicholas Camill,27,0,30,3
1649789696163,ECE 180,B00,083392,Abi Samra; Nicholas Camill,26,0,30,4
1649789702203,MATH 10B,A01,084110,Staff,25,0,30,5
1649789702203,MATH 10B,A02,084111,Staff,30,0,30,0
1649789702203,MATH 10B,A03,084112,Staff,30,0,30,0
1649789708226,MATH 10C,A01,083443,Staff,26,0,30,4
1649789708226,MATH 10C,A02,083444,Staff,26,0,30,4
1649789708226,MATH 10C,B01,084114,Staff,28,0,30,2
1649789708226,MATH 10C,B02,084115,Staff,30,0,30,0
1649789714249,MATH 18,A01,084117,Harel; Guershon,28,0,30,2
1649789714249,MATH 18,A02,084119,Harel; Guershon,29,0,30,1
1649789714249,MATH 18,A03,084120,Harel; Guershon,30,0,30,0
1649789714249,MATH 18,A04,084121,Harel; Guershon,30,0,30,0
1649789720287,MATH 20B,A01,084124,Um; Ko Woon,34,0,35,1
1649789720287,MATH 20B,B01,084126,Um; Ko Woon,35,0,35,0
1649789726318,MATH 20C,A01,083446,Hammock; Frances H,29,0,30,1
1649789726318,MATH 20C,A02,083447,Hammock; Frances H,30,0,30,0
1649789726318,MATH 20C,A03,083448,Hammock; Frances H,30,0,30,0
1649789726318,MATH 20C,A04,083449,Hammock; Frances H,30,0,30,0
1649789726318,MATH 20C,B01,083451,Hammock; Frances H,30,0,30,0
1649789726318,MATH 20C,B02,083452,Hammock; Frances H,30,0,30,0
1649789726318,MATH 20C,B03,083453,Hammock; Frances H,30,0,30,0
1649789726318,MATH 20C,B04,083454,Hammock; Frances H,30,0,30,0
1649789732341,MATH 20D,A01,084128,Staff,30,0,30,0
1649789732341,MATH 20D,A02,084129,Staff,30,0,30,0
1649789732341,MATH 20D,A03,084130,Staff,29,0,30,1
1649789732341,MATH 20D,B01,084133,Staff,30,0,30,0
1649789732341,MATH 20D,B02,084134,Staff,30,0,30,0
1649789732341,MATH 20D,B03,084135,Staff,30,0,30,0
1649789738367,MATH 20E,A01,084138,Staff,29,0,30,1
1649789738367,MATH 20E,A02,084139,Staff,29,0,30,1
1649789738367,MATH 20E,A03,084140,Staff,30,0,30,0
1649789738367,MATH 20E,A04,084141,Staff,30,0,30,0
1649789744400,MATH 102,A01,084143,Harel; Guershon,27,0,30,3
1649789744400,MATH 102,A02,084144,Harel; Guershon,29,0,30,1
1649789750424,MATH 103B,A01,083456,Staff,18,0,30,12
1649789750424,MATH 103B,A02,083457,Staff,28,0,30,2
1649789756448,MATH 109,A01,084146,Salehi Golsefidy; Alireza,30,0,30,0
1649789756448,MATH 109,A02,084147,Salehi Golsefidy; Alireza,29,0,30,1
1649789762471,MATH 120A,A01,085445,Eggers; John Dietrich,32,0,35,3
1649789762471,MATH 120A,A02,085446,Eggers; John Dietrich,33,0,35,2
1649789768504,MATH 142B,A01,084149,Verstraete; Jacques Allan,26,0,30,4
1649789768504,MATH 142B,A02,084150,Verstraete; Jacques Allan,27,0,30,3
1649789774531,MATH 170A,A01,083459,Nie; Jiawang,20,0,30,10
1649789774531,MATH 170A,A02,083460,Nie; Jiawang,28,0,30,2
1649789774531,MATH 170A,A03,083461,Nie; Jiawang,30,0,30,0
1649789780558,MATH 193B,A01,083463,Staff,24,0,30,6
1649789780558,MATH 193B,A02,083464,Staff,27,0,30,3
1649789780558,MATH 193B,A03,083465,Staff,30,0,30,0
1649789786634,COGS 2,A01,083966,Boyle; Mary E. T.,28,0,30,2
1649789792663,COGS 9,A01,083968,Staff,59,0,60,1
1649789798685,COGS 14B,A01,083970,Staff,49,0,50,1
1649789804705,COGS 100,A01,083972,Staff,58,0,60,2
1649789816758,COGS 101C,A01,083976,Staff,29,0,30,1
1649789822780,COGS 102A,A01,083978,Johnson; Christine M.,29,0,30,1
1649789828812,COGS 107B,A01,083980,Staff,46,0,50,4
1649789834873,COGS 115,A01,083982,Staff,27,0,30,3
1649789840896,COGS 118B,A01,083367,Staff,21,0,40,19
1649789846937,COGS 172,A01,083984,Provenzano; Emily Kara,25,0,30,5
1649789852961,COGS 177,A00,083368,Staff,18,0,30,12
1649789858987,COGS 186,A01,083986,Staff,28,0,40,12
1649789865012,COGS 187A,A01,083988,Boyle; Mary E. T.,53,0,60,7
1649789871033,CSE 8A,A50,084003,Miranda; Gregory Joseph,12,0,15,3
1649789877059,CSE 11,A01,084005,Miranda; Gregory Joseph,52,0,55,3
1649789883088,CSE 20,A01,084007,Staff,17,0,20,3
1649789889114,CSE 21,A01,084009,Staff,47,0,50,3
1649789895143,CSE 30,A01,083370,Cao; Yingjun,33,0,40,7
1649789901166,CSE 100,A01,083372,Cao; Yingjun,35,0,40,5
1649789907189,CSE 101,A01,084011,Staff,22,0,40,18
1649789913221,CSE 141,A01,083374,Eldon; John,33,0,75,42
1649789919256,CSE 141L,A01,083376,Eldon; John,35,0,75,40
1649789925279,CSE 175,A01,084013,Kumar; Rakesh,25,0,25,0
1649789931302,CSE 190,A00,092508,Staff,15,0,15,0
1649789937331,ECE 5,A01,084049,Morris; Karcher William,18,0,20,2
1649789943355,ECE 100,A01,084051,Baghdadchi; Saharnaz,18,0,20,2
1649789943355,ECE 100,A02,091916,Baghdadchi; Saharnaz,19,0,20,1
1649789949382,ECE 101,A01,084053,Baghdadchi; Saharnaz,33,0,37,4
1649789949382,ECE 101,A02,084054,Baghdadchi; Saharnaz,37,0,37,0
1649789955405,ECE 107,A01,083390,Staff,35,0,40,5
1649789961430,ECE 148,A01,084056,Silberman; Jack,8,0,12,4
1649789967457,ECE 180,A00,083391,Abi Samra; Nicholas Camill,27,0,30,3
1649789967457,ECE 180,B00,083392,Abi Samra; Nicholas Camill,26,0,30,4
1649789973498,MATH 10B,A01,084110,Staff,25,0,30,5
1649789973498,MATH 10B,A02,084111,Staff,30,0,30,0
1649789973498,MATH 10B,A03,084112,Staff,30,0,30,0
1649789979535,MATH 10C,A01,083443,Staff,26,0,30,4
1649789979535,MATH 10C,A02,083444,Staff,26,0,30,4
1649789979535,MATH 10C,B01,084114,Staff,28,0,30,2
1649789979535,MATH 10C,B02,084115,Staff,30,0,30,0
1649789985560,MATH 18,A01,084117,Harel; Guershon,28,0,30,2
1649789985560,MATH 18,A02,084119,Harel; Guershon,29,0,30,1
1649789985560,MATH 18,A03,084120,Harel; Guershon,30,0,30,0
1649789985560,MATH 18,A04,084121,Harel; Guershon,30,0,30,0
1649789991609,MATH 20B,A01,084124,Um; Ko Woon,34,0,35,1
1649789991609,MATH 20B,B01,084126,Um; Ko Woon,35,0,35,0
1649789997631,MATH 20C,A01,083446,Hammock; Frances H,29,0,30,1
1649789997631,MATH 20C,A02,083447,Hammock; Frances H,30,0,30,0
1649789997631,MATH 20C,A03,083448,Hammock; Frances H,30,0,30,0
1649789997631,MATH 20C,A04,083449,Hammock; Frances H,30,0,30,0
1649789997631,MATH 20C,B01,083451,Hammock; Frances H,30,0,30,0
1649789997631,MATH 20C,B02,083452,Hammock; Frances H,30,0,30,0
1649789997631,MATH 20C,B03,083453,Hammock; Frances H,30,0,30,0
1649789997631,MATH 20C,B04,083454,Hammock; Frances H,30,0,30,0
1649790003654,MATH 20D,A01,084128,Staff,30,0,30,0
1649790003654,MATH 20D,A02,084129,Staff,30,0,30,0
1649790003654,MATH 20D,A03,084130,Staff,29,0,30,1
1649790003654,MATH 20D,B01,084133,Staff,29,0,30,1
1649790003654,MATH 20D,B02,084134,Staff,30,0,30,0
1649790003654,MATH 20D,B03,084135,Staff,30,0,30,0
1649790009688,MATH 20E,A01,084138,Staff,29,0,30,1
1649790009688,MATH 20E,A02,084139,Staff,29,0,30,1
1649790009688,MATH 20E,A03,084140,Staff,30,0,30,0
1649790009688,MATH 20E,A04,084141,Staff,30,0,30,0
1649790015821,MATH 102,A01,084143,Harel; Guershon,27,0,30,3
1649790015821,MATH 102,A02,084144,Harel; Guershon,29,0,30,1
1649790021845,MATH 103B,A01,083456,Staff,17,0,30,13
1649790021845,MATH 103B,A02,083457,Staff,28,0,30,2
1649790027869,MATH 109,A01,084146,Salehi Golsefidy; Alireza,30,0,30,0
1649790027869,MATH 109,A02,084147,Salehi Golsefidy; Alireza,28,0,30,2
1649790033901,MATH 120A,A01,085445,Eggers; John Dietrich,32,0,35,3
1649790033901,MATH 120A,A02,085446,Eggers; John Dietrich,33,0,35,2
1649790039935,MATH 142B,A01,084149,Verstraete; Jacques Allan,26,0,30,4
1649790039935,MATH 142B,A02,084150,Verstraete; Jacques Allan,27,0,30,3
1649790045964,MATH 170A,A01,083459,Nie; Jiawang,19,0,30,11
1649790045964,MATH 170A,A02,083460,Nie; Jiawang,28,0,30,2
1649790045964,MATH 170A,A03,083461,Nie; Jiawang,30,0,30,0
1649790051991,MATH 193B,A01,083463,Staff,24,0,30,6
1649790051991,MATH 193B,A02,083464,Staff,27,0,30,3
1649790051991,MATH 193B,A03,083465,Staff,30,0,30,0
1649790058051,COGS 2,A01,083966,Boyle; Mary E. T.,28,0,30,2
1649790064076,COGS 9,A01,083968,Staff,59,0,60,1
1649790070099,COGS 14B,A01,083970,Staff,49,0,50,1
1649790076126,COGS 100,A01,083972,Staff,58,0,60,2
1649790088208,COGS 101C,A01,083976,Staff,29,0,30,1
1649790094240,COGS 102A,A01,083978,Johnson; Christine M.,29,0,30,1
1649790100275,COGS 107B,A01,083980,Staff,46,0,50,4
1649790106299,COGS 115,A01,083982,Staff,27,0,30,3
1649790112324,COGS 118B,A01,083367,Staff,20,0,40,20
1649790118348,COGS 172,A01,083984,Provenzano; Emily Kara,25,0,30,5
1649790124375,COGS 177,A00,083368,Staff,18,0,30,12
1649790130406,COGS 186,A01,083986,Staff,28,0,40,12
1649790136433,COGS 187A,A01,083988,Boyle; Mary E. T.,53,0,60,7
1649790142463,CSE 8A,A50,084003,Miranda; Gregory Joseph,12,0,15,3
1649790148489,CSE 11,A01,084005,Miranda; Gregory Joseph,52,0,55,3
1649790154516,CSE 20,A01,084007,Staff,17,0,20,3
1649790160540,CSE 21,A01,084009,Staff,47,0,50,3
1649790166562,CSE 30,A01,083370,Cao; Yingjun,33,0,40,7
1649790172587,CSE 100,A01,083372,Cao; Yingjun,34,0,40,6
1649790178616,CSE 101,A01,084011,Staff,21,0,40,19
1649790184640,CSE 141,A01,083374,Eldon; John,33,0,75,42
1649790190678,CSE 141L,A01,083376,Eldon; John,35,0,75,40
1649790196710,CSE 175,A01,084013,Kumar; Rakesh,25,0,25,0
1649790202745,CSE 190,A00,092508,Staff,15,0,15,0
1649790208772,ECE 5,A01,084049,Morris; Karcher William,18,0,20,2
1649790214798,ECE 100,A01,084051,Baghdadchi; Saharnaz,18,0,20,2
1649790214798,ECE 100,A02,091916,Baghdadchi; Saharnaz,19,0,20,1
1649790220824,ECE 101,A01,084053,Baghdadchi; Saharnaz,33,0,37,4
1649790220824,ECE 101,A02,084054,Baghdadchi; Saharnaz,37,0,37,0
1649790226851,ECE 107,A01,083390,Staff,35,0,40,5
1649790232892,ECE 148,A01,084056,Silberman; Jack,8,0,12,4
1649790238914,ECE 180,A00,083391,Abi Samra; Nicholas Camill,27,0,30,3
1649790238914,ECE 180,B00,083392,Abi Samra; Nicholas Camill,26,0,30,4
1649790244948,MATH 10B,A01,084110,Staff,25,0,30,5
1649790244948,MATH 10B,A02,084111,Staff,30,0,30,0
1649790244948,MATH 10B,A03,084112,Staff,30,0,30,0
1649790250973,MATH 10C,A01,083443,Staff,26,0,30,4
1649790250973,MATH 10C,A02,083444,Staff,26,0,30,4
1649790250973,MATH 10C,B01,084114,Staff,28,0,30,2
1649790250973,MATH 10C,B02,084115,Staff,30,0,30,0
1649790257011,MATH 18,A01,084117,Harel; Guershon,28,0,30,2
1649790257011,MATH 18,A02,084119,Harel; Guershon,29,0,30,1
1649790257011,MATH 18,A03,084120,Harel; Guershon,30,0,30,0
1649790257011,MATH 18,A04,084121,Harel; Guershon,30,0,30,0
1649790263035,MATH 20B,A01,084124,Um; Ko Woon,34,0,35,1
1649790263035,MATH 20B,B01,084126,Um; Ko Woon,35,0,35,0
1649790269068,MATH 20C,A01,083446,Hammock; Frances H,29,0,30,1
1649790269068,MATH 20C,A02,083447,Hammock; Frances H,30,0,30,0
1649790269068,MATH 20C,A03,083448,Hammock; Frances H,30,0,30,0
1649790269068,MATH 20C,A04,083449,Hammock; Frances H,30,0,30,0
1649790269068,MATH 20C,B01,083451,Hammock; Frances H,30,0,30,0
1649790269068,MATH 20C,B02,083452,Hammock; Frances H,30,0,30,0
1649790269068,MATH 20C,B03,083453,Hammock; Frances H,30,0,30,0
1649790269068,MATH 20C,B04,083454,Hammock; Frances H,30,0,30,0
1649790275108,MATH 20D,A01,084128,Staff,30,0,30,0
1649790275108,MATH 20D,A02,084129,Staff,30,0,30,0
1649790275108,MATH 20D,A03,084130,Staff,29,0,30,1
1649790275108,MATH 20D,B01,084133,Staff,29,0,30,1
1649790275108,MATH 20D,B02,084134,Staff,30,0,30,0
1649790275108,MATH 20D,B03,084135,Staff,30,0,30,0
1649790281136,MATH 20E,A01,084138,Staff,29,0,30,1
1649790281136,MATH 20E,A02,084139,Staff,29,0,30,1
1649790281136,MATH 20E,A03,084140,Staff,30,0,30,0
1649790281136,MATH 20E,A04,084141,Staff,30,0,30,0
1649790287162,MATH 102,A01,084143,Harel; Guershon,27,0,30,3
1649790287162,MATH 102,A02,084144,Harel; Guershon,29,0,30,1
1649790293185,MATH 103B,A01,083456,Staff,17,0,30,13
1649790293185,MATH 103B,A02,083457,Staff,28,0,30,2
1649790299212,MATH 109,A01,084146,Salehi Golsefidy; Alireza,30,0,30,0
1649790299212,MATH 109,A02,084147,Salehi Golsefidy; Alireza,28,0,30,2
1649790305241,MATH 120A,A01,085445,Eggers; John Dietrich,32,0,35,3
1649790305241,MATH 120A,A02,085446,Eggers; John Dietrich,33,0,35,2
1649790311277,MATH 142B,A01,084149,Verstraete; Jacques Allan,26,0,30,4
1649790311277,MATH 142B,A02,084150,Verstraete; Jacques Allan,27,0,30,3
1649790317302,MATH 170A,A01,083459,Nie; Jiawang,19,0,30,11
1649790317302,MATH 170A,A02,083460,Nie; Jiawang,28,0,30,2
1649790317302,MATH 170A,A03,083461,Nie; Jiawang,30,0,30,0
1649790323325,MATH 193B,A01,083463,Staff,24,0,30,6
1649790323325,MATH 193B,A02,083464,Staff,27,0,30,3
1649790323325,MATH 193B,A03,083465,Staff,30,0,30,0
1649790329374,COGS 2,A01,083966,Boyle; Mary E. T.,28,0,30,2
1649790335400,COGS 9,A01,083968,Staff,59,0,60,1
1649790341438,COGS 14B,A01,083970,Staff,49,0,50,1
1649790347460,COGS 100,A01,083972,Staff,58,0,60,2
1649790359510,COGS 101C,A01,083976,Staff,29,0,30,1
1649790365532,COGS 102A,A01,083978,Johnson; Christine M.,29,0,30,1
1649790371554,COGS 107B,A01,083980,Staff,46,0,50,4
1649790377598,COGS 115,A01,083982,Staff,27,0,30,3
1649790383626,COGS 118B,A01,083367,Staff,20,0,40,20
1649790389652,COGS 172,A01,083984,Provenzano; Emily Kara,25,0,30,5
1649790395675,COGS 177,A00,083368,Staff,18,0,30,12
1649790401701,COGS 186,A01,083986,Staff,28,0,40,12
1649790407727,COGS 187A,A01,083988,Boyle; Mary E. T.,53,0,60,7
1649790413767,CSE 8A,A50,084003,Miranda; Gregory Joseph,12,0,15,3
1649790419794,CSE 11,A01,084005,Miranda; Gregory Joseph,52,0,55,3
1649790425821,CSE 20,A01,084007,Staff,17,0,20,3
1649790431846,CSE 21,A01,084009,Staff,47,0,50,3
1649790437869,CSE 30,A01,083370,Cao; Yingjun,33,0,40,7
1649790443893,CSE 100,A01,083372,Cao; Yingjun,35,0,40,5
1649790449917,CSE 101,A01,084011,Staff,21,0,40,19
1649790455944,CSE 141,A01,083374,Eldon; John,33,0,75,42
1649790461971,CSE 141L,A01,083376,Eldon; John,35,0,75,40
1649790468003,CSE 175,A01,084013,Kumar; Rakesh,25,0,25,0
1649790474026,CSE 190,A00,092508,Staff,15,0,15,0
1649790480049,ECE 5,A01,084049,Morris; Karcher William,18,0,20,2
1649790486074,ECE 100,A01,084051,Baghdadchi; Saharnaz,18,0,20,2
1649790486074,ECE 100,A02,091916,Baghdadchi; Saharnaz,19,0,20,1
1649790492104,ECE 101,A01,084053,Baghdadchi; Saharnaz,33,0,37,4
1649790492104,ECE 101,A02,084054,Baghdadchi; Saharnaz,37,0,37,0
1649790498128,ECE 107,A01,083390,Staff,35,0,40,5
1649790504166,ECE 148,A01,084056,Silberman; Jack,8,0,12,4
1649790510196,ECE 180,A00,083391,Abi Samra; Nicholas Camill,27,0,30,3
1649790510196,ECE 180,B00,083392,Abi Samra; Nicholas Camill,26,0,30,4
1649790516218,MATH 10B,A01,084110,Staff,25,0,30,5
1649790516218,MATH 10B,A02,084111,Staff,30,0,30,0
1649790516218,MATH 10B,A03,084112,Staff,30,0,30,0
1649790522242,MATH 10C,A01,083443,Staff,26,0,30,4
1649790522242,MATH 10C,A02,083444,Staff,26,0,30,4
1649790522242,MATH 10C,B01,084114,Staff,28,0,30,2
1649790522242,MATH 10C,B02,084115,Staff,30,0,30,0
1649790528269,MATH 18,A01,084117,Harel; Guershon,28,0,30,2
1649790528269,MATH 18,A02,084119,Harel; Guershon,29,0,30,1
1649790528269,MATH 18,A03,084120,Harel; Guershon,30,0,30,0
1649790528269,MATH 18,A04,084121,Harel; Guershon,30,0,30,0
1649790534292,MATH 20B,A01,084124,Um; Ko Woon,34,0,35,1
1649790534292,MATH 20B,B01,084126,Um; Ko Woon,35,0,35,0
1649790540329,MATH 20C,A01,083446,Hammock; Frances H,29,0,30,1
1649790540329,MATH 20C,A02,083447,Hammock; Frances H,30,0,30,0
1649790540329,MATH 20C,A03,083448,Hammock; Frances H,30,0,30,0
1649790540329,MATH 20C,A04,083449,Hammock; Frances H,30,0,30,0
1649790540329,MATH 20C,B01,083451,Hammock; Frances H,30,0,30,0
1649790540329,MATH 20C,B02,083452,Hammock; Frances H,30,0,30,0
1649790540329,MATH 20C,B03,083453,Hammock; Frances H,30,0,30,0
1649790540329,MATH 20C,B04,083454,Hammock; Frances H,30,0,30,0
1649790546360,MATH 20D,A01,084128,Staff,30,0,30,0
1649790546360,MATH 20D,A02,084129,Staff,30,0,30,0
1649790546360,MATH 20D,A03,084130,Staff,29,0,30,1
1649790546360,MATH 20D,B01,084133,Staff,29,0,30,1
1649790546360,MATH 20D,B02,084134,Staff,30,0,30,0
1649790546360,MATH 20D,B03,084135,Staff,30,0,30,0
1649790552389,MATH 20E,A01,084138,Staff,29,0,30,1
1649790552389,MATH 20E,A02,084139,Staff,29,0,30,1
1649790552389,MATH 20E,A03,084140,Staff,30,0,30,0
1649790552389,MATH 20E,A04,084141,Staff,30,0,30,0
1649790558419,MATH 102,A01,084143,Harel; Guershon,27,0,30,3
1649790558419,MATH 102,A02,084144,Harel; Guershon,29,0,30,1
1649790564446,MATH 103B,A01,083456,Staff,17,0,30,13
1649790564446,MATH 103B,A02,083457,Staff,28,0,30,2
1649790570479,MATH 109,A01,084146,Salehi Golsefidy; Alireza,30,0,30,0
1649790570479,MATH 109,A02,084147,Salehi Golsefidy; Alireza,28,0,30,2
1649790576506,MATH 120A,A01,085445,Eggers; John Dietrich,32,0,35,3
1649790576506,MATH 120A,A02,085446,Eggers; John Dietrich,33,0,35,2
1649790582535,MATH 142B,A01,084149,Verstraete; Jacques Allan,26,0,30,4
1649790582535,MATH 142B,A02,084150,Verstraete; Jacques Allan,27,0,30,3
1649790588572,MATH 170A,A01,083459,Nie; Jiawang,19,0,30,11
1649790588572,MATH 170A,A02,083460,Nie; Jiawang,28,0,30,2
1649790588572,MATH 170A,A03,083461,Nie; Jiawang,30,0,30,0
1649790594599,MATH 193B,A01,083463,Staff,24,0,30,6
1649790594599,MATH 193B,A02,083464,Staff,27,0,30,3
1649790594599,MATH 193B,A03,083465,Staff,30,0,30,0
1649790600658,COGS 2,A01,083966,Boyle; Mary E. T.,28,0,30,2
1649790606783,COGS 9,A01,083968,Staff,59,0,60,1
1649790612805,COGS 14B,A01,083970,Staff,49,0,50,1
1649790618837,COGS 100,A01,083972,Staff,58,0,60,2
1649790630885,COGS 101C,A01,083976,Staff,29,0,30,1
1649790636912,COGS 102A,A01,083978,Johnson; Christine M.,29,0,30,1
1649790642939,COGS 107B,A01,083980,Staff,46,0,50,4
1649790648974,COGS 115,A01,083982,Staff,27,0,30,3
1649790655001,COGS 118B,A01,083367,Staff,19,0,40,21
1649790661026,COGS 172,A01,083984,Provenzano; Emily Kara,25,0,30,5
1649790667050,COGS 177,A00,083368,Staff,18,0,30,12
1649790673073,COGS 186,A01,083986,Staff,28,0,40,12
1649790679105,COGS 187A,A01,083988,Boyle; Mary E. T.,53,0,60,7
1649790685128,CSE 8A,A50,084003,Miranda; Gregory Joseph,12,0,15,3
1649790691153,CSE 11,A01,084005,Miranda; Gregory Joseph,52,0,55,3
1649790697180,CSE 20,A01,084007,Staff,17,0,20,3
1649790703229,CSE 21,A01,084009,Staff,47,0,50,3
1649790709252,CSE 30,A01,083370,Cao; Yingjun,33,0,40,7
1649790715291,CSE 100,A01,083372,Cao; Yingjun,35,0,40,5
1649790721316,CSE 101,A01,084011,Staff,21,0,40,19
1649790727342,CSE 141,A01,083374,Eldon; John,31,0,75,44
1649790733371,CSE 141L,A01,083376,Eldon; John,32,0,75,43
1649790739397,CSE 175,A01,084013,Kumar; Rakesh,25,0,25,0
1649790745422,CSE 190,A00,092508,Staff,15,0,15,0
1649790751449,ECE 5,A01,084049,Morris; Karcher William,18,0,20,2
1649790757476,ECE 100,A01,084051,Baghdadchi; Saharnaz,18,0,20,2
1649790757476,ECE 100,A02,091916,Baghdadchi; Saharnaz,19,0,20,1
1649790763508,ECE 101,A01,084053,Baghdadchi; Saharnaz,33,0,37,4
1649790763508,ECE 101,A02,084054,Baghdadchi; Saharnaz,37,0,37,0
1649790769541,ECE 107,A01,083390,Staff,35,0,40,5
1649790775564,ECE 148,A01,084056,Silberman; Jack,8,0,12,4
1649790781604,ECE 180,A00,083391,Abi Samra; Nicholas Camill,27,0,30,3
1649790781604,ECE 180,B00,083392,Abi Samra; Nicholas Camill,26,0,30,4
1649790787632,MATH 10B,A01,084110,Staff,25,0,30,5
1649790787632,MATH 10B,A02,084111,Staff,30,0,30,0
1649790787632,MATH 10B,A03,084112,Staff,30,0,30,0
1649790793656,MATH 10C,A01,083443,Staff,26,0,30,4
1649790793656,MATH 10C,A02,083444,Staff,26,0,30,4
1649790793656,MATH 10C,B01,084114,Staff,28,0,30,2
1649790793656,MATH 10C,B02,084115,Staff,30,0,30,0
1649790799687,MATH 18,A01,084117,Harel; Guershon,28,0,30,2
1649790799687,MATH 18,A02,084119,Harel; Guershon,29,0,30,1
1649790799687,MATH 18,A03,084120,Harel; Guershon,30,0,30,0
1649790799687,MATH 18,A04,084121,Harel; Guershon,30,0,30,0
1649790805710,MATH 20B,A01,084124,Um; Ko Woon,34,0,35,1
1649790805710,MATH 20B,B01,084126,Um; Ko Woon,35,0,35,0
1649790811735,MATH 20C,A01,083446,Hammock; Frances H,29,0,30,1
1649790811735,MATH 20C,A02,083447,Hammock; Frances H,30,0,30,0
1649790811735,MATH 20C,A03,083448,Hammock; Frances H,30,0,30,0
1649790811735,MATH 20C,A04,083449,Hammock; Frances H,30,0,30,0
1649790811735,MATH 20C,B01,083451,Hammock; Frances H,30,0,30,0
1649790811735,MATH 20C,B02,083452,Hammock; Frances H,30,0,30,0
1649790811735,MATH 20C,B03,083453,Hammock; Frances H,30,0,30,0
1649790811735,MATH 20C,B04,083454,Hammock; Frances H,30,0,30,0
1649790817762,MATH 20D,A01,084128,Staff,30,0,30,0
1649790817762,MATH 20D,A02,084129,Staff,30,0,30,0
1649790817762,MATH 20D,A03,084130,Staff,29,0,30,1
1649790817762,MATH 20D,B01,084133,Staff,29,0,30,1
1649790817762,MATH 20D,B02,084134,Staff,30,0,30,0
1649790817762,MATH 20D,B03,084135,Staff,30,0,30,0
1649790823785,MATH 20E,A01,084138,Staff,29,0,30,1
1649790823785,MATH 20E,A02,084139,Staff,29,0,30,1
1649790823785,MATH 20E,A03,084140,Staff,30,0,30,0
1649790823785,MATH 20E,A04,084141,Staff,30,0,30,0
1649790829828,MATH 102,A01,084143,Harel; Guershon,27,0,30,3
1649790829828,MATH 102,A02,084144,Harel; Guershon,29,0,30,1
1649790835854,MATH 103B,A01,083456,Staff,17,0,30,13
1649790835854,MATH 103B,A02,083457,Staff,28,0,30,2
1649790841894,MATH 109,A01,084146,Salehi Golsefidy; Alireza,30,0,30,0
1649790841894,MATH 109,A02,084147,Salehi Golsefidy; Alireza,28,0,30,2
1649790847917,MATH 120A,A01,085445,Eggers; John Dietrich,32,0,35,3
1649790847917,MATH 120A,A02,085446,Eggers; John Dietrich,33,0,35,2
1649790853943,MATH 142B,A01,084149,Verstraete; Jacques Allan,26,0,30,4
1649790853943,MATH 142B,A02,084150,Verstraete; Jacques Allan,27,0,30,3
1649790859968,MATH 170A,A01,083459,Nie; Jiawang,19,0,30,11
1649790859968,MATH 170A,A02,083460,Nie; Jiawang,28,0,30,2
1649790859968,MATH 170A,A03,083461,Nie; Jiawang,30,0,30,0
1649790865991,MATH 193B,A01,083463,Staff,24,0,30,6
1649790865991,MATH 193B,A02,083464,Staff,27,0,30,3
1649790865991,MATH 193B,A03,083465,Staff,30,0,30,0
1649790872044,COGS 2,A01,083966,Boyle; Mary E. T.,28,0,30,2
1649790878067,COGS 9,A01,083968,Staff,59,0,60,1
1649790884094,COGS 14B,A01,083970,Staff,49,0,50,1
1649790890121,COGS 100,A01,083972,Staff,58,0,60,2
1649790902186,COGS 101C,A01,083976,Staff,29,0,30,1
1649790908237,COGS 102A,A01,083978,Johnson; Christine M.,29,0,30,1
1649790914263,COGS 107B,A01,083980,Staff,46,0,50,4
1649790920290,COGS 115,A01,083982,Staff,27,0,30,3
1649790926313,COGS 118B,A01,083367,Staff,19,0,40,21
1649790932338,COGS 172,A01,083984,Provenzano; Emily Kara,25,0,30,5
1649790938361,COGS 177,A00,083368,Staff,18,0,30,12
1649790944383,COGS 186,A01,083986,Staff,28,0,40,12
1649790950406,COGS 187A,A01,083988,Boyle; Mary E. T.,53,0,60,7
1649790956431,CSE 8A,A50,084003,Miranda; Gregory Joseph,12,0,15,3
1649790962460,CSE 11,A01,084005,Miranda; Gregory Joseph,52,0,55,3
1649790968486,CSE 20,A01,084007,Staff,17,0,20,3
1649790974512,CSE 21,A01,084009,Staff,47,0,50,3
1649790980542,CSE 30,A01,083370,Cao; Yingjun,33,0,40,7
1649790986568,CSE 100,A01,083372,Cao; Yingjun,35,0,40,5
1649790992590,CSE 101,A01,084011,Staff,21,0,40,19
1649790998614,CSE 141,A01,083374,Eldon; John,31,0,75,44
1649791004637,CSE 141L,A01,083376,Eldon; John,32,0,75,43
1649791010667,CSE 175,A01,084013,Kumar; Rakesh,25,0,25,0
1649791016694,CSE 190,A00,092508,Staff,15,0,15,0
1649791022721,ECE 5,A01,084049,Morris; Karcher William,18,0,20,2
1649791028744,ECE 100,A01,084051,Baghdadchi; Saharnaz,18,0,20,2
1649791028744,ECE 100,A02,091916,Baghdadchi; Saharnaz,19,0,20,1
1649791034766,ECE 101,A01,084053,Baghdadchi; Saharnaz,33,0,37,4
1649791034766,ECE 101,A02,084054,Baghdadchi; Saharnaz,37,0,37,0
1649791040792,ECE 107,A01,083390,Staff,35,0,40,5
1649791046815,ECE 148,A01,084056,Silberman; Jack,8,0,12,4
1649791052847,ECE 180,A00,083391,Abi Samra; Nicholas Camill,27,0,30,3
1649791052847,ECE 180,B00,083392,Abi Samra; Nicholas Camill,26,0,30,4
1649791058885,MATH 10B,A01,084110,Staff,25,0,30,5
1649791058885,MATH 10B,A02,084111,Staff,30,0,30,0
1649791058885,MATH 10B,A03,084112,Staff,30,0,30,0
1649791064914,MATH 10C,A01,083443,Staff,26,0,30,4
1649791064914,MATH 10C,A02,083444,Staff,26,0,30,4
1649791064914,MATH 10C,B01,084114,Staff,28,0,30,2
1649791064914,MATH 10C,B02,084115,Staff,30,0,30,0
1649791070948,MATH 18,A01,084117,Harel; Guershon,28,0,30,2
1649791070948,MATH 18,A02,084119,Harel; Guershon,29,0,30,1
1649791070948,MATH 18,A03,084120,Harel; Guershon,30,0,30,0
1649791070948,MATH 18,A04,084121,Harel; Guershon,30,0,30,0
1649791076976,MATH 20B,A01,084124,Um; Ko Woon,34,0,35,1
1649791076976,MATH 20B,B01,084126,Um; Ko Woon,35,0,35,0
1649791083006,MATH 20C,A01,083446,Hammock; Frances H,29,0,30,1
1649791083006,MATH 20C,A02,083447,Hammock; Frances H,30,0,30,0
1649791083006,MATH 20C,A03,083448,Hammock; Frances H,30,0,30,0
1649791083006,MATH 20C,A04,083449,Hammock; Frances H,30,0,30,0
1649791083006,MATH 20C,B01,083451,Hammock; Frances H,30,0,30,0
1649791083006,MATH 20C,B02,083452,Hammock; Frances H,30,0,30,0
1649791083006,MATH 20C,B03,083453,Hammock; Frances H,30,0,30,0
1649791083006,MATH 20C,B04,083454,Hammock; Frances H,30,0,30,0
1649791089035,MATH 20D,A01,084128,Staff,30,0,30,0
1649791089035,MATH 20D,A02,084129,Staff,30,0,30,0
1649791089035,MATH 20D,A03,084130,Staff,29,0,30,1
1649791089035,MATH 20D,B01,084133,Staff,29,0,30,1
1649791089035,MATH 20D,B02,084134,Staff,30,0,30,0
1649791089035,MATH 20D,B03,084135,Staff,30,0,30,0
1649791095060,MATH 20E,A01,084138,Staff,29,0,30,1
1649791095060,MATH 20E,A02,084139,Staff,29,0,30,1
1649791095060,MATH 20E,A03,084140,Staff,30,0,30,0
1649791095060,MATH 20E,A04,084141,Staff,30,0,30,0
1649791101086,MATH 102,A01,084143,Harel; Guershon,27,0,30,3
1649791101086,MATH 102,A02,084144,Harel; Guershon,29,0,30,1
1649791107110,MATH 103B,A01,083456,Staff,17,0,30,13
1649791107110,MATH 103B,A02,083457,Staff,28,0,30,2
1649791113135,MATH 109,A01,084146,Salehi Golsefidy; Alireza,30,0,30,0
1649791113135,MATH 109,A02,084147,Salehi Golsefidy; Alireza,28,0,30,2
1649791119158,MATH 120A,A01,085445,Eggers; John Dietrich,32,0,35,3
1649791119158,MATH 120A,A02,085446,Eggers; John Dietrich,33,0,35,2
1649791125183,MATH 142B,A01,084149,Verstraete; Jacques Allan,26,0,30,4
1649791125183,MATH 142B,A02,084150,Verstraete; Jacques Allan,27,0,30,3
1649791131223,MATH 170A,A01,083459,Nie; Jiawang,19,0,30,11
1649791131223,MATH 170A,A02,083460,Nie; Jiawang,28,0,30,2
1649791131223,MATH 170A,A03,083461,Nie; Jiawang,30,0,30,0
1649791137254,MATH 193B,A01,083463,Staff,24,0,30,6
1649791137254,MATH 193B,A02,083464,Staff,27,0,30,3
1649791137254,MATH 193B,A03,083465,Staff,30,0,30,0
1649791143312,COGS 2,A01,083966,Boyle; Mary E. T.,28,0,30,2
1649791149347,COGS 9,A01,083968,Staff,59,0,60,1
1649791155378,COGS 14B,A01,083970,Staff,49,0,50,1
1649791161409,COGS 100,A01,083972,Staff,58,0,60,2
1649791173474,COGS 101C,A01,083976,Staff,29,0,30,1
1649791179500,COGS 102A,A01,083978,Johnson; Christine M.,29,0,30,1
1649791185525,COGS 107B,A01,083980,Staff,46,0,50,4
1649791191556,COGS 115,A01,083982,Staff,27,0,30,3
1649791197580,COGS 118B,A01,083367,Staff,19,0,40,21
1649791203682,COGS 172,A01,083984,Provenzano; Emily Kara,25,0,30,5
1649791209707,COGS 177,A00,083368,Staff,18,0,30,12
1649791215732,COGS 186,A01,083986,Staff,28,0,40,12
1649791221757,COGS 187A,A01,083988,Boyle; Mary E. T.,53,0,60,7
1649791227783,CSE 8A,A50,084003,Miranda; Gregory Joseph,12,0,15,3
1649791233805,CSE 11,A01,084005,Miranda; Gregory Joseph,52,0,55,3
1649791239829,CSE 20,A01,084007,Staff,17,0,20,3
1649791245854,CSE 21,A01,084009,Staff,47,0,50,3
1649791251877,CSE 30,A01,083370,Cao; Yingjun,33,0,40,7
1649791257900,CSE 100,A01,083372,Cao; Yingjun,35,0,40,5
1649791263924,CSE 101,A01,084011,Staff,21,0,40,19
1649791269951,CSE 141,A01,083374,Eldon; John,31,0,75,44
1649791275985,CSE 141L,A01,083376,Eldon; John,32,0,75,43
1649791282009,CSE 175,A01,084013,Kumar; Rakesh,25,0,25,0
1649791288032,CSE 190,A00,092508,Staff,15,0,15,0
1649791294055,ECE 5,A01,084049,Morris; Karcher William,18,0,20,2
1649791300082,ECE 100,A01,084051,Baghdadchi; Saharnaz,18,0,20,2
1649791300082,ECE 100,A02,091916,Baghdadchi; Saharnaz,19,0,20,1
1649791306109,ECE 101,A01,084053,Baghdadchi; Saharnaz,33,0,37,4
1649791306109,ECE 101,A02,084054,Baghdadchi; Saharnaz,37,0,37,0
1649791312137,ECE 107,A01,083390,Staff,35,0,40,5
1649791318163,ECE 148,A01,084056,Silberman; Jack,8,0,12,4
1649791324187,ECE 180,A00,083391,Abi Samra; Nicholas Camill,27,0,30,3
1649791324187,ECE 180,B00,083392,Abi Samra; Nicholas Camill,26,0,30,4
1649791330214,MATH 10B,A01,084110,Staff,25,0,30,5
1649791330214,MATH 10B,A02,084111,Staff,30,0,30,0
1649791330214,MATH 10B,A03,084112,Staff,30,0,30,0
1649791336238,MATH 10C,A01,083443,Staff,26,0,30,4
1649791336238,MATH 10C,A02,083444,Staff,26,0,30,4
1649791336238,MATH 10C,B01,084114,Staff,28,0,30,2
1649791336238,MATH 10C,B02,084115,Staff,30,0,30,0
1649791342274,MATH 18,A01,084117,Harel; Guershon,28,0,30,2
1649791342274,MATH 18,A02,084119,Harel; Guershon,29,0,30,1
1649791342274,MATH 18,A03,084120,Harel; Guershon,30,0,30,0
1649791342274,MATH 18,A04,084121,Harel; Guershon,30,0,30,0
1649791348302,MATH 20B,A01,084124,Um; Ko Woon,34,0,35,1
1649791348302,MATH 20B,B01,084126,Um; Ko Woon,35,0,35,0
1649791354331,MATH 20C,A01,083446,Hammock; Frances H,29,0,30,1
1649791354331,MATH 20C,A02,083447,Hammock; Frances H,30,0,30,0
1649791354331,MATH 20C,A03,083448,Hammock; Frances H,30,0,30,0
1649791354331,MATH 20C,A04,083449,Hammock; Frances H,30,0,30,0
1649791354331,MATH 20C,B01,083451,Hammock; Frances H,30,0,30,0
1649791354331,MATH 20C,B02,083452,Hammock; Frances H,30,0,30,0
1649791354331,MATH 20C,B03,083453,Hammock; Frances H,30,0,30,0
1649791354331,MATH 20C,B04,083454,Hammock; Frances H,30,0,30,0
1649791360353,MATH 20D,A01,084128,Staff,30,0,30,0
1649791360353,MATH 20D,A02,084129,Staff,30,0,30,0
1649791360353,MATH 20D,A03,084130,Staff,29,0,30,1
1649791360353,MATH 20D,B01,084133,Staff,29,0,30,1
1649791360353,MATH 20D,B02,084134,Staff,30,0,30,0
1649791360353,MATH 20D,B03,084135,Staff,30,0,30,0
1649791366383,MATH 20E,A01,084138,Staff,29,0,30,1
1649791366383,MATH 20E,A02,084139,Staff,29,0,30,1
1649791366383,MATH 20E,A03,084140,Staff,30,0,30,0
1649791366383,MATH 20E,A04,084141,Staff,30,0,30,0
1649791372425,MATH 102,A01,084143,Harel; Guershon,27,0,30,3
1649791372425,MATH 102,A02,084144,Harel; Guershon,29,0,30,1
1649791378450,MATH 103B,A01,083456,Staff,17,0,30,13
1649791378450,MATH 103B,A02,083457,Staff,28,0,30,2
1649791384474,MATH 109,A01,084146,Salehi Golsefidy; Alireza,30,0,30,0
1649791384474,MATH 109,A02,084147,Salehi Golsefidy; Alireza,28,0,30,2
1649791390512,MATH 120A,A01,085445,Eggers; John Dietrich,32,0,35,3
1649791390512,MATH 120A,A02,085446,Eggers; John Dietrich,33,0,35,2
1649791396539,MATH 142B,A01,084149,Verstraete; Jacques Allan,26,0,30,4
1649791396539,MATH 142B,A02,084150,Verstraete; Jacques Allan,27,0,30,3
1649791402566,MATH 170A,A01,083459,Nie; Jiawang,19,0,30,11
1649791402566,MATH 170A,A02,083460,Nie; Jiawang,28,0,30,2
1649791402566,MATH 170A,A03,083461,Nie; Jiawang,30,0,30,0
1649791408598,MATH 193B,A01,083463,Staff,24,0,30,6
1649791408598,MATH 193B,A02,083464,Staff,27,0,30,3
1649791408598,MATH 193B,A03,083465,Staff,30,0,30,0
1649791414656,COGS 2,A01,083966,Boyle; Mary E. T.,28,0,30,2
1649791420682,COGS 9,A01,083968,Staff,59,0,60,1
1649791426704,COGS 14B,A01,083970,Staff,49,0,50,1
1649791432730,COGS 100,A01,083972,Staff,58,0,60,2
1649791444780,COGS 101C,A01,083976,Staff,29,0,30,1
1649791450805,COGS 102A,A01,083978,Johnson; Christine M.,29,0,30,1
1649791456827,COGS 107B,A01,083980,Staff,46,0,50,4
1649791462860,COGS 115,A01,083982,Staff,27,0,30,3
1649791468883,COGS 118B,A01,083367,Staff,19,0,40,21
1649791474925,COGS 172,A01,083984,Provenzano; Emily Kara,25,0,30,5
1649791480948,COGS 177,A00,083368,Staff,18,0,30,12
1649791486971,COGS 186,A01,083986,Staff,28,0,40,12
1649791492995,COGS 187A,A01,083988,Boyle; Mary E. T.,53,0,60,7
1649791499020,CSE 8A,A50,084003,Miranda; Gregory Joseph,12,0,15,3
1649791505059,CSE 11,A01,084005,Miranda; Gregory Joseph,52,0,55,3
1649791511086,CSE 20,A01,084007,Staff,17,0,20,3
1649791517116,CSE 21,A01,084009,Staff,47,0,50,3
1649791523140,CSE 30,A01,083370,Cao; Yingjun,33,0,40,7
1649791529162,CSE 100,A01,083372,Cao; Yingjun,35,0,40,5
1649791535184,CSE 101,A01,084011,Staff,21,0,40,19
1649791541211,CSE 141,A01,083374,Eldon; John,31,0,75,44
1649791547239,CSE 141L,A01,083376,Eldon; John,32,0,75,43
1649791553266,CSE 175,A01,084013,Kumar; Rakesh,25,0,25,0
1649791559296,CSE 190,A00,092508,Staff,15,0,15,0
1649791565323,ECE 5,A01,084049,Morris; Karcher William,18,0,20,2
1649791571359,ECE 100,A01,084051,Baghdadchi; Saharnaz,18,0,20,2
1649791571359,ECE 100,A02,091916,Baghdadchi; Saharnaz,19,0,20,1
1649791577382,ECE 101,A01,084053,Baghdadchi; Saharnaz,33,0,37,4
1649791577382,ECE 101,A02,084054,Baghdadchi; Saharnaz,37,0,37,0
1649791583415,ECE 107,A01,083390,Staff,35,0,40,5
1649791589440,ECE 148,A01,084056,Silberman; Jack,8,0,12,4
1649791595473,ECE 180,A00,083391,Abi Samra; Nicholas Camill,27,0,30,3
1649791595473,ECE 180,B00,083392,Abi Samra; Nicholas Camill,26,0,30,4
1649791601498,MATH 10B,A01,084110,Staff,25,0,30,5
1649791601498,MATH 10B,A02,084111,Staff,30,0,30,0
1649791601498,MATH 10B,A03,084112,Staff,30,0,30,0
1649791607526,MATH 10C,A01,083443,Staff,26,0,30,4
1649791607526,MATH 10C,A02,083444,Staff,26,0,30,4
1649791607526,MATH 10C,B01,084114,Staff,28,0,30,2
1649791607526,MATH 10C,B02,084115,Staff,30,0,30,0
1649791613553,MATH 18,A01,084117,Harel; Guershon,28,0,30,2
1649791613553,MATH 18,A02,084119,Harel; Guershon,29,0,30,1
1649791613553,MATH 18,A03,084120,Harel; Guershon,30,0,30,0
1649791613553,MATH 18,A04,084121,Harel; Guershon,30,0,30,0
1649791619577,MATH 20B,A01,084124,Um; Ko Woon,34,0,35,1
1649791619577,MATH 20B,B01,084126,Um; Ko Woon,35,0,35,0
1649791625608,MATH 20C,A01,083446,Hammock; Frances H,29,0,30,1
1649791625608,MATH 20C,A02,083447,Hammock; Frances H,30,0,30,0
1649791625608,MATH 20C,A03,083448,Hammock; Frances H,30,0,30,0
1649791625608,MATH 20C,A04,083449,Hammock; Frances H,30,0,30,0
1649791625608,MATH 20C,B01,083451,Hammock; Frances H,30,0,30,0
1649791625608,MATH 20C,B02,083452,Hammock; Frances H,30,0,30,0
1649791625608,MATH 20C,B03,083453,Hammock; Frances H,30,0,30,0
1649791625608,MATH 20C,B04,083454,Hammock; Frances H,30,0,30,0
1649791631634,MATH 20D,A01,084128,Staff,30,0,30,0
1649791631634,MATH 20D,A02,084129,Staff,30,0,30,0
1649791631634,MATH 20D,A03,084130,Staff,29,0,30,1
1649791631634,MATH 20D,B01,084133,Staff,29,0,30,1
1649791631634,MATH 20D,B02,084134,Staff,30,0,30,0
1649791631634,MATH 20D,B03,084135,Staff,30,0,30,0
1649791637661,MATH 20E,A01,084138,Staff,30,0,30,0
1649791637661,MATH 20E,A02,084139,Staff,29,0,30,1
1649791637661,MATH 20E,A03,084140,Staff,30,0,30,0
1649791637661,MATH 20E,A04,084141,Staff,30,0,30,0
1649791643690,MATH 102,A01,084143,Harel; Guershon,27,0,30,3
1649791643690,MATH 102,A02,084144,Harel; Guershon,29,0,30,1
1649791649714,MATH 103B,A01,083456,Staff,17,0,30,13
1649791649714,MATH 103B,A02,083457,Staff,28,0,30,2
1649791655737,MATH 109,A01,084146,Salehi Golsefidy; Alireza,30,0,30,0
1649791655737,MATH 109,A02,084147,Salehi Golsefidy; Alireza,28,0,30,2
1649791661765,MATH 120A,A01,085445,Eggers; John Dietrich,32,0,35,3
1649791661765,MATH 120A,A02,085446,Eggers; John Dietrich,33,0,35,2
1649791667788,MATH 142B,A01,084149,Verstraete; Jacques Allan,26,0,30,4
1649791667788,MATH 142B,A02,084150,Verstraete; Jacques Allan,27,0,30,3
1649791673817,MATH 170A,A01,083459,Nie; Jiawang,18,0,30,12
1649791673817,MATH 170A,A02,083460,Nie; Jiawang,28,0,30,2
1649791673817,MATH 170A,A03,083461,Nie; Jiawang,30,0,30,0
1649791679840,MATH 193B,A01,083463,Staff,24,0,30,6
1649791679840,MATH 193B,A02,083464,Staff,27,0,30,3
1649791679840,MATH 193B,A03,083465,Staff,30,0,30,0
1649791685906,COGS 2,A01,083966,Boyle; Mary E. T.,28,0,30,2
1649791691933,COGS 9,A01,083968,Staff,59,0,60,1
1649791697967,COGS 14B,A01,083970,Staff,49,0,50,1
1649791703991,COGS 100,A01,083972,Staff,57,0,60,3
1649791716047,COGS 101C,A01,083976,Staff,28,0,30,2
1649791722070,COGS 102A,A01,083978,Johnson; Christine M.,29,0,30,1
1649791728097,COGS 107B,A01,083980,Staff,46,0,50,4
1649791734126,COGS 115,A01,083982,Staff,27,0,30,3
1649791740148,COGS 118B,A01,083367,Staff,19,0,40,21
1649791746174,COGS 172,A01,083984,Provenzano; Emily Kara,25,0,30,5
1649791752197,COGS 177,A00,083368,Staff,18,0,30,12
1649791758236,COGS 186,A01,083986,Staff,28,0,40,12
1649791764260,COGS 187A,A01,083988,Boyle; Mary E. T.,53,0,60,7
1649791770288,CSE 8A,A50,084003,Miranda; Gregory Joseph,12,0,15,3
1649791776311,CSE 11,A01,084005,Miranda; Gregory Joseph,52,0,55,3
1649791782351,CSE 20,A01,084007,Staff,17,0,20,3
1649791788375,CSE 21,A01,084009,Staff,47,0,50,3
1649791794401,CSE 30,A01,083370,Cao; Yingjun,33,0,40,7
1649791800519,CSE 100,A01,083372,Cao; Yingjun,35,0,40,5
1649791806541,CSE 101,A01,084011,Staff,21,0,40,19
1649791812570,CSE 141,A01,083374,Eldon; John,29,0,75,46
1649791818600,CSE 141L,A01,083376,Eldon; John,30,0,75,45
1649791824634,CSE 175,A01,084013,Kumar; Rakesh,25,0,25,0
1649791830669,CSE 190,A00,092508,Staff,15,0,15,0
1649791836693,ECE 5,A01,084049,Morris; Karcher William,18,0,20,2
1649791842721,ECE 100,A01,084051,Baghdadchi; Saharnaz,18,0,20,2
1649791842721,ECE 100,A02,091916,Baghdadchi; Saharnaz,19,0,20,1
1649791848762,ECE 101,A01,084053,Baghdadchi; Saharnaz,33,0,37,4
1649791848762,ECE 101,A02,084054,Baghdadchi; Saharnaz,37,0,37,0
1649791854790,ECE 107,A01,083390,Staff,35,0,40,5
1649791860816,ECE 148,A01,084056,Silberman; Jack,8,0,12,4
1649791866845,ECE 180,A00,083391,Abi Samra; Nicholas Camill,27,0,30,3
1649791866845,ECE 180,B00,083392,Abi Samra; Nicholas Camill,26,0,30,4
1649791872872,MATH 10B,A01,084110,Staff,25,0,30,5
1649791872872,MATH 10B,A02,084111,Staff,30,0,30,0
1649791872872,MATH 10B,A03,084112,Staff,30,0,30,0
1649791878902,MATH 10C,A01,083443,Staff,26,0,30,4
1649791878902,MATH 10C,A02,083444,Staff,26,0,30,4
1649791878902,MATH 10C,B01,084114,Staff,28,0,30,2
1649791878902,MATH 10C,B02,084115,Staff,30,0,30,0
1649791884929,MATH 18,A01,084117,Harel; Guershon,28,0,30,2
1649791884929,MATH 18,A02,084119,Harel; Guershon,29,0,30,1
1649791884929,MATH 18,A03,084120,Harel; Guershon,30,0,30,0
1649791884929,MATH 18,A04,084121,Harel; Guershon,30,0,30,0
1649791890961,MATH 20B,A01,084124,Um; Ko Woon,34,0,35,1
1649791890961,MATH 20B,B01,084126,Um; Ko Woon,35,0,35,0
1649791896991,MATH 20C,A01,083446,Hammock; Frances H,29,0,30,1
1649791896991,MATH 20C,A02,083447,Hammock; Frances H,30,0,30,0
1649791896991,MATH 20C,A03,083448,Hammock; Frances H,30,0,30,0
1649791896991,MATH 20C,A04,083449,Hammock; Frances H,30,0,30,0
1649791896991,MATH 20C,B01,083451,Hammock; Frances H,30,0,30,0
1649791896991,MATH 20C,B02,083452,Hammock; Frances H,30,0,30,0
1649791896991,MATH 20C,B03,083453,Hammock; Frances H,30,0,30,0
1649791896991,MATH 20C,B04,083454,Hammock; Frances H,30,0,30,0
1649791903016,MATH 20D,A01,084128,Staff,30,0,30,0
1649791903016,MATH 20D,A02,084129,Staff,30,0,30,0
1649791903016,MATH 20D,A03,084130,Staff,29,0,30,1
1649791903016,MATH 20D,B01,084133,Staff,29,0,30,1
1649791903016,MATH 20D,B02,084134,Staff,30,0,30,0
1649791903016,MATH 20D,B03,084135,Staff,30,0,30,0
1649791909042,MATH 20E,A01,084138,Staff,30,0,30,0
1649791909042,MATH 20E,A02,084139,Staff,29,0,30,1
1649791909042,MATH 20E,A03,084140,Staff,30,0,30,0
1649791909042,MATH 20E,A04,084141,Staff,30,0,30,0
1649791915075,MATH 102,A01,084143,Harel; Guershon,27,0,30,3
1649791915075,MATH 102,A02,084144,Harel; Guershon,29,0,30,1
1649791921107,MATH 103B,A01,083456,Staff,17,0,30,13
1649791921107,MATH 103B,A02,083457,Staff,28,0,30,2
1649791927132,MATH 109,A01,084146,Salehi Golsefidy; Alireza,30,0,30,0
1649791927132,MATH 109,A02,084147,Salehi Golsefidy; Alireza,28,0,30,2
1649791933166,MATH 120A,A01,085445,Eggers; John Dietrich,32,0,35,3
1649791933166,MATH 120A,A02,085446,Eggers; John Dietrich,33,0,35,2
1649791939192,MATH 142B,A01,084149,Verstraete; Jacques Allan,26,0,30,4
1649791939192,MATH 142B,A02,084150,Verstraete; Jacques Allan,27,0,30,3
1649791945220,MATH 170A,A01,083459,Nie; Jiawang,18,0,30,12
1649791945220,MATH 170A,A02,083460,Nie; Jiawang,28,0,30,2
1649791945220,MATH 170A,A03,083461,Nie; Jiawang,30,0,30,0
1649791951254,MATH 193B,A01,083463,Staff,24,0,30,6
1649791951254,MATH 193B,A02,083464,Staff,27,0,30,3
1649791951254,MATH 193B,A03,083465,Staff,30,0,30,0
1649791957306,COGS 2,A01,083966,Boyle; Mary E. T.,28,0,30,2
1649791963329,COGS 9,A01,083968,Staff,59,0,60,1
1649791969367,COGS 14B,A01,083970,Staff,49,0,50,1
1649791975392,COGS 100,A01,083972,Staff,57,0,60,3
1649791987450,COGS 101C,A01,083976,Staff,28,0,30,2
1649791993473,COGS 102A,A01,083978,Johnson; Christine M.,29,0,30,1
1649791999509,COGS 107B,A01,083980,Staff,46,0,50,4
1649792005535,COGS 115,A01,083982,Staff,27,0,30,3
1649792011567,COGS 118B,A01,083367,Staff,19,0,40,21
1649792017594,COGS 172,A01,083984,Provenzano; Emily Kara,25,0,30,5
1649792023621,COGS 177,A00,083368,Staff,18,0,30,12
1649792029669,COGS 186,A01,083986,Staff,28,0,40,12
1649792035692,COGS 187A,A01,083988,Boyle; Mary E. T.,53,0,60,7
1649792041716,CSE 8A,A50,084003,Miranda; Gregory Joseph,12,0,15,3
1649792047743,CSE 11,A01,084005,Miranda; Gregory Joseph,52,0,55,3
1649792053774,CSE 20,A01,084007,Staff,17,0,20,3
1649792059796,CSE 21,A01,084009,Staff,47,0,50,3
1649792065830,CSE 30,A01,083370,Cao; Yingjun,33,0,40,7
1649792071854,CSE 100,A01,083372,Cao; Yingjun,35,0,40,5
1649792077880,CSE 101,A01,084011,Staff,21,0,40,19
1649792083907,CSE 141,A01,083374,Eldon; John,29,0,75,46
1649792089931,CSE 141L,A01,083376,Eldon; John,30,0,75,45
1649792095958,CSE 175,A01,084013,Kumar; Rakesh,25,0,25,0
1649792101989,CSE 190,A00,092508,Staff,15,0,15,0
1649792108017,ECE 5,A01,084049,Morris; Karcher William,18,0,20,2
1649792114039,ECE 100,A01,084051,Baghdadchi; Saharnaz,18,0,20,2
1649792114039,ECE 100,A02,091916,Baghdadchi; Saharnaz,19,0,20,1
1649792120064,ECE 101,A01,084053,Baghdadchi; Saharnaz,33,0,37,4
1649792120064,ECE 101,A02,084054,Baghdadchi; Saharnaz,37,0,37,0
1649792126100,ECE 107,A01,083390,Staff,35,0,40,5
1649792132123,ECE 148,A01,084056,Silberman; Jack,8,0,12,4
1649792138148,ECE 180,A00,083391,Abi Samra; Nicholas Camill,27,0,30,3
1649792138148,ECE 180,B00,083392,Abi Samra; Nicholas Camill,26,0,30,4
1649792144184,MATH 10B,A01,084110,Staff,25,0,30,5
1649792144184,MATH 10B,A02,084111,Staff,30,0,30,0
1649792144184,MATH 10B,A03,084112,Staff,30,0,30,0
1649792150207,MATH 10C,A01,083443,Staff,26,0,30,4
1649792150207,MATH 10C,A02,083444,Staff,26,0,30,4
1649792150207,MATH 10C,B01,084114,Staff,28,0,30,2
1649792150207,MATH 10C,B02,084115,Staff,30,0,30,0
1649792156235,MATH 18,A01,084117,Harel; Guershon,28,0,30,2
1649792156235,MATH 18,A02,084119,Harel; Guershon,29,0,30,1
1649792156235,MATH 18,A03,084120,Harel; Guershon,30,0,30,0
1649792156235,MATH 18,A04,084121,Harel; Guershon,30,0,30,0
1649792162263,MATH 20B,A01,084124,Um; Ko Woon,34,0,35,1
1649792162263,MATH 20B,B01,084126,Um; Ko Woon,35,0,35,0
1649792168293,MATH 20C,A01,083446,Hammock; Frances H,29,0,30,1
1649792168293,MATH 20C,A02,083447,Hammock; Frances H,30,0,30,0
1649792168293,MATH 20C,A03,083448,Hammock; Frances H,30,0,30,0
1649792168293,MATH 20C,A04,083449,Hammock; Frances H,30,0,30,0
1649792168293,MATH 20C,B01,083451,Hammock; Frances H,30,0,30,0
1649792168293,MATH 20C,B02,083452,Hammock; Frances H,30,0,30,0
1649792168293,MATH 20C,B03,083453,Hammock; Frances H,30,0,30,0
1649792168293,MATH 20C,B04,083454,Hammock; Frances H,30,0,30,0
1649792174322,MATH 20D,A01,084128,Staff,30,0,30,0
1649792174322,MATH 20D,A02,084129,Staff,30,0,30,0
1649792174322,MATH 20D,A03,084130,Staff,29,0,30,1
1649792174322,MATH 20D,B01,084133,Staff,29,0,30,1
1649792174322,MATH 20D,B02,084134,Staff,30,0,30,0
1649792174322,MATH 20D,B03,084135,Staff,30,0,30,0
1649792180345,MATH 20E,A01,084138,Staff,30,0,30,0
1649792180345,MATH 20E,A02,084139,Staff,29,0,30,1
1649792180345,MATH 20E,A03,084140,Staff,30,0,30,0
1649792180345,MATH 20E,A04,084141,Staff,30,0,30,0
1649792186373,MATH 102,A01,084143,Harel; Guershon,27,0,30,3
1649792186373,MATH 102,A02,084144,Harel; Guershon,29,0,30,1
1649792192399,MATH 103B,A01,083456,Staff,17,0,30,13
1649792192399,MATH 103B,A02,083457,Staff,28,0,30,2
1649792198421,MATH 109,A01,084146,Salehi Golsefidy; Alireza,30,0,30,0
1649792198421,MATH 109,A02,084147,Salehi Golsefidy; Alireza,28,0,30,2
1649792204444,MATH 120A,A01,085445,Eggers; John Dietrich,32,0,35,3
1649792204444,MATH 120A,A02,085446,Eggers; John Dietrich,33,0,35,2
1649792210481,MATH 142B,A01,084149,Verstraete; Jacques Allan,26,0,30,4
1649792210481,MATH 142B,A02,084150,Verstraete; Jacques Allan,27,0,30,3
1649792216505,MATH 170A,A01,083459,Nie; Jiawang,18,0,30,12
1649792216505,MATH 170A,A02,083460,Nie; Jiawang,28,0,30,2
1649792216505,MATH 170A,A03,083461,Nie; Jiawang,30,0,30,0
1649792222535,MATH 193B,A01,083463,Staff,24,0,30,6
1649792222535,MATH 193B,A02,083464,Staff,27,0,30,3
1649792222535,MATH 193B,A03,083465,Staff,30,0,30,0
1649792228592,COGS 2,A01,083966,Boyle; Mary E. T.,28,0,30,2
1649792234616,COGS 9,A01,083968,Staff,59,0,60,1
1649792240639,COGS 14B,A01,083970,Staff,49,0,50,1
1649792246661,COGS 100,A01,083972,Staff,57,0,60,3
1649792258715,COGS 101C,A01,083976,Staff,28,0,30,2
1649792264756,COGS 102A,A01,083978,Johnson; Christine M.,29,0,30,1
1649792270779,COGS 107B,A01,083980,Staff,46,0,50,4
1649792276801,COGS 115,A01,083982,Staff,27,0,30,3
1649792282847,COGS 118B,A01,083367,Staff,19,0,40,21
1649792288875,COGS 172,A01,083984,Provenzano; Emily Kara,25,0,30,5
1649792294900,COGS 177,A00,083368,Staff,18,0,30,12
1649792300932,COGS 186,A01,083986,Staff,28,0,40,12
1649792306966,COGS 187A,A01,083988,Boyle; Mary E. T.,53,0,60,7
1649792312988,CSE 8A,A50,084003,Miranda; Gregory Joseph,12,0,15,3
1649792319029,CSE 11,A01,084005,Miranda; Gregory Joseph,52,0,55,3
1649792325053,CSE 20,A01,084007,Staff,17,0,20,3
1649792331075,CSE 21,A01,084009,Staff,47,0,50,3
1649792337101,CSE 30,A01,083370,Cao; Yingjun,33,0,40,7
1649792343126,CSE 100,A01,083372,Cao; Yingjun,35,0,40,5
1649792349153,CSE 101,A01,084011,Staff,21,0,40,19
1649792355175,CSE 141,A01,083374,Eldon; John,29,0,75,46
1649792361201,CSE 141L,A01,083376,Eldon; John,30,0,75,45
1649792367225,CSE 175,A01,084013,Kumar; Rakesh,25,0,25,0
1649792373249,CSE 190,A00,092508,Staff,15,0,15,0
1649792379277,ECE 5,A01,084049,Morris; Karcher William,18,0,20,2
1649792385304,ECE 100,A01,084051,Baghdadchi; Saharnaz,18,0,20,2
1649792385304,ECE 100,A02,091916,Baghdadchi; Saharnaz,19,0,20,1
1649792391339,ECE 101,A01,084053,Baghdadchi; Saharnaz,33,0,37,4
1649792391339,ECE 101,A02,084054,Baghdadchi; Saharnaz,37,0,37,0
1649792397453,ECE 107,A01,083390,Staff,35,0,40,5
1649792403479,ECE 148,A01,084056,Silberman; Jack,8,0,12,4
1649792409509,ECE 180,A00,083391,Abi Samra; Nicholas Camill,27,0,30,3
1649792409509,ECE 180,B00,083392,Abi Samra; Nicholas Camill,26,0,30,4
1649792415535,MATH 10B,A01,084110,Staff,25,0,30,5
1649792415535,MATH 10B,A02,084111,Staff,30,0,30,0
1649792415535,MATH 10B,A03,084112,Staff,30,0,30,0
1649792421560,MATH 10C,A01,083443,Staff,26,0,30,4
1649792421560,MATH 10C,A02,083444,Staff,26,0,30,4
1649792421560,MATH 10C,B01,084114,Staff,28,0,30,2
1649792421560,MATH 10C,B02,084115,Staff,30,0,30,0
1649792427588,MATH 18,A01,084117,Harel; Guershon,28,0,30,2
1649792427588,MATH 18,A02,084119,Harel; Guershon,29,0,30,1
1649792427588,MATH 18,A03,084120,Harel; Guershon,30,0,30,0
1649792427588,MATH 18,A04,084121,Harel; Guershon,30,0,30,0
1649792433624,MATH 20B,A01,084124,Um; Ko Woon,34,0,35,1
1649792433624,MATH 20B,B01,084126,Um; Ko Woon,35,0,35,0
1649792439654,MATH 20C,A01,083446,Hammock; Frances H,29,0,30,1
1649792439654,MATH 20C,A02,083447,Hammock; Frances H,30,0,30,0
1649792439654,MATH 20C,A03,083448,Hammock; Frances H,30,0,30,0
1649792439654,MATH 20C,A04,083449,Hammock; Frances H,30,0,30,0
1649792439654,MATH 20C,B01,083451,Hammock; Frances H,30,0,30,0
1649792439654,MATH 20C,B02,083452,Hammock; Frances H,30,0,30,0
1649792439654,MATH 20C,B03,083453,Hammock; Frances H,30,0,30,0
1649792439654,MATH 20C,B04,083454,Hammock; Frances H,30,0,30,0
1649792445677,MATH 20D,A01,084128,Staff,30,0,30,0
1649792445677,MATH 20D,A02,084129,Staff,30,0,30,0
1649792445677,MATH 20D,A03,084130,Staff,29,0,30,1
1649792445677,MATH 20D,B01,084133,Staff,29,0,30,1
1649792445677,MATH 20D,B02,084134,Staff,30,0,30,0
1649792445677,MATH 20D,B03,084135,Staff,30,0,30,0
1649792451708,MATH 20E,A01,084138,Staff,30,0,30,0
1649792451708,MATH 20E,A02,084139,Staff,29,0,30,1
1649792451708,MATH 20E,A03,084140,Staff,30,0,30,0
1649792451708,MATH 20E,A04,084141,Staff,30,0,30,0
1649792457735,MATH 102,A01,084143,Harel; Guershon,27,0,30,3
1649792457735,MATH 102,A02,084144,Harel; Guershon,29,0,30,1
1649792463763,MATH 103B,A01,083456,Staff,17,0,30,13
1649792463763,MATH 103B,A02,083457,Staff,28,0,30,2
1649792469804,MATH 109,A01,084146,Salehi Golsefidy; Alireza,30,0,30,0
1649792469804,MATH 109,A02,084147,Salehi Golsefidy; Alireza,28,0,30,2
1649792475832,MATH 120A,A01,085445,Eggers; John Dietrich,32,0,35,3
1649792475832,MATH 120A,A02,085446,Eggers; John Dietrich,33,0,35,2
1649792481863,MATH 142B,A01,084149,Verstraete; Jacques Allan,26,0,30,4
1649792481863,MATH 142B,A02,084150,Verstraete; Jacques Allan,27,0,30,3
1649792487891,MATH 170A,A01,083459,Nie; Jiawang,18,0,30,12
1649792487891,MATH 170A,A02,083460,Nie; Jiawang,28,0,30,2
1649792487891,MATH 170A,A03,083461,Nie; Jiawang,30,0,30,0
1649792493917,MATH 193B,A01,083463,Staff,24,0,30,6
1649792493917,MATH 193B,A02,083464,Staff,27,0,30,3
1649792493917,MATH 193B,A03,083465,Staff,30,0,30,0
1649792499968,COGS 2,A01,083966,Boyle; Mary E. T.,28,0,30,2
1649792505992,COGS 9,A01,083968,Staff,59,0,60,1
1649792512022,COGS 14B,A01,083970,Staff,49,0,50,1
1649792518055,COGS 100,A01,083972,Staff,57,0,60,3
1649792530104,COGS 101C,A01,083976,Staff,28,0,30,2
1649792536129,COGS 102A,A01,083978,Johnson; Christine M.,29,0,30,1
1649792542154,COGS 107B,A01,083980,Staff,46,0,50,4
1649792548187,COGS 115,A01,083982,Staff,27,0,30,3
1649792554209,COGS 118B,A01,083367,Staff,19,0,40,21
1649792560238,COGS 172,A01,083984,Provenzano; Emily Kara,25,0,30,5
1649792566268,COGS 177,A00,083368,Staff,18,0,30,12
1649792572291,COGS 186,A01,083986,Staff,28,0,40,12
1649792578319,COGS 187A,A01,083988,Boyle; Mary E. T.,53,0,60,7
1649792584347,CSE 8A,A50,084003,Miranda; Gregory Joseph,12,0,15,3
1649792590373,CSE 11,A01,084005,Miranda; Gregory Joseph,52,0,55,3
1649792596397,CSE 20,A01,084007,Staff,17,0,20,3
1649792602419,CSE 21,A01,084009,Staff,47,0,50,3
1649792608442,CSE 30,A01,083370,Cao; Yingjun,33,0,40,7
1649792614463,CSE 100,A01,083372,Cao; Yingjun,35,0,40,5
1649792620486,CSE 101,A01,084011,Staff,21,0,40,19
1649792626512,CSE 141,A01,083374,Eldon; John,29,0,75,46
1649792632535,CSE 141L,A01,083376,Eldon; John,30,0,75,45
1649792638557,CSE 175,A01,084013,Kumar; Rakesh,25,0,25,0
1649792644583,CSE 190,A00,092508,Staff,15,0,15,0
1649792650606,ECE 5,A01,084049,Morris; Karcher William,18,0,20,2
1649792656634,ECE 100,A01,084051,Baghdadchi; Saharnaz,18,0,20,2
1649792656634,ECE 100,A02,091916,Baghdadchi; Saharnaz,19,0,20,1
1649792662658,ECE 101,A01,084053,Baghdadchi; Saharnaz,33,0,37,4
1649792662658,ECE 101,A02,084054,Baghdadchi; Saharnaz,37,0,37,0
1649792668683,ECE 107,A01,083390,Staff,35,0,40,5
1649792674709,ECE 148,A01,084056,Silberman; Jack,8,0,12,4
1649792680731,ECE 180,A00,083391,Abi Samra; Nicholas Camill,27,0,30,3
1649792680731,ECE 180,B00,083392,Abi Samra; Nicholas Camill,26,0,30,4
1649792686756,MATH 10B,A01,084110,Staff,25,0,30,5
1649792686756,MATH 10B,A02,084111,Staff,29,0,30,1
1649792686756,MATH 10B,A03,084112,Staff,30,0,30,0
1649792692783,MATH 10C,A01,083443,Staff,26,0,30,4
1649792692783,MATH 10C,A02,083444,Staff,26,0,30,4
1649792692783,MATH 10C,B01,084114,Staff,28,0,30,2
1649792692783,MATH 10C,B02,084115,Staff,30,0,30,0
1649792698811,MATH 18,A01,084117,Harel; Guershon,28,0,30,2
1649792698811,MATH 18,A02,084119,Harel; Guershon,29,0,30,1
1649792698811,MATH 18,A03,084120,Harel; Guershon,30,0,30,0
1649792698811,MATH 18,A04,084121,Harel; Guershon,30,0,30,0
1649792704842,MATH 20B,A01,084124,Um; Ko Woon,34,0,35,1
1649792704842,MATH 20B,B01,084126,Um; Ko Woon,35,0,35,0
1649792710871,MATH 20C,A01,083446,Hammock; Frances H,29,0,30,1
1649792710871,MATH 20C,A02,083447,Hammock; Frances H,30,0,30,0
1649792710871,MATH 20C,A03,083448,Hammock; Frances H,30,0,30,0
1649792710871,MATH 20C,A04,083449,Hammock; Frances H,30,0,30,0
1649792710871,MATH 20C,B01,083451,Hammock; Frances H,30,0,30,0
1649792710871,MATH 20C,B02,083452,Hammock; Frances H,30,0,30,0
1649792710871,MATH 20C,B03,083453,Hammock; Frances H,30,0,30,0
1649792710871,MATH 20C,B04,083454,Hammock; Frances H,30,0,30,0
1649792716895,MATH 20D,A01,084128,Staff,30,0,30,0
1649792716895,MATH 20D,A02,084129,Staff,30,0,30,0
1649792716895,MATH 20D,A03,084130,Staff,29,0,30,1
1649792716895,MATH 20D,B01,084133,Staff,29,0,30,1
1649792716895,MATH 20D,B02,084134,Staff,30,0,30,0
1649792716895,MATH 20D,B03,084135,Staff,30,0,30,0
1649792722922,MATH 20E,A01,084138,Staff,30,0,30,0
1649792722922,MATH 20E,A02,084139,Staff,29,0,30,1
1649792722922,MATH 20E,A03,084140,Staff,30,0,30,0
1649792722922,MATH 20E,A04,084141,Staff,30,0,30,0
1649792728953,MATH 102,A01,084143,Harel; Guershon,27,0,30,3
1649792728953,MATH 102,A02,084144,Harel; Guershon,29,0,30,1
1649792734977,MATH 103B,A01,083456,Staff,17,0,30,13
1649792734977,MATH 103B,A02,083457,Staff,28,0,30,2
1649792741008,MATH 109,A01,084146,Salehi Golsefidy; Alireza,30,0,30,0
1649792741008,MATH 109,A02,084147,Salehi Golsefidy; Alireza,28,0,30,2
1649792747036,MATH 120A,A01,085445,Eggers; John Dietrich,32,0,35,3
1649792747036,MATH 120A,A02,085446,Eggers; John Dietrich,33,0,35,2
1649792753068,MATH 142B,A01,084149,Verstraete; Jacques Allan,26,0,30,4
1649792753068,MATH 142B,A02,084150,Verstraete; Jacques Allan,27,0,30,3
1649792759096,MATH 170A,A01,083459,Nie; Jiawang,18,0,30,12
1649792759096,MATH 170A,A02,083460,Nie; Jiawang,28,0,30,2
1649792759096,MATH 170A,A03,083461,Nie; Jiawang,30,0,30,0
1649792765125,MATH 193B,A01,083463,Staff,24,0,30,6
1649792765125,MATH 193B,A02,083464,Staff,27,0,30,3
1649792765125,MATH 193B,A03,083465,Staff,30,0,30,0
1649792771188,COGS 2,A01,083966,Boyle; Mary E. T.,28,0,30,2
1649792777215,COGS 9,A01,083968,Staff,59,0,60,1
1649792783242,COGS 14B,A01,083970,Staff,49,0,50,1
1649792789272,COGS 100,A01,083972,Staff,57,0,60,3
1649792801323,COGS 101C,A01,083976,Staff,28,0,30,2
1649792807352,COGS 102A,A01,083978,Johnson; Christine M.,29,0,30,1
1649792813375,COGS 107B,A01,083980,Staff,46,0,50,4
1649792819397,COGS 115,A01,083982,Staff,26,0,30,4
1649792825418,COGS 118B,A01,083367,Staff,19,0,40,21
1649792831441,COGS 172,A01,083984,Provenzano; Emily Kara,25,0,30,5
1649792837473,COGS 177,A00,083368,Staff,18,0,30,12
1649792843497,COGS 186,A01,083986,Staff,28,0,40,12
1649792849536,COGS 187A,A01,083988,Boyle; Mary E. T.,53,0,60,7
1649792855559,CSE 8A,A50,084003,Miranda; Gregory Joseph,12,0,15,3
1649792861583,CSE 11,A01,084005,Miranda; Gregory Joseph,52,0,55,3
1649792867606,CSE 20,A01,084007,Staff,17,0,20,3
1649792873629,CSE 21,A01,084009,Staff,47,0,50,3
1649792879657,CSE 30,A01,083370,Cao; Yingjun,33,0,40,7
1649792885684,CSE 100,A01,083372,Cao; Yingjun,35,0,40,5
1649792891706,CSE 101,A01,084011,Staff,21,0,40,19
1649792897731,CSE 141,A01,083374,Eldon; John,29,0,75,46
1649792903763,CSE 141L,A01,083376,Eldon; John,30,0,75,45
1649792909786,CSE 175,A01,084013,Kumar; Rakesh,25,0,25,0
1649792915812,CSE 190,A00,092508,Staff,15,0,15,0
1649792921836,ECE 5,A01,084049,Morris; Karcher William,18,0,20,2
1649792927867,ECE 100,A01,084051,Baghdadchi; Saharnaz,18,0,20,2
1649792927867,ECE 100,A02,091916,Baghdadchi; Saharnaz,19,0,20,1
1649792933898,ECE 101,A01,084053,Baghdadchi; Saharnaz,33,0,37,4
1649792933898,ECE 101,A02,084054,Baghdadchi; Saharnaz,37,0,37,0
1649792939921,ECE 107,A01,083390,Staff,35,0,40,5
1649792945945,ECE 148,A01,084056,Silberman; Jack,8,0,12,4
1649792951967,ECE 180,A00,083391,Abi Samra; Nicholas Camill,27,0,30,3
1649792951967,ECE 180,B00,083392,Abi Samra; Nicholas Camill,26,0,30,4
1649792957992,MATH 10B,A01,084110,Staff,25,0,30,5
1649792957992,MATH 10B,A02,084111,Staff,29,0,30,1
1649792957992,MATH 10B,A03,084112,Staff,30,0,30,0
1649792964016,MATH 10C,A01,083443,Staff,26,0,30,4
1649792964016,MATH 10C,A02,083444,Staff,26,0,30,4
1649792964016,MATH 10C,B01,084114,Staff,28,0,30,2
1649792964016,MATH 10C,B02,084115,Staff,30,0,30,0
1649792970038,MATH 18,A01,084117,Harel; Guershon,28,0,30,2
1649792970038,MATH 18,A02,084119,Harel; Guershon,29,0,30,1
1649792970038,MATH 18,A03,084120,Harel; Guershon,30,0,30,0
1649792970038,MATH 18,A04,084121,Harel; Guershon,30,0,30,0
1649792976064,MATH 20B,A01,084124,Um; Ko Woon,34,0,35,1
1649792976064,MATH 20B,B01,084126,Um; Ko Woon,35,0,35,0
1649792982088,MATH 20C,A01,083446,Hammock; Frances H,29,0,30,1
1649792982088,MATH 20C,A02,083447,Hammock; Frances H,30,0,30,0
1649792982088,MATH 20C,A03,083448,Hammock; Frances H,30,0,30,0
1649792982088,MATH 20C,A04,083449,Hammock; Frances H,30,0,30,0
1649792982088,MATH 20C,B01,083451,Hammock; Frances H,30,0,30,0
1649792982088,MATH 20C,B02,083452,Hammock; Frances H,30,0,30,0
1649792982088,MATH 20C,B03,083453,Hammock; Frances H,30,0,30,0
1649792982088,MATH 20C,B04,083454,Hammock; Frances H,30,0,30,0
1649792988175,MATH 20D,A01,084128,Staff,30,0,30,0
1649792988175,MATH 20D,A02,084129,Staff,30,0,30,0
1649792988175,MATH 20D,A03,084130,Staff,29,0,30,1
1649792988175,MATH 20D,B01,084133,Staff,29,0,30,1
1649792988175,MATH 20D,B02,084134,Staff,30,0,30,0
1649792988175,MATH 20D,B03,084135,Staff,30,0,30,0
1649792994306,MATH 20E,A01,084138,Staff,30,0,30,0
1649792994306,MATH 20E,A02,084139,Staff,29,0,30,1
1649792994306,MATH 20E,A03,084140,Staff,30,0,30,0
1649792994306,MATH 20E,A04,084141,Staff,30,0,30,0
1649793000328,MATH 102,A01,084143,Harel; Guershon,27,0,30,3
1649793000328,MATH 102,A02,084144,Harel; Guershon,29,0,30,1
1649793006366,MATH 103B,A01,083456,Staff,17,0,30,13
1649793006366,MATH 103B,A02,083457,Staff,28,0,30,2
1649793012391,MATH 109,A01,084146,Salehi Golsefidy; Alireza,30,0,30,0
1649793012391,MATH 109,A02,084147,Salehi Golsefidy; Alireza,28,0,30,2
1649793018421,MATH 120A,A01,085445,Eggers; John Dietrich,32,0,35,3
1649793018421,MATH 120A,A02,085446,Eggers; John Dietrich,33,0,35,2
1649793024456,MATH 142B,A01,084149,Verstraete; Jacques Allan,26,0,30,4
1649793024456,MATH 142B,A02,084150,Verstraete; Jacques Allan,27,0,30,3
1649793030480,MATH 170A,A01,083459,Nie; Jiawang,18,0,30,12
1649793030480,MATH 170A,A02,083460,Nie; Jiawang,28,0,30,2
1649793030480,MATH 170A,A03,083461,Nie; Jiawang,30,0,30,0
1649793036501,MATH 193B,A01,083463,Staff,24,0,30,6
1649793036501,MATH 193B,A02,083464,Staff,27,0,30,3
1649793036501,MATH 193B,A03,083465,Staff,30,0,30,0
1649793042574,COGS 2,A01,083966,Boyle; Mary E. T.,28,0,30,2
1649793048600,COGS 9,A01,083968,Staff,59,0,60,1
1649793054624,COGS 14B,A01,083970,Staff,49,0,50,1
1649793060650,COGS 100,A01,083972,Staff,57,0,60,3
1649793072701,COGS 101C,A01,083976,Staff,28,0,30,2
1649793078726,COGS 102A,A01,083978,Johnson; Christine M.,29,0,30,1
1649793084749,COGS 107B,A01,083980,Staff,46,0,50,4
1649793090772,COGS 115,A01,083982,Staff,26,0,30,4
1649793096797,COGS 118B,A01,083367,Staff,19,0,40,21
1649793102834,COGS 172,A01,083984,Provenzano; Emily Kara,25,0,30,5
1649793108860,COGS 177,A00,083368,Staff,18,0,30,12
1649793114885,COGS 186,A01,083986,Staff,28,0,40,12
1649793120913,COGS 187A,A01,083988,Boyle; Mary E. T.,53,0,60,7
1649793126942,CSE 8A,A50,084003,Miranda; Gregory Joseph,12,0,15,3
1649793132968,CSE 11,A01,084005,Miranda; Gregory Joseph,52,0,55,3
1649793138993,CSE 20,A01,084007,Staff,17,0,20,3
1649793145019,CSE 21,A01,084009,Staff,47,0,50,3
1649793151042,CSE 30,A01,083370,Cao; Yingjun,33,0,40,7
1649793157065,CSE 100,A01,083372,Cao; Yingjun,35,0,40,5
1649793163096,CSE 101,A01,084011,Staff,19,0,40,21
1649793169119,CSE 141,A01,083374,Eldon; John,29,0,75,46
1649793175141,CSE 141L,A01,083376,Eldon; John,30,0,75,45
1649793181176,CSE 175,A01,084013,Kumar; Rakesh,25,0,25,0
1649793187212,CSE 190,A00,092508,Staff,15,0,15,0
1649793193242,ECE 5,A01,084049,Morris; Karcher William,18,0,20,2
1649793199266,ECE 100,A01,084051,Baghdadchi; Saharnaz,18,0,20,2
1649793199266,ECE 100,A02,091916,Baghdadchi; Saharnaz,19,0,20,1
1649793205297,ECE 101,A01,084053,Baghdadchi; Saharnaz,33,0,37,4
1649793205297,ECE 101,A02,084054,Baghdadchi; Saharnaz,37,0,37,0
1649793211328,ECE 107,A01,083390,Staff,35,0,40,5
1649793217368,ECE 148,A01,084056,Silberman; Jack,8,0,12,4
1649793223392,ECE 180,A00,083391,Abi Samra; Nicholas Camill,27,0,30,3
1649793223392,ECE 180,B00,083392,Abi Samra; Nicholas Camill,26,0,30,4
1649793229415,MATH 10B,A01,084110,Staff,25,0,30,5
1649793229415,MATH 10B,A02,084111,Staff,29,0,30,1
1649793229415,MATH 10B,A03,084112,Staff,30,0,30,0
1649793235444,MATH 10C,A01,083443,Staff,26,0,30,4
1649793235444,MATH 10C,A02,083444,Staff,26,0,30,4
1649793235444,MATH 10C,B01,084114,Staff,28,0,30,2
1649793235444,MATH 10C,B02,084115,Staff,30,0,30,0
1649793241468,MATH 18,A01,084117,Harel; Guershon,28,0,30,2
1649793241468,MATH 18,A02,084119,Harel; Guershon,29,0,30,1
1649793241468,MATH 18,A03,084120,Harel; Guershon,30,0,30,0
1649793241468,MATH 18,A04,084121,Harel; Guershon,30,0,30,0
1649793247496,MATH 20B,A01,084124,Um; Ko Woon,34,0,35,1
1649793247496,MATH 20B,B01,084126,Um; Ko Woon,35,0,35,0
1649793253532,MATH 20C,A01,083446,Hammock; Frances H,29,0,30,1
1649793253532,MATH 20C,A02,083447,Hammock; Frances H,30,0,30,0
1649793253532,MATH 20C,A03,083448,Hammock; Frances H,30,0,30,0
1649793253532,MATH 20C,A04,083449,Hammock; Frances H,30,0,30,0
1649793253532,MATH 20C,B01,083451,Hammock; Frances H,30,0,30,0
1649793253532,MATH 20C,B02,083452,Hammock; Frances H,30,0,30,0
1649793253532,MATH 20C,B03,083453,Hammock; Frances H,30,0,30,0
1649793253532,MATH 20C,B04,083454,Hammock; Frances H,30,0,30,0
1649793259562,MATH 20D,A01,084128,Staff,30,0,30,0
1649793259562,MATH 20D,A02,084129,Staff,30,0,30,0
1649793259562,MATH 20D,A03,084130,Staff,29,0,30,1
1649793259562,MATH 20D,B01,084133,Staff,29,0,30,1
1649793259562,MATH 20D,B02,084134,Staff,30,0,30,0
1649793259562,MATH 20D,B03,084135,Staff,30,0,30,0
1649793265587,MATH 20E,A01,084138,Staff,30,0,30,0
1649793265587,MATH 20E,A02,084139,Staff,29,0,30,1
1649793265587,MATH 20E,A03,084140,Staff,30,0,30,0
1649793265587,MATH 20E,A04,084141,Staff,30,0,30,0
1649793271618,MATH 102,A01,084143,Harel; Guershon,27,0,30,3
1649793271618,MATH 102,A02,084144,Harel; Guershon,29,0,30,1
1649793277643,MATH 103B,A01,083456,Staff,17,0,30,13
1649793277643,MATH 103B,A02,083457,Staff,28,0,30,2
1649793283667,MATH 109,A01,084146,Salehi Golsefidy; Alireza,30,0,30,0
1649793283667,MATH 109,A02,084147,Salehi Golsefidy; Alireza,28,0,30,2
1649793289698,MATH 120A,A01,085445,Eggers; John Dietrich,32,0,35,3
1649793289698,MATH 120A,A02,085446,Eggers; John Dietrich,33,0,35,2
1649793295725,MATH 142B,A01,084149,Verstraete; Jacques Allan,25,0,30,5
1649793295725,MATH 142B,A02,084150,Verstraete; Jacques Allan,27,0,30,3
1649793301756,MATH 170A,A01,083459,Nie; Jiawang,18,0,30,12
1649793301756,MATH 170A,A02,083460,Nie; Jiawang,28,0,30,2
1649793301756,MATH 170A,A03,083461,Nie; Jiawang,30,0,30,0
1649793307786,MATH 193B,A01,083463,Staff,24,0,30,6
1649793307786,MATH 193B,A02,083464,Staff,27,0,30,3
1649793307786,MATH 193B,A03,083465,Staff,30,0,30,0
1649793313850,COGS 2,A01,083966,Boyle; Mary E. T.,28,0,30,2
1649793319880,COGS 9,A01,083968,Staff,59,0,60,1
1649793325907,COGS 14B,A01,083970,Staff,49,0,50,1
1649793331929,COGS 100,A01,083972,Staff,57,0,60,3
1649793343991,COGS 101C,A01,083976,Staff,28,0,30,2
1649793350016,COGS 102A,A01,083978,Johnson; Christine M.,29,0,30,1
1649793356042,COGS 107B,A01,083980,Staff,45,0,50,5
1649793362068,COGS 115,A01,083982,Staff,26,0,30,4
1649793368089,COGS 118B,A01,083367,Staff,19,0,40,21
1649793374121,COGS 172,A01,083984,Provenzano; Emily Kara,25,0,30,5
1649793386438,COGS 177,A00,083368,Staff,18,0,30,12
1649793392461,COGS 186,A01,083986,Staff,28,0,40,12
1649793398484,COGS 187A,A01,083988,Boyle; Mary E. T.,52,0,60,8
1649793404510,CSE 8A,A50,084003,Miranda; Gregory Joseph,12,0,15,3
1649793410536,CSE 11,A01,084005,Miranda; Gregory Joseph,52,0,55,3
1649793416563,CSE 20,A01,084007,Staff,17,0,20,3
1649793422585,CSE 21,A01,084009,Staff,47,0,50,3
1649793428608,CSE 30,A01,083370,Cao; Yingjun,33,0,40,7
1649793434631,CSE 100,A01,083372,Cao; Yingjun,35,0,40,5
1649793440659,CSE 101,A01,084011,Staff,18,0,40,22
1649793446687,CSE 141,A01,083374,Eldon; John,29,0,75,46
1649793452714,CSE 141L,A01,083376,Eldon; John,30,0,75,45
1649793458742,CSE 175,A01,084013,Kumar; Rakesh,25,0,25,0
1649793464768,CSE 190,A00,092508,Staff,15,0,15,0
1649793470795,ECE 5,A01,084049,Morris; Karcher William,18,0,20,2
1649793476818,ECE 100,A01,084051,Baghdadchi; Saharnaz,18,0,20,2
1649793476818,ECE 100,A02,091916,Baghdadchi; Saharnaz,19,0,20,1
1649793482841,ECE 101,A01,084053,Baghdadchi; Saharnaz,33,0,37,4
1649793482841,ECE 101,A02,084054,Baghdadchi; Saharnaz,37,0,37,0
1649793488868,ECE 107,A01,083390,Staff,35,0,40,5
1649793494895,ECE 148,A01,084056,Silberman; Jack,8,0,12,4
1649793500920,ECE 180,A00,083391,Abi Samra; Nicholas Camill,27,0,30,3
1649793500920,ECE 180,B00,083392,Abi Samra; Nicholas Camill,26,0,30,4
1649793506955,MATH 10B,A01,084110,Staff,25,0,30,5
1649793506955,MATH 10B,A02,084111,Staff,29,0,30,1
1649793506955,MATH 10B,A03,084112,Staff,30,0,30,0
1649793512980,MATH 10C,A01,083443,Staff,26,0,30,4
1649793512980,MATH 10C,A02,083444,Staff,26,0,30,4
1649793512980,MATH 10C,B01,084114,Staff,28,0,30,2
1649793512980,MATH 10C,B02,084115,Staff,30,0,30,0
1649793519004,MATH 18,A01,084117,Harel; Guershon,28,0,30,2
1649793519004,MATH 18,A02,084119,Harel; Guershon,29,0,30,1
1649793519004,MATH 18,A03,084120,Harel; Guershon,30,0,30,0
1649793519004,MATH 18,A04,084121,Harel; Guershon,30,0,30,0
1649793525028,MATH 20B,A01,084124,Um; Ko Woon,34,0,35,1
1649793525028,MATH 20B,B01,084126,Um; Ko Woon,35,0,35,0
1649793531064,MATH 20C,A01,083446,Hammock; Frances H,29,0,30,1
1649793531064,MATH 20C,A02,083447,Hammock; Frances H,30,0,30,0
1649793531064,MATH 20C,A03,083448,Hammock; Frances H,30,0,30,0
1649793531064,MATH 20C,A04,083449,Hammock; Frances H,30,0,30,0
1649793531064,MATH 20C,B01,083451,Hammock; Frances H,30,0,30,0
1649793531064,MATH 20C,B02,083452,Hammock; Frances H,30,0,30,0
1649793531064,MATH 20C,B03,083453,Hammock; Frances H,30,0,30,0
1649793531064,MATH 20C,B04,083454,Hammock; Frances H,30,0,30,0
1649793537104,MATH 20D,A01,084128,Staff,30,0,30,0
1649793537104,MATH 20D,A02,084129,Staff,30,0,30,0
1649793537104,MATH 20D,A03,084130,Staff,29,0,30,1
1649793537104,MATH 20D,B01,084133,Staff,29,0,30,1
1649793537104,MATH 20D,B02,084134,Staff,30,0,30,0
1649793537104,MATH 20D,B03,084135,Staff,30,0,30,0
1649793543132,MATH 20E,A01,084138,Staff,30,0,30,0
1649793543132,MATH 20E,A02,084139,Staff,29,0,30,1
1649793543132,MATH 20E,A03,084140,Staff,30,0,30,0
1649793543132,MATH 20E,A04,084141,Staff,30,0,30,0
1649793549160,MATH 102,A01,084143,Harel; Guershon,27,0,30,3
1649793549160,MATH 102,A02,084144,Harel; Guershon,29,0,30,1
1649793555190,MATH 103B,A01,083456,Staff,17,0,30,13
1649793555190,MATH 103B,A02,083457,Staff,27,0,30,3
1649793561225,MATH 109,A01,084146,Salehi Golsefidy; Alireza,30,0,30,0
1649793561225,MATH 109,A02,084147,Salehi Golsefidy; Alireza,28,0,30,2
1649793567248,MATH 120A,A01,085445,Eggers; John Dietrich,32,0,35,3
1649793567248,MATH 120A,A02,085446,Eggers; John Dietrich,33,0,35,2
1649793573272,MATH 142B,A01,084149,Verstraete; Jacques Allan,25,0,30,5
1649793573272,MATH 142B,A02,084150,Verstraete; Jacques Allan,27,0,30,3
1649793579308,MATH 170A,A01,083459,Nie; Jiawang,18,0,30,12
1649793579308,MATH 170A,A02,083460,Nie; Jiawang,28,0,30,2
1649793579308,MATH 170A,A03,083461,Nie; Jiawang,30,0,30,0
1649793585332,MATH 193B,A01,083463,Staff,24,0,30,6
1649793585332,MATH 193B,A02,083464,Staff,27,0,30,3
1649793585332,MATH 193B,A03,083465,Staff,30,0,30,0
1649793591484,COGS 2,A01,083966,Boyle; Mary E. T.,28,0,30,2
1649793597508,COGS 9,A01,083968,Staff,59,0,60,1
1649793603538,COGS 14B,A01,083970,Staff,49,0,50,1
1649793609565,COGS 100,A01,083972,Staff,56,0,60,4
1649793621612,COGS 101C,A01,083976,Staff,27,0,30,3
1649793627639,COGS 102A,A01,083978,Johnson; Christine M.,29,0,30,1
1649793633678,COGS 107B,A01,083980,Staff,45,0,50,5
1649793639701,COGS 115,A01,083982,Staff,26,0,30,4
1649793645727,COGS 118B,A01,083367,Staff,19,0,40,21
1649793651754,COGS 172,A01,083984,Provenzano; Emily Kara,25,0,30,5
1649793657775,COGS 177,A00,083368,Staff,18,0,30,12
1649793663812,COGS 186,A01,083986,Staff,28,0,40,12
1649793669835,COGS 187A,A01,083988,Boyle; Mary E. T.,52,0,60,8
1649793675866,CSE 8A,A50,084003,Miranda; Gregory Joseph,12,0,15,3
1649793681893,CSE 11,A01,084005,Miranda; Gregory Joseph,52,0,55,3
1649793687915,CSE 20,A01,084007,Staff,17,0,20,3
1649793693944,CSE 21,A01,084009,Staff,47,0,50,3
1649793699969,CSE 30,A01,083370,Cao; Yingjun,33,0,40,7
1649793705995,CSE 100,A01,083372,Cao; Yingjun,35,0,40,5
1649793712025,CSE 101,A01,084011,Staff,18,0,40,22
1649793718061,CSE 141,A01,083374,Eldon; John,29,0,75,46
1649793724090,CSE 141L,A01,083376,Eldon; John,30,0,75,45
1649793730116,CSE 175,A01,084013,Kumar; Rakesh,25,0,25,0
1649793736151,CSE 190,A00,092508,Staff,15,0,15,0
1649793742191,ECE 5,A01,084049,Morris; Karcher William,18,0,20,2
1649793748223,ECE 100,A01,084051,Baghdadchi; Saharnaz,18,0,20,2
1649793748223,ECE 100,A02,091916,Baghdadchi; Saharnaz,19,0,20,1
1649793754249,ECE 101,A01,084053,Baghdadchi; Saharnaz,33,0,37,4
1649793754249,ECE 101,A02,084054,Baghdadchi; Saharnaz,37,0,37,0
1649793760280,ECE 107,A01,083390,Staff,35,0,40,5
1649793766303,ECE 148,A01,084056,Silberman; Jack,8,0,12,4
1649793772327,ECE 180,A00,083391,Abi Samra; Nicholas Camill,27,0,30,3
1649793772327,ECE 180,B00,083392,Abi Samra; Nicholas Camill,26,0,30,4
1649793778354,MATH 10B,A01,084110,Staff,25,0,30,5
1649793778354,MATH 10B,A02,084111,Staff,29,0,30,1
1649793778354,MATH 10B,A03,084112,Staff,30,0,30,0
1649793784378,MATH 10C,A01,083443,Staff,26,0,30,4
1649793784378,MATH 10C,A02,083444,Staff,26,0,30,4
1649793784378,MATH 10C,B01,084114,Staff,28,0,30,2
1649793784378,MATH 10C,B02,084115,Staff,30,0,30,0
1649793790405,MATH 18,A01,084117,Harel; Guershon,28,0,30,2
1649793790405,MATH 18,A02,084119,Harel; Guershon,29,0,30,1
1649793790405,MATH 18,A03,084120,Harel; Guershon,30,0,30,0
1649793790405,MATH 18,A04,084121,Harel; Guershon,30,0,30,0
1649793796429,MATH 20B,A01,084124,Um; Ko Woon,34,0,35,1
1649793796429,MATH 20B,B01,084126,Um; Ko Woon,35,0,35,0
1649793802499,MATH 20C,A01,083446,Hammock; Frances H,29,0,30,1
1649793802499,MATH 20C,A02,083447,Hammock; Frances H,30,0,30,0
1649793802499,MATH 20C,A03,083448,Hammock; Frances H,30,0,30,0
1649793802499,MATH 20C,A04,083449,Hammock; Frances H,30,0,30,0
1649793802499,MATH 20C,B01,083451,Hammock; Frances H,30,0,30,0
1649793802499,MATH 20C,B02,083452,Hammock; Frances H,30,0,30,0
1649793802499,MATH 20C,B03,083453,Hammock; Frances H,30,0,30,0
1649793802499,MATH 20C,B04,083454,Hammock; Frances H,30,0,30,0
1649793808536,MATH 20D,A01,084128,Staff,30,0,30,0
1649793808536,MATH 20D,A02,084129,Staff,30,0,30,0
1649793808536,MATH 20D,A03,084130,Staff,29,0,30,1
1649793808536,MATH 20D,B01,084133,Staff,29,0,30,1
1649793808536,MATH 20D,B02,084134,Staff,30,0,30,0
1649793808536,MATH 20D,B03,084135,Staff,30,0,30,0
1649793814559,MATH 20E,A01,084138,Staff,30,0,30,0
1649793814559,MATH 20E,A02,084139,Staff,29,0,30,1
1649793814559,MATH 20E,A03,084140,Staff,30,0,30,0
1649793814559,MATH 20E,A04,084141,Staff,30,0,30,0
1649793820585,MATH 102,A01,084143,Harel; Guershon,27,0,30,3
1649793820585,MATH 102,A02,084144,Harel; Guershon,29,0,30,1
1649793826609,MATH 103B,A01,083456,Staff,17,0,30,13
1649793826609,MATH 103B,A02,083457,Staff,27,0,30,3
1649793832641,MATH 109,A01,084146,Salehi Golsefidy; Alireza,30,0,30,0
1649793832641,MATH 109,A02,084147,Salehi Golsefidy; Alireza,28,0,30,2
1649793838668,MATH 120A,A01,085445,Eggers; John Dietrich,32,0,35,3
1649793838668,MATH 120A,A02,085446,Eggers; John Dietrich,33,0,35,2
1649793844695,MATH 142B,A01,084149,Verstraete; Jacques Allan,25,0,30,5
1649793844695,MATH 142B,A02,084150,Verstraete; Jacques Allan,27,0,30,3
1649793850733,MATH 170A,A01,083459,Nie; Jiawang,18,0,30,12
1649793850733,MATH 170A,A02,083460,Nie; Jiawang,28,0,30,2
1649793850733,MATH 170A,A03,083461,Nie; Jiawang,30,0,30,0
1649793856757,MATH 193B,A01,083463,Staff,24,0,30,6
1649793856757,MATH 193B,A02,083464,Staff,27,0,30,3
1649793856757,MATH 193B,A03,083465,Staff,30,0,30,0
1649793862833,COGS 2,A01,083966,Boyle; Mary E. T.,28,0,30,2
1649793868858,COGS 9,A01,083968,Staff,59,0,60,1
1649793874882,COGS 14B,A01,083970,Staff,49,0,50,1
1649793880910,COGS 100,A01,083972,Staff,56,0,60,4
1649793892971,COGS 101C,A01,083976,Staff,27,0,30,3
1649793898994,COGS 102A,A01,083978,Johnson; Christine M.,29,0,30,1
1649793905018,COGS 107B,A01,083980,Staff,45,0,50,5
1649793911042,COGS 115,A01,083982,Staff,26,0,30,4
1649793917078,COGS 118B,A01,083367,Staff,18,0,40,22
1649793923108,COGS 172,A01,083984,Provenzano; Emily Kara,25,0,30,5
1649793929134,COGS 177,A00,083368,Staff,17,0,30,13
1649793935166,COGS 186,A01,083986,Staff,28,0,40,12
1649793941188,COGS 187A,A01,083988,Boyle; Mary E. T.,52,0,60,8
1649793947233,CSE 8A,A50,084003,Miranda; Gregory Joseph,12,0,15,3
1649793953257,CSE 11,A01,084005,Miranda; Gregory Joseph,52,0,55,3
1649793959279,CSE 20,A01,084007,Staff,17,0,20,3
1649793965311,CSE 21,A01,084009,Staff,46,0,50,4
1649793971334,CSE 30,A01,083370,Cao; Yingjun,32,0,40,8
1649793977369,CSE 100,A01,083372,Cao; Yingjun,35,0,40,5
1649793983402,CSE 101,A01,084011,Staff,18,0,40,22
1649793989428,CSE 141,A01,083374,Eldon; John,29,0,75,46
1649793995454,CSE 141L,A01,083376,Eldon; John,30,0,75,45
1649794001480,CSE 175,A01,084013,Kumar; Rakesh,25,0,25,0
1649794007505,CSE 190,A00,092508,Staff,15,0,15,0
1649794013527,ECE 5,A01,084049,Morris; Karcher William,18,0,20,2
1649794019550,ECE 100,A01,084051,Baghdadchi; Saharnaz,18,0,20,2
1649794019550,ECE 100,A02,091916,Baghdadchi; Saharnaz,19,0,20,1
1649794025573,ECE 101,A01,084053,Baghdadchi; Saharnaz,33,0,37,4
1649794025573,ECE 101,A02,084054,Baghdadchi; Saharnaz,37,0,37,0
1649794031596,ECE 107,A01,083390,Staff,35,0,40,5
1649794037620,ECE 148,A01,084056,Silberman; Jack,8,0,12,4
1649794043656,ECE 180,A00,083391,Abi Samra; Nicholas Camill,27,0,30,3
1649794043656,ECE 180,B00,083392,Abi Samra; Nicholas Camill,26,0,30,4
1649794049680,MATH 10B,A01,084110,Staff,25,0,30,5
1649794049680,MATH 10B,A02,084111,Staff,29,0,30,1
1649794049680,MATH 10B,A03,084112,Staff,30,0,30,0
1649794055734,MATH 10C,A01,083443,Staff,26,0,30,4
1649794055734,MATH 10C,A02,083444,Staff,26,0,30,4
1649794055734,MATH 10C,B01,084114,Staff,28,0,30,2
1649794055734,MATH 10C,B02,084115,Staff,30,0,30,0
1649794061767,MATH 18,A01,084117,Harel; Guershon,28,0,30,2
1649794061767,MATH 18,A02,084119,Harel; Guershon,29,0,30,1
1649794061767,MATH 18,A03,084120,Harel; Guershon,30,0,30,0
1649794061767,MATH 18,A04,084121,Harel; Guershon,30,0,30,0
1649794067792,MATH 20B,A01,084124,Um; Ko Woon,34,0,35,1
1649794067792,MATH 20B,B01,084126,Um; Ko Woon,35,0,35,0
1649794073819,MATH 20C,A01,083446,Hammock; Frances H,29,0,30,1
1649794073819,MATH 20C,A02,083447,Hammock; Frances H,30,0,30,0
1649794073819,MATH 20C,A03,083448,Hammock; Frances H,30,0,30,0
1649794073819,MATH 20C,A04,083449,Hammock; Frances H,30,0,30,0
1649794073819,MATH 20C,B01,083451,Hammock; Frances H,30,0,30,0
1649794073819,MATH 20C,B02,083452,Hammock; Frances H,30,0,30,0
1649794073819,MATH 20C,B03,083453,Hammock; Frances H,30,0,30,0
1649794073819,MATH 20C,B04,083454,Hammock; Frances H,30,0,30,0
1649794079854,MATH 20D,A01,084128,Staff,30,0,30,0
1649794079854,MATH 20D,A02,084129,Staff,30,0,30,0
1649794079854,MATH 20D,A03,084130,Staff,29,0,30,1
1649794079854,MATH 20D,B01,084133,Staff,29,0,30,1
1649794079854,MATH 20D,B02,084134,Staff,30,0,30,0
1649794079854,MATH 20D,B03,084135,Staff,30,0,30,0
1649794085883,MATH 20E,A01,084138,Staff,30,0,30,0
1649794085883,MATH 20E,A02,084139,Staff,29,0,30,1
1649794085883,MATH 20E,A03,084140,Staff,30,0,30,0
1649794085883,MATH 20E,A04,084141,Staff,30,0,30,0
1649794091919,MATH 102,A01,084143,Harel; Guershon,27,0,30,3
1649794091919,MATH 102,A02,084144,Harel; Guershon,29,0,30,1
1649794097947,MATH 103B,A01,083456,Staff,17,0,30,13
1649794097947,MATH 103B,A02,083457,Staff,27,0,30,3
1649794103982,MATH 109,A01,084146,Salehi Golsefidy; Alireza,30,0,30,0
1649794103982,MATH 109,A02,084147,Salehi Golsefidy; Alireza,28,0,30,2
1649794110008,MATH 120A,A01,085445,Eggers; John Dietrich,32,0,35,3
1649794110008,MATH 120A,A02,085446,Eggers; John Dietrich,33,0,35,2
1649794116029,MATH 142B,A01,084149,Verstraete; Jacques Allan,25,0,30,5
1649794116029,MATH 142B,A02,084150,Verstraete; Jacques Allan,27,0,30,3
1649794122052,MATH 170A,A01,083459,Nie; Jiawang,18,0,30,12
1649794122052,MATH 170A,A02,083460,Nie; Jiawang,28,0,30,2
1649794122052,MATH 170A,A03,083461,Nie; Jiawang,30,0,30,0
1649794128076,MATH 193B,A01,083463,Staff,24,0,30,6
1649794128076,MATH 193B,A02,083464,Staff,26,0,30,4
1649794128076,MATH 193B,A03,083465,Staff,30,0,30,0
1649794134142,COGS 2,A01,083966,Boyle; Mary E. T.,28,0,30,2
1649794140173,COGS 9,A01,083968,Staff,59,0,60,1
1649794146206,COGS 14B,A01,083970,Staff,49,0,50,1
1649794152235,COGS 100,A01,083972,Staff,56,0,60,4
1649794164286,COGS 101C,A01,083976,Staff,27,0,30,3
1649794170325,COGS 102A,A01,083978,Johnson; Christine M.,29,0,30,1
1649794176348,COGS 107B,A01,083980,Staff,45,0,50,5
1649794182371,COGS 115,A01,083982,Staff,26,0,30,4
1649794188494,COGS 118B,A01,083367,Staff,18,0,40,22
1649794194521,COGS 172,A01,083984,Provenzano; Emily Kara,25,0,30,5
1649794200551,COGS 177,A00,083368,Staff,17,0,30,13
1649794206578,COGS 186,A01,083986,Staff,28,0,40,12
1649794212620,COGS 187A,A01,083988,Boyle; Mary E. T.,52,0,60,8
1649794218651,CSE 8A,A50,084003,Miranda; Gregory Joseph,12,0,15,3
1649794224677,CSE 11,A01,084005,Miranda; Gregory Joseph,52,0,55,3
1649794230702,CSE 20,A01,084007,Staff,17,0,20,3
1649794236727,CSE 21,A01,084009,Staff,46,0,50,4
1649794242752,CSE 30,A01,083370,Cao; Yingjun,32,0,40,8
1649794248780,CSE 100,A01,083372,Cao; Yingjun,35,0,40,5
1649794254806,CSE 101,A01,084011,Staff,18,0,40,22
1649794260829,CSE 141,A01,083374,Eldon; John,28,0,75,47
1649794266858,CSE 141L,A01,083376,Eldon; John,29,0,75,46
1649794272888,CSE 175,A01,084013,Kumar; Rakesh,25,0,25,0
1649794278929,CSE 190,A00,092508,Staff,15,0,15,0
1649794284952,ECE 5,A01,084049,Morris; Karcher William,18,0,20,2
1649794290976,ECE 100,A01,084051,Baghdadchi; Saharnaz,18,0,20,2
1649794290976,ECE 100,A02,091916,Baghdadchi; Saharnaz,19,0,20,1
1649794296999,ECE 101,A01,084053,Baghdadchi; Saharnaz,33,0,37,4
1649794296999,ECE 101,A02,084054,Baghdadchi; Saharnaz,37,0,37,0
1649794303021,ECE 107,A01,083390,Staff,35,0,40,5
1649794309049,ECE 148,A01,084056,Silberman; Jack,8,0,12,4
1649794315073,ECE 180,A00,083391,Abi Samra; Nicholas Camill,27,0,30,3
1649794315073,ECE 180,B00,083392,Abi Samra; Nicholas Camill,26,0,30,4
1649794321110,MATH 10B,A01,084110,Staff,25,0,30,5
1649794321110,MATH 10B,A02,084111,Staff,29,0,30,1
1649794321110,MATH 10B,A03,084112,Staff,30,0,30,0
1649794327133,MATH 10C,A01,083443,Staff,26,0,30,4
1649794327133,MATH 10C,A02,083444,Staff,26,0,30,4
1649794327133,MATH 10C,B01,084114,Staff,28,0,30,2
1649794327133,MATH 10C,B02,084115,Staff,30,0,30,0
1649794333157,MATH 18,A01,084117,Harel; Guershon,28,0,30,2
1649794333157,MATH 18,A02,084119,Harel; Guershon,29,0,30,1
1649794333157,MATH 18,A03,084120,Harel; Guershon,30,0,30,0
1649794333157,MATH 18,A04,084121,Harel; Guershon,30,0,30,0
1649794339185,MATH 20B,A01,084124,Um; Ko Woon,34,0,35,1
1649794339185,MATH 20B,B01,084126,Um; Ko Woon,35,0,35,0
1649794345219,MATH 20C,A01,083446,Hammock; Frances H,29,0,30,1
1649794345219,MATH 20C,A02,083447,Hammock; Frances H,30,0,30,0
1649794345219,MATH 20C,A03,083448,Hammock; Frances H,30,0,30,0
1649794345219,MATH 20C,A04,083449,Hammock; Frances H,30,0,30,0
1649794345219,MATH 20C,B01,083451,Hammock; Frances H,30,0,30,0
1649794345219,MATH 20C,B02,083452,Hammock; Frances H,30,0,30,0
1649794345219,MATH 20C,B03,083453,Hammock; Frances H,30,0,30,0
1649794345219,MATH 20C,B04,083454,Hammock; Frances H,30,0,30,0
1649794351245,MATH 20D,A01,084128,Staff,30,0,30,0
1649794351245,MATH 20D,A02,084129,Staff,30,0,30,0
1649794351245,MATH 20D,A03,084130,Staff,29,0,30,1
1649794351245,MATH 20D,B01,084133,Staff,29,0,30,1
1649794351245,MATH 20D,B02,084134,Staff,30,0,30,0
1649794351245,MATH 20D,B03,084135,Staff,30,0,30,0
1649794357269,MATH 20E,A01,084138,Staff,30,0,30,0
1649794357269,MATH 20E,A02,084139,Staff,29,0,30,1
1649794357269,MATH 20E,A03,084140,Staff,30,0,30,0
1649794357269,MATH 20E,A04,084141,Staff,30,0,30,0
1649794363295,MATH 102,A01,084143,Harel; Guershon,27,0,30,3
1649794363295,MATH 102,A02,084144,Harel; Guershon,29,0,30,1
1649794369318,MATH 103B,A01,083456,Staff,17,0,30,13
1649794369318,MATH 103B,A02,083457,Staff,27,0,30,3
1649794375340,MATH 109,A01,084146,Salehi Golsefidy; Alireza,30,0,30,0
1649794375340,MATH 109,A02,084147,Salehi Golsefidy; Alireza,28,0,30,2
1649794381377,MATH 120A,A01,085445,Eggers; John Dietrich,32,0,35,3
1649794381377,MATH 120A,A02,085446,Eggers; John Dietrich,33,0,35,2
1649794387400,MATH 142B,A01,084149,Verstraete; Jacques Allan,25,0,30,5
1649794387400,MATH 142B,A02,084150,Verstraete; Jacques Allan,27,0,30,3
1649794393430,MATH 170A,A01,083459,Nie; Jiawang,17,0,30,13
1649794393430,MATH 170A,A02,083460,Nie; Jiawang,28,0,30,2
1649794393430,MATH 170A,A03,083461,Nie; Jiawang,30,0,30,0
1649794399453,MATH 193B,A01,083463,Staff,24,0,30,6
1649794399453,MATH 193B,A02,083464,Staff,26,0,30,4
1649794399453,MATH 193B,A03,083465,Staff,30,0,30,0
1649794405507,COGS 2,A01,083966,Boyle; Mary E. T.,28,0,30,2
1649794411537,COGS 9,A01,083968,Staff,59,0,60,1
1649794417567,COGS 14B,A01,083970,Staff,49,0,50,1
1649794423596,COGS 100,A01,083972,Staff,56,0,60,4
1649794435646,COGS 101C,A01,083976,Staff,27,0,30,3
1649794441668,COGS 102A,A01,083978,Johnson; Christine M.,29,0,30,1
1649794447692,COGS 107B,A01,083980,Staff,45,0,50,5
1649794453728,COGS 115,A01,083982,Staff,26,0,30,4
1649794459751,COGS 118B,A01,083367,Staff,18,0,40,22
1649794465779,COGS 172,A01,083984,Provenzano; Emily Kara,25,0,30,5
1649794471808,COGS 177,A00,083368,Staff,17,0,30,13
1649794477836,COGS 186,A01,083986,Staff,28,0,40,12
1649794483860,COGS 187A,A01,083988,Boyle; Mary E. T.,52,0,60,8
1649794489882,CSE 8A,A50,084003,Miranda; Gregory Joseph,12,0,15,3
1649794495906,CSE 11,A01,084005,Miranda; Gregory Joseph,52,0,55,3
1649794501929,CSE 20,A01,084007,Staff,17,0,20,3
1649794507961,CSE 21,A01,084009,Staff,46,0,50,4
1649794513988,CSE 30,A01,083370,Cao; Yingjun,32,0,40,8
1649794520010,CSE 100,A01,083372,Cao; Yingjun,34,0,40,6
1649794526050,CSE 101,A01,084011,Staff,18,0,40,22
1649794532085,CSE 141,A01,083374,Eldon; John,28,0,75,47
1649794538108,CSE 141L,A01,083376,Eldon; John,29,0,75,46
1649794544139,CSE 175,A01,084013,Kumar; Rakesh,25,0,25,0
1649794550166,CSE 190,A00,092508,Staff,15,0,15,0
1649794556199,ECE 5,A01,084049,Morris; Karcher William,18,0,20,2
1649794562221,ECE 100,A01,084051,Baghdadchi; Saharnaz,18,0,20,2
1649794562221,ECE 100,A02,091916,Baghdadchi; Saharnaz,19,0,20,1
1649794568254,ECE 101,A01,084053,Baghdadchi; Saharnaz,33,0,37,4
1649794568254,ECE 101,A02,084054,Baghdadchi; Saharnaz,37,0,37,0
1649794574277,ECE 107,A01,083390,Staff,35,0,40,5
1649794580298,ECE 148,A01,084056,Silberman; Jack,8,0,12,4
1649794586321,ECE 180,A00,083391,Abi Samra; Nicholas Camill,27,0,30,3
1649794586321,ECE 180,B00,083392,Abi Samra; Nicholas Camill,26,0,30,4
1649794592356,MATH 10B,A01,084110,Staff,25,0,30,5
1649794592356,MATH 10B,A02,084111,Staff,29,0,30,1
1649794592356,MATH 10B,A03,084112,Staff,30,0,30,0
1649794598390,MATH 10C,A01,083443,Staff,26,0,30,4
1649794598390,MATH 10C,A02,083444,Staff,26,0,30,4
1649794598390,MATH 10C,B01,084114,Staff,28,0,30,2
1649794598390,MATH 10C,B02,084115,Staff,30,0,30,0
1649794604423,MATH 18,A01,084117,Harel; Guershon,28,0,30,2
1649794604423,MATH 18,A02,084119,Harel; Guershon,29,0,30,1
1649794604423,MATH 18,A03,084120,Harel; Guershon,30,0,30,0
1649794604423,MATH 18,A04,084121,Harel; Guershon,30,0,30,0
1649794610451,MATH 20B,A01,084124,Um; Ko Woon,34,0,35,1
1649794610451,MATH 20B,B01,084126,Um; Ko Woon,35,0,35,0
1649794616484,MATH 20C,A01,083446,Hammock; Frances H,29,0,30,1
1649794616484,MATH 20C,A02,083447,Hammock; Frances H,30,0,30,0
1649794616484,MATH 20C,A03,083448,Hammock; Frances H,30,0,30,0
1649794616484,MATH 20C,A04,083449,Hammock; Frances H,30,0,30,0
1649794616484,MATH 20C,B01,083451,Hammock; Frances H,30,0,30,0
1649794616484,MATH 20C,B02,083452,Hammock; Frances H,30,0,30,0
1649794616484,MATH 20C,B03,083453,Hammock; Frances H,30,0,30,0
1649794616484,MATH 20C,B04,083454,Hammock; Frances H,30,0,30,0
1649794622517,MATH 20D,A01,084128,Staff,30,0,30,0
1649794622517,MATH 20D,A02,084129,Staff,30,0,30,0
1649794622517,MATH 20D,A03,084130,Staff,29,0,30,1
1649794622517,MATH 20D,B01,084133,Staff,29,0,30,1
1649794622517,MATH 20D,B02,084134,Staff,30,0,30,0
1649794622517,MATH 20D,B03,084135,Staff,30,0,30,0
1649794628548,MATH 20E,A01,084138,Staff,30,0,30,0
1649794628548,MATH 20E,A02,084139,Staff,29,0,30,1
1649794628548,MATH 20E,A03,084140,Staff,30,0,30,0
1649794628548,MATH 20E,A04,084141,Staff,30,0,30,0
1649794634584,MATH 102,A01,084143,Harel; Guershon,27,0,30,3
1649794634584,MATH 102,A02,084144,Harel; Guershon,29,0,30,1
1649794640611,MATH 103B,A01,083456,Staff,16,0,30,14
1649794640611,MATH 103B,A02,083457,Staff,27,0,30,3
1649794646638,MATH 109,A01,084146,Salehi Golsefidy; Alireza,30,0,30,0
1649794646638,MATH 109,A02,084147,Salehi Golsefidy; Alireza,28,0,30,2
1649794652668,MATH 120A,A01,085445,Eggers; John Dietrich,32,0,35,3
1649794652668,MATH 120A,A02,085446,Eggers; John Dietrich,33,0,35,2
1649794658696,MATH 142B,A01,084149,Verstraete; Jacques Allan,25,0,30,5
1649794658696,MATH 142B,A02,084150,Verstraete; Jacques Allan,26,0,30,4
1649794664719,MATH 170A,A01,083459,Nie; Jiawang,18,0,30,12
1649794664719,MATH 170A,A02,083460,Nie; Jiawang,28,0,30,2
1649794664719,MATH 170A,A03,083461,Nie; Jiawang,30,0,30,0
1649794670745,MATH 193B,A01,083463,Staff,24,0,30,6
1649794670745,MATH 193B,A02,083464,Staff,26,0,30,4
1649794670745,MATH 193B,A03,083465,Staff,30,0,30,0
1649794676795,COGS 2,A01,083966,Boyle; Mary E. T.,28,0,30,2
1649794682822,COGS 9,A01,083968,Staff,59,0,60,1
1649794688865,COGS 14B,A01,083970,Staff,49,0,50,1
1649794694891,COGS 100,A01,083972,Staff,56,0,60,4
1649794706943,COGS 101C,A01,083976,Staff,27,0,30,3
1649794712984,COGS 102A,A01,083978,Johnson; Christine M.,29,0,30,1
1649794719009,COGS 107B,A01,083980,Staff,45,0,50,5
1649794725032,COGS 115,A01,083982,Staff,26,0,30,4
1649794731055,COGS 118B,A01,083367,Staff,18,0,40,22
1649794737079,COGS 172,A01,083984,Provenzano; Emily Kara,25,0,30,5
1649794743106,COGS 177,A00,083368,Staff,17,0,30,13
1649794749131,COGS 186,A01,083986,Staff,28,0,40,12
1649794755156,COGS 187A,A01,083988,Boyle; Mary E. T.,52,0,60,8
1649794761183,CSE 8A,A50,084003,Miranda; Gregory Joseph,12,0,15,3
1649794767207,CSE 11,A01,084005,Miranda; Gregory Joseph,52,0,55,3
1649794773243,CSE 20,A01,084007,Staff,17,0,20,3
1649794779282,CSE 21,A01,084009,Staff,46,0,50,4
1649794785422,CSE 30,A01,083370,Cao; Yingjun,32,0,40,8
1649794791456,CSE 100,A01,083372,Cao; Yingjun,34,0,40,6
1649794797479,CSE 101,A01,084011,Staff,18,0,40,22
1649794803510,CSE 141,A01,083374,Eldon; John,28,0,75,47
1649794809537,CSE 141L,A01,083376,Eldon; John,29,0,75,46
1649794815571,CSE 175,A01,084013,Kumar; Rakesh,25,0,25,0
1649794821605,CSE 190,A00,092508,Staff,15,0,15,0
1649794827628,ECE 5,A01,084049,Morris; Karcher William,18,0,20,2
1649794833651,ECE 100,A01,084051,Baghdadchi; Saharnaz,18,0,20,2
1649794833651,ECE 100,A02,091916,Baghdadchi; Saharnaz,19,0,20,1
1649794839677,ECE 101,A01,084053,Baghdadchi; Saharnaz,33,0,37,4
1649794839677,ECE 101,A02,084054,Baghdadchi; Saharnaz,37,0,37,0
1649794845719,ECE 107,A01,083390,Staff,35,0,40,5
1649794851747,ECE 148,A01,084056,Silberman; Jack,8,0,12,4
1649794857769,ECE 180,A00,083391,Abi Samra; Nicholas Camill,27,0,30,3
1649794857769,ECE 180,B00,083392,Abi Samra; Nicholas Camill,26,0,30,4
1649794863796,MATH 10B,A01,084110,Staff,25,0,30,5
1649794863796,MATH 10B,A02,084111,Staff,29,0,30,1
1649794863796,MATH 10B,A03,084112,Staff,30,0,30,0
1649794869825,MATH 10C,A01,083443,Staff,26,0,30,4
1649794869825,MATH 10C,A02,083444,Staff,26,0,30,4
1649794869825,MATH 10C,B01,084114,Staff,28,0,30,2
1649794869825,MATH 10C,B02,084115,Staff,30,0,30,0
1649794875867,MATH 18,A01,084117,Harel; Guershon,28,0,30,2
1649794875867,MATH 18,A02,084119,Harel; Guershon,29,0,30,1
1649794875867,MATH 18,A03,084120,Harel; Guershon,30,0,30,0
1649794875867,MATH 18,A04,084121,Harel; Guershon,30,0,30,0
1649794881896,MATH 20B,A01,084124,Um; Ko Woon,34,0,35,1
1649794881896,MATH 20B,B01,084126,Um; Ko Woon,35,0,35,0
1649794887920,MATH 20C,A01,083446,Hammock; Frances H,29,0,30,1
1649794887920,MATH 20C,A02,083447,Hammock; Frances H,30,0,30,0
1649794887920,MATH 20C,A03,083448,Hammock; Frances H,30,0,30,0
1649794887920,MATH 20C,A04,083449,Hammock; Frances H,30,0,30,0
1649794887920,MATH 20C,B01,083451,Hammock; Frances H,30,0,30,0
1649794887920,MATH 20C,B02,083452,Hammock; Frances H,30,0,30,0
1649794887920,MATH 20C,B03,083453,Hammock; Frances H,30,0,30,0
1649794887920,MATH 20C,B04,083454,Hammock; Frances H,30,0,30,0
1649794893942,MATH 20D,A01,084128,Staff,30,0,30,0
1649794893942,MATH 20D,A02,084129,Staff,30,0,30,0
1649794893942,MATH 20D,A03,084130,Staff,29,0,30,1
1649794893942,MATH 20D,B01,084133,Staff,29,0,30,1
1649794893942,MATH 20D,B02,084134,Staff,30,0,30,0
1649794893942,MATH 20D,B03,084135,Staff,30,0,30,0
1649794899968,MATH 20E,A01,084138,Staff,30,0,30,0
1649794899968,MATH 20E,A02,084139,Staff,29,0,30,1
1649794899968,MATH 20E,A03,084140,Staff,30,0,30,0
1649794899968,MATH 20E,A04,084141,Staff,30,0,30,0
1649794905992,MATH 102,A01,084143,Harel; Guershon,27,0,30,3
1649794905992,MATH 102,A02,084144,Harel; Guershon,29,0,30,1
1649794912018,MATH 103B,A01,083456,Staff,16,0,30,14
1649794912018,MATH 103B,A02,083457,Staff,27,0,30,3
1649794918050,MATH 109,A01,084146,Salehi Golsefidy; Alireza,30,0,30,0
1649794918050,MATH 109,A02,084147,Salehi Golsefidy; Alireza,28,0,30,2
1649794924085,MATH 120A,A01,085445,Eggers; John Dietrich,32,0,35,3
1649794924085,MATH 120A,A02,085446,Eggers; John Dietrich,33,0,35,2
1649794930110,MATH 142B,A01,084149,Verstraete; Jacques Allan,25,0,30,5
1649794930110,MATH 142B,A02,084150,Verstraete; Jacques Allan,26,0,30,4
1649794936134,MATH 170A,A01,083459,Nie; Jiawang,18,0,30,12
1649794936134,MATH 170A,A02,083460,Nie; Jiawang,28,0,30,2
1649794936134,MATH 170A,A03,083461,Nie; Jiawang,30,0,30,0
1649794942170,MATH 193B,A01,083463,Staff,24,0,30,6
1649794942170,MATH 193B,A02,083464,Staff,26,0,30,4
1649794942170,MATH 193B,A03,083465,Staff,30,0,30,0
1649794948231,COGS 2,A01,083966,Boyle; Mary E. T.,28,0,30,2
1649794954257,COGS 9,A01,083968,Staff,59,0,60,1
1649794960288,COGS 14B,A01,083970,Staff,49,0,50,1
1649794966317,COGS 100,A01,083972,Staff,55,0,60,5
1649794978412,COGS 101C,A01,083976,Staff,27,0,30,3
1649794984444,COGS 102A,A01,083978,Johnson; Christine M.,29,0,30,1
1649794990476,COGS 107B,A01,083980,Staff,45,0,50,5
1649794996506,COGS 115,A01,083982,Staff,26,0,30,4
1649795002530,COGS 118B,A01,083367,Staff,18,0,40,22
1649795008553,COGS 172,A01,083984,Provenzano; Emily Kara,25,0,30,5
1649795014576,COGS 177,A00,083368,Staff,17,0,30,13
1649795020602,COGS 186,A01,083986,Staff,28,0,40,12
1649795026624,COGS 187A,A01,083988,Boyle; Mary E. T.,52,0,60,8
1649795032655,CSE 8A,A50,084003,Miranda; Gregory Joseph,12,0,15,3
1649795038680,CSE 11,A01,084005,Miranda; Gregory Joseph,52,0,55,3
1649795044705,CSE 20,A01,084007,Staff,17,0,20,3
1649795050729,CSE 21,A01,084009,Staff,46,0,50,4
1649795056751,CSE 30,A01,083370,Cao; Yingjun,31,0,40,9
1649795062777,CSE 100,A01,083372,Cao; Yingjun,34,0,40,6
1649795068800,CSE 101,A01,084011,Staff,18,0,40,22
1649795074829,CSE 141,A01,083374,Eldon; John,28,0,75,47
1649795080852,CSE 141L,A01,083376,Eldon; John,29,0,75,46
1649795086879,CSE 175,A01,084013,Kumar; Rakesh,25,0,25,0
1649795092905,CSE 190,A00,092508,Staff,15,0,15,0
1649795098929,ECE 5,A01,084049,Morris; Karcher William,18,0,20,2
1649795104953,ECE 100,A01,084051,Baghdadchi; Saharnaz,18,0,20,2
1649795104953,ECE 100,A02,091916,Baghdadchi; Saharnaz,19,0,20,1
1649795110978,ECE 101,A01,084053,Baghdadchi; Saharnaz,33,0,37,4
1649795110978,ECE 101,A02,084054,Baghdadchi; Saharnaz,37,0,37,0
1649795117016,ECE 107,A01,083390,Staff,35,0,40,5
1649795123038,ECE 148,A01,084056,Silberman; Jack,8,0,12,4
1649795129066,ECE 180,A00,083391,Abi Samra; Nicholas Camill,27,0,30,3
1649795129066,ECE 180,B00,083392,Abi Samra; Nicholas Camill,26,0,30,4
1649795135112,MATH 10B,A01,084110,Staff,25,0,30,5
1649795135112,MATH 10B,A02,084111,Staff,29,0,30,1
1649795135112,MATH 10B,A03,084112,Staff,30,0,30,0
1649795141136,MATH 10C,A01,083443,Staff,26,0,30,4
1649795141136,MATH 10C,A02,083444,Staff,26,0,30,4
1649795141136,MATH 10C,B01,084114,Staff,28,0,30,2
1649795141136,MATH 10C,B02,084115,Staff,30,0,30,0
1649795147159,MATH 18,A01,084117,Harel; Guershon,28,0,30,2
1649795147159,MATH 18,A02,084119,Harel; Guershon,29,0,30,1
1649795147159,MATH 18,A03,084120,Harel; Guershon,30,0,30,0
1649795147159,MATH 18,A04,084121,Harel; Guershon,30,0,30,0
1649795153182,MATH 20B,A01,084124,Um; Ko Woon,34,0,35,1
1649795153182,MATH 20B,B01,084126,Um; Ko Woon,35,0,35,0
1649795159212,MATH 20C,A01,083446,Hammock; Frances H,29,0,30,1
1649795159212,MATH 20C,A02,083447,Hammock; Frances H,30,0,30,0
1649795159212,MATH 20C,A03,083448,Hammock; Frances H,30,0,30,0
1649795159212,MATH 20C,A04,083449,Hammock; Frances H,30,0,30,0
1649795159212,MATH 20C,B01,083451,Hammock; Frances H,30,0,30,0
1649795159212,MATH 20C,B02,083452,Hammock; Frances H,30,0,30,0
1649795159212,MATH 20C,B03,083453,Hammock; Frances H,30,0,30,0
1649795159212,MATH 20C,B04,083454,Hammock; Frances H,30,0,30,0
1649795165247,MATH 20D,A01,084128,Staff,30,0,30,0
1649795165247,MATH 20D,A02,084129,Staff,30,0,30,0
1649795165247,MATH 20D,A03,084130,Staff,29,0,30,1
1649795165247,MATH 20D,B01,084133,Staff,29,0,30,1
1649795165247,MATH 20D,B02,084134,Staff,30,0,30,0
1649795165247,MATH 20D,B03,084135,Staff,30,0,30,0
1649795171279,MATH 20E,A01,084138,Staff,30,0,30,0
1649795171279,MATH 20E,A02,084139,Staff,29,0,30,1
1649795171279,MATH 20E,A03,084140,Staff,30,0,30,0
1649795171279,MATH 20E,A04,084141,Staff,30,0,30,0
1649795177302,MATH 102,A01,084143,Harel; Guershon,27,0,30,3
1649795177302,MATH 102,A02,084144,Harel; Guershon,29,0,30,1
1649795183340,MATH 103B,A01,083456,Staff,16,0,30,14
1649795183340,MATH 103B,A02,083457,Staff,27,0,30,3
1649795189377,MATH 109,A01,084146,Salehi Golsefidy; Alireza,30,0,30,0
1649795189377,MATH 109,A02,084147,Salehi Golsefidy; Alireza,28,0,30,2
1649795195404,MATH 120A,A01,085445,Eggers; John Dietrich,32,0,35,3
1649795195404,MATH 120A,A02,085446,Eggers; John Dietrich,33,0,35,2
1649795201428,MATH 142B,A01,084149,Verstraete; Jacques Allan,25,0,30,5
1649795201428,MATH 142B,A02,084150,Verstraete; Jacques Allan,26,0,30,4
1649795207469,MATH 170A,A01,083459,Nie; Jiawang,18,0,30,12
1649795207469,MATH 170A,A02,083460,Nie; Jiawang,28,0,30,2
1649795207469,MATH 170A,A03,083461,Nie; Jiawang,30,0,30,0
1649795213502,MATH 193B,A01,083463,Staff,24,0,30,6
1649795213502,MATH 193B,A02,083464,Staff,26,0,30,4
1649795213502,MATH 193B,A03,083465,Staff,30,0,30,0
1649795219563,COGS 2,A01,083966,Boyle; Mary E. T.,28,0,30,2
1649795225588,COGS 9,A01,083968,Staff,59,0,60,1
1649795231624,COGS 14B,A01,083970,Staff,49,0,50,1
1649795237647,COGS 100,A01,083972,Staff,55,0,60,5
1649795249693,COGS 101C,A01,083976,Staff,27,0,30,3
1649795255718,COGS 102A,A01,083978,Johnson; Christine M.,29,0,30,1
1649795261744,COGS 107B,A01,083980,Staff,45,0,50,5
1649795267773,COGS 115,A01,083982,Staff,26,0,30,4
1649795273796,COGS 118B,A01,083367,Staff,18,0,40,22
1649795279820,COGS 172,A01,083984,Provenzano; Emily Kara,25,0,30,5
1649795285846,COGS 177,A00,083368,Staff,17,0,30,13
1649795291879,COGS 186,A01,083986,Staff,28,0,40,12
1649795297907,COGS 187A,A01,083988,Boyle; Mary E. T.,52,0,60,8
1649795303938,CSE 8A,A50,084003,Miranda; Gregory Joseph,12,0,15,3
1649795309971,CSE 11,A01,084005,Miranda; Gregory Joseph,52,0,55,3
1649795315994,CSE 20,A01,084007,Staff,17,0,20,3
1649795322026,CSE 21,A01,084009,Staff,46,0,50,4
1649795328048,CSE 30,A01,083370,Cao; Yingjun,31,0,40,9
1649795334070,CSE 100,A01,083372,Cao; Yingjun,34,0,40,6
1649795340095,CSE 101,A01,084011,Staff,18,0,40,22
1649795346117,CSE 141,A01,083374,Eldon; John,28,0,75,47
1649795352142,CSE 141L,A01,083376,Eldon; John,29,0,75,46
1649795358164,CSE 175,A01,084013,Kumar; Rakesh,25,0,25,0
1649795364196,CSE 190,A00,092508,Staff,15,0,15,0
1649795370220,ECE 5,A01,084049,Morris; Karcher William,18,0,20,2
1649795376246,ECE 100,A01,084051,Baghdadchi; Saharnaz,18,0,20,2
1649795376246,ECE 100,A02,091916,Baghdadchi; Saharnaz,19,0,20,1
1649795382368,ECE 101,A01,084053,Baghdadchi; Saharnaz,33,0,37,4
1649795382368,ECE 101,A02,084054,Baghdadchi; Saharnaz,37,0,37,0
1649795388398,ECE 107,A01,083390,Staff,35,0,40,5
1649795394421,ECE 148,A01,084056,Silberman; Jack,8,0,12,4
1649795400455,ECE 180,A00,083391,Abi Samra; Nicholas Camill,27,0,30,3
1649795400455,ECE 180,B00,083392,Abi Samra; Nicholas Camill,26,0,30,4
1649795406478,MATH 10B,A01,084110,Staff,25,0,30,5
1649795406478,MATH 10B,A02,084111,Staff,29,0,30,1
1649795406478,MATH 10B,A03,084112,Staff,30,0,30,0
1649795412512,MATH 10C,A01,083443,Staff,26,0,30,4
1649795412512,MATH 10C,A02,083444,Staff,26,0,30,4
1649795412512,MATH 10C,B01,084114,Staff,28,0,30,2
1649795412512,MATH 10C,B02,084115,Staff,30,0,30,0
1649795418539,MATH 18,A01,084117,Harel; Guershon,28,0,30,2
1649795418539,MATH 18,A02,084119,Harel; Guershon,29,0,30,1
1649795418539,MATH 18,A03,084120,Harel; Guershon,30,0,30,0
1649795418539,MATH 18,A04,084121,Harel; Guershon,30,0,30,0
1649795424568,MATH 20B,A01,084124,Um; Ko Woon,34,0,35,1
1649795424568,MATH 20B,B01,084126,Um; Ko Woon,35,0,35,0
1649795430604,MATH 20C,A01,083446,Hammock; Frances H,29,0,30,1
1649795430604,MATH 20C,A02,083447,Hammock; Frances H,30,0,30,0
1649795430604,MATH 20C,A03,083448,Hammock; Frances H,30,0,30,0
1649795430604,MATH 20C,A04,083449,Hammock; Frances H,30,0,30,0
1649795430604,MATH 20C,B01,083451,Hammock; Frances H,30,0,30,0
1649795430604,MATH 20C,B02,083452,Hammock; Frances H,30,0,30,0
1649795430604,MATH 20C,B03,083453,Hammock; Frances H,30,0,30,0
1649795430604,MATH 20C,B04,083454,Hammock; Frances H,30,0,30,0
1649795436636,MATH 20D,A01,084128,Staff,30,0,30,0
1649795436636,MATH 20D,A02,084129,Staff,30,0,30,0
1649795436636,MATH 20D,A03,084130,Staff,29,0,30,1
1649795436636,MATH 20D,B01,084133,Staff,29,0,30,1
1649795436636,MATH 20D,B02,084134,Staff,30,0,30,0
1649795436636,MATH 20D,B03,084135,Staff,30,0,30,0
1649795442666,MATH 20E,A01,084138,Staff,30,0,30,0
1649795442666,MATH 20E,A02,084139,Staff,29,0,30,1
1649795442666,MATH 20E,A03,084140,Staff,30,0,30,0
1649795442666,MATH 20E,A04,084141,Staff,30,0,30,0
1649795448689,MATH 102,A01,084143,Harel; Guershon,27,0,30,3
1649795448689,MATH 102,A02,084144,Harel; Guershon,29,0,30,1
1649795454727,MATH 103B,A01,083456,Staff,16,0,30,14
1649795454727,MATH 103B,A02,083457,Staff,27,0,30,3
1649795460759,MATH 109,A01,084146,Salehi Golsefidy; Alireza,30,0,30,0
1649795460759,MATH 109,A02,084147,Salehi Golsefidy; Alireza,28,0,30,2
1649795466782,MATH 120A,A01,085445,Eggers; John Dietrich,32,0,35,3
1649795466782,MATH 120A,A02,085446,Eggers; John Dietrich,33,0,35,2
1649795472811,MATH 142B,A01,084149,Verstraete; Jacques Allan,25,0,30,5
1649795472811,MATH 142B,A02,084150,Verstraete; Jacques Allan,26,0,30,4
1649795478840,MATH 170A,A01,083459,Nie; Jiawang,18,0,30,12
1649795478840,MATH 170A,A02,083460,Nie; Jiawang,28,0,30,2
1649795478840,MATH 170A,A03,083461,Nie; Jiawang,30,0,30,0
1649795484870,MATH 193B,A01,083463,Staff,24,0,30,6
1649795484870,MATH 193B,A02,083464,Staff,26,0,30,4
1649795484870,MATH 193B,A03,083465,Staff,30,0,30,0
1649795490933,COGS 2,A01,083966,Boyle; Mary E. T.,28,0,30,2
1649795496957,COGS 9,A01,083968,Staff,59,0,60,1
1649795502991,COGS 14B,A01,083970,Staff,49,0,50,1
1649795509014,COGS 100,A01,083972,Staff,54,0,60,6
1649795521060,COGS 101C,A01,083976,Staff,27,0,30,3
1649795527086,COGS 102A,A01,083978,Johnson; Christine M.,29,0,30,1
1649795533113,COGS 107B,A01,083980,Staff,45,0,50,5
1649795539143,COGS 115,A01,083982,Staff,26,0,30,4
1649795545176,COGS 118B,A01,083367,Staff,18,0,40,22
1649795551205,COGS 172,A01,083984,Provenzano; Emily Kara,25,0,30,5
1649795557236,COGS 177,A00,083368,Staff,17,0,30,13
1649795563263,COGS 186,A01,083986,Staff,28,0,40,12
1649795569299,COGS 187A,A01,083988,Boyle; Mary E. T.,52,0,60,8
1649795575323,CSE 8A,A50,084003,Miranda; Gregory Joseph,12,0,15,3
1649795581349,CSE 11,A01,084005,Miranda; Gregory Joseph,52,0,55,3
1649795587371,CSE 20,A01,084007,Staff,17,0,20,3
1649795593408,CSE 21,A01,084009,Staff,45,0,50,5
1649795599432,CSE 30,A01,083370,Cao; Yingjun,31,0,40,9
1649795605473,CSE 100,A01,083372,Cao; Yingjun,34,0,40,6
1649795611505,CSE 101,A01,084011,Staff,18,0,40,22
1649795617530,CSE 141,A01,083374,Eldon; John,28,0,75,47
1649795623561,CSE 141L,A01,083376,Eldon; John,29,0,75,46
1649795629600,CSE 175,A01,084013,Kumar; Rakesh,25,0,25,0
1649795635634,CSE 190,A00,092508,Staff,15,0,15,0
1649795641662,ECE 5,A01,084049,Morris; Karcher William,18,0,20,2
1649795647697,ECE 100,A01,084051,Baghdadchi; Saharnaz,18,0,20,2
1649795647697,ECE 100,A02,091916,Baghdadchi; Saharnaz,19,0,20,1
1649795653731,ECE 101,A01,084053,Baghdadchi; Saharnaz,33,0,37,4
1649795653731,ECE 101,A02,084054,Baghdadchi; Saharnaz,37,0,37,0
1649795659758,ECE 107,A01,083390,Staff,35,0,40,5
1649795665792,ECE 148,A01,084056,Silberman; Jack,8,0,12,4
1649795671819,ECE 180,A00,083391,Abi Samra; Nicholas Camill,27,0,30,3
1649795671819,ECE 180,B00,083392,Abi Samra; Nicholas Camill,26,0,30,4
1649795677844,MATH 10B,A01,084110,Staff,25,0,30,5
1649795677844,MATH 10B,A02,084111,Staff,29,0,30,1
1649795677844,MATH 10B,A03,084112,Staff,30,0,30,0
1649795683872,MATH 10C,A01,083443,Staff,26,0,30,4
1649795683872,MATH 10C,A02,083444,Staff,26,0,30,4
1649795683872,MATH 10C,B01,084114,Staff,28,0,30,2
1649795683872,MATH 10C,B02,084115,Staff,30,0,30,0
1649795689901,MATH 18,A01,084117,Harel; Guershon,28,0,30,2
1649795689901,MATH 18,A02,084119,Harel; Guershon,29,0,30,1
1649795689901,MATH 18,A03,084120,Harel; Guershon,30,0,30,0
1649795689901,MATH 18,A04,084121,Harel; Guershon,30,0,30,0
1649795695928,MATH 20B,A01,084124,Um; Ko Woon,34,0,35,1
1649795695928,MATH 20B,B01,084126,Um; Ko Woon,35,0,35,0
1649795701954,MATH 20C,A01,083446,Hammock; Frances H,29,0,30,1
1649795701954,MATH 20C,A02,083447,Hammock; Frances H,30,0,30,0
1649795701954,MATH 20C,A03,083448,Hammock; Frances H,30,0,30,0
1649795701954,MATH 20C,A04,083449,Hammock; Frances H,30,0,30,0
1649795701954,MATH 20C,B01,083451,Hammock; Frances H,30,0,30,0
1649795701954,MATH 20C,B02,083452,Hammock; Frances H,30,0,30,0
1649795701954,MATH 20C,B03,083453,Hammock; Frances H,30,0,30,0
1649795701954,MATH 20C,B04,083454,Hammock; Frances H,30,0,30,0
1649795707988,MATH 20D,A01,084128,Staff,30,0,30,0
1649795707988,MATH 20D,A02,084129,Staff,30,0,30,0
1649795707988,MATH 20D,A03,084130,Staff,29,0,30,1
1649795707988,MATH 20D,B01,084133,Staff,29,0,30,1
1649795707988,MATH 20D,B02,084134,Staff,30,0,30,0
1649795707988,MATH 20D,B03,084135,Staff,30,0,30,0
1649795714014,MATH 20E,A01,084138,Staff,30,0,30,0
1649795714014,MATH 20E,A02,084139,Staff,29,0,30,1
1649795714014,MATH 20E,A03,084140,Staff,30,0,30,0
1649795714014,MATH 20E,A04,084141,Staff,30,0,30,0
1649795720072,MATH 102,A01,084143,Harel; Guershon,27,0,30,3
1649795720072,MATH 102,A02,084144,Harel; Guershon,29,0,30,1
1649795726099,MATH 103B,A01,083456,Staff,15,0,30,15
1649795726099,MATH 103B,A02,083457,Staff,27,0,30,3
1649795732132,MATH 109,A01,084146,Salehi Golsefidy; Alireza,30,0,30,0
1649795732132,MATH 109,A02,084147,Salehi Golsefidy; Alireza,28,0,30,2
1649795738156,MATH 120A,A01,085445,Eggers; John Dietrich,32,0,35,3
1649795738156,MATH 120A,A02,085446,Eggers; John Dietrich,33,0,35,2
1649795744179,MATH 142B,A01,084149,Verstraete; Jacques Allan,25,0,30,5
1649795744179,MATH 142B,A02,084150,Verstraete; Jacques Allan,26,0,30,4
1649795750207,MATH 170A,A01,083459,Nie; Jiawang,18,0,30,12
1649795750207,MATH 170A,A02,083460,Nie; Jiawang,27,0,30,3
1649795750207,MATH 170A,A03,083461,Nie; Jiawang,30,0,30,0
1649795756231,MATH 193B,A01,083463,Staff,24,0,30,6
1649795756231,MATH 193B,A02,083464,Staff,25,0,30,5
1649795756231,MATH 193B,A03,083465,Staff,30,0,30,0
1649795762297,COGS 2,A01,083966,Boyle; Mary E. T.,28,0,30,2
1649795768323,COGS 9,A01,083968,Staff,59,0,60,1
1649795774354,COGS 14B,A01,083970,Staff,49,0,50,1
1649795780389,COGS 100,A01,083972,Staff,55,0,60,5
1649795792435,COGS 101C,A01,083976,Staff,27,0,30,3
1649795798457,COGS 102A,A01,083978,Johnson; Christine M.,29,0,30,1
1649795804480,COGS 107B,A01,083980,Staff,45,0,50,5
1649795810503,COGS 115,A01,083982,Staff,26,0,30,4
1649795816530,COGS 118B,A01,083367,Staff,18,0,40,22
1649795822571,COGS 172,A01,083984,Provenzano; Emily Kara,25,0,30,5
1649795828601,COGS 177,A00,083368,Staff,17,0,30,13
1649795834629,COGS 186,A01,083986,Staff,28,0,40,12
1649795840656,COGS 187A,A01,083988,Boyle; Mary E. T.,52,0,60,8
1649795846682,CSE 8A,A50,084003,Miranda; Gregory Joseph,12,0,15,3
1649795852710,CSE 11,A01,084005,Miranda; Gregory Joseph,51,0,55,4
1649795858742,CSE 20,A01,084007,Staff,17,0,20,3
1649795864770,CSE 21,A01,084009,Staff,45,0,50,5
1649795870796,CSE 30,A01,083370,Cao; Yingjun,31,0,40,9
1649795876820,CSE 100,A01,083372,Cao; Yingjun,34,0,40,6
1649795882847,CSE 101,A01,084011,Staff,17,0,40,23
1649795888870,CSE 141,A01,083374,Eldon; John,27,0,75,48
1649795894898,CSE 141L,A01,083376,Eldon; John,28,0,75,47
1649795900921,CSE 175,A01,084013,Kumar; Rakesh,25,0,25,0
1649795906945,CSE 190,A00,092508,Staff,15,0,15,0
1649795912973,ECE 5,A01,084049,Morris; Karcher William,18,0,20,2
1649795919007,ECE 100,A01,084051,Baghdadchi; Saharnaz,18,0,20,2
1649795919007,ECE 100,A02,091916,Baghdadchi; Saharnaz,19,0,20,1
1649795925033,ECE 101,A01,084053,Baghdadchi; Saharnaz,33,0,37,4
1649795925033,ECE 101,A02,084054,Baghdadchi; Saharnaz,37,0,37,0
1649795931057,ECE 107,A01,083390,Staff,35,0,40,5
1649795937080,ECE 148,A01,084056,Silberman; Jack,8,0,12,4
1649795943103,ECE 180,A00,083391,Abi Samra; Nicholas Camill,27,0,30,3
1649795943103,ECE 180,B00,083392,Abi Samra; Nicholas Camill,26,0,30,4
1649795949127,MATH 10B,A01,084110,Staff,25,0,30,5
1649795949127,MATH 10B,A02,084111,Staff,29,0,30,1
1649795949127,MATH 10B,A03,084112,Staff,30,0,30,0
1649795955163,MATH 10C,A01,083443,Staff,26,0,30,4
1649795955163,MATH 10C,A02,083444,Staff,26,0,30,4
1649795955163,MATH 10C,B01,084114,Staff,28,0,30,2
1649795955163,MATH 10C,B02,084115,Staff,30,0,30,0
1649795961200,MATH 18,A01,084117,Harel; Guershon,28,0,30,2
1649795961200,MATH 18,A02,084119,Harel; Guershon,29,0,30,1
1649795961200,MATH 18,A03,084120,Harel; Guershon,30,0,30,0
1649795961200,MATH 18,A04,084121,Harel; Guershon,30,0,30,0
1649795967224,MATH 20B,A01,084124,Um; Ko Woon,34,0,35,1
1649795967224,MATH 20B,B01,084126,Um; Ko Woon,35,0,35,0
1649795973248,MATH 20C,A01,083446,Hammock; Frances H,29,0,30,1
1649795973248,MATH 20C,A02,083447,Hammock; Frances H,30,0,30,0
1649795973248,MATH 20C,A03,083448,Hammock; Frances H,30,0,30,0
1649795973248,MATH 20C,A04,083449,Hammock; Frances H,30,0,30,0
1649795973248,MATH 20C,B01,083451,Hammock; Frances H,30,0,30,0
1649795973248,MATH 20C,B02,083452,Hammock; Frances H,30,0,30,0
1649795973248,MATH 20C,B03,083453,Hammock; Frances H,30,0,30,0
1649795973248,MATH 20C,B04,083454,Hammock; Frances H,30,0,30,0
1649795979394,MATH 20D,A01,084128,Staff,30,0,30,0
1649795979394,MATH 20D,A02,084129,Staff,30,0,30,0
1649795979394,MATH 20D,A03,084130,Staff,29,0,30,1
1649795979394,MATH 20D,B01,084133,Staff,29,0,30,1
1649795979394,MATH 20D,B02,084134,Staff,30,0,30,0
1649795979394,MATH 20D,B03,084135,Staff,30,0,30,0
1649795985421,MATH 20E,A01,084138,Staff,30,0,30,0
1649795985421,MATH 20E,A02,084139,Staff,29,0,30,1
1649795985421,MATH 20E,A03,084140,Staff,30,0,30,0
1649795985421,MATH 20E,A04,084141,Staff,30,0,30,0
1649795991449,MATH 102,A01,084143,Harel; Guershon,27,0,30,3
1649795991449,MATH 102,A02,084144,Harel; Guershon,29,0,30,1
1649795997477,MATH 103B,A01,083456,Staff,14,0,30,16
1649795997477,MATH 103B,A02,083457,Staff,27,0,30,3
1649796003506,MATH 109,A01,084146,Salehi Golsefidy; Alireza,30,0,30,0
1649796003506,MATH 109,A02,084147,Salehi Golsefidy; Alireza,28,0,30,2
1649796009533,MATH 120A,A01,085445,Eggers; John Dietrich,32,0,35,3
1649796009533,MATH 120A,A02,085446,Eggers; John Dietrich,33,0,35,2
1649796015562,MATH 142B,A01,084149,Verstraete; Jacques Allan,25,0,30,5
1649796015562,MATH 142B,A02,084150,Verstraete; Jacques Allan,26,0,30,4
1649796021590,MATH 170A,A01,083459,Nie; Jiawang,18,0,30,12
1649796021590,MATH 170A,A02,083460,Nie; Jiawang,27,0,30,3
1649796021590,MATH 170A,A03,083461,Nie; Jiawang,30,0,30,0
1649796027616,MATH 193B,A01,083463,Staff,24,0,30,6
1649796027616,MATH 193B,A02,083464,Staff,25,0,30,5
1649796027616,MATH 193B,A03,083465,Staff,30,0,30,0
1649796033682,COGS 2,A01,083966,Boyle; Mary E. T.,28,0,30,2
1649796039719,COGS 9,A01,083968,Staff,59,0,60,1
1649796045749,COGS 14B,A01,083970,Staff,49,0,50,1
1649796051772,COGS 100,A01,083972,Staff,55,0,60,5
1649796063823,COGS 101C,A01,083976,Staff,27,0,30,3
1649796069847,COGS 102A,A01,083978,Johnson; Christine M.,29,0,30,1
1649796075874,COGS 107B,A01,083980,Staff,45,0,50,5
1649796081901,COGS 115,A01,083982,Staff,26,0,30,4
1649796087940,COGS 118B,A01,083367,Staff,18,0,40,22
1649796093963,COGS 172,A01,083984,Provenzano; Emily Kara,25,0,30,5
1649796099987,COGS 177,A00,083368,Staff,17,0,30,13
1649796106009,COGS 186,A01,083986,Staff,28,0,40,12
1649796112031,COGS 187A,A01,083988,Boyle; Mary E. T.,52,0,60,8
1649796118056,CSE 8A,A50,084003,Miranda; Gregory Joseph,12,0,15,3
1649796124085,CSE 11,A01,084005,Miranda; Gregory Joseph,51,0,55,4
1649796130110,CSE 20,A01,084007,Staff,17,0,20,3
1649796136133,CSE 21,A01,084009,Staff,45,0,50,5
1649796142156,CSE 30,A01,083370,Cao; Yingjun,31,0,40,9
1649796148185,CSE 100,A01,083372,Cao; Yingjun,34,0,40,6
1649796154212,CSE 101,A01,084011,Staff,17,0,40,23
1649796160235,CSE 141,A01,083374,Eldon; John,27,0,75,48
1649796166263,CSE 141L,A01,083376,Eldon; John,28,0,75,47
1649796172290,CSE 175,A01,084013,Kumar; Rakesh,25,0,25,0
1649796178318,CSE 190,A00,092508,Staff,15,0,15,0
1649796184341,ECE 5,A01,084049,Morris; Karcher William,18,0,20,2
1649796190378,ECE 100,A01,084051,Baghdadchi; Saharnaz,17,0,20,3
1649796190378,ECE 100,A02,091916,Baghdadchi; Saharnaz,19,0,20,1
1649796196406,ECE 101,A01,084053,Baghdadchi; Saharnaz,32,0,37,5
1649796196406,ECE 101,A02,084054,Baghdadchi; Saharnaz,37,0,37,0
1649796202431,ECE 107,A01,083390,Staff,35,0,40,5
1649796208455,ECE 148,A01,084056,Silberman; Jack,8,0,12,4
1649796214481,ECE 180,A00,083391,Abi Samra; Nicholas Camill,27,0,30,3
1649796214481,ECE 180,B00,083392,Abi Samra; Nicholas Camill,26,0,30,4
1649796220511,MATH 10B,A01,084110,Staff,25,0,30,5
1649796220511,MATH 10B,A02,084111,Staff,29,0,30,1
1649796220511,MATH 10B,A03,084112,Staff,30,0,30,0
1649796226538,MATH 10C,A01,083443,Staff,26,0,30,4
1649796226538,MATH 10C,A02,083444,Staff,26,0,30,4
1649796226538,MATH 10C,B01,084114,Staff,28,0,30,2
1649796226538,MATH 10C,B02,084115,Staff,30,0,30,0
1649796232566,MATH 18,A01,084117,Harel; Guershon,28,0,30,2
1649796232566,MATH 18,A02,084119,Harel; Guershon,29,0,30,1
1649796232566,MATH 18,A03,084120,Harel; Guershon,30,0,30,0
1649796232566,MATH 18,A04,084121,Harel; Guershon,30,0,30,0
1649796238592,MATH 20B,A01,084124,Um; Ko Woon,34,0,35,1
1649796238592,MATH 20B,B01,084126,Um; Ko Woon,35,0,35,0
1649796244627,MATH 20C,A01,083446,Hammock; Frances H,28,0,30,2
1649796244627,MATH 20C,A02,083447,Hammock; Frances H,30,0,30,0
1649796244627,MATH 20C,A03,083448,Hammock; Frances H,30,0,30,0
1649796244627,MATH 20C,A04,083449,Hammock; Frances H,30,0,30,0
1649796244627,MATH 20C,B01,083451,Hammock; Frances H,30,0,30,0
1649796244627,MATH 20C,B02,083452,Hammock; Frances H,30,0,30,0
1649796244627,MATH 20C,B03,083453,Hammock; Frances H,30,0,30,0
1649796244627,MATH 20C,B04,083454,Hammock; Frances H,30,0,30,0
1649796250650,MATH 20D,A01,084128,Staff,30,0,30,0
1649796250650,MATH 20D,A02,084129,Staff,30,0,30,0
1649796250650,MATH 20D,A03,084130,Staff,29,0,30,1
1649796250650,MATH 20D,B01,084133,Staff,29,0,30,1
1649796250650,MATH 20D,B02,084134,Staff,30,0,30,0
1649796250650,MATH 20D,B03,084135,Staff,30,0,30,0
1649796256679,MATH 20E,A01,084138,Staff,30,0,30,0
1649796256679,MATH 20E,A02,084139,Staff,29,0,30,1
1649796256679,MATH 20E,A03,084140,Staff,30,0,30,0
1649796256679,MATH 20E,A04,084141,Staff,30,0,30,0
1649796262705,MATH 102,A01,084143,Harel; Guershon,27,0,30,3
1649796262705,MATH 102,A02,084144,Harel; Guershon,29,0,30,1
1649796268729,MATH 103B,A01,083456,Staff,15,0,30,15
1649796268729,MATH 103B,A02,083457,Staff,27,0,30,3
1649796274756,MATH 109,A01,084146,Salehi Golsefidy; Alireza,30,0,30,0
1649796274756,MATH 109,A02,084147,Salehi Golsefidy; Alireza,28,0,30,2
1649796280788,MATH 120A,A01,085445,Eggers; John Dietrich,32,0,35,3
1649796280788,MATH 120A,A02,085446,Eggers; John Dietrich,33,0,35,2
1649796286821,MATH 142B,A01,084149,Verstraete; Jacques Allan,24,0,30,6
1649796286821,MATH 142B,A02,084150,Verstraete; Jacques Allan,26,0,30,4
1649796292845,MATH 170A,A01,083459,Nie; Jiawang,17,0,30,13
1649796292845,MATH 170A,A02,083460,Nie; Jiawang,27,0,30,3
1649796292845,MATH 170A,A03,083461,Nie; Jiawang,30,0,30,0
1649796298886,MATH 193B,A01,083463,Staff,23,0,30,7
1649796298886,MATH 193B,A02,083464,Staff,25,0,30,5
1649796298886,MATH 193B,A03,083465,Staff,30,0,30,0
1649796304953,COGS 2,A01,083966,Boyle; Mary E. T.,28,0,30,2
1649796310980,COGS 9,A01,083968,Staff,59,0,60,1
1649796317007,COGS 14B,A01,083970,Staff,49,0,50,1
1649796323030,COGS 100,A01,083972,Staff,55,0,60,5
1649796335080,COGS 101C,A01,083976,Staff,27,0,30,3
1649796341102,COGS 102A,A01,083978,Johnson; Christine M.,29,0,30,1
1649796347125,COGS 107B,A01,083980,Staff,45,0,50,5
1649796353150,COGS 115,A01,083982,Staff,26,0,30,4
1649796359177,COGS 118B,A01,083367,Staff,18,0,40,22
1649796365200,COGS 172,A01,083984,Provenzano; Emily Kara,25,0,30,5
1649796371226,COGS 177,A00,083368,Staff,17,0,30,13
1649796377248,COGS 186,A01,083986,Staff,28,0,40,12
1649796383272,COGS 187A,A01,083988,Boyle; Mary E. T.,52,0,60,8
1649796389299,CSE 8A,A50,084003,Miranda; Gregory Joseph,12,0,15,3
1649796395326,CSE 11,A01,084005,Miranda; Gregory Joseph,51,0,55,4
1649796401357,CSE 20,A01,084007,Staff,17,0,20,3
1649796407382,CSE 21,A01,084009,Staff,45,0,50,5
1649796413408,CSE 30,A01,083370,Cao; Yingjun,31,0,40,9
1649796419434,CSE 100,A01,083372,Cao; Yingjun,34,0,40,6
1649796425458,CSE 101,A01,084011,Staff,17,0,40,23
1649796431487,CSE 141,A01,083374,Eldon; John,26,0,75,49
1649796437510,CSE 141L,A01,083376,Eldon; John,27,0,75,48
1649796443539,CSE 175,A01,084013,Kumar; Rakesh,25,0,25,0
1649796449577,CSE 190,A00,092508,Staff,15,0,15,0
1649796455605,ECE 5,A01,084049,Morris; Karcher William,18,0,20,2
1649796461631,ECE 100,A01,084051,Baghdadchi; Saharnaz,17,0,20,3
1649796461631,ECE 100,A02,091916,Baghdadchi; Saharnaz,19,0,20,1
1649796467657,ECE 101,A01,084053,Baghdadchi; Saharnaz,32,0,37,5
1649796467657,ECE 101,A02,084054,Baghdadchi; Saharnaz,37,0,37,0
1649796473688,ECE 107,A01,083390,Staff,35,0,40,5
1649796479718,ECE 148,A01,084056,Silberman; Jack,8,0,12,4
1649796485746,ECE 180,A00,083391,Abi Samra; Nicholas Camill,27,0,30,3
1649796485746,ECE 180,B00,083392,Abi Samra; Nicholas Camill,26,0,30,4
1649796491780,MATH 10B,A01,084110,Staff,25,0,30,5
1649796491780,MATH 10B,A02,084111,Staff,29,0,30,1
1649796491780,MATH 10B,A03,084112,Staff,30,0,30,0
1649796497814,MATH 10C,A01,083443,Staff,26,0,30,4
1649796497814,MATH 10C,A02,083444,Staff,26,0,30,4
1649796497814,MATH 10C,B01,084114,Staff,28,0,30,2
1649796497814,MATH 10C,B02,084115,Staff,30,0,30,0
1649796503854,MATH 18,A01,084117,Harel; Guershon,28,0,30,2
1649796503854,MATH 18,A02,084119,Harel; Guershon,29,0,30,1
1649796503854,MATH 18,A03,084120,Harel; Guershon,30,0,30,0
1649796503854,MATH 18,A04,084121,Harel; Guershon,30,0,30,0
1649796509879,MATH 20B,A01,084124,Um; Ko Woon,34,0,35,1
1649796509879,MATH 20B,B01,084126,Um; Ko Woon,35,0,35,0
1649796515904,MATH 20C,A01,083446,Hammock; Frances H,28,0,30,2
1649796515904,MATH 20C,A02,083447,Hammock; Frances H,30,0,30,0
1649796515904,MATH 20C,A03,083448,Hammock; Frances H,30,0,30,0
1649796515904,MATH 20C,A04,083449,Hammock; Frances H,30,0,30,0
1649796515904,MATH 20C,B01,083451,Hammock; Frances H,30,0,30,0
1649796515904,MATH 20C,B02,083452,Hammock; Frances H,30,0,30,0
1649796515904,MATH 20C,B03,083453,Hammock; Frances H,30,0,30,0
1649796515904,MATH 20C,B04,083454,Hammock; Frances H,30,0,30,0
1649796521928,MATH 20D,A01,084128,Staff,30,0,30,0
1649796521928,MATH 20D,A02,084129,Staff,30,0,30,0
1649796521928,MATH 20D,A03,084130,Staff,29,0,30,1
1649796521928,MATH 20D,B01,084133,Staff,29,0,30,1
1649796521928,MATH 20D,B02,084134,Staff,30,0,30,0
1649796521928,MATH 20D,B03,084135,Staff,30,0,30,0
1649796527952,MATH 20E,A01,084138,Staff,30,0,30,0
1649796527952,MATH 20E,A02,084139,Staff,29,0,30,1
1649796527952,MATH 20E,A03,084140,Staff,30,0,30,0
1649796527952,MATH 20E,A04,084141,Staff,30,0,30,0
1649796533979,MATH 102,A01,084143,Harel; Guershon,26,0,30,4
1649796533979,MATH 102,A02,084144,Harel; Guershon,29,0,30,1
1649796540014,MATH 103B,A01,083456,Staff,15,0,30,15
1649796540014,MATH 103B,A02,083457,Staff,27,0,30,3
1649796546043,MATH 109,A01,084146,Salehi Golsefidy; Alireza,30,0,30,0
1649796546043,MATH 109,A02,084147,Salehi Golsefidy; Alireza,28,0,30,2
1649796552072,MATH 120A,A01,085445,Eggers; John Dietrich,32,0,35,3
1649796552072,MATH 120A,A02,085446,Eggers; John Dietrich,33,0,35,2
1649796558095,MATH 142B,A01,084149,Verstraete; Jacques Allan,24,0,30,6
1649796558095,MATH 142B,A02,084150,Verstraete; Jacques Allan,26,0,30,4
1649796564124,MATH 170A,A01,083459,Nie; Jiawang,17,0,30,13
1649796564124,MATH 170A,A02,083460,Nie; Jiawang,27,0,30,3
1649796564124,MATH 170A,A03,083461,Nie; Jiawang,30,0,30,0
1649796570153,MATH 193B,A01,083463,Staff,23,0,30,7
1649796570153,MATH 193B,A02,083464,Staff,25,0,30,5
1649796570153,MATH 193B,A03,083465,Staff,30,0,30,0
1649796576310,COGS 2,A01,083966,Boyle; Mary E. T.,28,0,30,2
1649796582346,COGS 9,A01,083968,Staff,59,0,60,1
1649796588376,COGS 14B,A01,083970,Staff,49,0,50,1
1649796594398,COGS 100,A01,083972,Staff,55,0,60,5
1649796606444,COGS 101C,A01,083976,Staff,27,0,30,3
1649796612474,COGS 102A,A01,083978,Johnson; Christine M.,29,0,30,1
1649796618502,COGS 107B,A01,083980,Staff,45,0,50,5
1649796624524,COGS 115,A01,083982,Staff,26,0,30,4
1649796630558,COGS 118B,A01,083367,Staff,18,0,40,22
1649796636583,COGS 172,A01,083984,Provenzano; Emily Kara,25,0,30,5
1649796642609,COGS 177,A00,083368,Staff,17,0,30,13
1649796648634,COGS 186,A01,083986,Staff,28,0,40,12
1649796654662,COGS 187A,A01,083988,Boyle; Mary E. T.,52,0,60,8
1649796660686,CSE 8A,A50,084003,Miranda; Gregory Joseph,12,0,15,3
1649796666710,CSE 11,A01,084005,Miranda; Gregory Joseph,51,0,55,4
1649796672733,CSE 20,A01,084007,Staff,17,0,20,3
1649796678760,CSE 21,A01,084009,Staff,45,0,50,5
1649796684786,CSE 30,A01,083370,Cao; Yingjun,31,0,40,9
1649796690813,CSE 100,A01,083372,Cao; Yingjun,34,0,40,6
1649796696837,CSE 101,A01,084011,Staff,17,0,40,23
1649796702860,CSE 141,A01,083374,Eldon; John,26,0,75,49
1649796708882,CSE 141L,A01,083376,Eldon; John,27,0,75,48
1649796714906,CSE 175,A01,084013,Kumar; Rakesh,25,0,25,0
1649796720928,CSE 190,A00,092508,Staff,15,0,15,0
1649796726958,ECE 5,A01,084049,Morris; Karcher William,18,0,20,2
1649796732986,ECE 100,A01,084051,Baghdadchi; Saharnaz,17,0,20,3
1649796732986,ECE 100,A02,091916,Baghdadchi; Saharnaz,19,0,20,1
1649796739015,ECE 101,A01,084053,Baghdadchi; Saharnaz,32,0,37,5
1649796739015,ECE 101,A02,084054,Baghdadchi; Saharnaz,37,0,37,0
1649796745044,ECE 107,A01,083390,Staff,35,0,40,5
1649796751068,ECE 148,A01,084056,Silberman; Jack,8,0,12,4
1649796757103,ECE 180,A00,083391,Abi Samra; Nicholas Camill,27,0,30,3
1649796757103,ECE 180,B00,083392,Abi Samra; Nicholas Camill,26,0,30,4
1649796763132,MATH 10B,A01,084110,Staff,25,0,30,5
1649796763132,MATH 10B,A02,084111,Staff,29,0,30,1
1649796763132,MATH 10B,A03,084112,Staff,30,0,30,0
1649796769169,MATH 10C,A01,083443,Staff,26,0,30,4
1649796769169,MATH 10C,A02,083444,Staff,26,0,30,4
1649796769169,MATH 10C,B01,084114,Staff,28,0,30,2
1649796769169,MATH 10C,B02,084115,Staff,30,0,30,0
1649796775193,MATH 18,A01,084117,Harel; Guershon,28,0,30,2
1649796775193,MATH 18,A02,084119,Harel; Guershon,29,0,30,1
1649796775193,MATH 18,A03,084120,Harel; Guershon,30,0,30,0
1649796775193,MATH 18,A04,084121,Harel; Guershon,30,0,30,0
1649796781216,MATH 20B,A01,084124,Um; Ko Woon,34,0,35,1
1649796781216,MATH 20B,B01,084126,Um; Ko Woon,35,0,35,0
1649796787251,MATH 20C,A01,083446,Hammock; Frances H,28,0,30,2
1649796787251,MATH 20C,A02,083447,Hammock; Frances H,30,0,30,0
1649796787251,MATH 20C,A03,083448,Hammock; Frances H,30,0,30,0
1649796787251,MATH 20C,A04,083449,Hammock; Frances H,30,0,30,0
1649796787251,MATH 20C,B01,083451,Hammock; Frances H,30,0,30,0
1649796787251,MATH 20C,B02,083452,Hammock; Frances H,30,0,30,0
1649796787251,MATH 20C,B03,083453,Hammock; Frances H,30,0,30,0
1649796787251,MATH 20C,B04,083454,Hammock; Frances H,30,0,30,0
1649796793280,MATH 20D,A01,084128,Staff,30,0,30,0
1649796793280,MATH 20D,A02,084129,Staff,30,0,30,0
1649796793280,MATH 20D,A03,084130,Staff,29,0,30,1
1649796793280,MATH 20D,B01,084133,Staff,29,0,30,1
1649796793280,MATH 20D,B02,084134,Staff,30,0,30,0
1649796793280,MATH 20D,B03,084135,Staff,30,0,30,0
1649796799304,MATH 20E,A01,084138,Staff,30,0,30,0
1649796799304,MATH 20E,A02,084139,Staff,29,0,30,1
1649796799304,MATH 20E,A03,084140,Staff,30,0,30,0
1649796799304,MATH 20E,A04,084141,Staff,30,0,30,0
1649796805332,MATH 102,A01,084143,Harel; Guershon,26,0,30,4
1649796805332,MATH 102,A02,084144,Harel; Guershon,29,0,30,1
1649796811372,MATH 103B,A01,083456,Staff,15,0,30,15
1649796811372,MATH 103B,A02,083457,Staff,27,0,30,3
1649796817400,MATH 109,A01,084146,Salehi Golsefidy; Alireza,30,0,30,0
1649796817400,MATH 109,A02,084147,Salehi Golsefidy; Alireza,28,0,30,2
1649796823434,MATH 120A,A01,085445,Eggers; John Dietrich,32,0,35,3
1649796823434,MATH 120A,A02,085446,Eggers; John Dietrich,33,0,35,2
1649796829473,MATH 142B,A01,084149,Verstraete; Jacques Allan,24,0,30,6
1649796829473,MATH 142B,A02,084150,Verstraete; Jacques Allan,26,0,30,4
1649796835502,MATH 170A,A01,083459,Nie; Jiawang,17,0,30,13
1649796835502,MATH 170A,A02,083460,Nie; Jiawang,27,0,30,3
1649796835502,MATH 170A,A03,083461,Nie; Jiawang,30,0,30,0
1649796841525,MATH 193B,A01,083463,Staff,23,0,30,7
1649796841525,MATH 193B,A02,083464,Staff,25,0,30,5
1649796841525,MATH 193B,A03,083465,Staff,30,0,30,0
1649796847583,COGS 2,A01,083966,Boyle; Mary E. T.,28,0,30,2
1649796853616,COGS 9,A01,083968,Staff,59,0,60,1
1649796859644,COGS 14B,A01,083970,Staff,49,0,50,1
1649796865675,COGS 100,A01,083972,Staff,55,0,60,5
1649796877743,COGS 101C,A01,083976,Staff,27,0,30,3
1649796883766,COGS 102A,A01,083978,Johnson; Christine M.,29,0,30,1
1649796889790,COGS 107B,A01,083980,Staff,45,0,50,5
1649796895822,COGS 115,A01,083982,Staff,26,0,30,4
1649796901850,COGS 118B,A01,083367,Staff,18,0,40,22
1649796907874,COGS 172,A01,083984,Provenzano; Emily Kara,25,0,30,5
1649796913901,COGS 177,A00,083368,Staff,17,0,30,13
1649796919928,COGS 186,A01,083986,Staff,28,0,40,12
1649796925951,COGS 187A,A01,083988,Boyle; Mary E. T.,52,0,60,8
1649796931981,CSE 8A,A50,084003,Miranda; Gregory Joseph,12,0,15,3
1649796938004,CSE 11,A01,084005,Miranda; Gregory Joseph,51,0,55,4
1649796944035,CSE 20,A01,084007,Staff,17,0,20,3
1649796950075,CSE 21,A01,084009,Staff,45,0,50,5
1649796956107,CSE 30,A01,083370,Cao; Yingjun,31,0,40,9
1649796962137,CSE 100,A01,083372,Cao; Yingjun,34,0,40,6
1649796968160,CSE 101,A01,084011,Staff,17,0,40,23
1649796974189,CSE 141,A01,083374,Eldon; John,26,0,75,49
1649796980212,CSE 141L,A01,083376,Eldon; John,27,0,75,48
1649796986238,CSE 175,A01,084013,Kumar; Rakesh,25,0,25,0
1649796992270,CSE 190,A00,092508,Staff,15,0,15,0
1649796998292,ECE 5,A01,084049,Morris; Karcher William,18,0,20,2
1649797004330,ECE 100,A01,084051,Baghdadchi; Saharnaz,17,0,20,3
1649797004330,ECE 100,A02,091916,Baghdadchi; Saharnaz,19,0,20,1
1649797010365,ECE 101,A01,084053,Baghdadchi; Saharnaz,32,0,37,5
1649797010365,ECE 101,A02,084054,Baghdadchi; Saharnaz,37,0,37,0
1649797016387,ECE 107,A01,083390,Staff,35,0,40,5
1649797022411,ECE 148,A01,084056,Silberman; Jack,8,0,12,4
1649797028450,ECE 180,A00,083391,Abi Samra; Nicholas Camill,27,0,30,3
1649797028450,ECE 180,B00,083392,Abi Samra; Nicholas Camill,26,0,30,4
1649797034483,MATH 10B,A01,084110,Staff,25,0,30,5
1649797034483,MATH 10B,A02,084111,Staff,29,0,30,1
1649797034483,MATH 10B,A03,084112,Staff,30,0,30,0
1649797040509,MATH 10C,A01,083443,Staff,26,0,30,4
1649797040509,MATH 10C,A02,083444,Staff,26,0,30,4
1649797040509,MATH 10C,B01,084114,Staff,28,0,30,2
1649797040509,MATH 10C,B02,084115,Staff,30,0,30,0
1649797046539,MATH 18,A01,084117,Harel; Guershon,28,0,30,2
1649797046539,MATH 18,A02,084119,Harel; Guershon,29,0,30,1
1649797046539,MATH 18,A03,084120,Harel; Guershon,30,0,30,0
1649797046539,MATH 18,A04,084121,Harel; Guershon,30,0,30,0
1649797052568,MATH 20B,A01,084124,Um; Ko Woon,34,0,35,1
1649797052568,MATH 20B,B01,084126,Um; Ko Woon,35,0,35,0
1649797058591,MATH 20C,A01,083446,Hammock; Frances H,28,0,30,2
1649797058591,MATH 20C,A02,083447,Hammock; Frances H,30,0,30,0
1649797058591,MATH 20C,A03,083448,Hammock; Frances H,30,0,30,0
1649797058591,MATH 20C,A04,083449,Hammock; Frances H,30,0,30,0
1649797058591,MATH 20C,B01,083451,Hammock; Frances H,30,0,30,0
1649797058591,MATH 20C,B02,083452,Hammock; Frances H,30,0,30,0
1649797058591,MATH 20C,B03,083453,Hammock; Frances H,30,0,30,0
1649797058591,MATH 20C,B04,083454,Hammock; Frances H,30,0,30,0
1649797064615,MATH 20D,A01,084128,Staff,30,0,30,0
1649797064615,MATH 20D,A02,084129,Staff,30,0,30,0
1649797064615,MATH 20D,A03,084130,Staff,29,0,30,1
1649797064615,MATH 20D,B01,084133,Staff,29,0,30,1
1649797064615,MATH 20D,B02,084134,Staff,30,0,30,0
1649797064615,MATH 20D,B03,084135,Staff,30,0,30,0
1649797070639,MATH 20E,A01,084138,Staff,30,0,30,0
1649797070639,MATH 20E,A02,084139,Staff,29,0,30,1
1649797070639,MATH 20E,A03,084140,Staff,30,0,30,0
1649797070639,MATH 20E,A04,084141,Staff,30,0,30,0
1649797076672,MATH 102,A01,084143,Harel; Guershon,26,0,30,4
1649797076672,MATH 102,A02,084144,Harel; Guershon,29,0,30,1
1649797082704,MATH 103B,A01,083456,Staff,15,0,30,15
1649797082704,MATH 103B,A02,083457,Staff,27,0,30,3
1649797088740,MATH 109,A01,084146,Salehi Golsefidy; Alireza,30,0,30,0
1649797088740,MATH 109,A02,084147,Salehi Golsefidy; Alireza,28,0,30,2
1649797094768,MATH 120A,A01,085445,Eggers; John Dietrich,32,0,35,3
1649797094768,MATH 120A,A02,085446,Eggers; John Dietrich,33,0,35,2
1649797100796,MATH 142B,A01,084149,Verstraete; Jacques Allan,24,0,30,6
1649797100796,MATH 142B,A02,084150,Verstraete; Jacques Allan,26,0,30,4
1649797106822,MATH 170A,A01,083459,Nie; Jiawang,17,0,30,13
1649797106822,MATH 170A,A02,083460,Nie; Jiawang,27,0,30,3
1649797106822,MATH 170A,A03,083461,Nie; Jiawang,30,0,30,0
1649797112852,MATH 193B,A01,083463,Staff,23,0,30,7
1649797112852,MATH 193B,A02,083464,Staff,25,0,30,5
1649797112852,MATH 193B,A03,083465,Staff,30,0,30,0
1649797118911,COGS 2,A01,083966,Boyle; Mary E. T.,28,0,30,2
1649797124941,COGS 9,A01,083968,Staff,59,0,60,1
1649797130976,COGS 14B,A01,083970,Staff,49,0,50,1
1649797137005,COGS 100,A01,083972,Staff,55,0,60,5
1649797149054,COGS 101C,A01,083976,Staff,27,0,30,3
1649797155079,COGS 102A,A01,083978,Johnson; Christine M.,29,0,30,1
1649797161106,COGS 107B,A01,083980,Staff,45,0,50,5
1649797167212,COGS 115,A01,083982,Staff,26,0,30,4
1649797173238,COGS 118B,A01,083367,Staff,18,0,40,22
1649797179274,COGS 172,A01,083984,Provenzano; Emily Kara,25,0,30,5
1649797185299,COGS 177,A00,083368,Staff,17,0,30,13
1649797191325,COGS 186,A01,083986,Staff,28,0,40,12
1649797197348,COGS 187A,A01,083988,Boyle; Mary E. T.,52,0,60,8
1649797203377,CSE 8A,A50,084003,Miranda; Gregory Joseph,12,0,15,3
1649797209405,CSE 11,A01,084005,Miranda; Gregory Joseph,51,0,55,4
1649797215438,CSE 20,A01,084007,Staff,17,0,20,3
1649797221461,CSE 21,A01,084009,Staff,45,0,50,5
1649797227493,CSE 30,A01,083370,Cao; Yingjun,31,0,40,9
1649797233517,CSE 100,A01,083372,Cao; Yingjun,34,0,40,6
1649797239541,CSE 101,A01,084011,Staff,17,0,40,23
1649797245564,CSE 141,A01,083374,Eldon; John,26,0,75,49
1649797251591,CSE 141L,A01,083376,Eldon; John,27,0,75,48
1649797257616,CSE 175,A01,084013,Kumar; Rakesh,25,0,25,0
1649797263643,CSE 190,A00,092508,Staff,15,0,15,0
1649797269667,ECE 5,A01,084049,Morris; Karcher William,18,0,20,2
1649797275703,ECE 100,A01,084051,Baghdadchi; Saharnaz,17,0,20,3
1649797275703,ECE 100,A02,091916,Baghdadchi; Saharnaz,19,0,20,1
1649797281726,ECE 101,A01,084053,Baghdadchi; Saharnaz,32,0,37,5
1649797281726,ECE 101,A02,084054,Baghdadchi; Saharnaz,37,0,37,0
1649797287758,ECE 107,A01,083390,Staff,35,0,40,5
1649797293784,ECE 148,A01,084056,Silberman; Jack,8,0,12,4
1649797299813,ECE 180,A00,083391,Abi Samra; Nicholas Camill,27,0,30,3
1649797299813,ECE 180,B00,083392,Abi Samra; Nicholas Camill,26,0,30,4
1649797305852,MATH 10B,A01,084110,Staff,25,0,30,5
1649797305852,MATH 10B,A02,084111,Staff,29,0,30,1
1649797305852,MATH 10B,A03,084112,Staff,30,0,30,0
1649797311891,MATH 10C,A01,083443,Staff,26,0,30,4
1649797311891,MATH 10C,A02,083444,Staff,26,0,30,4
1649797311891,MATH 10C,B01,084114,Staff,27,0,30,3
1649797311891,MATH 10C,B02,084115,Staff,30,0,30,0
1649797317928,MATH 18,A01,084117,Harel; Guershon,28,0,30,2
1649797317928,MATH 18,A02,084119,Harel; Guershon,29,0,30,1
1649797317928,MATH 18,A03,084120,Harel; Guershon,30,0,30,0
1649797317928,MATH 18,A04,084121,Harel; Guershon,30,0,30,0
1649797323952,MATH 20B,A01,084124,Um; Ko Woon,34,0,35,1
1649797323952,MATH 20B,B01,084126,Um; Ko Woon,35,0,35,0
1649797329982,MATH 20C,A01,083446,Hammock; Frances H,28,0,30,2
1649797329982,MATH 20C,A02,083447,Hammock; Frances H,30,0,30,0
1649797329982,MATH 20C,A03,083448,Hammock; Frances H,30,0,30,0
1649797329982,MATH 20C,A04,083449,Hammock; Frances H,30,0,30,0
1649797329982,MATH 20C,B01,083451,Hammock; Frances H,30,0,30,0
1649797329982,MATH 20C,B02,083452,Hammock; Frances H,30,0,30,0
1649797329982,MATH 20C,B03,083453,Hammock; Frances H,30,0,30,0
1649797329982,MATH 20C,B04,083454,Hammock; Frances H,30,0,30,0
1649797336005,MATH 20D,A01,084128,Staff,30,0,30,0
1649797336005,MATH 20D,A02,084129,Staff,30,0,30,0
1649797336005,MATH 20D,A03,084130,Staff,29,0,30,1
1649797336005,MATH 20D,B01,084133,Staff,29,0,30,1
1649797336005,MATH 20D,B02,084134,Staff,30,0,30,0
1649797336005,MATH 20D,B03,084135,Staff,30,0,30,0
1649797342033,MATH 20E,A01,084138,Staff,30,0,30,0
1649797342033,MATH 20E,A02,084139,Staff,29,0,30,1
1649797342033,MATH 20E,A03,084140,Staff,30,0,30,0
1649797342033,MATH 20E,A04,084141,Staff,30,0,30,0
1649797348063,MATH 102,A01,084143,Harel; Guershon,26,0,30,4
1649797348063,MATH 102,A02,084144,Harel; Guershon,29,0,30,1
1649797354088,MATH 103B,A01,083456,Staff,15,0,30,15
1649797354088,MATH 103B,A02,083457,Staff,27,0,30,3
1649797360120,MATH 109,A01,084146,Salehi Golsefidy; Alireza,30,0,30,0
1649797360120,MATH 109,A02,084147,Salehi Golsefidy; Alireza,28,0,30,2
1649797366143,MATH 120A,A01,085445,Eggers; John Dietrich,31,0,35,4
1649797366143,MATH 120A,A02,085446,Eggers; John Dietrich,33,0,35,2
1649797372177,MATH 142B,A01,084149,Verstraete; Jacques Allan,24,0,30,6
1649797372177,MATH 142B,A02,084150,Verstraete; Jacques Allan,26,0,30,4
1649797378202,MATH 170A,A01,083459,Nie; Jiawang,16,0,30,14
1649797378202,MATH 170A,A02,083460,Nie; Jiawang,27,0,30,3
1649797378202,MATH 170A,A03,083461,Nie; Jiawang,29,0,30,1
1649797384227,MATH 193B,A01,083463,Staff,23,0,30,7
1649797384227,MATH 193B,A02,083464,Staff,25,0,30,5
1649797384227,MATH 193B,A03,083465,Staff,30,0,30,0
1649797390278,COGS 2,A01,083966,Boyle; Mary E. T.,28,0,30,2
1649797396305,COGS 9,A01,083968,Staff,59,0,60,1
1649797402348,COGS 14B,A01,083970,Staff,49,0,50,1
1649797408374,COGS 100,A01,083972,Staff,55,0,60,5
1649797420434,COGS 101C,A01,083976,Staff,27,0,30,3
1649797426457,COGS 102A,A01,083978,Johnson; Christine M.,29,0,30,1
1649797432481,COGS 107B,A01,083980,Staff,45,0,50,5
1649797438504,COGS 115,A01,083982,Staff,26,0,30,4
1649797444535,COGS 118B,A01,083367,Staff,18,0,40,22
1649797450560,COGS 172,A01,083984,Provenzano; Emily Kara,25,0,30,5
1649797456591,COGS 177,A00,083368,Staff,17,0,30,13
1649797462615,COGS 186,A01,083986,Staff,28,0,40,12
1649797468642,COGS 187A,A01,083988,Boyle; Mary E. T.,52,0,60,8
1649797474675,CSE 8A,A50,084003,Miranda; Gregory Joseph,12,0,15,3
1649797480703,CSE 11,A01,084005,Miranda; Gregory Joseph,51,0,55,4
1649797486734,CSE 20,A01,084007,Staff,17,0,20,3
1649797492775,CSE 21,A01,084009,Staff,45,0,50,5
1649797498801,CSE 30,A01,083370,Cao; Yingjun,31,0,40,9
1649797504835,CSE 100,A01,083372,Cao; Yingjun,34,0,40,6
1649797510869,CSE 101,A01,084011,Staff,17,0,40,23
1649797516900,CSE 141,A01,083374,Eldon; John,25,0,75,50
1649797522924,CSE 141L,A01,083376,Eldon; John,26,0,75,49
1649797528947,CSE 175,A01,084013,Kumar; Rakesh,25,0,25,0
1649797534983,CSE 190,A00,092508,Staff,15,0,15,0
1649797541024,ECE 5,A01,084049,Morris; Karcher William,18,0,20,2
1649797547058,ECE 100,A01,084051,Baghdadchi; Saharnaz,17,0,20,3
1649797547058,ECE 100,A02,091916,Baghdadchi; Saharnaz,19,0,20,1
1649797553081,ECE 101,A01,084053,Baghdadchi; Saharnaz,32,0,37,5
1649797553081,ECE 101,A02,084054,Baghdadchi; Saharnaz,37,0,37,0
1649797559120,ECE 107,A01,083390,Staff,35,0,40,5
1649797565157,ECE 148,A01,084056,Silberman; Jack,8,0,12,4
1649797571188,ECE 180,A00,083391,Abi Samra; Nicholas Camill,27,0,30,3
1649797571188,ECE 180,B00,083392,Abi Samra; Nicholas Camill,26,0,30,4
1649797577218,MATH 10B,A01,084110,Staff,25,0,30,5
1649797577218,MATH 10B,A02,084111,Staff,29,0,30,1
1649797577218,MATH 10B,A03,084112,Staff,30,0,30,0
1649797583246,MATH 10C,A01,083443,Staff,26,0,30,4
1649797583246,MATH 10C,A02,083444,Staff,26,0,30,4
1649797583246,MATH 10C,B01,084114,Staff,27,0,30,3
1649797583246,MATH 10C,B02,084115,Staff,30,0,30,0
1649797589272,MATH 18,A01,084117,Harel; Guershon,28,0,30,2
1649797589272,MATH 18,A02,084119,Harel; Guershon,29,0,30,1
1649797589272,MATH 18,A03,084120,Harel; Guershon,30,0,30,0
1649797589272,MATH 18,A04,084121,Harel; Guershon,30,0,30,0
1649797595299,MATH 20B,A01,084124,Um; Ko Woon,34,0,35,1
1649797595299,MATH 20B,B01,084126,Um; Ko Woon,35,0,35,0
1649797601324,MATH 20C,A01,083446,Hammock; Frances H,28,0,30,2
1649797601324,MATH 20C,A02,083447,Hammock; Frances H,30,0,30,0
1649797601324,MATH 20C,A03,083448,Hammock; Frances H,30,0,30,0
1649797601324,MATH 20C,A04,083449,Hammock; Frances H,30,0,30,0
1649797601324,MATH 20C,B01,083451,Hammock; Frances H,30,0,30,0
1649797601324,MATH 20C,B02,083452,Hammock; Frances H,30,0,30,0
1649797601324,MATH 20C,B03,083453,Hammock; Frances H,30,0,30,0
1649797601324,MATH 20C,B04,083454,Hammock; Frances H,30,0,30,0
1649797607349,MATH 20D,A01,084128,Staff,30,0,30,0
1649797607349,MATH 20D,A02,084129,Staff,30,0,30,0
1649797607349,MATH 20D,A03,084130,Staff,29,0,30,1
1649797607349,MATH 20D,B01,084133,Staff,29,0,30,1
1649797607349,MATH 20D,B02,084134,Staff,30,0,30,0
1649797607349,MATH 20D,B03,084135,Staff,30,0,30,0
1649797613383,MATH 20E,A01,084138,Staff,30,0,30,0
1649797613383,MATH 20E,A02,084139,Staff,29,0,30,1
1649797613383,MATH 20E,A03,084140,Staff,30,0,30,0
1649797613383,MATH 20E,A04,084141,Staff,30,0,30,0
1649797619467,MATH 102,A01,084143,Harel; Guershon,26,0,30,4
1649797619467,MATH 102,A02,084144,Harel; Guershon,29,0,30,1
1649797625493,MATH 103B,A01,083456,Staff,15,0,30,15
1649797625493,MATH 103B,A02,083457,Staff,27,0,30,3
1649797631520,MATH 109,A01,084146,Salehi Golsefidy; Alireza,30,0,30,0
1649797631520,MATH 109,A02,084147,Salehi Golsefidy; Alireza,28,0,30,2
1649797637552,MATH 120A,A01,085445,Eggers; John Dietrich,31,0,35,4
1649797637552,MATH 120A,A02,085446,Eggers; John Dietrich,33,0,35,2
1649797643589,MATH 142B,A01,084149,Verstraete; Jacques Allan,24,0,30,6
1649797643589,MATH 142B,A02,084150,Verstraete; Jacques Allan,26,0,30,4
1649797649613,MATH 170A,A01,083459,Nie; Jiawang,16,0,30,14
1649797649613,MATH 170A,A02,083460,Nie; Jiawang,27,0,30,3
1649797649613,MATH 170A,A03,083461,Nie; Jiawang,29,0,30,1
1649797655635,MATH 193B,A01,083463,Staff,23,0,30,7
1649797655635,MATH 193B,A02,083464,Staff,25,0,30,5
1649797655635,MATH 193B,A03,083465,Staff,30,0,30,0
1649797661698,COGS 2,A01,083966,Boyle; Mary E. T.,28,0,30,2
1649797667722,COGS 9,A01,083968,Staff,59,0,60,1
1649797673759,COGS 14B,A01,083970,Staff,49,0,50,1
1649797679794,COGS 100,A01,083972,Staff,55,0,60,5
1649797691847,COGS 101C,A01,083976,Staff,27,0,30,3
1649797697880,COGS 102A,A01,083978,Johnson; Christine M.,28,0,30,2
1649797703905,COGS 107B,A01,083980,Staff,45,0,50,5
1649797709928,COGS 115,A01,083982,Staff,24,0,30,6
1649797715951,COGS 118B,A01,083367,Staff,17,0,40,23
1649797721983,COGS 172,A01,083984,Provenzano; Emily Kara,25,0,30,5
1649797728020,COGS 177,A00,083368,Staff,17,0,30,13
1649797734043,COGS 186,A01,083986,Staff,28,0,40,12
1649797740066,COGS 187A,A01,083988,Boyle; Mary E. T.,52,0,60,8
1649797746097,CSE 8A,A50,084003,Miranda; Gregory Joseph,12,0,15,3
1649797752124,CSE 11,A01,084005,Miranda; Gregory Joseph,51,0,55,4
1649797758147,CSE 20,A01,084007,Staff,17,0,20,3
1649797764258,CSE 21,A01,084009,Staff,45,0,50,5
1649797770281,CSE 30,A01,083370,Cao; Yingjun,31,0,40,9
1649797776306,CSE 100,A01,083372,Cao; Yingjun,34,0,40,6
1649797782331,CSE 101,A01,084011,Staff,17,0,40,23
1649797788359,CSE 141,A01,083374,Eldon; John,25,0,75,50
1649797794392,CSE 141L,A01,083376,Eldon; John,26,0,75,49
1649797800427,CSE 175,A01,084013,Kumar; Rakesh,25,0,25,0
1649797806453,CSE 190,A00,092508,Staff,15,0,15,0
1649797812480,ECE 5,A01,084049,Morris; Karcher William,18,0,20,2
1649797818504,ECE 100,A01,084051,Baghdadchi; Saharnaz,17,0,20,3
1649797818504,ECE 100,A02,091916,Baghdadchi; Saharnaz,19,0,20,1
1649797824541,ECE 101,A01,084053,Baghdadchi; Saharnaz,32,0,37,5
1649797824541,ECE 101,A02,084054,Baghdadchi; Saharnaz,37,0,37,0
1649797830571,ECE 107,A01,083390,Staff,35,0,40,5
1649797836597,ECE 148,A01,084056,Silberman; Jack,8,0,12,4
1649797842628,ECE 180,A00,083391,Abi Samra; Nicholas Camill,27,0,30,3
1649797842628,ECE 180,B00,083392,Abi Samra; Nicholas Camill,26,0,30,4
1649797848662,MATH 10B,A01,084110,Staff,25,0,30,5
1649797848662,MATH 10B,A02,084111,Staff,29,0,30,1
1649797848662,MATH 10B,A03,084112,Staff,30,0,30,0
1649797854689,MATH 10C,A01,083443,Staff,26,0,30,4
1649797854689,MATH 10C,A02,083444,Staff,26,0,30,4
1649797854689,MATH 10C,B01,084114,Staff,27,0,30,3
1649797854689,MATH 10C,B02,084115,Staff,30,0,30,0
1649797860719,MATH 18,A01,084117,Harel; Guershon,28,0,30,2
1649797860719,MATH 18,A02,084119,Harel; Guershon,29,0,30,1
1649797860719,MATH 18,A03,084120,Harel; Guershon,30,0,30,0
1649797860719,MATH 18,A04,084121,Harel; Guershon,30,0,30,0
1649797866752,MATH 20B,A01,084124,Um; Ko Woon,34,0,35,1
1649797866752,MATH 20B,B01,084126,Um; Ko Woon,35,0,35,0
1649797872788,MATH 20C,A01,083446,Hammock; Frances H,28,0,30,2
1649797872788,MATH 20C,A02,083447,Hammock; Frances H,30,0,30,0
1649797872788,MATH 20C,A03,083448,Hammock; Frances H,30,0,30,0
1649797872788,MATH 20C,A04,083449,Hammock; Frances H,30,0,30,0
1649797872788,MATH 20C,B01,083451,Hammock; Frances H,30,0,30,0
1649797872788,MATH 20C,B02,083452,Hammock; Frances H,30,0,30,0
1649797872788,MATH 20C,B03,083453,Hammock; Frances H,30,0,30,0
1649797872788,MATH 20C,B04,083454,Hammock; Frances H,30,0,30,0
1649797878812,MATH 20D,A01,084128,Staff,30,0,30,0
1649797878812,MATH 20D,A02,084129,Staff,30,0,30,0
1649797878812,MATH 20D,A03,084130,Staff,29,0,30,1
1649797878812,MATH 20D,B01,084133,Staff,29,0,30,1
1649797878812,MATH 20D,B02,084134,Staff,30,0,30,0
1649797878812,MATH 20D,B03,084135,Staff,30,0,30,0
1649797884837,MATH 20E,A01,084138,Staff,30,0,30,0
1649797884837,MATH 20E,A02,084139,Staff,29,0,30,1
1649797884837,MATH 20E,A03,084140,Staff,30,0,30,0
1649797884837,MATH 20E,A04,084141,Staff,30,0,30,0
1649797890870,MATH 102,A01,084143,Harel; Guershon,25,0,30,5
1649797890870,MATH 102,A02,084144,Harel; Guershon,29,0,30,1
1649797896907,MATH 103B,A01,083456,Staff,15,0,30,15
1649797896907,MATH 103B,A02,083457,Staff,27,0,30,3
1649797902931,MATH 109,A01,084146,Salehi Golsefidy; Alireza,30,0,30,0
1649797902931,MATH 109,A02,084147,Salehi Golsefidy; Alireza,28,0,30,2
1649797908963,MATH 120A,A01,085445,Eggers; John Dietrich,31,0,35,4
1649797908963,MATH 120A,A02,085446,Eggers; John Dietrich,33,0,35,2
1649797914986,MATH 142B,A01,084149,Verstraete; Jacques Allan,24,0,30,6
1649797914986,MATH 142B,A02,084150,Verstraete; Jacques Allan,26,0,30,4
1649797921014,MATH 170A,A01,083459,Nie; Jiawang,16,0,30,14
1649797921014,MATH 170A,A02,083460,Nie; Jiawang,27,0,30,3
1649797921014,MATH 170A,A03,083461,Nie; Jiawang,29,0,30,1
1649797927049,MATH 193B,A01,083463,Staff,23,0,30,7
1649797927049,MATH 193B,A02,083464,Staff,25,0,30,5
1649797927049,MATH 193B,A03,083465,Staff,30,0,30,0
1649797933122,COGS 2,A01,083966,Boyle; Mary E. T.,28,0,30,2
1649797939149,COGS 9,A01,083968,Staff,59,0,60,1
1649797945184,COGS 14B,A01,083970,Staff,49,0,50,1
1649797951224,COGS 100,A01,083972,Staff,55,0,60,5
1649797963280,COGS 101C,A01,083976,Staff,27,0,30,3
1649797969305,COGS 102A,A01,083978,Johnson; Christine M.,28,0,30,2
1649797975333,COGS 107B,A01,083980,Staff,45,0,50,5
1649797981358,COGS 115,A01,083982,Staff,24,0,30,6
1649797987384,COGS 118B,A01,083367,Staff,17,0,40,23
1649797993420,COGS 172,A01,083984,Provenzano; Emily Kara,25,0,30,5
1649797999443,COGS 177,A00,083368,Staff,17,0,30,13
1649798005482,COGS 186,A01,083986,Staff,28,0,40,12
1649798011507,COGS 187A,A01,083988,Boyle; Mary E. T.,51,0,60,9
1649798017536,CSE 8A,A50,084003,Miranda; Gregory Joseph,12,0,15,3
1649798023564,CSE 11,A01,084005,Miranda; Gregory Joseph,51,0,55,4
1649798029593,CSE 20,A01,084007,Staff,17,0,20,3
1649798035619,CSE 21,A01,084009,Staff,45,0,50,5
1649798041652,CSE 30,A01,083370,Cao; Yingjun,31,0,40,9
1649798047676,CSE 100,A01,083372,Cao; Yingjun,34,0,40,6
1649798053703,CSE 101,A01,084011,Staff,17,0,40,23
1649798059725,CSE 141,A01,083374,Eldon; John,24,0,75,51
1649798065756,CSE 141L,A01,083376,Eldon; John,26,0,75,49
1649798071785,CSE 175,A01,084013,Kumar; Rakesh,25,0,25,0
1649798077815,CSE 190,A00,092508,Staff,15,0,15,0
1649798083847,ECE 5,A01,084049,Morris; Karcher William,18,0,20,2
1649798089877,ECE 100,A01,084051,Baghdadchi; Saharnaz,17,0,20,3
1649798089877,ECE 100,A02,091916,Baghdadchi; Saharnaz,19,0,20,1
1649798095912,ECE 101,A01,084053,Baghdadchi; Saharnaz,32,0,37,5
1649798095912,ECE 101,A02,084054,Baghdadchi; Saharnaz,37,0,37,0
1649798101944,ECE 107,A01,083390,Staff,35,0,40,5
1649798107972,ECE 148,A01,084056,Silberman; Jack,8,0,12,4
1649798113997,ECE 180,A00,083391,Abi Samra; Nicholas Camill,27,0,30,3
1649798113997,ECE 180,B00,083392,Abi Samra; Nicholas Camill,26,0,30,4
1649798120036,MATH 10B,A01,084110,Staff,25,0,30,5
1649798120036,MATH 10B,A02,084111,Staff,29,0,30,1
1649798120036,MATH 10B,A03,084112,Staff,30,0,30,0
1649798126064,MATH 10C,A01,083443,Staff,25,0,30,5
1649798126064,MATH 10C,A02,083444,Staff,26,0,30,4
1649798126064,MATH 10C,B01,084114,Staff,27,0,30,3
1649798126064,MATH 10C,B02,084115,Staff,30,0,30,0
1649798132090,MATH 18,A01,084117,Harel; Guershon,28,0,30,2
1649798132090,MATH 18,A02,084119,Harel; Guershon,29,0,30,1
1649798132090,MATH 18,A03,084120,Harel; Guershon,30,0,30,0
1649798132090,MATH 18,A04,084121,Harel; Guershon,30,0,30,0
1649798138121,MATH 20B,A01,084124,Um; Ko Woon,34,0,35,1
1649798138121,MATH 20B,B01,084126,Um; Ko Woon,35,0,35,0
1649798144164,MATH 20C,A01,083446,Hammock; Frances H,28,0,30,2
1649798144164,MATH 20C,A02,083447,Hammock; Frances H,30,0,30,0
1649798144164,MATH 20C,A03,083448,Hammock; Frances H,30,0,30,0
1649798144164,MATH 20C,A04,083449,Hammock; Frances H,30,0,30,0
1649798144164,MATH 20C,B01,083451,Hammock; Frances H,30,0,30,0
1649798144164,MATH 20C,B02,083452,Hammock; Frances H,30,0,30,0
1649798144164,MATH 20C,B03,083453,Hammock; Frances H,30,0,30,0
1649798144164,MATH 20C,B04,083454,Hammock; Frances H,30,0,30,0
1649798150193,MATH 20D,A01,084128,Staff,30,0,30,0
1649798150193,MATH 20D,A02,084129,Staff,30,0,30,0
1649798150193,MATH 20D,A03,084130,Staff,29,0,30,1
1649798150193,MATH 20D,B01,084133,Staff,29,0,30,1
1649798150193,MATH 20D,B02,084134,Staff,30,0,30,0
1649798150193,MATH 20D,B03,084135,Staff,30,0,30,0
1649798156224,MATH 20E,A01,084138,Staff,30,0,30,0
1649798156224,MATH 20E,A02,084139,Staff,29,0,30,1
1649798156224,MATH 20E,A03,084140,Staff,30,0,30,0
1649798156224,MATH 20E,A04,084141,Staff,30,0,30,0
1649798162253,MATH 102,A01,084143,Harel; Guershon,25,0,30,5
1649798162253,MATH 102,A02,084144,Harel; Guershon,29,0,30,1
1649798168292,MATH 103B,A01,083456,Staff,15,0,30,15
1649798168292,MATH 103B,A02,083457,Staff,27,0,30,3
1649798174320,MATH 109,A01,084146,Salehi Golsefidy; Alireza,30,0,30,0
1649798174320,MATH 109,A02,084147,Salehi Golsefidy; Alireza,28,0,30,2
1649798180347,MATH 120A,A01,085445,Eggers; John Dietrich,31,0,35,4
1649798180347,MATH 120A,A02,085446,Eggers; John Dietrich,33,0,35,2
1649798186372,MATH 142B,A01,084149,Verstraete; Jacques Allan,24,0,30,6
1649798186372,MATH 142B,A02,084150,Verstraete; Jacques Allan,26,0,30,4
1649798192394,MATH 170A,A01,083459,Nie; Jiawang,16,0,30,14
1649798192394,MATH 170A,A02,083460,Nie; Jiawang,27,0,30,3
1649798192394,MATH 170A,A03,083461,Nie; Jiawang,29,0,30,1
1649798198420,MATH 193B,A01,083463,Staff,23,0,30,7
1649798198420,MATH 193B,A02,083464,Staff,25,0,30,5
1649798198420,MATH 193B,A03,083465,Staff,30,0,30,0
1649798204471,COGS 2,A01,083966,Boyle; Mary E. T.,28,0,30,2
1649798210499,COGS 9,A01,083968,Staff,59,0,60,1
1649798216526,COGS 14B,A01,083970,Staff,49,0,50,1
1649798222550,COGS 100,A01,083972,Staff,54,0,60,6
1649798234614,COGS 101C,A01,083976,Staff,27,0,30,3
1649798240639,COGS 102A,A01,083978,Johnson; Christine M.,28,0,30,2
1649798246661,COGS 107B,A01,083980,Staff,45,0,50,5
1649798252695,COGS 115,A01,083982,Staff,24,0,30,6
1649798258722,COGS 118B,A01,083367,Staff,17,0,40,23
1649798264748,COGS 172,A01,083984,Provenzano; Emily Kara,25,0,30,5
1649798270775,COGS 177,A00,083368,Staff,17,0,30,13
1649798276800,COGS 186,A01,083986,Staff,28,0,40,12
1649798282825,COGS 187A,A01,083988,Boyle; Mary E. T.,51,0,60,9
1649798288860,CSE 8A,A50,084003,Miranda; Gregory Joseph,12,0,15,3
1649798294884,CSE 11,A01,084005,Miranda; Gregory Joseph,51,0,55,4
1649798300915,CSE 20,A01,084007,Staff,17,0,20,3
1649798306947,CSE 21,A01,084009,Staff,45,0,50,5
1649798312971,CSE 30,A01,083370,Cao; Yingjun,31,0,40,9
1649798319007,CSE 100,A01,083372,Cao; Yingjun,34,0,40,6
1649798325034,CSE 101,A01,084011,Staff,17,0,40,23
1649798331061,CSE 141,A01,083374,Eldon; John,24,0,75,51
1649798337084,CSE 141L,A01,083376,Eldon; John,26,0,75,49
1649798343108,CSE 175,A01,084013,Kumar; Rakesh,25,0,25,0
1649798349172,CSE 190,A00,092508,Staff,15,0,15,0
1649798355195,ECE 5,A01,084049,Morris; Karcher William,18,0,20,2
1649798361300,ECE 100,A01,084051,Baghdadchi; Saharnaz,17,0,20,3
1649798361300,ECE 100,A02,091916,Baghdadchi; Saharnaz,19,0,20,1
1649798367324,ECE 101,A01,084053,Baghdadchi; Saharnaz,32,0,37,5
1649798367324,ECE 101,A02,084054,Baghdadchi; Saharnaz,37,0,37,0
1649798373355,ECE 107,A01,083390,Staff,35,0,40,5
1649798379383,ECE 148,A01,084056,Silberman; Jack,8,0,12,4
1649798385419,ECE 180,A00,083391,Abi Samra; Nicholas Camill,27,0,30,3
1649798385419,ECE 180,B00,083392,Abi Samra; Nicholas Camill,26,0,30,4
1649798391444,MATH 10B,A01,084110,Staff,25,0,30,5
1649798391444,MATH 10B,A02,084111,Staff,29,0,30,1
1649798391444,MATH 10B,A03,084112,Staff,30,0,30,0
1649798397477,MATH 10C,A01,083443,Staff,25,0,30,5
1649798397477,MATH 10C,A02,083444,Staff,26,0,30,4
1649798397477,MATH 10C,B01,084114,Staff,27,0,30,3
1649798397477,MATH 10C,B02,084115,Staff,30,0,30,0
1649798403516,MATH 18,A01,084117,Harel; Guershon,28,0,30,2
1649798403516,MATH 18,A02,084119,Harel; Guershon,29,0,30,1
1649798403516,MATH 18,A03,084120,Harel; Guershon,30,0,30,0
1649798403516,MATH 18,A04,084121,Harel; Guershon,30,0,30,0
1649798409545,MATH 20B,A01,084124,Um; Ko Woon,34,0,35,1
1649798409545,MATH 20B,B01,084126,Um; Ko Woon,35,0,35,0
1649798415574,MATH 20C,A01,083446,Hammock; Frances H,28,0,30,2
1649798415574,MATH 20C,A02,083447,Hammock; Frances H,30,0,30,0
1649798415574,MATH 20C,A03,083448,Hammock; Frances H,30,0,30,0
1649798415574,MATH 20C,A04,083449,Hammock; Frances H,30,0,30,0
1649798415574,MATH 20C,B01,083451,Hammock; Frances H,30,0,30,0
1649798415574,MATH 20C,B02,083452,Hammock; Frances H,30,0,30,0
1649798415574,MATH 20C,B03,083453,Hammock; Frances H,30,0,30,0
1649798415574,MATH 20C,B04,083454,Hammock; Frances H,30,0,30,0
1649798421607,MATH 20D,A01,084128,Staff,30,0,30,0
1649798421607,MATH 20D,A02,084129,Staff,30,0,30,0
1649798421607,MATH 20D,A03,084130,Staff,29,0,30,1
1649798421607,MATH 20D,B01,084133,Staff,29,0,30,1
1649798421607,MATH 20D,B02,084134,Staff,30,0,30,0
1649798421607,MATH 20D,B03,084135,Staff,30,0,30,0
1649798427636,MATH 20E,A01,084138,Staff,30,0,30,0
1649798427636,MATH 20E,A02,084139,Staff,29,0,30,1
1649798427636,MATH 20E,A03,084140,Staff,30,0,30,0
1649798427636,MATH 20E,A04,084141,Staff,30,0,30,0
1649798433678,MATH 102,A01,084143,Harel; Guershon,25,0,30,5
1649798433678,MATH 102,A02,084144,Harel; Guershon,29,0,30,1
1649798439708,MATH 103B,A01,083456,Staff,15,0,30,15
1649798439708,MATH 103B,A02,083457,Staff,27,0,30,3
1649798445732,MATH 109,A01,084146,Salehi Golsefidy; Alireza,30,0,30,0
1649798445732,MATH 109,A02,084147,Salehi Golsefidy; Alireza,28,0,30,2
1649798451764,MATH 120A,A01,085445,Eggers; John Dietrich,31,0,35,4
1649798451764,MATH 120A,A02,085446,Eggers; John Dietrich,33,0,35,2
1649798457786,MATH 142B,A01,084149,Verstraete; Jacques Allan,24,0,30,6
1649798457786,MATH 142B,A02,084150,Verstraete; Jacques Allan,26,0,30,4
1649798463811,MATH 170A,A01,083459,Nie; Jiawang,16,0,30,14
1649798463811,MATH 170A,A02,083460,Nie; Jiawang,27,0,30,3
1649798463811,MATH 170A,A03,083461,Nie; Jiawang,29,0,30,1
1649798469845,MATH 193B,A01,083463,Staff,23,0,30,7
1649798469845,MATH 193B,A02,083464,Staff,25,0,30,5
1649798469845,MATH 193B,A03,083465,Staff,30,0,30,0
1649798475917,COGS 2,A01,083966,Boyle; Mary E. T.,28,0,30,2
1649798481947,COGS 9,A01,083968,Staff,58,0,60,2
1649798487974,COGS 14B,A01,083970,Staff,49,0,50,1
1649798499858,COGS 100,A01,083972,Staff,54,0,60,6
1649798511920,COGS 101C,A01,083976,Staff,27,0,30,3
1649798517960,COGS 102A,A01,083978,Johnson; Christine M.,28,0,30,2
1649798523984,COGS 107B,A01,083980,Staff,45,0,50,5
1649798530011,COGS 115,A01,083982,Staff,24,0,30,6
1649798536046,COGS 118B,A01,083367,Staff,17,0,40,23
1649798542071,COGS 172,A01,083984,Provenzano; Emily Kara,25,0,30,5
1649798548097,COGS 177,A00,083368,Staff,17,0,30,13
1649798554121,COGS 186,A01,083986,Staff,28,0,40,12
1649798560148,COGS 187A,A01,083988,Boyle; Mary E. T.,51,0,60,9
1649798566172,CSE 8A,A50,084003,Miranda; Gregory Joseph,12,0,15,3
1649798572196,CSE 11,A01,084005,Miranda; Gregory Joseph,51,0,55,4
1649798578229,CSE 20,A01,084007,Staff,17,0,20,3
1649798584257,CSE 21,A01,084009,Staff,45,0,50,5
1649798590281,CSE 30,A01,083370,Cao; Yingjun,30,0,40,10
1649798596305,CSE 100,A01,083372,Cao; Yingjun,33,0,40,7
1649798602327,CSE 101,A01,084011,Staff,17,0,40,23
1649798608351,CSE 141,A01,083374,Eldon; John,23,0,75,52
1649798614375,CSE 141L,A01,083376,Eldon; John,25,0,75,50
1649798620402,CSE 175,A01,084013,Kumar; Rakesh,25,0,25,0
1649798626430,CSE 190,A00,092508,Staff,15,0,15,0
1649798632454,ECE 5,A01,084049,Morris; Karcher William,18,0,20,2
1649798638481,ECE 100,A01,084051,Baghdadchi; Saharnaz,17,0,20,3
1649798638481,ECE 100,A02,091916,Baghdadchi; Saharnaz,19,0,20,1
1649798644505,ECE 101,A01,084053,Baghdadchi; Saharnaz,31,0,37,6
1649798644505,ECE 101,A02,084054,Baghdadchi; Saharnaz,37,0,37,0
1649798650529,ECE 107,A01,083390,Staff,35,0,40,5
1649798656552,ECE 148,A01,084056,Silberman; Jack,8,0,12,4
1649798662579,ECE 180,A00,083391,Abi Samra; Nicholas Camill,27,0,30,3
1649798662579,ECE 180,B00,083392,Abi Samra; Nicholas Camill,26,0,30,4
1649798668603,MATH 10B,A01,084110,Staff,25,0,30,5
1649798668603,MATH 10B,A02,084111,Staff,29,0,30,1
1649798668603,MATH 10B,A03,084112,Staff,30,0,30,0
1649798674628,MATH 10C,A01,083443,Staff,25,0,30,5
1649798674628,MATH 10C,A02,083444,Staff,26,0,30,4
1649798674628,MATH 10C,B01,084114,Staff,27,0,30,3
1649798674628,MATH 10C,B02,084115,Staff,30,0,30,0
1649798680667,MATH 18,A01,084117,Harel; Guershon,28,0,30,2
1649798680667,MATH 18,A02,084119,Harel; Guershon,29,0,30,1
1649798680667,MATH 18,A03,084120,Harel; Guershon,30,0,30,0
1649798680667,MATH 18,A04,084121,Harel; Guershon,30,0,30,0
1649798686690,MATH 20B,A01,084124,Um; Ko Woon,34,0,35,1
1649798686690,MATH 20B,B01,084126,Um; Ko Woon,35,0,35,0
1649798692720,MATH 20C,A01,083446,Hammock; Frances H,27,0,30,3
1649798692720,MATH 20C,A02,083447,Hammock; Frances H,30,0,30,0
1649798692720,MATH 20C,A03,083448,Hammock; Frances H,30,0,30,0
1649798692720,MATH 20C,A04,083449,Hammock; Frances H,30,0,30,0
1649798692720,MATH 20C,B01,083451,Hammock; Frances H,30,0,30,0
1649798692720,MATH 20C,B02,083452,Hammock; Frances H,30,0,30,0
1649798692720,MATH 20C,B03,083453,Hammock; Frances H,30,0,30,0
1649798692720,MATH 20C,B04,083454,Hammock; Frances H,30,0,30,0
1649798698748,MATH 20D,A01,084128,Staff,30,0,30,0
1649798698748,MATH 20D,A02,084129,Staff,30,0,30,0
1649798698748,MATH 20D,A03,084130,Staff,29,0,30,1
1649798698748,MATH 20D,B01,084133,Staff,29,0,30,1
1649798698748,MATH 20D,B02,084134,Staff,30,0,30,0
1649798698748,MATH 20D,B03,084135,Staff,30,0,30,0
1649798704786,MATH 20E,A01,084138,Staff,30,0,30,0
1649798704786,MATH 20E,A02,084139,Staff,29,0,30,1
1649798704786,MATH 20E,A03,084140,Staff,30,0,30,0
1649798704786,MATH 20E,A04,084141,Staff,30,0,30,0
1649798710826,MATH 102,A01,084143,Harel; Guershon,25,0,30,5
1649798710826,MATH 102,A02,084144,Harel; Guershon,29,0,30,1
1649798716849,MATH 103B,A01,083456,Staff,15,0,30,15
1649798716849,MATH 103B,A02,083457,Staff,27,0,30,3
1649798722873,MATH 109,A01,084146,Salehi Golsefidy; Alireza,30,0,30,0
1649798722873,MATH 109,A02,084147,Salehi Golsefidy; Alireza,28,0,30,2
1649798728902,MATH 120A,A01,085445,Eggers; John Dietrich,31,0,35,4
1649798728902,MATH 120A,A02,085446,Eggers; John Dietrich,33,0,35,2
1649798734928,MATH 142B,A01,084149,Verstraete; Jacques Allan,24,0,30,6
1649798734928,MATH 142B,A02,084150,Verstraete; Jacques Allan,26,0,30,4
1649798740968,MATH 170A,A01,083459,Nie; Jiawang,16,0,30,14
1649798740968,MATH 170A,A02,083460,Nie; Jiawang,27,0,30,3
1649798740968,MATH 170A,A03,083461,Nie; Jiawang,29,0,30,1
1649798746992,MATH 193B,A01,083463,Staff,23,0,30,7
1649798746992,MATH 193B,A02,083464,Staff,25,0,30,5
1649798746992,MATH 193B,A03,083465,Staff,30,0,30,0
1649798753050,COGS 2,A01,083966,Boyle; Mary E. T.,28,0,30,2
1649798759080,COGS 9,A01,083968,Staff,58,0,60,2
1649798765106,COGS 14B,A01,083970,Staff,49,0,50,1
1649798771131,COGS 100,A01,083972,Staff,53,0,60,7
1649798783187,COGS 101C,A01,083976,Staff,27,0,30,3
1649798789210,COGS 102A,A01,083978,Johnson; Christine M.,28,0,30,2
1649798795236,COGS 107B,A01,083980,Staff,45,0,50,5
1649798801268,COGS 115,A01,083982,Staff,24,0,30,6
1649798807291,COGS 118B,A01,083367,Staff,17,0,40,23
1649798813319,COGS 172,A01,083984,Provenzano; Emily Kara,25,0,30,5
1649798819340,COGS 177,A00,083368,Staff,17,0,30,13
1649798825365,COGS 186,A01,083986,Staff,28,0,40,12
1649798831391,COGS 187A,A01,083988,Boyle; Mary E. T.,51,0,60,9
1649798837417,CSE 8A,A50,084003,Miranda; Gregory Joseph,12,0,15,3
1649798843444,CSE 11,A01,084005,Miranda; Gregory Joseph,51,0,55,4
1649798849479,CSE 20,A01,084007,Staff,17,0,20,3
1649798855505,CSE 21,A01,084009,Staff,45,0,50,5
1649798861538,CSE 30,A01,083370,Cao; Yingjun,30,0,40,10
1649798867572,CSE 100,A01,083372,Cao; Yingjun,33,0,40,7
1649798873597,CSE 101,A01,084011,Staff,17,0,40,23
1649798879620,CSE 141,A01,083374,Eldon; John,23,0,75,52
1649798885644,CSE 141L,A01,083376,Eldon; John,25,0,75,50
1649798891679,CSE 175,A01,084013,Kumar; Rakesh,25,0,25,0
1649798897706,CSE 190,A00,092508,Staff,15,0,15,0
1649798903732,ECE 5,A01,084049,Morris; Karcher William,18,0,20,2
1649798909756,ECE 100,A01,084051,Baghdadchi; Saharnaz,17,0,20,3
1649798909756,ECE 100,A02,091916,Baghdadchi; Saharnaz,19,0,20,1
1649798915779,ECE 101,A01,084053,Baghdadchi; Saharnaz,31,0,37,6
1649798915779,ECE 101,A02,084054,Baghdadchi; Saharnaz,37,0,37,0
1649798921809,ECE 107,A01,083390,Staff,35,0,40,5
1649798927837,ECE 148,A01,084056,Silberman; Jack,8,0,12,4
1649798933863,ECE 180,A00,083391,Abi Samra; Nicholas Camill,27,0,30,3
1649798933863,ECE 180,B00,083392,Abi Samra; Nicholas Camill,26,0,30,4
1649798939892,MATH 10B,A01,084110,Staff,25,0,30,5
1649798939892,MATH 10B,A02,084111,Staff,29,0,30,1
1649798939892,MATH 10B,A03,084112,Staff,30,0,30,0
1649798945925,MATH 10C,A01,083443,Staff,25,0,30,5
1649798945925,MATH 10C,A02,083444,Staff,26,0,30,4
1649798945925,MATH 10C,B01,084114,Staff,27,0,30,3
1649798945925,MATH 10C,B02,084115,Staff,30,0,30,0
1649798951954,MATH 18,A01,084117,Harel; Guershon,28,0,30,2
1649798951954,MATH 18,A02,084119,Harel; Guershon,29,0,30,1
1649798951954,MATH 18,A03,084120,Harel; Guershon,30,0,30,0
1649798951954,MATH 18,A04,084121,Harel; Guershon,30,0,30,0
1649798957989,MATH 20B,A01,084124,Um; Ko Woon,34,0,35,1
1649798957989,MATH 20B,B01,084126,Um; Ko Woon,35,0,35,0
1649798964087,MATH 20C,A01,083446,Hammock; Frances H,27,0,30,3
1649798964087,MATH 20C,A02,083447,Hammock; Frances H,30,0,30,0
1649798964087,MATH 20C,A03,083448,Hammock; Frances H,30,0,30,0
1649798964087,MATH 20C,A04,083449,Hammock; Frances H,30,0,30,0
1649798964087,MATH 20C,B01,083451,Hammock; Frances H,30,0,30,0
1649798964087,MATH 20C,B02,083452,Hammock; Frances H,30,0,30,0
1649798964087,MATH 20C,B03,083453,Hammock; Frances H,30,0,30,0
1649798964087,MATH 20C,B04,083454,Hammock; Frances H,30,0,30,0
1649798970127,MATH 20D,A01,084128,Staff,30,0,30,0
1649798970127,MATH 20D,A02,084129,Staff,30,0,30,0
1649798970127,MATH 20D,A03,084130,Staff,29,0,30,1
1649798970127,MATH 20D,B01,084133,Staff,29,0,30,1
1649798970127,MATH 20D,B02,084134,Staff,30,0,30,0
1649798970127,MATH 20D,B03,084135,Staff,30,0,30,0
1649798976157,MATH 20E,A01,084138,Staff,30,0,30,0
1649798976157,MATH 20E,A02,084139,Staff,29,0,30,1
1649798976157,MATH 20E,A03,084140,Staff,30,0,30,0
1649798976157,MATH 20E,A04,084141,Staff,30,0,30,0
1649798982183,MATH 102,A01,084143,Harel; Guershon,25,0,30,5
1649798982183,MATH 102,A02,084144,Harel; Guershon,29,0,30,1
1649798988209,MATH 103B,A01,083456,Staff,15,0,30,15
1649798988209,MATH 103B,A02,083457,Staff,27,0,30,3
1649798994238,MATH 109,A01,084146,Salehi Golsefidy; Alireza,30,0,30,0
1649798994238,MATH 109,A02,084147,Salehi Golsefidy; Alireza,28,0,30,2
1649799000266,MATH 120A,A01,085445,Eggers; John Dietrich,31,0,35,4
1649799000266,MATH 120A,A02,085446,Eggers; John Dietrich,33,0,35,2
1649799006290,MATH 142B,A01,084149,Verstraete; Jacques Allan,24,0,30,6
1649799006290,MATH 142B,A02,084150,Verstraete; Jacques Allan,26,0,30,4
1649799012321,MATH 170A,A01,083459,Nie; Jiawang,16,0,30,14
1649799012321,MATH 170A,A02,083460,Nie; Jiawang,27,0,30,3
1649799012321,MATH 170A,A03,083461,Nie; Jiawang,29,0,30,1
1649799018357,MATH 193B,A01,083463,Staff,23,0,30,7
1649799018357,MATH 193B,A02,083464,Staff,25,0,30,5
1649799018357,MATH 193B,A03,083465,Staff,30,0,30,0
1649799024418,COGS 2,A01,083966,Boyle; Mary E. T.,28,0,30,2
1649799030449,COGS 9,A01,083968,Staff,58,0,60,2
1649799036476,COGS 14B,A01,083970,Staff,49,0,50,1
1649799042506,COGS 100,A01,083972,Staff,53,0,60,7
1649799054554,COGS 101C,A01,083976,Staff,27,0,30,3
1649799060581,COGS 102A,A01,083978,Johnson; Christine M.,28,0,30,2
1649799066608,COGS 107B,A01,083980,Staff,45,0,50,5
1649799072635,COGS 115,A01,083982,Staff,24,0,30,6
1649799078658,COGS 118B,A01,083367,Staff,17,0,40,23
1649799084691,COGS 172,A01,083984,Provenzano; Emily Kara,25,0,30,5
1649799090717,COGS 177,A00,083368,Staff,17,0,30,13
1649799096741,COGS 186,A01,083986,Staff,28,0,40,12
1649799102764,COGS 187A,A01,083988,Boyle; Mary E. T.,51,0,60,9
1649799108788,CSE 8A,A50,084003,Miranda; Gregory Joseph,11,0,15,4
1649799114811,CSE 11,A01,084005,Miranda; Gregory Joseph,51,0,55,4
1649799120834,CSE 20,A01,084007,Staff,17,0,20,3
1649799126858,CSE 21,A01,084009,Staff,45,0,50,5
1649799132890,CSE 30,A01,083370,Cao; Yingjun,30,0,40,10
1649799138919,CSE 100,A01,083372,Cao; Yingjun,33,0,40,7
1649799144942,CSE 101,A01,084011,Staff,17,0,40,23
1649799150965,CSE 141,A01,083374,Eldon; John,23,0,75,52
1649799156992,CSE 141L,A01,083376,Eldon; John,25,0,75,50
1649799163019,CSE 175,A01,084013,Kumar; Rakesh,25,0,25,0
1649799169045,CSE 190,A00,092508,Staff,15,0,15,0
1649799175086,ECE 5,A01,084049,Morris; Karcher William,18,0,20,2
1649799181123,ECE 100,A01,084051,Baghdadchi; Saharnaz,17,0,20,3
1649799181123,ECE 100,A02,091916,Baghdadchi; Saharnaz,19,0,20,1
1649799187150,ECE 101,A01,084053,Baghdadchi; Saharnaz,31,0,37,6
1649799187150,ECE 101,A02,084054,Baghdadchi; Saharnaz,37,0,37,0
1649799193189,ECE 107,A01,083390,Staff,35,0,40,5
1649799199215,ECE 148,A01,084056,Silberman; Jack,8,0,12,4
1649799205239,ECE 180,A00,083391,Abi Samra; Nicholas Camill,27,0,30,3
1649799205239,ECE 180,B00,083392,Abi Samra; Nicholas Camill,26,0,30,4
1649799211263,MATH 10B,A01,084110,Staff,25,0,30,5
1649799211263,MATH 10B,A02,084111,Staff,29,0,30,1
1649799211263,MATH 10B,A03,084112,Staff,30,0,30,0
1649799217290,MATH 10C,A01,083443,Staff,25,0,30,5
1649799217290,MATH 10C,A02,083444,Staff,26,0,30,4
1649799217290,MATH 10C,B01,084114,Staff,27,0,30,3
1649799217290,MATH 10C,B02,084115,Staff,30,0,30,0
1649799223314,MATH 18,A01,084117,Harel; Guershon,28,0,30,2
1649799223314,MATH 18,A02,084119,Harel; Guershon,29,0,30,1
1649799223314,MATH 18,A03,084120,Harel; Guershon,30,0,30,0
1649799223314,MATH 18,A04,084121,Harel; Guershon,30,0,30,0
1649799229339,MATH 20B,A01,084124,Um; Ko Woon,34,0,35,1
1649799229339,MATH 20B,B01,084126,Um; Ko Woon,35,0,35,0
1649799235379,MATH 20C,A01,083446,Hammock; Frances H,27,0,30,3
1649799235379,MATH 20C,A02,083447,Hammock; Frances H,30,0,30,0
1649799235379,MATH 20C,A03,083448,Hammock; Frances H,30,0,30,0
1649799235379,MATH 20C,A04,083449,Hammock; Frances H,30,0,30,0
1649799235379,MATH 20C,B01,083451,Hammock; Frances H,30,0,30,0
1649799235379,MATH 20C,B02,083452,Hammock; Frances H,30,0,30,0
1649799235379,MATH 20C,B03,083453,Hammock; Frances H,30,0,30,0
1649799235379,MATH 20C,B04,083454,Hammock; Frances H,30,0,30,0
1649799241402,MATH 20D,A01,084128,Staff,30,0,30,0
1649799241402,MATH 20D,A02,084129,Staff,30,0,30,0
1649799241402,MATH 20D,A03,084130,Staff,29,0,30,1
1649799241402,MATH 20D,B01,084133,Staff,29,0,30,1
1649799241402,MATH 20D,B02,084134,Staff,30,0,30,0
1649799241402,MATH 20D,B03,084135,Staff,30,0,30,0
1649799247426,MATH 20E,A01,084138,Staff,30,0,30,0
1649799247426,MATH 20E,A02,084139,Staff,29,0,30,1
1649799247426,MATH 20E,A03,084140,Staff,30,0,30,0
1649799247426,MATH 20E,A04,084141,Staff,30,0,30,0
1649799253450,MATH 102,A01,084143,Harel; Guershon,25,0,30,5
1649799253450,MATH 102,A02,084144,Harel; Guershon,29,0,30,1
1649799259474,MATH 103B,A01,083456,Staff,15,0,30,15
1649799259474,MATH 103B,A02,083457,Staff,27,0,30,3
1649799265497,MATH 109,A01,084146,Salehi Golsefidy; Alireza,30,0,30,0
1649799265497,MATH 109,A02,084147,Salehi Golsefidy; Alireza,28,0,30,2
1649799271532,MATH 120A,A01,085445,Eggers; John Dietrich,31,0,35,4
1649799271532,MATH 120A,A02,085446,Eggers; John Dietrich,33,0,35,2
1649799277558,MATH 142B,A01,084149,Verstraete; Jacques Allan,24,0,30,6
1649799277558,MATH 142B,A02,084150,Verstraete; Jacques Allan,26,0,30,4
1649799283581,MATH 170A,A01,083459,Nie; Jiawang,16,0,30,14
1649799283581,MATH 170A,A02,083460,Nie; Jiawang,27,0,30,3
1649799283581,MATH 170A,A03,083461,Nie; Jiawang,29,0,30,1
1649799289608,MATH 193B,A01,083463,Staff,22,0,30,8
1649799289608,MATH 193B,A02,083464,Staff,25,0,30,5
1649799289608,MATH 193B,A03,083465,Staff,30,0,30,0
1649799295672,COGS 2,A01,083966,Boyle; Mary E. T.,28,0,30,2
1649799301704,COGS 9,A01,083968,Staff,58,0,60,2
1649799307728,COGS 14B,A01,083970,Staff,49,0,50,1
1649799313760,COGS 100,A01,083972,Staff,53,0,60,7
1649799325814,COGS 101C,A01,083976,Staff,27,0,30,3
1649799331866,COGS 102A,A01,083978,Johnson; Christine M.,28,0,30,2
1649799337897,COGS 107B,A01,083980,Staff,45,0,50,5
1649799343921,COGS 115,A01,083982,Staff,24,0,30,6
1649799349947,COGS 118B,A01,083367,Staff,17,0,40,23
1649799355973,COGS 172,A01,083984,Provenzano; Emily Kara,25,0,30,5
1649799362008,COGS 177,A00,083368,Staff,16,0,30,14
1649799368041,COGS 186,A01,083986,Staff,28,0,40,12
1649799374073,COGS 187A,A01,083988,Boyle; Mary E. T.,51,0,60,9
1649799380096,CSE 8A,A50,084003,Miranda; Gregory Joseph,11,0,15,4
1649799386124,CSE 11,A01,084005,Miranda; Gregory Joseph,51,0,55,4
1649799392156,CSE 20,A01,084007,Staff,17,0,20,3
1649799398181,CSE 21,A01,084009,Staff,45,0,50,5
1649799404205,CSE 30,A01,083370,Cao; Yingjun,30,0,40,10
1649799410236,CSE 100,A01,083372,Cao; Yingjun,33,0,40,7
1649799416261,CSE 101,A01,084011,Staff,17,0,40,23
1649799422283,CSE 141,A01,083374,Eldon; John,23,0,75,52
1649799428309,CSE 141L,A01,083376,Eldon; John,25,0,75,50
1649799434336,CSE 175,A01,084013,Kumar; Rakesh,25,0,25,0
1649799440362,CSE 190,A00,092508,Staff,15,0,15,0
1649799446385,ECE 5,A01,084049,Morris; Karcher William,18,0,20,2
1649799452414,ECE 100,A01,084051,Baghdadchi; Saharnaz,17,0,20,3
1649799452414,ECE 100,A02,091916,Baghdadchi; Saharnaz,19,0,20,1
1649799458441,ECE 101,A01,084053,Baghdadchi; Saharnaz,31,0,37,6
1649799458441,ECE 101,A02,084054,Baghdadchi; Saharnaz,37,0,37,0
1649799464464,ECE 107,A01,083390,Staff,35,0,40,5
1649799470494,ECE 148,A01,084056,Silberman; Jack,8,0,12,4
1649799476523,ECE 180,A00,083391,Abi Samra; Nicholas Camill,27,0,30,3
1649799476523,ECE 180,B00,083392,Abi Samra; Nicholas Camill,26,0,30,4
1649799482546,MATH 10B,A01,084110,Staff,25,0,30,5
1649799482546,MATH 10B,A02,084111,Staff,29,0,30,1
1649799482546,MATH 10B,A03,084112,Staff,30,0,30,0
1649799488580,MATH 10C,A01,083443,Staff,25,0,30,5
1649799488580,MATH 10C,A02,083444,Staff,26,0,30,4
1649799488580,MATH 10C,B01,084114,Staff,27,0,30,3
1649799488580,MATH 10C,B02,084115,Staff,30,0,30,0
1649799494606,MATH 18,A01,084117,Harel; Guershon,28,0,30,2
1649799494606,MATH 18,A02,084119,Harel; Guershon,29,0,30,1
1649799494606,MATH 18,A03,084120,Harel; Guershon,30,0,30,0
1649799494606,MATH 18,A04,084121,Harel; Guershon,30,0,30,0
1649799500631,MATH 20B,A01,084124,Um; Ko Woon,34,0,35,1
1649799500631,MATH 20B,B01,084126,Um; Ko Woon,35,0,35,0
1649799506660,MATH 20C,A01,083446,Hammock; Frances H,27,0,30,3
1649799506660,MATH 20C,A02,083447,Hammock; Frances H,30,0,30,0
1649799506660,MATH 20C,A03,083448,Hammock; Frances H,30,0,30,0
1649799506660,MATH 20C,A04,083449,Hammock; Frances H,30,0,30,0
1649799506660,MATH 20C,B01,083451,Hammock; Frances H,30,0,30,0
1649799506660,MATH 20C,B02,083452,Hammock; Frances H,30,0,30,0
1649799506660,MATH 20C,B03,083453,Hammock; Frances H,30,0,30,0
1649799506660,MATH 20C,B04,083454,Hammock; Frances H,30,0,30,0
1649799512684,MATH 20D,A01,084128,Staff,30,0,30,0
1649799512684,MATH 20D,A02,084129,Staff,30,0,30,0
1649799512684,MATH 20D,A03,084130,Staff,29,0,30,1
1649799512684,MATH 20D,B01,084133,Staff,29,0,30,1
1649799512684,MATH 20D,B02,084134,Staff,30,0,30,0
1649799512684,MATH 20D,B03,084135,Staff,30,0,30,0
1649799518713,MATH 20E,A01,084138,Staff,30,0,30,0
1649799518713,MATH 20E,A02,084139,Staff,29,0,30,1
1649799518713,MATH 20E,A03,084140,Staff,30,0,30,0
1649799518713,MATH 20E,A04,084141,Staff,30,0,30,0
1649799524737,MATH 102,A01,084143,Harel; Guershon,25,0,30,5
1649799524737,MATH 102,A02,084144,Harel; Guershon,29,0,30,1
1649799530764,MATH 103B,A01,083456,Staff,15,0,30,15
1649799530764,MATH 103B,A02,083457,Staff,27,0,30,3
1649799536788,MATH 109,A01,084146,Salehi Golsefidy; Alireza,30,0,30,0
1649799536788,MATH 109,A02,084147,Salehi Golsefidy; Alireza,28,0,30,2
1649799542812,MATH 120A,A01,085445,Eggers; John Dietrich,31,0,35,4
1649799542812,MATH 120A,A02,085446,Eggers; John Dietrich,33,0,35,2
1649799548853,MATH 142B,A01,084149,Verstraete; Jacques Allan,24,0,30,6
1649799548853,MATH 142B,A02,084150,Verstraete; Jacques Allan,26,0,30,4
1649799554880,MATH 170A,A01,083459,Nie; Jiawang,16,0,30,14
1649799554880,MATH 170A,A02,083460,Nie; Jiawang,27,0,30,3
1649799554880,MATH 170A,A03,083461,Nie; Jiawang,29,0,30,1
1649799561734,MATH 193B,A01,083463,Staff,22,0,30,8
1649799561734,MATH 193B,A02,083464,Staff,25,0,30,5
1649799561734,MATH 193B,A03,083465,Staff,30,0,30,0
1649799567797,COGS 2,A01,083966,Boyle; Mary E. T.,28,0,30,2
1649799573822,COGS 9,A01,083968,Staff,58,0,60,2
1649799579849,COGS 14B,A01,083970,Staff,49,0,50,1
1649799585872,COGS 100,A01,083972,Staff,53,0,60,7
1649799597953,COGS 101C,A01,083976,Staff,27,0,30,3
1649799603979,COGS 102A,A01,083978,Johnson; Christine M.,28,0,30,2
1649799610003,COGS 107B,A01,083980,Staff,45,0,50,5
1649799616033,COGS 115,A01,083982,Staff,24,0,30,6
1649799622073,COGS 118B,A01,083367,Staff,17,0,40,23
1649799628106,COGS 172,A01,083984,Provenzano; Emily Kara,25,0,30,5
1649799634141,COGS 177,A00,083368,Staff,16,0,30,14
1649799640167,COGS 186,A01,083986,Staff,28,0,40,12
1649799646191,COGS 187A,A01,083988,Boyle; Mary E. T.,51,0,60,9
1649799652216,CSE 8A,A50,084003,Miranda; Gregory Joseph,11,0,15,4
1649799658252,CSE 11,A01,084005,Miranda; Gregory Joseph,51,0,55,4
1649799664279,CSE 20,A01,084007,Staff,17,0,20,3
1649799670302,CSE 21,A01,084009,Staff,45,0,50,5
1649799676336,CSE 30,A01,083370,Cao; Yingjun,30,0,40,10
1649799682364,CSE 100,A01,083372,Cao; Yingjun,33,0,40,7
1649799688395,CSE 101,A01,084011,Staff,17,0,40,23
1649799694437,CSE 141,A01,083374,Eldon; John,22,0,75,53
1649799700473,CSE 141L,A01,083376,Eldon; John,24,0,75,51
1649799706497,CSE 175,A01,084013,Kumar; Rakesh,25,0,25,0
1649799712521,CSE 190,A00,092508,Staff,15,0,15,0
1649799718550,ECE 5,A01,084049,Morris; Karcher William,18,0,20,2
1649799724591,ECE 100,A01,084051,Baghdadchi; Saharnaz,17,0,20,3
1649799724591,ECE 100,A02,091916,Baghdadchi; Saharnaz,19,0,20,1
1649799730613,ECE 101,A01,084053,Baghdadchi; Saharnaz,30,0,37,7
1649799730613,ECE 101,A02,084054,Baghdadchi; Saharnaz,37,0,37,0
1649799736641,ECE 107,A01,083390,Staff,35,0,40,5
1649799742678,ECE 148,A01,084056,Silberman; Jack,8,0,12,4
1649799748700,ECE 180,A00,083391,Abi Samra; Nicholas Camill,27,0,30,3
1649799748700,ECE 180,B00,083392,Abi Samra; Nicholas Camill,26,0,30,4
1649799754722,MATH 10B,A01,084110,Staff,24,0,30,6
1649799754722,MATH 10B,A02,084111,Staff,29,0,30,1
1649799754722,MATH 10B,A03,084112,Staff,30,0,30,0
1649799760746,MATH 10C,A01,083443,Staff,25,0,30,5
1649799760746,MATH 10C,A02,083444,Staff,26,0,30,4
1649799760746,MATH 10C,B01,084114,Staff,27,0,30,3
1649799760746,MATH 10C,B02,084115,Staff,30,0,30,0
1649799766776,MATH 18,A01,084117,Harel; Guershon,28,0,30,2
1649799766776,MATH 18,A02,084119,Harel; Guershon,29,0,30,1
1649799766776,MATH 18,A03,084120,Harel; Guershon,30,0,30,0
1649799766776,MATH 18,A04,084121,Harel; Guershon,30,0,30,0
1649799772802,MATH 20B,A01,084124,Um; Ko Woon,34,0,35,1
1649799772802,MATH 20B,B01,084126,Um; Ko Woon,35,0,35,0
1649799778837,MATH 20C,A01,083446,Hammock; Frances H,27,0,30,3
1649799778837,MATH 20C,A02,083447,Hammock; Frances H,30,0,30,0
1649799778837,MATH 20C,A03,083448,Hammock; Frances H,30,0,30,0
1649799778837,MATH 20C,A04,083449,Hammock; Frances H,30,0,30,0
1649799778837,MATH 20C,B01,083451,Hammock; Frances H,30,0,30,0
1649799778837,MATH 20C,B02,083452,Hammock; Frances H,30,0,30,0
1649799778837,MATH 20C,B03,083453,Hammock; Frances H,30,0,30,0
1649799778837,MATH 20C,B04,083454,Hammock; Frances H,30,0,30,0
1649799784868,MATH 20D,A01,084128,Staff,30,0,30,0
1649799784868,MATH 20D,A02,084129,Staff,30,0,30,0
1649799784868,MATH 20D,A03,084130,Staff,29,0,30,1
1649799784868,MATH 20D,B01,084133,Staff,29,0,30,1
1649799784868,MATH 20D,B02,084134,Staff,30,0,30,0
1649799784868,MATH 20D,B03,084135,Staff,30,0,30,0
1649799790911,MATH 20E,A01,084138,Staff,30,0,30,0
1649799790911,MATH 20E,A02,084139,Staff,29,0,30,1
1649799790911,MATH 20E,A03,084140,Staff,30,0,30,0
1649799790911,MATH 20E,A04,084141,Staff,30,0,30,0
1649799796937,MATH 102,A01,084143,Harel; Guershon,25,0,30,5
1649799796937,MATH 102,A02,084144,Harel; Guershon,29,0,30,1
1649799802961,MATH 103B,A01,083456,Staff,15,0,30,15
1649799802961,MATH 103B,A02,083457,Staff,26,0,30,4
1649799808991,MATH 109,A01,084146,Salehi Golsefidy; Alireza,30,0,30,0
1649799808991,MATH 109,A02,084147,Salehi Golsefidy; Alireza,27,0,30,3
1649799815019,MATH 120A,A01,085445,Eggers; John Dietrich,31,0,35,4
1649799815019,MATH 120A,A02,085446,Eggers; John Dietrich,33,0,35,2
1649799821058,MATH 142B,A01,084149,Verstraete; Jacques Allan,22,0,30,8
1649799821058,MATH 142B,A02,084150,Verstraete; Jacques Allan,26,0,30,4
1649799827082,MATH 170A,A01,083459,Nie; Jiawang,16,0,30,14
1649799827082,MATH 170A,A02,083460,Nie; Jiawang,27,0,30,3
1649799827082,MATH 170A,A03,083461,Nie; Jiawang,29,0,30,1
1649799833126,MATH 193B,A01,083463,Staff,22,0,30,8
1649799833126,MATH 193B,A02,083464,Staff,25,0,30,5
1649799833126,MATH 193B,A03,083465,Staff,30,0,30,0
1649799839198,COGS 2,A01,083966,Boyle; Mary E. T.,28,0,30,2
1649799845261,COGS 9,A01,083968,Staff,58,0,60,2
1649799851289,COGS 14B,A01,083970,Staff,49,0,50,1
1649799857321,COGS 100,A01,083972,Staff,53,0,60,7
1649799869374,COGS 101C,A01,083976,Staff,27,0,30,3
1649799875401,COGS 102A,A01,083978,Johnson; Christine M.,28,0,30,2
1649799881430,COGS 107B,A01,083980,Staff,45,0,50,5
1649799887451,COGS 115,A01,083982,Staff,24,0,30,6
1649799893476,COGS 118B,A01,083367,Staff,16,0,40,24
1649799899504,COGS 172,A01,083984,Provenzano; Emily Kara,25,0,30,5
1649799905529,COGS 177,A00,083368,Staff,16,0,30,14
1649799911554,COGS 186,A01,083986,Staff,28,0,40,12
1649799917581,COGS 187A,A01,083988,Boyle; Mary E. T.,51,0,60,9
1649799923608,CSE 8A,A50,084003,Miranda; Gregory Joseph,11,0,15,4
1649799929635,CSE 11,A01,084005,Miranda; Gregory Joseph,51,0,55,4
1649799935657,CSE 20,A01,084007,Staff,17,0,20,3
1649799941681,CSE 21,A01,084009,Staff,44,0,50,6
1649799947706,CSE 30,A01,083370,Cao; Yingjun,29,0,40,11
1649799953731,CSE 100,A01,083372,Cao; Yingjun,33,0,40,7
1649799959761,CSE 101,A01,084011,Staff,17,0,40,23
1649799965793,CSE 141,A01,083374,Eldon; John,22,0,75,53
1649799971816,CSE 141L,A01,083376,Eldon; John,24,0,75,51
1649799977851,CSE 175,A01,084013,Kumar; Rakesh,25,0,25,0
1649799983880,CSE 190,A00,092508,Staff,15,0,15,0
1649799989919,ECE 5,A01,084049,Morris; Karcher William,18,0,20,2
1649799995951,ECE 100,A01,084051,Baghdadchi; Saharnaz,17,0,20,3
1649799995951,ECE 100,A02,091916,Baghdadchi; Saharnaz,19,0,20,1
1649800001977,ECE 101,A01,084053,Baghdadchi; Saharnaz,30,0,37,7
1649800001977,ECE 101,A02,084054,Baghdadchi; Saharnaz,37,0,37,0
1649800007999,ECE 107,A01,083390,Staff,35,0,40,5
1649800014032,ECE 148,A01,084056,Silberman; Jack,8,0,12,4
1649800020059,ECE 180,A00,083391,Abi Samra; Nicholas Camill,27,0,30,3
1649800020059,ECE 180,B00,083392,Abi Samra; Nicholas Camill,26,0,30,4
1649800026082,MATH 10B,A01,084110,Staff,24,0,30,6
1649800026082,MATH 10B,A02,084111,Staff,29,0,30,1
1649800026082,MATH 10B,A03,084112,Staff,30,0,30,0
1649800032106,MATH 10C,A01,083443,Staff,25,0,30,5
1649800032106,MATH 10C,A02,083444,Staff,26,0,30,4
1649800032106,MATH 10C,B01,084114,Staff,27,0,30,3
1649800032106,MATH 10C,B02,084115,Staff,30,0,30,0
1649800038132,MATH 18,A01,084117,Harel; Guershon,28,0,30,2
1649800038132,MATH 18,A02,084119,Harel; Guershon,29,0,30,1
1649800038132,MATH 18,A03,084120,Harel; Guershon,30,0,30,0
1649800038132,MATH 18,A04,084121,Harel; Guershon,30,0,30,0
1649800044169,MATH 20B,A01,084124,Um; Ko Woon,34,0,35,1
1649800044169,MATH 20B,B01,084126,Um; Ko Woon,35,0,35,0
1649800050210,MATH 20C,A01,083446,Hammock; Frances H,27,0,30,3
1649800050210,MATH 20C,A02,083447,Hammock; Frances H,30,0,30,0
1649800050210,MATH 20C,A03,083448,Hammock; Frances H,30,0,30,0
1649800050210,MATH 20C,A04,083449,Hammock; Frances H,30,0,30,0
1649800050210,MATH 20C,B01,083451,Hammock; Frances H,30,0,30,0
1649800050210,MATH 20C,B02,083452,Hammock; Frances H,30,0,30,0
1649800050210,MATH 20C,B03,083453,Hammock; Frances H,30,0,30,0
1649800050210,MATH 20C,B04,083454,Hammock; Frances H,30,0,30,0
1649800056232,MATH 20D,A01,084128,Staff,30,0,30,0
1649800056232,MATH 20D,A02,084129,Staff,30,0,30,0
1649800056232,MATH 20D,A03,084130,Staff,29,0,30,1
1649800056232,MATH 20D,B01,084133,Staff,29,0,30,1
1649800056232,MATH 20D,B02,084134,Staff,30,0,30,0
1649800056232,MATH 20D,B03,084135,Staff,30,0,30,0
1649800062256,MATH 20E,A01,084138,Staff,30,0,30,0
1649800062256,MATH 20E,A02,084139,Staff,29,0,30,1
1649800062256,MATH 20E,A03,084140,Staff,30,0,30,0
1649800062256,MATH 20E,A04,084141,Staff,30,0,30,0
1649800068283,MATH 102,A01,084143,Harel; Guershon,25,0,30,5
1649800068283,MATH 102,A02,084144,Harel; Guershon,29,0,30,1
1649800074309,MATH 103B,A01,083456,Staff,15,0,30,15
1649800074309,MATH 103B,A02,083457,Staff,26,0,30,4
1649800080336,MATH 109,A01,084146,Salehi Golsefidy; Alireza,30,0,30,0
1649800080336,MATH 109,A02,084147,Salehi Golsefidy; Alireza,27,0,30,3
1649800086359,MATH 120A,A01,085445,Eggers; John Dietrich,31,0,35,4
1649800086359,MATH 120A,A02,085446,Eggers; John Dietrich,33,0,35,2
1649800092390,MATH 142B,A01,084149,Verstraete; Jacques Allan,22,0,30,8
1649800092390,MATH 142B,A02,084150,Verstraete; Jacques Allan,26,0,30,4
1649800098426,MATH 170A,A01,083459,Nie; Jiawang,16,0,30,14
1649800098426,MATH 170A,A02,083460,Nie; Jiawang,27,0,30,3
1649800098426,MATH 170A,A03,083461,Nie; Jiawang,29,0,30,1
1649800104452,MATH 193B,A01,083463,Staff,22,0,30,8
1649800104452,MATH 193B,A02,083464,Staff,25,0,30,5
1649800104452,MATH 193B,A03,083465,Staff,30,0,30,0
1649800110517,COGS 2,A01,083966,Boyle; Mary E. T.,28,0,30,2
1649800116544,COGS 9,A01,083968,Staff,58,0,60,2
1649800122568,COGS 14B,A01,083970,Staff,49,0,50,1
1649800128591,COGS 100,A01,083972,Staff,52,0,60,8
1649800140645,COGS 101C,A01,083976,Staff,26,0,30,4
1649800146677,COGS 102A,A01,083978,Johnson; Christine M.,28,0,30,2
1649800152797,COGS 107B,A01,083980,Staff,45,0,50,5
1649800158826,COGS 115,A01,083982,Staff,24,0,30,6
1649800164859,COGS 118B,A01,083367,Staff,15,0,40,25
1649800170894,COGS 172,A01,083984,Provenzano; Emily Kara,25,0,30,5
1649800176918,COGS 177,A00,083368,Staff,16,0,30,14
1649800182944,COGS 186,A01,083986,Staff,28,0,40,12
1649800188967,COGS 187A,A01,083988,Boyle; Mary E. T.,51,0,60,9
1649800194989,CSE 8A,A50,084003,Miranda; Gregory Joseph,11,0,15,4
1649800201033,CSE 11,A01,084005,Miranda; Gregory Joseph,51,0,55,4
1649800207061,CSE 20,A01,084007,Staff,17,0,20,3
1649800213089,CSE 21,A01,084009,Staff,44,0,50,6
1649800219115,CSE 30,A01,083370,Cao; Yingjun,29,0,40,11
1649800225142,CSE 100,A01,083372,Cao; Yingjun,33,0,40,7
1649800231166,CSE 101,A01,084011,Staff,17,0,40,23
1649800237190,CSE 141,A01,083374,Eldon; John,22,0,75,53
1649800243222,CSE 141L,A01,083376,Eldon; John,24,0,75,51
1649800249248,CSE 175,A01,084013,Kumar; Rakesh,25,0,25,0
1649800255271,CSE 190,A00,092508,Staff,15,0,15,0
1649800261297,ECE 5,A01,084049,Morris; Karcher William,18,0,20,2
1649800267334,ECE 100,A01,084051,Baghdadchi; Saharnaz,17,0,20,3
1649800267334,ECE 100,A02,091916,Baghdadchi; Saharnaz,19,0,20,1
1649800273359,ECE 101,A01,084053,Baghdadchi; Saharnaz,30,0,37,7
1649800273359,ECE 101,A02,084054,Baghdadchi; Saharnaz,37,0,37,0
1649800279388,ECE 107,A01,083390,Staff,35,0,40,5
1649800285412,ECE 148,A01,084056,Silberman; Jack,8,0,12,4
1649800291446,ECE 180,A00,083391,Abi Samra; Nicholas Camill,27,0,30,3
1649800291446,ECE 180,B00,083392,Abi Samra; Nicholas Camill,26,0,30,4
1649800297470,MATH 10B,A01,084110,Staff,24,0,30,6
1649800297470,MATH 10B,A02,084111,Staff,29,0,30,1
1649800297470,MATH 10B,A03,084112,Staff,30,0,30,0
1649800303495,MATH 10C,A01,083443,Staff,25,0,30,5
1649800303495,MATH 10C,A02,083444,Staff,26,0,30,4
1649800303495,MATH 10C,B01,084114,Staff,27,0,30,3
1649800303495,MATH 10C,B02,084115,Staff,30,0,30,0
1649800309518,MATH 18,A01,084117,Harel; Guershon,28,0,30,2
1649800309518,MATH 18,A02,084119,Harel; Guershon,29,0,30,1
1649800309518,MATH 18,A03,084120,Harel; Guershon,30,0,30,0
1649800309518,MATH 18,A04,084121,Harel; Guershon,30,0,30,0
1649800315545,MATH 20B,A01,084124,Um; Ko Woon,34,0,35,1
1649800315545,MATH 20B,B01,084126,Um; Ko Woon,35,0,35,0
1649800321575,MATH 20C,A01,083446,Hammock; Frances H,27,0,30,3
1649800321575,MATH 20C,A02,083447,Hammock; Frances H,30,0,30,0
1649800321575,MATH 20C,A03,083448,Hammock; Frances H,30,0,30,0
1649800321575,MATH 20C,A04,083449,Hammock; Frances H,30,0,30,0
1649800321575,MATH 20C,B01,083451,Hammock; Frances H,30,0,30,0
1649800321575,MATH 20C,B02,083452,Hammock; Frances H,30,0,30,0
1649800321575,MATH 20C,B03,083453,Hammock; Frances H,30,0,30,0
1649800321575,MATH 20C,B04,083454,Hammock; Frances H,30,0,30,0
1649800327610,MATH 20D,A01,084128,Staff,30,0,30,0
1649800327610,MATH 20D,A02,084129,Staff,30,0,30,0
1649800327610,MATH 20D,A03,084130,Staff,29,0,30,1
1649800327610,MATH 20D,B01,084133,Staff,29,0,30,1
1649800327610,MATH 20D,B02,084134,Staff,30,0,30,0
1649800327610,MATH 20D,B03,084135,Staff,30,0,30,0
1649800333636,MATH 20E,A01,084138,Staff,30,0,30,0
1649800333636,MATH 20E,A02,084139,Staff,29,0,30,1
1649800333636,MATH 20E,A03,084140,Staff,30,0,30,0
1649800333636,MATH 20E,A04,084141,Staff,30,0,30,0
1649800339668,MATH 102,A01,084143,Harel; Guershon,25,0,30,5
1649800339668,MATH 102,A02,084144,Harel; Guershon,29,0,30,1
1649800345696,MATH 103B,A01,083456,Staff,15,0,30,15
1649800345696,MATH 103B,A02,083457,Staff,26,0,30,4
1649800351720,MATH 109,A01,084146,Salehi Golsefidy; Alireza,30,0,30,0
1649800351720,MATH 109,A02,084147,Salehi Golsefidy; Alireza,27,0,30,3
1649800357744,MATH 120A,A01,085445,Eggers; John Dietrich,31,0,35,4
1649800357744,MATH 120A,A02,085446,Eggers; John Dietrich,33,0,35,2
1649800363777,MATH 142B,A01,084149,Verstraete; Jacques Allan,22,0,30,8
1649800363777,MATH 142B,A02,084150,Verstraete; Jacques Allan,26,0,30,4
1649800369800,MATH 170A,A01,083459,Nie; Jiawang,16,0,30,14
1649800369800,MATH 170A,A02,083460,Nie; Jiawang,27,0,30,3
1649800369800,MATH 170A,A03,083461,Nie; Jiawang,29,0,30,1
1649800375843,MATH 193B,A01,083463,Staff,22,0,30,8
1649800375843,MATH 193B,A02,083464,Staff,25,0,30,5
1649800375843,MATH 193B,A03,083465,Staff,30,0,30,0
1649800381893,COGS 2,A01,083966,Boyle; Mary E. T.,28,0,30,2
1649800387925,COGS 9,A01,083968,Staff,58,0,60,2
1649800393961,COGS 14B,A01,083970,Staff,49,0,50,1
1649800399996,COGS 100,A01,083972,Staff,52,0,60,8
1649800412055,COGS 101C,A01,083976,Staff,26,0,30,4
1649800418087,COGS 102A,A01,083978,Johnson; Christine M.,28,0,30,2
1649800424120,COGS 107B,A01,083980,Staff,45,0,50,5
1649800430147,COGS 115,A01,083982,Staff,24,0,30,6
1649800436169,COGS 118B,A01,083367,Staff,15,0,40,25
1649800442193,COGS 172,A01,083984,Provenzano; Emily Kara,25,0,30,5
1649800448220,COGS 177,A00,083368,Staff,16,0,30,14
1649800454262,COGS 186,A01,083986,Staff,28,0,40,12
1649800460285,COGS 187A,A01,083988,Boyle; Mary E. T.,50,0,60,10
1649800466308,CSE 8A,A50,084003,Miranda; Gregory Joseph,11,0,15,4
1649800472330,CSE 11,A01,084005,Miranda; Gregory Joseph,51,0,55,4
1649800478365,CSE 20,A01,084007,Staff,17,0,20,3
1649800484401,CSE 21,A01,084009,Staff,44,0,50,6
1649800490431,CSE 30,A01,083370,Cao; Yingjun,29,0,40,11
1649800496460,CSE 100,A01,083372,Cao; Yingjun,33,0,40,7
1649800502485,CSE 101,A01,084011,Staff,17,0,40,23
1649800508508,CSE 141,A01,083374,Eldon; John,22,0,75,53
1649800514531,CSE 141L,A01,083376,Eldon; John,23,0,75,52
1649800520555,CSE 175,A01,084013,Kumar; Rakesh,25,0,25,0
1649800526588,CSE 190,A00,092508,Staff,15,0,15,0
1649800532612,ECE 5,A01,084049,Morris; Karcher William,18,0,20,2
1649800538637,ECE 100,A01,084051,Baghdadchi; Saharnaz,17,0,20,3
1649800538637,ECE 100,A02,091916,Baghdadchi; Saharnaz,19,0,20,1
1649800544669,ECE 101,A01,084053,Baghdadchi; Saharnaz,30,0,37,7
1649800544669,ECE 101,A02,084054,Baghdadchi; Saharnaz,37,0,37,0
1649800550697,ECE 107,A01,083390,Staff,35,0,40,5
1649800556727,ECE 148,A01,084056,Silberman; Jack,8,0,12,4
1649800562750,ECE 180,A00,083391,Abi Samra; Nicholas Camill,27,0,30,3
1649800562750,ECE 180,B00,083392,Abi Samra; Nicholas Camill,26,0,30,4
1649800568787,MATH 10B,A01,084110,Staff,24,0,30,6
1649800568787,MATH 10B,A02,084111,Staff,29,0,30,1
1649800568787,MATH 10B,A03,084112,Staff,30,0,30,0
1649800574810,MATH 10C,A01,083443,Staff,25,0,30,5
1649800574810,MATH 10C,A02,083444,Staff,26,0,30,4
1649800574810,MATH 10C,B01,084114,Staff,27,0,30,3
1649800574810,MATH 10C,B02,084115,Staff,30,0,30,0
1649800580845,MATH 18,A01,084117,Harel; Guershon,28,0,30,2
1649800580845,MATH 18,A02,084119,Harel; Guershon,29,0,30,1
1649800580845,MATH 18,A03,084120,Harel; Guershon,30,0,30,0
1649800580845,MATH 18,A04,084121,Harel; Guershon,30,0,30,0
1649800586873,MATH 20B,A01,084124,Um; Ko Woon,34,0,35,1
1649800586873,MATH 20B,B01,084126,Um; Ko Woon,35,0,35,0
1649800592900,MATH 20C,A01,083446,Hammock; Frances H,27,0,30,3
1649800592900,MATH 20C,A02,083447,Hammock; Frances H,30,0,30,0
1649800592900,MATH 20C,A03,083448,Hammock; Frances H,30,0,30,0
1649800592900,MATH 20C,A04,083449,Hammock; Frances H,30,0,30,0
1649800592900,MATH 20C,B01,083451,Hammock; Frances H,30,0,30,0
1649800592900,MATH 20C,B02,083452,Hammock; Frances H,30,0,30,0
1649800592900,MATH 20C,B03,083453,Hammock; Frances H,30,0,30,0
1649800592900,MATH 20C,B04,083454,Hammock; Frances H,30,0,30,0
1649800598924,MATH 20D,A01,084128,Staff,30,0,30,0
1649800598924,MATH 20D,A02,084129,Staff,30,0,30,0
1649800598924,MATH 20D,A03,084130,Staff,29,0,30,1
1649800598924,MATH 20D,B01,084133,Staff,29,0,30,1
1649800598924,MATH 20D,B02,084134,Staff,30,0,30,0
1649800598924,MATH 20D,B03,084135,Staff,30,0,30,0
1649800604947,MATH 20E,A01,084138,Staff,30,0,30,0
1649800604947,MATH 20E,A02,084139,Staff,29,0,30,1
1649800604947,MATH 20E,A03,084140,Staff,30,0,30,0
1649800604947,MATH 20E,A04,084141,Staff,30,0,30,0
1649800610977,MATH 102,A01,084143,Harel; Guershon,25,0,30,5
1649800610977,MATH 102,A02,084144,Harel; Guershon,29,0,30,1
1649800617014,MATH 103B,A01,083456,Staff,15,0,30,15
1649800617014,MATH 103B,A02,083457,Staff,26,0,30,4
1649800623053,MATH 109,A01,084146,Salehi Golsefidy; Alireza,30,0,30,0
1649800623053,MATH 109,A02,084147,Salehi Golsefidy; Alireza,27,0,30,3
1649800629095,MATH 120A,A01,085445,Eggers; John Dietrich,31,0,35,4
1649800629095,MATH 120A,A02,085446,Eggers; John Dietrich,33,0,35,2
1649800635117,MATH 142B,A01,084149,Verstraete; Jacques Allan,22,0,30,8
1649800635117,MATH 142B,A02,084150,Verstraete; Jacques Allan,26,0,30,4
1649800641145,MATH 170A,A01,083459,Nie; Jiawang,16,0,30,14
1649800641145,MATH 170A,A02,083460,Nie; Jiawang,27,0,30,3
1649800641145,MATH 170A,A03,083461,Nie; Jiawang,29,0,30,1
1649800647167,MATH 193B,A01,083463,Staff,22,0,30,8
1649800647167,MATH 193B,A02,083464,Staff,25,0,30,5
1649800647167,MATH 193B,A03,083465,Staff,30,0,30,0
1649800653219,COGS 2,A01,083966,Boyle; Mary E. T.,28,0,30,2
1649800659248,COGS 9,A01,083968,Staff,58,0,60,2
1649800665270,COGS 14B,A01,083970,Staff,49,0,50,1
1649800671302,COGS 100,A01,083972,Staff,52,0,60,8
1649800683361,COGS 101C,A01,083976,Staff,26,0,30,4
1649800689389,COGS 102A,A01,083978,Johnson; Christine M.,28,0,30,2
1649800695425,COGS 107B,A01,083980,Staff,45,0,50,5
1649800701455,COGS 115,A01,083982,Staff,24,0,30,6
1649800707479,COGS 118B,A01,083367,Staff,15,0,40,25
1649800713508,COGS 172,A01,083984,Provenzano; Emily Kara,25,0,30,5
1649800719530,COGS 177,A00,083368,Staff,16,0,30,14
1649800725563,COGS 186,A01,083986,Staff,28,0,40,12
1649800731593,COGS 187A,A01,083988,Boyle; Mary E. T.,50,0,60,10
1649800737628,CSE 8A,A50,084003,Miranda; Gregory Joseph,11,0,15,4
1649800743656,CSE 11,A01,084005,Miranda; Gregory Joseph,51,0,55,4
1649800749777,CSE 20,A01,084007,Staff,17,0,20,3
1649800755805,CSE 21,A01,084009,Staff,44,0,50,6
1649800761830,CSE 30,A01,083370,Cao; Yingjun,29,0,40,11
1649800767872,CSE 100,A01,083372,Cao; Yingjun,33,0,40,7
1649800773904,CSE 101,A01,084011,Staff,17,0,40,23
1649800779941,CSE 141,A01,083374,Eldon; John,22,0,75,53
1649800785974,CSE 141L,A01,083376,Eldon; John,23,0,75,52
1649800791997,CSE 175,A01,084013,Kumar; Rakesh,25,0,25,0
1649800798022,CSE 190,A00,092508,Staff,15,0,15,0
1649800804049,ECE 5,A01,084049,Morris; Karcher William,18,0,20,2
1649800810085,ECE 100,A01,084051,Baghdadchi; Saharnaz,17,0,20,3
1649800810085,ECE 100,A02,091916,Baghdadchi; Saharnaz,19,0,20,1
1649800816112,ECE 101,A01,084053,Baghdadchi; Saharnaz,30,0,37,7
1649800816112,ECE 101,A02,084054,Baghdadchi; Saharnaz,37,0,37,0
1649800822149,ECE 107,A01,083390,Staff,35,0,40,5
1649800828174,ECE 148,A01,084056,Silberman; Jack,8,0,12,4
1649800834202,ECE 180,A00,083391,Abi Samra; Nicholas Camill,27,0,30,3
1649800834202,ECE 180,B00,083392,Abi Samra; Nicholas Camill,26,0,30,4
1649800840234,MATH 10B,A01,084110,Staff,24,0,30,6
1649800840234,MATH 10B,A02,084111,Staff,29,0,30,1
1649800840234,MATH 10B,A03,084112,Staff,30,0,30,0
1649800846272,MATH 10C,A01,083443,Staff,25,0,30,5
1649800846272,MATH 10C,A02,083444,Staff,26,0,30,4
1649800846272,MATH 10C,B01,084114,Staff,27,0,30,3
1649800846272,MATH 10C,B02,084115,Staff,30,0,30,0
1649800852301,MATH 18,A01,084117,Harel; Guershon,28,0,30,2
1649800852301,MATH 18,A02,084119,Harel; Guershon,29,0,30,1
1649800852301,MATH 18,A03,084120,Harel; Guershon,30,0,30,0
1649800852301,MATH 18,A04,084121,Harel; Guershon,30,0,30,0
1649800858326,MATH 20B,A01,084124,Um; Ko Woon,34,0,35,1
1649800858326,MATH 20B,B01,084126,Um; Ko Woon,35,0,35,0
1649800864360,MATH 20C,A01,083446,Hammock; Frances H,27,0,30,3
1649800864360,MATH 20C,A02,083447,Hammock; Frances H,30,0,30,0
1649800864360,MATH 20C,A03,083448,Hammock; Frances H,30,0,30,0
1649800864360,MATH 20C,A04,083449,Hammock; Frances H,30,0,30,0
1649800864360,MATH 20C,B01,083451,Hammock; Frances H,30,0,30,0
1649800864360,MATH 20C,B02,083452,Hammock; Frances H,30,0,30,0
1649800864360,MATH 20C,B03,083453,Hammock; Frances H,30,0,30,0
1649800864360,MATH 20C,B04,083454,Hammock; Frances H,30,0,30,0
1649800870404,MATH 20D,A01,084128,Staff,30,0,30,0
1649800870404,MATH 20D,A02,084129,Staff,30,0,30,0
1649800870404,MATH 20D,A03,084130,Staff,29,0,30,1
1649800870404,MATH 20D,B01,084133,Staff,29,0,30,1
1649800870404,MATH 20D,B02,084134,Staff,30,0,30,0
1649800870404,MATH 20D,B03,084135,Staff,30,0,30,0
1649800876429,MATH 20E,A01,084138,Staff,30,0,30,0
1649800876429,MATH 20E,A02,084139,Staff,29,0,30,1
1649800876429,MATH 20E,A03,084140,Staff,30,0,30,0
1649800876429,MATH 20E,A04,084141,Staff,30,0,30,0
1649800882456,MATH 102,A01,084143,Harel; Guershon,25,0,30,5
1649800882456,MATH 102,A02,084144,Harel; Guershon,29,0,30,1
1649800888491,MATH 103B,A01,083456,Staff,15,0,30,15
1649800888491,MATH 103B,A02,083457,Staff,26,0,30,4
1649800894516,MATH 109,A01,084146,Salehi Golsefidy; Alireza,30,0,30,0
1649800894516,MATH 109,A02,084147,Salehi Golsefidy; Alireza,27,0,30,3
1649800900540,MATH 120A,A01,085445,Eggers; John Dietrich,31,0,35,4
1649800900540,MATH 120A,A02,085446,Eggers; John Dietrich,33,0,35,2
1649800906587,MATH 142B,A01,084149,Verstraete; Jacques Allan,22,0,30,8
1649800906587,MATH 142B,A02,084150,Verstraete; Jacques Allan,26,0,30,4
1649800912610,MATH 170A,A01,083459,Nie; Jiawang,16,0,30,14
1649800912610,MATH 170A,A02,083460,Nie; Jiawang,27,0,30,3
1649800912610,MATH 170A,A03,083461,Nie; Jiawang,29,0,30,1
1649800918643,MATH 193B,A01,083463,Staff,22,0,30,8
1649800918643,MATH 193B,A02,083464,Staff,25,0,30,5
1649800918643,MATH 193B,A03,083465,Staff,30,0,30,0
1649800924698,COGS 2,A01,083966,Boyle; Mary E. T.,28,0,30,2
1649800930726,COGS 9,A01,083968,Staff,58,0,60,2
1649800936764,COGS 14B,A01,083970,Staff,49,0,50,1
1649800942813,COGS 100,A01,083972,Staff,52,0,60,8
1649800954872,COGS 101C,A01,083976,Staff,26,0,30,4
1649800960906,COGS 102A,A01,083978,Johnson; Christine M.,28,0,30,2
1649800966932,COGS 107B,A01,083980,Staff,45,0,50,5
1649800972959,COGS 115,A01,083982,Staff,24,0,30,6
1649800978987,COGS 118B,A01,083367,Staff,15,0,40,25
1649800985014,COGS 172,A01,083984,Provenzano; Emily Kara,25,0,30,5
1649800991041,COGS 177,A00,083368,Staff,16,0,30,14
1649800997067,COGS 186,A01,083986,Staff,28,0,40,12
1649801003102,COGS 187A,A01,083988,Boyle; Mary E. T.,50,0,60,10
1649801009130,CSE 8A,A50,084003,Miranda; Gregory Joseph,11,0,15,4
1649801015165,CSE 11,A01,084005,Miranda; Gregory Joseph,51,0,55,4
1649801021194,CSE 20,A01,084007,Staff,17,0,20,3
1649801027218,CSE 21,A01,084009,Staff,44,0,50,6
1649801033248,CSE 30,A01,083370,Cao; Yingjun,28,0,40,12
1649801039271,CSE 100,A01,083372,Cao; Yingjun,33,0,40,7
1649801045294,CSE 101,A01,084011,Staff,15,0,40,25
1649801051330,CSE 141,A01,083374,Eldon; John,21,0,75,54
1649801057356,CSE 141L,A01,083376,Eldon; John,22,0,75,53
1649801063381,CSE 175,A01,084013,Kumar; Rakesh,25,0,25,0
1649801069418,CSE 190,A00,092508,Staff,15,0,15,0
1649801075445,ECE 5,A01,084049,Morris; Karcher William,18,0,20,2
1649801081483,ECE 100,A01,084051,Baghdadchi; Saharnaz,17,0,20,3
1649801081483,ECE 100,A02,091916,Baghdadchi; Saharnaz,19,0,20,1
1649801087510,ECE 101,A01,084053,Baghdadchi; Saharnaz,30,0,37,7
1649801087510,ECE 101,A02,084054,Baghdadchi; Saharnaz,37,0,37,0
1649801093533,ECE 107,A01,083390,Staff,35,0,40,5
1649801099559,ECE 148,A01,084056,Silberman; Jack,8,0,12,4
1649801105583,ECE 180,A00,083391,Abi Samra; Nicholas Camill,27,0,30,3
1649801105583,ECE 180,B00,083392,Abi Samra; Nicholas Camill,26,0,30,4
1649801111608,MATH 10B,A01,084110,Staff,24,0,30,6
1649801111608,MATH 10B,A02,084111,Staff,29,0,30,1
1649801111608,MATH 10B,A03,084112,Staff,30,0,30,0
1649801117642,MATH 10C,A01,083443,Staff,25,0,30,5
1649801117642,MATH 10C,A02,083444,Staff,26,0,30,4
1649801117642,MATH 10C,B01,084114,Staff,27,0,30,3
1649801117642,MATH 10C,B02,084115,Staff,30,0,30,0
1649801123672,MATH 18,A01,084117,Harel; Guershon,28,0,30,2
1649801123672,MATH 18,A02,084119,Harel; Guershon,29,0,30,1
1649801123672,MATH 18,A03,084120,Harel; Guershon,30,0,30,0
1649801123672,MATH 18,A04,084121,Harel; Guershon,30,0,30,0
1649801129701,MATH 20B,A01,084124,Um; Ko Woon,34,0,35,1
1649801129701,MATH 20B,B01,084126,Um; Ko Woon,35,0,35,0
1649801135737,MATH 20C,A01,083446,Hammock; Frances H,27,0,30,3
1649801135737,MATH 20C,A02,083447,Hammock; Frances H,30,0,30,0
1649801135737,MATH 20C,A03,083448,Hammock; Frances H,30,0,30,0
1649801135737,MATH 20C,A04,083449,Hammock; Frances H,30,0,30,0
1649801135737,MATH 20C,B01,083451,Hammock; Frances H,30,0,30,0
1649801135737,MATH 20C,B02,083452,Hammock; Frances H,30,0,30,0
1649801135737,MATH 20C,B03,083453,Hammock; Frances H,30,0,30,0
1649801135737,MATH 20C,B04,083454,Hammock; Frances H,30,0,30,0
1649801141766,MATH 20D,A01,084128,Staff,30,0,30,0
1649801141766,MATH 20D,A02,084129,Staff,30,0,30,0
1649801141766,MATH 20D,A03,084130,Staff,29,0,30,1
1649801141766,MATH 20D,B01,084133,Staff,29,0,30,1
1649801141766,MATH 20D,B02,084134,Staff,30,0,30,0
1649801141766,MATH 20D,B03,084135,Staff,30,0,30,0
1649801147797,MATH 20E,A01,084138,Staff,30,0,30,0
1649801147797,MATH 20E,A02,084139,Staff,29,0,30,1
1649801147797,MATH 20E,A03,084140,Staff,30,0,30,0
1649801147797,MATH 20E,A04,084141,Staff,30,0,30,0
1649801153825,MATH 102,A01,084143,Harel; Guershon,25,0,30,5
1649801153825,MATH 102,A02,084144,Harel; Guershon,29,0,30,1
1649801159848,MATH 103B,A01,083456,Staff,15,0,30,15
1649801159848,MATH 103B,A02,083457,Staff,26,0,30,4
1649801165873,MATH 109,A01,084146,Salehi Golsefidy; Alireza,30,0,30,0
1649801165873,MATH 109,A02,084147,Salehi Golsefidy; Alireza,27,0,30,3
1649801171896,MATH 120A,A01,085445,Eggers; John Dietrich,31,0,35,4
1649801171896,MATH 120A,A02,085446,Eggers; John Dietrich,33,0,35,2
1649801177920,MATH 142B,A01,084149,Verstraete; Jacques Allan,22,0,30,8
1649801177920,MATH 142B,A02,084150,Verstraete; Jacques Allan,26,0,30,4
1649801183943,MATH 170A,A01,083459,Nie; Jiawang,16,0,30,14
1649801183943,MATH 170A,A02,083460,Nie; Jiawang,27,0,30,3
1649801183943,MATH 170A,A03,083461,Nie; Jiawang,29,0,30,1
1649801189981,MATH 193B,A01,083463,Staff,22,0,30,8
1649801189981,MATH 193B,A02,083464,Staff,25,0,30,5
1649801189981,MATH 193B,A03,083465,Staff,30,0,30,0
1649801196042,COGS 2,A01,083966,Boyle; Mary E. T.,28,0,30,2
1649801202079,COGS 9,A01,083968,Staff,58,0,60,2
1649801208115,COGS 14B,A01,083970,Staff,49,0,50,1
1649801214138,COGS 100,A01,083972,Staff,52,0,60,8
1649801226189,COGS 101C,A01,083976,Staff,26,0,30,4
1649801232218,COGS 102A,A01,083978,Johnson; Christine M.,28,0,30,2
1649801238245,COGS 107B,A01,083980,Staff,45,0,50,5
1649801244282,COGS 115,A01,083982,Staff,24,0,30,6
1649801250309,COGS 118B,A01,083367,Staff,15,0,40,25
1649801256334,COGS 172,A01,083984,Provenzano; Emily Kara,25,0,30,5
1649801262367,COGS 177,A00,083368,Staff,16,0,30,14
1649801268403,COGS 186,A01,083986,Staff,28,0,40,12
1649801274431,COGS 187A,A01,083988,Boyle; Mary E. T.,50,0,60,10
1649801280466,CSE 8A,A50,084003,Miranda; Gregory Joseph,11,0,15,4
1649801286490,CSE 11,A01,084005,Miranda; Gregory Joseph,51,0,55,4
1649801292515,CSE 20,A01,084007,Staff,17,0,20,3
1649801298538,CSE 21,A01,084009,Staff,43,0,50,7
1649801304561,CSE 30,A01,083370,Cao; Yingjun,28,0,40,12
1649801310585,CSE 100,A01,083372,Cao; Yingjun,33,0,40,7
1649801316620,CSE 101,A01,084011,Staff,15,0,40,25
1649801322658,CSE 141,A01,083374,Eldon; John,21,0,75,54
1649801328697,CSE 141L,A01,083376,Eldon; John,22,0,75,53
1649801334724,CSE 175,A01,084013,Kumar; Rakesh,25,0,25,0
1649801340747,CSE 190,A00,092508,Staff,15,0,15,0
1649801346849,ECE 5,A01,084049,Morris; Karcher William,18,0,20,2
1649801352883,ECE 100,A01,084051,Baghdadchi; Saharnaz,17,0,20,3
1649801352883,ECE 100,A02,091916,Baghdadchi; Saharnaz,19,0,20,1
1649801358912,ECE 101,A01,084053,Baghdadchi; Saharnaz,30,0,37,7
1649801358912,ECE 101,A02,084054,Baghdadchi; Saharnaz,37,0,37,0
1649801364955,ECE 107,A01,083390,Staff,35,0,40,5
1649801370980,ECE 148,A01,084056,Silberman; Jack,8,0,12,4
1649801377004,ECE 180,A00,083391,Abi Samra; Nicholas Camill,27,0,30,3
1649801377004,ECE 180,B00,083392,Abi Samra; Nicholas Camill,26,0,30,4
1649801383029,MATH 10B,A01,084110,Staff,24,0,30,6
1649801383029,MATH 10B,A02,084111,Staff,29,0,30,1
1649801383029,MATH 10B,A03,084112,Staff,30,0,30,0
1649801389052,MATH 10C,A01,083443,Staff,25,0,30,5
1649801389052,MATH 10C,A02,083444,Staff,26,0,30,4
1649801389052,MATH 10C,B01,084114,Staff,27,0,30,3
1649801389052,MATH 10C,B02,084115,Staff,30,0,30,0
1649801395084,MATH 18,A01,084117,Harel; Guershon,28,0,30,2
1649801395084,MATH 18,A02,084119,Harel; Guershon,29,0,30,1
1649801395084,MATH 18,A03,084120,Harel; Guershon,30,0,30,0
1649801395084,MATH 18,A04,084121,Harel; Guershon,30,0,30,0
1649801401112,MATH 20B,A01,084124,Um; Ko Woon,34,0,35,1
1649801401112,MATH 20B,B01,084126,Um; Ko Woon,35,0,35,0
1649801407154,MATH 20C,A01,083446,Hammock; Frances H,27,0,30,3
1649801407154,MATH 20C,A02,083447,Hammock; Frances H,30,0,30,0
1649801407154,MATH 20C,A03,083448,Hammock; Frances H,30,0,30,0
1649801407154,MATH 20C,A04,083449,Hammock; Frances H,30,0,30,0
1649801407154,MATH 20C,B01,083451,Hammock; Frances H,30,0,30,0
1649801407154,MATH 20C,B02,083452,Hammock; Frances H,30,0,30,0
1649801407154,MATH 20C,B03,083453,Hammock; Frances H,30,0,30,0
1649801407154,MATH 20C,B04,083454,Hammock; Frances H,30,0,30,0
1649801413194,MATH 20D,A01,084128,Staff,30,0,30,0
1649801413194,MATH 20D,A02,084129,Staff,30,0,30,0
1649801413194,MATH 20D,A03,084130,Staff,29,0,30,1
1649801413194,MATH 20D,B01,084133,Staff,29,0,30,1
1649801413194,MATH 20D,B02,084134,Staff,30,0,30,0
1649801413194,MATH 20D,B03,084135,Staff,30,0,30,0
1649801419221,MATH 20E,A01,084138,Staff,30,0,30,0
1649801419221,MATH 20E,A02,084139,Staff,29,0,30,1
1649801419221,MATH 20E,A03,084140,Staff,30,0,30,0
1649801419221,MATH 20E,A04,084141,Staff,30,0,30,0
1649801425251,MATH 102,A01,084143,Harel; Guershon,24,0,30,6
1649801425251,MATH 102,A02,084144,Harel; Guershon,29,0,30,1
1649801431277,MATH 103B,A01,083456,Staff,15,0,30,15
1649801431277,MATH 103B,A02,083457,Staff,26,0,30,4
1649801437313,MATH 109,A01,084146,Salehi Golsefidy; Alireza,30,0,30,0
1649801437313,MATH 109,A02,084147,Salehi Golsefidy; Alireza,27,0,30,3
1649801443341,MATH 120A,A01,085445,Eggers; John Dietrich,31,0,35,4
1649801443341,MATH 120A,A02,085446,Eggers; John Dietrich,33,0,35,2
1649801449374,MATH 142B,A01,084149,Verstraete; Jacques Allan,22,0,30,8
1649801449374,MATH 142B,A02,084150,Verstraete; Jacques Allan,26,0,30,4
1649801455409,MATH 170A,A01,083459,Nie; Jiawang,15,0,30,15
1649801455409,MATH 170A,A02,083460,Nie; Jiawang,27,0,30,3
1649801455409,MATH 170A,A03,083461,Nie; Jiawang,29,0,30,1
1649801461434,MATH 193B,A01,083463,Staff,22,0,30,8
1649801461434,MATH 193B,A02,083464,Staff,25,0,30,5
1649801461434,MATH 193B,A03,083465,Staff,30,0,30,0
1649801467491,COGS 2,A01,083966,Boyle; Mary E. T.,28,0,30,2
1649801473515,COGS 9,A01,083968,Staff,58,0,60,2
1649801479541,COGS 14B,A01,083970,Staff,49,0,50,1
1649801485576,COGS 100,A01,083972,Staff,52,0,60,8
1649801497633,COGS 101C,A01,083976,Staff,26,0,30,4
1649801503659,COGS 102A,A01,083978,Johnson; Christine M.,28,0,30,2
1649801509692,COGS 107B,A01,083980,Staff,45,0,50,5
1649801515717,COGS 115,A01,083982,Staff,24,0,30,6
1649801521750,COGS 118B,A01,083367,Staff,15,0,40,25
1649801527778,COGS 172,A01,083984,Provenzano; Emily Kara,25,0,30,5
1649801533802,COGS 177,A00,083368,Staff,16,0,30,14
1649801539829,COGS 186,A01,083986,Staff,28,0,40,12
1649801545853,COGS 187A,A01,083988,Boyle; Mary E. T.,50,0,60,10
1649801551898,CSE 8A,A50,084003,Miranda; Gregory Joseph,11,0,15,4
1649801557925,CSE 11,A01,084005,Miranda; Gregory Joseph,51,0,55,4
1649801563968,CSE 20,A01,084007,Staff,17,0,20,3
1649801569995,CSE 21,A01,084009,Staff,43,0,50,7
1649801576018,CSE 30,A01,083370,Cao; Yingjun,28,0,40,12
1649801582044,CSE 100,A01,083372,Cao; Yingjun,33,0,40,7
1649801588068,CSE 101,A01,084011,Staff,15,0,40,25
1649801594108,CSE 141,A01,083374,Eldon; John,21,0,75,54
1649801600132,CSE 141L,A01,083376,Eldon; John,22,0,75,53
1649801606156,CSE 175,A01,084013,Kumar; Rakesh,25,0,25,0
1649801612184,CSE 190,A00,092508,Staff,15,0,15,0
1649801618210,ECE 5,A01,084049,Morris; Karcher William,18,0,20,2
1649801624235,ECE 100,A01,084051,Baghdadchi; Saharnaz,17,0,20,3
1649801624235,ECE 100,A02,091916,Baghdadchi; Saharnaz,19,0,20,1
1649801630262,ECE 101,A01,084053,Baghdadchi; Saharnaz,30,0,37,7
1649801630262,ECE 101,A02,084054,Baghdadchi; Saharnaz,37,0,37,0
1649801636286,ECE 107,A01,083390,Staff,35,0,40,5
1649801642311,ECE 148,A01,084056,Silberman; Jack,8,0,12,4
1649801648337,ECE 180,A00,083391,Abi Samra; Nicholas Camill,27,0,30,3
1649801648337,ECE 180,B00,083392,Abi Samra; Nicholas Camill,26,0,30,4
1649801654365,MATH 10B,A01,084110,Staff,24,0,30,6
1649801654365,MATH 10B,A02,084111,Staff,29,0,30,1
1649801654365,MATH 10B,A03,084112,Staff,30,0,30,0
1649801660388,MATH 10C,A01,083443,Staff,25,0,30,5
1649801660388,MATH 10C,A02,083444,Staff,26,0,30,4
1649801660388,MATH 10C,B01,084114,Staff,27,0,30,3
1649801660388,MATH 10C,B02,084115,Staff,30,0,30,0
1649801666416,MATH 18,A01,084117,Harel; Guershon,28,0,30,2
1649801666416,MATH 18,A02,084119,Harel; Guershon,29,0,30,1
1649801666416,MATH 18,A03,084120,Harel; Guershon,30,0,30,0
1649801666416,MATH 18,A04,084121,Harel; Guershon,30,0,30,0
1649801672440,MATH 20B,A01,084124,Um; Ko Woon,34,0,35,1
1649801672440,MATH 20B,B01,084126,Um; Ko Woon,35,0,35,0
1649801678475,MATH 20C,A01,083446,Hammock; Frances H,27,0,30,3
1649801678475,MATH 20C,A02,083447,Hammock; Frances H,30,0,30,0
1649801678475,MATH 20C,A03,083448,Hammock; Frances H,30,0,30,0
1649801678475,MATH 20C,A04,083449,Hammock; Frances H,30,0,30,0
1649801678475,MATH 20C,B01,083451,Hammock; Frances H,30,0,30,0
1649801678475,MATH 20C,B02,083452,Hammock; Frances H,30,0,30,0
1649801678475,MATH 20C,B03,083453,Hammock; Frances H,30,0,30,0
1649801678475,MATH 20C,B04,083454,Hammock; Frances H,30,0,30,0
1649801684500,MATH 20D,A01,084128,Staff,30,0,30,0
1649801684500,MATH 20D,A02,084129,Staff,30,0,30,0
1649801684500,MATH 20D,A03,084130,Staff,29,0,30,1
1649801684500,MATH 20D,B01,084133,Staff,29,0,30,1
1649801684500,MATH 20D,B02,084134,Staff,30,0,30,0
1649801684500,MATH 20D,B03,084135,Staff,30,0,30,0
1649801690523,MATH 20E,A01,084138,Staff,30,0,30,0
1649801690523,MATH 20E,A02,084139,Staff,29,0,30,1
1649801690523,MATH 20E,A03,084140,Staff,30,0,30,0
1649801690523,MATH 20E,A04,084141,Staff,30,0,30,0
1649801696549,MATH 102,A01,084143,Harel; Guershon,25,0,30,5
1649801696549,MATH 102,A02,084144,Harel; Guershon,28,0,30,2
1649801702578,MATH 103B,A01,083456,Staff,15,0,30,15
1649801702578,MATH 103B,A02,083457,Staff,26,0,30,4
1649801708601,MATH 109,A01,084146,Salehi Golsefidy; Alireza,30,0,30,0
1649801708601,MATH 109,A02,084147,Salehi Golsefidy; Alireza,27,0,30,3
1649801714624,MATH 120A,A01,085445,Eggers; John Dietrich,31,0,35,4
1649801714624,MATH 120A,A02,085446,Eggers; John Dietrich,33,0,35,2
1649801720654,MATH 142B,A01,084149,Verstraete; Jacques Allan,22,0,30,8
1649801720654,MATH 142B,A02,084150,Verstraete; Jacques Allan,26,0,30,4
1649801726679,MATH 170A,A01,083459,Nie; Jiawang,16,0,30,14
1649801726679,MATH 170A,A02,083460,Nie; Jiawang,27,0,30,3
1649801726679,MATH 170A,A03,083461,Nie; Jiawang,28,0,30,2
1649801732702,MATH 193B,A01,083463,Staff,22,0,30,8
1649801732702,MATH 193B,A02,083464,Staff,25,0,30,5
1649801732702,MATH 193B,A03,083465,Staff,30,0,30,0
1649801738766,COGS 2,A01,083966,Boyle; Mary E. T.,28,0,30,2
1649801744789,COGS 9,A01,083968,Staff,58,0,60,2
1649801750814,COGS 14B,A01,083970,Staff,49,0,50,1
1649801756842,COGS 100,A01,083972,Staff,52,0,60,8
1649801768902,COGS 101C,A01,083976,Staff,26,0,30,4
1649801774933,COGS 102A,A01,083978,Johnson; Christine M.,28,0,30,2
1649801780960,COGS 107B,A01,083980,Staff,45,0,50,5
1649801786984,COGS 115,A01,083982,Staff,24,0,30,6
1649801793018,COGS 118B,A01,083367,Staff,15,0,40,25
1649801799044,COGS 172,A01,083984,Provenzano; Emily Kara,25,0,30,5
1649801805068,COGS 177,A00,083368,Staff,16,0,30,14
1649801811090,COGS 186,A01,083986,Staff,28,0,40,12
1649801817126,COGS 187A,A01,083988,Boyle; Mary E. T.,50,0,60,10
1649801823154,CSE 8A,A50,084003,Miranda; Gregory Joseph,11,0,15,4
1649801829185,CSE 11,A01,084005,Miranda; Gregory Joseph,51,0,55,4
1649801835220,CSE 20,A01,084007,Staff,17,0,20,3
1649801841246,CSE 21,A01,084009,Staff,43,0,50,7
1649801847278,CSE 30,A01,083370,Cao; Yingjun,28,0,40,12
1649801853305,CSE 100,A01,083372,Cao; Yingjun,33,0,40,7
1649801859335,CSE 101,A01,084011,Staff,15,0,40,25
1649801865373,CSE 141,A01,083374,Eldon; John,21,0,75,54
1649801871400,CSE 141L,A01,083376,Eldon; John,22,0,75,53
1649801877429,CSE 175,A01,084013,Kumar; Rakesh,25,0,25,0
1649801883452,CSE 190,A00,092508,Staff,15,0,15,0
1649801889485,ECE 5,A01,084049,Morris; Karcher William,18,0,20,2
1649801895510,ECE 100,A01,084051,Baghdadchi; Saharnaz,17,0,20,3
1649801895510,ECE 100,A02,091916,Baghdadchi; Saharnaz,19,0,20,1
1649801901533,ECE 101,A01,084053,Baghdadchi; Saharnaz,30,0,37,7
1649801901533,ECE 101,A02,084054,Baghdadchi; Saharnaz,37,0,37,0
1649801907559,ECE 107,A01,083390,Staff,35,0,40,5
1649801913581,ECE 148,A01,084056,Silberman; Jack,8,0,12,4
1649801919605,ECE 180,A00,083391,Abi Samra; Nicholas Camill,27,0,30,3
1649801919605,ECE 180,B00,083392,Abi Samra; Nicholas Camill,26,0,30,4
1649801925644,MATH 10B,A01,084110,Staff,24,0,30,6
1649801925644,MATH 10B,A02,084111,Staff,29,0,30,1
1649801925644,MATH 10B,A03,084112,Staff,30,0,30,0
1649801931668,MATH 10C,A01,083443,Staff,24,0,30,6
1649801931668,MATH 10C,A02,083444,Staff,26,0,30,4
1649801931668,MATH 10C,B01,084114,Staff,27,0,30,3
1649801931668,MATH 10C,B02,084115,Staff,30,0,30,0
1649801937691,MATH 18,A01,084117,Harel; Guershon,28,0,30,2
1649801937691,MATH 18,A02,084119,Harel; Guershon,29,0,30,1
1649801937691,MATH 18,A03,084120,Harel; Guershon,30,0,30,0
1649801937691,MATH 18,A04,084121,Harel; Guershon,30,0,30,0
1649801943826,MATH 20B,A01,084124,Um; Ko Woon,34,0,35,1
1649801943826,MATH 20B,B01,084126,Um; Ko Woon,35,0,35,0
1649801949854,MATH 20C,A01,083446,Hammock; Frances H,27,0,30,3
1649801949854,MATH 20C,A02,083447,Hammock; Frances H,30,0,30,0
1649801949854,MATH 20C,A03,083448,Hammock; Frances H,30,0,30,0
1649801949854,MATH 20C,A04,083449,Hammock; Frances H,30,0,30,0
1649801949854,MATH 20C,B01,083451,Hammock; Frances H,30,0,30,0
1649801949854,MATH 20C,B02,083452,Hammock; Frances H,30,0,30,0
1649801949854,MATH 20C,B03,083453,Hammock; Frances H,30,0,30,0
1649801949854,MATH 20C,B04,083454,Hammock; Frances H,30,0,30,0
1649801955884,MATH 20D,A01,084128,Staff,30,0,30,0
1649801955884,MATH 20D,A02,084129,Staff,30,0,30,0
1649801955884,MATH 20D,A03,084130,Staff,29,0,30,1
1649801955884,MATH 20D,B01,084133,Staff,29,0,30,1
1649801955884,MATH 20D,B02,084134,Staff,30,0,30,0
1649801955884,MATH 20D,B03,084135,Staff,30,0,30,0
1649801961909,MATH 20E,A01,084138,Staff,30,0,30,0
1649801961909,MATH 20E,A02,084139,Staff,29,0,30,1
1649801961909,MATH 20E,A03,084140,Staff,30,0,30,0
1649801961909,MATH 20E,A04,084141,Staff,30,0,30,0
1649801967933,MATH 102,A01,084143,Harel; Guershon,25,0,30,5
1649801967933,MATH 102,A02,084144,Harel; Guershon,28,0,30,2
1649801973963,MATH 103B,A01,083456,Staff,15,0,30,15
1649801973963,MATH 103B,A02,083457,Staff,26,0,30,4
1649801979990,MATH 109,A01,084146,Salehi Golsefidy; Alireza,30,0,30,0
1649801979990,MATH 109,A02,084147,Salehi Golsefidy; Alireza,27,0,30,3
1649801986019,MATH 120A,A01,085445,Eggers; John Dietrich,31,0,35,4
1649801986019,MATH 120A,A02,085446,Eggers; John Dietrich,33,0,35,2
1649801992047,MATH 142B,A01,084149,Verstraete; Jacques Allan,22,0,30,8
1649801992047,MATH 142B,A02,084150,Verstraete; Jacques Allan,26,0,30,4
1649801998069,MATH 170A,A01,083459,Nie; Jiawang,16,0,30,14
1649801998069,MATH 170A,A02,083460,Nie; Jiawang,27,0,30,3
1649801998069,MATH 170A,A03,083461,Nie; Jiawang,28,0,30,2
1649802004106,MATH 193B,A01,083463,Staff,22,0,30,8
1649802004106,MATH 193B,A02,083464,Staff,25,0,30,5
1649802004106,MATH 193B,A03,083465,Staff,30,0,30,0
1649802010179,COGS 2,A01,083966,Boyle; Mary E. T.,28,0,30,2
1649802016203,COGS 9,A01,083968,Staff,58,0,60,2
1649802022230,COGS 14B,A01,083970,Staff,49,0,50,1
1649802028274,COGS 100,A01,083972,Staff,52,0,60,8
1649802040329,COGS 101C,A01,083976,Staff,26,0,30,4
1649802046359,COGS 102A,A01,083978,Johnson; Christine M.,28,0,30,2
1649802052383,COGS 107B,A01,083980,Staff,45,0,50,5
1649802058418,COGS 115,A01,083982,Staff,24,0,30,6
1649802064442,COGS 118B,A01,083367,Staff,15,0,40,25
1649802070468,COGS 172,A01,083984,Provenzano; Emily Kara,25,0,30,5
1649802076492,COGS 177,A00,083368,Staff,15,0,30,15
1649802082514,COGS 186,A01,083986,Staff,28,0,40,12
1649802088539,COGS 187A,A01,083988,Boyle; Mary E. T.,50,0,60,10
1649802094576,CSE 8A,A50,084003,Miranda; Gregory Joseph,11,0,15,4
1649802100603,CSE 11,A01,084005,Miranda; Gregory Joseph,51,0,55,4
1649802106630,CSE 20,A01,084007,Staff,17,0,20,3
1649802112657,CSE 21,A01,084009,Staff,43,0,50,7
1649802118681,CSE 30,A01,083370,Cao; Yingjun,28,0,40,12
1649802124710,CSE 100,A01,083372,Cao; Yingjun,33,0,40,7
1649802130738,CSE 101,A01,084011,Staff,14,0,40,26
1649802136770,CSE 141,A01,083374,Eldon; John,21,0,75,54
1649802142797,CSE 141L,A01,083376,Eldon; John,22,0,75,53
1649802148820,CSE 175,A01,084013,Kumar; Rakesh,25,0,25,0
1649802154847,CSE 190,A00,092508,Staff,15,0,15,0
1649802160871,ECE 5,A01,084049,Morris; Karcher William,18,0,20,2
1649802166901,ECE 100,A01,084051,Baghdadchi; Saharnaz,17,0,20,3
1649802166901,ECE 100,A02,091916,Baghdadchi; Saharnaz,19,0,20,1
1649802172925,ECE 101,A01,084053,Baghdadchi; Saharnaz,30,0,37,7
1649802172925,ECE 101,A02,084054,Baghdadchi; Saharnaz,37,0,37,0
1649802178953,ECE 107,A01,083390,Staff,35,0,40,5
1649802184988,ECE 148,A01,084056,Silberman; Jack,8,0,12,4
1649802191011,ECE 180,A00,083391,Abi Samra; Nicholas Camill,27,0,30,3
1649802191011,ECE 180,B00,083392,Abi Samra; Nicholas Camill,26,0,30,4
1649802197035,MATH 10B,A01,084110,Staff,24,0,30,6
1649802197035,MATH 10B,A02,084111,Staff,29,0,30,1
1649802197035,MATH 10B,A03,084112,Staff,30,0,30,0
1649802203070,MATH 10C,A01,083443,Staff,24,0,30,6
1649802203070,MATH 10C,A02,083444,Staff,26,0,30,4
1649802203070,MATH 10C,B01,084114,Staff,27,0,30,3
1649802203070,MATH 10C,B02,084115,Staff,30,0,30,0
1649802209098,MATH 18,A01,084117,Harel; Guershon,28,0,30,2
1649802209098,MATH 18,A02,084119,Harel; Guershon,29,0,30,1
1649802209098,MATH 18,A03,084120,Harel; Guershon,30,0,30,0
1649802209098,MATH 18,A04,084121,Harel; Guershon,30,0,30,0
1649802215124,MATH 20B,A01,084124,Um; Ko Woon,34,0,35,1
1649802215124,MATH 20B,B01,084126,Um; Ko Woon,35,0,35,0
1649802221148,MATH 20C,A01,083446,Hammock; Frances H,27,0,30,3
1649802221148,MATH 20C,A02,083447,Hammock; Frances H,30,0,30,0
1649802221148,MATH 20C,A03,083448,Hammock; Frances H,30,0,30,0
1649802221148,MATH 20C,A04,083449,Hammock; Frances H,30,0,30,0
1649802221148,MATH 20C,B01,083451,Hammock; Frances H,30,0,30,0
1649802221148,MATH 20C,B02,083452,Hammock; Frances H,30,0,30,0
1649802221148,MATH 20C,B03,083453,Hammock; Frances H,30,0,30,0
1649802221148,MATH 20C,B04,083454,Hammock; Frances H,30,0,30,0
1649802227176,MATH 20D,A01,084128,Staff,30,0,30,0
1649802227176,MATH 20D,A02,084129,Staff,30,0,30,0
1649802227176,MATH 20D,A03,084130,Staff,29,0,30,1
1649802227176,MATH 20D,B01,084133,Staff,29,0,30,1
1649802227176,MATH 20D,B02,084134,Staff,30,0,30,0
1649802227176,MATH 20D,B03,084135,Staff,30,0,30,0
1649802233203,MATH 20E,A01,084138,Staff,30,0,30,0
1649802233203,MATH 20E,A02,084139,Staff,29,0,30,1
1649802233203,MATH 20E,A03,084140,Staff,30,0,30,0
1649802233203,MATH 20E,A04,084141,Staff,30,0,30,0
1649802239235,MATH 102,A01,084143,Harel; Guershon,25,0,30,5
1649802239235,MATH 102,A02,084144,Harel; Guershon,28,0,30,2
1649802245259,MATH 103B,A01,083456,Staff,14,0,30,16
1649802245259,MATH 103B,A02,083457,Staff,26,0,30,4
1649802251292,MATH 109,A01,084146,Salehi Golsefidy; Alireza,30,0,30,0
1649802251292,MATH 109,A02,084147,Salehi Golsefidy; Alireza,27,0,30,3
1649802257319,MATH 120A,A01,085445,Eggers; John Dietrich,31,0,35,4
1649802257319,MATH 120A,A02,085446,Eggers; John Dietrich,33,0,35,2
1649802263342,MATH 142B,A01,084149,Verstraete; Jacques Allan,21,0,30,9
1649802263342,MATH 142B,A02,084150,Verstraete; Jacques Allan,26,0,30,4
1649802269370,MATH 170A,A01,083459,Nie; Jiawang,16,0,30,14
1649802269370,MATH 170A,A02,083460,Nie; Jiawang,27,0,30,3
1649802269370,MATH 170A,A03,083461,Nie; Jiawang,28,0,30,2
1649802275397,MATH 193B,A01,083463,Staff,22,0,30,8
1649802275397,MATH 193B,A02,083464,Staff,25,0,30,5
1649802275397,MATH 193B,A03,083465,Staff,30,0,30,0
1649802281467,COGS 2,A01,083966,Boyle; Mary E. T.,28,0,30,2
1649802287492,COGS 9,A01,083968,Staff,58,0,60,2
1649802293517,COGS 14B,A01,083970,Staff,49,0,50,1
1649802299556,COGS 100,A01,083972,Staff,52,0,60,8
1649802311624,COGS 101C,A01,083976,Staff,26,0,30,4
1649802317657,COGS 102A,A01,083978,Johnson; Christine M.,28,0,30,2
1649802323679,COGS 107B,A01,083980,Staff,45,0,50,5
1649802329719,COGS 115,A01,083982,Staff,23,0,30,7
1649802335743,COGS 118B,A01,083367,Staff,15,0,40,25
1649802341769,COGS 172,A01,083984,Provenzano; Emily Kara,25,0,30,5
1649802347794,COGS 177,A00,083368,Staff,15,0,30,15
1649802353820,COGS 186,A01,083986,Staff,28,0,40,12
1649802359854,COGS 187A,A01,083988,Boyle; Mary E. T.,50,0,60,10
1649802365891,CSE 8A,A50,084003,Miranda; Gregory Joseph,11,0,15,4
1649802371919,CSE 11,A01,084005,Miranda; Gregory Joseph,51,0,55,4
1649802377953,CSE 20,A01,084007,Staff,17,0,20,3
1649802383980,CSE 21,A01,084009,Staff,43,0,50,7
1649802390015,CSE 30,A01,083370,Cao; Yingjun,28,0,40,12
1649802396038,CSE 100,A01,083372,Cao; Yingjun,33,0,40,7
1649802402064,CSE 101,A01,084011,Staff,12,0,40,28
1649802408087,CSE 141,A01,083374,Eldon; John,19,0,75,56
1649802414114,CSE 141L,A01,083376,Eldon; John,20,0,75,55
1649802420142,CSE 175,A01,084013,Kumar; Rakesh,25,0,25,0
1649802426167,CSE 190,A00,092508,Staff,15,0,15,0
1649802432199,ECE 5,A01,084049,Morris; Karcher William,18,0,20,2
1649802438229,ECE 100,A01,084051,Baghdadchi; Saharnaz,17,0,20,3
1649802438229,ECE 100,A02,091916,Baghdadchi; Saharnaz,19,0,20,1
1649802444264,ECE 101,A01,084053,Baghdadchi; Saharnaz,30,0,37,7
1649802444264,ECE 101,A02,084054,Baghdadchi; Saharnaz,37,0,37,0
1649802450288,ECE 107,A01,083390,Staff,35,0,40,5
1649802456312,ECE 148,A01,084056,Silberman; Jack,8,0,12,4
1649802462344,ECE 180,A00,083391,Abi Samra; Nicholas Camill,27,0,30,3
1649802462344,ECE 180,B00,083392,Abi Samra; Nicholas Camill,26,0,30,4
1649802468372,MATH 10B,A01,084110,Staff,24,0,30,6
1649802468372,MATH 10B,A02,084111,Staff,29,0,30,1
1649802468372,MATH 10B,A03,084112,Staff,30,0,30,0
1649802474405,MATH 10C,A01,083443,Staff,24,0,30,6
1649802474405,MATH 10C,A02,083444,Staff,26,0,30,4
1649802474405,MATH 10C,B01,084114,Staff,27,0,30,3
1649802474405,MATH 10C,B02,084115,Staff,30,0,30,0
1649802480438,MATH 18,A01,084117,Harel; Guershon,28,0,30,2
1649802480438,MATH 18,A02,084119,Harel; Guershon,29,0,30,1
1649802480438,MATH 18,A03,084120,Harel; Guershon,30,0,30,0
1649802480438,MATH 18,A04,084121,Harel; Guershon,30,0,30,0
1649802486462,MATH 20B,A01,084124,Um; Ko Woon,34,0,35,1
1649802486462,MATH 20B,B01,084126,Um; Ko Woon,35,0,35,0
1649802492490,MATH 20C,A01,083446,Hammock; Frances H,27,0,30,3
1649802492490,MATH 20C,A02,083447,Hammock; Frances H,30,0,30,0
1649802492490,MATH 20C,A03,083448,Hammock; Frances H,30,0,30,0
1649802492490,MATH 20C,A04,083449,Hammock; Frances H,30,0,30,0
1649802492490,MATH 20C,B01,083451,Hammock; Frances H,30,0,30,0
1649802492490,MATH 20C,B02,083452,Hammock; Frances H,30,0,30,0
1649802492490,MATH 20C,B03,083453,Hammock; Frances H,30,0,30,0
1649802492490,MATH 20C,B04,083454,Hammock; Frances H,30,0,30,0
1649802498521,MATH 20D,A01,084128,Staff,30,0,30,0
1649802498521,MATH 20D,A02,084129,Staff,30,0,30,0
1649802498521,MATH 20D,A03,084130,Staff,29,0,30,1
1649802498521,MATH 20D,B01,084133,Staff,29,0,30,1
1649802498521,MATH 20D,B02,084134,Staff,30,0,30,0
1649802498521,MATH 20D,B03,084135,Staff,30,0,30,0
1649802504546,MATH 20E,A01,084138,Staff,30,0,30,0
1649802504546,MATH 20E,A02,084139,Staff,29,0,30,1
1649802504546,MATH 20E,A03,084140,Staff,30,0,30,0
1649802504546,MATH 20E,A04,084141,Staff,30,0,30,0
1649802510571,MATH 102,A01,084143,Harel; Guershon,25,0,30,5
1649802510571,MATH 102,A02,084144,Harel; Guershon,28,0,30,2
1649802516592,MATH 103B,A01,083456,Staff,14,0,30,16
1649802516592,MATH 103B,A02,083457,Staff,26,0,30,4
1649802522615,MATH 109,A01,084146,Salehi Golsefidy; Alireza,30,0,30,0
1649802522615,MATH 109,A02,084147,Salehi Golsefidy; Alireza,27,0,30,3
1649802528645,MATH 120A,A01,085445,Eggers; John Dietrich,31,0,35,4
1649802528645,MATH 120A,A02,085446,Eggers; John Dietrich,33,0,35,2
1649802534675,MATH 142B,A01,084149,Verstraete; Jacques Allan,21,0,30,9
1649802534675,MATH 142B,A02,084150,Verstraete; Jacques Allan,26,0,30,4
1649802540780,MATH 170A,A01,083459,Nie; Jiawang,16,0,30,14
1649802540780,MATH 170A,A02,083460,Nie; Jiawang,27,0,30,3
1649802540780,MATH 170A,A03,083461,Nie; Jiawang,28,0,30,2
1649802546809,MATH 193B,A01,083463,Staff,22,0,30,8
1649802546809,MATH 193B,A02,083464,Staff,25,0,30,5
1649802546809,MATH 193B,A03,083465,Staff,30,0,30,0
1649802552859,COGS 2,A01,083966,Boyle; Mary E. T.,28,0,30,2
1649802558886,COGS 9,A01,083968,Staff,58,0,60,2
1649802564910,COGS 14B,A01,083970,Staff,49,0,50,1
1649802570952,COGS 100,A01,083972,Staff,52,0,60,8
1649802583004,COGS 101C,A01,083976,Staff,26,0,30,4
1649802589028,COGS 102A,A01,083978,Johnson; Christine M.,28,0,30,2
1649802595052,COGS 107B,A01,083980,Staff,45,0,50,5
1649802601082,COGS 115,A01,083982,Staff,23,0,30,7
1649802607108,COGS 118B,A01,083367,Staff,15,0,40,25
1649802613134,COGS 172,A01,083984,Provenzano; Emily Kara,25,0,30,5
1649802619163,COGS 177,A00,083368,Staff,15,0,30,15
1649802625189,COGS 186,A01,083986,Staff,28,0,40,12
1649802631226,COGS 187A,A01,083988,Boyle; Mary E. T.,50,0,60,10
1649802637252,CSE 8A,A50,084003,Miranda; Gregory Joseph,11,0,15,4
1649802643278,CSE 11,A01,084005,Miranda; Gregory Joseph,51,0,55,4
1649802649306,CSE 20,A01,084007,Staff,17,0,20,3
1649802655344,CSE 21,A01,084009,Staff,43,0,50,7
1649802661368,CSE 30,A01,083370,Cao; Yingjun,28,0,40,12
1649802667393,CSE 100,A01,083372,Cao; Yingjun,33,0,40,7
1649802673417,CSE 101,A01,084011,Staff,12,0,40,28
1649802679445,CSE 141,A01,083374,Eldon; John,18,0,75,57
1649802685473,CSE 141L,A01,083376,Eldon; John,19,0,75,56
1649802691496,CSE 175,A01,084013,Kumar; Rakesh,25,0,25,0
1649802697521,CSE 190,A00,092508,Staff,15,0,15,0
1649802703557,ECE 5,A01,084049,Morris; Karcher William,18,0,20,2
1649802709581,ECE 100,A01,084051,Baghdadchi; Saharnaz,17,0,20,3
1649802709581,ECE 100,A02,091916,Baghdadchi; Saharnaz,19,0,20,1
1649802715611,ECE 101,A01,084053,Baghdadchi; Saharnaz,30,0,37,7
1649802715611,ECE 101,A02,084054,Baghdadchi; Saharnaz,37,0,37,0
1649802721640,ECE 107,A01,083390,Staff,35,0,40,5
1649802727666,ECE 148,A01,084056,Silberman; Jack,8,0,12,4
1649802733693,ECE 180,A00,083391,Abi Samra; Nicholas Camill,27,0,30,3
1649802733693,ECE 180,B00,083392,Abi Samra; Nicholas Camill,26,0,30,4
1649802739728,MATH 10B,A01,084110,Staff,23,0,30,7
1649802739728,MATH 10B,A02,084111,Staff,29,0,30,1
1649802739728,MATH 10B,A03,084112,Staff,30,0,30,0
1649802745760,MATH 10C,A01,083443,Staff,24,0,30,6
1649802745760,MATH 10C,A02,083444,Staff,26,0,30,4
1649802745760,MATH 10C,B01,084114,Staff,27,0,30,3
1649802745760,MATH 10C,B02,084115,Staff,30,0,30,0
1649802751788,MATH 18,A01,084117,Harel; Guershon,28,0,30,2
1649802751788,MATH 18,A02,084119,Harel; Guershon,29,0,30,1
1649802751788,MATH 18,A03,084120,Harel; Guershon,30,0,30,0
1649802751788,MATH 18,A04,084121,Harel; Guershon,30,0,30,0
1649802757818,MATH 20B,A01,084124,Um; Ko Woon,34,0,35,1
1649802757818,MATH 20B,B01,084126,Um; Ko Woon,35,0,35,0
1649802763844,MATH 20C,A01,083446,Hammock; Frances H,27,0,30,3
1649802763844,MATH 20C,A02,083447,Hammock; Frances H,30,0,30,0
1649802763844,MATH 20C,A03,083448,Hammock; Frances H,30,0,30,0
1649802763844,MATH 20C,A04,083449,Hammock; Frances H,30,0,30,0
1649802763844,MATH 20C,B01,083451,Hammock; Frances H,30,0,30,0
1649802763844,MATH 20C,B02,083452,Hammock; Frances H,30,0,30,0
1649802763844,MATH 20C,B03,083453,Hammock; Frances H,30,0,30,0
1649802763844,MATH 20C,B04,083454,Hammock; Frances H,30,0,30,0
1649802769866,MATH 20D,A01,084128,Staff,30,0,30,0
1649802769866,MATH 20D,A02,084129,Staff,30,0,30,0
1649802769866,MATH 20D,A03,084130,Staff,29,0,30,1
1649802769866,MATH 20D,B01,084133,Staff,29,0,30,1
1649802769866,MATH 20D,B02,084134,Staff,30,0,30,0
1649802769866,MATH 20D,B03,084135,Staff,30,0,30,0
1649802775889,MATH 20E,A01,084138,Staff,30,0,30,0
1649802775889,MATH 20E,A02,084139,Staff,29,0,30,1
1649802775889,MATH 20E,A03,084140,Staff,30,0,30,0
1649802775889,MATH 20E,A04,084141,Staff,30,0,30,0
1649802781916,MATH 102,A01,084143,Harel; Guershon,25,0,30,5
1649802781916,MATH 102,A02,084144,Harel; Guershon,28,0,30,2
1649802787940,MATH 103B,A01,083456,Staff,13,0,30,17
1649802787940,MATH 103B,A02,083457,Staff,26,0,30,4
1649802793968,MATH 109,A01,084146,Salehi Golsefidy; Alireza,30,0,30,0
1649802793968,MATH 109,A02,084147,Salehi Golsefidy; Alireza,27,0,30,3
1649802800002,MATH 120A,A01,085445,Eggers; John Dietrich,31,0,35,4
1649802800002,MATH 120A,A02,085446,Eggers; John Dietrich,33,0,35,2
1649802806033,MATH 142B,A01,084149,Verstraete; Jacques Allan,20,0,30,10
1649802806033,MATH 142B,A02,084150,Verstraete; Jacques Allan,26,0,30,4
1649802812065,MATH 170A,A01,083459,Nie; Jiawang,16,0,30,14
1649802812065,MATH 170A,A02,083460,Nie; Jiawang,27,0,30,3
1649802812065,MATH 170A,A03,083461,Nie; Jiawang,28,0,30,2
1649802818095,MATH 193B,A01,083463,Staff,22,0,30,8
1649802818095,MATH 193B,A02,083464,Staff,25,0,30,5
1649802818095,MATH 193B,A03,083465,Staff,30,0,30,0
1649802824147,COGS 2,A01,083966,Boyle; Mary E. T.,28,0,30,2
1649802830178,COGS 9,A01,083968,Staff,58,0,60,2
1649802836202,COGS 14B,A01,083970,Staff,49,0,50,1
1649802842224,COGS 100,A01,083972,Staff,52,0,60,8
1649802854277,COGS 101C,A01,083976,Staff,26,0,30,4
1649802860304,COGS 102A,A01,083978,Johnson; Christine M.,28,0,30,2
1649802866330,COGS 107B,A01,083980,Staff,45,0,50,5
1649802872354,COGS 115,A01,083982,Staff,23,0,30,7
1649802878379,COGS 118B,A01,083367,Staff,15,0,40,25
1649802884404,COGS 172,A01,083984,Provenzano; Emily Kara,25,0,30,5
1649802890431,COGS 177,A00,083368,Staff,15,0,30,15
1649802896460,COGS 186,A01,083986,Staff,28,0,40,12
1649802902487,COGS 187A,A01,083988,Boyle; Mary E. T.,50,0,60,10
1649802908517,CSE 8A,A50,084003,Miranda; Gregory Joseph,11,0,15,4
1649802914552,CSE 11,A01,084005,Miranda; Gregory Joseph,51,0,55,4
1649802920587,CSE 20,A01,084007,Staff,17,0,20,3
1649802926617,CSE 21,A01,084009,Staff,43,0,50,7
1649802932642,CSE 30,A01,083370,Cao; Yingjun,28,0,40,12
1649802938670,CSE 100,A01,083372,Cao; Yingjun,33,0,40,7
1649802944698,CSE 101,A01,084011,Staff,12,0,40,28
1649802950725,CSE 141,A01,083374,Eldon; John,16,0,75,59
1649802956749,CSE 141L,A01,083376,Eldon; John,17,0,75,58
1649802962777,CSE 175,A01,084013,Kumar; Rakesh,25,0,25,0
1649802968801,CSE 190,A00,092508,Staff,15,0,15,0
1649802974825,ECE 5,A01,084049,Morris; Karcher William,18,0,20,2
1649802980849,ECE 100,A01,084051,Baghdadchi; Saharnaz,17,0,20,3
1649802980849,ECE 100,A02,091916,Baghdadchi; Saharnaz,19,0,20,1
1649802986874,ECE 101,A01,084053,Baghdadchi; Saharnaz,29,0,37,8
1649802986874,ECE 101,A02,084054,Baghdadchi; Saharnaz,37,0,37,0
1649802992898,ECE 107,A01,083390,Staff,35,0,40,5
1649802998933,ECE 148,A01,084056,Silberman; Jack,8,0,12,4
1649803004961,ECE 180,A00,083391,Abi Samra; Nicholas Camill,27,0,30,3
1649803004961,ECE 180,B00,083392,Abi Samra; Nicholas Camill,26,0,30,4
1649803010993,MATH 10B,A01,084110,Staff,23,0,30,7
1649803010993,MATH 10B,A02,084111,Staff,29,0,30,1
1649803010993,MATH 10B,A03,084112,Staff,30,0,30,0
1649803017024,MATH 10C,A01,083443,Staff,24,0,30,6
1649803017024,MATH 10C,A02,083444,Staff,26,0,30,4
1649803017024,MATH 10C,B01,084114,Staff,27,0,30,3
1649803017024,MATH 10C,B02,084115,Staff,30,0,30,0
1649803023062,MATH 18,A01,084117,Harel; Guershon,28,0,30,2
1649803023062,MATH 18,A02,084119,Harel; Guershon,29,0,30,1
1649803023062,MATH 18,A03,084120,Harel; Guershon,30,0,30,0
1649803023062,MATH 18,A04,084121,Harel; Guershon,30,0,30,0
1649803029094,MATH 20B,A01,084124,Um; Ko Woon,34,0,35,1
1649803029094,MATH 20B,B01,084126,Um; Ko Woon,35,0,35,0
1649803035122,MATH 20C,A01,083446,Hammock; Frances H,27,0,30,3
1649803035122,MATH 20C,A02,083447,Hammock; Frances H,30,0,30,0
1649803035122,MATH 20C,A03,083448,Hammock; Frances H,30,0,30,0
1649803035122,MATH 20C,A04,083449,Hammock; Frances H,30,0,30,0
1649803035122,MATH 20C,B01,083451,Hammock; Frances H,30,0,30,0
1649803035122,MATH 20C,B02,083452,Hammock; Frances H,30,0,30,0
1649803035122,MATH 20C,B03,083453,Hammock; Frances H,30,0,30,0
1649803035122,MATH 20C,B04,083454,Hammock; Frances H,30,0,30,0
1649803041160,MATH 20D,A01,084128,Staff,30,0,30,0
1649803041160,MATH 20D,A02,084129,Staff,30,0,30,0
1649803041160,MATH 20D,A03,084130,Staff,29,0,30,1
1649803041160,MATH 20D,B01,084133,Staff,29,0,30,1
1649803041160,MATH 20D,B02,084134,Staff,30,0,30,0
1649803041160,MATH 20D,B03,084135,Staff,30,0,30,0
1649803047187,MATH 20E,A01,084138,Staff,30,0,30,0
1649803047187,MATH 20E,A02,084139,Staff,29,0,30,1
1649803047187,MATH 20E,A03,084140,Staff,30,0,30,0
1649803047187,MATH 20E,A04,084141,Staff,30,0,30,0
1649803053211,MATH 102,A01,084143,Harel; Guershon,25,0,30,5
1649803053211,MATH 102,A02,084144,Harel; Guershon,28,0,30,2
1649803059235,MATH 103B,A01,083456,Staff,13,0,30,17
1649803059235,MATH 103B,A02,083457,Staff,26,0,30,4
1649803065261,MATH 109,A01,084146,Salehi Golsefidy; Alireza,30,0,30,0
1649803065261,MATH 109,A02,084147,Salehi Golsefidy; Alireza,27,0,30,3
1649803071296,MATH 120A,A01,085445,Eggers; John Dietrich,31,0,35,4
1649803071296,MATH 120A,A02,085446,Eggers; John Dietrich,33,0,35,2
1649803077324,MATH 142B,A01,084149,Verstraete; Jacques Allan,20,0,30,10
1649803077324,MATH 142B,A02,084150,Verstraete; Jacques Allan,26,0,30,4
1649803083366,MATH 170A,A01,083459,Nie; Jiawang,16,0,30,14
1649803083366,MATH 170A,A02,083460,Nie; Jiawang,27,0,30,3
1649803083366,MATH 170A,A03,083461,Nie; Jiawang,28,0,30,2
1649803089390,MATH 193B,A01,083463,Staff,22,0,30,8
1649803089390,MATH 193B,A02,083464,Staff,25,0,30,5
1649803089390,MATH 193B,A03,083465,Staff,30,0,30,0
1649803095450,COGS 2,A01,083966,Boyle; Mary E. T.,28,0,30,2
1649803101476,COGS 9,A01,083968,Staff,58,0,60,2
1649803107499,COGS 14B,A01,083970,Staff,49,0,50,1
1649803113522,COGS 100,A01,083972,Staff,52,0,60,8
1649803125570,COGS 101C,A01,083976,Staff,26,0,30,4
1649803131668,COGS 102A,A01,083978,Johnson; Christine M.,28,0,30,2
1649803137701,COGS 107B,A01,083980,Staff,45,0,50,5
1649803143725,COGS 115,A01,083982,Staff,23,0,30,7
1649803149752,COGS 118B,A01,083367,Staff,15,0,40,25
1649803155780,COGS 172,A01,083984,Provenzano; Emily Kara,25,0,30,5
1649803161827,COGS 177,A00,083368,Staff,15,0,30,15
1649803167854,COGS 186,A01,083986,Staff,28,0,40,12
1649803173892,COGS 187A,A01,083988,Boyle; Mary E. T.,50,0,60,10
1649803179918,CSE 8A,A50,084003,Miranda; Gregory Joseph,11,0,15,4
1649803185951,CSE 11,A01,084005,Miranda; Gregory Joseph,51,0,55,4
1649803191976,CSE 20,A01,084007,Staff,17,0,20,3
1649803198006,CSE 21,A01,084009,Staff,43,0,50,7
1649803204029,CSE 30,A01,083370,Cao; Yingjun,28,0,40,12
1649803210052,CSE 100,A01,083372,Cao; Yingjun,33,0,40,7
1649803216085,CSE 101,A01,084011,Staff,12,0,40,28
1649803222116,CSE 141,A01,083374,Eldon; John,15,0,75,60
1649803228140,CSE 141L,A01,083376,Eldon; John,15,0,75,60
1649803234172,CSE 175,A01,084013,Kumar; Rakesh,25,0,25,0
1649803240199,CSE 190,A00,092508,Staff,15,0,15,0
1649803246226,ECE 5,A01,084049,Morris; Karcher William,18,0,20,2
1649803252249,ECE 100,A01,084051,Baghdadchi; Saharnaz,17,0,20,3
1649803252249,ECE 100,A02,091916,Baghdadchi; Saharnaz,19,0,20,1
1649803258273,ECE 101,A01,084053,Baghdadchi; Saharnaz,29,0,37,8
1649803258273,ECE 101,A02,084054,Baghdadchi; Saharnaz,37,0,37,0
1649803264300,ECE 107,A01,083390,Staff,35,0,40,5
1649803270327,ECE 148,A01,084056,Silberman; Jack,8,0,12,4
1649803276361,ECE 180,A00,083391,Abi Samra; Nicholas Camill,27,0,30,3
1649803276361,ECE 180,B00,083392,Abi Samra; Nicholas Camill,26,0,30,4
1649803282389,MATH 10B,A01,084110,Staff,23,0,30,7
1649803282389,MATH 10B,A02,084111,Staff,29,0,30,1
1649803282389,MATH 10B,A03,084112,Staff,30,0,30,0
1649803288416,MATH 10C,A01,083443,Staff,24,0,30,6
1649803288416,MATH 10C,A02,083444,Staff,26,0,30,4
1649803288416,MATH 10C,B01,084114,Staff,27,0,30,3
1649803288416,MATH 10C,B02,084115,Staff,30,0,30,0
1649803294449,MATH 18,A01,084117,Harel; Guershon,28,0,30,2
1649803294449,MATH 18,A02,084119,Harel; Guershon,29,0,30,1
1649803294449,MATH 18,A03,084120,Harel; Guershon,30,0,30,0
1649803294449,MATH 18,A04,084121,Harel; Guershon,30,0,30,0
1649803300479,MATH 20B,A01,084124,Um; Ko Woon,34,0,35,1
1649803300479,MATH 20B,B01,084126,Um; Ko Woon,35,0,35,0
1649803312188,MATH 20C,A01,083446,Hammock; Frances H,27,0,30,3
1649803312188,MATH 20C,A02,083447,Hammock; Frances H,30,0,30,0
1649803312188,MATH 20C,A03,083448,Hammock; Frances H,30,0,30,0
1649803312188,MATH 20C,A04,083449,Hammock; Frances H,30,0,30,0
1649803312188,MATH 20C,B01,083451,Hammock; Frances H,30,0,30,0
1649803312188,MATH 20C,B02,083452,Hammock; Frances H,30,0,30,0
1649803312188,MATH 20C,B03,083453,Hammock; Frances H,30,0,30,0
1649803312188,MATH 20C,B04,083454,Hammock; Frances H,30,0,30,0
1649803318212,MATH 20D,A01,084128,Staff,30,0,30,0
1649803318212,MATH 20D,A02,084129,Staff,30,0,30,0
1649803318212,MATH 20D,A03,084130,Staff,29,0,30,1
1649803318212,MATH 20D,B01,084133,Staff,29,0,30,1
1649803318212,MATH 20D,B02,084134,Staff,30,0,30,0
1649803318212,MATH 20D,B03,084135,Staff,30,0,30,0
1649803324236,MATH 20E,A01,084138,Staff,30,0,30,0
1649803324236,MATH 20E,A02,084139,Staff,29,0,30,1
1649803324236,MATH 20E,A03,084140,Staff,30,0,30,0
1649803324236,MATH 20E,A04,084141,Staff,30,0,30,0
1649803330262,MATH 102,A01,084143,Harel; Guershon,25,0,30,5
1649803330262,MATH 102,A02,084144,Harel; Guershon,28,0,30,2
1649803336287,MATH 103B,A01,083456,Staff,13,0,30,17
1649803336287,MATH 103B,A02,083457,Staff,26,0,30,4
1649803342317,MATH 109,A01,084146,Salehi Golsefidy; Alireza,30,0,30,0
1649803342317,MATH 109,A02,084147,Salehi Golsefidy; Alireza,27,0,30,3
1649803348354,MATH 120A,A01,085445,Eggers; John Dietrich,31,0,35,4
1649803348354,MATH 120A,A02,085446,Eggers; John Dietrich,33,0,35,2
1649803354382,MATH 142B,A01,084149,Verstraete; Jacques Allan,20,0,30,10
1649803354382,MATH 142B,A02,084150,Verstraete; Jacques Allan,26,0,30,4
1649803360415,MATH 170A,A01,083459,Nie; Jiawang,16,0,30,14
1649803360415,MATH 170A,A02,083460,Nie; Jiawang,27,0,30,3
1649803360415,MATH 170A,A03,083461,Nie; Jiawang,28,0,30,2
1649803366438,MATH 193B,A01,083463,Staff,22,0,30,8
1649803366438,MATH 193B,A02,083464,Staff,25,0,30,5
1649803366438,MATH 193B,A03,083465,Staff,30,0,30,0
1649803372493,COGS 2,A01,083966,Boyle; Mary E. T.,28,0,30,2
1649803378515,COGS 9,A01,083968,Staff,58,0,60,2
1649803384541,COGS 14B,A01,083970,Staff,49,0,50,1
1649803390566,COGS 100,A01,083972,Staff,52,0,60,8
1649803402618,COGS 101C,A01,083976,Staff,26,0,30,4
1649803408641,COGS 102A,A01,083978,Johnson; Christine M.,28,0,30,2
1649803414669,COGS 107B,A01,083980,Staff,45,0,50,5
1649803420700,COGS 115,A01,083982,Staff,23,0,30,7
1649803426723,COGS 118B,A01,083367,Staff,12,0,40,28
1649803432750,COGS 172,A01,083984,Provenzano; Emily Kara,25,0,30,5
1649803438775,COGS 177,A00,083368,Staff,15,0,30,15
1649803444802,COGS 186,A01,083986,Staff,28,0,40,12
1649803450828,COGS 187A,A01,083988,Boyle; Mary E. T.,50,0,60,10
1649803456852,CSE 8A,A50,084003,Miranda; Gregory Joseph,11,0,15,4
1649803462892,CSE 11,A01,084005,Miranda; Gregory Joseph,51,0,55,4
1649803468920,CSE 20,A01,084007,Staff,17,0,20,3
1649803474943,CSE 21,A01,084009,Staff,43,0,50,7
1649803480966,CSE 30,A01,083370,Cao; Yingjun,28,0,40,12
1649803486988,CSE 100,A01,083372,Cao; Yingjun,33,0,40,7
1649803493014,CSE 101,A01,084011,Staff,11,0,40,29
1649803499042,CSE 141,A01,083374,Eldon; John,15,0,75,60
1649803505066,CSE 141L,A01,083376,Eldon; John,15,0,75,60
1649803511100,CSE 175,A01,084013,Kumar; Rakesh,25,0,25,0
1649803517127,CSE 190,A00,092508,Staff,15,0,15,0
1649803523151,ECE 5,A01,084049,Morris; Karcher William,18,0,20,2
1649803529184,ECE 100,A01,084051,Baghdadchi; Saharnaz,17,0,20,3
1649803529184,ECE 100,A02,091916,Baghdadchi; Saharnaz,19,0,20,1
1649803535213,ECE 101,A01,084053,Baghdadchi; Saharnaz,29,0,37,8
1649803535213,ECE 101,A02,084054,Baghdadchi; Saharnaz,37,0,37,0
1649803541240,ECE 107,A01,083390,Staff,35,0,40,5
1649803547266,ECE 148,A01,084056,Silberman; Jack,8,0,12,4
1649803553301,ECE 180,A00,083391,Abi Samra; Nicholas Camill,27,0,30,3
1649803553301,ECE 180,B00,083392,Abi Samra; Nicholas Camill,26,0,30,4
1649803559323,MATH 10B,A01,084110,Staff,23,0,30,7
1649803559323,MATH 10B,A02,084111,Staff,29,0,30,1
1649803559323,MATH 10B,A03,084112,Staff,30,0,30,0
1649803565354,MATH 10C,A01,083443,Staff,24,0,30,6
1649803565354,MATH 10C,A02,083444,Staff,26,0,30,4
1649803565354,MATH 10C,B01,084114,Staff,27,0,30,3
1649803565354,MATH 10C,B02,084115,Staff,30,0,30,0
1649803571377,MATH 18,A01,084117,Harel; Guershon,28,0,30,2
1649803571377,MATH 18,A02,084119,Harel; Guershon,29,0,30,1
1649803571377,MATH 18,A03,084120,Harel; Guershon,30,0,30,0
1649803571377,MATH 18,A04,084121,Harel; Guershon,30,0,30,0
1649803577399,MATH 20B,A01,084124,Um; Ko Woon,34,0,35,1
1649803577399,MATH 20B,B01,084126,Um; Ko Woon,35,0,35,0
1649803583425,MATH 20C,A01,083446,Hammock; Frances H,27,0,30,3
1649803583425,MATH 20C,A02,083447,Hammock; Frances H,30,0,30,0
1649803583425,MATH 20C,A03,083448,Hammock; Frances H,30,0,30,0
1649803583425,MATH 20C,A04,083449,Hammock; Frances H,30,0,30,0
1649803583425,MATH 20C,B01,083451,Hammock; Frances H,30,0,30,0
1649803583425,MATH 20C,B02,083452,Hammock; Frances H,30,0,30,0
1649803583425,MATH 20C,B03,083453,Hammock; Frances H,30,0,30,0
1649803583425,MATH 20C,B04,083454,Hammock; Frances H,30,0,30,0
1649803589456,MATH 20D,A01,084128,Staff,30,0,30,0
1649803589456,MATH 20D,A02,084129,Staff,30,0,30,0
1649803589456,MATH 20D,A03,084130,Staff,29,0,30,1
1649803589456,MATH 20D,B01,084133,Staff,29,0,30,1
1649803589456,MATH 20D,B02,084134,Staff,30,0,30,0
1649803589456,MATH 20D,B03,084135,Staff,30,0,30,0
1649803595488,MATH 20E,A01,084138,Staff,30,0,30,0
1649803595488,MATH 20E,A02,084139,Staff,29,0,30,1
1649803595488,MATH 20E,A03,084140,Staff,30,0,30,0
1649803595488,MATH 20E,A04,084141,Staff,30,0,30,0
1649803601512,MATH 102,A01,084143,Harel; Guershon,25,0,30,5
1649803601512,MATH 102,A02,084144,Harel; Guershon,28,0,30,2
1649803607544,MATH 103B,A01,083456,Staff,13,0,30,17
1649803607544,MATH 103B,A02,083457,Staff,26,0,30,4
1649803613573,MATH 109,A01,084146,Salehi Golsefidy; Alireza,30,0,30,0
1649803613573,MATH 109,A02,084147,Salehi Golsefidy; Alireza,27,0,30,3
1649803619602,MATH 120A,A01,085445,Eggers; John Dietrich,31,0,35,4
1649803619602,MATH 120A,A02,085446,Eggers; John Dietrich,33,0,35,2
1649803625637,MATH 142B,A01,084149,Verstraete; Jacques Allan,20,0,30,10
1649803625637,MATH 142B,A02,084150,Verstraete; Jacques Allan,26,0,30,4
1649803631664,MATH 170A,A01,083459,Nie; Jiawang,16,0,30,14
1649803631664,MATH 170A,A02,083460,Nie; Jiawang,27,0,30,3
1649803631664,MATH 170A,A03,083461,Nie; Jiawang,28,0,30,2
1649803637688,MATH 193B,A01,083463,Staff,22,0,30,8
1649803637688,MATH 193B,A02,083464,Staff,25,0,30,5
1649803637688,MATH 193B,A03,083465,Staff,30,0,30,0
1649803643750,COGS 2,A01,083966,Boyle; Mary E. T.,28,0,30,2
1649803649783,COGS 9,A01,083968,Staff,57,0,60,3
1649803655817,COGS 14B,A01,083970,Staff,49,0,50,1
1649803661856,COGS 100,A01,083972,Staff,52,0,60,8
1649803673904,COGS 101C,A01,083976,Staff,26,0,30,4
1649803679928,COGS 102A,A01,083978,Johnson; Christine M.,28,0,30,2
1649803685951,COGS 107B,A01,083980,Staff,45,0,50,5
1649803691974,COGS 115,A01,083982,Staff,23,0,30,7
1649803698011,COGS 118B,A01,083367,Staff,12,0,40,28
1649803704042,COGS 172,A01,083984,Provenzano; Emily Kara,25,0,30,5
1649803710066,COGS 177,A00,083368,Staff,15,0,30,15
1649803716090,COGS 186,A01,083986,Staff,28,0,40,12
1649803722117,COGS 187A,A01,083988,Boyle; Mary E. T.,50,0,60,10
1649803728140,CSE 8A,A50,084003,Miranda; Gregory Joseph,11,0,15,4
1649803734247,CSE 11,A01,084005,Miranda; Gregory Joseph,51,0,55,4
1649803740270,CSE 20,A01,084007,Staff,17,0,20,3
1649803746296,CSE 21,A01,084009,Staff,43,0,50,7
1649803752319,CSE 30,A01,083370,Cao; Yingjun,28,0,40,12
1649803758347,CSE 100,A01,083372,Cao; Yingjun,33,0,40,7
1649803764372,CSE 101,A01,084011,Staff,11,0,40,29
1649803770408,CSE 141,A01,083374,Eldon; John,14,0,75,61
1649803776432,CSE 141L,A01,083376,Eldon; John,14,0,75,61
1649803782458,CSE 175,A01,084013,Kumar; Rakesh,25,0,25,0
1649803788482,CSE 190,A00,092508,Staff,15,0,15,0
1649803794504,ECE 5,A01,084049,Morris; Karcher William,18,0,20,2
1649803800534,ECE 100,A01,084051,Baghdadchi; Saharnaz,17,0,20,3
1649803800534,ECE 100,A02,091916,Baghdadchi; Saharnaz,19,0,20,1
1649803806567,ECE 101,A01,084053,Baghdadchi; Saharnaz,29,0,37,8
1649803806567,ECE 101,A02,084054,Baghdadchi; Saharnaz,37,0,37,0
1649803812593,ECE 107,A01,083390,Staff,35,0,40,5
1649803818620,ECE 148,A01,084056,Silberman; Jack,8,0,12,4
1649803824648,ECE 180,A00,083391,Abi Samra; Nicholas Camill,27,0,30,3
1649803824648,ECE 180,B00,083392,Abi Samra; Nicholas Camill,26,0,30,4
1649803830669,MATH 10B,A01,084110,Staff,23,0,30,7
1649803830669,MATH 10B,A02,084111,Staff,29,0,30,1
1649803830669,MATH 10B,A03,084112,Staff,30,0,30,0
1649803836695,MATH 10C,A01,083443,Staff,24,0,30,6
1649803836695,MATH 10C,A02,083444,Staff,26,0,30,4
1649803836695,MATH 10C,B01,084114,Staff,27,0,30,3
1649803836695,MATH 10C,B02,084115,Staff,30,0,30,0
1649803842718,MATH 18,A01,084117,Harel; Guershon,28,0,30,2
1649803842718,MATH 18,A02,084119,Harel; Guershon,29,0,30,1
1649803842718,MATH 18,A03,084120,Harel; Guershon,30,0,30,0
1649803842718,MATH 18,A04,084121,Harel; Guershon,30,0,30,0
1649803848741,MATH 20B,A01,084124,Um; Ko Woon,34,0,35,1
1649803848741,MATH 20B,B01,084126,Um; Ko Woon,35,0,35,0
1649803854779,MATH 20C,A01,083446,Hammock; Frances H,27,0,30,3
1649803854779,MATH 20C,A02,083447,Hammock; Frances H,30,0,30,0
1649803854779,MATH 20C,A03,083448,Hammock; Frances H,30,0,30,0
1649803854779,MATH 20C,A04,083449,Hammock; Frances H,30,0,30,0
1649803854779,MATH 20C,B01,083451,Hammock; Frances H,30,0,30,0
1649803854779,MATH 20C,B02,083452,Hammock; Frances H,30,0,30,0
1649803854779,MATH 20C,B03,083453,Hammock; Frances H,30,0,30,0
1649803854779,MATH 20C,B04,083454,Hammock; Frances H,30,0,30,0
1649803860802,MATH 20D,A01,084128,Staff,30,0,30,0
1649803860802,MATH 20D,A02,084129,Staff,30,0,30,0
1649803860802,MATH 20D,A03,084130,Staff,29,0,30,1
1649803860802,MATH 20D,B01,084133,Staff,29,0,30,1
1649803860802,MATH 20D,B02,084134,Staff,30,0,30,0
1649803860802,MATH 20D,B03,084135,Staff,30,0,30,0
1649803866825,MATH 20E,A01,084138,Staff,30,0,30,0
1649803866825,MATH 20E,A02,084139,Staff,29,0,30,1
1649803866825,MATH 20E,A03,084140,Staff,30,0,30,0
1649803866825,MATH 20E,A04,084141,Staff,30,0,30,0
1649803872850,MATH 102,A01,084143,Harel; Guershon,25,0,30,5
1649803872850,MATH 102,A02,084144,Harel; Guershon,28,0,30,2
1649803878874,MATH 103B,A01,083456,Staff,13,0,30,17
1649803878874,MATH 103B,A02,083457,Staff,26,0,30,4
1649803884898,MATH 109,A01,084146,Salehi Golsefidy; Alireza,30,0,30,0
1649803884898,MATH 109,A02,084147,Salehi Golsefidy; Alireza,27,0,30,3
1649803890922,MATH 120A,A01,085445,Eggers; John Dietrich,31,0,35,4
1649803890922,MATH 120A,A02,085446,Eggers; John Dietrich,33,0,35,2
1649803896945,MATH 142B,A01,084149,Verstraete; Jacques Allan,20,0,30,10
1649803896945,MATH 142B,A02,084150,Verstraete; Jacques Allan,26,0,30,4
1649803902972,MATH 170A,A01,083459,Nie; Jiawang,16,0,30,14
1649803902972,MATH 170A,A02,083460,Nie; Jiawang,26,0,30,4
1649803902972,MATH 170A,A03,083461,Nie; Jiawang,28,0,30,2
1649803908997,MATH 193B,A01,083463,Staff,22,0,30,8
1649803908997,MATH 193B,A02,083464,Staff,24,0,30,6
1649803908997,MATH 193B,A03,083465,Staff,30,0,30,0
1649803915055,COGS 2,A01,083966,Boyle; Mary E. T.,28,0,30,2
1649803921081,COGS 9,A01,083968,Staff,57,0,60,3
1649803927111,COGS 14B,A01,083970,Staff,49,0,50,1
1649803933139,COGS 100,A01,083972,Staff,52,0,60,8
1649803945192,COGS 101C,A01,083976,Staff,26,0,30,4
1649803951215,COGS 102A,A01,083978,Johnson; Christine M.,28,0,30,2
1649803957248,COGS 107B,A01,083980,Staff,45,0,50,5
1649803963279,COGS 115,A01,083982,Staff,23,0,30,7
1649803969304,COGS 118B,A01,083367,Staff,12,0,40,28
1649803975358,COGS 172,A01,083984,Provenzano; Emily Kara,25,0,30,5
1649803981392,COGS 177,A00,083368,Staff,15,0,30,15
1649803987419,COGS 186,A01,083986,Staff,28,0,40,12
1649803993444,COGS 187A,A01,083988,Boyle; Mary E. T.,50,0,60,10
1649803999472,CSE 8A,A50,084003,Miranda; Gregory Joseph,11,0,15,4
1649804005495,CSE 11,A01,084005,Miranda; Gregory Joseph,51,0,55,4
1649804011526,CSE 20,A01,084007,Staff,17,0,20,3
1649804017549,CSE 21,A01,084009,Staff,43,0,50,7
1649804023572,CSE 30,A01,083370,Cao; Yingjun,28,0,40,12
1649804029605,CSE 100,A01,083372,Cao; Yingjun,33,0,40,7
1649804035630,CSE 101,A01,084011,Staff,11,0,40,29
1649804041669,CSE 141,A01,083374,Eldon; John,14,0,75,61
1649804047695,CSE 141L,A01,083376,Eldon; John,14,0,75,61
1649804053718,CSE 175,A01,084013,Kumar; Rakesh,25,0,25,0
1649804059759,CSE 190,A00,092508,Staff,15,0,15,0
1649804065785,ECE 5,A01,084049,Morris; Karcher William,18,0,20,2
1649804071812,ECE 100,A01,084051,Baghdadchi; Saharnaz,17,0,20,3
1649804071812,ECE 100,A02,091916,Baghdadchi; Saharnaz,19,0,20,1
1649804077840,ECE 101,A01,084053,Baghdadchi; Saharnaz,29,0,37,8
1649804077840,ECE 101,A02,084054,Baghdadchi; Saharnaz,37,0,37,0
1649804083863,ECE 107,A01,083390,Staff,35,0,40,5
1649804089897,ECE 148,A01,084056,Silberman; Jack,8,0,12,4
1649804095921,ECE 180,A00,083391,Abi Samra; Nicholas Camill,27,0,30,3
1649804095921,ECE 180,B00,083392,Abi Samra; Nicholas Camill,26,0,30,4
1649804101952,MATH 10B,A01,084110,Staff,23,0,30,7
1649804101952,MATH 10B,A02,084111,Staff,29,0,30,1
1649804101952,MATH 10B,A03,084112,Staff,30,0,30,0
1649804107975,MATH 10C,A01,083443,Staff,24,0,30,6
1649804107975,MATH 10C,A02,083444,Staff,26,0,30,4
1649804107975,MATH 10C,B01,084114,Staff,27,0,30,3
1649804107975,MATH 10C,B02,084115,Staff,30,0,30,0
1649804114000,MATH 18,A01,084117,Harel; Guershon,28,0,30,2
1649804114000,MATH 18,A02,084119,Harel; Guershon,29,0,30,1
1649804114000,MATH 18,A03,084120,Harel; Guershon,30,0,30,0
1649804114000,MATH 18,A04,084121,Harel; Guershon,30,0,30,0
1649804120024,MATH 20B,A01,084124,Um; Ko Woon,34,0,35,1
1649804120024,MATH 20B,B01,084126,Um; Ko Woon,35,0,35,0
1649804126050,MATH 20C,A01,083446,Hammock; Frances H,27,0,30,3
1649804126050,MATH 20C,A02,083447,Hammock; Frances H,30,0,30,0
1649804126050,MATH 20C,A03,083448,Hammock; Frances H,30,0,30,0
1649804126050,MATH 20C,A04,083449,Hammock; Frances H,30,0,30,0
1649804126050,MATH 20C,B01,083451,Hammock; Frances H,30,0,30,0
1649804126050,MATH 20C,B02,083452,Hammock; Frances H,30,0,30,0
1649804126050,MATH 20C,B03,083453,Hammock; Frances H,30,0,30,0
1649804126050,MATH 20C,B04,083454,Hammock; Frances H,30,0,30,0
1649804132076,MATH 20D,A01,084128,Staff,30,0,30,0
1649804132076,MATH 20D,A02,084129,Staff,30,0,30,0
1649804132076,MATH 20D,A03,084130,Staff,29,0,30,1
1649804132076,MATH 20D,B01,084133,Staff,29,0,30,1
1649804132076,MATH 20D,B02,084134,Staff,30,0,30,0
1649804132076,MATH 20D,B03,084135,Staff,30,0,30,0
1649804138104,MATH 20E,A01,084138,Staff,30,0,30,0
1649804138104,MATH 20E,A02,084139,Staff,29,0,30,1
1649804138104,MATH 20E,A03,084140,Staff,30,0,30,0
1649804138104,MATH 20E,A04,084141,Staff,30,0,30,0
1649804144126,MATH 102,A01,084143,Harel; Guershon,25,0,30,5
1649804144126,MATH 102,A02,084144,Harel; Guershon,28,0,30,2
1649804150149,MATH 103B,A01,083456,Staff,13,0,30,17
1649804150149,MATH 103B,A02,083457,Staff,25,0,30,5
1649804156183,MATH 109,A01,084146,Salehi Golsefidy; Alireza,30,0,30,0
1649804156183,MATH 109,A02,084147,Salehi Golsefidy; Alireza,27,0,30,3
1649804162216,MATH 120A,A01,085445,Eggers; John Dietrich,31,0,35,4
1649804162216,MATH 120A,A02,085446,Eggers; John Dietrich,33,0,35,2
1649804168248,MATH 142B,A01,084149,Verstraete; Jacques Allan,20,0,30,10
1649804168248,MATH 142B,A02,084150,Verstraete; Jacques Allan,26,0,30,4
1649804174272,MATH 170A,A01,083459,Nie; Jiawang,16,0,30,14
1649804174272,MATH 170A,A02,083460,Nie; Jiawang,26,0,30,4
1649804174272,MATH 170A,A03,083461,Nie; Jiawang,28,0,30,2
1649804180298,MATH 193B,A01,083463,Staff,22,0,30,8
1649804180298,MATH 193B,A02,083464,Staff,24,0,30,6
1649804180298,MATH 193B,A03,083465,Staff,30,0,30,0
1649804186359,COGS 2,A01,083966,Boyle; Mary E. T.,28,0,30,2
1649804192398,COGS 9,A01,083968,Staff,57,0,60,3
1649804198424,COGS 14B,A01,083970,Staff,49,0,50,1
1649804204449,COGS 100,A01,083972,Staff,52,0,60,8
1649804216517,COGS 101C,A01,083976,Staff,26,0,30,4
1649804222539,COGS 102A,A01,083978,Johnson; Christine M.,28,0,30,2
1649804228565,COGS 107B,A01,083980,Staff,45,0,50,5
1649804234593,COGS 115,A01,083982,Staff,23,0,30,7
1649804240617,COGS 118B,A01,083367,Staff,11,0,40,29
1649804246649,COGS 172,A01,083984,Provenzano; Emily Kara,25,0,30,5
1649804252673,COGS 177,A00,083368,Staff,15,0,30,15
1649804258705,COGS 186,A01,083986,Staff,28,0,40,12
1649804264731,COGS 187A,A01,083988,Boyle; Mary E. T.,50,0,60,10
1649804270758,CSE 8A,A50,084003,Miranda; Gregory Joseph,11,0,15,4
1649804276782,CSE 11,A01,084005,Miranda; Gregory Joseph,51,0,55,4
1649804282807,CSE 20,A01,084007,Staff,17,0,20,3
1649804288831,CSE 21,A01,084009,Staff,43,0,50,7
1649804294861,CSE 30,A01,083370,Cao; Yingjun,28,0,40,12
1649804300886,CSE 100,A01,083372,Cao; Yingjun,33,0,40,7
1649804306922,CSE 101,A01,084011,Staff,11,0,40,29
1649804312952,CSE 141,A01,083374,Eldon; John,14,0,75,61
1649804318976,CSE 141L,A01,083376,Eldon; John,14,0,75,61
1649804324998,CSE 175,A01,084013,Kumar; Rakesh,25,0,25,0
1649804331110,CSE 190,A00,092508,Staff,15,0,15,0
1649804337132,ECE 5,A01,084049,Morris; Karcher William,18,0,20,2
1649804343159,ECE 100,A01,084051,Baghdadchi; Saharnaz,17,0,20,3
1649804343159,ECE 100,A02,091916,Baghdadchi; Saharnaz,19,0,20,1
1649804349194,ECE 101,A01,084053,Baghdadchi; Saharnaz,29,0,37,8
1649804349194,ECE 101,A02,084054,Baghdadchi; Saharnaz,37,0,37,0
1649804355225,ECE 107,A01,083390,Staff,35,0,40,5
1649804361258,ECE 148,A01,084056,Silberman; Jack,8,0,12,4
1649804367288,ECE 180,A00,083391,Abi Samra; Nicholas Camill,27,0,30,3
1649804367288,ECE 180,B00,083392,Abi Samra; Nicholas Camill,26,0,30,4
1649804373319,MATH 10B,A01,084110,Staff,23,0,30,7
1649804373319,MATH 10B,A02,084111,Staff,29,0,30,1
1649804373319,MATH 10B,A03,084112,Staff,30,0,30,0
1649804379343,MATH 10C,A01,083443,Staff,24,0,30,6
1649804379343,MATH 10C,A02,083444,Staff,26,0,30,4
1649804379343,MATH 10C,B01,084114,Staff,27,0,30,3
1649804379343,MATH 10C,B02,084115,Staff,30,0,30,0
1649804385371,MATH 18,A01,084117,Harel; Guershon,28,0,30,2
1649804385371,MATH 18,A02,084119,Harel; Guershon,29,0,30,1
1649804385371,MATH 18,A03,084120,Harel; Guershon,30,0,30,0
1649804385371,MATH 18,A04,084121,Harel; Guershon,30,0,30,0
1649804391396,MATH 20B,A01,084124,Um; Ko Woon,34,0,35,1
1649804391396,MATH 20B,B01,084126,Um; Ko Woon,35,0,35,0
1649804397440,MATH 20C,A01,083446,Hammock; Frances H,27,0,30,3
1649804397440,MATH 20C,A02,083447,Hammock; Frances H,30,0,30,0
1649804397440,MATH 20C,A03,083448,Hammock; Frances H,30,0,30,0
1649804397440,MATH 20C,A04,083449,Hammock; Frances H,30,0,30,0
1649804397440,MATH 20C,B01,083451,Hammock; Frances H,30,0,30,0
1649804397440,MATH 20C,B02,083452,Hammock; Frances H,30,0,30,0
1649804397440,MATH 20C,B03,083453,Hammock; Frances H,30,0,30,0
1649804397440,MATH 20C,B04,083454,Hammock; Frances H,30,0,30,0
1649804403463,MATH 20D,A01,084128,Staff,30,0,30,0
1649804403463,MATH 20D,A02,084129,Staff,30,0,30,0
1649804403463,MATH 20D,A03,084130,Staff,29,0,30,1
1649804403463,MATH 20D,B01,084133,Staff,29,0,30,1
1649804403463,MATH 20D,B02,084134,Staff,30,0,30,0
1649804403463,MATH 20D,B03,084135,Staff,30,0,30,0
1649804409495,MATH 20E,A01,084138,Staff,30,0,30,0
1649804409495,MATH 20E,A02,084139,Staff,29,0,30,1
1649804409495,MATH 20E,A03,084140,Staff,30,0,30,0
1649804409495,MATH 20E,A04,084141,Staff,30,0,30,0
1649804415517,MATH 102,A01,084143,Harel; Guershon,25,0,30,5
1649804415517,MATH 102,A02,084144,Harel; Guershon,28,0,30,2
1649804421543,MATH 103B,A01,083456,Staff,13,0,30,17
1649804421543,MATH 103B,A02,083457,Staff,25,0,30,5
1649804427578,MATH 109,A01,084146,Salehi Golsefidy; Alireza,30,0,30,0
1649804427578,MATH 109,A02,084147,Salehi Golsefidy; Alireza,27,0,30,3
1649804433605,MATH 120A,A01,085445,Eggers; John Dietrich,31,0,35,4
1649804433605,MATH 120A,A02,085446,Eggers; John Dietrich,33,0,35,2
1649804439633,MATH 142B,A01,084149,Verstraete; Jacques Allan,20,0,30,10
1649804439633,MATH 142B,A02,084150,Verstraete; Jacques Allan,26,0,30,4
1649804445660,MATH 170A,A01,083459,Nie; Jiawang,16,0,30,14
1649804445660,MATH 170A,A02,083460,Nie; Jiawang,26,0,30,4
1649804445660,MATH 170A,A03,083461,Nie; Jiawang,28,0,30,2
1649804451684,MATH 193B,A01,083463,Staff,22,0,30,8
1649804451684,MATH 193B,A02,083464,Staff,24,0,30,6
1649804451684,MATH 193B,A03,083465,Staff,30,0,30,0
1649804457743,COGS 2,A01,083966,Boyle; Mary E. T.,28,0,30,2
1649804463778,COGS 9,A01,083968,Staff,57,0,60,3
1649804469830,COGS 14B,A01,083970,Staff,49,0,50,1
1649804475854,COGS 100,A01,083972,Staff,52,0,60,8
1649804487909,COGS 101C,A01,083976,Staff,26,0,30,4
1649804493933,COGS 102A,A01,083978,Johnson; Christine M.,28,0,30,2
1649804499969,COGS 107B,A01,083980,Staff,44,0,50,6
1649804505991,COGS 115,A01,083982,Staff,23,0,30,7
1649804512022,COGS 118B,A01,083367,Staff,11,0,40,29
1649804518045,COGS 172,A01,083984,Provenzano; Emily Kara,25,0,30,5
1649804524069,COGS 177,A00,083368,Staff,15,0,30,15
1649804530098,COGS 186,A01,083986,Staff,28,0,40,12
1649804536124,COGS 187A,A01,083988,Boyle; Mary E. T.,50,0,60,10
1649804542147,CSE 8A,A50,084003,Miranda; Gregory Joseph,11,0,15,4
1649804548174,CSE 11,A01,084005,Miranda; Gregory Joseph,51,0,55,4
1649804554198,CSE 20,A01,084007,Staff,17,0,20,3
1649804560230,CSE 21,A01,084009,Staff,43,0,50,7
1649804566252,CSE 30,A01,083370,Cao; Yingjun,28,0,40,12
1649804572283,CSE 100,A01,083372,Cao; Yingjun,33,0,40,7
1649804578349,CSE 101,A01,084011,Staff,11,0,40,29
1649804584371,CSE 141,A01,083374,Eldon; John,14,0,75,61
1649804590394,CSE 141L,A01,083376,Eldon; John,14,0,75,61
1649804596424,CSE 175,A01,084013,Kumar; Rakesh,25,0,25,0
1649804602462,CSE 190,A00,092508,Staff,15,0,15,0
1649804608490,ECE 5,A01,084049,Morris; Karcher William,18,0,20,2
1649804614514,ECE 100,A01,084051,Baghdadchi; Saharnaz,17,0,20,3
1649804614514,ECE 100,A02,091916,Baghdadchi; Saharnaz,19,0,20,1
1649804620538,ECE 101,A01,084053,Baghdadchi; Saharnaz,28,0,37,9
1649804620538,ECE 101,A02,084054,Baghdadchi; Saharnaz,37,0,37,0
1649804626567,ECE 107,A01,083390,Staff,35,0,40,5
1649804632591,ECE 148,A01,084056,Silberman; Jack,8,0,12,4
1649804638617,ECE 180,A00,083391,Abi Samra; Nicholas Camill,27,0,30,3
1649804638617,ECE 180,B00,083392,Abi Samra; Nicholas Camill,26,0,30,4
1649804644650,MATH 10B,A01,084110,Staff,22,0,30,8
1649804644650,MATH 10B,A02,084111,Staff,29,0,30,1
1649804644650,MATH 10B,A03,084112,Staff,30,0,30,0
1649804650676,MATH 10C,A01,083443,Staff,24,0,30,6
1649804650676,MATH 10C,A02,083444,Staff,26,0,30,4
1649804650676,MATH 10C,B01,084114,Staff,27,0,30,3
1649804650676,MATH 10C,B02,084115,Staff,30,0,30,0
1649804656707,MATH 18,A01,084117,Harel; Guershon,28,0,30,2
1649804656707,MATH 18,A02,084119,Harel; Guershon,29,0,30,1
1649804656707,MATH 18,A03,084120,Harel; Guershon,30,0,30,0
1649804656707,MATH 18,A04,084121,Harel; Guershon,30,0,30,0
1649804662732,MATH 20B,A01,084124,Um; Ko Woon,34,0,35,1
1649804662732,MATH 20B,B01,084126,Um; Ko Woon,35,0,35,0
1649804668759,MATH 20C,A01,083446,Hammock; Frances H,27,0,30,3
1649804668759,MATH 20C,A02,083447,Hammock; Frances H,30,0,30,0
1649804668759,MATH 20C,A03,083448,Hammock; Frances H,30,0,30,0
1649804668759,MATH 20C,A04,083449,Hammock; Frances H,30,0,30,0
1649804668759,MATH 20C,B01,083451,Hammock; Frances H,30,0,30,0
1649804668759,MATH 20C,B02,083452,Hammock; Frances H,30,0,30,0
1649804668759,MATH 20C,B03,083453,Hammock; Frances H,30,0,30,0
1649804668759,MATH 20C,B04,083454,Hammock; Frances H,30,0,30,0
1649804674783,MATH 20D,A01,084128,Staff,30,0,30,0
1649804674783,MATH 20D,A02,084129,Staff,30,0,30,0
1649804674783,MATH 20D,A03,084130,Staff,29,0,30,1
1649804674783,MATH 20D,B01,084133,Staff,29,0,30,1
1649804674783,MATH 20D,B02,084134,Staff,30,0,30,0
1649804674783,MATH 20D,B03,084135,Staff,30,0,30,0
1649804680811,MATH 20E,A01,084138,Staff,30,0,30,0
1649804680811,MATH 20E,A02,084139,Staff,29,0,30,1
1649804680811,MATH 20E,A03,084140,Staff,30,0,30,0
1649804680811,MATH 20E,A04,084141,Staff,30,0,30,0
1649804686835,MATH 102,A01,084143,Harel; Guershon,25,0,30,5
1649804686835,MATH 102,A02,084144,Harel; Guershon,28,0,30,2
1649804692875,MATH 103B,A01,083456,Staff,13,0,30,17
1649804692875,MATH 103B,A02,083457,Staff,24,0,30,6
1649804698899,MATH 109,A01,084146,Salehi Golsefidy; Alireza,30,0,30,0
1649804698899,MATH 109,A02,084147,Salehi Golsefidy; Alireza,27,0,30,3
1649804704922,MATH 120A,A01,085445,Eggers; John Dietrich,31,0,35,4
1649804704922,MATH 120A,A02,085446,Eggers; John Dietrich,33,0,35,2
1649804710945,MATH 142B,A01,084149,Verstraete; Jacques Allan,20,0,30,10
1649804710945,MATH 142B,A02,084150,Verstraete; Jacques Allan,26,0,30,4
1649804716980,MATH 170A,A01,083459,Nie; Jiawang,16,0,30,14
1649804716980,MATH 170A,A02,083460,Nie; Jiawang,26,0,30,4
1649804716980,MATH 170A,A03,083461,Nie; Jiawang,28,0,30,2
1649804723013,MATH 193B,A01,083463,Staff,22,0,30,8
1649804723013,MATH 193B,A02,083464,Staff,24,0,30,6
1649804723013,MATH 193B,A03,083465,Staff,30,0,30,0
1649804729064,COGS 2,A01,083966,Boyle; Mary E. T.,28,0,30,2
1649804735091,COGS 9,A01,083968,Staff,57,0,60,3
1649804741114,COGS 14B,A01,083970,Staff,49,0,50,1
1649804747140,COGS 100,A01,083972,Staff,52,0,60,8
1649804759188,COGS 101C,A01,083976,Staff,26,0,30,4
1649804765210,COGS 102A,A01,083978,Johnson; Christine M.,28,0,30,2
1649804771232,COGS 107B,A01,083980,Staff,44,0,50,6
1649804777257,COGS 115,A01,083982,Staff,23,0,30,7
1649804783280,COGS 118B,A01,083367,Staff,11,0,40,29
1649804789308,COGS 172,A01,083984,Provenzano; Emily Kara,25,0,30,5
1649804795330,COGS 177,A00,083368,Staff,15,0,30,15
1649804801357,COGS 186,A01,083986,Staff,28,0,40,12
1649804807381,COGS 187A,A01,083988,Boyle; Mary E. T.,50,0,60,10
1649804813422,CSE 8A,A50,084003,Miranda; Gregory Joseph,11,0,15,4
1649804819447,CSE 11,A01,084005,Miranda; Gregory Joseph,51,0,55,4
1649804825471,CSE 20,A01,084007,Staff,17,0,20,3
1649804831495,CSE 21,A01,084009,Staff,43,0,50,7
1649804837519,CSE 30,A01,083370,Cao; Yingjun,28,0,40,12
1649804843555,CSE 100,A01,083372,Cao; Yingjun,33,0,40,7
1649804849586,CSE 101,A01,084011,Staff,11,0,40,29
1649804855611,CSE 141,A01,083374,Eldon; John,14,0,75,61
1649804861647,CSE 141L,A01,083376,Eldon; John,14,0,75,61
1649804867670,CSE 175,A01,084013,Kumar; Rakesh,25,0,25,0
1649804873702,CSE 190,A00,092508,Staff,15,0,15,0
1649804879729,ECE 5,A01,084049,Morris; Karcher William,18,0,20,2
1649804885752,ECE 100,A01,084051,Baghdadchi; Saharnaz,17,0,20,3
1649804885752,ECE 100,A02,091916,Baghdadchi; Saharnaz,19,0,20,1
1649804891776,ECE 101,A01,084053,Baghdadchi; Saharnaz,27,0,37,10
1649804891776,ECE 101,A02,084054,Baghdadchi; Saharnaz,37,0,37,0
1649804897803,ECE 107,A01,083390,Staff,35,0,40,5
1649804903841,ECE 148,A01,084056,Silberman; Jack,8,0,12,4
1649804909867,ECE 180,A00,083391,Abi Samra; Nicholas Camill,27,0,30,3
1649804909867,ECE 180,B00,083392,Abi Samra; Nicholas Camill,26,0,30,4
1649804915901,MATH 10B,A01,084110,Staff,22,0,30,8
1649804915901,MATH 10B,A02,084111,Staff,29,0,30,1
1649804915901,MATH 10B,A03,084112,Staff,30,0,30,0
1649804921927,MATH 10C,A01,083443,Staff,24,0,30,6
1649804921927,MATH 10C,A02,083444,Staff,26,0,30,4
1649804921927,MATH 10C,B01,084114,Staff,27,0,30,3
1649804921927,MATH 10C,B02,084115,Staff,30,0,30,0
1649804928051,MATH 18,A01,084117,Harel; Guershon,28,0,30,2
1649804928051,MATH 18,A02,084119,Harel; Guershon,29,0,30,1
1649804928051,MATH 18,A03,084120,Harel; Guershon,30,0,30,0
1649804928051,MATH 18,A04,084121,Harel; Guershon,30,0,30,0
1649804934074,MATH 20B,A01,084124,Um; Ko Woon,34,0,35,1
1649804934074,MATH 20B,B01,084126,Um; Ko Woon,35,0,35,0
1649804940104,MATH 20C,A01,083446,Hammock; Frances H,27,0,30,3
1649804940104,MATH 20C,A02,083447,Hammock; Frances H,30,0,30,0
1649804940104,MATH 20C,A03,083448,Hammock; Frances H,30,0,30,0
1649804940104,MATH 20C,A04,083449,Hammock; Frances H,30,0,30,0
1649804940104,MATH 20C,B01,083451,Hammock; Frances H,30,0,30,0
1649804940104,MATH 20C,B02,083452,Hammock; Frances H,30,0,30,0
1649804940104,MATH 20C,B03,083453,Hammock; Frances H,30,0,30,0
1649804940104,MATH 20C,B04,083454,Hammock; Frances H,30,0,30,0
1649804946126,MATH 20D,A01,084128,Staff,30,0,30,0
1649804946126,MATH 20D,A02,084129,Staff,30,0,30,0
1649804946126,MATH 20D,A03,084130,Staff,29,0,30,1
1649804946126,MATH 20D,B01,084133,Staff,29,0,30,1
1649804946126,MATH 20D,B02,084134,Staff,30,0,30,0
1649804946126,MATH 20D,B03,084135,Staff,30,0,30,0
1649804952152,MATH 20E,A01,084138,Staff,30,0,30,0
1649804952152,MATH 20E,A02,084139,Staff,29,0,30,1
1649804952152,MATH 20E,A03,084140,Staff,30,0,30,0
1649804952152,MATH 20E,A04,084141,Staff,30,0,30,0
1649804958198,MATH 102,A01,084143,Harel; Guershon,25,0,30,5
1649804958198,MATH 102,A02,084144,Harel; Guershon,28,0,30,2
1649804964226,MATH 103B,A01,083456,Staff,13,0,30,17
1649804964226,MATH 103B,A02,083457,Staff,24,0,30,6
1649804970252,MATH 109,A01,084146,Salehi Golsefidy; Alireza,30,0,30,0
1649804970252,MATH 109,A02,084147,Salehi Golsefidy; Alireza,27,0,30,3
1649804976284,MATH 120A,A01,085445,Eggers; John Dietrich,31,0,35,4
1649804976284,MATH 120A,A02,085446,Eggers; John Dietrich,32,0,35,3
1649804982310,MATH 142B,A01,084149,Verstraete; Jacques Allan,20,0,30,10
1649804982310,MATH 142B,A02,084150,Verstraete; Jacques Allan,26,0,30,4
1649804988335,MATH 170A,A01,083459,Nie; Jiawang,16,0,30,14
1649804988335,MATH 170A,A02,083460,Nie; Jiawang,26,0,30,4
1649804988335,MATH 170A,A03,083461,Nie; Jiawang,28,0,30,2
1649804994367,MATH 193B,A01,083463,Staff,22,0,30,8
1649804994367,MATH 193B,A02,083464,Staff,24,0,30,6
1649804994367,MATH 193B,A03,083465,Staff,30,0,30,0
1649805000435,COGS 2,A01,083966,Boyle; Mary E. T.,28,0,30,2
1649805006462,COGS 9,A01,083968,Staff,57,0,60,3
1649805012487,COGS 14B,A01,083970,Staff,49,0,50,1
1649805018522,COGS 100,A01,083972,Staff,52,0,60,8
1649805030585,COGS 101C,A01,083976,Staff,26,0,30,4
1649805036613,COGS 102A,A01,083978,Johnson; Christine M.,28,0,30,2
1649805042647,COGS 107B,A01,083980,Staff,43,0,50,7
1649805048669,COGS 115,A01,083982,Staff,23,0,30,7
1649805054694,COGS 118B,A01,083367,Staff,11,0,40,29
1649805060719,COGS 172,A01,083984,Provenzano; Emily Kara,25,0,30,5
1649805066743,COGS 177,A00,083368,Staff,15,0,30,15
1649805072770,COGS 186,A01,083986,Staff,28,0,40,12
1649805078792,COGS 187A,A01,083988,Boyle; Mary E. T.,49,0,60,11
1649805084815,CSE 8A,A50,084003,Miranda; Gregory Joseph,11,0,15,4
1649805090841,CSE 11,A01,084005,Miranda; Gregory Joseph,51,0,55,4
1649805096877,CSE 20,A01,084007,Staff,17,0,20,3
1649805102901,CSE 21,A01,084009,Staff,43,0,50,7
1649805108923,CSE 30,A01,083370,Cao; Yingjun,28,0,40,12
1649805114946,CSE 100,A01,083372,Cao; Yingjun,33,0,40,7
1649805120982,CSE 101,A01,084011,Staff,11,0,40,29
1649805127005,CSE 141,A01,083374,Eldon; John,14,0,75,61
1649805133045,CSE 141L,A01,083376,Eldon; John,14,0,75,61
1649805139070,CSE 175,A01,084013,Kumar; Rakesh,25,0,25,0
1649805145096,CSE 190,A00,092508,Staff,15,0,15,0
1649805151119,ECE 5,A01,084049,Morris; Karcher William,18,0,20,2
1649805157142,ECE 100,A01,084051,Baghdadchi; Saharnaz,17,0,20,3
1649805157142,ECE 100,A02,091916,Baghdadchi; Saharnaz,19,0,20,1
1649805163169,ECE 101,A01,084053,Baghdadchi; Saharnaz,27,0,37,10
1649805163169,ECE 101,A02,084054,Baghdadchi; Saharnaz,37,0,37,0
1649805169199,ECE 107,A01,083390,Staff,35,0,40,5
1649805175222,ECE 148,A01,084056,Silberman; Jack,8,0,12,4
1649805181247,ECE 180,A00,083391,Abi Samra; Nicholas Camill,27,0,30,3
1649805181247,ECE 180,B00,083392,Abi Samra; Nicholas Camill,26,0,30,4
1649805187271,MATH 10B,A01,084110,Staff,22,0,30,8
1649805187271,MATH 10B,A02,084111,Staff,29,0,30,1
1649805187271,MATH 10B,A03,084112,Staff,30,0,30,0
1649805193295,MATH 10C,A01,083443,Staff,24,0,30,6
1649805193295,MATH 10C,A02,083444,Staff,26,0,30,4
1649805193295,MATH 10C,B01,084114,Staff,27,0,30,3
1649805193295,MATH 10C,B02,084115,Staff,30,0,30,0
1649805199323,MATH 18,A01,084117,Harel; Guershon,28,0,30,2
1649805199323,MATH 18,A02,084119,Harel; Guershon,29,0,30,1
1649805199323,MATH 18,A03,084120,Harel; Guershon,30,0,30,0
1649805199323,MATH 18,A04,084121,Harel; Guershon,30,0,30,0
1649805205346,MATH 20B,A01,084124,Um; Ko Woon,33,0,35,2
1649805205346,MATH 20B,B01,084126,Um; Ko Woon,35,0,35,0
1649805211380,MATH 20C,A01,083446,Hammock; Frances H,27,0,30,3
1649805211380,MATH 20C,A02,083447,Hammock; Frances H,30,0,30,0
1649805211380,MATH 20C,A03,083448,Hammock; Frances H,30,0,30,0
1649805211380,MATH 20C,A04,083449,Hammock; Frances H,30,0,30,0
1649805211380,MATH 20C,B01,083451,Hammock; Frances H,30,0,30,0
1649805211380,MATH 20C,B02,083452,Hammock; Frances H,30,0,30,0
1649805211380,MATH 20C,B03,083453,Hammock; Frances H,30,0,30,0
1649805211380,MATH 20C,B04,083454,Hammock; Frances H,30,0,30,0
1649805217408,MATH 20D,A01,084128,Staff,30,0,30,0
1649805217408,MATH 20D,A02,084129,Staff,30,0,30,0
1649805217408,MATH 20D,A03,084130,Staff,29,0,30,1
1649805217408,MATH 20D,B01,084133,Staff,29,0,30,1
1649805217408,MATH 20D,B02,084134,Staff,30,0,30,0
1649805217408,MATH 20D,B03,084135,Staff,30,0,30,0
1649805223432,MATH 20E,A01,084138,Staff,30,0,30,0
1649805223432,MATH 20E,A02,084139,Staff,29,0,30,1
1649805223432,MATH 20E,A03,084140,Staff,30,0,30,0
1649805223432,MATH 20E,A04,084141,Staff,30,0,30,0
1649805229455,MATH 102,A01,084143,Harel; Guershon,25,0,30,5
1649805229455,MATH 102,A02,084144,Harel; Guershon,28,0,30,2
1649805235478,MATH 103B,A01,083456,Staff,13,0,30,17
1649805235478,MATH 103B,A02,083457,Staff,24,0,30,6
1649805241502,MATH 109,A01,084146,Salehi Golsefidy; Alireza,30,0,30,0
1649805241502,MATH 109,A02,084147,Salehi Golsefidy; Alireza,27,0,30,3
1649805247528,MATH 120A,A01,085445,Eggers; John Dietrich,31,0,35,4
1649805247528,MATH 120A,A02,085446,Eggers; John Dietrich,32,0,35,3
1649805253556,MATH 142B,A01,084149,Verstraete; Jacques Allan,20,0,30,10
1649805253556,MATH 142B,A02,084150,Verstraete; Jacques Allan,26,0,30,4
1649805259581,MATH 170A,A01,083459,Nie; Jiawang,16,0,30,14
1649805259581,MATH 170A,A02,083460,Nie; Jiawang,26,0,30,4
1649805259581,MATH 170A,A03,083461,Nie; Jiawang,28,0,30,2
1649805265605,MATH 193B,A01,083463,Staff,22,0,30,8
1649805265605,MATH 193B,A02,083464,Staff,24,0,30,6
1649805265605,MATH 193B,A03,083465,Staff,30,0,30,0
1649805271665,COGS 2,A01,083966,Boyle; Mary E. T.,28,0,30,2
1649805277705,COGS 9,A01,083968,Staff,57,0,60,3
1649805283736,COGS 14B,A01,083970,Staff,49,0,50,1
1649805289762,COGS 100,A01,083972,Staff,52,0,60,8
1649805301812,COGS 101C,A01,083976,Staff,26,0,30,4
1649805307842,COGS 102A,A01,083978,Johnson; Christine M.,28,0,30,2
1649805313881,COGS 107B,A01,083980,Staff,43,0,50,7
1649805319904,COGS 115,A01,083982,Staff,23,0,30,7
1649805325931,COGS 118B,A01,083367,Staff,11,0,40,29
1649805331953,COGS 172,A01,083984,Provenzano; Emily Kara,25,0,30,5
1649805337976,COGS 177,A00,083368,Staff,15,0,30,15
1649805344000,COGS 186,A01,083986,Staff,28,0,40,12
1649805350030,COGS 187A,A01,083988,Boyle; Mary E. T.,49,0,60,11
1649805356059,CSE 8A,A50,084003,Miranda; Gregory Joseph,11,0,15,4
1649805362091,CSE 11,A01,084005,Miranda; Gregory Joseph,51,0,55,4
1649805368131,CSE 20,A01,084007,Staff,17,0,20,3
1649805374156,CSE 21,A01,084009,Staff,43,0,50,7
1649805380180,CSE 30,A01,083370,Cao; Yingjun,28,0,40,12
1649805386206,CSE 100,A01,083372,Cao; Yingjun,33,0,40,7
1649805392232,CSE 101,A01,084011,Staff,11,0,40,29
1649805398255,CSE 141,A01,083374,Eldon; John,14,0,75,61
1649805404283,CSE 141L,A01,083376,Eldon; John,14,0,75,61
1649805410307,CSE 175,A01,084013,Kumar; Rakesh,25,0,25,0
1649805416331,CSE 190,A00,092508,Staff,15,0,15,0
1649805422359,ECE 5,A01,084049,Morris; Karcher William,18,0,20,2
1649805428387,ECE 100,A01,084051,Baghdadchi; Saharnaz,17,0,20,3
1649805428387,ECE 100,A02,091916,Baghdadchi; Saharnaz,19,0,20,1
1649805434410,ECE 101,A01,084053,Baghdadchi; Saharnaz,27,0,37,10
1649805434410,ECE 101,A02,084054,Baghdadchi; Saharnaz,37,0,37,0
1649805440438,ECE 107,A01,083390,Staff,35,0,40,5
1649805446464,ECE 148,A01,084056,Silberman; Jack,8,0,12,4
1649805452488,ECE 180,A00,083391,Abi Samra; Nicholas Camill,27,0,30,3
1649805452488,ECE 180,B00,083392,Abi Samra; Nicholas Camill,26,0,30,4
1649805458510,MATH 10B,A01,084110,Staff,22,0,30,8
1649805458510,MATH 10B,A02,084111,Staff,29,0,30,1
1649805458510,MATH 10B,A03,084112,Staff,30,0,30,0
1649805464538,MATH 10C,A01,083443,Staff,24,0,30,6
1649805464538,MATH 10C,A02,083444,Staff,26,0,30,4
1649805464538,MATH 10C,B01,084114,Staff,27,0,30,3
1649805464538,MATH 10C,B02,084115,Staff,30,0,30,0
1649805470564,MATH 18,A01,084117,Harel; Guershon,28,0,30,2
1649805470564,MATH 18,A02,084119,Harel; Guershon,29,0,30,1
1649805470564,MATH 18,A03,084120,Harel; Guershon,30,0,30,0
1649805470564,MATH 18,A04,084121,Harel; Guershon,30,0,30,0
1649805476587,MATH 20B,A01,084124,Um; Ko Woon,33,0,35,2
1649805476587,MATH 20B,B01,084126,Um; Ko Woon,35,0,35,0
1649805482614,MATH 20C,A01,083446,Hammock; Frances H,27,0,30,3
1649805482614,MATH 20C,A02,083447,Hammock; Frances H,30,0,30,0
1649805482614,MATH 20C,A03,083448,Hammock; Frances H,30,0,30,0
1649805482614,MATH 20C,A04,083449,Hammock; Frances H,30,0,30,0
1649805482614,MATH 20C,B01,083451,Hammock; Frances H,30,0,30,0
1649805482614,MATH 20C,B02,083452,Hammock; Frances H,30,0,30,0
1649805482614,MATH 20C,B03,083453,Hammock; Frances H,30,0,30,0
1649805482614,MATH 20C,B04,083454,Hammock; Frances H,30,0,30,0
1649805488642,MATH 20D,A01,084128,Staff,30,0,30,0
1649805488642,MATH 20D,A02,084129,Staff,30,0,30,0
1649805488642,MATH 20D,A03,084130,Staff,29,0,30,1
1649805488642,MATH 20D,B01,084133,Staff,29,0,30,1
1649805488642,MATH 20D,B02,084134,Staff,30,0,30,0
1649805488642,MATH 20D,B03,084135,Staff,30,0,30,0
1649805494666,MATH 20E,A01,084138,Staff,30,0,30,0
1649805494666,MATH 20E,A02,084139,Staff,29,0,30,1
1649805494666,MATH 20E,A03,084140,Staff,30,0,30,0
1649805494666,MATH 20E,A04,084141,Staff,30,0,30,0
1649805500693,MATH 102,A01,084143,Harel; Guershon,25,0,30,5
1649805500693,MATH 102,A02,084144,Harel; Guershon,28,0,30,2
1649805506724,MATH 103B,A01,083456,Staff,13,0,30,17
1649805506724,MATH 103B,A02,083457,Staff,24,0,30,6
1649805512750,MATH 109,A01,084146,Salehi Golsefidy; Alireza,30,0,30,0
1649805512750,MATH 109,A02,084147,Salehi Golsefidy; Alireza,27,0,30,3
1649805518780,MATH 120A,A01,085445,Eggers; John Dietrich,31,0,35,4
1649805518780,MATH 120A,A02,085446,Eggers; John Dietrich,32,0,35,3
1649805524876,MATH 142B,A01,084149,Verstraete; Jacques Allan,20,0,30,10
1649805524876,MATH 142B,A02,084150,Verstraete; Jacques Allan,26,0,30,4
1649805530903,MATH 170A,A01,083459,Nie; Jiawang,16,0,30,14
1649805530903,MATH 170A,A02,083460,Nie; Jiawang,26,0,30,4
1649805530903,MATH 170A,A03,083461,Nie; Jiawang,28,0,30,2
1649805536931,MATH 193B,A01,083463,Staff,22,0,30,8
1649805536931,MATH 193B,A02,083464,Staff,24,0,30,6
1649805536931,MATH 193B,A03,083465,Staff,30,0,30,0
1649805543000,COGS 2,A01,083966,Boyle; Mary E. T.,28,0,30,2
1649805549025,COGS 9,A01,083968,Staff,57,0,60,3
1649805555053,COGS 14B,A01,083970,Staff,49,0,50,1
1649805561093,COGS 100,A01,083972,Staff,52,0,60,8
1649805573140,COGS 101C,A01,083976,Staff,26,0,30,4
1649805579167,COGS 102A,A01,083978,Johnson; Christine M.,28,0,30,2
1649805585195,COGS 107B,A01,083980,Staff,43,0,50,7
1649805591222,COGS 115,A01,083982,Staff,23,0,30,7
1649805597252,COGS 118B,A01,083367,Staff,11,0,40,29
1649805603280,COGS 172,A01,083984,Provenzano; Emily Kara,25,0,30,5
1649805609308,COGS 177,A00,083368,Staff,15,0,30,15
1649805615331,COGS 186,A01,083986,Staff,28,0,40,12
1649805621354,COGS 187A,A01,083988,Boyle; Mary E. T.,49,0,60,11
1649805627377,CSE 8A,A50,084003,Miranda; Gregory Joseph,11,0,15,4
1649805633403,CSE 11,A01,084005,Miranda; Gregory Joseph,51,0,55,4
1649805639429,CSE 20,A01,084007,Staff,17,0,20,3
1649805645453,CSE 21,A01,084009,Staff,43,0,50,7
1649805651485,CSE 30,A01,083370,Cao; Yingjun,28,0,40,12
1649805657513,CSE 100,A01,083372,Cao; Yingjun,33,0,40,7
1649805663544,CSE 101,A01,084011,Staff,11,0,40,29
1649805669586,CSE 141,A01,083374,Eldon; John,14,0,75,61
1649805675609,CSE 141L,A01,083376,Eldon; John,14,0,75,61
1649805681633,CSE 175,A01,084013,Kumar; Rakesh,25,0,25,0
1649805687660,CSE 190,A00,092508,Staff,15,0,15,0
1649805693687,ECE 5,A01,084049,Morris; Karcher William,18,0,20,2
1649805699729,ECE 100,A01,084051,Baghdadchi; Saharnaz,17,0,20,3
1649805699729,ECE 100,A02,091916,Baghdadchi; Saharnaz,19,0,20,1
1649805705767,ECE 101,A01,084053,Baghdadchi; Saharnaz,27,0,37,10
1649805705767,ECE 101,A02,084054,Baghdadchi; Saharnaz,37,0,37,0
1649805711791,ECE 107,A01,083390,Staff,35,0,40,5
1649805717818,ECE 148,A01,084056,Silberman; Jack,8,0,12,4
1649805723843,ECE 180,A00,083391,Abi Samra; Nicholas Camill,27,0,30,3
1649805723843,ECE 180,B00,083392,Abi Samra; Nicholas Camill,26,0,30,4
1649805729866,MATH 10B,A01,084110,Staff,22,0,30,8
1649805729866,MATH 10B,A02,084111,Staff,29,0,30,1
1649805729866,MATH 10B,A03,084112,Staff,30,0,30,0
1649805735892,MATH 10C,A01,083443,Staff,24,0,30,6
1649805735892,MATH 10C,A02,083444,Staff,26,0,30,4
1649805735892,MATH 10C,B01,084114,Staff,27,0,30,3
1649805735892,MATH 10C,B02,084115,Staff,30,0,30,0
1649805741915,MATH 18,A01,084117,Harel; Guershon,28,0,30,2
1649805741915,MATH 18,A02,084119,Harel; Guershon,29,0,30,1
1649805741915,MATH 18,A03,084120,Harel; Guershon,30,0,30,0
1649805741915,MATH 18,A04,084121,Harel; Guershon,30,0,30,0
1649805747940,MATH 20B,A01,084124,Um; Ko Woon,33,0,35,2
1649805747940,MATH 20B,B01,084126,Um; Ko Woon,35,0,35,0
1649805753993,MATH 20C,A01,083446,Hammock; Frances H,27,0,30,3
1649805753993,MATH 20C,A02,083447,Hammock; Frances H,30,0,30,0
1649805753993,MATH 20C,A03,083448,Hammock; Frances H,30,0,30,0
1649805753993,MATH 20C,A04,083449,Hammock; Frances H,30,0,30,0
1649805753993,MATH 20C,B01,083451,Hammock; Frances H,30,0,30,0
1649805753993,MATH 20C,B02,083452,Hammock; Frances H,30,0,30,0
1649805753993,MATH 20C,B03,083453,Hammock; Frances H,30,0,30,0
1649805753993,MATH 20C,B04,083454,Hammock; Frances H,30,0,30,0
1649805760025,MATH 20D,A01,084128,Staff,30,0,30,0
1649805760025,MATH 20D,A02,084129,Staff,30,0,30,0
1649805760025,MATH 20D,A03,084130,Staff,29,0,30,1
1649805760025,MATH 20D,B01,084133,Staff,28,0,30,2
1649805760025,MATH 20D,B02,084134,Staff,30,0,30,0
1649805760025,MATH 20D,B03,084135,Staff,30,0,30,0
1649805766058,MATH 20E,A01,084138,Staff,30,0,30,0
1649805766058,MATH 20E,A02,084139,Staff,29,0,30,1
1649805766058,MATH 20E,A03,084140,Staff,30,0,30,0
1649805766058,MATH 20E,A04,084141,Staff,30,0,30,0
1649805772088,MATH 102,A01,084143,Harel; Guershon,25,0,30,5
1649805772088,MATH 102,A02,084144,Harel; Guershon,28,0,30,2
1649805778112,MATH 103B,A01,083456,Staff,13,0,30,17
1649805778112,MATH 103B,A02,083457,Staff,24,0,30,6
1649805784137,MATH 109,A01,084146,Salehi Golsefidy; Alireza,30,0,30,0
1649805784137,MATH 109,A02,084147,Salehi Golsefidy; Alireza,27,0,30,3
1649805790169,MATH 120A,A01,085445,Eggers; John Dietrich,31,0,35,4
1649805790169,MATH 120A,A02,085446,Eggers; John Dietrich,32,0,35,3
1649805796196,MATH 142B,A01,084149,Verstraete; Jacques Allan,20,0,30,10
1649805796196,MATH 142B,A02,084150,Verstraete; Jacques Allan,26,0,30,4
1649805802220,MATH 170A,A01,083459,Nie; Jiawang,16,0,30,14
1649805802220,MATH 170A,A02,083460,Nie; Jiawang,26,0,30,4
1649805802220,MATH 170A,A03,083461,Nie; Jiawang,28,0,30,2
1649805808247,MATH 193B,A01,083463,Staff,22,0,30,8
1649805808247,MATH 193B,A02,083464,Staff,24,0,30,6
1649805808247,MATH 193B,A03,083465,Staff,30,0,30,0
1649805814298,COGS 2,A01,083966,Boyle; Mary E. T.,28,0,30,2
1649805820322,COGS 9,A01,083968,Staff,57,0,60,3
1649805826352,COGS 14B,A01,083970,Staff,49,0,50,1
1649805832380,COGS 100,A01,083972,Staff,51,0,60,9
1649805844433,COGS 101C,A01,083976,Staff,26,0,30,4
1649805850456,COGS 102A,A01,083978,Johnson; Christine M.,28,0,30,2
1649805856491,COGS 107B,A01,083980,Staff,43,0,50,7
1649805862518,COGS 115,A01,083982,Staff,23,0,30,7
1649805868548,COGS 118B,A01,083367,Staff,10,0,40,30
1649805874575,COGS 172,A01,083984,Provenzano; Emily Kara,25,0,30,5
1649805880602,COGS 177,A00,083368,Staff,15,0,30,15
1649805886652,COGS 186,A01,083986,Staff,28,0,40,12
1649805892724,COGS 187A,A01,083988,Boyle; Mary E. T.,49,0,60,11
1649805898751,CSE 8A,A50,084003,Miranda; Gregory Joseph,11,0,15,4
1649805904774,CSE 11,A01,084005,Miranda; Gregory Joseph,50,0,55,5
1649805910800,CSE 20,A01,084007,Staff,17,0,20,3
1649805916827,CSE 21,A01,084009,Staff,43,0,50,7
1649805922853,CSE 30,A01,083370,Cao; Yingjun,28,0,40,12
1649805928877,CSE 100,A01,083372,Cao; Yingjun,33,0,40,7
1649805934904,CSE 101,A01,084011,Staff,10,0,40,30
1649805940937,CSE 141,A01,083374,Eldon; John,14,0,75,61
1649805946966,CSE 141L,A01,083376,Eldon; John,14,0,75,61
1649805952992,CSE 175,A01,084013,Kumar; Rakesh,25,0,25,0
1649805959019,CSE 190,A00,092508,Staff,15,0,15,0
1649805965047,ECE 5,A01,084049,Morris; Karcher William,18,0,20,2
1649805971076,ECE 100,A01,084051,Baghdadchi; Saharnaz,17,0,20,3
1649805971076,ECE 100,A02,091916,Baghdadchi; Saharnaz,19,0,20,1
1649805977104,ECE 101,A01,084053,Baghdadchi; Saharnaz,27,0,37,10
1649805977104,ECE 101,A02,084054,Baghdadchi; Saharnaz,37,0,37,0
1649805983133,ECE 107,A01,083390,Staff,35,0,40,5
1649805989160,ECE 148,A01,084056,Silberman; Jack,8,0,12,4
1649805995183,ECE 180,A00,083391,Abi Samra; Nicholas Camill,27,0,30,3
1649805995183,ECE 180,B00,083392,Abi Samra; Nicholas Camill,26,0,30,4
1649806001208,MATH 10B,A01,084110,Staff,22,0,30,8
1649806001208,MATH 10B,A02,084111,Staff,29,0,30,1
1649806001208,MATH 10B,A03,084112,Staff,30,0,30,0
1649806007237,MATH 10C,A01,083443,Staff,24,0,30,6
1649806007237,MATH 10C,A02,083444,Staff,26,0,30,4
1649806007237,MATH 10C,B01,084114,Staff,27,0,30,3
1649806007237,MATH 10C,B02,084115,Staff,30,0,30,0
1649806013277,MATH 18,A01,084117,Harel; Guershon,28,0,30,2
1649806013277,MATH 18,A02,084119,Harel; Guershon,29,0,30,1
1649806013277,MATH 18,A03,084120,Harel; Guershon,30,0,30,0
1649806013277,MATH 18,A04,084121,Harel; Guershon,30,0,30,0
1649806019305,MATH 20B,A01,084124,Um; Ko Woon,33,0,35,2
1649806019305,MATH 20B,B01,084126,Um; Ko Woon,35,0,35,0
1649806025333,MATH 20C,A01,083446,Hammock; Frances H,27,0,30,3
1649806025333,MATH 20C,A02,083447,Hammock; Frances H,30,0,30,0
1649806025333,MATH 20C,A03,083448,Hammock; Frances H,30,0,30,0
1649806025333,MATH 20C,A04,083449,Hammock; Frances H,30,0,30,0
1649806025333,MATH 20C,B01,083451,Hammock; Frances H,30,0,30,0
1649806025333,MATH 20C,B02,083452,Hammock; Frances H,30,0,30,0
1649806025333,MATH 20C,B03,083453,Hammock; Frances H,30,0,30,0
1649806025333,MATH 20C,B04,083454,Hammock; Frances H,30,0,30,0
1649806031361,MATH 20D,A01,084128,Staff,30,0,30,0
1649806031361,MATH 20D,A02,084129,Staff,30,0,30,0
1649806031361,MATH 20D,A03,084130,Staff,29,0,30,1
1649806031361,MATH 20D,B01,084133,Staff,28,0,30,2
1649806031361,MATH 20D,B02,084134,Staff,30,0,30,0
1649806031361,MATH 20D,B03,084135,Staff,30,0,30,0
1649806037396,MATH 20E,A01,084138,Staff,30,0,30,0
1649806037396,MATH 20E,A02,084139,Staff,29,0,30,1
1649806037396,MATH 20E,A03,084140,Staff,30,0,30,0
1649806037396,MATH 20E,A04,084141,Staff,30,0,30,0
1649806043419,MATH 102,A01,084143,Harel; Guershon,25,0,30,5
1649806043419,MATH 102,A02,084144,Harel; Guershon,28,0,30,2
1649806049443,MATH 103B,A01,083456,Staff,13,0,30,17
1649806049443,MATH 103B,A02,083457,Staff,24,0,30,6
1649806055473,MATH 109,A01,084146,Salehi Golsefidy; Alireza,30,0,30,0
1649806055473,MATH 109,A02,084147,Salehi Golsefidy; Alireza,27,0,30,3
1649806061498,MATH 120A,A01,085445,Eggers; John Dietrich,31,0,35,4
1649806061498,MATH 120A,A02,085446,Eggers; John Dietrich,32,0,35,3
1649806067525,MATH 142B,A01,084149,Verstraete; Jacques Allan,20,0,30,10
1649806067525,MATH 142B,A02,084150,Verstraete; Jacques Allan,26,0,30,4
1649806073548,MATH 170A,A01,083459,Nie; Jiawang,16,0,30,14
1649806073548,MATH 170A,A02,083460,Nie; Jiawang,26,0,30,4
1649806073548,MATH 170A,A03,083461,Nie; Jiawang,28,0,30,2
1649806079576,MATH 193B,A01,083463,Staff,22,0,30,8
1649806079576,MATH 193B,A02,083464,Staff,24,0,30,6
1649806079576,MATH 193B,A03,083465,Staff,30,0,30,0
1649806085634,COGS 2,A01,083966,Boyle; Mary E. T.,28,0,30,2
1649806091666,COGS 9,A01,083968,Staff,57,0,60,3
1649806097688,COGS 14B,A01,083970,Staff,49,0,50,1
1649806103724,COGS 100,A01,083972,Staff,51,0,60,9
1649806115857,COGS 101C,A01,083976,Staff,26,0,30,4
1649806121885,COGS 102A,A01,083978,Johnson; Christine M.,28,0,30,2
1649806127909,COGS 107B,A01,083980,Staff,43,0,50,7
1649806133933,COGS 115,A01,083982,Staff,23,0,30,7
1649806139955,COGS 118B,A01,083367,Staff,10,0,40,30
1649806145980,COGS 172,A01,083984,Provenzano; Emily Kara,25,0,30,5
1649806152007,COGS 177,A00,083368,Staff,15,0,30,15
1649806158035,COGS 186,A01,083986,Staff,28,0,40,12
1649806164066,COGS 187A,A01,083988,Boyle; Mary E. T.,49,0,60,11
1649806170093,CSE 8A,A50,084003,Miranda; Gregory Joseph,11,0,15,4
1649806176116,CSE 11,A01,084005,Miranda; Gregory Joseph,50,0,55,5
1649806182141,CSE 20,A01,084007,Staff,17,0,20,3
1649806188170,CSE 21,A01,084009,Staff,42,0,50,8
1649806194193,CSE 30,A01,083370,Cao; Yingjun,27,0,40,13
1649806200226,CSE 100,A01,083372,Cao; Yingjun,33,0,40,7
1649806206249,CSE 101,A01,084011,Staff,10,0,40,30
1649806212278,CSE 141,A01,083374,Eldon; John,14,0,75,61
1649806218305,CSE 141L,A01,083376,Eldon; John,14,0,75,61
1649806224330,CSE 175,A01,084013,Kumar; Rakesh,25,0,25,0
1649806230352,CSE 190,A00,092508,Staff,15,0,15,0
1649806236377,ECE 5,A01,084049,Morris; Karcher William,18,0,20,2
1649806242400,ECE 100,A01,084051,Baghdadchi; Saharnaz,17,0,20,3
1649806242400,ECE 100,A02,091916,Baghdadchi; Saharnaz,19,0,20,1
1649806248434,ECE 101,A01,084053,Baghdadchi; Saharnaz,27,0,37,10
1649806248434,ECE 101,A02,084054,Baghdadchi; Saharnaz,37,0,37,0
1649806254456,ECE 107,A01,083390,Staff,35,0,40,5
1649806260491,ECE 148,A01,084056,Silberman; Jack,8,0,12,4
1649806266531,ECE 180,A00,083391,Abi Samra; Nicholas Camill,27,0,30,3
1649806266531,ECE 180,B00,083392,Abi Samra; Nicholas Camill,26,0,30,4
1649806272557,MATH 10B,A01,084110,Staff,22,0,30,8
1649806272557,MATH 10B,A02,084111,Staff,29,0,30,1
1649806272557,MATH 10B,A03,084112,Staff,30,0,30,0
1649806278584,MATH 10C,A01,083443,Staff,24,0,30,6
1649806278584,MATH 10C,A02,083444,Staff,26,0,30,4
1649806278584,MATH 10C,B01,084114,Staff,27,0,30,3
1649806278584,MATH 10C,B02,084115,Staff,30,0,30,0
1649806284612,MATH 18,A01,084117,Harel; Guershon,28,0,30,2
1649806284612,MATH 18,A02,084119,Harel; Guershon,29,0,30,1
1649806284612,MATH 18,A03,084120,Harel; Guershon,30,0,30,0
1649806284612,MATH 18,A04,084121,Harel; Guershon,30,0,30,0
1649806290645,MATH 20B,A01,084124,Um; Ko Woon,33,0,35,2
1649806290645,MATH 20B,B01,084126,Um; Ko Woon,35,0,35,0
1649806296670,MATH 20C,A01,083446,Hammock; Frances H,27,0,30,3
1649806296670,MATH 20C,A02,083447,Hammock; Frances H,30,0,30,0
1649806296670,MATH 20C,A03,083448,Hammock; Frances H,30,0,30,0
1649806296670,MATH 20C,A04,083449,Hammock; Frances H,30,0,30,0
1649806296670,MATH 20C,B01,083451,Hammock; Frances H,30,0,30,0
1649806296670,MATH 20C,B02,083452,Hammock; Frances H,30,0,30,0
1649806296670,MATH 20C,B03,083453,Hammock; Frances H,30,0,30,0
1649806296670,MATH 20C,B04,083454,Hammock; Frances H,30,0,30,0
1649806302700,MATH 20D,A01,084128,Staff,30,0,30,0
1649806302700,MATH 20D,A02,084129,Staff,30,0,30,0
1649806302700,MATH 20D,A03,084130,Staff,29,0,30,1
1649806302700,MATH 20D,B01,084133,Staff,28,0,30,2
1649806302700,MATH 20D,B02,084134,Staff,30,0,30,0
1649806302700,MATH 20D,B03,084135,Staff,30,0,30,0
1649806308724,MATH 20E,A01,084138,Staff,30,0,30,0
1649806308724,MATH 20E,A02,084139,Staff,29,0,30,1
1649806308724,MATH 20E,A03,084140,Staff,30,0,30,0
1649806308724,MATH 20E,A04,084141,Staff,30,0,30,0
1649806314752,MATH 102,A01,084143,Harel; Guershon,25,0,30,5
1649806314752,MATH 102,A02,084144,Harel; Guershon,28,0,30,2
1649806320780,MATH 103B,A01,083456,Staff,12,0,30,18
1649806320780,MATH 103B,A02,083457,Staff,24,0,30,6
1649806326807,MATH 109,A01,084146,Salehi Golsefidy; Alireza,30,0,30,0
1649806326807,MATH 109,A02,084147,Salehi Golsefidy; Alireza,27,0,30,3
1649806332832,MATH 120A,A01,085445,Eggers; John Dietrich,31,0,35,4
1649806332832,MATH 120A,A02,085446,Eggers; John Dietrich,32,0,35,3
1649806338861,MATH 142B,A01,084149,Verstraete; Jacques Allan,20,0,30,10
1649806338861,MATH 142B,A02,084150,Verstraete; Jacques Allan,26,0,30,4
1649806344888,MATH 170A,A01,083459,Nie; Jiawang,16,0,30,14
1649806344888,MATH 170A,A02,083460,Nie; Jiawang,26,0,30,4
1649806344888,MATH 170A,A03,083461,Nie; Jiawang,28,0,30,2
1649806350910,MATH 193B,A01,083463,Staff,22,0,30,8
1649806350910,MATH 193B,A02,083464,Staff,24,0,30,6
1649806350910,MATH 193B,A03,083465,Staff,30,0,30,0
1649806356970,COGS 2,A01,083966,Boyle; Mary E. T.,28,0,30,2
1649806362991,COGS 9,A01,083968,Staff,57,0,60,3
1649806369018,COGS 14B,A01,083970,Staff,49,0,50,1
1649806375041,COGS 100,A01,083972,Staff,49,0,60,11
1649806387087,COGS 101C,A01,083976,Staff,26,0,30,4
1649806393123,COGS 102A,A01,083978,Johnson; Christine M.,27,0,30,3
1649806399145,COGS 107B,A01,083980,Staff,43,0,50,7
1649806405171,COGS 115,A01,083982,Staff,23,0,30,7
1649806411194,COGS 118B,A01,083367,Staff,10,0,40,30
1649806417223,COGS 172,A01,083984,Provenzano; Emily Kara,25,0,30,5
1649806423248,COGS 177,A00,083368,Staff,14,0,30,16
1649806429275,COGS 186,A01,083986,Staff,28,0,40,12
1649806435300,COGS 187A,A01,083988,Boyle; Mary E. T.,49,0,60,11
1649806441326,CSE 8A,A50,084003,Miranda; Gregory Joseph,11,0,15,4
1649806447350,CSE 11,A01,084005,Miranda; Gregory Joseph,50,0,55,5
1649806453375,CSE 20,A01,084007,Staff,17,0,20,3
1649806459399,CSE 21,A01,084009,Staff,42,0,50,8
1649806465436,CSE 30,A01,083370,Cao; Yingjun,27,0,40,13
1649806471463,CSE 100,A01,083372,Cao; Yingjun,33,0,40,7
1649806477485,CSE 101,A01,084011,Staff,10,0,40,30
1649806483513,CSE 141,A01,083374,Eldon; John,14,0,75,61
1649806489548,CSE 141L,A01,083376,Eldon; John,14,0,75,61
1649806495570,CSE 175,A01,084013,Kumar; Rakesh,25,0,25,0
1649806501594,CSE 190,A00,092508,Staff,15,0,15,0
1649806507625,ECE 5,A01,084049,Morris; Karcher William,18,0,20,2
1649806513651,ECE 100,A01,084051,Baghdadchi; Saharnaz,17,0,20,3
1649806513651,ECE 100,A02,091916,Baghdadchi; Saharnaz,19,0,20,1
1649806519777,ECE 101,A01,084053,Baghdadchi; Saharnaz,27,0,37,10
1649806519777,ECE 101,A02,084054,Baghdadchi; Saharnaz,37,0,37,0
1649806525806,ECE 107,A01,083390,Staff,35,0,40,5
1649806531837,ECE 148,A01,084056,Silberman; Jack,8,0,12,4
1649806537860,ECE 180,A00,083391,Abi Samra; Nicholas Camill,27,0,30,3
1649806537860,ECE 180,B00,083392,Abi Samra; Nicholas Camill,26,0,30,4
1649806543895,MATH 10B,A01,084110,Staff,22,0,30,8
1649806543895,MATH 10B,A02,084111,Staff,29,0,30,1
1649806543895,MATH 10B,A03,084112,Staff,30,0,30,0
1649806549920,MATH 10C,A01,083443,Staff,24,0,30,6
1649806549920,MATH 10C,A02,083444,Staff,26,0,30,4
1649806549920,MATH 10C,B01,084114,Staff,27,0,30,3
1649806549920,MATH 10C,B02,084115,Staff,30,0,30,0
1649806555943,MATH 18,A01,084117,Harel; Guershon,28,0,30,2
1649806555943,MATH 18,A02,084119,Harel; Guershon,29,0,30,1
1649806555943,MATH 18,A03,084120,Harel; Guershon,30,0,30,0
1649806555943,MATH 18,A04,084121,Harel; Guershon,30,0,30,0
1649806561967,MATH 20B,A01,084124,Um; Ko Woon,33,0,35,2
1649806561967,MATH 20B,B01,084126,Um; Ko Woon,35,0,35,0
1649806567998,MATH 20C,A01,083446,Hammock; Frances H,27,0,30,3
1649806567998,MATH 20C,A02,083447,Hammock; Frances H,30,0,30,0
1649806567998,MATH 20C,A03,083448,Hammock; Frances H,30,0,30,0
1649806567998,MATH 20C,A04,083449,Hammock; Frances H,30,0,30,0
1649806567998,MATH 20C,B01,083451,Hammock; Frances H,30,0,30,0
1649806567998,MATH 20C,B02,083452,Hammock; Frances H,30,0,30,0
1649806567998,MATH 20C,B03,083453,Hammock; Frances H,30,0,30,0
1649806567998,MATH 20C,B04,083454,Hammock; Frances H,30,0,30,0
1649806574026,MATH 20D,A01,084128,Staff,30,0,30,0
1649806574026,MATH 20D,A02,084129,Staff,30,0,30,0
1649806574026,MATH 20D,A03,084130,Staff,29,0,30,1
1649806574026,MATH 20D,B01,084133,Staff,28,0,30,2
1649806574026,MATH 20D,B02,084134,Staff,30,0,30,0
1649806574026,MATH 20D,B03,084135,Staff,30,0,30,0
1649806580054,MATH 20E,A01,084138,Staff,30,0,30,0
1649806580054,MATH 20E,A02,084139,Staff,29,0,30,1
1649806580054,MATH 20E,A03,084140,Staff,29,0,30,1
1649806580054,MATH 20E,A04,084141,Staff,30,0,30,0
1649806586076,MATH 102,A01,084143,Harel; Guershon,25,0,30,5
1649806586076,MATH 102,A02,084144,Harel; Guershon,28,0,30,2
1649806592099,MATH 103B,A01,083456,Staff,11,0,30,19
1649806592099,MATH 103B,A02,083457,Staff,24,0,30,6
1649806598122,MATH 109,A01,084146,Salehi Golsefidy; Alireza,30,0,30,0
1649806598122,MATH 109,A02,084147,Salehi Golsefidy; Alireza,27,0,30,3
1649806604145,MATH 120A,A01,085445,Eggers; John Dietrich,31,0,35,4
1649806604145,MATH 120A,A02,085446,Eggers; John Dietrich,32,0,35,3
1649806610168,MATH 142B,A01,084149,Verstraete; Jacques Allan,20,0,30,10
1649806610168,MATH 142B,A02,084150,Verstraete; Jacques Allan,26,0,30,4
1649806616194,MATH 170A,A01,083459,Nie; Jiawang,16,0,30,14
1649806616194,MATH 170A,A02,083460,Nie; Jiawang,26,0,30,4
1649806616194,MATH 170A,A03,083461,Nie; Jiawang,28,0,30,2
1649806622218,MATH 193B,A01,083463,Staff,22,0,30,8
1649806622218,MATH 193B,A02,083464,Staff,24,0,30,6
1649806622218,MATH 193B,A03,083465,Staff,30,0,30,0
1649806628273,COGS 2,A01,083966,Boyle; Mary E. T.,28,0,30,2
1649806634296,COGS 9,A01,083968,Staff,57,0,60,3
1649806640319,COGS 14B,A01,083970,Staff,49,0,50,1
1649806646353,COGS 100,A01,083972,Staff,49,0,60,11
1649806658402,COGS 101C,A01,083976,Staff,26,0,30,4
1649806664435,COGS 102A,A01,083978,Johnson; Christine M.,27,0,30,3
1649806670459,COGS 107B,A01,083980,Staff,43,0,50,7
1649806676486,COGS 115,A01,083982,Staff,23,0,30,7
1649806682510,COGS 118B,A01,083367,Staff,10,0,40,30
1649806688533,COGS 172,A01,083984,Provenzano; Emily Kara,25,0,30,5
1649806694562,COGS 177,A00,083368,Staff,14,0,30,16
1649806700588,COGS 186,A01,083986,Staff,28,0,40,12
1649806706612,COGS 187A,A01,083988,Boyle; Mary E. T.,49,0,60,11
1649806712717,CSE 8A,A50,084003,Miranda; Gregory Joseph,11,0,15,4
1649806718741,CSE 11,A01,084005,Miranda; Gregory Joseph,50,0,55,5
1649806724764,CSE 20,A01,084007,Staff,17,0,20,3
1649806730796,CSE 21,A01,084009,Staff,42,0,50,8
1649806736819,CSE 30,A01,083370,Cao; Yingjun,27,0,40,13
1649806742842,CSE 100,A01,083372,Cao; Yingjun,33,0,40,7
1649806748871,CSE 101,A01,084011,Staff,9,0,40,31
1649806754906,CSE 141,A01,083374,Eldon; John,14,0,75,61
1649806760932,CSE 141L,A01,083376,Eldon; John,14,0,75,61
1649806766958,CSE 175,A01,084013,Kumar; Rakesh,25,0,25,0
1649806772982,CSE 190,A00,092508,Staff,15,0,15,0
1649806779004,ECE 5,A01,084049,Morris; Karcher William,18,0,20,2
1649806785028,ECE 100,A01,084051,Baghdadchi; Saharnaz,17,0,20,3
1649806785028,ECE 100,A02,091916,Baghdadchi; Saharnaz,19,0,20,1
1649806791056,ECE 101,A01,084053,Baghdadchi; Saharnaz,27,0,37,10
1649806791056,ECE 101,A02,084054,Baghdadchi; Saharnaz,37,0,37,0
1649806797080,ECE 107,A01,083390,Staff,35,0,40,5
1649806803116,ECE 148,A01,084056,Silberman; Jack,8,0,12,4
1649806809146,ECE 180,A00,083391,Abi Samra; Nicholas Camill,27,0,30,3
1649806809146,ECE 180,B00,083392,Abi Samra; Nicholas Camill,26,0,30,4
1649806815170,MATH 10B,A01,084110,Staff,22,0,30,8
1649806815170,MATH 10B,A02,084111,Staff,29,0,30,1
1649806815170,MATH 10B,A03,084112,Staff,30,0,30,0
1649806821201,MATH 10C,A01,083443,Staff,24,0,30,6
1649806821201,MATH 10C,A02,083444,Staff,26,0,30,4
1649806821201,MATH 10C,B01,084114,Staff,27,0,30,3
1649806821201,MATH 10C,B02,084115,Staff,30,0,30,0
1649806827225,MATH 18,A01,084117,Harel; Guershon,28,0,30,2
1649806827225,MATH 18,A02,084119,Harel; Guershon,29,0,30,1
1649806827225,MATH 18,A03,084120,Harel; Guershon,30,0,30,0
1649806827225,MATH 18,A04,084121,Harel; Guershon,30,0,30,0
1649806833259,MATH 20B,A01,084124,Um; Ko Woon,33,0,35,2
1649806833259,MATH 20B,B01,084126,Um; Ko Woon,35,0,35,0
1649806839290,MATH 20C,A01,083446,Hammock; Frances H,27,0,30,3
1649806839290,MATH 20C,A02,083447,Hammock; Frances H,30,0,30,0
1649806839290,MATH 20C,A03,083448,Hammock; Frances H,30,0,30,0
1649806839290,MATH 20C,A04,083449,Hammock; Frances H,30,0,30,0
1649806839290,MATH 20C,B01,083451,Hammock; Frances H,30,0,30,0
1649806839290,MATH 20C,B02,083452,Hammock; Frances H,30,0,30,0
1649806839290,MATH 20C,B03,083453,Hammock; Frances H,30,0,30,0
1649806839290,MATH 20C,B04,083454,Hammock; Frances H,30,0,30,0
1649806845326,MATH 20D,A01,084128,Staff,30,0,30,0
1649806845326,MATH 20D,A02,084129,Staff,30,0,30,0
1649806845326,MATH 20D,A03,084130,Staff,29,0,30,1
1649806845326,MATH 20D,B01,084133,Staff,28,0,30,2
1649806845326,MATH 20D,B02,084134,Staff,30,0,30,0
1649806845326,MATH 20D,B03,084135,Staff,30,0,30,0
1649806851351,MATH 20E,A01,084138,Staff,30,0,30,0
1649806851351,MATH 20E,A02,084139,Staff,29,0,30,1
1649806851351,MATH 20E,A03,084140,Staff,29,0,30,1
1649806851351,MATH 20E,A04,084141,Staff,30,0,30,0
1649806857378,MATH 102,A01,084143,Harel; Guershon,25,0,30,5
1649806857378,MATH 102,A02,084144,Harel; Guershon,28,0,30,2
1649806863400,MATH 103B,A01,083456,Staff,11,0,30,19
1649806863400,MATH 103B,A02,083457,Staff,24,0,30,6
1649806869424,MATH 109,A01,084146,Salehi Golsefidy; Alireza,30,0,30,0
1649806869424,MATH 109,A02,084147,Salehi Golsefidy; Alireza,27,0,30,3
1649806875464,MATH 120A,A01,085445,Eggers; John Dietrich,31,0,35,4
1649806875464,MATH 120A,A02,085446,Eggers; John Dietrich,32,0,35,3
1649806881488,MATH 142B,A01,084149,Verstraete; Jacques Allan,20,0,30,10
1649806881488,MATH 142B,A02,084150,Verstraete; Jacques Allan,26,0,30,4
1649806887521,MATH 170A,A01,083459,Nie; Jiawang,16,0,30,14
1649806887521,MATH 170A,A02,083460,Nie; Jiawang,26,0,30,4
1649806887521,MATH 170A,A03,083461,Nie; Jiawang,28,0,30,2
1649806893547,MATH 193B,A01,083463,Staff,22,0,30,8
1649806893547,MATH 193B,A02,083464,Staff,24,0,30,6
1649806893547,MATH 193B,A03,083465,Staff,30,0,30,0
1649806899614,COGS 2,A01,083966,Boyle; Mary E. T.,28,0,30,2
1649806905637,COGS 9,A01,083968,Staff,57,0,60,3
1649806911663,COGS 14B,A01,083970,Staff,49,0,50,1
1649806917686,COGS 100,A01,083972,Staff,49,0,60,11
1649806929740,COGS 101C,A01,083976,Staff,26,0,30,4
1649806935770,COGS 102A,A01,083978,Johnson; Christine M.,27,0,30,3
1649806941799,COGS 107B,A01,083980,Staff,43,0,50,7
1649806947827,COGS 115,A01,083982,Staff,23,0,30,7
1649806953854,COGS 118B,A01,083367,Staff,10,0,40,30
1649806959881,COGS 172,A01,083984,Provenzano; Emily Kara,25,0,30,5
1649806965920,COGS 177,A00,083368,Staff,14,0,30,16
1649806971943,COGS 186,A01,083986,Staff,28,0,40,12
1649806977976,COGS 187A,A01,083988,Boyle; Mary E. T.,48,0,60,12
1649806984004,CSE 8A,A50,084003,Miranda; Gregory Joseph,11,0,15,4
1649806990032,CSE 11,A01,084005,Miranda; Gregory Joseph,50,0,55,5
1649806996056,CSE 20,A01,084007,Staff,17,0,20,3
1649807002078,CSE 21,A01,084009,Staff,42,0,50,8
1649807008109,CSE 30,A01,083370,Cao; Yingjun,27,0,40,13
1649807014135,CSE 100,A01,083372,Cao; Yingjun,33,0,40,7
1649807020175,CSE 101,A01,084011,Staff,9,0,40,31
1649807026199,CSE 141,A01,083374,Eldon; John,13,0,75,62
1649807032229,CSE 141L,A01,083376,Eldon; John,13,0,75,62
1649807038259,CSE 175,A01,084013,Kumar; Rakesh,25,0,25,0
1649807044284,CSE 190,A00,092508,Staff,15,0,15,0
1649807050308,ECE 5,A01,084049,Morris; Karcher William,18,0,20,2
1649807056332,ECE 100,A01,084051,Baghdadchi; Saharnaz,17,0,20,3
1649807056332,ECE 100,A02,091916,Baghdadchi; Saharnaz,19,0,20,1
1649807062362,ECE 101,A01,084053,Baghdadchi; Saharnaz,27,0,37,10
1649807062362,ECE 101,A02,084054,Baghdadchi; Saharnaz,37,0,37,0
1649807068387,ECE 107,A01,083390,Staff,35,0,40,5
1649807074411,ECE 148,A01,084056,Silberman; Jack,8,0,12,4
1649807080442,ECE 180,A00,083391,Abi Samra; Nicholas Camill,27,0,30,3
1649807080442,ECE 180,B00,083392,Abi Samra; Nicholas Camill,26,0,30,4
1649807086466,MATH 10B,A01,084110,Staff,22,0,30,8
1649807086466,MATH 10B,A02,084111,Staff,29,0,30,1
1649807086466,MATH 10B,A03,084112,Staff,30,0,30,0
1649807092498,MATH 10C,A01,083443,Staff,24,0,30,6
1649807092498,MATH 10C,A02,083444,Staff,26,0,30,4
1649807092498,MATH 10C,B01,084114,Staff,27,0,30,3
1649807092498,MATH 10C,B02,084115,Staff,30,0,30,0
1649807098538,MATH 18,A01,084117,Harel; Guershon,28,0,30,2
1649807098538,MATH 18,A02,084119,Harel; Guershon,29,0,30,1
1649807098538,MATH 18,A03,084120,Harel; Guershon,30,0,30,0
1649807098538,MATH 18,A04,084121,Harel; Guershon,30,0,30,0
1649807104576,MATH 20B,A01,084124,Um; Ko Woon,33,0,35,2
1649807104576,MATH 20B,B01,084126,Um; Ko Woon,35,0,35,0
1649807110605,MATH 20C,A01,083446,Hammock; Frances H,27,0,30,3
1649807110605,MATH 20C,A02,083447,Hammock; Frances H,30,0,30,0
1649807110605,MATH 20C,A03,083448,Hammock; Frances H,30,0,30,0
1649807110605,MATH 20C,A04,083449,Hammock; Frances H,30,0,30,0
1649807110605,MATH 20C,B01,083451,Hammock; Frances H,30,0,30,0
1649807110605,MATH 20C,B02,083452,Hammock; Frances H,30,0,30,0
1649807110605,MATH 20C,B03,083453,Hammock; Frances H,30,0,30,0
1649807110605,MATH 20C,B04,083454,Hammock; Frances H,30,0,30,0
1649807116632,MATH 20D,A01,084128,Staff,30,0,30,0
1649807116632,MATH 20D,A02,084129,Staff,30,0,30,0
1649807116632,MATH 20D,A03,084130,Staff,29,0,30,1
1649807116632,MATH 20D,B01,084133,Staff,28,0,30,2
1649807116632,MATH 20D,B02,084134,Staff,30,0,30,0
1649807116632,MATH 20D,B03,084135,Staff,30,0,30,0
1649807122663,MATH 20E,A01,084138,Staff,30,0,30,0
1649807122663,MATH 20E,A02,084139,Staff,29,0,30,1
1649807122663,MATH 20E,A03,084140,Staff,29,0,30,1
1649807122663,MATH 20E,A04,084141,Staff,30,0,30,0
1649807128686,MATH 102,A01,084143,Harel; Guershon,25,0,30,5
1649807128686,MATH 102,A02,084144,Harel; Guershon,28,0,30,2
1649807134712,MATH 103B,A01,083456,Staff,11,0,30,19
1649807134712,MATH 103B,A02,083457,Staff,24,0,30,6
1649807140735,MATH 109,A01,084146,Salehi Golsefidy; Alireza,30,0,30,0
1649807140735,MATH 109,A02,084147,Salehi Golsefidy; Alireza,27,0,30,3
1649807146765,MATH 120A,A01,085445,Eggers; John Dietrich,31,0,35,4
1649807146765,MATH 120A,A02,085446,Eggers; John Dietrich,32,0,35,3
1649807152789,MATH 142B,A01,084149,Verstraete; Jacques Allan,20,0,30,10
1649807152789,MATH 142B,A02,084150,Verstraete; Jacques Allan,26,0,30,4
1649807158817,MATH 170A,A01,083459,Nie; Jiawang,16,0,30,14
1649807158817,MATH 170A,A02,083460,Nie; Jiawang,26,0,30,4
1649807158817,MATH 170A,A03,083461,Nie; Jiawang,28,0,30,2
1649807164850,MATH 193B,A01,083463,Staff,22,0,30,8
1649807164850,MATH 193B,A02,083464,Staff,24,0,30,6
1649807164850,MATH 193B,A03,083465,Staff,30,0,30,0
1649807170916,COGS 2,A01,083966,Boyle; Mary E. T.,28,0,30,2
1649807176938,COGS 9,A01,083968,Staff,57,0,60,3
1649807182968,COGS 14B,A01,083970,Staff,49,0,50,1
1649807188995,COGS 100,A01,083972,Staff,49,0,60,11
1649807201046,COGS 101C,A01,083976,Staff,26,0,30,4
1649807207070,COGS 102A,A01,083978,Johnson; Christine M.,27,0,30,3
1649807213094,COGS 107B,A01,083980,Staff,43,0,50,7
1649807219117,COGS 115,A01,083982,Staff,23,0,30,7
1649807225143,COGS 118B,A01,083367,Staff,10,0,40,30
1649807231170,COGS 172,A01,083984,Provenzano; Emily Kara,25,0,30,5
1649807237194,COGS 177,A00,083368,Staff,14,0,30,16
1649807243216,COGS 186,A01,083986,Staff,28,0,40,12
1649807249239,COGS 187A,A01,083988,Boyle; Mary E. T.,47,0,60,13
1649807255265,CSE 8A,A50,084003,Miranda; Gregory Joseph,11,0,15,4
1649807261289,CSE 11,A01,084005,Miranda; Gregory Joseph,50,0,55,5
1649807267316,CSE 20,A01,084007,Staff,17,0,20,3
1649807273348,CSE 21,A01,084009,Staff,42,0,50,8
1649807279369,CSE 30,A01,083370,Cao; Yingjun,27,0,40,13
1649807285395,CSE 100,A01,083372,Cao; Yingjun,32,0,40,8
1649807291421,CSE 101,A01,084011,Staff,9,0,40,31
1649807297445,CSE 141,A01,083374,Eldon; John,13,0,75,62
1649807303468,CSE 141L,A01,083376,Eldon; John,13,0,75,62
1649807309569,CSE 175,A01,084013,Kumar; Rakesh,25,0,25,0
1649807315593,CSE 190,A00,092508,Staff,15,0,15,0
1649807321616,ECE 5,A01,084049,Morris; Karcher William,18,0,20,2
1649807327640,ECE 100,A01,084051,Baghdadchi; Saharnaz,17,0,20,3
1649807327640,ECE 100,A02,091916,Baghdadchi; Saharnaz,19,0,20,1
1649807333666,ECE 101,A01,084053,Baghdadchi; Saharnaz,27,0,37,10
1649807333666,ECE 101,A02,084054,Baghdadchi; Saharnaz,37,0,37,0
1649807339690,ECE 107,A01,083390,Staff,35,0,40,5
1649807345717,ECE 148,A01,084056,Silberman; Jack,8,0,12,4
1649807351744,ECE 180,A00,083391,Abi Samra; Nicholas Camill,27,0,30,3
1649807351744,ECE 180,B00,083392,Abi Samra; Nicholas Camill,26,0,30,4
1649807357766,MATH 10B,A01,084110,Staff,22,0,30,8
1649807357766,MATH 10B,A02,084111,Staff,29,0,30,1
1649807357766,MATH 10B,A03,084112,Staff,30,0,30,0
1649807363796,MATH 10C,A01,083443,Staff,23,0,30,7
1649807363796,MATH 10C,A02,083444,Staff,26,0,30,4
1649807363796,MATH 10C,B01,084114,Staff,27,0,30,3
1649807363796,MATH 10C,B02,084115,Staff,30,0,30,0
1649807369820,MATH 18,A01,084117,Harel; Guershon,28,0,30,2
1649807369820,MATH 18,A02,084119,Harel; Guershon,29,0,30,1
1649807369820,MATH 18,A03,084120,Harel; Guershon,30,0,30,0
1649807369820,MATH 18,A04,084121,Harel; Guershon,30,0,30,0
1649807375847,MATH 20B,A01,084124,Um; Ko Woon,33,0,35,2
1649807375847,MATH 20B,B01,084126,Um; Ko Woon,35,0,35,0
1649807381870,MATH 20C,A01,083446,Hammock; Frances H,27,0,30,3
1649807381870,MATH 20C,A02,083447,Hammock; Frances H,30,0,30,0
1649807381870,MATH 20C,A03,083448,Hammock; Frances H,30,0,30,0
1649807381870,MATH 20C,A04,083449,Hammock; Frances H,30,0,30,0
1649807381870,MATH 20C,B01,083451,Hammock; Frances H,30,0,30,0
1649807381870,MATH 20C,B02,083452,Hammock; Frances H,30,0,30,0
1649807381870,MATH 20C,B03,083453,Hammock; Frances H,30,0,30,0
1649807381870,MATH 20C,B04,083454,Hammock; Frances H,30,0,30,0
1649807387897,MATH 20D,A01,084128,Staff,30,0,30,0
1649807387897,MATH 20D,A02,084129,Staff,30,0,30,0
1649807387897,MATH 20D,A03,084130,Staff,29,0,30,1
1649807387897,MATH 20D,B01,084133,Staff,28,0,30,2
1649807387897,MATH 20D,B02,084134,Staff,30,0,30,0
1649807387897,MATH 20D,B03,084135,Staff,30,0,30,0
1649807393922,MATH 20E,A01,084138,Staff,30,0,30,0
1649807393922,MATH 20E,A02,084139,Staff,29,0,30,1
1649807393922,MATH 20E,A03,084140,Staff,29,0,30,1
1649807393922,MATH 20E,A04,084141,Staff,30,0,30,0
1649807399945,MATH 102,A01,084143,Harel; Guershon,25,0,30,5
1649807399945,MATH 102,A02,084144,Harel; Guershon,28,0,30,2
1649807405969,MATH 103B,A01,083456,Staff,11,0,30,19
1649807405969,MATH 103B,A02,083457,Staff,24,0,30,6
1649807411997,MATH 109,A01,084146,Salehi Golsefidy; Alireza,30,0,30,0
1649807411997,MATH 109,A02,084147,Salehi Golsefidy; Alireza,27,0,30,3
1649807418020,MATH 120A,A01,085445,Eggers; John Dietrich,31,0,35,4
1649807418020,MATH 120A,A02,085446,Eggers; John Dietrich,32,0,35,3
1649807424051,MATH 142B,A01,084149,Verstraete; Jacques Allan,20,0,30,10
1649807424051,MATH 142B,A02,084150,Verstraete; Jacques Allan,26,0,30,4
1649807430081,MATH 170A,A01,083459,Nie; Jiawang,16,0,30,14
1649807430081,MATH 170A,A02,083460,Nie; Jiawang,26,0,30,4
1649807430081,MATH 170A,A03,083461,Nie; Jiawang,28,0,30,2
1649807436107,MATH 193B,A01,083463,Staff,22,0,30,8
1649807436107,MATH 193B,A02,083464,Staff,24,0,30,6
1649807436107,MATH 193B,A03,083465,Staff,30,0,30,0
1649807442162,COGS 2,A01,083966,Boyle; Mary E. T.,28,0,30,2
1649807448195,COGS 9,A01,083968,Staff,57,0,60,3
1649807454227,COGS 14B,A01,083970,Staff,49,0,50,1
1649807460257,COGS 100,A01,083972,Staff,50,0,60,10
1649807472312,COGS 101C,A01,083976,Staff,26,0,30,4
1649807478338,COGS 102A,A01,083978,Johnson; Christine M.,27,0,30,3
1649807484368,COGS 107B,A01,083980,Staff,43,0,50,7
1649807490407,COGS 115,A01,083982,Staff,23,0,30,7
1649807496431,COGS 118B,A01,083367,Staff,10,0,40,30
1649807502458,COGS 172,A01,083984,Provenzano; Emily Kara,25,0,30,5
1649807508484,COGS 177,A00,083368,Staff,14,0,30,16
1649807514524,COGS 186,A01,083986,Staff,28,0,40,12
1649807520561,COGS 187A,A01,083988,Boyle; Mary E. T.,47,0,60,13
1649807526587,CSE 8A,A50,084003,Miranda; Gregory Joseph,11,0,15,4
1649807532617,CSE 11,A01,084005,Miranda; Gregory Joseph,50,0,55,5
1649807538652,CSE 20,A01,084007,Staff,17,0,20,3
1649807544680,CSE 21,A01,084009,Staff,42,0,50,8
1649807550706,CSE 30,A01,083370,Cao; Yingjun,27,0,40,13
1649807556729,CSE 100,A01,083372,Cao; Yingjun,32,0,40,8
1649807562766,CSE 101,A01,084011,Staff,9,0,40,31
1649807568794,CSE 141,A01,083374,Eldon; John,13,0,75,62
1649807574817,CSE 141L,A01,083376,Eldon; John,13,0,75,62
1649807580844,CSE 175,A01,084013,Kumar; Rakesh,25,0,25,0
1649807586868,CSE 190,A00,092508,Staff,15,0,15,0
1649807592891,ECE 5,A01,084049,Morris; Karcher William,18,0,20,2
1649807598917,ECE 100,A01,084051,Baghdadchi; Saharnaz,17,0,20,3
1649807598917,ECE 100,A02,091916,Baghdadchi; Saharnaz,18,0,20,2
1649807604950,ECE 101,A01,084053,Baghdadchi; Saharnaz,27,0,37,10
1649807604950,ECE 101,A02,084054,Baghdadchi; Saharnaz,37,0,37,0
1649807610985,ECE 107,A01,083390,Staff,34,0,40,6
1649807617009,ECE 148,A01,084056,Silberman; Jack,8,0,12,4
1649807623045,ECE 180,A00,083391,Abi Samra; Nicholas Camill,27,0,30,3
1649807623045,ECE 180,B00,083392,Abi Samra; Nicholas Camill,26,0,30,4
1649807629074,MATH 10B,A01,084110,Staff,22,0,30,8
1649807629074,MATH 10B,A02,084111,Staff,29,0,30,1
1649807629074,MATH 10B,A03,084112,Staff,30,0,30,0
1649807635106,MATH 10C,A01,083443,Staff,23,0,30,7
1649807635106,MATH 10C,A02,083444,Staff,26,0,30,4
1649807635106,MATH 10C,B01,084114,Staff,27,0,30,3
1649807635106,MATH 10C,B02,084115,Staff,30,0,30,0
1649807641136,MATH 18,A01,084117,Harel; Guershon,28,0,30,2
1649807641136,MATH 18,A02,084119,Harel; Guershon,29,0,30,1
1649807641136,MATH 18,A03,084120,Harel; Guershon,30,0,30,0
1649807641136,MATH 18,A04,084121,Harel; Guershon,30,0,30,0
1649807647165,MATH 20B,A01,084124,Um; Ko Woon,33,0,35,2
1649807647165,MATH 20B,B01,084126,Um; Ko Woon,35,0,35,0
1649807653190,MATH 20C,A01,083446,Hammock; Frances H,27,0,30,3
1649807653190,MATH 20C,A02,083447,Hammock; Frances H,30,0,30,0
1649807653190,MATH 20C,A03,083448,Hammock; Frances H,30,0,30,0
1649807653190,MATH 20C,A04,083449,Hammock; Frances H,30,0,30,0
1649807653190,MATH 20C,B01,083451,Hammock; Frances H,30,0,30,0
1649807653190,MATH 20C,B02,083452,Hammock; Frances H,30,0,30,0
1649807653190,MATH 20C,B03,083453,Hammock; Frances H,30,0,30,0
1649807653190,MATH 20C,B04,083454,Hammock; Frances H,30,0,30,0
1649807659226,MATH 20D,A01,084128,Staff,30,0,30,0
1649807659226,MATH 20D,A02,084129,Staff,30,0,30,0
1649807659226,MATH 20D,A03,084130,Staff,29,0,30,1
1649807659226,MATH 20D,B01,084133,Staff,28,0,30,2
1649807659226,MATH 20D,B02,084134,Staff,30,0,30,0
1649807659226,MATH 20D,B03,084135,Staff,30,0,30,0
1649807665260,MATH 20E,A01,084138,Staff,30,0,30,0
1649807665260,MATH 20E,A02,084139,Staff,29,0,30,1
1649807665260,MATH 20E,A03,084140,Staff,29,0,30,1
1649807665260,MATH 20E,A04,084141,Staff,30,0,30,0
1649807671290,MATH 102,A01,084143,Harel; Guershon,25,0,30,5
1649807671290,MATH 102,A02,084144,Harel; Guershon,28,0,30,2
1649807677315,MATH 103B,A01,083456,Staff,11,0,30,19
1649807677315,MATH 103B,A02,083457,Staff,24,0,30,6
1649807683339,MATH 109,A01,084146,Salehi Golsefidy; Alireza,30,0,30,0
1649807683339,MATH 109,A02,084147,Salehi Golsefidy; Alireza,27,0,30,3
1649807689374,MATH 120A,A01,085445,Eggers; John Dietrich,31,0,35,4
1649807689374,MATH 120A,A02,085446,Eggers; John Dietrich,32,0,35,3
1649807705189,MATH 142B,A01,084149,Verstraete; Jacques Allan,20,0,30,10
1649807705189,MATH 142B,A02,084150,Verstraete; Jacques Allan,26,0,30,4
1649807711211,MATH 170A,A01,083459,Nie; Jiawang,16,0,30,14
1649807711211,MATH 170A,A02,083460,Nie; Jiawang,26,0,30,4
1649807711211,MATH 170A,A03,083461,Nie; Jiawang,28,0,30,2
1649807717237,MATH 193B,A01,083463,Staff,22,0,30,8
1649807717237,MATH 193B,A02,083464,Staff,22,0,30,8
1649807717237,MATH 193B,A03,083465,Staff,30,0,30,0
1649807723288,COGS 2,A01,083966,Boyle; Mary E. T.,28,0,30,2
1649807729313,COGS 9,A01,083968,Staff,57,0,60,3
1649807735334,COGS 14B,A01,083970,Staff,49,0,50,1
1649807741362,COGS 17,A01,092679,Staff,0,0,0,0
1649807747386,COGS 100,A01,083972,Staff,50,0,60,10
1649807759434,COGS 101C,A01,083976,Staff,26,0,30,4
1649807765462,COGS 102A,A01,083978,Johnson; Christine M.,27,0,30,3
1649807771486,COGS 107B,A01,083980,Staff,42,0,50,8
1649807777510,COGS 115,A01,083982,Staff,23,0,30,7
1649807783535,COGS 118B,A01,083367,Staff,10,0,40,30
1649807789562,COGS 172,A01,083984,Provenzano; Emily Kara,25,0,30,5
1649807795589,COGS 177,A00,083368,Staff,14,0,30,16
1649807801615,COGS 186,A01,083986,Staff,28,0,40,12
1649807807636,COGS 187A,A01,083988,Boyle; Mary E. T.,47,0,60,13
1649807813664,CSE 8A,A50,084003,Miranda; Gregory Joseph,11,0,15,4
1649807819699,CSE 11,A01,084005,Miranda; Gregory Joseph,50,0,55,5
1649807825723,CSE 20,A01,084007,Staff,17,0,20,3
1649807831754,CSE 21,A01,084009,Staff,42,0,50,8
1649807837787,CSE 30,A01,083370,Cao; Yingjun,27,0,40,13
1649807843811,CSE 100,A01,083372,Cao; Yingjun,32,0,40,8
1649807849835,CSE 101,A01,084011,Staff,8,0,40,32
1649807855859,CSE 141,A01,083374,Eldon; John,13,0,75,62
1649807861899,CSE 141L,A01,083376,Eldon; John,13,0,75,62
1649807867926,CSE 175,A01,084013,Kumar; Rakesh,25,0,25,0
1649807873952,CSE 190,A00,092508,Staff,15,0,15,0
1649807879976,ECE 5,A01,084049,Morris; Karcher William,18,0,20,2
1649807886000,ECE 100,A01,084051,Baghdadchi; Saharnaz,17,0,20,3
1649807886000,ECE 100,A02,091916,Baghdadchi; Saharnaz,18,0,20,2
1649807892027,ECE 101,A01,084053,Baghdadchi; Saharnaz,27,0,37,10
1649807892027,ECE 101,A02,084054,Baghdadchi; Saharnaz,37,0,37,0
1649807898056,ECE 107,A01,083390,Staff,34,0,40,6
1649807904079,ECE 148,A01,084056,Silberman; Jack,8,0,12,4
1649807910107,ECE 180,A00,083391,Abi Samra; Nicholas Camill,27,0,30,3
1649807910107,ECE 180,B00,083392,Abi Samra; Nicholas Camill,26,0,30,4
1649807916203,MATH 10B,A01,084110,Staff,22,0,30,8
1649807916203,MATH 10B,A02,084111,Staff,29,0,30,1
1649807916203,MATH 10B,A03,084112,Staff,30,0,30,0
1649807922226,MATH 10C,A01,083443,Staff,23,0,30,7
1649807922226,MATH 10C,A02,083444,Staff,26,0,30,4
1649807922226,MATH 10C,B01,084114,Staff,27,0,30,3
1649807922226,MATH 10C,B02,084115,Staff,30,0,30,0
1649807928258,MATH 18,A01,084117,Harel; Guershon,28,0,30,2
1649807928258,MATH 18,A02,084119,Harel; Guershon,29,0,30,1
1649807928258,MATH 18,A03,084120,Harel; Guershon,30,0,30,0
1649807928258,MATH 18,A04,084121,Harel; Guershon,30,0,30,0
1649807934282,MATH 20B,A01,084124,Um; Ko Woon,33,0,35,2
1649807934282,MATH 20B,B01,084126,Um; Ko Woon,35,0,35,0
1649807940315,MATH 20C,A01,083446,Hammock; Frances H,27,0,30,3
1649807940315,MATH 20C,A02,083447,Hammock; Frances H,30,0,30,0
1649807940315,MATH 20C,A03,083448,Hammock; Frances H,30,0,30,0
1649807940315,MATH 20C,A04,083449,Hammock; Frances H,30,0,30,0
1649807940315,MATH 20C,B01,083451,Hammock; Frances H,30,0,30,0
1649807940315,MATH 20C,B02,083452,Hammock; Frances H,30,0,30,0
1649807940315,MATH 20C,B03,083453,Hammock; Frances H,30,0,30,0
1649807940315,MATH 20C,B04,083454,Hammock; Frances H,30,0,30,0
1649807946339,MATH 20D,A01,084128,Staff,30,0,30,0
1649807946339,MATH 20D,A02,084129,Staff,30,0,30,0
1649807946339,MATH 20D,A03,084130,Staff,29,0,30,1
1649807946339,MATH 20D,B01,084133,Staff,28,0,30,2
1649807946339,MATH 20D,B02,084134,Staff,30,0,30,0
1649807946339,MATH 20D,B03,084135,Staff,30,0,30,0
1649807952367,MATH 20E,A01,084138,Staff,30,0,30,0
1649807952367,MATH 20E,A02,084139,Staff,29,0,30,1
1649807952367,MATH 20E,A03,084140,Staff,29,0,30,1
1649807952367,MATH 20E,A04,084141,Staff,30,0,30,0
1649807958394,MATH 102,A01,084143,Harel; Guershon,25,0,30,5
1649807958394,MATH 102,A02,084144,Harel; Guershon,28,0,30,2
1649807964416,MATH 103B,A01,083456,Staff,11,0,30,19
1649807964416,MATH 103B,A02,083457,Staff,24,0,30,6
1649807970440,MATH 109,A01,084146,Salehi Golsefidy; Alireza,30,0,30,0
1649807970440,MATH 109,A02,084147,Salehi Golsefidy; Alireza,27,0,30,3
1649807976467,MATH 120A,A01,085445,Eggers; John Dietrich,31,0,35,4
1649807976467,MATH 120A,A02,085446,Eggers; John Dietrich,32,0,35,3
1649807982504,MATH 142B,A01,084149,Verstraete; Jacques Allan,20,0,30,10
1649807982504,MATH 142B,A02,084150,Verstraete; Jacques Allan,26,0,30,4
1649807988531,MATH 170A,A01,083459,Nie; Jiawang,16,0,30,14
1649807988531,MATH 170A,A02,083460,Nie; Jiawang,26,0,30,4
1649807988531,MATH 170A,A03,083461,Nie; Jiawang,28,0,30,2
1649807994560,MATH 193B,A01,083463,Staff,22,0,30,8
1649807994560,MATH 193B,A02,083464,Staff,22,0,30,8
1649807994560,MATH 193B,A03,083465,Staff,30,0,30,0
1649808000626,COGS 2,A01,083966,Boyle; Mary E. T.,28,0,30,2
1649808006667,COGS 9,A01,083968,Staff,57,0,60,3
1649808012691,COGS 14B,A01,083970,Staff,49,0,50,1
1649808018742,COGS 17,A01,092679,Staff,0,0,0,0
1649808024773,COGS 100,A01,083972,Staff,50,0,60,10
1649808036840,COGS 101C,A01,083976,Staff,26,0,30,4
1649808042867,COGS 102A,A01,083978,Johnson; Christine M.,27,0,30,3
1649808048900,COGS 107B,A01,083980,Staff,42,0,50,8
1649808054926,COGS 115,A01,083982,Staff,23,0,30,7
1649808060950,COGS 118B,A01,083367,Staff,10,0,40,30
1649808066980,COGS 172,A01,083984,Provenzano; Emily Kara,25,0,30,5
1649808073008,COGS 177,A00,083368,Staff,14,0,30,16
1649808079032,COGS 186,A01,083986,Staff,28,0,40,12
1649808085059,COGS 187A,A01,083988,Boyle; Mary E. T.,47,0,60,13
1649808091092,CSE 8A,A50,084003,Miranda; Gregory Joseph,11,0,15,4
1649808097119,CSE 11,A01,084005,Miranda; Gregory Joseph,50,0,55,5
1649808103153,CSE 20,A01,084007,Staff,17,0,20,3
1649808109180,CSE 21,A01,084009,Staff,42,0,50,8
1649808115206,CSE 30,A01,083370,Cao; Yingjun,27,0,40,13
1649808121229,CSE 100,A01,083372,Cao; Yingjun,32,0,40,8
1649808127261,CSE 101,A01,084011,Staff,8,0,40,32
1649808133288,CSE 141,A01,083374,Eldon; John,12,0,75,63
1649808139314,CSE 141L,A01,083376,Eldon; John,12,0,75,63
1649808145343,CSE 175,A01,084013,Kumar; Rakesh,25,0,25,0
1649808151370,CSE 190,A00,092508,Staff,15,0,15,0
1649808157405,ECE 5,A01,084049,Morris; Karcher William,18,0,20,2
1649808163429,ECE 100,A01,084051,Baghdadchi; Saharnaz,17,0,20,3
1649808163429,ECE 100,A02,091916,Baghdadchi; Saharnaz,18,0,20,2
1649808169454,ECE 101,A01,084053,Baghdadchi; Saharnaz,27,0,37,10
1649808169454,ECE 101,A02,084054,Baghdadchi; Saharnaz,37,0,37,0
1649808175477,ECE 107,A01,083390,Staff,34,0,40,6
1649808181508,ECE 148,A01,084056,Silberman; Jack,8,0,12,4
1649808187532,ECE 180,A00,083391,Abi Samra; Nicholas Camill,27,0,30,3
1649808187532,ECE 180,B00,083392,Abi Samra; Nicholas Camill,26,0,30,4
1649808193557,MATH 10B,A01,084110,Staff,22,0,30,8
1649808193557,MATH 10B,A02,084111,Staff,29,0,30,1
1649808193557,MATH 10B,A03,084112,Staff,30,0,30,0
1649808199584,MATH 10C,A01,083443,Staff,22,0,30,8
1649808199584,MATH 10C,A02,083444,Staff,26,0,30,4
1649808199584,MATH 10C,B01,084114,Staff,27,0,30,3
1649808199584,MATH 10C,B02,084115,Staff,30,0,30,0
1649808205616,MATH 18,A01,084117,Harel; Guershon,28,0,30,2
1649808205616,MATH 18,A02,084119,Harel; Guershon,29,0,30,1
1649808205616,MATH 18,A03,084120,Harel; Guershon,30,0,30,0
1649808205616,MATH 18,A04,084121,Harel; Guershon,30,0,30,0
1649808211640,MATH 20B,A01,084124,Um; Ko Woon,33,0,35,2
1649808211640,MATH 20B,B01,084126,Um; Ko Woon,35,0,35,0
1649808217667,MATH 20C,A01,083446,Hammock; Frances H,27,0,30,3
1649808217667,MATH 20C,A02,083447,Hammock; Frances H,30,0,30,0
1649808217667,MATH 20C,A03,083448,Hammock; Frances H,30,0,30,0
1649808217667,MATH 20C,A04,083449,Hammock; Frances H,30,0,30,0
1649808217667,MATH 20C,B01,083451,Hammock; Frances H,30,0,30,0
1649808217667,MATH 20C,B02,083452,Hammock; Frances H,30,0,30,0
1649808217667,MATH 20C,B03,083453,Hammock; Frances H,30,0,30,0
1649808217667,MATH 20C,B04,083454,Hammock; Frances H,30,0,30,0
1649808223694,MATH 20D,A01,084128,Staff,30,0,30,0
1649808223694,MATH 20D,A02,084129,Staff,30,0,30,0
1649808223694,MATH 20D,A03,084130,Staff,29,0,30,1
1649808223694,MATH 20D,B01,084133,Staff,28,0,30,2
1649808223694,MATH 20D,B02,084134,Staff,30,0,30,0
1649808223694,MATH 20D,B03,084135,Staff,30,0,30,0
1649808229718,MATH 20E,A01,084138,Staff,30,0,30,0
1649808229718,MATH 20E,A02,084139,Staff,29,0,30,1
1649808229718,MATH 20E,A03,084140,Staff,29,0,30,1
1649808229718,MATH 20E,A04,084141,Staff,30,0,30,0
1649808235751,MATH 102,A01,084143,Harel; Guershon,25,0,30,5
1649808235751,MATH 102,A02,084144,Harel; Guershon,28,0,30,2
1649808241779,MATH 103B,A01,083456,Staff,11,0,30,19
1649808241779,MATH 103B,A02,083457,Staff,24,0,30,6
1649808247807,MATH 109,A01,084146,Salehi Golsefidy; Alireza,30,0,30,0
1649808247807,MATH 109,A02,084147,Salehi Golsefidy; Alireza,27,0,30,3
1649808253832,MATH 120A,A01,085445,Eggers; John Dietrich,31,0,35,4
1649808253832,MATH 120A,A02,085446,Eggers; John Dietrich,32,0,35,3
1649808259863,MATH 142B,A01,084149,Verstraete; Jacques Allan,19,0,30,11
1649808259863,MATH 142B,A02,084150,Verstraete; Jacques Allan,26,0,30,4
1649808265901,MATH 170A,A01,083459,Nie; Jiawang,16,0,30,14
1649808265901,MATH 170A,A02,083460,Nie; Jiawang,26,0,30,4
1649808265901,MATH 170A,A03,083461,Nie; Jiawang,28,0,30,2
1649808271925,MATH 193B,A01,083463,Staff,22,0,30,8
1649808271925,MATH 193B,A02,083464,Staff,22,0,30,8
1649808271925,MATH 193B,A03,083465,Staff,30,0,30,0
1649808277993,COGS 2,A01,083966,Boyle; Mary E. T.,28,0,30,2
1649808284019,COGS 9,A01,083968,Staff,57,0,60,3
1649808290046,COGS 14B,A01,083970,Staff,49,0,50,1
1649808296084,COGS 17,A01,092679,Staff,75,0,75,0
1649808302110,COGS 100,A01,083972,Staff,50,0,60,10
1649808314159,COGS 101C,A01,083976,Staff,26,0,30,4
1649808320184,COGS 102A,A01,083978,Johnson; Christine M.,27,0,30,3
1649808326208,COGS 107B,A01,083980,Staff,42,0,50,8
1649808332236,COGS 115,A01,083982,Staff,23,0,30,7
1649808338264,COGS 118B,A01,083367,Staff,9,0,40,31
1649808344287,COGS 172,A01,083984,Provenzano; Emily Kara,25,0,30,5
1649808350312,COGS 177,A00,083368,Staff,14,0,30,16
1649808356335,COGS 186,A01,083986,Staff,28,0,40,12
1649808362360,COGS 187A,A01,083988,Boyle; Mary E. T.,47,0,60,13
1649808368393,CSE 8A,A50,084003,Miranda; Gregory Joseph,11,0,15,4
1649808374418,CSE 11,A01,084005,Miranda; Gregory Joseph,50,0,55,5
1649808380451,CSE 20,A01,084007,Staff,17,0,20,3
1649808386473,CSE 21,A01,084009,Staff,42,0,50,8
1649808392499,CSE 30,A01,083370,Cao; Yingjun,27,0,40,13
1649808398536,CSE 100,A01,083372,Cao; Yingjun,31,0,40,9
1649808404572,CSE 101,A01,084011,Staff,8,0,40,32
1649808410593,CSE 141,A01,083374,Eldon; John,11,0,75,64
1649808416619,CSE 141L,A01,083376,Eldon; John,11,0,75,64
1649808422642,CSE 175,A01,084013,Kumar; Rakesh,25,0,25,0
1649808428665,CSE 190,A00,092508,Staff,15,0,15,0
1649808434690,ECE 5,A01,084049,Morris; Karcher William,18,0,20,2
1649808440718,ECE 100,A01,084051,Baghdadchi; Saharnaz,17,0,20,3
1649808440718,ECE 100,A02,091916,Baghdadchi; Saharnaz,18,0,20,2
1649808446754,ECE 101,A01,084053,Baghdadchi; Saharnaz,27,0,37,10
1649808446754,ECE 101,A02,084054,Baghdadchi; Saharnaz,37,0,37,0
1649808452779,ECE 107,A01,083390,Staff,34,0,40,6
1649808458807,ECE 148,A01,084056,Silberman; Jack,8,0,12,4
1649808464835,ECE 180,A00,083391,Abi Samra; Nicholas Camill,27,0,30,3
1649808464835,ECE 180,B00,083392,Abi Samra; Nicholas Camill,26,0,30,4
1649808470858,MATH 10B,A01,084110,Staff,22,0,30,8
1649808470858,MATH 10B,A02,084111,Staff,29,0,30,1
1649808470858,MATH 10B,A03,084112,Staff,30,0,30,0
1649808476882,MATH 10C,A01,083443,Staff,22,0,30,8
1649808476882,MATH 10C,A02,083444,Staff,26,0,30,4
1649808476882,MATH 10C,B01,084114,Staff,27,0,30,3
1649808476882,MATH 10C,B02,084115,Staff,30,0,30,0
1649808482911,MATH 18,A01,084117,Harel; Guershon,28,0,30,2
1649808482911,MATH 18,A02,084119,Harel; Guershon,29,0,30,1
1649808482911,MATH 18,A03,084120,Harel; Guershon,30,0,30,0
1649808482911,MATH 18,A04,084121,Harel; Guershon,30,0,30,0
1649808488937,MATH 20B,A01,084124,Um; Ko Woon,33,0,35,2
1649808488937,MATH 20B,B01,084126,Um; Ko Woon,35,0,35,0
1649808494962,MATH 20C,A01,083446,Hammock; Frances H,27,0,30,3
1649808494962,MATH 20C,A02,083447,Hammock; Frances H,30,0,30,0
1649808494962,MATH 20C,A03,083448,Hammock; Frances H,30,0,30,0
1649808494962,MATH 20C,A04,083449,Hammock; Frances H,30,0,30,0
1649808494962,MATH 20C,B01,083451,Hammock; Frances H,30,0,30,0
1649808494962,MATH 20C,B02,083452,Hammock; Frances H,30,0,30,0
1649808494962,MATH 20C,B03,083453,Hammock; Frances H,30,0,30,0
1649808494962,MATH 20C,B04,083454,Hammock; Frances H,30,0,30,0
1649808500990,MATH 20D,A01,084128,Staff,30,0,30,0
1649808500990,MATH 20D,A02,084129,Staff,30,0,30,0
1649808500990,MATH 20D,A03,084130,Staff,29,0,30,1
1649808500990,MATH 20D,B01,084133,Staff,28,0,30,2
1649808500990,MATH 20D,B02,084134,Staff,30,0,30,0
1649808500990,MATH 20D,B03,084135,Staff,30,0,30,0
1649808507019,MATH 20E,A01,084138,Staff,30,0,30,0
1649808507019,MATH 20E,A02,084139,Staff,29,0,30,1
1649808507019,MATH 20E,A03,084140,Staff,29,0,30,1
1649808507019,MATH 20E,A04,084141,Staff,30,0,30,0
1649808513137,MATH 102,A01,084143,Harel; Guershon,25,0,30,5
1649808513137,MATH 102,A02,084144,Harel; Guershon,28,0,30,2
1649808519177,MATH 103B,A01,083456,Staff,11,0,30,19
1649808519177,MATH 103B,A02,083457,Staff,24,0,30,6
1649808525207,MATH 109,A01,084146,Salehi Golsefidy; Alireza,30,0,30,0
1649808525207,MATH 109,A02,084147,Salehi Golsefidy; Alireza,27,0,30,3
1649808531231,MATH 120A,A01,085445,Eggers; John Dietrich,31,0,35,4
1649808531231,MATH 120A,A02,085446,Eggers; John Dietrich,32,0,35,3
1649808537255,MATH 142B,A01,084149,Verstraete; Jacques Allan,19,0,30,11
1649808537255,MATH 142B,A02,084150,Verstraete; Jacques Allan,26,0,30,4
1649808543279,MATH 170A,A01,083459,Nie; Jiawang,16,0,30,14
1649808543279,MATH 170A,A02,083460,Nie; Jiawang,26,0,30,4
1649808543279,MATH 170A,A03,083461,Nie; Jiawang,28,0,30,2
1649808549303,MATH 193B,A01,083463,Staff,22,0,30,8
1649808549303,MATH 193B,A02,083464,Staff,22,0,30,8
1649808549303,MATH 193B,A03,083465,Staff,30,0,30,0
1649808555372,COGS 2,A01,083966,Boyle; Mary E. T.,28,0,30,2
1649808561396,COGS 9,A01,083968,Staff,57,0,60,3
1649808567419,COGS 14B,A01,083970,Staff,49,0,50,1
1649808573443,COGS 17,A01,092679,Staff,75,0,75,0
1649808579470,COGS 100,A01,083972,Staff,50,0,60,10
1649808591517,COGS 101C,A01,083976,Staff,26,0,30,4
1649808597541,COGS 102A,A01,083978,Johnson; Christine M.,27,0,30,3
1649808603569,COGS 107B,A01,083980,Staff,42,0,50,8
1649808609603,COGS 115,A01,083982,Staff,23,0,30,7
1649808615626,COGS 118B,A01,083367,Staff,9,0,40,31
1649808621661,COGS 172,A01,083984,Provenzano; Emily Kara,25,0,30,5
1649808627685,COGS 177,A00,083368,Staff,14,0,30,16
1649808633711,COGS 186,A01,083986,Staff,28,0,40,12
1649808639736,COGS 187A,A01,083988,Boyle; Mary E. T.,47,0,60,13
1649808645765,CSE 8A,A50,084003,Miranda; Gregory Joseph,11,0,15,4
1649808651789,CSE 11,A01,084005,Miranda; Gregory Joseph,50,0,55,5
1649808657822,CSE 20,A01,084007,Staff,17,0,20,3
1649808663846,CSE 21,A01,084009,Staff,42,0,50,8
1649808669876,CSE 30,A01,083370,Cao; Yingjun,26,0,40,14
1649808675913,CSE 100,A01,083372,Cao; Yingjun,31,0,40,9
1649808681942,CSE 101,A01,084011,Staff,8,0,40,32
1649808687965,CSE 141,A01,083374,Eldon; John,11,0,75,64
1649808693990,CSE 141L,A01,083376,Eldon; John,11,0,75,64
1649808700016,CSE 175,A01,084013,Kumar; Rakesh,25,0,25,0
1649808706039,CSE 190,A00,092508,Staff,15,0,15,0
1649808712063,ECE 5,A01,084049,Morris; Karcher William,18,0,20,2
1649808718090,ECE 100,A01,084051,Baghdadchi; Saharnaz,17,0,20,3
1649808718090,ECE 100,A02,091916,Baghdadchi; Saharnaz,18,0,20,2
1649808724128,ECE 101,A01,084053,Baghdadchi; Saharnaz,27,0,37,10
1649808724128,ECE 101,A02,084054,Baghdadchi; Saharnaz,37,0,37,0
1649808730192,ECE 107,A01,083390,Staff,34,0,40,6
1649808736233,ECE 148,A01,084056,Silberman; Jack,8,0,12,4
1649808742261,ECE 180,A00,083391,Abi Samra; Nicholas Camill,27,0,30,3
1649808742261,ECE 180,B00,083392,Abi Samra; Nicholas Camill,26,0,30,4
1649808748286,MATH 10B,A01,084110,Staff,22,0,30,8
1649808748286,MATH 10B,A02,084111,Staff,29,0,30,1
1649808748286,MATH 10B,A03,084112,Staff,30,0,30,0
1649808754314,MATH 10C,A01,083443,Staff,22,0,30,8
1649808754314,MATH 10C,A02,083444,Staff,26,0,30,4
1649808754314,MATH 10C,B01,084114,Staff,27,0,30,3
1649808754314,MATH 10C,B02,084115,Staff,30,0,30,0
1649808760346,MATH 18,A01,084117,Harel; Guershon,28,0,30,2
1649808760346,MATH 18,A02,084119,Harel; Guershon,29,0,30,1
1649808760346,MATH 18,A03,084120,Harel; Guershon,30,0,30,0
1649808760346,MATH 18,A04,084121,Harel; Guershon,30,0,30,0
1649808766376,MATH 20B,A01,084124,Um; Ko Woon,33,0,35,2
1649808766376,MATH 20B,B01,084126,Um; Ko Woon,35,0,35,0
1649808772417,MATH 20C,A01,083446,Hammock; Frances H,27,0,30,3
1649808772417,MATH 20C,A02,083447,Hammock; Frances H,30,0,30,0
1649808772417,MATH 20C,A03,083448,Hammock; Frances H,30,0,30,0
1649808772417,MATH 20C,A04,083449,Hammock; Frances H,30,0,30,0
1649808772417,MATH 20C,B01,083451,Hammock; Frances H,30,0,30,0
1649808772417,MATH 20C,B02,083452,Hammock; Frances H,30,0,30,0
1649808772417,MATH 20C,B03,083453,Hammock; Frances H,30,0,30,0
1649808772417,MATH 20C,B04,083454,Hammock; Frances H,30,0,30,0
1649808778443,MATH 20D,A01,084128,Staff,30,0,30,0
1649808778443,MATH 20D,A02,084129,Staff,30,0,30,0
1649808778443,MATH 20D,A03,084130,Staff,29,0,30,1
1649808778443,MATH 20D,B01,084133,Staff,28,0,30,2
1649808778443,MATH 20D,B02,084134,Staff,30,0,30,0
1649808778443,MATH 20D,B03,084135,Staff,30,0,30,0
1649808784467,MATH 20E,A01,084138,Staff,30,0,30,0
1649808784467,MATH 20E,A02,084139,Staff,29,0,30,1
1649808784467,MATH 20E,A03,084140,Staff,29,0,30,1
1649808784467,MATH 20E,A04,084141,Staff,30,0,30,0
1649808790497,MATH 102,A01,084143,Harel; Guershon,25,0,30,5
1649808790497,MATH 102,A02,084144,Harel; Guershon,28,0,30,2
1649808796528,MATH 103B,A01,083456,Staff,11,0,30,19
1649808796528,MATH 103B,A02,083457,Staff,24,0,30,6
1649808802559,MATH 109,A01,084146,Salehi Golsefidy; Alireza,30,0,30,0
1649808802559,MATH 109,A02,084147,Salehi Golsefidy; Alireza,27,0,30,3
1649808808582,MATH 120A,A01,085445,Eggers; John Dietrich,31,0,35,4
1649808808582,MATH 120A,A02,085446,Eggers; John Dietrich,32,0,35,3
1649808814605,MATH 142B,A01,084149,Verstraete; Jacques Allan,19,0,30,11
1649808814605,MATH 142B,A02,084150,Verstraete; Jacques Allan,26,0,30,4
1649808820638,MATH 170A,A01,083459,Nie; Jiawang,16,0,30,14
1649808820638,MATH 170A,A02,083460,Nie; Jiawang,26,0,30,4
1649808820638,MATH 170A,A03,083461,Nie; Jiawang,28,0,30,2
1649808826667,MATH 193B,A01,083463,Staff,22,0,30,8
1649808826667,MATH 193B,A02,083464,Staff,22,0,30,8
1649808826667,MATH 193B,A03,083465,Staff,30,0,30,0
1649808832735,COGS 2,A01,083966,Boyle; Mary E. T.,28,0,30,2
1649808838759,COGS 9,A01,083968,Staff,57,0,60,3
1649808844784,COGS 14B,A01,083970,Staff,49,0,50,1
1649808850809,COGS 17,A01,092679,Staff,75,0,75,0
1649808856836,COGS 100,A01,083972,Staff,50,0,60,10
1649808868882,COGS 101C,A01,083976,Staff,26,0,30,4
1649808874905,COGS 102A,A01,083978,Johnson; Christine M.,27,0,30,3
1649808880934,COGS 107B,A01,083980,Staff,42,0,50,8
1649808886968,COGS 115,A01,083982,Staff,23,0,30,7
1649808892997,COGS 118B,A01,083367,Staff,9,0,40,31
1649808899025,COGS 172,A01,083984,Provenzano; Emily Kara,25,0,30,5
1649808905052,COGS 177,A00,083368,Staff,14,0,30,16
1649808911087,COGS 186,A01,083986,Staff,28,0,40,12
1649808917122,COGS 187A,A01,083988,Boyle; Mary E. T.,47,0,60,13
1649808923146,CSE 8A,A50,084003,Miranda; Gregory Joseph,11,0,15,4
1649808929176,CSE 11,A01,084005,Miranda; Gregory Joseph,50,0,55,5
1649808935201,CSE 20,A01,084007,Staff,17,0,20,3
1649808941228,CSE 21,A01,084009,Staff,42,0,50,8
1649808947250,CSE 30,A01,083370,Cao; Yingjun,26,0,40,14
1649808953273,CSE 100,A01,083372,Cao; Yingjun,30,0,40,10
1649808959297,CSE 101,A01,084011,Staff,8,0,40,32
1649808965323,CSE 141,A01,083374,Eldon; John,11,0,75,64
1649808971353,CSE 141L,A01,083376,Eldon; John,11,0,75,64
1649808977375,CSE 175,A01,084013,Kumar; Rakesh,25,0,25,0
1649808983397,CSE 190,A00,092508,Staff,15,0,15,0
1649808989422,ECE 5,A01,084049,Morris; Karcher William,18,0,20,2
1649808995454,ECE 100,A01,084051,Baghdadchi; Saharnaz,17,0,20,3
1649808995454,ECE 100,A02,091916,Baghdadchi; Saharnaz,18,0,20,2
1649809001480,ECE 101,A01,084053,Baghdadchi; Saharnaz,27,0,37,10
1649809001480,ECE 101,A02,084054,Baghdadchi; Saharnaz,37,0,37,0
1649809007516,ECE 107,A01,083390,Staff,34,0,40,6
1649809013542,ECE 148,A01,084056,Silberman; Jack,8,0,12,4
1649809019564,ECE 180,A00,083391,Abi Samra; Nicholas Camill,27,0,30,3
1649809019564,ECE 180,B00,083392,Abi Samra; Nicholas Camill,26,0,30,4
1649809025591,MATH 10B,A01,084110,Staff,22,0,30,8
1649809025591,MATH 10B,A02,084111,Staff,29,0,30,1
1649809025591,MATH 10B,A03,084112,Staff,30,0,30,0
1649809031615,MATH 10C,A01,083443,Staff,22,0,30,8
1649809031615,MATH 10C,A02,083444,Staff,26,0,30,4
1649809031615,MATH 10C,B01,084114,Staff,27,0,30,3
1649809031615,MATH 10C,B02,084115,Staff,30,0,30,0
1649809037647,MATH 18,A01,084117,Harel; Guershon,28,0,30,2
1649809037647,MATH 18,A02,084119,Harel; Guershon,29,0,30,1
1649809037647,MATH 18,A03,084120,Harel; Guershon,29,0,30,1
1649809037647,MATH 18,A04,084121,Harel; Guershon,30,0,30,0
1649809043670,MATH 20B,A01,084124,Um; Ko Woon,33,0,35,2
1649809043670,MATH 20B,B01,084126,Um; Ko Woon,35,0,35,0
1649809049698,MATH 20C,A01,083446,Hammock; Frances H,27,0,30,3
1649809049698,MATH 20C,A02,083447,Hammock; Frances H,30,0,30,0
1649809049698,MATH 20C,A03,083448,Hammock; Frances H,30,0,30,0
1649809049698,MATH 20C,A04,083449,Hammock; Frances H,30,0,30,0
1649809049698,MATH 20C,B01,083451,Hammock; Frances H,30,0,30,0
1649809049698,MATH 20C,B02,083452,Hammock; Frances H,30,0,30,0
1649809049698,MATH 20C,B03,083453,Hammock; Frances H,30,0,30,0
1649809049698,MATH 20C,B04,083454,Hammock; Frances H,30,0,30,0
1649809055721,MATH 20D,A01,084128,Staff,30,0,30,0
1649809055721,MATH 20D,A02,084129,Staff,30,0,30,0
1649809055721,MATH 20D,A03,084130,Staff,29,0,30,1
1649809055721,MATH 20D,B01,084133,Staff,28,0,30,2
1649809055721,MATH 20D,B02,084134,Staff,30,0,30,0
1649809055721,MATH 20D,B03,084135,Staff,30,0,30,0
1649809061748,MATH 20E,A01,084138,Staff,30,0,30,0
1649809061748,MATH 20E,A02,084139,Staff,29,0,30,1
1649809061748,MATH 20E,A03,084140,Staff,29,0,30,1
1649809061748,MATH 20E,A04,084141,Staff,30,0,30,0
1649809067772,MATH 102,A01,084143,Harel; Guershon,25,0,30,5
1649809067772,MATH 102,A02,084144,Harel; Guershon,28,0,30,2
1649809073796,MATH 103B,A01,083456,Staff,11,0,30,19
1649809073796,MATH 103B,A02,083457,Staff,24,0,30,6
1649809079819,MATH 109,A01,084146,Salehi Golsefidy; Alireza,30,0,30,0
1649809079819,MATH 109,A02,084147,Salehi Golsefidy; Alireza,27,0,30,3
1649809085852,MATH 120A,A01,085445,Eggers; John Dietrich,31,0,35,4
1649809085852,MATH 120A,A02,085446,Eggers; John Dietrich,32,0,35,3
1649809091882,MATH 142B,A01,084149,Verstraete; Jacques Allan,18,0,30,12
1649809091882,MATH 142B,A02,084150,Verstraete; Jacques Allan,26,0,30,4
1649809097906,MATH 170A,A01,083459,Nie; Jiawang,16,0,30,14
1649809097906,MATH 170A,A02,083460,Nie; Jiawang,26,0,30,4
1649809097906,MATH 170A,A03,083461,Nie; Jiawang,28,0,30,2
1649809103929,MATH 193B,A01,083463,Staff,22,0,30,8
1649809103929,MATH 193B,A02,083464,Staff,22,0,30,8
1649809103929,MATH 193B,A03,083465,Staff,30,0,30,0
1649809110067,COGS 2,A01,083966,Boyle; Mary E. T.,28,0,30,2
1649809116090,COGS 9,A01,083968,Staff,57,0,60,3
1649809122113,COGS 14B,A01,083970,Staff,49,0,50,1
1649809128149,COGS 17,A01,092679,Staff,75,0,75,0
1649809134174,COGS 100,A01,083972,Staff,50,0,60,10
1649809146240,COGS 101C,A01,083976,Staff,26,0,30,4
1649809152263,COGS 102A,A01,083978,Johnson; Christine M.,27,0,30,3
1649809158289,COGS 107B,A01,083980,Staff,42,0,50,8
1649809164310,COGS 115,A01,083982,Staff,23,0,30,7
1649809170336,COGS 118B,A01,083367,Staff,9,0,40,31
1649809176359,COGS 172,A01,083984,Provenzano; Emily Kara,25,0,30,5
1649809182383,COGS 177,A00,083368,Staff,13,0,30,17
1649809188405,COGS 186,A01,083986,Staff,28,0,40,12
1649809194429,COGS 187A,A01,083988,Boyle; Mary E. T.,47,0,60,13
1649809200453,CSE 8A,A50,084003,Miranda; Gregory Joseph,11,0,15,4
1649809206476,CSE 11,A01,084005,Miranda; Gregory Joseph,50,0,55,5
1649809212500,CSE 20,A01,084007,Staff,17,0,20,3
1649809218527,CSE 21,A01,084009,Staff,42,0,50,8
1649809224556,CSE 30,A01,083370,Cao; Yingjun,25,0,40,15
1649809230583,CSE 100,A01,083372,Cao; Yingjun,30,0,40,10
1649809236615,CSE 101,A01,084011,Staff,8,0,40,32
1649809242648,CSE 141,A01,083374,Eldon; John,11,0,75,64
1649809248670,CSE 141L,A01,083376,Eldon; John,11,0,75,64
1649809254698,CSE 175,A01,084013,Kumar; Rakesh,25,0,25,0
1649809260723,CSE 190,A00,092508,Staff,15,0,15,0
1649809266747,ECE 5,A01,084049,Morris; Karcher William,18,0,20,2
1649809272773,ECE 100,A01,084051,Baghdadchi; Saharnaz,17,0,20,3
1649809272773,ECE 100,A02,091916,Baghdadchi; Saharnaz,18,0,20,2
1649809278801,ECE 101,A01,084053,Baghdadchi; Saharnaz,27,0,37,10
1649809278801,ECE 101,A02,084054,Baghdadchi; Saharnaz,37,0,37,0
1649809284834,ECE 107,A01,083390,Staff,34,0,40,6
1649809290864,ECE 148,A01,084056,Silberman; Jack,8,0,12,4
1649809296888,ECE 180,A00,083391,Abi Samra; Nicholas Camill,27,0,30,3
1649809296888,ECE 180,B00,083392,Abi Samra; Nicholas Camill,26,0,30,4
1649809302915,MATH 10B,A01,084110,Staff,22,0,30,8
1649809302915,MATH 10B,A02,084111,Staff,29,0,30,1
1649809302915,MATH 10B,A03,084112,Staff,30,0,30,0
1649809308944,MATH 10C,A01,083443,Staff,22,0,30,8
1649809308944,MATH 10C,A02,083444,Staff,26,0,30,4
1649809308944,MATH 10C,B01,084114,Staff,27,0,30,3
1649809308944,MATH 10C,B02,084115,Staff,30,0,30,0
1649809314976,MATH 18,A01,084117,Harel; Guershon,28,0,30,2
1649809314976,MATH 18,A02,084119,Harel; Guershon,29,0,30,1
1649809314976,MATH 18,A03,084120,Harel; Guershon,30,0,30,0
1649809314976,MATH 18,A04,084121,Harel; Guershon,30,0,30,0
1649809321002,MATH 20B,A01,084124,Um; Ko Woon,33,0,35,2
1649809321002,MATH 20B,B01,084126,Um; Ko Woon,35,0,35,0
1649809327036,MATH 20C,A01,083446,Hammock; Frances H,27,0,30,3
1649809327036,MATH 20C,A02,083447,Hammock; Frances H,30,0,30,0
1649809327036,MATH 20C,A03,083448,Hammock; Frances H,30,0,30,0
1649809327036,MATH 20C,A04,083449,Hammock; Frances H,30,0,30,0
1649809327036,MATH 20C,B01,083451,Hammock; Frances H,30,0,30,0
1649809327036,MATH 20C,B02,083452,Hammock; Frances H,30,0,30,0
1649809327036,MATH 20C,B03,083453,Hammock; Frances H,30,0,30,0
1649809327036,MATH 20C,B04,083454,Hammock; Frances H,30,0,30,0
1649809333066,MATH 20D,A01,084128,Staff,30,0,30,0
1649809333066,MATH 20D,A02,084129,Staff,30,0,30,0
1649809333066,MATH 20D,A03,084130,Staff,29,0,30,1
1649809333066,MATH 20D,B01,084133,Staff,28,0,30,2
1649809333066,MATH 20D,B02,084134,Staff,30,0,30,0
1649809333066,MATH 20D,B03,084135,Staff,30,0,30,0
1649809339097,MATH 20E,A01,084138,Staff,30,0,30,0
1649809339097,MATH 20E,A02,084139,Staff,29,0,30,1
1649809339097,MATH 20E,A03,084140,Staff,29,0,30,1
1649809339097,MATH 20E,A04,084141,Staff,30,0,30,0
1649809345123,MATH 102,A01,084143,Harel; Guershon,25,0,30,5
1649809345123,MATH 102,A02,084144,Harel; Guershon,28,0,30,2
1649809351150,MATH 103B,A01,083456,Staff,10,0,30,20
1649809351150,MATH 103B,A02,083457,Staff,24,0,30,6
1649809357177,MATH 109,A01,084146,Salehi Golsefidy; Alireza,30,0,30,0
1649809357177,MATH 109,A02,084147,Salehi Golsefidy; Alireza,27,0,30,3
1649809363209,MATH 120A,A01,085445,Eggers; John Dietrich,31,0,35,4
1649809363209,MATH 120A,A02,085446,Eggers; John Dietrich,32,0,35,3
1649809369246,MATH 142B,A01,084149,Verstraete; Jacques Allan,18,0,30,12
1649809369246,MATH 142B,A02,084150,Verstraete; Jacques Allan,26,0,30,4
1649809375272,MATH 170A,A01,083459,Nie; Jiawang,16,0,30,14
1649809375272,MATH 170A,A02,083460,Nie; Jiawang,26,0,30,4
1649809375272,MATH 170A,A03,083461,Nie; Jiawang,27,0,30,3
1649809381295,MATH 193B,A01,083463,Staff,22,0,30,8
1649809381295,MATH 193B,A02,083464,Staff,22,0,30,8
1649809381295,MATH 193B,A03,083465,Staff,30,0,30,0
1649809387351,COGS 2,A01,083966,Boyle; Mary E. T.,28,0,30,2
1649809393374,COGS 9,A01,083968,Staff,57,0,60,3
1649809399408,COGS 14B,A01,083970,Staff,48,0,50,2
1649809405431,COGS 17,A01,092679,Staff,75,0,75,0
1649809411454,COGS 100,A01,083972,Staff,50,0,60,10
1649809423499,COGS 101C,A01,083976,Staff,26,0,30,4
1649809429523,COGS 102A,A01,083978,Johnson; Christine M.,27,0,30,3
1649809435549,COGS 107B,A01,083980,Staff,42,0,50,8
1649809441576,COGS 115,A01,083982,Staff,23,0,30,7
1649809447604,COGS 118B,A01,083367,Staff,9,0,40,31
1649809453628,COGS 172,A01,083984,Provenzano; Emily Kara,25,0,30,5
1649809459656,COGS 177,A00,083368,Staff,12,0,30,18
1649809465680,COGS 186,A01,083986,Staff,28,0,40,12
1649809471706,COGS 187A,A01,083988,Boyle; Mary E. T.,47,0,60,13
1649809477729,CSE 8A,A50,084003,Miranda; Gregory Joseph,11,0,15,4
1649809483756,CSE 11,A01,084005,Miranda; Gregory Joseph,50,0,55,5
1649809489778,CSE 20,A01,084007,Staff,17,0,20,3
1649809495803,CSE 21,A01,084009,Staff,41,0,50,9
1649809501835,CSE 30,A01,083370,Cao; Yingjun,25,0,40,15
1649809507859,CSE 100,A01,083372,Cao; Yingjun,29,0,40,11
1649809513885,CSE 101,A01,084011,Staff,7,0,40,33
1649809519909,CSE 141,A01,083374,Eldon; John,10,0,75,65
1649809525932,CSE 141L,A01,083376,Eldon; John,9,0,75,66
1649809531958,CSE 175,A01,084013,Kumar; Rakesh,25,0,25,0
1649809537983,CSE 190,A00,092508,Staff,15,0,15,0
1649809544007,ECE 5,A01,084049,Morris; Karcher William,18,0,20,2
1649809550034,ECE 100,A01,084051,Baghdadchi; Saharnaz,17,0,20,3
1649809550034,ECE 100,A02,091916,Baghdadchi; Saharnaz,18,0,20,2
1649809556064,ECE 101,A01,084053,Baghdadchi; Saharnaz,27,0,37,10
1649809556064,ECE 101,A02,084054,Baghdadchi; Saharnaz,37,0,37,0
1649809562093,ECE 107,A01,083390,Staff,34,0,40,6
1649809568118,ECE 148,A01,084056,Silberman; Jack,8,0,12,4
1649809574141,ECE 180,A00,083391,Abi Samra; Nicholas Camill,27,0,30,3
1649809574141,ECE 180,B00,083392,Abi Samra; Nicholas Camill,26,0,30,4
1649809580178,MATH 10B,A01,084110,Staff,22,0,30,8
1649809580178,MATH 10B,A02,084111,Staff,29,0,30,1
1649809580178,MATH 10B,A03,084112,Staff,30,0,30,0
1649809586200,MATH 10C,A01,083443,Staff,22,0,30,8
1649809586200,MATH 10C,A02,083444,Staff,26,0,30,4
1649809586200,MATH 10C,B01,084114,Staff,27,0,30,3
1649809586200,MATH 10C,B02,084115,Staff,30,0,30,0
1649809592226,MATH 18,A01,084117,Harel; Guershon,28,0,30,2
1649809592226,MATH 18,A02,084119,Harel; Guershon,29,0,30,1
1649809592226,MATH 18,A03,084120,Harel; Guershon,30,0,30,0
1649809592226,MATH 18,A04,084121,Harel; Guershon,30,0,30,0
1649809598254,MATH 20B,A01,084124,Um; Ko Woon,33,0,35,2
1649809598254,MATH 20B,B01,084126,Um; Ko Woon,35,0,35,0
1649809604280,MATH 20C,A01,083446,Hammock; Frances H,27,0,30,3
1649809604280,MATH 20C,A02,083447,Hammock; Frances H,30,0,30,0
1649809604280,MATH 20C,A03,083448,Hammock; Frances H,30,0,30,0
1649809604280,MATH 20C,A04,083449,Hammock; Frances H,30,0,30,0
1649809604280,MATH 20C,B01,083451,Hammock; Frances H,30,0,30,0
1649809604280,MATH 20C,B02,083452,Hammock; Frances H,30,0,30,0
1649809604280,MATH 20C,B03,083453,Hammock; Frances H,30,0,30,0
1649809604280,MATH 20C,B04,083454,Hammock; Frances H,30,0,30,0
1649809610315,MATH 20D,A01,084128,Staff,30,0,30,0
1649809610315,MATH 20D,A02,084129,Staff,30,0,30,0
1649809610315,MATH 20D,A03,084130,Staff,29,0,30,1
1649809610315,MATH 20D,B01,084133,Staff,28,0,30,2
1649809610315,MATH 20D,B02,084134,Staff,30,0,30,0
1649809610315,MATH 20D,B03,084135,Staff,30,0,30,0
1649809616339,MATH 20E,A01,084138,Staff,29,0,30,1
1649809616339,MATH 20E,A02,084139,Staff,29,0,30,1
1649809616339,MATH 20E,A03,084140,Staff,29,0,30,1
1649809616339,MATH 20E,A04,084141,Staff,30,0,30,0
1649809622364,MATH 102,A01,084143,Harel; Guershon,25,0,30,5
1649809622364,MATH 102,A02,084144,Harel; Guershon,28,0,30,2
1649809628390,MATH 103B,A01,083456,Staff,10,0,30,20
1649809628390,MATH 103B,A02,083457,Staff,24,0,30,6
1649809634412,MATH 109,A01,084146,Salehi Golsefidy; Alireza,30,0,30,0
1649809634412,MATH 109,A02,084147,Salehi Golsefidy; Alireza,27,0,30,3
1649809640439,MATH 120A,A01,085445,Eggers; John Dietrich,31,0,35,4
1649809640439,MATH 120A,A02,085446,Eggers; John Dietrich,32,0,35,3
1649809646466,MATH 142B,A01,084149,Verstraete; Jacques Allan,18,0,30,12
1649809646466,MATH 142B,A02,084150,Verstraete; Jacques Allan,26,0,30,4
1649809652493,MATH 170A,A01,083459,Nie; Jiawang,16,0,30,14
1649809652493,MATH 170A,A02,083460,Nie; Jiawang,26,0,30,4
1649809652493,MATH 170A,A03,083461,Nie; Jiawang,27,0,30,3
1649809658523,MATH 193B,A01,083463,Staff,22,0,30,8
1649809658523,MATH 193B,A02,083464,Staff,22,0,30,8
1649809658523,MATH 193B,A03,083465,Staff,30,0,30,0
1649809664581,COGS 2,A01,083966,Boyle; Mary E. T.,27,0,30,3
1649809670604,COGS 9,A01,083968,Staff,57,0,60,3
1649809676627,COGS 14B,A01,083970,Staff,48,0,50,2
1649809682653,COGS 17,A01,092679,Staff,75,0,75,0
1649809688679,COGS 100,A01,083972,Staff,49,0,60,11
1649809700836,COGS 101C,A01,083976,Staff,26,0,30,4
1649809706863,COGS 102A,A01,083978,Johnson; Christine M.,27,0,30,3
1649809712888,COGS 107B,A01,083980,Staff,42,0,50,8
1649809718923,COGS 115,A01,083982,Staff,23,0,30,7
1649809724948,COGS 118B,A01,083367,Staff,9,0,40,31
1649809730971,COGS 172,A01,083984,Provenzano; Emily Kara,25,0,30,5
1649809736996,COGS 177,A00,083368,Staff,12,0,30,18
1649809743020,COGS 186,A01,083986,Staff,28,0,40,12
1649809749044,COGS 187A,A01,083988,Boyle; Mary E. T.,46,0,60,14
1649809755071,CSE 8A,A50,084003,Miranda; Gregory Joseph,11,0,15,4
1649809761098,CSE 11,A01,084005,Miranda; Gregory Joseph,50,0,55,5
1649809767126,CSE 20,A01,084007,Staff,17,0,20,3
1649809773157,CSE 21,A01,084009,Staff,41,0,50,9
1649809779184,CSE 30,A01,083370,Cao; Yingjun,25,0,40,15
1649809785211,CSE 100,A01,083372,Cao; Yingjun,29,0,40,11
1649809791238,CSE 101,A01,084011,Staff,7,0,40,33
1649809797264,CSE 141,A01,083374,Eldon; John,10,0,75,65
1649809803287,CSE 141L,A01,083376,Eldon; John,9,0,75,66
1649809809311,CSE 175,A01,084013,Kumar; Rakesh,25,0,25,0
1649809815335,CSE 190,A00,092508,Staff,15,0,15,0
1649809821359,ECE 5,A01,084049,Morris; Karcher William,18,0,20,2
1649809827391,ECE 100,A01,084051,Baghdadchi; Saharnaz,17,0,20,3
1649809827391,ECE 100,A02,091916,Baghdadchi; Saharnaz,18,0,20,2
1649809833429,ECE 101,A01,084053,Baghdadchi; Saharnaz,27,0,37,10
1649809833429,ECE 101,A02,084054,Baghdadchi; Saharnaz,37,0,37,0
1649809839463,ECE 107,A01,083390,Staff,34,0,40,6
1649809845498,ECE 148,A01,084056,Silberman; Jack,8,0,12,4
1649809851522,ECE 180,A00,083391,Abi Samra; Nicholas Camill,27,0,30,3
1649809851522,ECE 180,B00,083392,Abi Samra; Nicholas Camill,26,0,30,4
1649809857551,MATH 10B,A01,084110,Staff,22,0,30,8
1649809857551,MATH 10B,A02,084111,Staff,29,0,30,1
1649809857551,MATH 10B,A03,084112,Staff,30,0,30,0
1649809863576,MATH 10C,A01,083443,Staff,22,0,30,8
1649809863576,MATH 10C,A02,083444,Staff,26,0,30,4
1649809863576,MATH 10C,B01,084114,Staff,27,0,30,3
1649809863576,MATH 10C,B02,084115,Staff,30,0,30,0
1649809869604,MATH 18,A01,084117,Harel; Guershon,28,0,30,2
1649809869604,MATH 18,A02,084119,Harel; Guershon,29,0,30,1
1649809869604,MATH 18,A03,084120,Harel; Guershon,30,0,30,0
1649809869604,MATH 18,A04,084121,Harel; Guershon,30,0,30,0
1649809875629,MATH 20B,A01,084124,Um; Ko Woon,33,0,35,2
1649809875629,MATH 20B,B01,084126,Um; Ko Woon,35,0,35,0
1649809881652,MATH 20C,A01,083446,Hammock; Frances H,27,0,30,3
1649809881652,MATH 20C,A02,083447,Hammock; Frances H,30,0,30,0
1649809881652,MATH 20C,A03,083448,Hammock; Frances H,30,0,30,0
1649809881652,MATH 20C,A04,083449,Hammock; Frances H,30,0,30,0
1649809881652,MATH 20C,B01,083451,Hammock; Frances H,30,0,30,0
1649809881652,MATH 20C,B02,083452,Hammock; Frances H,30,0,30,0
1649809881652,MATH 20C,B03,083453,Hammock; Frances H,30,0,30,0
1649809881652,MATH 20C,B04,083454,Hammock; Frances H,30,0,30,0
1649809887675,MATH 20D,A01,084128,Staff,30,0,30,0
1649809887675,MATH 20D,A02,084129,Staff,30,0,30,0
1649809887675,MATH 20D,A03,084130,Staff,29,0,30,1
1649809887675,MATH 20D,B01,084133,Staff,28,0,30,2
1649809887675,MATH 20D,B02,084134,Staff,30,0,30,0
1649809887675,MATH 20D,B03,084135,Staff,30,0,30,0
1649809893701,MATH 20E,A01,084138,Staff,29,0,30,1
1649809893701,MATH 20E,A02,084139,Staff,29,0,30,1
1649809893701,MATH 20E,A03,084140,Staff,29,0,30,1
1649809893701,MATH 20E,A04,084141,Staff,30,0,30,0
1649809899731,MATH 102,A01,084143,Harel; Guershon,25,0,30,5
1649809899731,MATH 102,A02,084144,Harel; Guershon,28,0,30,2
1649809905754,MATH 103B,A01,083456,Staff,10,0,30,20
1649809905754,MATH 103B,A02,083457,Staff,24,0,30,6
1649809911782,MATH 109,A01,084146,Salehi Golsefidy; Alireza,30,0,30,0
1649809911782,MATH 109,A02,084147,Salehi Golsefidy; Alireza,27,0,30,3
1649809917809,MATH 120A,A01,085445,Eggers; John Dietrich,31,0,35,4
1649809917809,MATH 120A,A02,085446,Eggers; John Dietrich,32,0,35,3
1649809923838,MATH 142B,A01,084149,Verstraete; Jacques Allan,18,0,30,12
1649809923838,MATH 142B,A02,084150,Verstraete; Jacques Allan,26,0,30,4
1649809929868,MATH 170A,A01,083459,Nie; Jiawang,16,0,30,14
1649809929868,MATH 170A,A02,083460,Nie; Jiawang,26,0,30,4
1649809929868,MATH 170A,A03,083461,Nie; Jiawang,27,0,30,3
1649809935892,MATH 193B,A01,083463,Staff,22,0,30,8
1649809935892,MATH 193B,A02,083464,Staff,22,0,30,8
1649809935892,MATH 193B,A03,083465,Staff,30,0,30,0
1649809941952,COGS 2,A01,083966,Boyle; Mary E. T.,27,0,30,3
1649809947979,COGS 9,A01,083968,Staff,57,0,60,3
1649809954002,COGS 14B,A01,083970,Staff,48,0,50,2
1649809960026,COGS 17,A01,092679,Staff,75,0,75,0
1649809966056,COGS 100,A01,083972,Staff,49,0,60,11
1649809978108,COGS 101C,A01,083976,Staff,26,0,30,4
1649809984135,COGS 102A,A01,083978,Johnson; Christine M.,27,0,30,3
1649809990159,COGS 107B,A01,083980,Staff,41,0,50,9
1649809996185,COGS 115,A01,083982,Staff,23,0,30,7
1649810002214,COGS 118B,A01,083367,Staff,9,0,40,31
1649810008239,COGS 172,A01,083984,Provenzano; Emily Kara,25,0,30,5
1649810014263,COGS 177,A00,083368,Staff,12,0,30,18
1649810020287,COGS 186,A01,083986,Staff,28,0,40,12
1649810026310,COGS 187A,A01,083988,Boyle; Mary E. T.,46,0,60,14
1649810032334,CSE 8A,A50,084003,Miranda; Gregory Joseph,11,0,15,4
1649810038366,CSE 11,A01,084005,Miranda; Gregory Joseph,50,0,55,5
1649810044393,CSE 20,A01,084007,Staff,17,0,20,3
1649810050417,CSE 21,A01,084009,Staff,41,0,50,9
1649810056443,CSE 30,A01,083370,Cao; Yingjun,25,0,40,15
1649810062470,CSE 100,A01,083372,Cao; Yingjun,29,0,40,11
1649810068495,CSE 101,A01,084011,Staff,7,0,40,33
1649810074521,CSE 141,A01,083374,Eldon; John,10,0,75,65
1649810080543,CSE 141L,A01,083376,Eldon; John,9,0,75,66
1649810086567,CSE 175,A01,084013,Kumar; Rakesh,25,0,25,0
1649810092595,CSE 190,A00,092508,Staff,15,0,15,0
1649810098629,ECE 5,A01,084049,Morris; Karcher William,18,0,20,2
1649810104658,ECE 100,A01,084051,Baghdadchi; Saharnaz,17,0,20,3
1649810104658,ECE 100,A02,091916,Baghdadchi; Saharnaz,18,0,20,2
1649810110692,ECE 101,A01,084053,Baghdadchi; Saharnaz,27,0,37,10
1649810110692,ECE 101,A02,084054,Baghdadchi; Saharnaz,37,0,37,0
1649810116717,ECE 107,A01,083390,Staff,34,0,40,6
1649810122739,ECE 148,A01,084056,Silberman; Jack,8,0,12,4
1649810128761,ECE 180,A00,083391,Abi Samra; Nicholas Camill,27,0,30,3
1649810128761,ECE 180,B00,083392,Abi Samra; Nicholas Camill,26,0,30,4
1649810134785,MATH 10B,A01,084110,Staff,22,0,30,8
1649810134785,MATH 10B,A02,084111,Staff,29,0,30,1
1649810134785,MATH 10B,A03,084112,Staff,29,0,30,1
1649810140809,MATH 10C,A01,083443,Staff,22,0,30,8
1649810140809,MATH 10C,A02,083444,Staff,26,0,30,4
1649810140809,MATH 10C,B01,084114,Staff,27,0,30,3
1649810140809,MATH 10C,B02,084115,Staff,30,0,30,0
1649810146833,MATH 18,A01,084117,Harel; Guershon,28,0,30,2
1649810146833,MATH 18,A02,084119,Harel; Guershon,29,0,30,1
1649810146833,MATH 18,A03,084120,Harel; Guershon,30,0,30,0
1649810146833,MATH 18,A04,084121,Harel; Guershon,30,0,30,0
1649810152855,MATH 20B,A01,084124,Um; Ko Woon,33,0,35,2
1649810152855,MATH 20B,B01,084126,Um; Ko Woon,35,0,35,0
1649810158885,MATH 20C,A01,083446,Hammock; Frances H,27,0,30,3
1649810158885,MATH 20C,A02,083447,Hammock; Frances H,30,0,30,0
1649810158885,MATH 20C,A03,083448,Hammock; Frances H,30,0,30,0
1649810158885,MATH 20C,A04,083449,Hammock; Frances H,30,0,30,0
1649810158885,MATH 20C,B01,083451,Hammock; Frances H,30,0,30,0
1649810158885,MATH 20C,B02,083452,Hammock; Frances H,30,0,30,0
1649810158885,MATH 20C,B03,083453,Hammock; Frances H,30,0,30,0
1649810158885,MATH 20C,B04,083454,Hammock; Frances H,30,0,30,0
1649810164911,MATH 20D,A01,084128,Staff,30,0,30,0
1649810164911,MATH 20D,A02,084129,Staff,30,0,30,0
1649810164911,MATH 20D,A03,084130,Staff,29,0,30,1
1649810164911,MATH 20D,B01,084133,Staff,28,0,30,2
1649810164911,MATH 20D,B02,084134,Staff,30,0,30,0
1649810164911,MATH 20D,B03,084135,Staff,30,0,30,0
1649810170934,MATH 20E,A01,084138,Staff,29,0,30,1
1649810170934,MATH 20E,A02,084139,Staff,29,0,30,1
1649810170934,MATH 20E,A03,084140,Staff,29,0,30,1
1649810170934,MATH 20E,A04,084141,Staff,30,0,30,0
1649810176976,MATH 102,A01,084143,Harel; Guershon,25,0,30,5
1649810176976,MATH 102,A02,084144,Harel; Guershon,28,0,30,2
1649810182999,MATH 103B,A01,083456,Staff,10,0,30,20
1649810182999,MATH 103B,A02,083457,Staff,24,0,30,6
1649810189028,MATH 109,A01,084146,Salehi Golsefidy; Alireza,30,0,30,0
1649810189028,MATH 109,A02,084147,Salehi Golsefidy; Alireza,27,0,30,3
1649810195068,MATH 120A,A01,085445,Eggers; John Dietrich,31,0,35,4
1649810195068,MATH 120A,A02,085446,Eggers; John Dietrich,32,0,35,3
1649810201091,MATH 142B,A01,084149,Verstraete; Jacques Allan,18,0,30,12
1649810201091,MATH 142B,A02,084150,Verstraete; Jacques Allan,26,0,30,4
1649810207115,MATH 170A,A01,083459,Nie; Jiawang,16,0,30,14
1649810207115,MATH 170A,A02,083460,Nie; Jiawang,26,0,30,4
1649810207115,MATH 170A,A03,083461,Nie; Jiawang,27,0,30,3
1649810213144,MATH 193B,A01,083463,Staff,22,0,30,8
1649810213144,MATH 193B,A02,083464,Staff,22,0,30,8
1649810213144,MATH 193B,A03,083465,Staff,30,0,30,0
1649810219194,COGS 2,A01,083966,Boyle; Mary E. T.,27,0,30,3
1649810225217,COGS 9,A01,083968,Staff,57,0,60,3
1649810231242,COGS 14B,A01,083970,Staff,48,0,50,2
1649810237270,COGS 17,A01,092679,Staff,75,0,75,0
1649810243299,COGS 100,A01,083972,Staff,49,0,60,11
1649810255354,COGS 101C,A01,083976,Staff,26,0,30,4
1649810261376,COGS 102A,A01,083978,Johnson; Christine M.,27,0,30,3
1649810267408,COGS 107B,A01,083980,Staff,41,0,50,9
1649810273429,COGS 115,A01,083982,Staff,23,0,30,7
1649810279455,COGS 118B,A01,083367,Staff,9,0,40,31
1649810285480,COGS 172,A01,083984,Provenzano; Emily Kara,25,0,30,5
1649810291504,COGS 177,A00,083368,Staff,12,0,30,18
1649810297624,COGS 186,A01,083986,Staff,28,0,40,12
1649810303649,COGS 187A,A01,083988,Boyle; Mary E. T.,46,0,60,14
1649810309673,CSE 8A,A50,084003,Miranda; Gregory Joseph,11,0,15,4
1649810315700,CSE 11,A01,084005,Miranda; Gregory Joseph,50,0,55,5
1649810321724,CSE 20,A01,084007,Staff,17,0,20,3
1649810327751,CSE 21,A01,084009,Staff,41,0,50,9
1649810333774,CSE 30,A01,083370,Cao; Yingjun,25,0,40,15
1649810339798,CSE 100,A01,083372,Cao; Yingjun,29,0,40,11
1649810345827,CSE 101,A01,084011,Staff,7,0,40,33
1649810351854,CSE 141,A01,083374,Eldon; John,9,0,75,66
1649810357877,CSE 141L,A01,083376,Eldon; John,8,0,75,67
1649810363900,CSE 175,A01,084013,Kumar; Rakesh,25,0,25,0
1649810369928,CSE 190,A00,092508,Staff,15,0,15,0
1649810375950,ECE 5,A01,084049,Morris; Karcher William,18,0,20,2
1649810381975,ECE 100,A01,084051,Baghdadchi; Saharnaz,17,0,20,3
1649810381975,ECE 100,A02,091916,Baghdadchi; Saharnaz,18,0,20,2
1649810388005,ECE 101,A01,084053,Baghdadchi; Saharnaz,27,0,37,10
1649810388005,ECE 101,A02,084054,Baghdadchi; Saharnaz,37,0,37,0
1649810394040,ECE 107,A01,083390,Staff,34,0,40,6
1649810400063,ECE 148,A01,084056,Silberman; Jack,8,0,12,4
1649810406090,ECE 180,A00,083391,Abi Samra; Nicholas Camill,27,0,30,3
1649810406090,ECE 180,B00,083392,Abi Samra; Nicholas Camill,26,0,30,4
1649810412117,MATH 10B,A01,084110,Staff,22,0,30,8
1649810412117,MATH 10B,A02,084111,Staff,29,0,30,1
1649810412117,MATH 10B,A03,084112,Staff,29,0,30,1
1649810418143,MATH 10C,A01,083443,Staff,22,0,30,8
1649810418143,MATH 10C,A02,083444,Staff,26,0,30,4
1649810418143,MATH 10C,B01,084114,Staff,27,0,30,3
1649810418143,MATH 10C,B02,084115,Staff,30,0,30,0
1649810424175,MATH 18,A01,084117,Harel; Guershon,28,0,30,2
1649810424175,MATH 18,A02,084119,Harel; Guershon,29,0,30,1
1649810424175,MATH 18,A03,084120,Harel; Guershon,30,0,30,0
1649810424175,MATH 18,A04,084121,Harel; Guershon,30,0,30,0
1649810430199,MATH 20B,A01,084124,Um; Ko Woon,33,0,35,2
1649810430199,MATH 20B,B01,084126,Um; Ko Woon,35,0,35,0
1649810436232,MATH 20C,A01,083446,Hammock; Frances H,27,0,30,3
1649810436232,MATH 20C,A02,083447,Hammock; Frances H,30,0,30,0
1649810436232,MATH 20C,A03,083448,Hammock; Frances H,30,0,30,0
1649810436232,MATH 20C,A04,083449,Hammock; Frances H,30,0,30,0
1649810436232,MATH 20C,B01,083451,Hammock; Frances H,30,0,30,0
1649810436232,MATH 20C,B02,083452,Hammock; Frances H,30,0,30,0
1649810436232,MATH 20C,B03,083453,Hammock; Frances H,30,0,30,0
1649810436232,MATH 20C,B04,083454,Hammock; Frances H,30,0,30,0
1649810442258,MATH 20D,A01,084128,Staff,30,0,30,0
1649810442258,MATH 20D,A02,084129,Staff,30,0,30,0
1649810442258,MATH 20D,A03,084130,Staff,29,0,30,1
1649810442258,MATH 20D,B01,084133,Staff,28,0,30,2
1649810442258,MATH 20D,B02,084134,Staff,30,0,30,0
1649810442258,MATH 20D,B03,084135,Staff,30,0,30,0
1649810448286,MATH 20E,A01,084138,Staff,29,0,30,1
1649810448286,MATH 20E,A02,084139,Staff,29,0,30,1
1649810448286,MATH 20E,A03,084140,Staff,29,0,30,1
1649810448286,MATH 20E,A04,084141,Staff,30,0,30,0
1649810454313,MATH 102,A01,084143,Harel; Guershon,25,0,30,5
1649810454313,MATH 102,A02,084144,Harel; Guershon,28,0,30,2
1649810460336,MATH 103B,A01,083456,Staff,10,0,30,20
1649810460336,MATH 103B,A02,083457,Staff,24,0,30,6
1649810466366,MATH 109,A01,084146,Salehi Golsefidy; Alireza,30,0,30,0
1649810466366,MATH 109,A02,084147,Salehi Golsefidy; Alireza,27,0,30,3
1649810472393,MATH 120A,A01,085445,Eggers; John Dietrich,31,0,35,4
1649810472393,MATH 120A,A02,085446,Eggers; John Dietrich,32,0,35,3
1649810478428,MATH 142B,A01,084149,Verstraete; Jacques Allan,18,0,30,12
1649810478428,MATH 142B,A02,084150,Verstraete; Jacques Allan,26,0,30,4
1649810484450,MATH 170A,A01,083459,Nie; Jiawang,16,0,30,14
1649810484450,MATH 170A,A02,083460,Nie; Jiawang,26,0,30,4
1649810484450,MATH 170A,A03,083461,Nie; Jiawang,27,0,30,3
1649810490475,MATH 193B,A01,083463,Staff,22,0,30,8
1649810490475,MATH 193B,A02,083464,Staff,22,0,30,8
1649810490475,MATH 193B,A03,083465,Staff,30,0,30,0
1649810496532,COGS 2,A01,083966,Boyle; Mary E. T.,27,0,30,3
1649810502563,COGS 9,A01,083968,Staff,57,0,60,3
1649810508586,COGS 14B,A01,083970,Staff,48,0,50,2
1649810514612,COGS 17,A01,092679,Staff,75,0,75,0
1649810520635,COGS 100,A01,083972,Staff,49,0,60,11
1649810532679,COGS 101C,A01,083976,Staff,26,0,30,4
1649810538706,COGS 102A,A01,083978,Johnson; Christine M.,27,0,30,3
1649810544730,COGS 107B,A01,083980,Staff,41,0,50,9
1649810550755,COGS 115,A01,083982,Staff,23,0,30,7
1649810556780,COGS 118B,A01,083367,Staff,9,0,40,31
1649810562805,COGS 172,A01,083984,Provenzano; Emily Kara,25,0,30,5
1649810568833,COGS 177,A00,083368,Staff,12,0,30,18
1649810574856,COGS 186,A01,083986,Staff,28,0,40,12
1649810580881,COGS 187A,A01,083988,Boyle; Mary E. T.,46,0,60,14
1649810586906,CSE 8A,A50,084003,Miranda; Gregory Joseph,11,0,15,4
1649810592930,CSE 11,A01,084005,Miranda; Gregory Joseph,50,0,55,5
1649810598962,CSE 20,A01,084007,Staff,17,0,20,3
1649810604995,CSE 21,A01,084009,Staff,41,0,50,9
1649810611030,CSE 30,A01,083370,Cao; Yingjun,25,0,40,15
1649810617061,CSE 100,A01,083372,Cao; Yingjun,29,0,40,11
1649810623083,CSE 101,A01,084011,Staff,6,0,40,34
1649810629107,CSE 141,A01,083374,Eldon; John,8,0,75,67
1649810635133,CSE 141L,A01,083376,Eldon; John,7,0,75,68
1649810641157,CSE 175,A01,084013,Kumar; Rakesh,25,0,25,0
1649810647179,CSE 190,A00,092508,Staff,15,0,15,0
1649810653209,ECE 5,A01,084049,Morris; Karcher William,18,0,20,2
1649810659231,ECE 100,A01,084051,Baghdadchi; Saharnaz,17,0,20,3
1649810659231,ECE 100,A02,091916,Baghdadchi; Saharnaz,18,0,20,2
1649810665256,ECE 101,A01,084053,Baghdadchi; Saharnaz,27,0,37,10
1649810665256,ECE 101,A02,084054,Baghdadchi; Saharnaz,37,0,37,0
1649810671280,ECE 107,A01,083390,Staff,34,0,40,6
1649810677302,ECE 148,A01,084056,Silberman; Jack,8,0,12,4
1649810683324,ECE 180,A00,083391,Abi Samra; Nicholas Camill,27,0,30,3
1649810683324,ECE 180,B00,083392,Abi Samra; Nicholas Camill,26,0,30,4
1649810689347,MATH 10B,A01,084110,Staff,22,0,30,8
1649810689347,MATH 10B,A02,084111,Staff,29,0,30,1
1649810689347,MATH 10B,A03,084112,Staff,29,0,30,1
1649810695369,MATH 10C,A01,083443,Staff,22,0,30,8
1649810695369,MATH 10C,A02,083444,Staff,26,0,30,4
1649810695369,MATH 10C,B01,084114,Staff,27,0,30,3
1649810695369,MATH 10C,B02,084115,Staff,30,0,30,0
1649810701399,MATH 18,A01,084117,Harel; Guershon,28,0,30,2
1649810701399,MATH 18,A02,084119,Harel; Guershon,29,0,30,1
1649810701399,MATH 18,A03,084120,Harel; Guershon,30,0,30,0
1649810701399,MATH 18,A04,084121,Harel; Guershon,30,0,30,0
1649810707423,MATH 20B,A01,084124,Um; Ko Woon,33,0,35,2
1649810707423,MATH 20B,B01,084126,Um; Ko Woon,35,0,35,0
1649810713447,MATH 20C,A01,083446,Hammock; Frances H,27,0,30,3
1649810713447,MATH 20C,A02,083447,Hammock; Frances H,30,0,30,0
1649810713447,MATH 20C,A03,083448,Hammock; Frances H,30,0,30,0
1649810713447,MATH 20C,A04,083449,Hammock; Frances H,30,0,30,0
1649810713447,MATH 20C,B01,083451,Hammock; Frances H,30,0,30,0
1649810713447,MATH 20C,B02,083452,Hammock; Frances H,30,0,30,0
1649810713447,MATH 20C,B03,083453,Hammock; Frances H,30,0,30,0
1649810713447,MATH 20C,B04,083454,Hammock; Frances H,30,0,30,0
1649810719479,MATH 20D,A01,084128,Staff,30,0,30,0
1649810719479,MATH 20D,A02,084129,Staff,30,0,30,0
1649810719479,MATH 20D,A03,084130,Staff,29,0,30,1
1649810719479,MATH 20D,B01,084133,Staff,28,0,30,2
1649810719479,MATH 20D,B02,084134,Staff,30,0,30,0
1649810719479,MATH 20D,B03,084135,Staff,30,0,30,0
1649810725513,MATH 20E,A01,084138,Staff,29,0,30,1
1649810725513,MATH 20E,A02,084139,Staff,29,0,30,1
1649810725513,MATH 20E,A03,084140,Staff,29,0,30,1
1649810725513,MATH 20E,A04,084141,Staff,30,0,30,0
1649810731536,MATH 102,A01,084143,Harel; Guershon,25,0,30,5
1649810731536,MATH 102,A02,084144,Harel; Guershon,28,0,30,2
1649810737560,MATH 103B,A01,083456,Staff,9,0,30,21
1649810737560,MATH 103B,A02,083457,Staff,24,0,30,6
1649810743585,MATH 109,A01,084146,Salehi Golsefidy; Alireza,30,0,30,0
1649810743585,MATH 109,A02,084147,Salehi Golsefidy; Alireza,27,0,30,3
1649810749623,MATH 120A,A01,085445,Eggers; John Dietrich,31,0,35,4
1649810749623,MATH 120A,A02,085446,Eggers; John Dietrich,32,0,35,3
1649810755644,MATH 142B,A01,084149,Verstraete; Jacques Allan,18,0,30,12
1649810755644,MATH 142B,A02,084150,Verstraete; Jacques Allan,26,0,30,4
1649810761672,MATH 170A,A01,083459,Nie; Jiawang,16,0,30,14
1649810761672,MATH 170A,A02,083460,Nie; Jiawang,26,0,30,4
1649810761672,MATH 170A,A03,083461,Nie; Jiawang,26,0,30,4
1649810767699,MATH 193B,A01,083463,Staff,22,0,30,8
1649810767699,MATH 193B,A02,083464,Staff,22,0,30,8
1649810767699,MATH 193B,A03,083465,Staff,30,0,30,0
1649810773759,COGS 2,A01,083966,Boyle; Mary E. T.,27,0,30,3
1649810779785,COGS 9,A01,083968,Staff,57,0,60,3
1649810785809,COGS 14B,A01,083970,Staff,48,0,50,2
1649810791834,COGS 17,A01,092679,Staff,75,0,75,0
1649810797858,COGS 100,A01,083972,Staff,49,0,60,11
1649810809917,COGS 101C,A01,083976,Staff,26,0,30,4
1649810815941,COGS 102A,A01,083978,Johnson; Christine M.,27,0,30,3
1649810821964,COGS 107B,A01,083980,Staff,41,0,50,9
1649810827988,COGS 115,A01,083982,Staff,23,0,30,7
1649810834018,COGS 118B,A01,083367,Staff,9,0,40,31
1649810840045,COGS 172,A01,083984,Provenzano; Emily Kara,25,0,30,5
1649810846080,COGS 177,A00,083368,Staff,12,0,30,18
1649810852107,COGS 186,A01,083986,Staff,28,0,40,12
1649810858141,COGS 187A,A01,083988,Boyle; Mary E. T.,46,0,60,14
1649810864172,CSE 8A,A50,084003,Miranda; Gregory Joseph,11,0,15,4
1649810870196,CSE 11,A01,084005,Miranda; Gregory Joseph,50,0,55,5
1649810876217,CSE 20,A01,084007,Staff,17,0,20,3
1649810882239,CSE 21,A01,084009,Staff,41,0,50,9
1649810888274,CSE 30,A01,083370,Cao; Yingjun,25,0,40,15
1649810894374,CSE 100,A01,083372,Cao; Yingjun,29,0,40,11
1649810900399,CSE 101,A01,084011,Staff,5,0,40,35
1649810906426,CSE 141,A01,083374,Eldon; John,8,0,75,67
1649810912448,CSE 141L,A01,083376,Eldon; John,7,0,75,68
1649810918471,CSE 175,A01,084013,Kumar; Rakesh,25,0,25,0
1649810924496,CSE 190,A00,092508,Staff,15,0,15,0
1649810930521,ECE 5,A01,084049,Morris; Karcher William,18,0,20,2
1649810936557,ECE 100,A01,084051,Baghdadchi; Saharnaz,17,0,20,3
1649810936557,ECE 100,A02,091916,Baghdadchi; Saharnaz,18,0,20,2
1649810942581,ECE 101,A01,084053,Baghdadchi; Saharnaz,27,0,37,10
1649810942581,ECE 101,A02,084054,Baghdadchi; Saharnaz,37,0,37,0
1649810948612,ECE 107,A01,083390,Staff,34,0,40,6
1649810954634,ECE 148,A01,084056,Silberman; Jack,8,0,12,4
1649810960656,ECE 180,A00,083391,Abi Samra; Nicholas Camill,27,0,30,3
1649810960656,ECE 180,B00,083392,Abi Samra; Nicholas Camill,26,0,30,4
1649810966682,MATH 10B,A01,084110,Staff,22,0,30,8
1649810966682,MATH 10B,A02,084111,Staff,29,0,30,1
1649810966682,MATH 10B,A03,084112,Staff,29,0,30,1
1649810972711,MATH 10C,A01,083443,Staff,22,0,30,8
1649810972711,MATH 10C,A02,083444,Staff,26,0,30,4
1649810972711,MATH 10C,B01,084114,Staff,27,0,30,3
1649810972711,MATH 10C,B02,084115,Staff,30,0,30,0
1649810978736,MATH 18,A01,084117,Harel; Guershon,28,0,30,2
1649810978736,MATH 18,A02,084119,Harel; Guershon,29,0,30,1
1649810978736,MATH 18,A03,084120,Harel; Guershon,30,0,30,0
1649810978736,MATH 18,A04,084121,Harel; Guershon,30,0,30,0
1649810984763,MATH 20B,A01,084124,Um; Ko Woon,33,0,35,2
1649810984763,MATH 20B,B01,084126,Um; Ko Woon,35,0,35,0
1649810990789,MATH 20C,A01,083446,Hammock; Frances H,27,0,30,3
1649810990789,MATH 20C,A02,083447,Hammock; Frances H,30,0,30,0
1649810990789,MATH 20C,A03,083448,Hammock; Frances H,30,0,30,0
1649810990789,MATH 20C,A04,083449,Hammock; Frances H,30,0,30,0
1649810990789,MATH 20C,B01,083451,Hammock; Frances H,30,0,30,0
1649810990789,MATH 20C,B02,083452,Hammock; Frances H,30,0,30,0
1649810990789,MATH 20C,B03,083453,Hammock; Frances H,30,0,30,0
1649810990789,MATH 20C,B04,083454,Hammock; Frances H,30,0,30,0
1649810996812,MATH 20D,A01,084128,Staff,30,0,30,0
1649810996812,MATH 20D,A02,084129,Staff,30,0,30,0
1649810996812,MATH 20D,A03,084130,Staff,29,0,30,1
1649810996812,MATH 20D,B01,084133,Staff,28,0,30,2
1649810996812,MATH 20D,B02,084134,Staff,30,0,30,0
1649810996812,MATH 20D,B03,084135,Staff,30,0,30,0
1649811002837,MATH 20E,A01,084138,Staff,29,0,30,1
1649811002837,MATH 20E,A02,084139,Staff,29,0,30,1
1649811002837,MATH 20E,A03,084140,Staff,29,0,30,1
1649811002837,MATH 20E,A04,084141,Staff,30,0,30,0
1649811008860,MATH 102,A01,084143,Harel; Guershon,25,0,30,5
1649811008860,MATH 102,A02,084144,Harel; Guershon,28,0,30,2
1649811014884,MATH 103B,A01,083456,Staff,9,0,30,21
1649811014884,MATH 103B,A02,083457,Staff,24,0,30,6
1649811020914,MATH 109,A01,084146,Salehi Golsefidy; Alireza,30,0,30,0
1649811020914,MATH 109,A02,084147,Salehi Golsefidy; Alireza,27,0,30,3
1649811026937,MATH 120A,A01,085445,Eggers; John Dietrich,31,0,35,4
1649811026937,MATH 120A,A02,085446,Eggers; John Dietrich,32,0,35,3
1649811032972,MATH 142B,A01,084149,Verstraete; Jacques Allan,18,0,30,12
1649811032972,MATH 142B,A02,084150,Verstraete; Jacques Allan,26,0,30,4
1649811038999,MATH 170A,A01,083459,Nie; Jiawang,16,0,30,14
1649811038999,MATH 170A,A02,083460,Nie; Jiawang,26,0,30,4
1649811038999,MATH 170A,A03,083461,Nie; Jiawang,26,0,30,4
1649811045027,MATH 193B,A01,083463,Staff,22,0,30,8
1649811045027,MATH 193B,A02,083464,Staff,22,0,30,8
1649811045027,MATH 193B,A03,083465,Staff,30,0,30,0
1649811051080,COGS 2,A01,083966,Boyle; Mary E. T.,27,0,30,3
1649811057106,COGS 9,A01,083968,Staff,57,0,60,3
1649811063139,COGS 14B,A01,083970,Staff,48,0,50,2
1649811069161,COGS 17,A01,092679,Staff,75,0,75,0
1649811075184,COGS 100,A01,083972,Staff,49,0,60,11
1649811087228,COGS 101C,A01,083976,Staff,26,0,30,4
1649811093252,COGS 102A,A01,083978,Johnson; Christine M.,27,0,30,3
1649811099276,COGS 107B,A01,083980,Staff,41,0,50,9
1649811105299,COGS 115,A01,083982,Staff,23,0,30,7
1649811111324,COGS 118B,A01,083367,Staff,9,0,40,31
1649811117346,COGS 172,A01,083984,Provenzano; Emily Kara,25,0,30,5
1649811123372,COGS 177,A00,083368,Staff,12,0,30,18
1649811129397,COGS 186,A01,083986,Staff,28,0,40,12
1649811135429,COGS 187A,A01,083988,Boyle; Mary E. T.,46,0,60,14
1649811141458,CSE 8A,A50,084003,Miranda; Gregory Joseph,11,0,15,4
1649811147485,CSE 11,A01,084005,Miranda; Gregory Joseph,50,0,55,5
1649811153513,CSE 20,A01,084007,Staff,17,0,20,3
1649811159536,CSE 21,A01,084009,Staff,41,0,50,9
1649811165567,CSE 30,A01,083370,Cao; Yingjun,25,0,40,15
1649811171593,CSE 100,A01,083372,Cao; Yingjun,29,0,40,11
1649811177617,CSE 101,A01,084011,Staff,4,0,40,36
1649811183645,CSE 141,A01,083374,Eldon; John,8,0,75,67
1649811189667,CSE 141L,A01,083376,Eldon; John,7,0,75,68
1649811195703,CSE 175,A01,084013,Kumar; Rakesh,25,0,25,0
1649811201727,CSE 190,A00,092508,Staff,15,0,15,0
1649811207763,ECE 5,A01,084049,Morris; Karcher William,18,0,20,2
1649811213799,ECE 100,A01,084051,Baghdadchi; Saharnaz,17,0,20,3
1649811213799,ECE 100,A02,091916,Baghdadchi; Saharnaz,18,0,20,2
1649811219827,ECE 101,A01,084053,Baghdadchi; Saharnaz,27,0,37,10
1649811219827,ECE 101,A02,084054,Baghdadchi; Saharnaz,37,0,37,0
1649811225851,ECE 107,A01,083390,Staff,34,0,40,6
1649811231879,ECE 148,A01,084056,Silberman; Jack,8,0,12,4
1649811237910,ECE 180,A00,083391,Abi Samra; Nicholas Camill,27,0,30,3
1649811237910,ECE 180,B00,083392,Abi Samra; Nicholas Camill,26,0,30,4
1649811243932,MATH 10B,A01,084110,Staff,22,0,30,8
1649811243932,MATH 10B,A02,084111,Staff,29,0,30,1
1649811243932,MATH 10B,A03,084112,Staff,29,0,30,1
1649811249960,MATH 10C,A01,083443,Staff,22,0,30,8
1649811249960,MATH 10C,A02,083444,Staff,26,0,30,4
1649811249960,MATH 10C,B01,084114,Staff,26,0,30,4
1649811249960,MATH 10C,B02,084115,Staff,30,0,30,0
1649811255982,MATH 18,A01,084117,Harel; Guershon,28,0,30,2
1649811255982,MATH 18,A02,084119,Harel; Guershon,29,0,30,1
1649811255982,MATH 18,A03,084120,Harel; Guershon,30,0,30,0
1649811255982,MATH 18,A04,084121,Harel; Guershon,30,0,30,0
1649811262005,MATH 20B,A01,084124,Um; Ko Woon,33,0,35,2
1649811262005,MATH 20B,B01,084126,Um; Ko Woon,35,0,35,0
1649811268029,MATH 20C,A01,083446,Hammock; Frances H,27,0,30,3
1649811268029,MATH 20C,A02,083447,Hammock; Frances H,30,0,30,0
1649811268029,MATH 20C,A03,083448,Hammock; Frances H,30,0,30,0
1649811268029,MATH 20C,A04,083449,Hammock; Frances H,30,0,30,0
1649811268029,MATH 20C,B01,083451,Hammock; Frances H,30,0,30,0
1649811268029,MATH 20C,B02,083452,Hammock; Frances H,30,0,30,0
1649811268029,MATH 20C,B03,083453,Hammock; Frances H,30,0,30,0
1649811268029,MATH 20C,B04,083454,Hammock; Frances H,30,0,30,0
1649811274058,MATH 20D,A01,084128,Staff,30,0,30,0
1649811274058,MATH 20D,A02,084129,Staff,30,0,30,0
1649811274058,MATH 20D,A03,084130,Staff,29,0,30,1
1649811274058,MATH 20D,B01,084133,Staff,28,0,30,2
1649811274058,MATH 20D,B02,084134,Staff,30,0,30,0
1649811274058,MATH 20D,B03,084135,Staff,30,0,30,0
1649811280084,MATH 20E,A01,084138,Staff,29,0,30,1
1649811280084,MATH 20E,A02,084139,Staff,29,0,30,1
1649811280084,MATH 20E,A03,084140,Staff,29,0,30,1
1649811280084,MATH 20E,A04,084141,Staff,30,0,30,0
1649811286121,MATH 102,A01,084143,Harel; Guershon,25,0,30,5
1649811286121,MATH 102,A02,084144,Harel; Guershon,27,0,30,3
1649811292148,MATH 103B,A01,083456,Staff,9,0,30,21
1649811292148,MATH 103B,A02,083457,Staff,24,0,30,6
1649811298172,MATH 109,A01,084146,Salehi Golsefidy; Alireza,30,0,30,0
1649811298172,MATH 109,A02,084147,Salehi Golsefidy; Alireza,27,0,30,3
1649811304197,MATH 120A,A01,085445,Eggers; John Dietrich,31,0,35,4
1649811304197,MATH 120A,A02,085446,Eggers; John Dietrich,32,0,35,3
1649811310222,MATH 142B,A01,084149,Verstraete; Jacques Allan,18,0,30,12
1649811310222,MATH 142B,A02,084150,Verstraete; Jacques Allan,26,0,30,4
1649811316246,MATH 170A,A01,083459,Nie; Jiawang,16,0,30,14
1649811316246,MATH 170A,A02,083460,Nie; Jiawang,26,0,30,4
1649811316246,MATH 170A,A03,083461,Nie; Jiawang,26,0,30,4
1649811322272,MATH 193B,A01,083463,Staff,22,0,30,8
1649811322272,MATH 193B,A02,083464,Staff,22,0,30,8
1649811322272,MATH 193B,A03,083465,Staff,30,0,30,0
1649811328324,COGS 2,A01,083966,Boyle; Mary E. T.,27,0,30,3
1649811334356,COGS 9,A01,083968,Staff,57,0,60,3
1649811340383,COGS 14B,A01,083970,Staff,48,0,50,2
1649811346417,COGS 17,A01,092679,Staff,75,0,75,0
1649811352439,COGS 100,A01,083972,Staff,49,0,60,11
1649811364490,COGS 101C,A01,083976,Staff,26,0,30,4
1649811370518,COGS 102A,A01,083978,Johnson; Christine M.,27,0,30,3
1649811376548,COGS 107B,A01,083980,Staff,41,0,50,9
1649811382572,COGS 115,A01,083982,Staff,23,0,30,7
1649811388595,COGS 118B,A01,083367,Staff,9,0,40,31
1649811394622,COGS 172,A01,083984,Provenzano; Emily Kara,24,0,30,6
1649811400645,COGS 177,A00,083368,Staff,12,0,30,18
1649811406668,COGS 186,A01,083986,Staff,28,0,40,12
1649811412695,COGS 187A,A01,083988,Boyle; Mary E. T.,46,0,60,14
1649811418720,CSE 8A,A50,084003,Miranda; Gregory Joseph,11,0,15,4
1649811424745,CSE 11,A01,084005,Miranda; Gregory Joseph,50,0,55,5
1649811430781,CSE 20,A01,084007,Staff,17,0,20,3
1649811436804,CSE 21,A01,084009,Staff,41,0,50,9
1649811442831,CSE 30,A01,083370,Cao; Yingjun,25,0,40,15
1649811448865,CSE 100,A01,083372,Cao; Yingjun,29,0,40,11
1649811454892,CSE 101,A01,084011,Staff,4,0,40,36
1649811460915,CSE 141,A01,083374,Eldon; John,8,0,75,67
1649811466940,CSE 141L,A01,083376,Eldon; John,7,0,75,68
1649811472979,CSE 175,A01,084013,Kumar; Rakesh,25,0,25,0
1649811479005,CSE 190,A00,092508,Staff,15,0,15,0
1649811485043,ECE 5,A01,084049,Morris; Karcher William,18,0,20,2
1649811491147,ECE 100,A01,084051,Baghdadchi; Saharnaz,17,0,20,3
1649811491147,ECE 100,A02,091916,Baghdadchi; Saharnaz,18,0,20,2
1649811497174,ECE 101,A01,084053,Baghdadchi; Saharnaz,27,0,37,10
1649811497174,ECE 101,A02,084054,Baghdadchi; Saharnaz,37,0,37,0
1649811503205,ECE 107,A01,083390,Staff,34,0,40,6
1649811509229,ECE 148,A01,084056,Silberman; Jack,8,0,12,4
1649811515254,ECE 180,A00,083391,Abi Samra; Nicholas Camill,27,0,30,3
1649811515254,ECE 180,B00,083392,Abi Samra; Nicholas Camill,26,0,30,4
1649811521279,MATH 10B,A01,084110,Staff,22,0,30,8
1649811521279,MATH 10B,A02,084111,Staff,29,0,30,1
1649811521279,MATH 10B,A03,084112,Staff,29,0,30,1
1649811527300,MATH 10C,A01,083443,Staff,22,0,30,8
1649811527300,MATH 10C,A02,083444,Staff,26,0,30,4
1649811527300,MATH 10C,B01,084114,Staff,26,0,30,4
1649811527300,MATH 10C,B02,084115,Staff,30,0,30,0
1649811533334,MATH 18,A01,084117,Harel; Guershon,28,0,30,2
1649811533334,MATH 18,A02,084119,Harel; Guershon,29,0,30,1
1649811533334,MATH 18,A03,084120,Harel; Guershon,30,0,30,0
1649811533334,MATH 18,A04,084121,Harel; Guershon,30,0,30,0
1649811539361,MATH 20B,A01,084124,Um; Ko Woon,33,0,35,2
1649811539361,MATH 20B,B01,084126,Um; Ko Woon,35,0,35,0
1649811545385,MATH 20C,A01,083446,Hammock; Frances H,27,0,30,3
1649811545385,MATH 20C,A02,083447,Hammock; Frances H,30,0,30,0
1649811545385,MATH 20C,A03,083448,Hammock; Frances H,30,0,30,0
1649811545385,MATH 20C,A04,083449,Hammock; Frances H,30,0,30,0
1649811545385,MATH 20C,B01,083451,Hammock; Frances H,30,0,30,0
1649811545385,MATH 20C,B02,083452,Hammock; Frances H,30,0,30,0
1649811545385,MATH 20C,B03,083453,Hammock; Frances H,30,0,30,0
1649811545385,MATH 20C,B04,083454,Hammock; Frances H,30,0,30,0
1649811551415,MATH 20D,A01,084128,Staff,30,0,30,0
1649811551415,MATH 20D,A02,084129,Staff,30,0,30,0
1649811551415,MATH 20D,A03,084130,Staff,29,0,30,1
1649811551415,MATH 20D,B01,084133,Staff,28,0,30,2
1649811551415,MATH 20D,B02,084134,Staff,30,0,30,0
1649811551415,MATH 20D,B03,084135,Staff,30,0,30,0
1649811557445,MATH 20E,A01,084138,Staff,29,0,30,1
1649811557445,MATH 20E,A02,084139,Staff,29,0,30,1
1649811557445,MATH 20E,A03,084140,Staff,29,0,30,1
1649811557445,MATH 20E,A04,084141,Staff,30,0,30,0
1649811563471,MATH 102,A01,084143,Harel; Guershon,25,0,30,5
1649811563471,MATH 102,A02,084144,Harel; Guershon,27,0,30,3
1649811569495,MATH 103B,A01,083456,Staff,9,0,30,21
1649811569495,MATH 103B,A02,083457,Staff,24,0,30,6
1649811575525,MATH 109,A01,084146,Salehi Golsefidy; Alireza,30,0,30,0
1649811575525,MATH 109,A02,084147,Salehi Golsefidy; Alireza,27,0,30,3
1649811581568,MATH 120A,A01,085445,Eggers; John Dietrich,31,0,35,4
1649811581568,MATH 120A,A02,085446,Eggers; John Dietrich,32,0,35,3
1649811587601,MATH 142B,A01,084149,Verstraete; Jacques Allan,18,0,30,12
1649811587601,MATH 142B,A02,084150,Verstraete; Jacques Allan,26,0,30,4
1649811593624,MATH 170A,A01,083459,Nie; Jiawang,16,0,30,14
1649811593624,MATH 170A,A02,083460,Nie; Jiawang,26,0,30,4
1649811593624,MATH 170A,A03,083461,Nie; Jiawang,26,0,30,4
1649811599654,MATH 193B,A01,083463,Staff,22,0,30,8
1649811599654,MATH 193B,A02,083464,Staff,22,0,30,8
1649811599654,MATH 193B,A03,083465,Staff,30,0,30,0
1649811605709,COGS 2,A01,083966,Boyle; Mary E. T.,27,0,30,3
1649811611737,COGS 9,A01,083968,Staff,57,0,60,3
1649811617774,COGS 14B,A01,083970,Staff,48,0,50,2
1649811623805,COGS 17,A01,092679,Staff,75,0,75,0
1649811629831,COGS 100,A01,083972,Staff,49,0,60,11
1649811641892,COGS 101C,A01,083976,Staff,26,0,30,4
1649811647921,COGS 102A,A01,083978,Johnson; Christine M.,27,0,30,3
1649811653948,COGS 107B,A01,083980,Staff,41,0,50,9
1649811659974,COGS 115,A01,083982,Staff,23,0,30,7
1649811666006,COGS 118B,A01,083367,Staff,9,0,40,31
1649811672040,COGS 172,A01,083984,Provenzano; Emily Kara,24,0,30,6
1649811678074,COGS 177,A00,083368,Staff,12,0,30,18
1649811684101,COGS 186,A01,083986,Staff,28,0,40,12
1649811690133,COGS 187A,A01,083988,Boyle; Mary E. T.,46,0,60,14
1649811696162,CSE 8A,A50,084003,Miranda; Gregory Joseph,11,0,15,4
1649811702184,CSE 11,A01,084005,Miranda; Gregory Joseph,50,0,55,5
1649811708211,CSE 20,A01,084007,Staff,17,0,20,3
1649811714242,CSE 21,A01,084009,Staff,41,0,50,9
1649811720265,CSE 30,A01,083370,Cao; Yingjun,25,0,40,15
1649811726288,CSE 100,A01,083372,Cao; Yingjun,29,0,40,11
1649811732336,CSE 101,A01,084011,Staff,4,0,40,36
1649811738364,CSE 141,A01,083374,Eldon; John,8,0,75,67
1649811744393,CSE 141L,A01,083376,Eldon; John,7,0,75,68
1649811750415,CSE 175,A01,084013,Kumar; Rakesh,25,0,25,0
1649811756441,CSE 190,A00,092508,Staff,15,0,15,0
1649811762469,ECE 5,A01,084049,Morris; Karcher William,18,0,20,2
1649811768497,ECE 100,A01,084051,Baghdadchi; Saharnaz,17,0,20,3
1649811768497,ECE 100,A02,091916,Baghdadchi; Saharnaz,18,0,20,2
1649811774524,ECE 101,A01,084053,Baghdadchi; Saharnaz,27,0,37,10
1649811774524,ECE 101,A02,084054,Baghdadchi; Saharnaz,37,0,37,0
1649811780549,ECE 107,A01,083390,Staff,34,0,40,6
1649811786577,ECE 148,A01,084056,Silberman; Jack,8,0,12,4
1649811792608,ECE 180,A00,083391,Abi Samra; Nicholas Camill,27,0,30,3
1649811792608,ECE 180,B00,083392,Abi Samra; Nicholas Camill,26,0,30,4
1649811798634,MATH 10B,A01,084110,Staff,22,0,30,8
1649811798634,MATH 10B,A02,084111,Staff,29,0,30,1
1649811798634,MATH 10B,A03,084112,Staff,29,0,30,1
1649811804660,MATH 10C,A01,083443,Staff,22,0,30,8
1649811804660,MATH 10C,A02,083444,Staff,26,0,30,4
1649811804660,MATH 10C,B01,084114,Staff,26,0,30,4
1649811804660,MATH 10C,B02,084115,Staff,30,0,30,0
1649811810688,MATH 18,A01,084117,Harel; Guershon,28,0,30,2
1649811810688,MATH 18,A02,084119,Harel; Guershon,29,0,30,1
1649811810688,MATH 18,A03,084120,Harel; Guershon,30,0,30,0
1649811810688,MATH 18,A04,084121,Harel; Guershon,30,0,30,0
1649811816718,MATH 20B,A01,084124,Um; Ko Woon,33,0,35,2
1649811816718,MATH 20B,B01,084126,Um; Ko Woon,35,0,35,0
1649811822754,MATH 20C,A01,083446,Hammock; Frances H,27,0,30,3
1649811822754,MATH 20C,A02,083447,Hammock; Frances H,30,0,30,0
1649811822754,MATH 20C,A03,083448,Hammock; Frances H,30,0,30,0
1649811822754,MATH 20C,A04,083449,Hammock; Frances H,30,0,30,0
1649811822754,MATH 20C,B01,083451,Hammock; Frances H,30,0,30,0
1649811822754,MATH 20C,B02,083452,Hammock; Frances H,30,0,30,0
1649811822754,MATH 20C,B03,083453,Hammock; Frances H,30,0,30,0
1649811822754,MATH 20C,B04,083454,Hammock; Frances H,30,0,30,0
1649811828780,MATH 20D,A01,084128,Staff,30,0,30,0
1649811828780,MATH 20D,A02,084129,Staff,30,0,30,0
1649811828780,MATH 20D,A03,084130,Staff,29,0,30,1
1649811828780,MATH 20D,B01,084133,Staff,28,0,30,2
1649811828780,MATH 20D,B02,084134,Staff,30,0,30,0
1649811828780,MATH 20D,B03,084135,Staff,30,0,30,0
1649811834804,MATH 20E,A01,084138,Staff,29,0,30,1
1649811834804,MATH 20E,A02,084139,Staff,29,0,30,1
1649811834804,MATH 20E,A03,084140,Staff,29,0,30,1
1649811834804,MATH 20E,A04,084141,Staff,30,0,30,0
1649811840829,MATH 102,A01,084143,Harel; Guershon,25,0,30,5
1649811840829,MATH 102,A02,084144,Harel; Guershon,27,0,30,3
1649811846863,MATH 103B,A01,083456,Staff,9,0,30,21
1649811846863,MATH 103B,A02,083457,Staff,24,0,30,6
1649811852894,MATH 109,A01,084146,Salehi Golsefidy; Alireza,30,0,30,0
1649811852894,MATH 109,A02,084147,Salehi Golsefidy; Alireza,27,0,30,3
1649811858917,MATH 120A,A01,085445,Eggers; John Dietrich,31,0,35,4
1649811858917,MATH 120A,A02,085446,Eggers; John Dietrich,32,0,35,3
1649811864945,MATH 142B,A01,084149,Verstraete; Jacques Allan,18,0,30,12
1649811864945,MATH 142B,A02,084150,Verstraete; Jacques Allan,26,0,30,4
1649811870978,MATH 170A,A01,083459,Nie; Jiawang,16,0,30,14
1649811870978,MATH 170A,A02,083460,Nie; Jiawang,26,0,30,4
1649811870978,MATH 170A,A03,083461,Nie; Jiawang,26,0,30,4
1649811877001,MATH 193B,A01,083463,Staff,22,0,30,8
1649811877001,MATH 193B,A02,083464,Staff,22,0,30,8
1649811877001,MATH 193B,A03,083465,Staff,30,0,30,0
1649811883065,COGS 2,A01,083966,Boyle; Mary E. T.,27,0,30,3
1649811889092,COGS 9,A01,083968,Staff,57,0,60,3
1649811895116,COGS 14B,A01,083970,Staff,48,0,50,2
1649811901144,COGS 17,A01,092679,Staff,75,0,75,0
1649811907170,COGS 100,A01,083972,Staff,49,0,60,11
1649811919233,COGS 101C,A01,083976,Staff,26,0,30,4
1649811925262,COGS 102A,A01,083978,Johnson; Christine M.,27,0,30,3
1649811931289,COGS 107B,A01,083980,Staff,41,0,50,9
1649811937321,COGS 115,A01,083982,Staff,23,0,30,7
1649811943348,COGS 118B,A01,083367,Staff,9,0,40,31
1649811949371,COGS 172,A01,083984,Provenzano; Emily Kara,24,0,30,6
1649811955400,COGS 177,A00,083368,Staff,12,0,30,18
1649811961426,COGS 186,A01,083986,Staff,28,0,40,12
1649811967451,COGS 187A,A01,083988,Boyle; Mary E. T.,46,0,60,14
1649811973485,CSE 8A,A50,084003,Miranda; Gregory Joseph,11,0,15,4
1649811979510,CSE 11,A01,084005,Miranda; Gregory Joseph,50,0,55,5
1649811985538,CSE 20,A01,084007,Staff,17,0,20,3
1649811991562,CSE 21,A01,084009,Staff,41,0,50,9
1649811997592,CSE 30,A01,083370,Cao; Yingjun,25,0,40,15
1649812003616,CSE 100,A01,083372,Cao; Yingjun,29,0,40,11
1649812009645,CSE 101,A01,084011,Staff,4,0,40,36
1649812015670,CSE 141,A01,083374,Eldon; John,8,0,75,67
1649812021693,CSE 141L,A01,083376,Eldon; John,7,0,75,68
1649812027723,CSE 175,A01,084013,Kumar; Rakesh,25,0,25,0
1649812033748,CSE 190,A00,092508,Staff,15,0,15,0
1649812039776,ECE 5,A01,084049,Morris; Karcher William,18,0,20,2
1649812045801,ECE 100,A01,084051,Baghdadchi; Saharnaz,17,0,20,3
1649812045801,ECE 100,A02,091916,Baghdadchi; Saharnaz,18,0,20,2
1649812051837,ECE 101,A01,084053,Baghdadchi; Saharnaz,27,0,37,10
1649812051837,ECE 101,A02,084054,Baghdadchi; Saharnaz,37,0,37,0
1649812057878,ECE 107,A01,083390,Staff,34,0,40,6
1649812063902,ECE 148,A01,084056,Silberman; Jack,8,0,12,4
1649812069928,ECE 180,A00,083391,Abi Samra; Nicholas Camill,27,0,30,3
1649812069928,ECE 180,B00,083392,Abi Samra; Nicholas Camill,26,0,30,4
1649812075952,MATH 10B,A01,084110,Staff,22,0,30,8
1649812075952,MATH 10B,A02,084111,Staff,29,0,30,1
1649812075952,MATH 10B,A03,084112,Staff,29,0,30,1
1649812081974,MATH 10C,A01,083443,Staff,22,0,30,8
1649812081974,MATH 10C,A02,083444,Staff,26,0,30,4
1649812081974,MATH 10C,B01,084114,Staff,26,0,30,4
1649812081974,MATH 10C,B02,084115,Staff,30,0,30,0
1649812088102,MATH 18,A01,084117,Harel; Guershon,28,0,30,2
1649812088102,MATH 18,A02,084119,Harel; Guershon,29,0,30,1
1649812088102,MATH 18,A03,084120,Harel; Guershon,30,0,30,0
1649812088102,MATH 18,A04,084121,Harel; Guershon,30,0,30,0
1649812094125,MATH 20B,A01,084124,Um; Ko Woon,33,0,35,2
1649812094125,MATH 20B,B01,084126,Um; Ko Woon,35,0,35,0
1649812100161,MATH 20C,A01,083446,Hammock; Frances H,27,0,30,3
1649812100161,MATH 20C,A02,083447,Hammock; Frances H,30,0,30,0
1649812100161,MATH 20C,A03,083448,Hammock; Frances H,30,0,30,0
1649812100161,MATH 20C,A04,083449,Hammock; Frances H,30,0,30,0
1649812100161,MATH 20C,B01,083451,Hammock; Frances H,30,0,30,0
1649812100161,MATH 20C,B02,083452,Hammock; Frances H,30,0,30,0
1649812100161,MATH 20C,B03,083453,Hammock; Frances H,30,0,30,0
1649812100161,MATH 20C,B04,083454,Hammock; Frances H,30,0,30,0
1649812106193,MATH 20D,A01,084128,Staff,30,0,30,0
1649812106193,MATH 20D,A02,084129,Staff,30,0,30,0
1649812106193,MATH 20D,A03,084130,Staff,29,0,30,1
1649812106193,MATH 20D,B01,084133,Staff,28,0,30,2
1649812106193,MATH 20D,B02,084134,Staff,30,0,30,0
1649812106193,MATH 20D,B03,084135,Staff,30,0,30,0
1649812112222,MATH 20E,A01,084138,Staff,29,0,30,1
1649812112222,MATH 20E,A02,084139,Staff,29,0,30,1
1649812112222,MATH 20E,A03,084140,Staff,29,0,30,1
1649812112222,MATH 20E,A04,084141,Staff,30,0,30,0
1649812118245,MATH 102,A01,084143,Harel; Guershon,25,0,30,5
1649812118245,MATH 102,A02,084144,Harel; Guershon,27,0,30,3
1649812124282,MATH 103B,A01,083456,Staff,9,0,30,21
1649812124282,MATH 103B,A02,083457,Staff,24,0,30,6
1649812130306,MATH 109,A01,084146,Salehi Golsefidy; Alireza,30,0,30,0
1649812130306,MATH 109,A02,084147,Salehi Golsefidy; Alireza,27,0,30,3
1649812136333,MATH 120A,A01,085445,Eggers; John Dietrich,31,0,35,4
1649812136333,MATH 120A,A02,085446,Eggers; John Dietrich,32,0,35,3
1649812142356,MATH 142B,A01,084149,Verstraete; Jacques Allan,18,0,30,12
1649812142356,MATH 142B,A02,084150,Verstraete; Jacques Allan,26,0,30,4
1649812148379,MATH 170A,A01,083459,Nie; Jiawang,16,0,30,14
1649812148379,MATH 170A,A02,083460,Nie; Jiawang,26,0,30,4
1649812148379,MATH 170A,A03,083461,Nie; Jiawang,26,0,30,4
1649812154405,MATH 193B,A01,083463,Staff,22,0,30,8
1649812154405,MATH 193B,A02,083464,Staff,22,0,30,8
1649812154405,MATH 193B,A03,083465,Staff,30,0,30,0
1649812160469,COGS 2,A01,083966,Boyle; Mary E. T.,27,0,30,3
1649812166497,COGS 9,A01,083968,Staff,57,0,60,3
1649812172524,COGS 14B,A01,083970,Staff,48,0,50,2
1649812178559,COGS 17,A01,092679,Staff,75,0,75,0
1649812184588,COGS 100,A01,083972,Staff,49,0,60,11
1649812196637,COGS 101C,A01,083976,Staff,26,0,30,4
1649812202665,COGS 102A,A01,083978,Johnson; Christine M.,27,0,30,3
1649812208691,COGS 107B,A01,083980,Staff,41,0,50,9
1649812214715,COGS 115,A01,083982,Staff,23,0,30,7
1649812220753,COGS 118B,A01,083367,Staff,9,0,40,31
1649812226776,COGS 172,A01,083984,Provenzano; Emily Kara,24,0,30,6
1649812232799,COGS 177,A00,083368,Staff,12,0,30,18
1649812238826,COGS 186,A01,083986,Staff,28,0,40,12
1649812244854,COGS 187A,A01,083988,Boyle; Mary E. T.,46,0,60,14
1649812250878,CSE 8A,A50,084003,Miranda; Gregory Joseph,11,0,15,4
1649812256906,CSE 11,A01,084005,Miranda; Gregory Joseph,50,0,55,5
1649812262931,CSE 20,A01,084007,Staff,17,0,20,3
1649812268959,CSE 21,A01,084009,Staff,41,0,50,9
1649812274987,CSE 30,A01,083370,Cao; Yingjun,25,0,40,15
1649812281015,CSE 100,A01,083372,Cao; Yingjun,29,0,40,11
1649812287041,CSE 101,A01,084011,Staff,4,0,40,36
1649812293070,CSE 141,A01,083374,Eldon; John,8,0,75,67
1649812299095,CSE 141L,A01,083376,Eldon; John,7,0,75,68
1649812305125,CSE 175,A01,084013,Kumar; Rakesh,25,0,25,0
1649812311154,CSE 190,A00,092508,Staff,15,0,15,0
1649812317182,ECE 5,A01,084049,Morris; Karcher William,18,0,20,2
1649812323209,ECE 100,A01,084051,Baghdadchi; Saharnaz,17,0,20,3
1649812323209,ECE 100,A02,091916,Baghdadchi; Saharnaz,18,0,20,2
1649812338527,ECE 101,A01,084053,Baghdadchi; Saharnaz,27,0,37,10
1649812338527,ECE 101,A02,084054,Baghdadchi; Saharnaz,37,0,37,0
1649812344559,ECE 107,A01,083390,Staff,34,0,40,6
1649812350588,ECE 148,A01,084056,Silberman; Jack,8,0,12,4
1649812356614,ECE 180,A00,083391,Abi Samra; Nicholas Camill,27,0,30,3
1649812356614,ECE 180,B00,083392,Abi Samra; Nicholas Camill,26,0,30,4
1649812362643,MATH 10B,A01,084110,Staff,22,0,30,8
1649812362643,MATH 10B,A02,084111,Staff,29,0,30,1
1649812362643,MATH 10B,A03,084112,Staff,29,0,30,1
1649812368678,MATH 10C,A01,083443,Staff,22,0,30,8
1649812368678,MATH 10C,A02,083444,Staff,26,0,30,4
1649812368678,MATH 10C,B01,084114,Staff,26,0,30,4
1649812368678,MATH 10C,B02,084115,Staff,30,0,30,0
1649812374706,MATH 18,A01,084117,Harel; Guershon,28,0,30,2
1649812374706,MATH 18,A02,084119,Harel; Guershon,29,0,30,1
1649812374706,MATH 18,A03,084120,Harel; Guershon,30,0,30,0
1649812374706,MATH 18,A04,084121,Harel; Guershon,30,0,30,0
1649812380730,MATH 20B,A01,084124,Um; Ko Woon,33,0,35,2
1649812380730,MATH 20B,B01,084126,Um; Ko Woon,35,0,35,0
1649812386761,MATH 20C,A01,083446,Hammock; Frances H,27,0,30,3
1649812386761,MATH 20C,A02,083447,Hammock; Frances H,30,0,30,0
1649812386761,MATH 20C,A03,083448,Hammock; Frances H,30,0,30,0
1649812386761,MATH 20C,A04,083449,Hammock; Frances H,30,0,30,0
1649812386761,MATH 20C,B01,083451,Hammock; Frances H,30,0,30,0
1649812386761,MATH 20C,B02,083452,Hammock; Frances H,30,0,30,0
1649812386761,MATH 20C,B03,083453,Hammock; Frances H,30,0,30,0
1649812386761,MATH 20C,B04,083454,Hammock; Frances H,30,0,30,0
1649812392785,MATH 20D,A01,084128,Staff,30,0,30,0
1649812392785,MATH 20D,A02,084129,Staff,30,0,30,0
1649812392785,MATH 20D,A03,084130,Staff,29,0,30,1
1649812392785,MATH 20D,B01,084133,Staff,28,0,30,2
1649812392785,MATH 20D,B02,084134,Staff,30,0,30,0
1649812392785,MATH 20D,B03,084135,Staff,30,0,30,0
1649812398815,MATH 20E,A01,084138,Staff,29,0,30,1
1649812398815,MATH 20E,A02,084139,Staff,29,0,30,1
1649812398815,MATH 20E,A03,084140,Staff,29,0,30,1
1649812398815,MATH 20E,A04,084141,Staff,30,0,30,0
1649812404849,MATH 102,A01,084143,Harel; Guershon,25,0,30,5
1649812404849,MATH 102,A02,084144,Harel; Guershon,27,0,30,3
1649812410871,MATH 103B,A01,083456,Staff,9,0,30,21
1649812410871,MATH 103B,A02,083457,Staff,24,0,30,6
1649812416894,MATH 109,A01,084146,Salehi Golsefidy; Alireza,30,0,30,0
1649812416894,MATH 109,A02,084147,Salehi Golsefidy; Alireza,27,0,30,3
1649812422923,MATH 120A,A01,085445,Eggers; John Dietrich,31,0,35,4
1649812422923,MATH 120A,A02,085446,Eggers; John Dietrich,32,0,35,3
1649812428949,MATH 142B,A01,084149,Verstraete; Jacques Allan,18,0,30,12
1649812428949,MATH 142B,A02,084150,Verstraete; Jacques Allan,26,0,30,4
1649812434973,MATH 170A,A01,083459,Nie; Jiawang,16,0,30,14
1649812434973,MATH 170A,A02,083460,Nie; Jiawang,26,0,30,4
1649812434973,MATH 170A,A03,083461,Nie; Jiawang,26,0,30,4
1649812441009,MATH 193B,A01,083463,Staff,22,0,30,8
1649812441009,MATH 193B,A02,083464,Staff,22,0,30,8
1649812441009,MATH 193B,A03,083465,Staff,30,0,30,0
1649812447068,COGS 2,A01,083966,Boyle; Mary E. T.,27,0,30,3
1649812453094,COGS 9,A01,083968,Staff,57,0,60,3
1649812459123,COGS 14B,A01,083970,Staff,48,0,50,2
1649812465151,COGS 17,A01,092679,Staff,75,0,75,0
1649812471175,COGS 100,A01,083972,Staff,49,0,60,11
1649812483233,COGS 101C,A01,083976,Staff,26,0,30,4
1649812489258,COGS 102A,A01,083978,Johnson; Christine M.,27,0,30,3
1649812495285,COGS 107B,A01,083980,Staff,41,0,50,9
1649812501311,COGS 115,A01,083982,Staff,23,0,30,7
1649812507334,COGS 118B,A01,083367,Staff,9,0,40,31
1649812513357,COGS 172,A01,083984,Provenzano; Emily Kara,24,0,30,6
1649812519382,COGS 177,A00,083368,Staff,12,0,30,18
1649812525408,COGS 186,A01,083986,Staff,28,0,40,12
1649812531433,COGS 187A,A01,083988,Boyle; Mary E. T.,46,0,60,14
1649812537462,CSE 8A,A50,084003,Miranda; Gregory Joseph,11,0,15,4
1649812543492,CSE 11,A01,084005,Miranda; Gregory Joseph,50,0,55,5
1649812549516,CSE 20,A01,084007,Staff,17,0,20,3
1649812555540,CSE 21,A01,084009,Staff,41,0,50,9
1649812561569,CSE 30,A01,083370,Cao; Yingjun,25,0,40,15
1649812567593,CSE 100,A01,083372,Cao; Yingjun,29,0,40,11
1649812573620,CSE 101,A01,084011,Staff,4,0,40,36
1649812579648,CSE 141,A01,083374,Eldon; John,8,0,75,67
1649812585673,CSE 141L,A01,083376,Eldon; John,7,0,75,68
1649812591700,CSE 175,A01,084013,Kumar; Rakesh,25,0,25,0
1649812597727,CSE 190,A00,092508,Staff,15,0,15,0
1649812603751,ECE 5,A01,084049,Morris; Karcher William,18,0,20,2
1649812609778,ECE 100,A01,084051,Baghdadchi; Saharnaz,17,0,20,3
1649812609778,ECE 100,A02,091916,Baghdadchi; Saharnaz,18,0,20,2
1649812615806,ECE 101,A01,084053,Baghdadchi; Saharnaz,27,0,37,10
1649812615806,ECE 101,A02,084054,Baghdadchi; Saharnaz,37,0,37,0
1649812621831,ECE 107,A01,083390,Staff,34,0,40,6
1649812627859,ECE 148,A01,084056,Silberman; Jack,8,0,12,4
1649812633893,ECE 180,A00,083391,Abi Samra; Nicholas Camill,27,0,30,3
1649812633893,ECE 180,B00,083392,Abi Samra; Nicholas Camill,26,0,30,4
1649812639917,MATH 10B,A01,084110,Staff,22,0,30,8
1649812639917,MATH 10B,A02,084111,Staff,29,0,30,1
1649812639917,MATH 10B,A03,084112,Staff,29,0,30,1
1649812645941,MATH 10C,A01,083443,Staff,22,0,30,8
1649812645941,MATH 10C,A02,083444,Staff,26,0,30,4
1649812645941,MATH 10C,B01,084114,Staff,26,0,30,4
1649812645941,MATH 10C,B02,084115,Staff,30,0,30,0
1649812651968,MATH 18,A01,084117,Harel; Guershon,28,0,30,2
1649812651968,MATH 18,A02,084119,Harel; Guershon,29,0,30,1
1649812651968,MATH 18,A03,084120,Harel; Guershon,30,0,30,0
1649812651968,MATH 18,A04,084121,Harel; Guershon,30,0,30,0
1649812657993,MATH 20B,A01,084124,Um; Ko Woon,33,0,35,2
1649812657993,MATH 20B,B01,084126,Um; Ko Woon,35,0,35,0
1649812664025,MATH 20C,A01,083446,Hammock; Frances H,27,0,30,3
1649812664025,MATH 20C,A02,083447,Hammock; Frances H,30,0,30,0
1649812664025,MATH 20C,A03,083448,Hammock; Frances H,30,0,30,0
1649812664025,MATH 20C,A04,083449,Hammock; Frances H,30,0,30,0
1649812664025,MATH 20C,B01,083451,Hammock; Frances H,30,0,30,0
1649812664025,MATH 20C,B02,083452,Hammock; Frances H,30,0,30,0
1649812664025,MATH 20C,B03,083453,Hammock; Frances H,30,0,30,0
1649812664025,MATH 20C,B04,083454,Hammock; Frances H,30,0,30,0
1649812670054,MATH 20D,A01,084128,Staff,30,0,30,0
1649812670054,MATH 20D,A02,084129,Staff,30,0,30,0
1649812670054,MATH 20D,A03,084130,Staff,29,0,30,1
1649812670054,MATH 20D,B01,084133,Staff,28,0,30,2
1649812670054,MATH 20D,B02,084134,Staff,30,0,30,0
1649812670054,MATH 20D,B03,084135,Staff,30,0,30,0
1649812676080,MATH 20E,A01,084138,Staff,29,0,30,1
1649812676080,MATH 20E,A02,084139,Staff,29,0,30,1
1649812676080,MATH 20E,A03,084140,Staff,29,0,30,1
1649812676080,MATH 20E,A04,084141,Staff,30,0,30,0
1649812682110,MATH 102,A01,084143,Harel; Guershon,25,0,30,5
1649812682110,MATH 102,A02,084144,Harel; Guershon,27,0,30,3
1649812688132,MATH 103B,A01,083456,Staff,9,0,30,21
1649812688132,MATH 103B,A02,083457,Staff,24,0,30,6
1649812694232,MATH 109,A01,084146,Salehi Golsefidy; Alireza,30,0,30,0
1649812694232,MATH 109,A02,084147,Salehi Golsefidy; Alireza,27,0,30,3
1649812700261,MATH 120A,A01,085445,Eggers; John Dietrich,31,0,35,4
1649812700261,MATH 120A,A02,085446,Eggers; John Dietrich,32,0,35,3
1649812706285,MATH 142B,A01,084149,Verstraete; Jacques Allan,18,0,30,12
1649812706285,MATH 142B,A02,084150,Verstraete; Jacques Allan,26,0,30,4
1649812712318,MATH 170A,A01,083459,Nie; Jiawang,16,0,30,14
1649812712318,MATH 170A,A02,083460,Nie; Jiawang,26,0,30,4
1649812712318,MATH 170A,A03,083461,Nie; Jiawang,26,0,30,4
1649812718344,MATH 193B,A01,083463,Staff,22,0,30,8
1649812718344,MATH 193B,A02,083464,Staff,22,0,30,8
1649812718344,MATH 193B,A03,083465,Staff,30,0,30,0
1649812724407,COGS 2,A01,083966,Boyle; Mary E. T.,27,0,30,3
1649812730436,COGS 9,A01,083968,Staff,57,0,60,3
1649812736464,COGS 14B,A01,083970,Staff,48,0,50,2
1649812742495,COGS 17,A01,092679,Staff,75,0,75,0
1649812748519,COGS 100,A01,083972,Staff,49,0,60,11
1649812760565,COGS 101C,A01,083976,Staff,26,0,30,4
1649812766589,COGS 102A,A01,083978,Johnson; Christine M.,27,0,30,3
1649812772620,COGS 107B,A01,083980,Staff,41,0,50,9
1649812778659,COGS 115,A01,083982,Staff,23,0,30,7
1649812784691,COGS 118B,A01,083367,Staff,9,0,40,31
1649812790718,COGS 172,A01,083984,Provenzano; Emily Kara,24,0,30,6
1649812796742,COGS 177,A00,083368,Staff,12,0,30,18
1649812802770,COGS 186,A01,083986,Staff,28,0,40,12
1649812808793,COGS 187A,A01,083988,Boyle; Mary E. T.,46,0,60,14
1649812814828,CSE 8A,A50,084003,Miranda; Gregory Joseph,11,0,15,4
1649812820858,CSE 11,A01,084005,Miranda; Gregory Joseph,50,0,55,5
1649812826881,CSE 20,A01,084007,Staff,17,0,20,3
1649812832904,CSE 21,A01,084009,Staff,41,0,50,9
1649812838931,CSE 30,A01,083370,Cao; Yingjun,25,0,40,15
1649812844957,CSE 100,A01,083372,Cao; Yingjun,29,0,40,11
1649812850985,CSE 101,A01,084011,Staff,4,0,40,36
1649812857007,CSE 141,A01,083374,Eldon; John,8,0,75,67
1649812863031,CSE 141L,A01,083376,Eldon; John,7,0,75,68
1649812869059,CSE 175,A01,084013,Kumar; Rakesh,25,0,25,0
1649812875091,CSE 190,A00,092508,Staff,15,0,15,0
1649812881119,ECE 5,A01,084049,Morris; Karcher William,18,0,20,2
1649812887147,ECE 100,A01,084051,Baghdadchi; Saharnaz,17,0,20,3
1649812887147,ECE 100,A02,091916,Baghdadchi; Saharnaz,18,0,20,2
1649812893176,ECE 101,A01,084053,Baghdadchi; Saharnaz,27,0,37,10
1649812893176,ECE 101,A02,084054,Baghdadchi; Saharnaz,37,0,37,0
1649812899200,ECE 107,A01,083390,Staff,34,0,40,6
1649812905224,ECE 148,A01,084056,Silberman; Jack,8,0,12,4
1649812911254,ECE 180,A00,083391,Abi Samra; Nicholas Camill,27,0,30,3
1649812911254,ECE 180,B00,083392,Abi Samra; Nicholas Camill,26,0,30,4
1649812917285,MATH 10B,A01,084110,Staff,22,0,30,8
1649812917285,MATH 10B,A02,084111,Staff,29,0,30,1
1649812917285,MATH 10B,A03,084112,Staff,29,0,30,1
1649812923310,MATH 10C,A01,083443,Staff,22,0,30,8
1649812923310,MATH 10C,A02,083444,Staff,26,0,30,4
1649812923310,MATH 10C,B01,084114,Staff,26,0,30,4
1649812923310,MATH 10C,B02,084115,Staff,30,0,30,0
1649812929337,MATH 18,A01,084117,Harel; Guershon,28,0,30,2
1649812929337,MATH 18,A02,084119,Harel; Guershon,29,0,30,1
1649812929337,MATH 18,A03,084120,Harel; Guershon,30,0,30,0
1649812929337,MATH 18,A04,084121,Harel; Guershon,30,0,30,0
1649812935363,MATH 20B,A01,084124,Um; Ko Woon,33,0,35,2
1649812935363,MATH 20B,B01,084126,Um; Ko Woon,35,0,35,0
1649812941389,MATH 20C,A01,083446,Hammock; Frances H,27,0,30,3
1649812941389,MATH 20C,A02,083447,Hammock; Frances H,30,0,30,0
1649812941389,MATH 20C,A03,083448,Hammock; Frances H,30,0,30,0
1649812941389,MATH 20C,A04,083449,Hammock; Frances H,30,0,30,0
1649812941389,MATH 20C,B01,083451,Hammock; Frances H,30,0,30,0
1649812941389,MATH 20C,B02,083452,Hammock; Frances H,30,0,30,0
1649812941389,MATH 20C,B03,083453,Hammock; Frances H,30,0,30,0
1649812941389,MATH 20C,B04,083454,Hammock; Frances H,30,0,30,0
1649812947418,MATH 20D,A01,084128,Staff,30,0,30,0
1649812947418,MATH 20D,A02,084129,Staff,30,0,30,0
1649812947418,MATH 20D,A03,084130,Staff,29,0,30,1
1649812947418,MATH 20D,B01,084133,Staff,28,0,30,2
1649812947418,MATH 20D,B02,084134,Staff,30,0,30,0
1649812947418,MATH 20D,B03,084135,Staff,30,0,30,0
1649812953441,MATH 20E,A01,084138,Staff,29,0,30,1
1649812953441,MATH 20E,A02,084139,Staff,29,0,30,1
1649812953441,MATH 20E,A03,084140,Staff,29,0,30,1
1649812953441,MATH 20E,A04,084141,Staff,30,0,30,0
1649812959471,MATH 102,A01,084143,Harel; Guershon,25,0,30,5
1649812959471,MATH 102,A02,084144,Harel; Guershon,27,0,30,3
1649812965494,MATH 103B,A01,083456,Staff,9,0,30,21
1649812965494,MATH 103B,A02,083457,Staff,24,0,30,6
1649812971521,MATH 109,A01,084146,Salehi Golsefidy; Alireza,30,0,30,0
1649812971521,MATH 109,A02,084147,Salehi Golsefidy; Alireza,27,0,30,3
1649812977549,MATH 120A,A01,085445,Eggers; John Dietrich,31,0,35,4
1649812977549,MATH 120A,A02,085446,Eggers; John Dietrich,32,0,35,3
1649812983580,MATH 142B,A01,084149,Verstraete; Jacques Allan,18,0,30,12
1649812983580,MATH 142B,A02,084150,Verstraete; Jacques Allan,26,0,30,4
1649812989608,MATH 170A,A01,083459,Nie; Jiawang,15,0,30,15
1649812989608,MATH 170A,A02,083460,Nie; Jiawang,26,0,30,4
1649812989608,MATH 170A,A03,083461,Nie; Jiawang,26,0,30,4
1649812995636,MATH 193B,A01,083463,Staff,22,0,30,8
1649812995636,MATH 193B,A02,083464,Staff,22,0,30,8
1649812995636,MATH 193B,A03,083465,Staff,30,0,30,0
1649813001696,COGS 2,A01,083966,Boyle; Mary E. T.,27,0,30,3
1649813007724,COGS 9,A01,083968,Staff,57,0,60,3
1649813013752,COGS 14B,A01,083970,Staff,48,0,50,2
1649813019775,COGS 17,A01,092679,Staff,74,0,75,1
1649813025811,COGS 100,A01,083972,Staff,49,0,60,11
1649813037880,COGS 101C,A01,083976,Staff,26,0,30,4
1649813043904,COGS 102A,A01,083978,Johnson; Christine M.,27,0,30,3
1649813049927,COGS 107B,A01,083980,Staff,41,0,50,9
1649813055962,COGS 115,A01,083982,Staff,23,0,30,7
1649813061990,COGS 118B,A01,083367,Staff,9,0,40,31
1649813068014,COGS 172,A01,083984,Provenzano; Emily Kara,24,0,30,6
1649813074041,COGS 177,A00,083368,Staff,12,0,30,18
1649813080065,COGS 186,A01,083986,Staff,28,0,40,12
1649813086091,COGS 187A,A01,083988,Boyle; Mary E. T.,46,0,60,14
1649813092126,CSE 8A,A50,084003,Miranda; Gregory Joseph,11,0,15,4
1649813098150,CSE 11,A01,084005,Miranda; Gregory Joseph,50,0,55,5
1649813104175,CSE 20,A01,084007,Staff,17,0,20,3
1649813110219,CSE 21,A01,084009,Staff,41,0,50,9
1649813116248,CSE 30,A01,083370,Cao; Yingjun,25,0,40,15
1649813122275,CSE 100,A01,083372,Cao; Yingjun,29,0,40,11
1649813128306,CSE 101,A01,084011,Staff,4,0,40,36
1649813134334,CSE 141,A01,083374,Eldon; John,8,0,75,67
1649813140359,CSE 141L,A01,083376,Eldon; John,7,0,75,68
1649813146386,CSE 175,A01,084013,Kumar; Rakesh,25,0,25,0
1649813152412,CSE 190,A00,092508,Staff,15,0,15,0
1649813158449,ECE 5,A01,084049,Morris; Karcher William,18,0,20,2
1649813164473,ECE 100,A01,084051,Baghdadchi; Saharnaz,17,0,20,3
1649813164473,ECE 100,A02,091916,Baghdadchi; Saharnaz,18,0,20,2
1649813170503,ECE 101,A01,084053,Baghdadchi; Saharnaz,27,0,37,10
1649813170503,ECE 101,A02,084054,Baghdadchi; Saharnaz,37,0,37,0
1649813176527,ECE 107,A01,083390,Staff,34,0,40,6
1649813182553,ECE 148,A01,084056,Silberman; Jack,8,0,12,4
1649813188577,ECE 180,A00,083391,Abi Samra; Nicholas Camill,27,0,30,3
1649813188577,ECE 180,B00,083392,Abi Samra; Nicholas Camill,26,0,30,4
1649813194615,MATH 10B,A01,084110,Staff,22,0,30,8
1649813194615,MATH 10B,A02,084111,Staff,29,0,30,1
1649813194615,MATH 10B,A03,084112,Staff,29,0,30,1
1649813200644,MATH 10C,A01,083443,Staff,22,0,30,8
1649813200644,MATH 10C,A02,083444,Staff,26,0,30,4
1649813200644,MATH 10C,B01,084114,Staff,26,0,30,4
1649813200644,MATH 10C,B02,084115,Staff,30,0,30,0
1649813206675,MATH 18,A01,084117,Harel; Guershon,28,0,30,2
1649813206675,MATH 18,A02,084119,Harel; Guershon,29,0,30,1
1649813206675,MATH 18,A03,084120,Harel; Guershon,30,0,30,0
1649813206675,MATH 18,A04,084121,Harel; Guershon,30,0,30,0
1649813212706,MATH 20B,A01,084124,Um; Ko Woon,33,0,35,2
1649813212706,MATH 20B,B01,084126,Um; Ko Woon,35,0,35,0
1649813218732,MATH 20C,A01,083446,Hammock; Frances H,27,0,30,3
1649813218732,MATH 20C,A02,083447,Hammock; Frances H,30,0,30,0
1649813218732,MATH 20C,A03,083448,Hammock; Frances H,30,0,30,0
1649813218732,MATH 20C,A04,083449,Hammock; Frances H,30,0,30,0
1649813218732,MATH 20C,B01,083451,Hammock; Frances H,30,0,30,0
1649813218732,MATH 20C,B02,083452,Hammock; Frances H,30,0,30,0
1649813218732,MATH 20C,B03,083453,Hammock; Frances H,30,0,30,0
1649813218732,MATH 20C,B04,083454,Hammock; Frances H,30,0,30,0
1649813224762,MATH 20D,A01,084128,Staff,30,0,30,0
1649813224762,MATH 20D,A02,084129,Staff,30,0,30,0
1649813224762,MATH 20D,A03,084130,Staff,29,0,30,1
1649813224762,MATH 20D,B01,084133,Staff,28,0,30,2
1649813224762,MATH 20D,B02,084134,Staff,30,0,30,0
1649813224762,MATH 20D,B03,084135,Staff,30,0,30,0
1649813230786,MATH 20E,A01,084138,Staff,29,0,30,1
1649813230786,MATH 20E,A02,084139,Staff,29,0,30,1
1649813230786,MATH 20E,A03,084140,Staff,29,0,30,1
1649813230786,MATH 20E,A04,084141,Staff,30,0,30,0
1649813236815,MATH 102,A01,084143,Harel; Guershon,25,0,30,5
1649813236815,MATH 102,A02,084144,Harel; Guershon,27,0,30,3
1649813242844,MATH 103B,A01,083456,Staff,9,0,30,21
1649813242844,MATH 103B,A02,083457,Staff,24,0,30,6
1649813248873,MATH 109,A01,084146,Salehi Golsefidy; Alireza,30,0,30,0
1649813248873,MATH 109,A02,084147,Salehi Golsefidy; Alireza,27,0,30,3
1649813254901,MATH 120A,A01,085445,Eggers; John Dietrich,31,0,35,4
1649813254901,MATH 120A,A02,085446,Eggers; John Dietrich,32,0,35,3
1649813260927,MATH 142B,A01,084149,Verstraete; Jacques Allan,18,0,30,12
1649813260927,MATH 142B,A02,084150,Verstraete; Jacques Allan,26,0,30,4
1649813266956,MATH 170A,A01,083459,Nie; Jiawang,15,0,30,15
1649813266956,MATH 170A,A02,083460,Nie; Jiawang,26,0,30,4
1649813266956,MATH 170A,A03,083461,Nie; Jiawang,26,0,30,4
1649813272984,MATH 193B,A01,083463,Staff,22,0,30,8
1649813272984,MATH 193B,A02,083464,Staff,22,0,30,8
1649813272984,MATH 193B,A03,083465,Staff,30,0,30,0
1649813279038,COGS 2,A01,083966,Boyle; Mary E. T.,27,0,30,3
1649813285138,COGS 9,A01,083968,Staff,57,0,60,3
1649813291167,COGS 14B,A01,083970,Staff,48,0,50,2
1649813297191,COGS 17,A01,092679,Staff,74,0,75,1
1649813303214,COGS 100,A01,083972,Staff,49,0,60,11
1649813315262,COGS 101C,A01,083976,Staff,26,0,30,4
1649813321286,COGS 102A,A01,083978,Johnson; Christine M.,27,0,30,3
1649813327314,COGS 107B,A01,083980,Staff,41,0,50,9
1649813333338,COGS 115,A01,083982,Staff,23,0,30,7
1649813339363,COGS 118B,A01,083367,Staff,9,0,40,31
1649813345386,COGS 172,A01,083984,Provenzano; Emily Kara,24,0,30,6
1649813351413,COGS 177,A00,083368,Staff,12,0,30,18
1649813357445,COGS 186,A01,083986,Staff,28,0,40,12
1649813363481,COGS 187A,A01,083988,Boyle; Mary E. T.,46,0,60,14
1649813369510,CSE 8A,A50,084003,Miranda; Gregory Joseph,11,0,15,4
1649813375537,CSE 11,A01,084005,Miranda; Gregory Joseph,50,0,55,5
1649813381561,CSE 20,A01,084007,Staff,17,0,20,3
1649813387588,CSE 21,A01,084009,Staff,41,0,50,9
1649813393618,CSE 30,A01,083370,Cao; Yingjun,25,0,40,15
1649813399646,CSE 100,A01,083372,Cao; Yingjun,29,0,40,11
1649813405675,CSE 101,A01,084011,Staff,4,0,40,36
1649813411700,CSE 141,A01,083374,Eldon; John,8,0,75,67
1649813417728,CSE 141L,A01,083376,Eldon; John,7,0,75,68
1649813423759,CSE 175,A01,084013,Kumar; Rakesh,25,0,25,0
1649813429782,CSE 190,A00,092508,Staff,15,0,15,0
1649813435809,ECE 5,A01,084049,Morris; Karcher William,18,0,20,2
1649813441833,ECE 100,A01,084051,Baghdadchi; Saharnaz,17,0,20,3
1649813441833,ECE 100,A02,091916,Baghdadchi; Saharnaz,18,0,20,2
1649813447857,ECE 101,A01,084053,Baghdadchi; Saharnaz,27,0,37,10
1649813447857,ECE 101,A02,084054,Baghdadchi; Saharnaz,37,0,37,0
1649813453880,ECE 107,A01,083390,Staff,34,0,40,6
1649813459907,ECE 148,A01,084056,Silberman; Jack,8,0,12,4
1649813465932,ECE 180,A00,083391,Abi Samra; Nicholas Camill,27,0,30,3
1649813465932,ECE 180,B00,083392,Abi Samra; Nicholas Camill,26,0,30,4
1649813471965,MATH 10B,A01,084110,Staff,22,0,30,8
1649813471965,MATH 10B,A02,084111,Staff,29,0,30,1
1649813471965,MATH 10B,A03,084112,Staff,29,0,30,1
1649813477988,MATH 10C,A01,083443,Staff,22,0,30,8
1649813477988,MATH 10C,A02,083444,Staff,26,0,30,4
1649813477988,MATH 10C,B01,084114,Staff,26,0,30,4
1649813477988,MATH 10C,B02,084115,Staff,30,0,30,0
1649813484012,MATH 18,A01,084117,Harel; Guershon,28,0,30,2
1649813484012,MATH 18,A02,084119,Harel; Guershon,29,0,30,1
1649813484012,MATH 18,A03,084120,Harel; Guershon,30,0,30,0
1649813484012,MATH 18,A04,084121,Harel; Guershon,30,0,30,0
1649813490036,MATH 20B,A01,084124,Um; Ko Woon,33,0,35,2
1649813490036,MATH 20B,B01,084126,Um; Ko Woon,35,0,35,0
1649813496066,MATH 20C,A01,083446,Hammock; Frances H,27,0,30,3
1649813496066,MATH 20C,A02,083447,Hammock; Frances H,30,0,30,0
1649813496066,MATH 20C,A03,083448,Hammock; Frances H,30,0,30,0
1649813496066,MATH 20C,A04,083449,Hammock; Frances H,30,0,30,0
1649813496066,MATH 20C,B01,083451,Hammock; Frances H,30,0,30,0
1649813496066,MATH 20C,B02,083452,Hammock; Frances H,30,0,30,0
1649813496066,MATH 20C,B03,083453,Hammock; Frances H,30,0,30,0
1649813496066,MATH 20C,B04,083454,Hammock; Frances H,30,0,30,0
1649813502302,MATH 20D,A01,084128,Staff,30,0,30,0
1649813502302,MATH 20D,A02,084129,Staff,30,0,30,0
1649813502302,MATH 20D,A03,084130,Staff,29,0,30,1
1649813502302,MATH 20D,B01,084133,Staff,28,0,30,2
1649813502302,MATH 20D,B02,084134,Staff,30,0,30,0
1649813502302,MATH 20D,B03,084135,Staff,30,0,30,0
1649813508329,MATH 20E,A01,084138,Staff,29,0,30,1
1649813508329,MATH 20E,A02,084139,Staff,29,0,30,1
1649813508329,MATH 20E,A03,084140,Staff,29,0,30,1
1649813508329,MATH 20E,A04,084141,Staff,30,0,30,0
1649813514358,MATH 102,A01,084143,Harel; Guershon,25,0,30,5
1649813514358,MATH 102,A02,084144,Harel; Guershon,27,0,30,3
1649813520386,MATH 103B,A01,083456,Staff,9,0,30,21
1649813520386,MATH 103B,A02,083457,Staff,24,0,30,6
1649813526412,MATH 109,A01,084146,Salehi Golsefidy; Alireza,30,0,30,0
1649813526412,MATH 109,A02,084147,Salehi Golsefidy; Alireza,27,0,30,3
1649813532437,MATH 120A,A01,085445,Eggers; John Dietrich,31,0,35,4
1649813532437,MATH 120A,A02,085446,Eggers; John Dietrich,32,0,35,3
1649813538460,MATH 142B,A01,084149,Verstraete; Jacques Allan,18,0,30,12
1649813538460,MATH 142B,A02,084150,Verstraete; Jacques Allan,26,0,30,4
1649813544485,MATH 170A,A01,083459,Nie; Jiawang,15,0,30,15
1649813544485,MATH 170A,A02,083460,Nie; Jiawang,26,0,30,4
1649813544485,MATH 170A,A03,083461,Nie; Jiawang,26,0,30,4
1649813550513,MATH 193B,A01,083463,Staff,22,0,30,8
1649813550513,MATH 193B,A02,083464,Staff,22,0,30,8
1649813550513,MATH 193B,A03,083465,Staff,30,0,30,0
1649813556588,COGS 2,A01,083966,Boyle; Mary E. T.,27,0,30,3
1649813562614,COGS 9,A01,083968,Staff,57,0,60,3
1649813568647,COGS 14B,A01,083970,Staff,48,0,50,2
1649813574675,COGS 17,A01,092679,Staff,74,0,75,1
1649813580709,COGS 100,A01,083972,Staff,49,0,60,11
1649813592765,COGS 101C,A01,083976,Staff,26,0,30,4
1649813598796,COGS 102A,A01,083978,Johnson; Christine M.,27,0,30,3
1649813604819,COGS 107B,A01,083980,Staff,41,0,50,9
1649813610853,COGS 115,A01,083982,Staff,23,0,30,7
1649813616898,COGS 118B,A01,083367,Staff,9,0,40,31
1649813622923,COGS 172,A01,083984,Provenzano; Emily Kara,24,0,30,6
1649813628950,COGS 177,A00,083368,Staff,11,0,30,19
1649813634980,COGS 186,A01,083986,Staff,28,0,40,12
1649813641007,COGS 187A,A01,083988,Boyle; Mary E. T.,46,0,60,14
1649813647031,CSE 8A,A50,084003,Miranda; Gregory Joseph,11,0,15,4
1649813653058,CSE 11,A01,084005,Miranda; Gregory Joseph,50,0,55,5
1649813659083,CSE 20,A01,084007,Staff,17,0,20,3
1649813665112,CSE 21,A01,084009,Staff,41,0,50,9
1649813671139,CSE 30,A01,083370,Cao; Yingjun,25,0,40,15
1649813677165,CSE 100,A01,083372,Cao; Yingjun,29,0,40,11
1649813683201,CSE 101,A01,084011,Staff,4,0,40,36
1649813689227,CSE 141,A01,083374,Eldon; John,8,0,75,67
1649813695251,CSE 141L,A01,083376,Eldon; John,7,0,75,68
1649813701275,CSE 175,A01,084013,Kumar; Rakesh,25,0,25,0
1649813707307,CSE 190,A00,092508,Staff,15,0,15,0
1649813713329,ECE 5,A01,084049,Morris; Karcher William,18,0,20,2
1649813719365,ECE 100,A01,084051,Baghdadchi; Saharnaz,17,0,20,3
1649813719365,ECE 100,A02,091916,Baghdadchi; Saharnaz,18,0,20,2
1649813725388,ECE 101,A01,084053,Baghdadchi; Saharnaz,27,0,37,10
1649813725388,ECE 101,A02,084054,Baghdadchi; Saharnaz,37,0,37,0
1649813731413,ECE 107,A01,083390,Staff,34,0,40,6
1649813737436,ECE 148,A01,084056,Silberman; Jack,8,0,12,4
1649813743464,ECE 180,A00,083391,Abi Samra; Nicholas Camill,27,0,30,3
1649813743464,ECE 180,B00,083392,Abi Samra; Nicholas Camill,26,0,30,4
1649813749492,MATH 10B,A01,084110,Staff,22,0,30,8
1649813749492,MATH 10B,A02,084111,Staff,29,0,30,1
1649813749492,MATH 10B,A03,084112,Staff,29,0,30,1
1649813755514,MATH 10C,A01,083443,Staff,22,0,30,8
1649813755514,MATH 10C,A02,083444,Staff,26,0,30,4
1649813755514,MATH 10C,B01,084114,Staff,26,0,30,4
1649813755514,MATH 10C,B02,084115,Staff,30,0,30,0
1649813761550,MATH 18,A01,084117,Harel; Guershon,28,0,30,2
1649813761550,MATH 18,A02,084119,Harel; Guershon,29,0,30,1
1649813761550,MATH 18,A03,084120,Harel; Guershon,30,0,30,0
1649813761550,MATH 18,A04,084121,Harel; Guershon,30,0,30,0
1649813767578,MATH 20B,A01,084124,Um; Ko Woon,33,0,35,2
1649813767578,MATH 20B,B01,084126,Um; Ko Woon,35,0,35,0
1649813773612,MATH 20C,A01,083446,Hammock; Frances H,27,0,30,3
1649813773612,MATH 20C,A02,083447,Hammock; Frances H,30,0,30,0
1649813773612,MATH 20C,A03,083448,Hammock; Frances H,30,0,30,0
1649813773612,MATH 20C,A04,083449,Hammock; Frances H,30,0,30,0
1649813773612,MATH 20C,B01,083451,Hammock; Frances H,30,0,30,0
1649813773612,MATH 20C,B02,083452,Hammock; Frances H,30,0,30,0
1649813773612,MATH 20C,B03,083453,Hammock; Frances H,30,0,30,0
1649813773612,MATH 20C,B04,083454,Hammock; Frances H,30,0,30,0
1649813779644,MATH 20D,A01,084128,Staff,30,0,30,0
1649813779644,MATH 20D,A02,084129,Staff,30,0,30,0
1649813779644,MATH 20D,A03,084130,Staff,29,0,30,1
1649813779644,MATH 20D,B01,084133,Staff,28,0,30,2
1649813779644,MATH 20D,B02,084134,Staff,30,0,30,0
1649813779644,MATH 20D,B03,084135,Staff,30,0,30,0
1649813785676,MATH 20E,A01,084138,Staff,29,0,30,1
1649813785676,MATH 20E,A02,084139,Staff,29,0,30,1
1649813785676,MATH 20E,A03,084140,Staff,29,0,30,1
1649813785676,MATH 20E,A04,084141,Staff,30,0,30,0
1649813791701,MATH 102,A01,084143,Harel; Guershon,25,0,30,5
1649813791701,MATH 102,A02,084144,Harel; Guershon,27,0,30,3
1649813797730,MATH 103B,A01,083456,Staff,9,0,30,21
1649813797730,MATH 103B,A02,083457,Staff,24,0,30,6
1649813803755,MATH 109,A01,084146,Salehi Golsefidy; Alireza,30,0,30,0
1649813803755,MATH 109,A02,084147,Salehi Golsefidy; Alireza,27,0,30,3
1649813809794,MATH 120A,A01,085445,Eggers; John Dietrich,31,0,35,4
1649813809794,MATH 120A,A02,085446,Eggers; John Dietrich,32,0,35,3
1649813815821,MATH 142B,A01,084149,Verstraete; Jacques Allan,18,0,30,12
1649813815821,MATH 142B,A02,084150,Verstraete; Jacques Allan,26,0,30,4
1649813821848,MATH 170A,A01,083459,Nie; Jiawang,15,0,30,15
1649813821848,MATH 170A,A02,083460,Nie; Jiawang,26,0,30,4
1649813821848,MATH 170A,A03,083461,Nie; Jiawang,26,0,30,4
1649813827873,MATH 193B,A01,083463,Staff,22,0,30,8
1649813827873,MATH 193B,A02,083464,Staff,22,0,30,8
1649813827873,MATH 193B,A03,083465,Staff,30,0,30,0
1649813833929,COGS 2,A01,083966,Boyle; Mary E. T.,27,0,30,3
1649813839954,COGS 9,A01,083968,Staff,57,0,60,3
1649813845983,COGS 14B,A01,083970,Staff,48,0,50,2
1649813852009,COGS 17,A01,092679,Staff,74,0,75,1
1649813858038,COGS 100,A01,083972,Staff,49,0,60,11
1649813870095,COGS 101C,A01,083976,Staff,26,0,30,4
1649813876121,COGS 102A,A01,083978,Johnson; Christine M.,27,0,30,3
1649813882218,COGS 107B,A01,083980,Staff,41,0,50,9
1649813888240,COGS 115,A01,083982,Staff,23,0,30,7
1649813894269,COGS 118B,A01,083367,Staff,9,0,40,31
1649813900293,COGS 172,A01,083984,Provenzano; Emily Kara,24,0,30,6
1649813906328,COGS 177,A00,083368,Staff,11,0,30,19
1649813912350,COGS 186,A01,083986,Staff,28,0,40,12
1649813918375,COGS 187A,A01,083988,Boyle; Mary E. T.,46,0,60,14
1649813924402,CSE 8A,A50,084003,Miranda; Gregory Joseph,11,0,15,4
1649813930425,CSE 11,A01,084005,Miranda; Gregory Joseph,50,0,55,5
1649813936449,CSE 20,A01,084007,Staff,17,0,20,3
1649813942472,CSE 21,A01,084009,Staff,41,0,50,9
1649813948495,CSE 30,A01,083370,Cao; Yingjun,25,0,40,15
1649813954519,CSE 100,A01,083372,Cao; Yingjun,29,0,40,11
1649813960547,CSE 101,A01,084011,Staff,4,0,40,36
1649813966574,CSE 141,A01,083374,Eldon; John,8,0,75,67
1649813972602,CSE 141L,A01,083376,Eldon; John,7,0,75,68
1649813978631,CSE 175,A01,084013,Kumar; Rakesh,25,0,25,0
1649813984659,CSE 190,A00,092508,Staff,15,0,15,0
1649813990683,ECE 5,A01,084049,Morris; Karcher William,18,0,20,2
1649813996708,ECE 100,A01,084051,Baghdadchi; Saharnaz,17,0,20,3
1649813996708,ECE 100,A02,091916,Baghdadchi; Saharnaz,18,0,20,2
1649814002737,ECE 101,A01,084053,Baghdadchi; Saharnaz,27,0,37,10
1649814002737,ECE 101,A02,084054,Baghdadchi; Saharnaz,37,0,37,0
1649814008764,ECE 107,A01,083390,Staff,34,0,40,6
1649814014800,ECE 148,A01,084056,Silberman; Jack,8,0,12,4
1649814020828,ECE 180,A00,083391,Abi Samra; Nicholas Camill,27,0,30,3
1649814020828,ECE 180,B00,083392,Abi Samra; Nicholas Camill,26,0,30,4
1649814026857,MATH 10B,A01,084110,Staff,22,0,30,8
1649814026857,MATH 10B,A02,084111,Staff,29,0,30,1
1649814026857,MATH 10B,A03,084112,Staff,29,0,30,1
1649814032885,MATH 10C,A01,083443,Staff,22,0,30,8
1649814032885,MATH 10C,A02,083444,Staff,26,0,30,4
1649814032885,MATH 10C,B01,084114,Staff,26,0,30,4
1649814032885,MATH 10C,B02,084115,Staff,30,0,30,0
1649814038913,MATH 18,A01,084117,Harel; Guershon,28,0,30,2
1649814038913,MATH 18,A02,084119,Harel; Guershon,29,0,30,1
1649814038913,MATH 18,A03,084120,Harel; Guershon,30,0,30,0
1649814038913,MATH 18,A04,084121,Harel; Guershon,30,0,30,0
1649814044937,MATH 20B,A01,084124,Um; Ko Woon,33,0,35,2
1649814044937,MATH 20B,B01,084126,Um; Ko Woon,35,0,35,0
1649814050962,MATH 20C,A01,083446,Hammock; Frances H,27,0,30,3
1649814050962,MATH 20C,A02,083447,Hammock; Frances H,30,0,30,0
1649814050962,MATH 20C,A03,083448,Hammock; Frances H,30,0,30,0
1649814050962,MATH 20C,A04,083449,Hammock; Frances H,30,0,30,0
1649814050962,MATH 20C,B01,083451,Hammock; Frances H,30,0,30,0
1649814050962,MATH 20C,B02,083452,Hammock; Frances H,30,0,30,0
1649814050962,MATH 20C,B03,083453,Hammock; Frances H,30,0,30,0
1649814050962,MATH 20C,B04,083454,Hammock; Frances H,30,0,30,0
1649814056986,MATH 20D,A01,084128,Staff,30,0,30,0
1649814056986,MATH 20D,A02,084129,Staff,30,0,30,0
1649814056986,MATH 20D,A03,084130,Staff,29,0,30,1
1649814056986,MATH 20D,B01,084133,Staff,28,0,30,2
1649814056986,MATH 20D,B02,084134,Staff,30,0,30,0
1649814056986,MATH 20D,B03,084135,Staff,30,0,30,0
1649814063016,MATH 20E,A01,084138,Staff,29,0,30,1
1649814063016,MATH 20E,A02,084139,Staff,29,0,30,1
1649814063016,MATH 20E,A03,084140,Staff,29,0,30,1
1649814063016,MATH 20E,A04,084141,Staff,30,0,30,0
1649814069044,MATH 102,A01,084143,Harel; Guershon,25,0,30,5
1649814069044,MATH 102,A02,084144,Harel; Guershon,26,0,30,4
1649814075071,MATH 103B,A01,083456,Staff,9,0,30,21
1649814075071,MATH 103B,A02,083457,Staff,24,0,30,6
1649814081096,MATH 109,A01,084146,Salehi Golsefidy; Alireza,30,0,30,0
1649814081096,MATH 109,A02,084147,Salehi Golsefidy; Alireza,27,0,30,3
1649814087121,MATH 120A,A01,085445,Eggers; John Dietrich,31,0,35,4
1649814087121,MATH 120A,A02,085446,Eggers; John Dietrich,32,0,35,3
1649814093146,MATH 142B,A01,084149,Verstraete; Jacques Allan,18,0,30,12
1649814093146,MATH 142B,A02,084150,Verstraete; Jacques Allan,26,0,30,4
1649814099173,MATH 170A,A01,083459,Nie; Jiawang,15,0,30,15
1649814099173,MATH 170A,A02,083460,Nie; Jiawang,26,0,30,4
1649814099173,MATH 170A,A03,083461,Nie; Jiawang,26,0,30,4
1649814105197,MATH 193B,A01,083463,Staff,22,0,30,8
1649814105197,MATH 193B,A02,083464,Staff,22,0,30,8
1649814105197,MATH 193B,A03,083465,Staff,30,0,30,0
1649814111259,COGS 2,A01,083966,Boyle; Mary E. T.,27,0,30,3
1649814117287,COGS 9,A01,083968,Staff,57,0,60,3
1649814123314,COGS 14B,A01,083970,Staff,48,0,50,2
1649814129340,COGS 17,A01,092679,Staff,74,0,75,1
1649814135364,COGS 100,A01,083972,Staff,49,0,60,11
1649814147414,COGS 101C,A01,083976,Staff,26,0,30,4
1649814153435,COGS 102A,A01,083978,Johnson; Christine M.,27,0,30,3
1649814159459,COGS 107B,A01,083980,Staff,41,0,50,9
1649814165485,COGS 115,A01,083982,Staff,23,0,30,7
1649814171509,COGS 118B,A01,083367,Staff,9,0,40,31
1649814177532,COGS 172,A01,083984,Provenzano; Emily Kara,24,0,30,6
1649814183556,COGS 177,A00,083368,Staff,11,0,30,19
1649814189580,COGS 186,A01,083986,Staff,28,0,40,12
1649814195605,COGS 187A,A01,083988,Boyle; Mary E. T.,46,0,60,14
1649814201630,CSE 8A,A50,084003,Miranda; Gregory Joseph,11,0,15,4
1649814207658,CSE 11,A01,084005,Miranda; Gregory Joseph,50,0,55,5
1649814213692,CSE 20,A01,084007,Staff,17,0,20,3
1649814219728,CSE 21,A01,084009,Staff,41,0,50,9
1649814225754,CSE 30,A01,083370,Cao; Yingjun,25,0,40,15
1649814231781,CSE 100,A01,083372,Cao; Yingjun,29,0,40,11
1649814237805,CSE 101,A01,084011,Staff,4,0,40,36
1649814243829,CSE 141,A01,083374,Eldon; John,8,0,75,67
1649814249853,CSE 141L,A01,083376,Eldon; John,7,0,75,68
1649814255876,CSE 175,A01,084013,Kumar; Rakesh,25,0,25,0
1649814261905,CSE 190,A00,092508,Staff,15,0,15,0
1649814267930,ECE 5,A01,084049,Morris; Karcher William,18,0,20,2
1649814273958,ECE 100,A01,084051,Baghdadchi; Saharnaz,17,0,20,3
1649814273958,ECE 100,A02,091916,Baghdadchi; Saharnaz,18,0,20,2
1649814279982,ECE 101,A01,084053,Baghdadchi; Saharnaz,27,0,37,10
1649814279982,ECE 101,A02,084054,Baghdadchi; Saharnaz,37,0,37,0
1649814286017,ECE 107,A01,083390,Staff,34,0,40,6
1649814292041,ECE 148,A01,084056,Silberman; Jack,8,0,12,4
1649814298064,ECE 180,A00,083391,Abi Samra; Nicholas Camill,27,0,30,3
1649814298064,ECE 180,B00,083392,Abi Samra; Nicholas Camill,26,0,30,4
1649814304093,MATH 10B,A01,084110,Staff,22,0,30,8
1649814304093,MATH 10B,A02,084111,Staff,29,0,30,1
1649814304093,MATH 10B,A03,084112,Staff,29,0,30,1
1649814310120,MATH 10C,A01,083443,Staff,22,0,30,8
1649814310120,MATH 10C,A02,083444,Staff,26,0,30,4
1649814310120,MATH 10C,B01,084114,Staff,26,0,30,4
1649814310120,MATH 10C,B02,084115,Staff,30,0,30,0
1649814316143,MATH 18,A01,084117,Harel; Guershon,28,0,30,2
1649814316143,MATH 18,A02,084119,Harel; Guershon,29,0,30,1
1649814316143,MATH 18,A03,084120,Harel; Guershon,30,0,30,0
1649814316143,MATH 18,A04,084121,Harel; Guershon,30,0,30,0
1649814322167,MATH 20B,A01,084124,Um; Ko Woon,33,0,35,2
1649814322167,MATH 20B,B01,084126,Um; Ko Woon,35,0,35,0
1649814328200,MATH 20C,A01,083446,Hammock; Frances H,27,0,30,3
1649814328200,MATH 20C,A02,083447,Hammock; Frances H,30,0,30,0
1649814328200,MATH 20C,A03,083448,Hammock; Frances H,30,0,30,0
1649814328200,MATH 20C,A04,083449,Hammock; Frances H,30,0,30,0
1649814328200,MATH 20C,B01,083451,Hammock; Frances H,30,0,30,0
1649814328200,MATH 20C,B02,083452,Hammock; Frances H,30,0,30,0
1649814328200,MATH 20C,B03,083453,Hammock; Frances H,30,0,30,0
1649814328200,MATH 20C,B04,083454,Hammock; Frances H,30,0,30,0
1649814334228,MATH 20D,A01,084128,Staff,30,0,30,0
1649814334228,MATH 20D,A02,084129,Staff,30,0,30,0
1649814334228,MATH 20D,A03,084130,Staff,29,0,30,1
1649814334228,MATH 20D,B01,084133,Staff,28,0,30,2
1649814334228,MATH 20D,B02,084134,Staff,30,0,30,0
1649814334228,MATH 20D,B03,084135,Staff,30,0,30,0
1649814340256,MATH 20E,A01,084138,Staff,29,0,30,1
1649814340256,MATH 20E,A02,084139,Staff,29,0,30,1
1649814340256,MATH 20E,A03,084140,Staff,29,0,30,1
1649814340256,MATH 20E,A04,084141,Staff,30,0,30,0
1649814346290,MATH 102,A01,084143,Harel; Guershon,25,0,30,5
1649814346290,MATH 102,A02,084144,Harel; Guershon,26,0,30,4
1649814352320,MATH 103B,A01,083456,Staff,9,0,30,21
1649814352320,MATH 103B,A02,083457,Staff,24,0,30,6
1649814358354,MATH 109,A01,084146,Salehi Golsefidy; Alireza,30,0,30,0
1649814358354,MATH 109,A02,084147,Salehi Golsefidy; Alireza,27,0,30,3
1649814364384,MATH 120A,A01,085445,Eggers; John Dietrich,31,0,35,4
1649814364384,MATH 120A,A02,085446,Eggers; John Dietrich,32,0,35,3
1649814370407,MATH 142B,A01,084149,Verstraete; Jacques Allan,18,0,30,12
1649814370407,MATH 142B,A02,084150,Verstraete; Jacques Allan,26,0,30,4
1649814376432,MATH 170A,A01,083459,Nie; Jiawang,15,0,30,15
1649814376432,MATH 170A,A02,083460,Nie; Jiawang,26,0,30,4
1649814376432,MATH 170A,A03,083461,Nie; Jiawang,26,0,30,4
1649814382457,MATH 193B,A01,083463,Staff,22,0,30,8
1649814382457,MATH 193B,A02,083464,Staff,22,0,30,8
1649814382457,MATH 193B,A03,083465,Staff,30,0,30,0
1649814388512,COGS 2,A01,083966,Boyle; Mary E. T.,27,0,30,3
1649814394536,COGS 9,A01,083968,Staff,57,0,60,3
1649814400568,COGS 14B,A01,083970,Staff,48,0,50,2
1649814406589,COGS 17,A01,092679,Staff,74,0,75,1
1649814412613,COGS 100,A01,083972,Staff,49,0,60,11
1649814424672,COGS 101C,A01,083976,Staff,26,0,30,4
1649814430696,COGS 102A,A01,083978,Johnson; Christine M.,27,0,30,3
1649814436723,COGS 107B,A01,083980,Staff,41,0,50,9
1649814442751,COGS 115,A01,083982,Staff,23,0,30,7
1649814448781,COGS 118B,A01,083367,Staff,9,0,40,31
1649814454804,COGS 172,A01,083984,Provenzano; Emily Kara,24,0,30,6
1649814460828,COGS 177,A00,083368,Staff,11,0,30,19
1649814466851,COGS 186,A01,083986,Staff,28,0,40,12
1649814472878,COGS 187A,A01,083988,Boyle; Mary E. T.,46,0,60,14
1649814478974,CSE 8A,A50,084003,Miranda; Gregory Joseph,11,0,15,4
1649814484998,CSE 11,A01,084005,Miranda; Gregory Joseph,50,0,55,5
1649814491028,CSE 20,A01,084007,Staff,17,0,20,3
1649814497056,CSE 21,A01,084009,Staff,41,0,50,9
1649814503100,CSE 30,A01,083370,Cao; Yingjun,25,0,40,15
1649814509125,CSE 100,A01,083372,Cao; Yingjun,29,0,40,11
1649814515152,CSE 101,A01,084011,Staff,4,0,40,36
1649814521176,CSE 141,A01,083374,Eldon; John,8,0,75,67
1649814527204,CSE 141L,A01,083376,Eldon; John,7,0,75,68
1649814533228,CSE 175,A01,084013,Kumar; Rakesh,25,0,25,0
1649814539253,CSE 190,A00,092508,Staff,15,0,15,0
1649814545275,ECE 5,A01,084049,Morris; Karcher William,18,0,20,2
1649814551299,ECE 100,A01,084051,Baghdadchi; Saharnaz,17,0,20,3
1649814551299,ECE 100,A02,091916,Baghdadchi; Saharnaz,18,0,20,2
1649814557326,ECE 101,A01,084053,Baghdadchi; Saharnaz,27,0,37,10
1649814557326,ECE 101,A02,084054,Baghdadchi; Saharnaz,37,0,37,0
1649814563353,ECE 107,A01,083390,Staff,34,0,40,6
1649814569381,ECE 148,A01,084056,Silberman; Jack,8,0,12,4
1649814575405,ECE 180,A00,083391,Abi Samra; Nicholas Camill,27,0,30,3
1649814575405,ECE 180,B00,083392,Abi Samra; Nicholas Camill,26,0,30,4
1649814581439,MATH 10B,A01,084110,Staff,22,0,30,8
1649814581439,MATH 10B,A02,084111,Staff,29,0,30,1
1649814581439,MATH 10B,A03,084112,Staff,29,0,30,1
1649814587465,MATH 10C,A01,083443,Staff,22,0,30,8
1649814587465,MATH 10C,A02,083444,Staff,26,0,30,4
1649814587465,MATH 10C,B01,084114,Staff,26,0,30,4
1649814587465,MATH 10C,B02,084115,Staff,30,0,30,0
1649814593488,MATH 18,A01,084117,Harel; Guershon,28,0,30,2
1649814593488,MATH 18,A02,084119,Harel; Guershon,29,0,30,1
1649814593488,MATH 18,A03,084120,Harel; Guershon,30,0,30,0
1649814593488,MATH 18,A04,084121,Harel; Guershon,30,0,30,0
1649814599520,MATH 20B,A01,084124,Um; Ko Woon,33,0,35,2
1649814599520,MATH 20B,B01,084126,Um; Ko Woon,35,0,35,0
1649814605547,MATH 20C,A01,083446,Hammock; Frances H,27,0,30,3
1649814605547,MATH 20C,A02,083447,Hammock; Frances H,30,0,30,0
1649814605547,MATH 20C,A03,083448,Hammock; Frances H,30,0,30,0
1649814605547,MATH 20C,A04,083449,Hammock; Frances H,30,0,30,0
1649814605547,MATH 20C,B01,083451,Hammock; Frances H,30,0,30,0
1649814605547,MATH 20C,B02,083452,Hammock; Frances H,30,0,30,0
1649814605547,MATH 20C,B03,083453,Hammock; Frances H,30,0,30,0
1649814605547,MATH 20C,B04,083454,Hammock; Frances H,30,0,30,0
1649814611570,MATH 20D,A01,084128,Staff,30,0,30,0
1649814611570,MATH 20D,A02,084129,Staff,30,0,30,0
1649814611570,MATH 20D,A03,084130,Staff,29,0,30,1
1649814611570,MATH 20D,B01,084133,Staff,28,0,30,2
1649814611570,MATH 20D,B02,084134,Staff,30,0,30,0
1649814611570,MATH 20D,B03,084135,Staff,30,0,30,0
1649814617593,MATH 20E,A01,084138,Staff,29,0,30,1
1649814617593,MATH 20E,A02,084139,Staff,29,0,30,1
1649814617593,MATH 20E,A03,084140,Staff,29,0,30,1
1649814617593,MATH 20E,A04,084141,Staff,30,0,30,0
1649814623635,MATH 102,A01,084143,Harel; Guershon,25,0,30,5
1649814623635,MATH 102,A02,084144,Harel; Guershon,26,0,30,4
1649814629658,MATH 103B,A01,083456,Staff,9,0,30,21
1649814629658,MATH 103B,A02,083457,Staff,24,0,30,6
1649814635688,MATH 109,A01,084146,Salehi Golsefidy; Alireza,30,0,30,0
1649814635688,MATH 109,A02,084147,Salehi Golsefidy; Alireza,27,0,30,3
1649814641715,MATH 120A,A01,085445,Eggers; John Dietrich,31,0,35,4
1649814641715,MATH 120A,A02,085446,Eggers; John Dietrich,32,0,35,3
1649814647740,MATH 142B,A01,084149,Verstraete; Jacques Allan,18,0,30,12
1649814647740,MATH 142B,A02,084150,Verstraete; Jacques Allan,26,0,30,4
1649814653765,MATH 170A,A01,083459,Nie; Jiawang,15,0,30,15
1649814653765,MATH 170A,A02,083460,Nie; Jiawang,26,0,30,4
1649814653765,MATH 170A,A03,083461,Nie; Jiawang,26,0,30,4
1649814659791,MATH 193B,A01,083463,Staff,22,0,30,8
1649814659791,MATH 193B,A02,083464,Staff,22,0,30,8
1649814659791,MATH 193B,A03,083465,Staff,30,0,30,0
1649814665847,COGS 2,A01,083966,Boyle; Mary E. T.,27,0,30,3
1649814671876,COGS 9,A01,083968,Staff,57,0,60,3
1649814677899,COGS 14B,A01,083970,Staff,48,0,50,2
1649814683928,COGS 17,A01,092679,Staff,74,0,75,1
1649814689952,COGS 100,A01,083972,Staff,49,0,60,11
1649814702002,COGS 101C,A01,083976,Staff,26,0,30,4
1649814708030,COGS 102A,A01,083978,Johnson; Christine M.,27,0,30,3
1649814714057,COGS 107B,A01,083980,Staff,41,0,50,9
1649814720086,COGS 115,A01,083982,Staff,23,0,30,7
1649814726113,COGS 118B,A01,083367,Staff,9,0,40,31
1649814732141,COGS 172,A01,083984,Provenzano; Emily Kara,24,0,30,6
1649814738164,COGS 177,A00,083368,Staff,11,0,30,19
1649814744186,COGS 186,A01,083986,Staff,28,0,40,12
1649814750216,COGS 187A,A01,083988,Boyle; Mary E. T.,46,0,60,14
1649814756244,CSE 8A,A50,084003,Miranda; Gregory Joseph,11,0,15,4
1649814762267,CSE 11,A01,084005,Miranda; Gregory Joseph,50,0,55,5
1649814768291,CSE 20,A01,084007,Staff,17,0,20,3
1649814774315,CSE 21,A01,084009,Staff,41,0,50,9
1649814780341,CSE 30,A01,083370,Cao; Yingjun,25,0,40,15
1649814786374,CSE 100,A01,083372,Cao; Yingjun,29,0,40,11
1649814792399,CSE 101,A01,084011,Staff,4,0,40,36
1649814798426,CSE 141,A01,083374,Eldon; John,8,0,75,67
1649814804450,CSE 141L,A01,083376,Eldon; John,7,0,75,68
1649814810476,CSE 175,A01,084013,Kumar; Rakesh,25,0,25,0
1649814816507,CSE 190,A00,092508,Staff,15,0,15,0
1649814822530,ECE 5,A01,084049,Morris; Karcher William,18,0,20,2
1649814828553,ECE 100,A01,084051,Baghdadchi; Saharnaz,17,0,20,3
1649814828553,ECE 100,A02,091916,Baghdadchi; Saharnaz,18,0,20,2
1649814834576,ECE 101,A01,084053,Baghdadchi; Saharnaz,27,0,37,10
1649814834576,ECE 101,A02,084054,Baghdadchi; Saharnaz,37,0,37,0
1649814840601,ECE 107,A01,083390,Staff,34,0,40,6
1649814846623,ECE 148,A01,084056,Silberman; Jack,8,0,12,4
1649814852651,ECE 180,A00,083391,Abi Samra; Nicholas Camill,27,0,30,3
1649814852651,ECE 180,B00,083392,Abi Samra; Nicholas Camill,26,0,30,4
1649814858673,MATH 10B,A01,084110,Staff,22,0,30,8
1649814858673,MATH 10B,A02,084111,Staff,29,0,30,1
1649814858673,MATH 10B,A03,084112,Staff,29,0,30,1
1649814869440,MATH 10C,A01,083443,Staff,22,0,30,8
1649814869440,MATH 10C,A02,083444,Staff,26,0,30,4
1649814869440,MATH 10C,B01,084114,Staff,26,0,30,4
1649814869440,MATH 10C,B02,084115,Staff,30,0,30,0
1649814875465,MATH 18,A01,084117,Harel; Guershon,28,0,30,2
1649814875465,MATH 18,A02,084119,Harel; Guershon,29,0,30,1
1649814875465,MATH 18,A03,084120,Harel; Guershon,30,0,30,0
1649814875465,MATH 18,A04,084121,Harel; Guershon,30,0,30,0
1649814881494,MATH 20B,A01,084124,Um; Ko Woon,33,0,35,2
1649814881494,MATH 20B,B01,084126,Um; Ko Woon,35,0,35,0
1649814887527,MATH 20C,A01,083446,Hammock; Frances H,27,0,30,3
1649814887527,MATH 20C,A02,083447,Hammock; Frances H,30,0,30,0
1649814887527,MATH 20C,A03,083448,Hammock; Frances H,30,0,30,0
1649814887527,MATH 20C,A04,083449,Hammock; Frances H,30,0,30,0
1649814887527,MATH 20C,B01,083451,Hammock; Frances H,30,0,30,0
1649814887527,MATH 20C,B02,083452,Hammock; Frances H,30,0,30,0
1649814887527,MATH 20C,B03,083453,Hammock; Frances H,30,0,30,0
1649814887527,MATH 20C,B04,083454,Hammock; Frances H,30,0,30,0
1649814893554,MATH 20D,A01,084128,Staff,30,0,30,0
1649814893554,MATH 20D,A02,084129,Staff,30,0,30,0
1649814893554,MATH 20D,A03,084130,Staff,29,0,30,1
1649814893554,MATH 20D,B01,084133,Staff,28,0,30,2
1649814893554,MATH 20D,B02,084134,Staff,30,0,30,0
1649814893554,MATH 20D,B03,084135,Staff,30,0,30,0
1649814899580,MATH 20E,A01,084138,Staff,29,0,30,1
1649814899580,MATH 20E,A02,084139,Staff,29,0,30,1
1649814899580,MATH 20E,A03,084140,Staff,29,0,30,1
1649814899580,MATH 20E,A04,084141,Staff,30,0,30,0
1649814905619,MATH 102,A01,084143,Harel; Guershon,25,0,30,5
1649814905619,MATH 102,A02,084144,Harel; Guershon,26,0,30,4
1649814911654,MATH 103B,A01,083456,Staff,9,0,30,21
1649814911654,MATH 103B,A02,083457,Staff,24,0,30,6
1649814917680,MATH 109,A01,084146,Salehi Golsefidy; Alireza,30,0,30,0
1649814917680,MATH 109,A02,084147,Salehi Golsefidy; Alireza,27,0,30,3
1649814923709,MATH 120A,A01,085445,Eggers; John Dietrich,31,0,35,4
1649814923709,MATH 120A,A02,085446,Eggers; John Dietrich,32,0,35,3
1649814929731,MATH 142B,A01,084149,Verstraete; Jacques Allan,18,0,30,12
1649814929731,MATH 142B,A02,084150,Verstraete; Jacques Allan,26,0,30,4
1649814935762,MATH 170A,A01,083459,Nie; Jiawang,15,0,30,15
1649814935762,MATH 170A,A02,083460,Nie; Jiawang,26,0,30,4
1649814935762,MATH 170A,A03,083461,Nie; Jiawang,26,0,30,4
1649814941784,MATH 193B,A01,083463,Staff,22,0,30,8
1649814941784,MATH 193B,A02,083464,Staff,22,0,30,8
1649814941784,MATH 193B,A03,083465,Staff,30,0,30,0
1649814947847,COGS 2,A01,083966,Boyle; Mary E. T.,27,0,30,3
1649814953875,COGS 9,A01,083968,Staff,57,0,60,3
1649814959901,COGS 14B,A01,083970,Staff,48,0,50,2
1649814965926,COGS 17,A01,092679,Staff,74,0,75,1
1649814971949,COGS 100,A01,083972,Staff,49,0,60,11
1649814984001,COGS 101C,A01,083976,Staff,26,0,30,4
1649814990038,COGS 102A,A01,083978,Johnson; Christine M.,27,0,30,3
1649814996062,COGS 107B,A01,083980,Staff,41,0,50,9
1649815002087,COGS 115,A01,083982,Staff,23,0,30,7
1649815008112,COGS 118B,A01,083367,Staff,9,0,40,31
1649815014137,COGS 172,A01,083984,Provenzano; Emily Kara,24,0,30,6
1649815020161,COGS 177,A00,083368,Staff,11,0,30,19
1649815026195,COGS 186,A01,083986,Staff,28,0,40,12
1649815032219,COGS 187A,A01,083988,Boyle; Mary E. T.,46,0,60,14
1649815038248,CSE 8A,A50,084003,Miranda; Gregory Joseph,11,0,15,4
1649815044275,CSE 11,A01,084005,Miranda; Gregory Joseph,50,0,55,5
1649815050301,CSE 20,A01,084007,Staff,17,0,20,3
1649815056324,CSE 21,A01,084009,Staff,41,0,50,9
1649815062348,CSE 30,A01,083370,Cao; Yingjun,25,0,40,15
1649815068381,CSE 100,A01,083372,Cao; Yingjun,29,0,40,11
1649815074406,CSE 101,A01,084011,Staff,4,0,40,36
1649815080507,CSE 141,A01,083374,Eldon; John,8,0,75,67
1649815086534,CSE 141L,A01,083376,Eldon; John,7,0,75,68
1649815092562,CSE 175,A01,084013,Kumar; Rakesh,25,0,25,0
1649815098585,CSE 190,A00,092508,Staff,15,0,15,0
1649815104608,ECE 5,A01,084049,Morris; Karcher William,18,0,20,2
1649815110632,ECE 100,A01,084051,Baghdadchi; Saharnaz,17,0,20,3
1649815110632,ECE 100,A02,091916,Baghdadchi; Saharnaz,18,0,20,2
1649815116670,ECE 101,A01,084053,Baghdadchi; Saharnaz,27,0,37,10
1649815116670,ECE 101,A02,084054,Baghdadchi; Saharnaz,37,0,37,0
1649815122700,ECE 107,A01,083390,Staff,34,0,40,6
1649815128724,ECE 148,A01,084056,Silberman; Jack,8,0,12,4
1649815134747,ECE 180,A00,083391,Abi Samra; Nicholas Camill,27,0,30,3
1649815134747,ECE 180,B00,083392,Abi Samra; Nicholas Camill,26,0,30,4
1649815140770,MATH 10B,A01,084110,Staff,22,0,30,8
1649815140770,MATH 10B,A02,084111,Staff,29,0,30,1
1649815140770,MATH 10B,A03,084112,Staff,29,0,30,1
1649815146794,MATH 10C,A01,083443,Staff,22,0,30,8
1649815146794,MATH 10C,A02,083444,Staff,26,0,30,4
1649815146794,MATH 10C,B01,084114,Staff,26,0,30,4
1649815146794,MATH 10C,B02,084115,Staff,30,0,30,0
1649815152825,MATH 18,A01,084117,Harel; Guershon,28,0,30,2
1649815152825,MATH 18,A02,084119,Harel; Guershon,29,0,30,1
1649815152825,MATH 18,A03,084120,Harel; Guershon,30,0,30,0
1649815152825,MATH 18,A04,084121,Harel; Guershon,30,0,30,0
1649815158848,MATH 20B,A01,084124,Um; Ko Woon,33,0,35,2
1649815158848,MATH 20B,B01,084126,Um; Ko Woon,35,0,35,0
1649815164878,MATH 20C,A01,083446,Hammock; Frances H,27,0,30,3
1649815164878,MATH 20C,A02,083447,Hammock; Frances H,30,0,30,0
1649815164878,MATH 20C,A03,083448,Hammock; Frances H,30,0,30,0
1649815164878,MATH 20C,A04,083449,Hammock; Frances H,30,0,30,0
1649815164878,MATH 20C,B01,083451,Hammock; Frances H,30,0,30,0
1649815164878,MATH 20C,B02,083452,Hammock; Frances H,30,0,30,0
1649815164878,MATH 20C,B03,083453,Hammock; Frances H,30,0,30,0
1649815164878,MATH 20C,B04,083454,Hammock; Frances H,30,0,30,0
1649815170904,MATH 20D,A01,084128,Staff,30,0,30,0
1649815170904,MATH 20D,A02,084129,Staff,30,0,30,0
1649815170904,MATH 20D,A03,084130,Staff,29,0,30,1
1649815170904,MATH 20D,B01,084133,Staff,28,0,30,2
1649815170904,MATH 20D,B02,084134,Staff,30,0,30,0
1649815170904,MATH 20D,B03,084135,Staff,30,0,30,0
1649815176933,MATH 20E,A01,084138,Staff,29,0,30,1
1649815176933,MATH 20E,A02,084139,Staff,29,0,30,1
1649815176933,MATH 20E,A03,084140,Staff,29,0,30,1
1649815176933,MATH 20E,A04,084141,Staff,30,0,30,0
1649815182957,MATH 102,A01,084143,Harel; Guershon,25,0,30,5
1649815182957,MATH 102,A02,084144,Harel; Guershon,26,0,30,4
1649815188985,MATH 103B,A01,083456,Staff,9,0,30,21
1649815188985,MATH 103B,A02,083457,Staff,24,0,30,6
1649815195014,MATH 109,A01,084146,Salehi Golsefidy; Alireza,30,0,30,0
1649815195014,MATH 109,A02,084147,Salehi Golsefidy; Alireza,27,0,30,3
1649815201047,MATH 120A,A01,085445,Eggers; John Dietrich,31,0,35,4
1649815201047,MATH 120A,A02,085446,Eggers; John Dietrich,32,0,35,3
1649815207076,MATH 142B,A01,084149,Verstraete; Jacques Allan,18,0,30,12
1649815207076,MATH 142B,A02,084150,Verstraete; Jacques Allan,26,0,30,4
1649815213104,MATH 170A,A01,083459,Nie; Jiawang,15,0,30,15
1649815213104,MATH 170A,A02,083460,Nie; Jiawang,26,0,30,4
1649815213104,MATH 170A,A03,083461,Nie; Jiawang,26,0,30,4
1649815219128,MATH 193B,A01,083463,Staff,22,0,30,8
1649815219128,MATH 193B,A02,083464,Staff,22,0,30,8
1649815219128,MATH 193B,A03,083465,Staff,30,0,30,0
1649815225186,COGS 2,A01,083966,Boyle; Mary E. T.,27,0,30,3
1649815231220,COGS 9,A01,083968,Staff,57,0,60,3
1649815237254,COGS 14B,A01,083970,Staff,48,0,50,2
1649815243290,COGS 17,A01,092679,Staff,74,0,75,1
1649815249313,COGS 100,A01,083972,Staff,49,0,60,11
1649815261372,COGS 101C,A01,083976,Staff,26,0,30,4
1649815267395,COGS 102A,A01,083978,Johnson; Christine M.,27,0,30,3
1649815273422,COGS 107B,A01,083980,Staff,41,0,50,9
1649815279446,COGS 115,A01,083982,Staff,23,0,30,7
1649815285468,COGS 118B,A01,083367,Staff,9,0,40,31
1649815291496,COGS 172,A01,083984,Provenzano; Emily Kara,24,0,30,6
1649815297530,COGS 177,A00,083368,Staff,11,0,30,19
1649815303557,COGS 186,A01,083986,Staff,28,0,40,12
1649815309586,COGS 187A,A01,083988,Boyle; Mary E. T.,46,0,60,14
1649815315609,CSE 8A,A50,084003,Miranda; Gregory Joseph,11,0,15,4
1649815321638,CSE 11,A01,084005,Miranda; Gregory Joseph,50,0,55,5
1649815327661,CSE 20,A01,084007,Staff,17,0,20,3
1649815333686,CSE 21,A01,084009,Staff,41,0,50,9
1649815339714,CSE 30,A01,083370,Cao; Yingjun,25,0,40,15
1649815345741,CSE 100,A01,083372,Cao; Yingjun,29,0,40,11
1649815351767,CSE 101,A01,084011,Staff,4,0,40,36
1649815357791,CSE 141,A01,083374,Eldon; John,6,0,75,69
1649815363817,CSE 141L,A01,083376,Eldon; John,5,0,75,70
1649815369841,CSE 175,A01,084013,Kumar; Rakesh,24,0,25,1
1649815375865,CSE 190,A00,092508,Staff,15,0,15,0
1649815381892,ECE 5,A01,084049,Morris; Karcher William,18,0,20,2
1649815387918,ECE 100,A01,084051,Baghdadchi; Saharnaz,17,0,20,3
1649815387918,ECE 100,A02,091916,Baghdadchi; Saharnaz,18,0,20,2
1649815393946,ECE 101,A01,084053,Baghdadchi; Saharnaz,27,0,37,10
1649815393946,ECE 101,A02,084054,Baghdadchi; Saharnaz,37,0,37,0
1649815399970,ECE 107,A01,083390,Staff,34,0,40,6
1649815405996,ECE 148,A01,084056,Silberman; Jack,8,0,12,4
1649815412020,ECE 180,A00,083391,Abi Samra; Nicholas Camill,27,0,30,3
1649815412020,ECE 180,B00,083392,Abi Samra; Nicholas Camill,26,0,30,4
1649815418044,MATH 10B,A01,084110,Staff,21,0,30,9
1649815418044,MATH 10B,A02,084111,Staff,29,0,30,1
1649815418044,MATH 10B,A03,084112,Staff,29,0,30,1
1649815424072,MATH 10C,A01,083443,Staff,22,0,30,8
1649815424072,MATH 10C,A02,083444,Staff,26,0,30,4
1649815424072,MATH 10C,B01,084114,Staff,26,0,30,4
1649815424072,MATH 10C,B02,084115,Staff,30,0,30,0
1649815430096,MATH 18,A01,084117,Harel; Guershon,28,0,30,2
1649815430096,MATH 18,A02,084119,Harel; Guershon,29,0,30,1
1649815430096,MATH 18,A03,084120,Harel; Guershon,30,0,30,0
1649815430096,MATH 18,A04,084121,Harel; Guershon,30,0,30,0
1649815436120,MATH 20B,A01,084124,Um; Ko Woon,33,0,35,2
1649815436120,MATH 20B,B01,084126,Um; Ko Woon,35,0,35,0
1649815442146,MATH 20C,A01,083446,Hammock; Frances H,27,0,30,3
1649815442146,MATH 20C,A02,083447,Hammock; Frances H,30,0,30,0
1649815442146,MATH 20C,A03,083448,Hammock; Frances H,30,0,30,0
1649815442146,MATH 20C,A04,083449,Hammock; Frances H,30,0,30,0
1649815442146,MATH 20C,B01,083451,Hammock; Frances H,30,0,30,0
1649815442146,MATH 20C,B02,083452,Hammock; Frances H,30,0,30,0
1649815442146,MATH 20C,B03,083453,Hammock; Frances H,30,0,30,0
1649815442146,MATH 20C,B04,083454,Hammock; Frances H,30,0,30,0
1649815448174,MATH 20D,A01,084128,Staff,30,0,30,0
1649815448174,MATH 20D,A02,084129,Staff,30,0,30,0
1649815448174,MATH 20D,A03,084130,Staff,29,0,30,1
1649815448174,MATH 20D,B01,084133,Staff,28,0,30,2
1649815448174,MATH 20D,B02,084134,Staff,30,0,30,0
1649815448174,MATH 20D,B03,084135,Staff,30,0,30,0
1649815454198,MATH 20E,A01,084138,Staff,29,0,30,1
1649815454198,MATH 20E,A02,084139,Staff,29,0,30,1
1649815454198,MATH 20E,A03,084140,Staff,29,0,30,1
1649815454198,MATH 20E,A04,084141,Staff,30,0,30,0
1649815460220,MATH 102,A01,084143,Harel; Guershon,25,0,30,5
1649815460220,MATH 102,A02,084144,Harel; Guershon,26,0,30,4
1649815466246,MATH 103B,A01,083456,Staff,8,0,30,22
1649815466246,MATH 103B,A02,083457,Staff,24,0,30,6
1649815472271,MATH 109,A01,084146,Salehi Golsefidy; Alireza,30,0,30,0
1649815472271,MATH 109,A02,084147,Salehi Golsefidy; Alireza,27,0,30,3
1649815478296,MATH 120A,A01,085445,Eggers; John Dietrich,31,0,35,4
1649815478296,MATH 120A,A02,085446,Eggers; John Dietrich,32,0,35,3
1649815484319,MATH 142B,A01,084149,Verstraete; Jacques Allan,17,0,30,13
1649815484319,MATH 142B,A02,084150,Verstraete; Jacques Allan,26,0,30,4
1649815490343,MATH 170A,A01,083459,Nie; Jiawang,15,0,30,15
1649815490343,MATH 170A,A02,083460,Nie; Jiawang,26,0,30,4
1649815490343,MATH 170A,A03,083461,Nie; Jiawang,26,0,30,4
1649815496366,MATH 193B,A01,083463,Staff,21,0,30,9
1649815496366,MATH 193B,A02,083464,Staff,22,0,30,8
1649815496366,MATH 193B,A03,083465,Staff,29,0,30,1
1649815502434,COGS 2,A01,083966,Boyle; Mary E. T.,27,0,30,3
1649815508456,COGS 9,A01,083968,Staff,57,0,60,3
1649815514477,COGS 14B,A01,083970,Staff,48,0,50,2
1649815520513,COGS 17,A01,092679,Staff,74,0,75,1
1649815526539,COGS 100,A01,083972,Staff,49,0,60,11
1649815538588,COGS 101C,A01,083976,Staff,26,0,30,4
1649815544611,COGS 102A,A01,083978,Johnson; Christine M.,26,0,30,4
1649815550634,COGS 107B,A01,083980,Staff,41,0,50,9
1649815556659,COGS 115,A01,083982,Staff,23,0,30,7
1649815562688,COGS 118B,A01,083367,Staff,9,0,40,31
1649815568710,COGS 172,A01,083984,Provenzano; Emily Kara,24,0,30,6
1649815574741,COGS 177,A00,083368,Staff,10,0,30,20
1649815580764,COGS 186,A01,083986,Staff,28,0,40,12
1649815586788,COGS 187A,A01,083988,Boyle; Mary E. T.,45,0,60,15
1649815592813,CSE 8A,A50,084003,Miranda; Gregory Joseph,11,0,15,4
1649815598836,CSE 11,A01,084005,Miranda; Gregory Joseph,50,0,55,5
1649815604863,CSE 20,A01,084007,Staff,17,0,20,3
1649815610885,CSE 21,A01,084009,Staff,41,0,50,9
1649815616908,CSE 30,A01,083370,Cao; Yingjun,24,0,40,16
1649815622936,CSE 100,A01,083372,Cao; Yingjun,28,0,40,12
1649815628961,CSE 101,A01,084011,Staff,4,0,40,36
1649815634984,CSE 141,A01,083374,Eldon; John,5,0,75,70
1649815641009,CSE 141L,A01,083376,Eldon; John,3,0,75,72
1649815647033,CSE 175,A01,084013,Kumar; Rakesh,24,0,25,1
1649815653062,CSE 190,A00,092508,Staff,15,0,15,0
1649815659086,ECE 5,A01,084049,Morris; Karcher William,18,0,20,2
1649815665113,ECE 100,A01,084051,Baghdadchi; Saharnaz,17,0,20,3
1649815665113,ECE 100,A02,091916,Baghdadchi; Saharnaz,18,0,20,2
1649815671137,ECE 101,A01,084053,Baghdadchi; Saharnaz,27,0,37,10
1649815671137,ECE 101,A02,084054,Baghdadchi; Saharnaz,37,0,37,0
1649815677250,ECE 107,A01,083390,Staff,34,0,40,6
1649815683275,ECE 148,A01,084056,Silberman; Jack,8,0,12,4
1649815689302,ECE 180,A00,083391,Abi Samra; Nicholas Camill,27,0,30,3
1649815689302,ECE 180,B00,083392,Abi Samra; Nicholas Camill,26,0,30,4
1649815695329,MATH 10B,A01,084110,Staff,21,0,30,9
1649815695329,MATH 10B,A02,084111,Staff,29,0,30,1
1649815695329,MATH 10B,A03,084112,Staff,29,0,30,1
1649815701355,MATH 10C,A01,083443,Staff,22,0,30,8
1649815701355,MATH 10C,A02,083444,Staff,26,0,30,4
1649815701355,MATH 10C,B01,084114,Staff,26,0,30,4
1649815701355,MATH 10C,B02,084115,Staff,30,0,30,0
1649815707378,MATH 18,A01,084117,Harel; Guershon,28,0,30,2
1649815707378,MATH 18,A02,084119,Harel; Guershon,29,0,30,1
1649815707378,MATH 18,A03,084120,Harel; Guershon,30,0,30,0
1649815707378,MATH 18,A04,084121,Harel; Guershon,30,0,30,0
1649815713405,MATH 20B,A01,084124,Um; Ko Woon,33,0,35,2
1649815713405,MATH 20B,B01,084126,Um; Ko Woon,35,0,35,0
1649815719429,MATH 20C,A01,083446,Hammock; Frances H,27,0,30,3
1649815719429,MATH 20C,A02,083447,Hammock; Frances H,30,0,30,0
1649815719429,MATH 20C,A03,083448,Hammock; Frances H,30,0,30,0
1649815719429,MATH 20C,A04,083449,Hammock; Frances H,30,0,30,0
1649815719429,MATH 20C,B01,083451,Hammock; Frances H,30,0,30,0
1649815719429,MATH 20C,B02,083452,Hammock; Frances H,30,0,30,0
1649815719429,MATH 20C,B03,083453,Hammock; Frances H,30,0,30,0
1649815719429,MATH 20C,B04,083454,Hammock; Frances H,30,0,30,0
1649815725454,MATH 20D,A01,084128,Staff,29,0,30,1
1649815725454,MATH 20D,A02,084129,Staff,30,0,30,0
1649815725454,MATH 20D,A03,084130,Staff,29,0,30,1
1649815725454,MATH 20D,B01,084133,Staff,28,0,30,2
1649815725454,MATH 20D,B02,084134,Staff,30,0,30,0
1649815725454,MATH 20D,B03,084135,Staff,30,0,30,0
1649815731484,MATH 20E,A01,084138,Staff,29,0,30,1
1649815731484,MATH 20E,A02,084139,Staff,29,0,30,1
1649815731484,MATH 20E,A03,084140,Staff,29,0,30,1
1649815731484,MATH 20E,A04,084141,Staff,30,0,30,0
1649815737509,MATH 102,A01,084143,Harel; Guershon,25,0,30,5
1649815737509,MATH 102,A02,084144,Harel; Guershon,26,0,30,4
1649815743540,MATH 103B,A01,083456,Staff,7,0,30,23
1649815743540,MATH 103B,A02,083457,Staff,24,0,30,6
1649815749564,MATH 109,A01,084146,Salehi Golsefidy; Alireza,30,0,30,0
1649815749564,MATH 109,A02,084147,Salehi Golsefidy; Alireza,27,0,30,3
1649815755588,MATH 120A,A01,085445,Eggers; John Dietrich,31,0,35,4
1649815755588,MATH 120A,A02,085446,Eggers; John Dietrich,32,0,35,3
1649815761612,MATH 142B,A01,084149,Verstraete; Jacques Allan,16,0,30,14
1649815761612,MATH 142B,A02,084150,Verstraete; Jacques Allan,26,0,30,4
1649815767642,MATH 170A,A01,083459,Nie; Jiawang,15,0,30,15
1649815767642,MATH 170A,A02,083460,Nie; Jiawang,26,0,30,4
1649815767642,MATH 170A,A03,083461,Nie; Jiawang,26,0,30,4
1649815773666,MATH 193B,A01,083463,Staff,21,0,30,9
1649815773666,MATH 193B,A02,083464,Staff,21,0,30,9
1649815773666,MATH 193B,A03,083465,Staff,29,0,30,1
1649815779721,COGS 2,A01,083966,Boyle; Mary E. T.,27,0,30,3
1649815785744,COGS 9,A01,083968,Staff,57,0,60,3
1649815791771,COGS 14B,A01,083970,Staff,48,0,50,2
1649815797795,COGS 17,A01,092679,Staff,74,0,75,1
1649815803822,COGS 100,A01,083972,Staff,49,0,60,11
1649815815868,COGS 101C,A01,083976,Staff,26,0,30,4
1649815821892,COGS 102A,A01,083978,Johnson; Christine M.,26,0,30,4
1649815827917,COGS 107B,A01,083980,Staff,41,0,50,9
1649815833945,COGS 115,A01,083982,Staff,23,0,30,7
1649815839967,COGS 118B,A01,083367,Staff,9,0,40,31
1649815846002,COGS 172,A01,083984,Provenzano; Emily Kara,24,0,30,6
1649815852023,COGS 177,A00,083368,Staff,10,0,30,20
1649815858045,COGS 186,A01,083986,Staff,27,0,40,13
1649815864076,COGS 187A,A01,083988,Boyle; Mary E. T.,44,0,60,16
1649815870100,CSE 8A,A50,084003,Miranda; Gregory Joseph,11,0,15,4
1649815876123,CSE 11,A01,084005,Miranda; Gregory Joseph,50,0,55,5
1649815882147,CSE 20,A01,084007,Staff,17,0,20,3
1649815888177,CSE 21,A01,084009,Staff,41,0,50,9
1649815894201,CSE 30,A01,083370,Cao; Yingjun,23,0,40,17
1649815900223,CSE 100,A01,083372,Cao; Yingjun,27,0,40,13
1649815906249,CSE 101,A01,084011,Staff,3,0,40,37
1649815912271,CSE 141,A01,083374,Eldon; John,5,0,75,70
1649815918321,CSE 141L,A01,083376,Eldon; John,3,0,75,72
1649815924347,CSE 175,A01,084013,Kumar; Rakesh,24,0,25,1
1649815930370,CSE 190,A00,092508,Staff,15,0,15,0
1649815936392,ECE 5,A01,084049,Morris; Karcher William,18,0,20,2
1649815942425,ECE 100,A01,084051,Baghdadchi; Saharnaz,17,0,20,3
1649815942425,ECE 100,A02,091916,Baghdadchi; Saharnaz,18,0,20,2
1649815948450,ECE 101,A01,084053,Baghdadchi; Saharnaz,27,0,37,10
1649815948450,ECE 101,A02,084054,Baghdadchi; Saharnaz,37,0,37,0
1649815954476,ECE 107,A01,083390,Staff,34,0,40,6
1649815960500,ECE 148,A01,084056,Silberman; Jack,8,0,12,4
1649815966522,ECE 180,A00,083391,Abi Samra; Nicholas Camill,27,0,30,3
1649815966522,ECE 180,B00,083392,Abi Samra; Nicholas Camill,26,0,30,4
1649815972566,MATH 10B,A01,084110,Staff,21,0,30,9
1649815972566,MATH 10B,A02,084111,Staff,29,0,30,1
1649815972566,MATH 10B,A03,084112,Staff,29,0,30,1
1649815978590,MATH 10C,A01,083443,Staff,22,0,30,8
1649815978590,MATH 10C,A02,083444,Staff,26,0,30,4
1649815978590,MATH 10C,B01,084114,Staff,26,0,30,4
1649815978590,MATH 10C,B02,084115,Staff,30,0,30,0
1649815984627,MATH 18,A01,084117,Harel; Guershon,28,0,30,2
1649815984627,MATH 18,A02,084119,Harel; Guershon,29,0,30,1
1649815984627,MATH 18,A03,084120,Harel; Guershon,30,0,30,0
1649815984627,MATH 18,A04,084121,Harel; Guershon,30,0,30,0
1649815990654,MATH 20B,A01,084124,Um; Ko Woon,33,0,35,2
1649815990654,MATH 20B,B01,084126,Um; Ko Woon,35,0,35,0
1649815996696,MATH 20C,A01,083446,Hammock; Frances H,27,0,30,3
1649815996696,MATH 20C,A02,083447,Hammock; Frances H,30,0,30,0
1649815996696,MATH 20C,A03,083448,Hammock; Frances H,30,0,30,0
1649815996696,MATH 20C,A04,083449,Hammock; Frances H,30,0,30,0
1649815996696,MATH 20C,B01,083451,Hammock; Frances H,30,0,30,0
1649815996696,MATH 20C,B02,083452,Hammock; Frances H,30,0,30,0
1649815996696,MATH 20C,B03,083453,Hammock; Frances H,30,0,30,0
1649815996696,MATH 20C,B04,083454,Hammock; Frances H,30,0,30,0
1649816002719,MATH 20D,A01,084128,Staff,29,0,30,1
1649816002719,MATH 20D,A02,084129,Staff,30,0,30,0
1649816002719,MATH 20D,A03,084130,Staff,29,0,30,1
1649816002719,MATH 20D,B01,084133,Staff,28,0,30,2
1649816002719,MATH 20D,B02,084134,Staff,30,0,30,0
1649816002719,MATH 20D,B03,084135,Staff,30,0,30,0
1649816008743,MATH 20E,A01,084138,Staff,29,0,30,1
1649816008743,MATH 20E,A02,084139,Staff,29,0,30,1
1649816008743,MATH 20E,A03,084140,Staff,29,0,30,1
1649816008743,MATH 20E,A04,084141,Staff,30,0,30,0
1649816014766,MATH 102,A01,084143,Harel; Guershon,25,0,30,5
1649816014766,MATH 102,A02,084144,Harel; Guershon,26,0,30,4
1649816020798,MATH 103B,A01,083456,Staff,5,0,30,25
1649816020798,MATH 103B,A02,083457,Staff,24,0,30,6
1649816026830,MATH 109,A01,084146,Salehi Golsefidy; Alireza,30,0,30,0
1649816026830,MATH 109,A02,084147,Salehi Golsefidy; Alireza,27,0,30,3
1649816032861,MATH 120A,A01,085445,Eggers; John Dietrich,31,0,35,4
1649816032861,MATH 120A,A02,085446,Eggers; John Dietrich,31,0,35,4
1649816038885,MATH 142B,A01,084149,Verstraete; Jacques Allan,15,0,30,15
1649816038885,MATH 142B,A02,084150,Verstraete; Jacques Allan,26,0,30,4
1649816044908,MATH 170A,A01,083459,Nie; Jiawang,15,0,30,15
1649816044908,MATH 170A,A02,083460,Nie; Jiawang,26,0,30,4
1649816044908,MATH 170A,A03,083461,Nie; Jiawang,26,0,30,4
1649816050936,MATH 193B,A01,083463,Staff,21,0,30,9
1649816050936,MATH 193B,A02,083464,Staff,21,0,30,9
1649816050936,MATH 193B,A03,083465,Staff,28,0,30,2
1649816057005,COGS 2,A01,083966,Boyle; Mary E. T.,27,0,30,3
1649816063028,COGS 9,A01,083968,Staff,57,0,60,3
1649816069055,COGS 14B,A01,083970,Staff,48,0,50,2
1649816075083,COGS 17,A01,092679,Staff,74,0,75,1
1649816081108,COGS 100,A01,083972,Staff,49,0,60,11
1649816093159,COGS 101C,A01,083976,Staff,26,0,30,4
1649816099183,COGS 102A,A01,083978,Johnson; Christine M.,26,0,30,4
1649816105220,COGS 107B,A01,083980,Staff,40,0,50,10
1649816111242,COGS 115,A01,083982,Staff,23,0,30,7
1649816117271,COGS 118B,A01,083367,Staff,7,0,40,33
1649816123302,COGS 172,A01,083984,Provenzano; Emily Kara,24,0,30,6
1649816129328,COGS 177,A00,083368,Staff,10,0,30,20
1649816135354,COGS 186,A01,083986,Staff,26,0,40,14
1649816141393,COGS 187A,A01,083988,Boyle; Mary E. T.,44,0,60,16
1649816147420,CSE 8A,A50,084003,Miranda; Gregory Joseph,10,0,15,5
1649816153454,CSE 11,A01,084005,Miranda; Gregory Joseph,50,0,55,5
1649816159495,CSE 20,A01,084007,Staff,17,0,20,3
1649816165522,CSE 21,A01,084009,Staff,40,0,50,10
1649816171545,CSE 30,A01,083370,Cao; Yingjun,23,0,40,17
1649816177571,CSE 100,A01,083372,Cao; Yingjun,27,0,40,13
1649816183599,CSE 101,A01,084011,Staff,3,0,40,37
1649816189622,CSE 141,A01,083374,Eldon; John,5,0,75,70
1649816195650,CSE 141L,A01,083376,Eldon; John,3,0,75,72
1649816201675,CSE 175,A01,084013,Kumar; Rakesh,24,0,25,1
1649816207697,CSE 190,A00,092508,Staff,15,0,15,0
1649816213725,ECE 5,A01,084049,Morris; Karcher William,18,0,20,2
1649816219762,ECE 100,A01,084051,Baghdadchi; Saharnaz,17,0,20,3
1649816219762,ECE 100,A02,091916,Baghdadchi; Saharnaz,18,0,20,2
1649816225789,ECE 101,A01,084053,Baghdadchi; Saharnaz,27,0,37,10
1649816225789,ECE 101,A02,084054,Baghdadchi; Saharnaz,37,0,37,0
1649816231815,ECE 107,A01,083390,Staff,34,0,40,6
1649816237840,ECE 148,A01,084056,Silberman; Jack,8,0,12,4
1649816243867,ECE 180,A00,083391,Abi Samra; Nicholas Camill,27,0,30,3
1649816243867,ECE 180,B00,083392,Abi Samra; Nicholas Camill,26,0,30,4
1649816249897,MATH 10B,A01,084110,Staff,21,0,30,9
1649816249897,MATH 10B,A02,084111,Staff,29,0,30,1
1649816249897,MATH 10B,A03,084112,Staff,29,0,30,1
1649816255920,MATH 10C,A01,083443,Staff,22,0,30,8
1649816255920,MATH 10C,A02,083444,Staff,26,0,30,4
1649816255920,MATH 10C,B01,084114,Staff,26,0,30,4
1649816255920,MATH 10C,B02,084115,Staff,30,0,30,0
1649816261944,MATH 18,A01,084117,Harel; Guershon,28,0,30,2
1649816261944,MATH 18,A02,084119,Harel; Guershon,29,0,30,1
1649816261944,MATH 18,A03,084120,Harel; Guershon,30,0,30,0
1649816261944,MATH 18,A04,084121,Harel; Guershon,30,0,30,0
1649816267968,MATH 20B,A01,084124,Um; Ko Woon,33,0,35,2
1649816267968,MATH 20B,B01,084126,Um; Ko Woon,35,0,35,0
1649816274073,MATH 20C,A01,083446,Hammock; Frances H,27,0,30,3
1649816274073,MATH 20C,A02,083447,Hammock; Frances H,30,0,30,0
1649816274073,MATH 20C,A03,083448,Hammock; Frances H,30,0,30,0
1649816274073,MATH 20C,A04,083449,Hammock; Frances H,30,0,30,0
1649816274073,MATH 20C,B01,083451,Hammock; Frances H,30,0,30,0
1649816274073,MATH 20C,B02,083452,Hammock; Frances H,30,0,30,0
1649816274073,MATH 20C,B03,083453,Hammock; Frances H,30,0,30,0
1649816274073,MATH 20C,B04,083454,Hammock; Frances H,30,0,30,0
1649816280100,MATH 20D,A01,084128,Staff,29,0,30,1
1649816280100,MATH 20D,A02,084129,Staff,30,0,30,0
1649816280100,MATH 20D,A03,084130,Staff,29,0,30,1
1649816280100,MATH 20D,B01,084133,Staff,28,0,30,2
1649816280100,MATH 20D,B02,084134,Staff,30,0,30,0
1649816280100,MATH 20D,B03,084135,Staff,30,0,30,0
1649816286129,MATH 20E,A01,084138,Staff,29,0,30,1
1649816286129,MATH 20E,A02,084139,Staff,29,0,30,1
1649816286129,MATH 20E,A03,084140,Staff,29,0,30,1
1649816286129,MATH 20E,A04,084141,Staff,30,0,30,0
1649816292153,MATH 102,A01,084143,Harel; Guershon,24,0,30,6
1649816292153,MATH 102,A02,084144,Harel; Guershon,25,0,30,5
1649816298179,MATH 103B,A01,083456,Staff,4,0,30,26
1649816298179,MATH 103B,A02,083457,Staff,24,0,30,6
1649816304202,MATH 109,A01,084146,Salehi Golsefidy; Alireza,30,0,30,0
1649816304202,MATH 109,A02,084147,Salehi Golsefidy; Alireza,27,0,30,3
1649816310227,MATH 120A,A01,085445,Eggers; John Dietrich,31,0,35,4
1649816310227,MATH 120A,A02,085446,Eggers; John Dietrich,31,0,35,4
1649816316257,MATH 142B,A01,084149,Verstraete; Jacques Allan,14,0,30,16
1649816316257,MATH 142B,A02,084150,Verstraete; Jacques Allan,26,0,30,4
1649816322284,MATH 170A,A01,083459,Nie; Jiawang,15,0,30,15
1649816322284,MATH 170A,A02,083460,Nie; Jiawang,26,0,30,4
1649816322284,MATH 170A,A03,083461,Nie; Jiawang,26,0,30,4
1649816328307,MATH 193B,A01,083463,Staff,21,0,30,9
1649816328307,MATH 193B,A02,083464,Staff,21,0,30,9
1649816328307,MATH 193B,A03,083465,Staff,28,0,30,2
1649816334370,COGS 2,A01,083966,Boyle; Mary E. T.,27,0,30,3
1649816340394,COGS 9,A01,083968,Staff,57,0,60,3
1649816346428,COGS 14B,A01,083970,Staff,48,0,50,2
1649816352453,COGS 17,A01,092679,Staff,74,0,75,1
1649816358479,COGS 100,A01,083972,Staff,48,0,60,12
1649816370528,COGS 101C,A01,083976,Staff,26,0,30,4
1649816376552,COGS 102A,A01,083978,Johnson; Christine M.,26,0,30,4
1649816382579,COGS 107B,A01,083980,Staff,40,0,50,10
1649816388604,COGS 115,A01,083982,Staff,22,0,30,8
1649816394635,COGS 118B,A01,083367,Staff,7,0,40,33
1649816400663,COGS 172,A01,083984,Provenzano; Emily Kara,24,0,30,6
1649816406685,COGS 177,A00,083368,Staff,9,0,30,21
1649816412709,COGS 186,A01,083986,Staff,26,0,40,14
1649816418732,COGS 187A,A01,083988,Boyle; Mary E. T.,44,0,60,16
1649816424759,CSE 8A,A50,084003,Miranda; Gregory Joseph,10,0,15,5
1649816430783,CSE 11,A01,084005,Miranda; Gregory Joseph,50,0,55,5
1649816436806,CSE 20,A01,084007,Staff,17,0,20,3
1649816442827,CSE 21,A01,084009,Staff,40,0,50,10
1649816448855,CSE 30,A01,083370,Cao; Yingjun,23,0,40,17
1649816454879,CSE 100,A01,083372,Cao; Yingjun,27,0,40,13
1649816460907,CSE 101,A01,084011,Staff,2,0,40,38
1649816466930,CSE 141,A01,083374,Eldon; John,5,0,75,70
1649816472954,CSE 141L,A01,083376,Eldon; John,3,0,75,72
1649816478980,CSE 175,A01,084013,Kumar; Rakesh,24,0,25,1
1649816485007,CSE 190,A00,092508,Staff,15,0,15,0
1649816491046,ECE 5,A01,084049,Morris; Karcher William,18,0,20,2
1649816497071,ECE 100,A01,084051,Baghdadchi; Saharnaz,17,0,20,3
1649816497071,ECE 100,A02,091916,Baghdadchi; Saharnaz,18,0,20,2
1649816503102,ECE 101,A01,084053,Baghdadchi; Saharnaz,26,0,37,11
1649816503102,ECE 101,A02,084054,Baghdadchi; Saharnaz,37,0,37,0
1649816509130,ECE 107,A01,083390,Staff,34,0,40,6
1649816515161,ECE 148,A01,084056,Silberman; Jack,8,0,12,4
1649816521185,ECE 180,A00,083391,Abi Samra; Nicholas Camill,27,0,30,3
1649816521185,ECE 180,B00,083392,Abi Samra; Nicholas Camill,26,0,30,4
1649816527210,MATH 10B,A01,084110,Staff,21,0,30,9
1649816527210,MATH 10B,A02,084111,Staff,29,0,30,1
1649816527210,MATH 10B,A03,084112,Staff,29,0,30,1
1649816533239,MATH 10C,A01,083443,Staff,22,0,30,8
1649816533239,MATH 10C,A02,083444,Staff,26,0,30,4
1649816533239,MATH 10C,B01,084114,Staff,26,0,30,4
1649816533239,MATH 10C,B02,084115,Staff,30,0,30,0
1649816539268,MATH 18,A01,084117,Harel; Guershon,28,0,30,2
1649816539268,MATH 18,A02,084119,Harel; Guershon,29,0,30,1
1649816539268,MATH 18,A03,084120,Harel; Guershon,30,0,30,0
1649816539268,MATH 18,A04,084121,Harel; Guershon,30,0,30,0
1649816545305,MATH 20B,A01,084124,Um; Ko Woon,33,0,35,2
1649816545305,MATH 20B,B01,084126,Um; Ko Woon,35,0,35,0
1649816551330,MATH 20C,A01,083446,Hammock; Frances H,27,0,30,3
1649816551330,MATH 20C,A02,083447,Hammock; Frances H,30,0,30,0
1649816551330,MATH 20C,A03,083448,Hammock; Frances H,30,0,30,0
1649816551330,MATH 20C,A04,083449,Hammock; Frances H,30,0,30,0
1649816551330,MATH 20C,B01,083451,Hammock; Frances H,30,0,30,0
1649816551330,MATH 20C,B02,083452,Hammock; Frances H,30,0,30,0
1649816551330,MATH 20C,B03,083453,Hammock; Frances H,30,0,30,0
1649816551330,MATH 20C,B04,083454,Hammock; Frances H,30,0,30,0
1649816557354,MATH 20D,A01,084128,Staff,29,0,30,1
1649816557354,MATH 20D,A02,084129,Staff,30,0,30,0
1649816557354,MATH 20D,A03,084130,Staff,29,0,30,1
1649816557354,MATH 20D,B01,084133,Staff,28,0,30,2
1649816557354,MATH 20D,B02,084134,Staff,30,0,30,0
1649816557354,MATH 20D,B03,084135,Staff,30,0,30,0
1649816563378,MATH 20E,A01,084138,Staff,29,0,30,1
1649816563378,MATH 20E,A02,084139,Staff,29,0,30,1
1649816563378,MATH 20E,A03,084140,Staff,29,0,30,1
1649816563378,MATH 20E,A04,084141,Staff,30,0,30,0
1649816569407,MATH 102,A01,084143,Harel; Guershon,24,0,30,6
1649816569407,MATH 102,A02,084144,Harel; Guershon,25,0,30,5
1649816575432,MATH 103B,A01,083456,Staff,4,0,30,26
1649816575432,MATH 103B,A02,083457,Staff,24,0,30,6
1649816581457,MATH 109,A01,084146,Salehi Golsefidy; Alireza,30,0,30,0
1649816581457,MATH 109,A02,084147,Salehi Golsefidy; Alireza,27,0,30,3
1649816587482,MATH 120A,A01,085445,Eggers; John Dietrich,31,0,35,4
1649816587482,MATH 120A,A02,085446,Eggers; John Dietrich,31,0,35,4
1649816593509,MATH 142B,A01,084149,Verstraete; Jacques Allan,14,0,30,16
1649816593509,MATH 142B,A02,084150,Verstraete; Jacques Allan,26,0,30,4
1649816599537,MATH 170A,A01,083459,Nie; Jiawang,15,0,30,15
1649816599537,MATH 170A,A02,083460,Nie; Jiawang,26,0,30,4
1649816599537,MATH 170A,A03,083461,Nie; Jiawang,26,0,30,4
1649816605565,MATH 193B,A01,083463,Staff,21,0,30,9
1649816605565,MATH 193B,A02,083464,Staff,21,0,30,9
1649816605565,MATH 193B,A03,083465,Staff,28,0,30,2
1649816611623,COGS 2,A01,083966,Boyle; Mary E. T.,27,0,30,3
1649816617650,COGS 9,A01,083968,Staff,57,0,60,3
1649816623678,COGS 14B,A01,083970,Staff,48,0,50,2
1649816629705,COGS 17,A01,092679,Staff,74,0,75,1
1649816635743,COGS 100,A01,083972,Staff,48,0,60,12
1649816647802,COGS 101C,A01,083976,Staff,26,0,30,4
1649816653825,COGS 102A,A01,083978,Johnson; Christine M.,26,0,30,4
1649816659849,COGS 107B,A01,083980,Staff,40,0,50,10
1649816665882,COGS 115,A01,083982,Staff,22,0,30,8
1649816671927,COGS 118B,A01,083367,Staff,7,0,40,33
1649816677962,COGS 172,A01,083984,Provenzano; Emily Kara,24,0,30,6
1649816683990,COGS 177,A00,083368,Staff,9,0,30,21
1649816690013,COGS 186,A01,083986,Staff,26,0,40,14
1649816696036,COGS 187A,A01,083988,Boyle; Mary E. T.,43,0,60,17
1649816702062,CSE 8A,A50,084003,Miranda; Gregory Joseph,10,0,15,5
1649816708086,CSE 11,A01,084005,Miranda; Gregory Joseph,50,0,55,5
1649816714112,CSE 20,A01,084007,Staff,17,0,20,3
1649816720134,CSE 21,A01,084009,Staff,40,0,50,10
1649816726160,CSE 30,A01,083370,Cao; Yingjun,23,0,40,17
1649816732184,CSE 100,A01,083372,Cao; Yingjun,24,0,40,16
1649816738208,CSE 101,A01,084011,Staff,1,0,40,39
1649816744240,CSE 141,A01,083374,Eldon; John,3,0,75,72
1649816750263,CSE 141L,A01,083376,Eldon; John,1,0,75,74
1649816756288,CSE 175,A01,084013,Kumar; Rakesh,24,0,25,1
1649816762314,CSE 190,A00,092508,Staff,15,0,15,0
1649816768340,ECE 5,A01,084049,Morris; Karcher William,18,0,20,2
1649816774367,ECE 100,A01,084051,Baghdadchi; Saharnaz,17,0,20,3
1649816774367,ECE 100,A02,091916,Baghdadchi; Saharnaz,18,0,20,2
1649816780391,ECE 101,A01,084053,Baghdadchi; Saharnaz,26,0,37,11
1649816780391,ECE 101,A02,084054,Baghdadchi; Saharnaz,37,0,37,0
1649816786418,ECE 107,A01,083390,Staff,34,0,40,6
1649816792442,ECE 148,A01,084056,Silberman; Jack,8,0,12,4
1649816798474,ECE 180,A00,083391,Abi Samra; Nicholas Camill,27,0,30,3
1649816798474,ECE 180,B00,083392,Abi Samra; Nicholas Camill,26,0,30,4
1649816804501,MATH 10B,A01,084110,Staff,21,0,30,9
1649816804501,MATH 10B,A02,084111,Staff,29,0,30,1
1649816804501,MATH 10B,A03,084112,Staff,29,0,30,1
1649816810529,MATH 10C,A01,083443,Staff,22,0,30,8
1649816810529,MATH 10C,A02,083444,Staff,26,0,30,4
1649816810529,MATH 10C,B01,084114,Staff,26,0,30,4
1649816810529,MATH 10C,B02,084115,Staff,30,0,30,0
1649816816556,MATH 18,A01,084117,Harel; Guershon,28,0,30,2
1649816816556,MATH 18,A02,084119,Harel; Guershon,29,0,30,1
1649816816556,MATH 18,A03,084120,Harel; Guershon,30,0,30,0
1649816816556,MATH 18,A04,084121,Harel; Guershon,30,0,30,0
1649816822584,MATH 20B,A01,084124,Um; Ko Woon,33,0,35,2
1649816822584,MATH 20B,B01,084126,Um; Ko Woon,35,0,35,0
1649816828607,MATH 20C,A01,083446,Hammock; Frances H,27,0,30,3
1649816828607,MATH 20C,A02,083447,Hammock; Frances H,30,0,30,0
1649816828607,MATH 20C,A03,083448,Hammock; Frances H,30,0,30,0
1649816828607,MATH 20C,A04,083449,Hammock; Frances H,30,0,30,0
1649816828607,MATH 20C,B01,083451,Hammock; Frances H,30,0,30,0
1649816828607,MATH 20C,B02,083452,Hammock; Frances H,30,0,30,0
1649816828607,MATH 20C,B03,083453,Hammock; Frances H,30,0,30,0
1649816828607,MATH 20C,B04,083454,Hammock; Frances H,30,0,30,0
1649816834634,MATH 20D,A01,084128,Staff,29,0,30,1
1649816834634,MATH 20D,A02,084129,Staff,30,0,30,0
1649816834634,MATH 20D,A03,084130,Staff,29,0,30,1
1649816834634,MATH 20D,B01,084133,Staff,28,0,30,2
1649816834634,MATH 20D,B02,084134,Staff,30,0,30,0
1649816834634,MATH 20D,B03,084135,Staff,30,0,30,0
1649816840658,MATH 20E,A01,084138,Staff,29,0,30,1
1649816840658,MATH 20E,A02,084139,Staff,29,0,30,1
1649816840658,MATH 20E,A03,084140,Staff,29,0,30,1
1649816840658,MATH 20E,A04,084141,Staff,30,0,30,0
1649816846683,MATH 102,A01,084143,Harel; Guershon,24,0,30,6
1649816846683,MATH 102,A02,084144,Harel; Guershon,25,0,30,5
1649816852705,MATH 103B,A01,083456,Staff,4,0,30,26
1649816852705,MATH 103B,A02,083457,Staff,24,0,30,6
1649816858732,MATH 109,A01,084146,Salehi Golsefidy; Alireza,30,0,30,0
1649816858732,MATH 109,A02,084147,Salehi Golsefidy; Alireza,27,0,30,3
1649816864764,MATH 120A,A01,085445,Eggers; John Dietrich,31,0,35,4
1649816864764,MATH 120A,A02,085446,Eggers; John Dietrich,31,0,35,4
1649816870866,MATH 142B,A01,084149,Verstraete; Jacques Allan,14,0,30,16
1649816870866,MATH 142B,A02,084150,Verstraete; Jacques Allan,26,0,30,4
1649816876892,MATH 170A,A01,083459,Nie; Jiawang,15,0,30,15
1649816876892,MATH 170A,A02,083460,Nie; Jiawang,25,0,30,5
1649816876892,MATH 170A,A03,083461,Nie; Jiawang,26,0,30,4
1649816882915,MATH 193B,A01,083463,Staff,20,0,30,10
1649816882915,MATH 193B,A02,083464,Staff,21,0,30,9
1649816882915,MATH 193B,A03,083465,Staff,28,0,30,2
1649816888966,COGS 2,A01,083966,Boyle; Mary E. T.,27,0,30,3
1649816894989,COGS 9,A01,083968,Staff,57,0,60,3
1649816901013,COGS 14B,A01,083970,Staff,48,0,50,2
1649816907039,COGS 17,A01,092679,Staff,74,0,75,1
1649816913066,COGS 100,A01,083972,Staff,48,0,60,12
1649816925114,COGS 101C,A01,083976,Staff,26,0,30,4
1649816931140,COGS 102A,A01,083978,Johnson; Christine M.,26,0,30,4
1649816937164,COGS 107B,A01,083980,Staff,40,0,50,10
1649816943190,COGS 115,A01,083982,Staff,22,0,30,8
1649816949215,COGS 118B,A01,083367,Staff,6,0,40,34
1649816955242,COGS 172,A01,083984,Provenzano; Emily Kara,24,0,30,6
1649816961264,COGS 177,A00,083368,Staff,9,0,30,21
1649816967292,COGS 186,A01,083986,Staff,26,0,40,14
1649816973315,COGS 187A,A01,083988,Boyle; Mary E. T.,42,0,60,18
1649816979346,CSE 8A,A50,084003,Miranda; Gregory Joseph,10,0,15,5
1649816985371,CSE 11,A01,084005,Miranda; Gregory Joseph,50,0,55,5
1649816991394,CSE 20,A01,084007,Staff,17,0,20,3
1649816997424,CSE 21,A01,084009,Staff,40,0,50,10
1649817003458,CSE 30,A01,083370,Cao; Yingjun,23,0,40,17
1649817009485,CSE 100,A01,083372,Cao; Yingjun,24,0,40,16
1649817015509,CSE 101,A01,084011,Staff,1,0,40,39
1649817021533,CSE 141,A01,083374,Eldon; John,3,0,75,72
1649817027561,CSE 141L,A01,083376,Eldon; John,0,0,75,75
1649817033592,CSE 175,A01,084013,Kumar; Rakesh,24,0,25,1
1649817039613,CSE 190,A00,092508,Staff,15,0,15,0
1649817045646,ECE 5,A01,084049,Morris; Karcher William,18,0,20,2
1649817051668,ECE 100,A01,084051,Baghdadchi; Saharnaz,17,0,20,3
1649817051668,ECE 100,A02,091916,Baghdadchi; Saharnaz,18,0,20,2
1649817057693,ECE 101,A01,084053,Baghdadchi; Saharnaz,26,0,37,11
1649817057693,ECE 101,A02,084054,Baghdadchi; Saharnaz,37,0,37,0
1649817063733,ECE 107,A01,083390,Staff,34,0,40,6
1649817069762,ECE 148,A01,084056,Silberman; Jack,8,0,12,4
1649817075789,ECE 180,A00,083391,Abi Samra; Nicholas Camill,27,0,30,3
1649817075789,ECE 180,B00,083392,Abi Samra; Nicholas Camill,26,0,30,4
1649817081817,MATH 10B,A01,084110,Staff,21,0,30,9
1649817081817,MATH 10B,A02,084111,Staff,29,0,30,1
1649817081817,MATH 10B,A03,084112,Staff,29,0,30,1
1649817087840,MATH 10C,A01,083443,Staff,22,0,30,8
1649817087840,MATH 10C,A02,083444,Staff,26,0,30,4
1649817087840,MATH 10C,B01,084114,Staff,26,0,30,4
1649817087840,MATH 10C,B02,084115,Staff,30,0,30,0
1649817093863,MATH 18,A01,084117,Harel; Guershon,28,0,30,2
1649817093863,MATH 18,A02,084119,Harel; Guershon,29,0,30,1
1649817093863,MATH 18,A03,084120,Harel; Guershon,30,0,30,0
1649817093863,MATH 18,A04,084121,Harel; Guershon,30,0,30,0
1649817099887,MATH 20B,A01,084124,Um; Ko Woon,33,0,35,2
1649817099887,MATH 20B,B01,084126,Um; Ko Woon,35,0,35,0
1649817105910,MATH 20C,A01,083446,Hammock; Frances H,27,0,30,3
1649817105910,MATH 20C,A02,083447,Hammock; Frances H,30,0,30,0
1649817105910,MATH 20C,A03,083448,Hammock; Frances H,30,0,30,0
1649817105910,MATH 20C,A04,083449,Hammock; Frances H,30,0,30,0
1649817105910,MATH 20C,B01,083451,Hammock; Frances H,30,0,30,0
1649817105910,MATH 20C,B02,083452,Hammock; Frances H,30,0,30,0
1649817105910,MATH 20C,B03,083453,Hammock; Frances H,30,0,30,0
1649817105910,MATH 20C,B04,083454,Hammock; Frances H,30,0,30,0
1649817111935,MATH 20D,A01,084128,Staff,29,0,30,1
1649817111935,MATH 20D,A02,084129,Staff,30,0,30,0
1649817111935,MATH 20D,A03,084130,Staff,29,0,30,1
1649817111935,MATH 20D,B01,084133,Staff,28,0,30,2
1649817111935,MATH 20D,B02,084134,Staff,30,0,30,0
1649817111935,MATH 20D,B03,084135,Staff,30,0,30,0
1649817117963,MATH 20E,A01,084138,Staff,29,0,30,1
1649817117963,MATH 20E,A02,084139,Staff,29,0,30,1
1649817117963,MATH 20E,A03,084140,Staff,29,0,30,1
1649817117963,MATH 20E,A04,084141,Staff,30,0,30,0
1649817123986,MATH 102,A01,084143,Harel; Guershon,24,0,30,6
1649817123986,MATH 102,A02,084144,Harel; Guershon,25,0,30,5
1649817130013,MATH 103B,A01,083456,Staff,4,0,30,26
1649817130013,MATH 103B,A02,083457,Staff,24,0,30,6
1649817136047,MATH 109,A01,084146,Salehi Golsefidy; Alireza,30,0,30,0
1649817136047,MATH 109,A02,084147,Salehi Golsefidy; Alireza,27,0,30,3
1649817142071,MATH 120A,A01,085445,Eggers; John Dietrich,31,0,35,4
1649817142071,MATH 120A,A02,085446,Eggers; John Dietrich,31,0,35,4
1649817148108,MATH 142B,A01,084149,Verstraete; Jacques Allan,14,0,30,16
1649817148108,MATH 142B,A02,084150,Verstraete; Jacques Allan,26,0,30,4
1649817154132,MATH 170A,A01,083459,Nie; Jiawang,14,0,30,16
1649817154132,MATH 170A,A02,083460,Nie; Jiawang,25,0,30,5
1649817154132,MATH 170A,A03,083461,Nie; Jiawang,26,0,30,4
1649817160159,MATH 193B,A01,083463,Staff,20,0,30,10
1649817160159,MATH 193B,A02,083464,Staff,21,0,30,9
1649817160159,MATH 193B,A03,083465,Staff,28,0,30,2
1649817166211,COGS 2,A01,083966,Boyle; Mary E. T.,27,0,30,3
1649817172234,COGS 9,A01,083968,Staff,57,0,60,3
1649817178257,COGS 14B,A01,083970,Staff,48,0,50,2
1649817184285,COGS 17,A01,092679,Staff,74,0,75,1
1649817190311,COGS 100,A01,083972,Staff,48,0,60,12
1649817202375,COGS 101C,A01,083976,Staff,26,0,30,4
1649817208402,COGS 102A,A01,083978,Johnson; Christine M.,26,0,30,4
1649817214425,COGS 107B,A01,083980,Staff,40,0,50,10
1649817220449,COGS 115,A01,083982,Staff,22,0,30,8
1649817226473,COGS 118B,A01,083367,Staff,6,0,40,34
1649817232498,COGS 172,A01,083984,Provenzano; Emily Kara,24,0,30,6
1649817238525,COGS 177,A00,083368,Staff,9,0,30,21
1649817244548,COGS 186,A01,083986,Staff,26,0,40,14
1649817250571,COGS 187A,A01,083988,Boyle; Mary E. T.,42,0,60,18
1649817256599,CSE 8A,A50,084003,Miranda; Gregory Joseph,10,0,15,5
1649817262625,CSE 11,A01,084005,Miranda; Gregory Joseph,50,0,55,5
1649817268648,CSE 20,A01,084007,Staff,17,0,20,3
1649817274674,CSE 21,A01,084009,Staff,40,0,50,10
1649817280702,CSE 30,A01,083370,Cao; Yingjun,23,0,40,17
1649817286726,CSE 100,A01,083372,Cao; Yingjun,24,0,40,16
1649817292748,CSE 101,A01,084011,Staff,0,0,40,40
1649817298772,CSE 141,A01,083374,Eldon; John,2,0,75,73
1649817304799,CSE 141L,A01,083376,Eldon; John,0,0,75,75
1649817310823,CSE 175,A01,084013,Kumar; Rakesh,24,0,25,1
1649817316846,CSE 190,A00,092508,Staff,15,0,15,0
1649817322869,ECE 5,A01,084049,Morris; Karcher William,18,0,20,2
1649817328893,ECE 100,A01,084051,Baghdadchi; Saharnaz,17,0,20,3
1649817328893,ECE 100,A02,091916,Baghdadchi; Saharnaz,18,0,20,2
1649817334919,ECE 101,A01,084053,Baghdadchi; Saharnaz,26,0,37,11
1649817334919,ECE 101,A02,084054,Baghdadchi; Saharnaz,37,0,37,0
1649817340945,ECE 107,A01,083390,Staff,34,0,40,6
1649817346972,ECE 148,A01,084056,Silberman; Jack,8,0,12,4
1649817352996,ECE 180,A00,083391,Abi Samra; Nicholas Camill,27,0,30,3
1649817352996,ECE 180,B00,083392,Abi Samra; Nicholas Camill,26,0,30,4
1649817359020,MATH 10B,A01,084110,Staff,21,0,30,9
1649817359020,MATH 10B,A02,084111,Staff,29,0,30,1
1649817359020,MATH 10B,A03,084112,Staff,29,0,30,1
1649817365060,MATH 10C,A01,083443,Staff,22,0,30,8
1649817365060,MATH 10C,A02,083444,Staff,26,0,30,4
1649817365060,MATH 10C,B01,084114,Staff,26,0,30,4
1649817365060,MATH 10C,B02,084115,Staff,30,0,30,0
1649817371083,MATH 18,A01,084117,Harel; Guershon,28,0,30,2
1649817371083,MATH 18,A02,084119,Harel; Guershon,29,0,30,1
1649817371083,MATH 18,A03,084120,Harel; Guershon,30,0,30,0
1649817371083,MATH 18,A04,084121,Harel; Guershon,30,0,30,0
1649817377113,MATH 20B,A01,084124,Um; Ko Woon,33,0,35,2
1649817377113,MATH 20B,B01,084126,Um; Ko Woon,35,0,35,0
1649817383143,MATH 20C,A01,083446,Hammock; Frances H,27,0,30,3
1649817383143,MATH 20C,A02,083447,Hammock; Frances H,30,0,30,0
1649817383143,MATH 20C,A03,083448,Hammock; Frances H,30,0,30,0
1649817383143,MATH 20C,A04,083449,Hammock; Frances H,30,0,30,0
1649817383143,MATH 20C,B01,083451,Hammock; Frances H,30,0,30,0
1649817383143,MATH 20C,B02,083452,Hammock; Frances H,30,0,30,0
1649817383143,MATH 20C,B03,083453,Hammock; Frances H,30,0,30,0
1649817383143,MATH 20C,B04,083454,Hammock; Frances H,30,0,30,0
1649817389168,MATH 20D,A01,084128,Staff,29,0,30,1
1649817389168,MATH 20D,A02,084129,Staff,30,0,30,0
1649817389168,MATH 20D,A03,084130,Staff,29,0,30,1
1649817389168,MATH 20D,B01,084133,Staff,28,0,30,2
1649817389168,MATH 20D,B02,084134,Staff,30,0,30,0
1649817389168,MATH 20D,B03,084135,Staff,30,0,30,0
1649817395198,MATH 20E,A01,084138,Staff,29,0,30,1
1649817395198,MATH 20E,A02,084139,Staff,29,0,30,1
1649817395198,MATH 20E,A03,084140,Staff,29,0,30,1
1649817395198,MATH 20E,A04,084141,Staff,30,0,30,0
1649817401222,MATH 102,A01,084143,Harel; Guershon,24,0,30,6
1649817401222,MATH 102,A02,084144,Harel; Guershon,25,0,30,5
1649817407247,MATH 103B,A01,083456,Staff,4,0,30,26
1649817407247,MATH 103B,A02,083457,Staff,24,0,30,6
1649817413270,MATH 109,A01,084146,Salehi Golsefidy; Alireza,30,0,30,0
1649817413270,MATH 109,A02,084147,Salehi Golsefidy; Alireza,27,0,30,3
1649817419291,MATH 120A,A01,085445,Eggers; John Dietrich,31,0,35,4
1649817419291,MATH 120A,A02,085446,Eggers; John Dietrich,31,0,35,4
1649817425314,MATH 142B,A01,084149,Verstraete; Jacques Allan,14,0,30,16
1649817425314,MATH 142B,A02,084150,Verstraete; Jacques Allan,26,0,30,4
1649817431342,MATH 170A,A01,083459,Nie; Jiawang,14,0,30,16
1649817431342,MATH 170A,A02,083460,Nie; Jiawang,25,0,30,5
1649817431342,MATH 170A,A03,083461,Nie; Jiawang,26,0,30,4
1649817437370,MATH 193B,A01,083463,Staff,20,0,30,10
1649817437370,MATH 193B,A02,083464,Staff,21,0,30,9
1649817437370,MATH 193B,A03,083465,Staff,28,0,30,2
1649817443428,COGS 2,A01,083966,Boyle; Mary E. T.,27,0,30,3
1649817449450,COGS 9,A01,083968,Staff,57,0,60,3
1649817455474,COGS 14B,A01,083970,Staff,48,0,50,2
1649817461572,COGS 17,A01,092679,Staff,74,0,75,1
1649817467601,COGS 100,A01,083972,Staff,48,0,60,12
1649817479650,COGS 101C,A01,083976,Staff,26,0,30,4
1649817485677,COGS 102A,A01,083978,Johnson; Christine M.,26,0,30,4
1649817491699,COGS 107B,A01,083980,Staff,40,0,50,10
1649817497725,COGS 115,A01,083982,Staff,22,0,30,8
1649817503749,COGS 118B,A01,083367,Staff,6,0,40,34
1649817509773,COGS 172,A01,083984,Provenzano; Emily Kara,24,0,30,6
1649817515798,COGS 177,A00,083368,Staff,9,0,30,21
1649817521821,COGS 186,A01,083986,Staff,26,0,40,14
1649817527844,COGS 187A,A01,083988,Boyle; Mary E. T.,42,0,60,18
1649817533870,CSE 8A,A50,084003,Miranda; Gregory Joseph,10,0,15,5
1649817539898,CSE 11,A01,084005,Miranda; Gregory Joseph,50,0,55,5
1649817545928,CSE 20,A01,084007,Staff,17,0,20,3
1649817551951,CSE 21,A01,084009,Staff,40,0,50,10
1649817557990,CSE 30,A01,083370,Cao; Yingjun,23,0,40,17
1649817564015,CSE 100,A01,083372,Cao; Yingjun,24,0,40,16
1649817570038,CSE 101,A01,084011,Staff,0,0,40,40
1649817576062,CSE 141,A01,083374,Eldon; John,2,0,75,73
1649817582086,CSE 141L,A01,083376,Eldon; John,0,0,75,75
1649817588109,CSE 175,A01,084013,Kumar; Rakesh,24,0,25,1
1649817594133,CSE 190,A00,092508,Staff,15,0,15,0
1649817600157,ECE 5,A01,084049,Morris; Karcher William,18,0,20,2
1649817606190,ECE 100,A01,084051,Baghdadchi; Saharnaz,17,0,20,3
1649817606190,ECE 100,A02,091916,Baghdadchi; Saharnaz,18,0,20,2
1649817612221,ECE 101,A01,084053,Baghdadchi; Saharnaz,26,0,37,11
1649817612221,ECE 101,A02,084054,Baghdadchi; Saharnaz,37,0,37,0
1649817618249,ECE 107,A01,083390,Staff,34,0,40,6
1649817624277,ECE 148,A01,084056,Silberman; Jack,8,0,12,4
1649817630304,ECE 180,A00,083391,Abi Samra; Nicholas Camill,27,0,30,3
1649817630304,ECE 180,B00,083392,Abi Samra; Nicholas Camill,26,0,30,4
1649817636328,MATH 10B,A01,084110,Staff,21,0,30,9
1649817636328,MATH 10B,A02,084111,Staff,29,0,30,1
1649817636328,MATH 10B,A03,084112,Staff,29,0,30,1
1649817642353,MATH 10C,A01,083443,Staff,21,0,30,9
1649817642353,MATH 10C,A02,083444,Staff,26,0,30,4
1649817642353,MATH 10C,B01,084114,Staff,26,0,30,4
1649817642353,MATH 10C,B02,084115,Staff,30,0,30,0
1649817648388,MATH 18,A01,084117,Harel; Guershon,28,0,30,2
1649817648388,MATH 18,A02,084119,Harel; Guershon,29,0,30,1
1649817648388,MATH 18,A03,084120,Harel; Guershon,30,0,30,0
1649817648388,MATH 18,A04,084121,Harel; Guershon,30,0,30,0
1649817654417,MATH 20B,A01,084124,Um; Ko Woon,33,0,35,2
1649817654417,MATH 20B,B01,084126,Um; Ko Woon,35,0,35,0
1649817660443,MATH 20C,A01,083446,Hammock; Frances H,27,0,30,3
1649817660443,MATH 20C,A02,083447,Hammock; Frances H,30,0,30,0
1649817660443,MATH 20C,A03,083448,Hammock; Frances H,30,0,30,0
1649817660443,MATH 20C,A04,083449,Hammock; Frances H,30,0,30,0
1649817660443,MATH 20C,B01,083451,Hammock; Frances H,30,0,30,0
1649817660443,MATH 20C,B02,083452,Hammock; Frances H,30,0,30,0
1649817660443,MATH 20C,B03,083453,Hammock; Frances H,30,0,30,0
1649817660443,MATH 20C,B04,083454,Hammock; Frances H,30,0,30,0
1649817666466,MATH 20D,A01,084128,Staff,29,0,30,1
1649817666466,MATH 20D,A02,084129,Staff,30,0,30,0
1649817666466,MATH 20D,A03,084130,Staff,29,0,30,1
1649817666466,MATH 20D,B01,084133,Staff,28,0,30,2
1649817666466,MATH 20D,B02,084134,Staff,30,0,30,0
1649817666466,MATH 20D,B03,084135,Staff,30,0,30,0
1649817672493,MATH 20E,A01,084138,Staff,29,0,30,1
1649817672493,MATH 20E,A02,084139,Staff,29,0,30,1
1649817672493,MATH 20E,A03,084140,Staff,29,0,30,1
1649817672493,MATH 20E,A04,084141,Staff,30,0,30,0
1649817678525,MATH 102,A01,084143,Harel; Guershon,24,0,30,6
1649817678525,MATH 102,A02,084144,Harel; Guershon,25,0,30,5
1649817684548,MATH 103B,A01,083456,Staff,4,0,30,26
1649817684548,MATH 103B,A02,083457,Staff,24,0,30,6
1649817690576,MATH 109,A01,084146,Salehi Golsefidy; Alireza,30,0,30,0
1649817690576,MATH 109,A02,084147,Salehi Golsefidy; Alireza,27,0,30,3
1649817696603,MATH 120A,A01,085445,Eggers; John Dietrich,31,0,35,4
1649817696603,MATH 120A,A02,085446,Eggers; John Dietrich,31,0,35,4
1649817702626,MATH 142B,A01,084149,Verstraete; Jacques Allan,14,0,30,16
1649817702626,MATH 142B,A02,084150,Verstraete; Jacques Allan,26,0,30,4
1649817708647,MATH 170A,A01,083459,Nie; Jiawang,14,0,30,16
1649817708647,MATH 170A,A02,083460,Nie; Jiawang,25,0,30,5
1649817708647,MATH 170A,A03,083461,Nie; Jiawang,26,0,30,4
1649817714670,MATH 193B,A01,083463,Staff,20,0,30,10
1649817714670,MATH 193B,A02,083464,Staff,21,0,30,9
1649817714670,MATH 193B,A03,083465,Staff,28,0,30,2
1649817720732,COGS 2,A01,083966,Boyle; Mary E. T.,27,0,30,3
1649817726759,COGS 9,A01,083968,Staff,57,0,60,3
1649817732782,COGS 14B,A01,083970,Staff,48,0,50,2
1649817738804,COGS 17,A01,092679,Staff,74,0,75,1
1649817744831,COGS 100,A01,083972,Staff,48,0,60,12
1649817756883,COGS 101C,A01,083976,Staff,26,0,30,4
1649817762909,COGS 102A,A01,083978,Johnson; Christine M.,26,0,30,4
1649817768933,COGS 107B,A01,083980,Staff,40,0,50,10
1649817774958,COGS 115,A01,083982,Staff,22,0,30,8
1649817780992,COGS 118B,A01,083367,Staff,6,0,40,34
1649817787019,COGS 172,A01,083984,Provenzano; Emily Kara,24,0,30,6
1649817793047,COGS 177,A00,083368,Staff,9,0,30,21
1649817799075,COGS 186,A01,083986,Staff,26,0,40,14
1649817805098,COGS 187A,A01,083988,Boyle; Mary E. T.,41,0,60,19
1649817811128,CSE 8A,A50,084003,Miranda; Gregory Joseph,10,0,15,5
1649817817152,CSE 11,A01,084005,Miranda; Gregory Joseph,49,0,55,6
1649817823185,CSE 20,A01,084007,Staff,17,0,20,3
1649817829208,CSE 21,A01,084009,Staff,39,0,50,11
1649817835234,CSE 30,A01,083370,Cao; Yingjun,23,0,40,17
1649817841260,CSE 100,A01,083372,Cao; Yingjun,24,0,40,16
1649817847285,CSE 101,A01,084011,Staff,0,2,40,40
1649817853312,CSE 141,A01,083374,Eldon; John,0,0,75,75
1649817859340,CSE 141L,A01,083376,Eldon; John,0,2,75,75
1649817865365,CSE 175,A01,084013,Kumar; Rakesh,24,0,25,1
1649817871391,CSE 190,A00,092508,Staff,15,0,15,0
1649817877417,ECE 5,A01,084049,Morris; Karcher William,18,0,20,2
1649817883452,ECE 100,A01,084051,Baghdadchi; Saharnaz,17,0,20,3
1649817883452,ECE 100,A02,091916,Baghdadchi; Saharnaz,18,0,20,2
1649817889479,ECE 101,A01,084053,Baghdadchi; Saharnaz,26,0,37,11
1649817889479,ECE 101,A02,084054,Baghdadchi; Saharnaz,37,0,37,0
1649817895505,ECE 107,A01,083390,Staff,34,0,40,6
1649817901538,ECE 148,A01,084056,Silberman; Jack,8,0,12,4
1649817907565,ECE 180,A00,083391,Abi Samra; Nicholas Camill,27,0,30,3
1649817907565,ECE 180,B00,083392,Abi Samra; Nicholas Camill,26,0,30,4
1649817913602,MATH 10B,A01,084110,Staff,21,0,30,9
1649817913602,MATH 10B,A02,084111,Staff,29,0,30,1
1649817913602,MATH 10B,A03,084112,Staff,29,0,30,1
1649817919626,MATH 10C,A01,083443,Staff,21,0,30,9
1649817919626,MATH 10C,A02,083444,Staff,26,0,30,4
1649817919626,MATH 10C,B01,084114,Staff,26,0,30,4
1649817919626,MATH 10C,B02,084115,Staff,30,0,30,0
1649817925655,MATH 18,A01,084117,Harel; Guershon,28,0,30,2
1649817925655,MATH 18,A02,084119,Harel; Guershon,29,0,30,1
1649817925655,MATH 18,A03,084120,Harel; Guershon,30,0,30,0
1649817925655,MATH 18,A04,084121,Harel; Guershon,30,0,30,0
1649817931687,MATH 20B,A01,084124,Um; Ko Woon,33,0,35,2
1649817931687,MATH 20B,B01,084126,Um; Ko Woon,35,0,35,0
1649817937714,MATH 20C,A01,083446,Hammock; Frances H,27,0,30,3
1649817937714,MATH 20C,A02,083447,Hammock; Frances H,30,0,30,0
1649817937714,MATH 20C,A03,083448,Hammock; Frances H,30,0,30,0
1649817937714,MATH 20C,A04,083449,Hammock; Frances H,30,0,30,0
1649817937714,MATH 20C,B01,083451,Hammock; Frances H,30,0,30,0
1649817937714,MATH 20C,B02,083452,Hammock; Frances H,30,0,30,0
1649817937714,MATH 20C,B03,083453,Hammock; Frances H,30,0,30,0
1649817937714,MATH 20C,B04,083454,Hammock; Frances H,30,0,30,0
1649817943744,MATH 20D,A01,084128,Staff,29,0,30,1
1649817943744,MATH 20D,A02,084129,Staff,30,0,30,0
1649817943744,MATH 20D,A03,084130,Staff,29,0,30,1
1649817943744,MATH 20D,B01,084133,Staff,28,0,30,2
1649817943744,MATH 20D,B02,084134,Staff,30,0,30,0
1649817943744,MATH 20D,B03,084135,Staff,30,0,30,0
1649817949776,MATH 20E,A01,084138,Staff,29,0,30,1
1649817949776,MATH 20E,A02,084139,Staff,29,0,30,1
1649817949776,MATH 20E,A03,084140,Staff,29,0,30,1
1649817949776,MATH 20E,A04,084141,Staff,30,0,30,0
1649817955803,MATH 102,A01,084143,Harel; Guershon,24,0,30,6
1649817955803,MATH 102,A02,084144,Harel; Guershon,25,0,30,5
1649817961827,MATH 103B,A01,083456,Staff,2,0,30,28
1649817961827,MATH 103B,A02,083457,Staff,24,0,30,6
1649817967858,MATH 109,A01,084146,Salehi Golsefidy; Alireza,30,0,30,0
1649817967858,MATH 109,A02,084147,Salehi Golsefidy; Alireza,27,0,30,3
1649817973888,MATH 120A,A01,085445,Eggers; John Dietrich,31,0,35,4
1649817973888,MATH 120A,A02,085446,Eggers; John Dietrich,31,0,35,4
1649817979916,MATH 142B,A01,084149,Verstraete; Jacques Allan,14,0,30,16
1649817979916,MATH 142B,A02,084150,Verstraete; Jacques Allan,26,0,30,4
1649817985944,MATH 170A,A01,083459,Nie; Jiawang,13,0,30,17
1649817985944,MATH 170A,A02,083460,Nie; Jiawang,25,0,30,5
1649817985944,MATH 170A,A03,083461,Nie; Jiawang,26,0,30,4
1649817991977,MATH 193B,A01,083463,Staff,19,0,30,11
1649817991977,MATH 193B,A02,083464,Staff,21,0,30,9
1649817991977,MATH 193B,A03,083465,Staff,28,0,30,2
1649817998046,COGS 2,A01,083966,Boyle; Mary E. T.,27,0,30,3
1649818004069,COGS 9,A01,083968,Staff,57,0,60,3
1649818010092,COGS 14B,A01,083970,Staff,48,0,50,2
1649818016114,COGS 17,A01,092679,Staff,74,0,75,1
1649818022136,COGS 100,A01,083972,Staff,47,0,60,13
1649818034191,COGS 101C,A01,083976,Staff,25,0,30,5
1649818040217,COGS 102A,A01,083978,Johnson; Christine M.,26,0,30,4
1649818046243,COGS 107B,A01,083980,Staff,40,0,50,10
1649818052266,COGS 115,A01,083982,Staff,22,0,30,8
1649818058369,COGS 118B,A01,083367,Staff,6,0,40,34
1649818064398,COGS 172,A01,083984,Provenzano; Emily Kara,23,0,30,7
1649818070428,COGS 177,A00,083368,Staff,9,0,30,21
1649818076459,COGS 186,A01,083986,Staff,26,0,40,14
1649818082483,COGS 187A,A01,083988,Boyle; Mary E. T.,41,0,60,19
1649818088506,CSE 8A,A50,084003,Miranda; Gregory Joseph,10,0,15,5
1649818094530,CSE 11,A01,084005,Miranda; Gregory Joseph,49,0,55,6
1649818100553,CSE 20,A01,084007,Staff,17,0,20,3
1649818106576,CSE 21,A01,084009,Staff,39,0,50,11
1649818112600,CSE 30,A01,083370,Cao; Yingjun,23,0,40,17
1649818118621,CSE 100,A01,083372,Cao; Yingjun,23,0,40,17
1649818124644,CSE 101,A01,084011,Staff,0,2,40,40
1649818130671,CSE 141,A01,083374,Eldon; John,0,1,75,75
1649818136695,CSE 141L,A01,083376,Eldon; John,0,3,75,75
1649818142726,CSE 175,A01,084013,Kumar; Rakesh,24,0,25,1
1649818148758,CSE 190,A00,092508,Staff,15,0,15,0
1649818154785,ECE 5,A01,084049,Morris; Karcher William,17,0,20,3
1649818160817,ECE 100,A01,084051,Baghdadchi; Saharnaz,17,0,20,3
1649818160817,ECE 100,A02,091916,Baghdadchi; Saharnaz,18,0,20,2
1649818166840,ECE 101,A01,084053,Baghdadchi; Saharnaz,26,0,37,11
1649818166840,ECE 101,A02,084054,Baghdadchi; Saharnaz,37,0,37,0
1649818172882,ECE 107,A01,083390,Staff,34,0,40,6
1649818178910,ECE 148,A01,084056,Silberman; Jack,8,0,12,4
1649818184937,ECE 180,A00,083391,Abi Samra; Nicholas Camill,27,0,30,3
1649818184937,ECE 180,B00,083392,Abi Samra; Nicholas Camill,26,0,30,4
1649818190960,MATH 10B,A01,084110,Staff,21,0,30,9
1649818190960,MATH 10B,A02,084111,Staff,29,0,30,1
1649818190960,MATH 10B,A03,084112,Staff,29,0,30,1
1649818196983,MATH 10C,A01,083443,Staff,21,0,30,9
1649818196983,MATH 10C,A02,083444,Staff,26,0,30,4
1649818196983,MATH 10C,B01,084114,Staff,26,0,30,4
1649818196983,MATH 10C,B02,084115,Staff,30,0,30,0
1649818203007,MATH 18,A01,084117,Harel; Guershon,28,0,30,2
1649818203007,MATH 18,A02,084119,Harel; Guershon,29,0,30,1
1649818203007,MATH 18,A03,084120,Harel; Guershon,30,0,30,0
1649818203007,MATH 18,A04,084121,Harel; Guershon,30,0,30,0
1649818209032,MATH 20B,A01,084124,Um; Ko Woon,33,0,35,2
1649818209032,MATH 20B,B01,084126,Um; Ko Woon,35,0,35,0
1649818215058,MATH 20C,A01,083446,Hammock; Frances H,27,0,30,3
1649818215058,MATH 20C,A02,083447,Hammock; Frances H,30,0,30,0
1649818215058,MATH 20C,A03,083448,Hammock; Frances H,30,0,30,0
1649818215058,MATH 20C,A04,083449,Hammock; Frances H,30,0,30,0
1649818215058,MATH 20C,B01,083451,Hammock; Frances H,29,0,30,1
1649818215058,MATH 20C,B02,083452,Hammock; Frances H,30,0,30,0
1649818215058,MATH 20C,B03,083453,Hammock; Frances H,30,0,30,0
1649818215058,MATH 20C,B04,083454,Hammock; Frances H,30,0,30,0
1649818221085,MATH 20D,A01,084128,Staff,29,0,30,1
1649818221085,MATH 20D,A02,084129,Staff,30,0,30,0
1649818221085,MATH 20D,A03,084130,Staff,29,0,30,1
1649818221085,MATH 20D,B01,084133,Staff,28,0,30,2
1649818221085,MATH 20D,B02,084134,Staff,30,0,30,0
1649818221085,MATH 20D,B03,084135,Staff,30,0,30,0
1649818227117,MATH 20E,A01,084138,Staff,29,0,30,1
1649818227117,MATH 20E,A02,084139,Staff,29,0,30,1
1649818227117,MATH 20E,A03,084140,Staff,29,0,30,1
1649818227117,MATH 20E,A04,084141,Staff,30,0,30,0
1649818233141,MATH 102,A01,084143,Harel; Guershon,24,0,30,6
1649818233141,MATH 102,A02,084144,Harel; Guershon,25,0,30,5
1649818239167,MATH 103B,A01,083456,Staff,2,0,30,28
1649818239167,MATH 103B,A02,083457,Staff,24,0,30,6
1649818245192,MATH 109,A01,084146,Salehi Golsefidy; Alireza,30,0,30,0
1649818245192,MATH 109,A02,084147,Salehi Golsefidy; Alireza,27,0,30,3
1649818251214,MATH 120A,A01,085445,Eggers; John Dietrich,31,0,35,4
1649818251214,MATH 120A,A02,085446,Eggers; John Dietrich,31,0,35,4
1649818257241,MATH 142B,A01,084149,Verstraete; Jacques Allan,13,0,30,17
1649818257241,MATH 142B,A02,084150,Verstraete; Jacques Allan,26,0,30,4
1649818263267,MATH 170A,A01,083459,Nie; Jiawang,13,0,30,17
1649818263267,MATH 170A,A02,083460,Nie; Jiawang,25,0,30,5
1649818263267,MATH 170A,A03,083461,Nie; Jiawang,26,0,30,4
1649818269296,MATH 193B,A01,083463,Staff,19,0,30,11
1649818269296,MATH 193B,A02,083464,Staff,21,0,30,9
1649818269296,MATH 193B,A03,083465,Staff,28,0,30,2
1649818275357,COGS 2,A01,083966,Boyle; Mary E. T.,27,0,30,3
1649818281383,COGS 9,A01,083968,Staff,57,0,60,3
1649818287407,COGS 14B,A01,083970,Staff,48,0,50,2
1649818293430,COGS 17,A01,092679,Staff,74,0,75,1
1649818299454,COGS 100,A01,083972,Staff,47,0,60,13
1649818311509,COGS 101C,A01,083976,Staff,25,0,30,5
1649818317537,COGS 102A,A01,083978,Johnson; Christine M.,26,0,30,4
1649818323560,COGS 107B,A01,083980,Staff,40,0,50,10
1649818329581,COGS 115,A01,083982,Staff,22,0,30,8
1649818335605,COGS 118B,A01,083367,Staff,6,0,40,34
1649818341632,COGS 172,A01,083984,Provenzano; Emily Kara,23,0,30,7
1649818347659,COGS 177,A00,083368,Staff,8,0,30,22
1649818353680,COGS 186,A01,083986,Staff,26,0,40,14
1649818359704,COGS 187A,A01,083988,Boyle; Mary E. T.,41,0,60,19
1649818365732,CSE 8A,A50,084003,Miranda; Gregory Joseph,10,0,15,5
1649818371760,CSE 11,A01,084005,Miranda; Gregory Joseph,49,0,55,6
1649818377787,CSE 20,A01,084007,Staff,17,0,20,3
1649818383811,CSE 21,A01,084009,Staff,39,0,50,11
1649818389835,CSE 30,A01,083370,Cao; Yingjun,23,0,40,17
1649818395859,CSE 100,A01,083372,Cao; Yingjun,22,0,40,18
1649818401888,CSE 101,A01,084011,Staff,0,2,40,40
1649818407914,CSE 141,A01,083374,Eldon; John,0,1,75,75
1649818413938,CSE 141L,A01,083376,Eldon; John,0,3,75,75
1649818419962,CSE 175,A01,084013,Kumar; Rakesh,24,0,25,1
1649818425989,CSE 190,A00,092508,Staff,15,0,15,0
1649818432018,ECE 5,A01,084049,Morris; Karcher William,17,0,20,3
1649818438039,ECE 100,A01,084051,Baghdadchi; Saharnaz,17,0,20,3
1649818438039,ECE 100,A02,091916,Baghdadchi; Saharnaz,18,0,20,2
1649818444070,ECE 101,A01,084053,Baghdadchi; Saharnaz,26,0,37,11
1649818444070,ECE 101,A02,084054,Baghdadchi; Saharnaz,37,0,37,0
1649818450108,ECE 107,A01,083390,Staff,34,0,40,6
1649818456130,ECE 148,A01,084056,Silberman; Jack,8,0,12,4
1649818462158,ECE 180,A00,083391,Abi Samra; Nicholas Camill,27,0,30,3
1649818462158,ECE 180,B00,083392,Abi Samra; Nicholas Camill,26,0,30,4
1649818468185,MATH 10B,A01,084110,Staff,21,0,30,9
1649818468185,MATH 10B,A02,084111,Staff,29,0,30,1
1649818468185,MATH 10B,A03,084112,Staff,29,0,30,1
1649818474209,MATH 10C,A01,083443,Staff,21,0,30,9
1649818474209,MATH 10C,A02,083444,Staff,26,0,30,4
1649818474209,MATH 10C,B01,084114,Staff,26,0,30,4
1649818474209,MATH 10C,B02,084115,Staff,30,0,30,0
1649818480235,MATH 18,A01,084117,Harel; Guershon,28,0,30,2
1649818480235,MATH 18,A02,084119,Harel; Guershon,29,0,30,1
1649818480235,MATH 18,A03,084120,Harel; Guershon,30,0,30,0
1649818480235,MATH 18,A04,084121,Harel; Guershon,30,0,30,0
1649818486263,MATH 20B,A01,084124,Um; Ko Woon,33,0,35,2
1649818486263,MATH 20B,B01,084126,Um; Ko Woon,35,0,35,0
1649818492293,MATH 20C,A01,083446,Hammock; Frances H,27,0,30,3
1649818492293,MATH 20C,A02,083447,Hammock; Frances H,30,0,30,0
1649818492293,MATH 20C,A03,083448,Hammock; Frances H,30,0,30,0
1649818492293,MATH 20C,A04,083449,Hammock; Frances H,30,0,30,0
1649818492293,MATH 20C,B01,083451,Hammock; Frances H,29,0,30,1
1649818492293,MATH 20C,B02,083452,Hammock; Frances H,30,0,30,0
1649818492293,MATH 20C,B03,083453,Hammock; Frances H,30,0,30,0
1649818492293,MATH 20C,B04,083454,Hammock; Frances H,30,0,30,0
1649818498317,MATH 20D,A01,084128,Staff,29,0,30,1
1649818498317,MATH 20D,A02,084129,Staff,30,0,30,0
1649818498317,MATH 20D,A03,084130,Staff,29,0,30,1
1649818498317,MATH 20D,B01,084133,Staff,28,0,30,2
1649818498317,MATH 20D,B02,084134,Staff,30,0,30,0
1649818498317,MATH 20D,B03,084135,Staff,30,0,30,0
1649818504347,MATH 20E,A01,084138,Staff,29,0,30,1
1649818504347,MATH 20E,A02,084139,Staff,29,0,30,1
1649818504347,MATH 20E,A03,084140,Staff,29,0,30,1
1649818504347,MATH 20E,A04,084141,Staff,30,0,30,0
1649818510374,MATH 102,A01,084143,Harel; Guershon,24,0,30,6
1649818510374,MATH 102,A02,084144,Harel; Guershon,25,0,30,5
1649818516397,MATH 103B,A01,083456,Staff,2,0,30,28
1649818516397,MATH 103B,A02,083457,Staff,24,0,30,6
1649818522426,MATH 109,A01,084146,Salehi Golsefidy; Alireza,30,0,30,0
1649818522426,MATH 109,A02,084147,Salehi Golsefidy; Alireza,27,0,30,3
1649818528454,MATH 120A,A01,085445,Eggers; John Dietrich,31,0,35,4
1649818528454,MATH 120A,A02,085446,Eggers; John Dietrich,31,0,35,4
1649818534478,MATH 142B,A01,084149,Verstraete; Jacques Allan,12,0,30,18
1649818534478,MATH 142B,A02,084150,Verstraete; Jacques Allan,26,0,30,4
1649818540503,MATH 170A,A01,083459,Nie; Jiawang,13,0,30,17
1649818540503,MATH 170A,A02,083460,Nie; Jiawang,25,0,30,5
1649818540503,MATH 170A,A03,083461,Nie; Jiawang,26,0,30,4
1649818546533,MATH 193B,A01,083463,Staff,19,0,30,11
1649818546533,MATH 193B,A02,083464,Staff,20,0,30,10
1649818546533,MATH 193B,A03,083465,Staff,27,0,30,3
1649818552596,COGS 2,A01,083966,Boyle; Mary E. T.,27,0,30,3
1649818558620,COGS 9,A01,083968,Staff,57,0,60,3
1649818564644,COGS 14B,A01,083970,Staff,48,0,50,2
1649818570668,COGS 17,A01,092679,Staff,74,0,75,1
1649818576691,COGS 100,A01,083972,Staff,47,0,60,13
1649818588744,COGS 101C,A01,083976,Staff,25,0,30,5
1649818594768,COGS 102A,A01,083978,Johnson; Christine M.,26,0,30,4
1649818600797,COGS 107B,A01,083980,Staff,40,0,50,10
1649818606820,COGS 115,A01,083982,Staff,22,0,30,8
1649818612843,COGS 118B,A01,083367,Staff,6,0,40,34
1649818618874,COGS 172,A01,083984,Provenzano; Emily Kara,23,0,30,7
1649818624898,COGS 177,A00,083368,Staff,8,0,30,22
1649818630928,COGS 186,A01,083986,Staff,26,0,40,14
1649818636953,COGS 187A,A01,083988,Boyle; Mary E. T.,41,0,60,19
1649818642980,CSE 8A,A50,084003,Miranda; Gregory Joseph,10,0,15,5
1649818649004,CSE 11,A01,084005,Miranda; Gregory Joseph,49,0,55,6
1649818655100,CSE 20,A01,084007,Staff,17,0,20,3
1649818661123,CSE 21,A01,084009,Staff,38,0,50,12
1649818667146,CSE 30,A01,083370,Cao; Yingjun,23,0,40,17
1649818673172,CSE 100,A01,083372,Cao; Yingjun,22,0,40,18
1649818679208,CSE 101,A01,084011,Staff,0,2,40,40
1649818685235,CSE 141,A01,083374,Eldon; John,0,1,75,75
1649818691257,CSE 141L,A01,083376,Eldon; John,0,3,75,75
1649818697280,CSE 175,A01,084013,Kumar; Rakesh,24,0,25,1
1649818703304,CSE 190,A00,092508,Staff,15,0,15,0
1649818709330,ECE 5,A01,084049,Morris; Karcher William,17,0,20,3
1649818715362,ECE 100,A01,084051,Baghdadchi; Saharnaz,17,0,20,3
1649818715362,ECE 100,A02,091916,Baghdadchi; Saharnaz,18,0,20,2
1649818721389,ECE 101,A01,084053,Baghdadchi; Saharnaz,26,0,37,11
1649818721389,ECE 101,A02,084054,Baghdadchi; Saharnaz,37,0,37,0
1649818727414,ECE 107,A01,083390,Staff,34,0,40,6
1649818733453,ECE 148,A01,084056,Silberman; Jack,8,0,12,4
1649818739480,ECE 180,A00,083391,Abi Samra; Nicholas Camill,27,0,30,3
1649818739480,ECE 180,B00,083392,Abi Samra; Nicholas Camill,26,0,30,4
1649818745505,MATH 10B,A01,084110,Staff,21,0,30,9
1649818745505,MATH 10B,A02,084111,Staff,29,0,30,1
1649818745505,MATH 10B,A03,084112,Staff,29,0,30,1
1649818751532,MATH 10C,A01,083443,Staff,21,0,30,9
1649818751532,MATH 10C,A02,083444,Staff,26,0,30,4
1649818751532,MATH 10C,B01,084114,Staff,26,0,30,4
1649818751532,MATH 10C,B02,084115,Staff,30,0,30,0
1649818757559,MATH 18,A01,084117,Harel; Guershon,28,0,30,2
1649818757559,MATH 18,A02,084119,Harel; Guershon,29,0,30,1
1649818757559,MATH 18,A03,084120,Harel; Guershon,30,0,30,0
1649818757559,MATH 18,A04,084121,Harel; Guershon,30,0,30,0
1649818763587,MATH 20B,A01,084124,Um; Ko Woon,33,0,35,2
1649818763587,MATH 20B,B01,084126,Um; Ko Woon,35,0,35,0
1649818769615,MATH 20C,A01,083446,Hammock; Frances H,27,0,30,3
1649818769615,MATH 20C,A02,083447,Hammock; Frances H,30,0,30,0
1649818769615,MATH 20C,A03,083448,Hammock; Frances H,30,0,30,0
1649818769615,MATH 20C,A04,083449,Hammock; Frances H,30,0,30,0
1649818769615,MATH 20C,B01,083451,Hammock; Frances H,29,0,30,1
1649818769615,MATH 20C,B02,083452,Hammock; Frances H,30,0,30,0
1649818769615,MATH 20C,B03,083453,Hammock; Frances H,30,0,30,0
1649818769615,MATH 20C,B04,083454,Hammock; Frances H,30,0,30,0
1649818775639,MATH 20D,A01,084128,Staff,29,0,30,1
1649818775639,MATH 20D,A02,084129,Staff,30,0,30,0
1649818775639,MATH 20D,A03,084130,Staff,29,0,30,1
1649818775639,MATH 20D,B01,084133,Staff,28,0,30,2
1649818775639,MATH 20D,B02,084134,Staff,30,0,30,0
1649818775639,MATH 20D,B03,084135,Staff,30,0,30,0
1649818781665,MATH 20E,A01,084138,Staff,29,0,30,1
1649818781665,MATH 20E,A02,084139,Staff,29,0,30,1
1649818781665,MATH 20E,A03,084140,Staff,29,0,30,1
1649818781665,MATH 20E,A04,084141,Staff,30,0,30,0
1649818787691,MATH 102,A01,084143,Harel; Guershon,24,0,30,6
1649818787691,MATH 102,A02,084144,Harel; Guershon,25,0,30,5
1649818793721,MATH 103B,A01,083456,Staff,1,0,30,29
1649818793721,MATH 103B,A02,083457,Staff,23,0,30,7
1649818799746,MATH 109,A01,084146,Salehi Golsefidy; Alireza,30,0,30,0
1649818799746,MATH 109,A02,084147,Salehi Golsefidy; Alireza,27,0,30,3
1649818805774,MATH 120A,A01,085445,Eggers; John Dietrich,31,0,35,4
1649818805774,MATH 120A,A02,085446,Eggers; John Dietrich,31,0,35,4
1649818811800,MATH 142B,A01,084149,Verstraete; Jacques Allan,12,0,30,18
1649818811800,MATH 142B,A02,084150,Verstraete; Jacques Allan,26,0,30,4
1649818817825,MATH 170A,A01,083459,Nie; Jiawang,12,0,30,18
1649818817825,MATH 170A,A02,083460,Nie; Jiawang,25,0,30,5
1649818817825,MATH 170A,A03,083461,Nie; Jiawang,26,0,30,4
1649818823848,MATH 193B,A01,083463,Staff,19,0,30,11
1649818823848,MATH 193B,A02,083464,Staff,20,0,30,10
1649818823848,MATH 193B,A03,083465,Staff,27,0,30,3
1649818829912,COGS 2,A01,083966,Boyle; Mary E. T.,27,0,30,3
1649818835936,COGS 9,A01,083968,Staff,57,0,60,3
1649818841960,COGS 14B,A01,083970,Staff,48,0,50,2
1649818847987,COGS 17,A01,092679,Staff,74,0,75,1
1649818854011,COGS 100,A01,083972,Staff,47,0,60,13
1649818866097,COGS 101C,A01,083976,Staff,25,0,30,5
1649818872124,COGS 102A,A01,083978,Johnson; Christine M.,26,0,30,4
1649818878150,COGS 107B,A01,083980,Staff,40,0,50,10
1649818884174,COGS 115,A01,083982,Staff,22,0,30,8
1649818890198,COGS 118B,A01,083367,Staff,6,0,40,34
1649818896221,COGS 172,A01,083984,Provenzano; Emily Kara,23,0,30,7
1649818902247,COGS 177,A00,083368,Staff,8,0,30,22
1649818908271,COGS 186,A01,083986,Staff,26,0,40,14
1649818914296,COGS 187A,A01,083988,Boyle; Mary E. T.,41,0,60,19
1649818920319,CSE 8A,A50,084003,Miranda; Gregory Joseph,10,0,15,5
1649818926350,CSE 11,A01,084005,Miranda; Gregory Joseph,49,0,55,6
1649818932372,CSE 20,A01,084007,Staff,17,0,20,3
1649818938395,CSE 21,A01,084009,Staff,38,0,50,12
1649818944422,CSE 30,A01,083370,Cao; Yingjun,23,0,40,17
1649818950447,CSE 100,A01,083372,Cao; Yingjun,22,0,40,18
1649818956485,CSE 101,A01,084011,Staff,0,2,40,40
1649818962509,CSE 141,A01,083374,Eldon; John,0,2,75,75
1649818968538,CSE 141L,A01,083376,Eldon; John,0,4,75,75
1649818974579,CSE 175,A01,084013,Kumar; Rakesh,24,0,25,1
1649818980603,CSE 190,A00,092508,Staff,15,0,15,0
1649818986628,ECE 5,A01,084049,Morris; Karcher William,17,0,20,3
1649818992653,ECE 100,A01,084051,Baghdadchi; Saharnaz,17,0,20,3
1649818992653,ECE 100,A02,091916,Baghdadchi; Saharnaz,18,0,20,2
1649818998676,ECE 101,A01,084053,Baghdadchi; Saharnaz,25,0,37,12
1649818998676,ECE 101,A02,084054,Baghdadchi; Saharnaz,37,0,37,0
1649819004699,ECE 107,A01,083390,Staff,34,0,40,6
1649819010723,ECE 148,A01,084056,Silberman; Jack,8,0,12,4
1649819016745,ECE 180,A00,083391,Abi Samra; Nicholas Camill,27,0,30,3
1649819016745,ECE 180,B00,083392,Abi Samra; Nicholas Camill,26,0,30,4
1649819022769,MATH 10B,A01,084110,Staff,21,0,30,9
1649819022769,MATH 10B,A02,084111,Staff,29,0,30,1
1649819022769,MATH 10B,A03,084112,Staff,29,0,30,1
1649819028794,MATH 10C,A01,083443,Staff,20,0,30,10
1649819028794,MATH 10C,A02,083444,Staff,26,0,30,4
1649819028794,MATH 10C,B01,084114,Staff,26,0,30,4
1649819028794,MATH 10C,B02,084115,Staff,30,0,30,0
1649819034821,MATH 18,A01,084117,Harel; Guershon,28,0,30,2
1649819034821,MATH 18,A02,084119,Harel; Guershon,29,0,30,1
1649819034821,MATH 18,A03,084120,Harel; Guershon,30,0,30,0
1649819034821,MATH 18,A04,084121,Harel; Guershon,30,0,30,0
1649819040845,MATH 20B,A01,084124,Um; Ko Woon,33,0,35,2
1649819040845,MATH 20B,B01,084126,Um; Ko Woon,35,0,35,0
1649819046868,MATH 20C,A01,083446,Hammock; Frances H,27,0,30,3
1649819046868,MATH 20C,A02,083447,Hammock; Frances H,30,0,30,0
1649819046868,MATH 20C,A03,083448,Hammock; Frances H,30,0,30,0
1649819046868,MATH 20C,A04,083449,Hammock; Frances H,30,0,30,0
1649819046868,MATH 20C,B01,083451,Hammock; Frances H,29,0,30,1
1649819046868,MATH 20C,B02,083452,Hammock; Frances H,30,0,30,0
1649819046868,MATH 20C,B03,083453,Hammock; Frances H,30,0,30,0
1649819046868,MATH 20C,B04,083454,Hammock; Frances H,30,0,30,0
1649819052893,MATH 20D,A01,084128,Staff,29,0,30,1
1649819052893,MATH 20D,A02,084129,Staff,30,0,30,0
1649819052893,MATH 20D,A03,084130,Staff,29,0,30,1
1649819052893,MATH 20D,B01,084133,Staff,28,0,30,2
1649819052893,MATH 20D,B02,084134,Staff,30,0,30,0
1649819052893,MATH 20D,B03,084135,Staff,30,0,30,0
1649819058916,MATH 20E,A01,084138,Staff,29,0,30,1
1649819058916,MATH 20E,A02,084139,Staff,29,0,30,1
1649819058916,MATH 20E,A03,084140,Staff,29,0,30,1
1649819058916,MATH 20E,A04,084141,Staff,30,0,30,0
1649819064941,MATH 102,A01,084143,Harel; Guershon,24,0,30,6
1649819064941,MATH 102,A02,084144,Harel; Guershon,25,0,30,5
1649819070969,MATH 103B,A01,083456,Staff,1,0,30,29
1649819070969,MATH 103B,A02,083457,Staff,23,0,30,7
1649819076993,MATH 109,A01,084146,Salehi Golsefidy; Alireza,30,0,30,0
1649819076993,MATH 109,A02,084147,Salehi Golsefidy; Alireza,27,0,30,3
1649819083020,MATH 120A,A01,085445,Eggers; John Dietrich,31,0,35,4
1649819083020,MATH 120A,A02,085446,Eggers; John Dietrich,31,0,35,4
1649819089056,MATH 142B,A01,084149,Verstraete; Jacques Allan,12,0,30,18
1649819089056,MATH 142B,A02,084150,Verstraete; Jacques Allan,26,0,30,4
1649819095089,MATH 170A,A01,083459,Nie; Jiawang,12,0,30,18
1649819095089,MATH 170A,A02,083460,Nie; Jiawang,25,0,30,5
1649819095089,MATH 170A,A03,083461,Nie; Jiawang,26,0,30,4
1649819101116,MATH 193B,A01,083463,Staff,19,0,30,11
1649819101116,MATH 193B,A02,083464,Staff,20,0,30,10
1649819101116,MATH 193B,A03,083465,Staff,27,0,30,3
1649819107171,COGS 2,A01,083966,Boyle; Mary E. T.,27,0,30,3
1649819113201,COGS 9,A01,083968,Staff,57,0,60,3
1649819119228,COGS 14B,A01,083970,Staff,48,0,50,2
1649819125253,COGS 17,A01,092679,Staff,74,0,75,1
1649819131282,COGS 100,A01,083972,Staff,47,0,60,13
1649819143332,COGS 101C,A01,083976,Staff,25,0,30,5
1649819149356,COGS 102A,A01,083978,Johnson; Christine M.,26,0,30,4
1649819155382,COGS 107B,A01,083980,Staff,40,0,50,10
1649819161408,COGS 115,A01,083982,Staff,22,0,30,8
1649819167431,COGS 118B,A01,083367,Staff,6,0,40,34
1649819173454,COGS 172,A01,083984,Provenzano; Emily Kara,23,0,30,7
1649819179480,COGS 177,A00,083368,Staff,8,0,30,22
1649819185506,COGS 186,A01,083986,Staff,26,0,40,14
1649819191534,COGS 187A,A01,083988,Boyle; Mary E. T.,41,0,60,19
1649819197561,CSE 8A,A50,084003,Miranda; Gregory Joseph,10,0,15,5
1649819203585,CSE 11,A01,084005,Miranda; Gregory Joseph,49,0,55,6
1649819209608,CSE 20,A01,084007,Staff,17,0,20,3
1649819215637,CSE 21,A01,084009,Staff,38,0,50,12
1649819221665,CSE 30,A01,083370,Cao; Yingjun,23,0,40,17
1649819227687,CSE 100,A01,083372,Cao; Yingjun,21,0,40,19
1649819233718,CSE 101,A01,084011,Staff,0,2,40,40
1649819239744,CSE 141,A01,083374,Eldon; John,0,2,75,75
1649819245771,CSE 141L,A01,083376,Eldon; John,0,4,75,75
1649819251887,CSE 175,A01,084013,Kumar; Rakesh,24,0,25,1
1649819257911,CSE 190,A00,092508,Staff,15,0,15,0
1649819263940,ECE 5,A01,084049,Morris; Karcher William,17,0,20,3
1649819269968,ECE 100,A01,084051,Baghdadchi; Saharnaz,17,0,20,3
1649819269968,ECE 100,A02,091916,Baghdadchi; Saharnaz,18,0,20,2
1649819275991,ECE 101,A01,084053,Baghdadchi; Saharnaz,25,0,37,12
1649819275991,ECE 101,A02,084054,Baghdadchi; Saharnaz,37,0,37,0
1649819282015,ECE 107,A01,083390,Staff,34,0,40,6
1649819288039,ECE 148,A01,084056,Silberman; Jack,8,0,12,4
1649819294063,ECE 180,A00,083391,Abi Samra; Nicholas Camill,27,0,30,3
1649819294063,ECE 180,B00,083392,Abi Samra; Nicholas Camill,26,0,30,4
1649819300086,MATH 10B,A01,084110,Staff,21,0,30,9
1649819300086,MATH 10B,A02,084111,Staff,29,0,30,1
1649819300086,MATH 10B,A03,084112,Staff,29,0,30,1
1649819306113,MATH 10C,A01,083443,Staff,20,0,30,10
1649819306113,MATH 10C,A02,083444,Staff,26,0,30,4
1649819306113,MATH 10C,B01,084114,Staff,26,0,30,4
1649819306113,MATH 10C,B02,084115,Staff,30,0,30,0
1649819312148,MATH 18,A01,084117,Harel; Guershon,28,0,30,2
1649819312148,MATH 18,A02,084119,Harel; Guershon,29,0,30,1
1649819312148,MATH 18,A03,084120,Harel; Guershon,30,0,30,0
1649819312148,MATH 18,A04,084121,Harel; Guershon,30,0,30,0
1649819318176,MATH 20B,A01,084124,Um; Ko Woon,33,0,35,2
1649819318176,MATH 20B,B01,084126,Um; Ko Woon,35,0,35,0
1649819324207,MATH 20C,A01,083446,Hammock; Frances H,27,0,30,3
1649819324207,MATH 20C,A02,083447,Hammock; Frances H,30,0,30,0
1649819324207,MATH 20C,A03,083448,Hammock; Frances H,30,0,30,0
1649819324207,MATH 20C,A04,083449,Hammock; Frances H,30,0,30,0
1649819324207,MATH 20C,B01,083451,Hammock; Frances H,29,0,30,1
1649819324207,MATH 20C,B02,083452,Hammock; Frances H,30,0,30,0
1649819324207,MATH 20C,B03,083453,Hammock; Frances H,30,0,30,0
1649819324207,MATH 20C,B04,083454,Hammock; Frances H,30,0,30,0
1649819330232,MATH 20D,A01,084128,Staff,29,0,30,1
1649819330232,MATH 20D,A02,084129,Staff,30,0,30,0
1649819330232,MATH 20D,A03,084130,Staff,29,0,30,1
1649819330232,MATH 20D,B01,084133,Staff,28,0,30,2
1649819330232,MATH 20D,B02,084134,Staff,30,0,30,0
1649819330232,MATH 20D,B03,084135,Staff,30,0,30,0
1649819336254,MATH 20E,A01,084138,Staff,29,0,30,1
1649819336254,MATH 20E,A02,084139,Staff,29,0,30,1
1649819336254,MATH 20E,A03,084140,Staff,29,0,30,1
1649819336254,MATH 20E,A04,084141,Staff,30,0,30,0
1649819342280,MATH 102,A01,084143,Harel; Guershon,24,0,30,6
1649819342280,MATH 102,A02,084144,Harel; Guershon,25,0,30,5
1649819348303,MATH 103B,A01,083456,Staff,1,0,30,29
1649819348303,MATH 103B,A02,083457,Staff,23,0,30,7
1649819354324,MATH 109,A01,084146,Salehi Golsefidy; Alireza,30,0,30,0
1649819354324,MATH 109,A02,084147,Salehi Golsefidy; Alireza,27,0,30,3
1649819360352,MATH 120A,A01,085445,Eggers; John Dietrich,31,0,35,4
1649819360352,MATH 120A,A02,085446,Eggers; John Dietrich,31,0,35,4
1649819366383,MATH 142B,A01,084149,Verstraete; Jacques Allan,12,0,30,18
1649819366383,MATH 142B,A02,084150,Verstraete; Jacques Allan,26,0,30,4
1649819372410,MATH 170A,A01,083459,Nie; Jiawang,12,0,30,18
1649819372410,MATH 170A,A02,083460,Nie; Jiawang,25,0,30,5
1649819372410,MATH 170A,A03,083461,Nie; Jiawang,26,0,30,4
1649819378434,MATH 193B,A01,083463,Staff,19,0,30,11
1649819378434,MATH 193B,A02,083464,Staff,20,0,30,10
1649819378434,MATH 193B,A03,083465,Staff,27,0,30,3
1649819384498,COGS 2,A01,083966,Boyle; Mary E. T.,27,0,30,3
1649819390522,COGS 9,A01,083968,Staff,57,0,60,3
1649819396550,COGS 14B,A01,083970,Staff,48,0,50,2
1649819402571,COGS 17,A01,092679,Staff,74,0,75,1
1649819408593,COGS 100,A01,083972,Staff,47,0,60,13
1649819420649,COGS 101C,A01,083976,Staff,25,0,30,5
1649819426675,COGS 102A,A01,083978,Johnson; Christine M.,26,0,30,4
1649819432700,COGS 107B,A01,083980,Staff,40,0,50,10
1649819438728,COGS 115,A01,083982,Staff,22,0,30,8
1649819444756,COGS 118B,A01,083367,Staff,6,0,40,34
1649819450784,COGS 172,A01,083984,Provenzano; Emily Kara,23,0,30,7
1649819456810,COGS 177,A00,083368,Staff,8,0,30,22
1649819462840,COGS 186,A01,083986,Staff,26,0,40,14
1649819468868,COGS 187A,A01,083988,Boyle; Mary E. T.,41,0,60,19
1649819474898,CSE 8A,A50,084003,Miranda; Gregory Joseph,10,0,15,5
1649819480922,CSE 11,A01,084005,Miranda; Gregory Joseph,49,0,55,6
1649819486947,CSE 20,A01,084007,Staff,17,0,20,3
1649819492975,CSE 21,A01,084009,Staff,38,0,50,12
1649819498999,CSE 30,A01,083370,Cao; Yingjun,23,0,40,17
1649819505023,CSE 100,A01,083372,Cao; Yingjun,21,0,40,19
1649819511048,CSE 101,A01,084011,Staff,0,3,40,40
1649819517072,CSE 141,A01,083374,Eldon; John,0,3,75,75
1649819523100,CSE 141L,A01,083376,Eldon; John,0,5,75,75
1649819529123,CSE 175,A01,084013,Kumar; Rakesh,24,0,25,1
1649819535149,CSE 190,A00,092508,Staff,15,0,15,0
1649819541177,ECE 5,A01,084049,Morris; Karcher William,17,0,20,3
1649819547210,ECE 100,A01,084051,Baghdadchi; Saharnaz,17,0,20,3
1649819547210,ECE 100,A02,091916,Baghdadchi; Saharnaz,18,0,20,2
1649819553239,ECE 101,A01,084053,Baghdadchi; Saharnaz,25,0,37,12
1649819553239,ECE 101,A02,084054,Baghdadchi; Saharnaz,37,0,37,0
1649819559271,ECE 107,A01,083390,Staff,34,0,40,6
1649819565294,ECE 148,A01,084056,Silberman; Jack,8,0,12,4
1649819571320,ECE 180,A00,083391,Abi Samra; Nicholas Camill,27,0,30,3
1649819571320,ECE 180,B00,083392,Abi Samra; Nicholas Camill,26,0,30,4
1649819577356,MATH 10B,A01,084110,Staff,21,0,30,9
1649819577356,MATH 10B,A02,084111,Staff,29,0,30,1
1649819577356,MATH 10B,A03,084112,Staff,29,0,30,1
1649819583394,MATH 10C,A01,083443,Staff,20,0,30,10
1649819583394,MATH 10C,A02,083444,Staff,26,0,30,4
1649819583394,MATH 10C,B01,084114,Staff,26,0,30,4
1649819583394,MATH 10C,B02,084115,Staff,30,0,30,0
1649819589423,MATH 18,A01,084117,Harel; Guershon,28,0,30,2
1649819589423,MATH 18,A02,084119,Harel; Guershon,29,0,30,1
1649819589423,MATH 18,A03,084120,Harel; Guershon,30,0,30,0
1649819589423,MATH 18,A04,084121,Harel; Guershon,30,0,30,0
1649819595447,MATH 20B,A01,084124,Um; Ko Woon,33,0,35,2
1649819595447,MATH 20B,B01,084126,Um; Ko Woon,35,0,35,0
1649819601472,MATH 20C,A01,083446,Hammock; Frances H,27,0,30,3
1649819601472,MATH 20C,A02,083447,Hammock; Frances H,30,0,30,0
1649819601472,MATH 20C,A03,083448,Hammock; Frances H,30,0,30,0
1649819601472,MATH 20C,A04,083449,Hammock; Frances H,30,0,30,0
1649819601472,MATH 20C,B01,083451,Hammock; Frances H,29,0,30,1
1649819601472,MATH 20C,B02,083452,Hammock; Frances H,30,0,30,0
1649819601472,MATH 20C,B03,083453,Hammock; Frances H,30,0,30,0
1649819601472,MATH 20C,B04,083454,Hammock; Frances H,30,0,30,0
1649819607497,MATH 20D,A01,084128,Staff,29,0,30,1
1649819607497,MATH 20D,A02,084129,Staff,30,0,30,0
1649819607497,MATH 20D,A03,084130,Staff,29,0,30,1
1649819607497,MATH 20D,B01,084133,Staff,28,0,30,2
1649819607497,MATH 20D,B02,084134,Staff,30,0,30,0
1649819607497,MATH 20D,B03,084135,Staff,30,0,30,0
1649819613526,MATH 20E,A01,084138,Staff,29,0,30,1
1649819613526,MATH 20E,A02,084139,Staff,29,0,30,1
1649819613526,MATH 20E,A03,084140,Staff,29,0,30,1
1649819613526,MATH 20E,A04,084141,Staff,30,0,30,0
1649819619550,MATH 102,A01,084143,Harel; Guershon,24,0,30,6
1649819619550,MATH 102,A02,084144,Harel; Guershon,25,0,30,5
1649819625581,MATH 103B,A01,083456,Staff,0,0,30,30
1649819625581,MATH 103B,A02,083457,Staff,23,0,30,7
1649819631621,MATH 109,A01,084146,Salehi Golsefidy; Alireza,30,0,30,0
1649819631621,MATH 109,A02,084147,Salehi Golsefidy; Alireza,27,0,30,3
1649819637649,MATH 120A,A01,085445,Eggers; John Dietrich,31,0,35,4
1649819637649,MATH 120A,A02,085446,Eggers; John Dietrich,31,0,35,4
1649819643672,MATH 142B,A01,084149,Verstraete; Jacques Allan,12,0,30,18
1649819643672,MATH 142B,A02,084150,Verstraete; Jacques Allan,25,0,30,5
1649819649700,MATH 170A,A01,083459,Nie; Jiawang,12,0,30,18
1649819649700,MATH 170A,A02,083460,Nie; Jiawang,25,0,30,5
1649819649700,MATH 170A,A03,083461,Nie; Jiawang,26,0,30,4
1649819655723,MATH 193B,A01,083463,Staff,18,0,30,12
1649819655723,MATH 193B,A02,083464,Staff,19,0,30,11
1649819655723,MATH 193B,A03,083465,Staff,27,0,30,3
1649819661796,COGS 2,A01,083966,Boyle; Mary E. T.,27,0,30,3
1649819667825,COGS 9,A01,083968,Staff,57,0,60,3
1649819673849,COGS 14B,A01,083970,Staff,48,0,50,2
1649819679874,COGS 17,A01,092679,Staff,74,0,75,1
1649819685902,COGS 100,A01,083972,Staff,47,0,60,13
1649819697953,COGS 101C,A01,083976,Staff,25,0,30,5
1649819703975,COGS 102A,A01,083978,Johnson; Christine M.,26,0,30,4
1649819709999,COGS 107B,A01,083980,Staff,40,0,50,10
1649819716024,COGS 115,A01,083982,Staff,22,0,30,8
1649819722047,COGS 118B,A01,083367,Staff,6,0,40,34
1649819728074,COGS 172,A01,083984,Provenzano; Emily Kara,22,0,30,8
1649819734101,COGS 177,A00,083368,Staff,6,0,30,24
1649819740129,COGS 186,A01,083986,Staff,25,0,40,15
1649819746153,COGS 187A,A01,083988,Boyle; Mary E. T.,41,0,60,19
1649819752177,CSE 8A,A50,084003,Miranda; Gregory Joseph,10,0,15,5
1649819758201,CSE 11,A01,084005,Miranda; Gregory Joseph,49,0,55,6
1649819764227,CSE 20,A01,084007,Staff,17,0,20,3
1649819770255,CSE 21,A01,084009,Staff,38,0,50,12
1649819776278,CSE 30,A01,083370,Cao; Yingjun,23,0,40,17
1649819782301,CSE 100,A01,083372,Cao; Yingjun,21,0,40,19
1649819788326,CSE 101,A01,084011,Staff,0,3,40,40
1649819794351,CSE 141,A01,083374,Eldon; John,0,3,75,75
1649819800378,CSE 141L,A01,083376,Eldon; John,0,5,75,75
1649819806400,CSE 175,A01,084013,Kumar; Rakesh,24,0,25,1
1649819812424,CSE 190,A00,092508,Staff,15,0,15,0
1649819818450,ECE 5,A01,084049,Morris; Karcher William,17,0,20,3
1649819824478,ECE 100,A01,084051,Baghdadchi; Saharnaz,17,0,20,3
1649819824478,ECE 100,A02,091916,Baghdadchi; Saharnaz,18,0,20,2
1649819830504,ECE 101,A01,084053,Baghdadchi; Saharnaz,25,0,37,12
1649819830504,ECE 101,A02,084054,Baghdadchi; Saharnaz,37,0,37,0
1649819836533,ECE 107,A01,083390,Staff,34,0,40,6
1649819842582,ECE 148,A01,084056,Silberman; Jack,8,0,12,4
1649819848693,ECE 180,A00,083391,Abi Samra; Nicholas Camill,27,0,30,3
1649819848693,ECE 180,B00,083392,Abi Samra; Nicholas Camill,26,0,30,4
1649819854720,MATH 10B,A01,084110,Staff,21,0,30,9
1649819854720,MATH 10B,A02,084111,Staff,29,0,30,1
1649819854720,MATH 10B,A03,084112,Staff,29,0,30,1
1649819860744,MATH 10C,A01,083443,Staff,20,0,30,10
1649819860744,MATH 10C,A02,083444,Staff,26,0,30,4
1649819860744,MATH 10C,B01,084114,Staff,26,0,30,4
1649819860744,MATH 10C,B02,084115,Staff,30,0,30,0
1649819866777,MATH 18,A01,084117,Harel; Guershon,28,0,30,2
1649819866777,MATH 18,A02,084119,Harel; Guershon,29,0,30,1
1649819866777,MATH 18,A03,084120,Harel; Guershon,30,0,30,0
1649819866777,MATH 18,A04,084121,Harel; Guershon,30,0,30,0
1649819872798,MATH 20B,A01,084124,Um; Ko Woon,33,0,35,2
1649819872798,MATH 20B,B01,084126,Um; Ko Woon,35,0,35,0
1649819878829,MATH 20C,A01,083446,Hammock; Frances H,27,0,30,3
1649819878829,MATH 20C,A02,083447,Hammock; Frances H,30,0,30,0
1649819878829,MATH 20C,A03,083448,Hammock; Frances H,30,0,30,0
1649819878829,MATH 20C,A04,083449,Hammock; Frances H,30,0,30,0
1649819878829,MATH 20C,B01,083451,Hammock; Frances H,29,0,30,1
1649819878829,MATH 20C,B02,083452,Hammock; Frances H,30,0,30,0
1649819878829,MATH 20C,B03,083453,Hammock; Frances H,30,0,30,0
1649819878829,MATH 20C,B04,083454,Hammock; Frances H,30,0,30,0
1649819884861,MATH 20D,A01,084128,Staff,29,0,30,1
1649819884861,MATH 20D,A02,084129,Staff,30,0,30,0
1649819884861,MATH 20D,A03,084130,Staff,29,0,30,1
1649819884861,MATH 20D,B01,084133,Staff,28,0,30,2
1649819884861,MATH 20D,B02,084134,Staff,30,0,30,0
1649819884861,MATH 20D,B03,084135,Staff,30,0,30,0
1649819890911,MATH 20E,A01,084138,Staff,29,0,30,1
1649819890911,MATH 20E,A02,084139,Staff,29,0,30,1
1649819890911,MATH 20E,A03,084140,Staff,29,0,30,1
1649819890911,MATH 20E,A04,084141,Staff,30,0,30,0
1649819896936,MATH 102,A01,084143,Harel; Guershon,24,0,30,6
1649819896936,MATH 102,A02,084144,Harel; Guershon,25,0,30,5
1649819902960,MATH 103B,A01,083456,Staff,0,0,30,30
1649819902960,MATH 103B,A02,083457,Staff,23,0,30,7
1649819908985,MATH 109,A01,084146,Salehi Golsefidy; Alireza,30,0,30,0
1649819908985,MATH 109,A02,084147,Salehi Golsefidy; Alireza,27,0,30,3
1649819915009,MATH 120A,A01,085445,Eggers; John Dietrich,31,0,35,4
1649819915009,MATH 120A,A02,085446,Eggers; John Dietrich,31,0,35,4
1649819921032,MATH 142B,A01,084149,Verstraete; Jacques Allan,12,0,30,18
1649819921032,MATH 142B,A02,084150,Verstraete; Jacques Allan,25,0,30,5
1649819927060,MATH 170A,A01,083459,Nie; Jiawang,12,0,30,18
1649819927060,MATH 170A,A02,083460,Nie; Jiawang,25,0,30,5
1649819927060,MATH 170A,A03,083461,Nie; Jiawang,26,0,30,4
1649819933088,MATH 193B,A01,083463,Staff,18,0,30,12
1649819933088,MATH 193B,A02,083464,Staff,19,0,30,11
1649819933088,MATH 193B,A03,083465,Staff,27,0,30,3
1649819939142,COGS 2,A01,083966,Boyle; Mary E. T.,27,0,30,3
1649819945165,COGS 9,A01,083968,Staff,57,0,60,3
1649819951207,COGS 14B,A01,083970,Staff,48,0,50,2
1649819957231,COGS 17,A01,092679,Staff,74,0,75,1
1649819963253,COGS 100,A01,083972,Staff,47,0,60,13
1649819975300,COGS 101C,A01,083976,Staff,25,0,30,5
1649819981323,COGS 102A,A01,083978,Johnson; Christine M.,26,0,30,4
1649819987347,COGS 107B,A01,083980,Staff,40,0,50,10
1649819993370,COGS 115,A01,083982,Staff,22,0,30,8
1649819999392,COGS 118B,A01,083367,Staff,6,0,40,34
1649820005414,COGS 172,A01,083984,Provenzano; Emily Kara,22,0,30,8
1649820011452,COGS 177,A00,083368,Staff,6,0,30,24
1649820017475,COGS 186,A01,083986,Staff,25,0,40,15
1649820023509,COGS 187A,A01,083988,Boyle; Mary E. T.,41,0,60,19
1649820029531,CSE 8A,A50,084003,Miranda; Gregory Joseph,10,0,15,5
1649820035555,CSE 11,A01,084005,Miranda; Gregory Joseph,49,0,55,6
1649820041580,CSE 20,A01,084007,Staff,17,0,20,3
1649820047601,CSE 21,A01,084009,Staff,38,0,50,12
1649820053623,CSE 30,A01,083370,Cao; Yingjun,23,0,40,17
1649820059648,CSE 100,A01,083372,Cao; Yingjun,21,0,40,19
1649820065673,CSE 101,A01,084011,Staff,0,3,40,40
1649820071696,CSE 141,A01,083374,Eldon; John,0,3,75,75
1649820077723,CSE 141L,A01,083376,Eldon; John,0,5,75,75
1649820083747,CSE 175,A01,084013,Kumar; Rakesh,24,0,25,1
1649820089773,CSE 190,A00,092508,Staff,15,0,15,0
1649820095796,ECE 5,A01,084049,Morris; Karcher William,17,0,20,3
1649820101821,ECE 100,A01,084051,Baghdadchi; Saharnaz,17,0,20,3
1649820101821,ECE 100,A02,091916,Baghdadchi; Saharnaz,18,0,20,2
1649820107849,ECE 101,A01,084053,Baghdadchi; Saharnaz,25,0,37,12
1649820107849,ECE 101,A02,084054,Baghdadchi; Saharnaz,37,0,37,0
1649820113875,ECE 107,A01,083390,Staff,34,0,40,6
1649820119900,ECE 148,A01,084056,Silberman; Jack,8,0,12,4
1649820125935,ECE 180,A00,083391,Abi Samra; Nicholas Camill,27,0,30,3
1649820125935,ECE 180,B00,083392,Abi Samra; Nicholas Camill,26,0,30,4
1649820131959,MATH 10B,A01,084110,Staff,21,0,30,9
1649820131959,MATH 10B,A02,084111,Staff,29,0,30,1
1649820131959,MATH 10B,A03,084112,Staff,29,0,30,1
1649820137982,MATH 10C,A01,083443,Staff,20,0,30,10
1649820137982,MATH 10C,A02,083444,Staff,26,0,30,4
1649820137982,MATH 10C,B01,084114,Staff,26,0,30,4
1649820137982,MATH 10C,B02,084115,Staff,30,0,30,0
1649820144011,MATH 18,A01,084117,Harel; Guershon,28,0,30,2
1649820144011,MATH 18,A02,084119,Harel; Guershon,29,0,30,1
1649820144011,MATH 18,A03,084120,Harel; Guershon,30,0,30,0
1649820144011,MATH 18,A04,084121,Harel; Guershon,30,0,30,0
1649820150040,MATH 20B,A01,084124,Um; Ko Woon,33,0,35,2
1649820150040,MATH 20B,B01,084126,Um; Ko Woon,35,0,35,0
1649820156074,MATH 20C,A01,083446,Hammock; Frances H,27,0,30,3
1649820156074,MATH 20C,A02,083447,Hammock; Frances H,30,0,30,0
1649820156074,MATH 20C,A03,083448,Hammock; Frances H,30,0,30,0
1649820156074,MATH 20C,A04,083449,Hammock; Frances H,30,0,30,0
1649820156074,MATH 20C,B01,083451,Hammock; Frances H,29,0,30,1
1649820156074,MATH 20C,B02,083452,Hammock; Frances H,30,0,30,0
1649820156074,MATH 20C,B03,083453,Hammock; Frances H,30,0,30,0
1649820156074,MATH 20C,B04,083454,Hammock; Frances H,30,0,30,0
1649820162109,MATH 20D,A01,084128,Staff,29,0,30,1
1649820162109,MATH 20D,A02,084129,Staff,30,0,30,0
1649820162109,MATH 20D,A03,084130,Staff,29,0,30,1
1649820162109,MATH 20D,B01,084133,Staff,28,0,30,2
1649820162109,MATH 20D,B02,084134,Staff,30,0,30,0
1649820162109,MATH 20D,B03,084135,Staff,30,0,30,0
1649820168140,MATH 20E,A01,084138,Staff,29,0,30,1
1649820168140,MATH 20E,A02,084139,Staff,29,0,30,1
1649820168140,MATH 20E,A03,084140,Staff,29,0,30,1
1649820168140,MATH 20E,A04,084141,Staff,30,0,30,0
1649820174168,MATH 102,A01,084143,Harel; Guershon,24,0,30,6
1649820174168,MATH 102,A02,084144,Harel; Guershon,25,0,30,5
1649820180192,MATH 103B,A01,083456,Staff,0,0,30,30
1649820180192,MATH 103B,A02,083457,Staff,23,0,30,7
1649820186220,MATH 109,A01,084146,Salehi Golsefidy; Alireza,30,0,30,0
1649820186220,MATH 109,A02,084147,Salehi Golsefidy; Alireza,27,0,30,3
1649820192254,MATH 120A,A01,085445,Eggers; John Dietrich,31,0,35,4
1649820192254,MATH 120A,A02,085446,Eggers; John Dietrich,31,0,35,4
1649820198278,MATH 142B,A01,084149,Verstraete; Jacques Allan,11,0,30,19
1649820198278,MATH 142B,A02,084150,Verstraete; Jacques Allan,25,0,30,5
1649820204303,MATH 170A,A01,083459,Nie; Jiawang,12,0,30,18
1649820204303,MATH 170A,A02,083460,Nie; Jiawang,25,0,30,5
1649820204303,MATH 170A,A03,083461,Nie; Jiawang,26,0,30,4
1649820210336,MATH 193B,A01,083463,Staff,18,0,30,12
1649820210336,MATH 193B,A02,083464,Staff,19,0,30,11
1649820210336,MATH 193B,A03,083465,Staff,27,0,30,3
1649820216406,COGS 2,A01,083966,Boyle; Mary E. T.,27,0,30,3
1649820222428,COGS 9,A01,083968,Staff,57,0,60,3
1649820228456,COGS 14B,A01,083970,Staff,48,0,50,2
1649820234478,COGS 17,A01,092679,Staff,74,0,75,1
1649820240510,COGS 100,A01,083972,Staff,47,0,60,13
1649820252557,COGS 101C,A01,083976,Staff,25,0,30,5
1649820258581,COGS 102A,A01,083978,Johnson; Christine M.,26,0,30,4
1649820264603,COGS 107B,A01,083980,Staff,40,0,50,10
1649820270628,COGS 115,A01,083982,Staff,22,0,30,8
1649820276653,COGS 118B,A01,083367,Staff,6,0,40,34
1649820282676,COGS 172,A01,083984,Provenzano; Emily Kara,22,0,30,8
1649820288701,COGS 177,A00,083368,Staff,6,0,30,24
1649820294724,COGS 186,A01,083986,Staff,25,0,40,15
1649820300754,COGS 187A,A01,083988,Boyle; Mary E. T.,41,0,60,19
1649820306790,CSE 8A,A50,084003,Miranda; Gregory Joseph,10,0,15,5
1649820312821,CSE 11,A01,084005,Miranda; Gregory Joseph,49,0,55,6
1649820318849,CSE 20,A01,084007,Staff,17,0,20,3
1649820324876,CSE 21,A01,084009,Staff,38,0,50,12
1649820330901,CSE 30,A01,083370,Cao; Yingjun,23,0,40,17
1649820343765,CSE 100,A01,083372,Cao; Yingjun,21,0,40,19
1649820349791,CSE 101,A01,084011,Staff,0,4,40,40
1649820355815,CSE 141,A01,083374,Eldon; John,0,3,75,75
1649820361841,CSE 141L,A01,083376,Eldon; John,0,5,75,75
1649820367865,CSE 175,A01,084013,Kumar; Rakesh,24,0,25,1
1649820373889,CSE 190,A00,092508,Staff,15,0,15,0
1649820379919,ECE 5,A01,084049,Morris; Karcher William,17,0,20,3
1649820385944,ECE 100,A01,084051,Baghdadchi; Saharnaz,16,0,20,4
1649820385944,ECE 100,A02,091916,Baghdadchi; Saharnaz,18,0,20,2
1649820391972,ECE 101,A01,084053,Baghdadchi; Saharnaz,25,0,37,12
1649820391972,ECE 101,A02,084054,Baghdadchi; Saharnaz,37,0,37,0
1649820398006,ECE 107,A01,083390,Staff,33,0,40,7
1649820404044,ECE 148,A01,084056,Silberman; Jack,8,0,12,4
1649820410072,ECE 180,A00,083391,Abi Samra; Nicholas Camill,27,0,30,3
1649820410072,ECE 180,B00,083392,Abi Samra; Nicholas Camill,26,0,30,4
1649820416096,MATH 10B,A01,084110,Staff,21,0,30,9
1649820416096,MATH 10B,A02,084111,Staff,29,0,30,1
1649820416096,MATH 10B,A03,084112,Staff,29,0,30,1
1649820422121,MATH 10C,A01,083443,Staff,20,0,30,10
1649820422121,MATH 10C,A02,083444,Staff,26,0,30,4
1649820422121,MATH 10C,B01,084114,Staff,26,0,30,4
1649820422121,MATH 10C,B02,084115,Staff,30,0,30,0
1649820428144,MATH 18,A01,084117,Harel; Guershon,28,0,30,2
1649820428144,MATH 18,A02,084119,Harel; Guershon,29,0,30,1
1649820428144,MATH 18,A03,084120,Harel; Guershon,30,0,30,0
1649820428144,MATH 18,A04,084121,Harel; Guershon,30,0,30,0
1649820434173,MATH 20B,A01,084124,Um; Ko Woon,33,0,35,2
1649820434173,MATH 20B,B01,084126,Um; Ko Woon,35,0,35,0
1649820440206,MATH 20C,A01,083446,Hammock; Frances H,27,0,30,3
1649820440206,MATH 20C,A02,083447,Hammock; Frances H,30,0,30,0
1649820440206,MATH 20C,A03,083448,Hammock; Frances H,30,0,30,0
1649820440206,MATH 20C,A04,083449,Hammock; Frances H,30,0,30,0
1649820440206,MATH 20C,B01,083451,Hammock; Frances H,29,0,30,1
1649820440206,MATH 20C,B02,083452,Hammock; Frances H,30,0,30,0
1649820440206,MATH 20C,B03,083453,Hammock; Frances H,30,0,30,0
1649820440206,MATH 20C,B04,083454,Hammock; Frances H,30,0,30,0
1649820446981,MATH 20D,A01,084128,Staff,29,0,30,1
1649820446981,MATH 20D,A02,084129,Staff,30,0,30,0
1649820446981,MATH 20D,A03,084130,Staff,29,0,30,1
1649820446981,MATH 20D,B01,084133,Staff,28,0,30,2
1649820446981,MATH 20D,B02,084134,Staff,30,0,30,0
1649820446981,MATH 20D,B03,084135,Staff,30,0,30,0
1649820453086,MATH 20E,A01,084138,Staff,29,0,30,1
1649820453086,MATH 20E,A02,084139,Staff,29,0,30,1
1649820453086,MATH 20E,A03,084140,Staff,29,0,30,1
1649820453086,MATH 20E,A04,084141,Staff,30,0,30,0
1649820459111,MATH 102,A01,084143,Harel; Guershon,24,0,30,6
1649820459111,MATH 102,A02,084144,Harel; Guershon,25,0,30,5
1649820465135,MATH 103B,A01,083456,Staff,0,0,30,30
1649820465135,MATH 103B,A02,083457,Staff,23,0,30,7
1649820471167,MATH 109,A01,084146,Salehi Golsefidy; Alireza,30,0,30,0
1649820471167,MATH 109,A02,084147,Salehi Golsefidy; Alireza,27,0,30,3
1649820477195,MATH 120A,A01,085445,Eggers; John Dietrich,31,0,35,4
1649820477195,MATH 120A,A02,085446,Eggers; John Dietrich,31,0,35,4
1649820483220,MATH 142B,A01,084149,Verstraete; Jacques Allan,11,0,30,19
1649820483220,MATH 142B,A02,084150,Verstraete; Jacques Allan,25,0,30,5
1649820489261,MATH 170A,A01,083459,Nie; Jiawang,12,0,30,18
1649820489261,MATH 170A,A02,083460,Nie; Jiawang,25,0,30,5
1649820489261,MATH 170A,A03,083461,Nie; Jiawang,26,0,30,4
1649820495299,MATH 193B,A01,083463,Staff,18,0,30,12
1649820495299,MATH 193B,A02,083464,Staff,19,0,30,11
1649820495299,MATH 193B,A03,083465,Staff,27,0,30,3
1649820501366,COGS 2,A01,083966,Boyle; Mary E. T.,27,0,30,3
1649820507393,COGS 9,A01,083968,Staff,57,0,60,3
1649820513421,COGS 14B,A01,083970,Staff,48,0,50,2
1649820519445,COGS 17,A01,092679,Staff,74,0,75,1
1649820525469,COGS 100,A01,083972,Staff,47,0,60,13
1649820537527,COGS 101C,A01,083976,Staff,25,0,30,5
1649820543550,COGS 102A,A01,083978,Johnson; Christine M.,26,0,30,4
1649820549574,COGS 107B,A01,083980,Staff,40,0,50,10
1649820555598,COGS 115,A01,083982,Staff,22,0,30,8
1649820561628,COGS 118B,A01,083367,Staff,6,0,40,34
1649820567658,COGS 172,A01,083984,Provenzano; Emily Kara,22,0,30,8
1649820573684,COGS 177,A00,083368,Staff,6,0,30,24
1649820579711,COGS 186,A01,083986,Staff,25,0,40,15
1649820585743,COGS 187A,A01,083988,Boyle; Mary E. T.,41,0,60,19
1649820591770,CSE 8A,A50,084003,Miranda; Gregory Joseph,9,0,15,6
1649820597794,CSE 11,A01,084005,Miranda; Gregory Joseph,49,0,55,6
1649820603817,CSE 20,A01,084007,Staff,17,0,20,3
1649820609846,CSE 21,A01,084009,Staff,38,0,50,12
1649820615872,CSE 30,A01,083370,Cao; Yingjun,23,0,40,17
1649820621895,CSE 100,A01,083372,Cao; Yingjun,21,0,40,19
1649820627918,CSE 101,A01,084011,Staff,0,4,40,40
1649820633941,CSE 141,A01,083374,Eldon; John,0,3,75,75
1649820639975,CSE 141L,A01,083376,Eldon; John,0,5,75,75
1649820645998,CSE 175,A01,084013,Kumar; Rakesh,24,0,25,1
1649820652021,CSE 190,A00,092508,Staff,15,0,15,0
1649820658044,ECE 5,A01,084049,Morris; Karcher William,17,0,20,3
1649820664071,ECE 100,A01,084051,Baghdadchi; Saharnaz,16,0,20,4
1649820664071,ECE 100,A02,091916,Baghdadchi; Saharnaz,18,0,20,2
1649820670110,ECE 101,A01,084053,Baghdadchi; Saharnaz,25,0,37,12
1649820670110,ECE 101,A02,084054,Baghdadchi; Saharnaz,37,0,37,0
1649820676142,ECE 107,A01,083390,Staff,33,0,40,7
1649820682168,ECE 148,A01,084056,Silberman; Jack,8,0,12,4
1649820688192,ECE 180,A00,083391,Abi Samra; Nicholas Camill,27,0,30,3
1649820688192,ECE 180,B00,083392,Abi Samra; Nicholas Camill,26,0,30,4
1649820694214,MATH 10B,A01,084110,Staff,21,0,30,9
1649820694214,MATH 10B,A02,084111,Staff,29,0,30,1
1649820694214,MATH 10B,A03,084112,Staff,29,0,30,1
1649820700236,MATH 10C,A01,083443,Staff,20,0,30,10
1649820700236,MATH 10C,A02,083444,Staff,26,0,30,4
1649820700236,MATH 10C,B01,084114,Staff,26,0,30,4
1649820700236,MATH 10C,B02,084115,Staff,30,0,30,0
1649820706264,MATH 18,A01,084117,Harel; Guershon,28,0,30,2
1649820706264,MATH 18,A02,084119,Harel; Guershon,29,0,30,1
1649820706264,MATH 18,A03,084120,Harel; Guershon,30,0,30,0
1649820706264,MATH 18,A04,084121,Harel; Guershon,30,0,30,0
1649820712293,MATH 20B,A01,084124,Um; Ko Woon,33,0,35,2
1649820712293,MATH 20B,B01,084126,Um; Ko Woon,35,0,35,0
1649820718320,MATH 20C,A01,083446,Hammock; Frances H,27,0,30,3
1649820718320,MATH 20C,A02,083447,Hammock; Frances H,30,0,30,0
1649820718320,MATH 20C,A03,083448,Hammock; Frances H,30,0,30,0
1649820718320,MATH 20C,A04,083449,Hammock; Frances H,30,0,30,0
1649820718320,MATH 20C,B01,083451,Hammock; Frances H,29,0,30,1
1649820718320,MATH 20C,B02,083452,Hammock; Frances H,30,0,30,0
1649820718320,MATH 20C,B03,083453,Hammock; Frances H,30,0,30,0
1649820718320,MATH 20C,B04,083454,Hammock; Frances H,30,0,30,0
1649820724351,MATH 20D,A01,084128,Staff,29,0,30,1
1649820724351,MATH 20D,A02,084129,Staff,30,0,30,0
1649820724351,MATH 20D,A03,084130,Staff,29,0,30,1
1649820724351,MATH 20D,B01,084133,Staff,28,0,30,2
1649820724351,MATH 20D,B02,084134,Staff,30,0,30,0
1649820724351,MATH 20D,B03,084135,Staff,30,0,30,0
1649820730374,MATH 20E,A01,084138,Staff,29,0,30,1
1649820730374,MATH 20E,A02,084139,Staff,29,0,30,1
1649820730374,MATH 20E,A03,084140,Staff,29,0,30,1
1649820730374,MATH 20E,A04,084141,Staff,30,0,30,0
1649820736411,MATH 102,A01,084143,Harel; Guershon,24,0,30,6
1649820736411,MATH 102,A02,084144,Harel; Guershon,25,0,30,5
1649820742439,MATH 103B,A01,083456,Staff,0,0,30,30
1649820742439,MATH 103B,A02,083457,Staff,23,0,30,7
1649820748462,MATH 109,A01,084146,Salehi Golsefidy; Alireza,30,0,30,0
1649820748462,MATH 109,A02,084147,Salehi Golsefidy; Alireza,27,0,30,3
1649820754500,MATH 120A,A01,085445,Eggers; John Dietrich,31,0,35,4
1649820754500,MATH 120A,A02,085446,Eggers; John Dietrich,31,0,35,4
1649820760522,MATH 142B,A01,084149,Verstraete; Jacques Allan,10,0,30,20
1649820760522,MATH 142B,A02,084150,Verstraete; Jacques Allan,25,0,30,5
1649820766553,MATH 170A,A01,083459,Nie; Jiawang,11,0,30,19
1649820766553,MATH 170A,A02,083460,Nie; Jiawang,25,0,30,5
1649820766553,MATH 170A,A03,083461,Nie; Jiawang,26,0,30,4
1649820772586,MATH 193B,A01,083463,Staff,18,0,30,12
1649820772586,MATH 193B,A02,083464,Staff,19,0,30,11
1649820772586,MATH 193B,A03,083465,Staff,27,0,30,3
1649820778637,COGS 2,A01,083966,Boyle; Mary E. T.,27,0,30,3
1649820784661,COGS 9,A01,083968,Staff,57,0,60,3
1649820790694,COGS 14B,A01,083970,Staff,48,0,50,2
1649820796722,COGS 17,A01,092679,Staff,74,0,75,1
1649820802746,COGS 100,A01,083972,Staff,47,0,60,13
1649820814797,COGS 101C,A01,083976,Staff,25,0,30,5
1649820820822,COGS 102A,A01,083978,Johnson; Christine M.,26,0,30,4
1649820826857,COGS 107B,A01,083980,Staff,40,0,50,10
1649820832879,COGS 115,A01,083982,Staff,22,0,30,8
1649820838906,COGS 118B,A01,083367,Staff,6,0,40,34
1649820844947,COGS 172,A01,083984,Provenzano; Emily Kara,22,0,30,8
1649820850970,COGS 177,A00,083368,Staff,6,0,30,24
1649820856994,COGS 186,A01,083986,Staff,25,0,40,15
1649820863017,COGS 187A,A01,083988,Boyle; Mary E. T.,41,0,60,19
1649820869045,CSE 8A,A50,084003,Miranda; Gregory Joseph,9,0,15,6
1649820875069,CSE 11,A01,084005,Miranda; Gregory Joseph,49,0,55,6
1649820881101,CSE 20,A01,084007,Staff,17,0,20,3
1649820887126,CSE 21,A01,084009,Staff,38,0,50,12
1649820893152,CSE 30,A01,083370,Cao; Yingjun,23,0,40,17
1649820899178,CSE 100,A01,083372,Cao; Yingjun,20,0,40,20
1649820905210,CSE 101,A01,084011,Staff,0,5,40,40
1649820911237,CSE 141,A01,083374,Eldon; John,0,3,75,75
1649820917261,CSE 141L,A01,083376,Eldon; John,0,5,75,75
1649820923284,CSE 175,A01,084013,Kumar; Rakesh,24,0,25,1
1649820929308,CSE 190,A00,092508,Staff,15,0,15,0
1649820935332,ECE 5,A01,084049,Morris; Karcher William,17,0,20,3
1649820941355,ECE 100,A01,084051,Baghdadchi; Saharnaz,16,0,20,4
1649820941355,ECE 100,A02,091916,Baghdadchi; Saharnaz,18,0,20,2
1649820947383,ECE 101,A01,084053,Baghdadchi; Saharnaz,25,0,37,12
1649820947383,ECE 101,A02,084054,Baghdadchi; Saharnaz,37,0,37,0
1649820953413,ECE 107,A01,083390,Staff,33,0,40,7
1649820959439,ECE 148,A01,084056,Silberman; Jack,8,0,12,4
1649820965469,ECE 180,A00,083391,Abi Samra; Nicholas Camill,27,0,30,3
1649820965469,ECE 180,B00,083392,Abi Samra; Nicholas Camill,26,0,30,4
1649820971499,MATH 10B,A01,084110,Staff,21,0,30,9
1649820971499,MATH 10B,A02,084111,Staff,29,0,30,1
1649820971499,MATH 10B,A03,084112,Staff,29,0,30,1
1649820977536,MATH 10C,A01,083443,Staff,20,0,30,10
1649820977536,MATH 10C,A02,083444,Staff,26,0,30,4
1649820977536,MATH 10C,B01,084114,Staff,26,0,30,4
1649820977536,MATH 10C,B02,084115,Staff,30,0,30,0
1649820983562,MATH 18,A01,084117,Harel; Guershon,28,0,30,2
1649820983562,MATH 18,A02,084119,Harel; Guershon,29,0,30,1
1649820983562,MATH 18,A03,084120,Harel; Guershon,30,0,30,0
1649820983562,MATH 18,A04,084121,Harel; Guershon,30,0,30,0
1649820989588,MATH 20B,A01,084124,Um; Ko Woon,33,0,35,2
1649820989588,MATH 20B,B01,084126,Um; Ko Woon,35,0,35,0
1649820995624,MATH 20C,A01,083446,Hammock; Frances H,27,0,30,3
1649820995624,MATH 20C,A02,083447,Hammock; Frances H,30,0,30,0
1649820995624,MATH 20C,A03,083448,Hammock; Frances H,30,0,30,0
1649820995624,MATH 20C,A04,083449,Hammock; Frances H,30,0,30,0
1649820995624,MATH 20C,B01,083451,Hammock; Frances H,29,0,30,1
1649820995624,MATH 20C,B02,083452,Hammock; Frances H,30,0,30,0
1649820995624,MATH 20C,B03,083453,Hammock; Frances H,30,0,30,0
1649820995624,MATH 20C,B04,083454,Hammock; Frances H,30,0,30,0
1649821001647,MATH 20D,A01,084128,Staff,29,0,30,1
1649821001647,MATH 20D,A02,084129,Staff,30,0,30,0
1649821001647,MATH 20D,A03,084130,Staff,29,0,30,1
1649821001647,MATH 20D,B01,084133,Staff,28,0,30,2
1649821001647,MATH 20D,B02,084134,Staff,30,0,30,0
1649821001647,MATH 20D,B03,084135,Staff,30,0,30,0
1649821007672,MATH 20E,A01,084138,Staff,29,0,30,1
1649821007672,MATH 20E,A02,084139,Staff,29,0,30,1
1649821007672,MATH 20E,A03,084140,Staff,29,0,30,1
1649821007672,MATH 20E,A04,084141,Staff,30,0,30,0
1649821013700,MATH 102,A01,084143,Harel; Guershon,24,0,30,6
1649821013700,MATH 102,A02,084144,Harel; Guershon,25,0,30,5
1649821019728,MATH 103B,A01,083456,Staff,0,0,30,30
1649821019728,MATH 103B,A02,083457,Staff,23,0,30,7
1649821025753,MATH 109,A01,084146,Salehi Golsefidy; Alireza,30,0,30,0
1649821025753,MATH 109,A02,084147,Salehi Golsefidy; Alireza,27,0,30,3
1649821031777,MATH 120A,A01,085445,Eggers; John Dietrich,31,0,35,4
1649821031777,MATH 120A,A02,085446,Eggers; John Dietrich,31,0,35,4
1649821037801,MATH 142B,A01,084149,Verstraete; Jacques Allan,10,0,30,20
1649821037801,MATH 142B,A02,084150,Verstraete; Jacques Allan,25,0,30,5
1649821043826,MATH 170A,A01,083459,Nie; Jiawang,11,0,30,19
1649821043826,MATH 170A,A02,083460,Nie; Jiawang,25,0,30,5
1649821043826,MATH 170A,A03,083461,Nie; Jiawang,26,0,30,4
1649821049943,MATH 193B,A01,083463,Staff,18,0,30,12
1649821049943,MATH 193B,A02,083464,Staff,19,0,30,11
1649821049943,MATH 193B,A03,083465,Staff,27,0,30,3
1649821056002,COGS 2,A01,083966,Boyle; Mary E. T.,27,0,30,3
1649821062028,COGS 9,A01,083968,Staff,57,0,60,3
1649821068056,COGS 14B,A01,083970,Staff,48,0,50,2
1649821074089,COGS 17,A01,092679,Staff,74,0,75,1
1649821080112,COGS 100,A01,083972,Staff,47,0,60,13
1649821092166,COGS 101C,A01,083976,Staff,25,0,30,5
1649821098193,COGS 102A,A01,083978,Johnson; Christine M.,26,0,30,4
1649821104216,COGS 107B,A01,083980,Staff,40,0,50,10
1649821110242,COGS 115,A01,083982,Staff,22,0,30,8
1649821116266,COGS 118B,A01,083367,Staff,6,0,40,34
1649821122291,COGS 172,A01,083984,Provenzano; Emily Kara,22,0,30,8
1649821128315,COGS 177,A00,083368,Staff,6,0,30,24
1649821134343,COGS 186,A01,083986,Staff,25,0,40,15
1649821140367,COGS 187A,A01,083988,Boyle; Mary E. T.,41,0,60,19
1649821146406,CSE 8A,A50,084003,Miranda; Gregory Joseph,9,0,15,6
1649821152430,CSE 11,A01,084005,Miranda; Gregory Joseph,49,0,55,6
1649821158457,CSE 20,A01,084007,Staff,17,0,20,3
1649821164480,CSE 21,A01,084009,Staff,38,0,50,12
1649821170504,CSE 30,A01,083370,Cao; Yingjun,22,0,40,18
1649821176528,CSE 100,A01,083372,Cao; Yingjun,20,0,40,20
1649821182553,CSE 101,A01,084011,Staff,0,5,40,40
1649821188577,CSE 141,A01,083374,Eldon; John,0,3,75,75
1649821194611,CSE 141L,A01,083376,Eldon; John,0,5,75,75
1649821200635,CSE 175,A01,084013,Kumar; Rakesh,24,0,25,1
1649821206657,CSE 190,A00,092508,Staff,15,0,15,0
1649821212682,ECE 5,A01,084049,Morris; Karcher William,17,0,20,3
1649821218709,ECE 100,A01,084051,Baghdadchi; Saharnaz,16,0,20,4
1649821218709,ECE 100,A02,091916,Baghdadchi; Saharnaz,18,0,20,2
1649821224736,ECE 101,A01,084053,Baghdadchi; Saharnaz,25,0,37,12
1649821224736,ECE 101,A02,084054,Baghdadchi; Saharnaz,37,0,37,0
1649821230761,ECE 107,A01,083390,Staff,33,0,40,7
1649821236784,ECE 148,A01,084056,Silberman; Jack,8,0,12,4
1649821242811,ECE 180,A00,083391,Abi Samra; Nicholas Camill,27,0,30,3
1649821242811,ECE 180,B00,083392,Abi Samra; Nicholas Camill,26,0,30,4
1649821248842,MATH 10B,A01,084110,Staff,20,0,30,10
1649821248842,MATH 10B,A02,084111,Staff,29,0,30,1
1649821248842,MATH 10B,A03,084112,Staff,29,0,30,1
1649821254865,MATH 10C,A01,083443,Staff,20,0,30,10
1649821254865,MATH 10C,A02,083444,Staff,26,0,30,4
1649821254865,MATH 10C,B01,084114,Staff,26,0,30,4
1649821254865,MATH 10C,B02,084115,Staff,30,0,30,0
1649821260889,MATH 18,A01,084117,Harel; Guershon,28,0,30,2
1649821260889,MATH 18,A02,084119,Harel; Guershon,29,0,30,1
1649821260889,MATH 18,A03,084120,Harel; Guershon,30,0,30,0
1649821260889,MATH 18,A04,084121,Harel; Guershon,30,0,30,0
1649821266912,MATH 20B,A01,084124,Um; Ko Woon,33,0,35,2
1649821266912,MATH 20B,B01,084126,Um; Ko Woon,35,0,35,0
1649821272937,MATH 20C,A01,083446,Hammock; Frances H,27,0,30,3
1649821272937,MATH 20C,A02,083447,Hammock; Frances H,30,0,30,0
1649821272937,MATH 20C,A03,083448,Hammock; Frances H,30,0,30,0
1649821272937,MATH 20C,A04,083449,Hammock; Frances H,30,0,30,0
1649821272937,MATH 20C,B01,083451,Hammock; Frances H,29,0,30,1
1649821272937,MATH 20C,B02,083452,Hammock; Frances H,30,0,30,0
1649821272937,MATH 20C,B03,083453,Hammock; Frances H,30,0,30,0
1649821272937,MATH 20C,B04,083454,Hammock; Frances H,30,0,30,0
1649821278961,MATH 20D,A01,084128,Staff,29,0,30,1
1649821278961,MATH 20D,A02,084129,Staff,30,0,30,0
1649821278961,MATH 20D,A03,084130,Staff,29,0,30,1
1649821278961,MATH 20D,B01,084133,Staff,28,0,30,2
1649821278961,MATH 20D,B02,084134,Staff,30,0,30,0
1649821278961,MATH 20D,B03,084135,Staff,30,0,30,0
1649821284989,MATH 20E,A01,084138,Staff,29,0,30,1
1649821284989,MATH 20E,A02,084139,Staff,29,0,30,1
1649821284989,MATH 20E,A03,084140,Staff,29,0,30,1
1649821284989,MATH 20E,A04,084141,Staff,30,0,30,0
1649821291034,MATH 102,A01,084143,Harel; Guershon,24,0,30,6
1649821291034,MATH 102,A02,084144,Harel; Guershon,25,0,30,5
1649821297068,MATH 103B,A01,083456,Staff,0,0,30,30
1649821297068,MATH 103B,A02,083457,Staff,23,0,30,7
1649821303091,MATH 109,A01,084146,Salehi Golsefidy; Alireza,30,0,30,0
1649821303091,MATH 109,A02,084147,Salehi Golsefidy; Alireza,27,0,30,3
1649821309121,MATH 120A,A01,085445,Eggers; John Dietrich,31,0,35,4
1649821309121,MATH 120A,A02,085446,Eggers; John Dietrich,31,0,35,4
1649821315150,MATH 142B,A01,084149,Verstraete; Jacques Allan,10,0,30,20
1649821315150,MATH 142B,A02,084150,Verstraete; Jacques Allan,25,0,30,5
1649821321177,MATH 170A,A01,083459,Nie; Jiawang,11,0,30,19
1649821321177,MATH 170A,A02,083460,Nie; Jiawang,25,0,30,5
1649821321177,MATH 170A,A03,083461,Nie; Jiawang,26,0,30,4
1649821327201,MATH 193B,A01,083463,Staff,18,0,30,12
1649821327201,MATH 193B,A02,083464,Staff,19,0,30,11
1649821327201,MATH 193B,A03,083465,Staff,27,0,30,3
1649821333252,COGS 2,A01,083966,Boyle; Mary E. T.,27,0,30,3
1649821339277,COGS 9,A01,083968,Staff,57,0,60,3
1649821345301,COGS 14B,A01,083970,Staff,48,0,50,2
1649821351327,COGS 17,A01,092679,Staff,73,0,75,2
1649821357354,COGS 100,A01,083972,Staff,47,0,60,13
1649821369400,COGS 101C,A01,083976,Staff,25,0,30,5
1649821375422,COGS 102A,A01,083978,Johnson; Christine M.,26,0,30,4
1649821381444,COGS 107B,A01,083980,Staff,40,0,50,10
1649821387471,COGS 115,A01,083982,Staff,22,0,30,8
1649821393494,COGS 118B,A01,083367,Staff,6,0,40,34
1649821399516,COGS 172,A01,083984,Provenzano; Emily Kara,22,0,30,8
1649821405541,COGS 177,A00,083368,Staff,6,0,30,24
1649821411564,COGS 186,A01,083986,Staff,25,0,40,15
1649821417591,COGS 187A,A01,083988,Boyle; Mary E. T.,41,0,60,19
1649821423615,CSE 8A,A50,084003,Miranda; Gregory Joseph,9,0,15,6
1649821429639,CSE 11,A01,084005,Miranda; Gregory Joseph,49,0,55,6
1649821435663,CSE 20,A01,084007,Staff,16,0,20,4
1649821441693,CSE 21,A01,084009,Staff,38,0,50,12
1649821447717,CSE 30,A01,083370,Cao; Yingjun,21,0,40,19
1649821453741,CSE 100,A01,083372,Cao; Yingjun,20,0,40,20
1649821459766,CSE 101,A01,084011,Staff,0,6,40,40
1649821465794,CSE 141,A01,083374,Eldon; John,0,4,75,75
1649821471817,CSE 141L,A01,083376,Eldon; John,0,6,75,75
1649821477840,CSE 175,A01,084013,Kumar; Rakesh,24,0,25,1
1649821483868,CSE 190,A00,092508,Staff,15,0,15,0
1649821489894,ECE 5,A01,084049,Morris; Karcher William,17,0,20,3
1649821495918,ECE 100,A01,084051,Baghdadchi; Saharnaz,16,0,20,4
1649821495918,ECE 100,A02,091916,Baghdadchi; Saharnaz,18,0,20,2
1649821501944,ECE 101,A01,084053,Baghdadchi; Saharnaz,25,0,37,12
1649821501944,ECE 101,A02,084054,Baghdadchi; Saharnaz,37,0,37,0
1649821507971,ECE 107,A01,083390,Staff,33,0,40,7
1649821513993,ECE 148,A01,084056,Silberman; Jack,8,0,12,4
1649821520018,ECE 180,A00,083391,Abi Samra; Nicholas Camill,27,0,30,3
1649821520018,ECE 180,B00,083392,Abi Samra; Nicholas Camill,26,0,30,4
1649821526041,MATH 10B,A01,084110,Staff,20,0,30,10
1649821526041,MATH 10B,A02,084111,Staff,29,0,30,1
1649821526041,MATH 10B,A03,084112,Staff,29,0,30,1
1649821532070,MATH 10C,A01,083443,Staff,20,0,30,10
1649821532070,MATH 10C,A02,083444,Staff,26,0,30,4
1649821532070,MATH 10C,B01,084114,Staff,26,0,30,4
1649821532070,MATH 10C,B02,084115,Staff,30,0,30,0
1649821538098,MATH 18,A01,084117,Harel; Guershon,28,0,30,2
1649821538098,MATH 18,A02,084119,Harel; Guershon,29,0,30,1
1649821538098,MATH 18,A03,084120,Harel; Guershon,30,0,30,0
1649821538098,MATH 18,A04,084121,Harel; Guershon,30,0,30,0
1649821544125,MATH 20B,A01,084124,Um; Ko Woon,33,0,35,2
1649821544125,MATH 20B,B01,084126,Um; Ko Woon,35,0,35,0
1649821550156,MATH 20C,A01,083446,Hammock; Frances H,27,0,30,3
1649821550156,MATH 20C,A02,083447,Hammock; Frances H,30,0,30,0
1649821550156,MATH 20C,A03,083448,Hammock; Frances H,30,0,30,0
1649821550156,MATH 20C,A04,083449,Hammock; Frances H,30,0,30,0
1649821550156,MATH 20C,B01,083451,Hammock; Frances H,29,0,30,1
1649821550156,MATH 20C,B02,083452,Hammock; Frances H,30,0,30,0
1649821550156,MATH 20C,B03,083453,Hammock; Frances H,30,0,30,0
1649821550156,MATH 20C,B04,083454,Hammock; Frances H,30,0,30,0
1649821556184,MATH 20D,A01,084128,Staff,29,0,30,1
1649821556184,MATH 20D,A02,084129,Staff,30,0,30,0
1649821556184,MATH 20D,A03,084130,Staff,29,0,30,1
1649821556184,MATH 20D,B01,084133,Staff,28,0,30,2
1649821556184,MATH 20D,B02,084134,Staff,30,0,30,0
1649821556184,MATH 20D,B03,084135,Staff,30,0,30,0
1649821562206,MATH 20E,A01,084138,Staff,29,0,30,1
1649821562206,MATH 20E,A02,084139,Staff,29,0,30,1
1649821562206,MATH 20E,A03,084140,Staff,29,0,30,1
1649821562206,MATH 20E,A04,084141,Staff,30,0,30,0
1649821568231,MATH 102,A01,084143,Harel; Guershon,24,0,30,6
1649821568231,MATH 102,A02,084144,Harel; Guershon,25,0,30,5
1649821574254,MATH 103B,A01,083456,Staff,0,0,30,30
1649821574254,MATH 103B,A02,083457,Staff,23,0,30,7
1649821580277,MATH 109,A01,084146,Salehi Golsefidy; Alireza,30,0,30,0
1649821580277,MATH 109,A02,084147,Salehi Golsefidy; Alireza,27,0,30,3
1649821586304,MATH 120A,A01,085445,Eggers; John Dietrich,31,0,35,4
1649821586304,MATH 120A,A02,085446,Eggers; John Dietrich,31,0,35,4
1649821592333,MATH 142B,A01,084149,Verstraete; Jacques Allan,10,0,30,20
1649821592333,MATH 142B,A02,084150,Verstraete; Jacques Allan,25,0,30,5
1649821598359,MATH 170A,A01,083459,Nie; Jiawang,11,0,30,19
1649821598359,MATH 170A,A02,083460,Nie; Jiawang,25,0,30,5
1649821598359,MATH 170A,A03,083461,Nie; Jiawang,26,0,30,4
1649821604382,MATH 193B,A01,083463,Staff,18,0,30,12
1649821604382,MATH 193B,A02,083464,Staff,19,0,30,11
1649821604382,MATH 193B,A03,083465,Staff,27,0,30,3
1649821610445,COGS 2,A01,083966,Boyle; Mary E. T.,27,0,30,3
1649821616471,COGS 9,A01,083968,Staff,57,0,60,3
1649821622502,COGS 14B,A01,083970,Staff,48,0,50,2
1649821628525,COGS 17,A01,092679,Staff,73,0,75,2
1649821634561,COGS 100,A01,083972,Staff,47,0,60,13
1649821646689,COGS 101C,A01,083976,Staff,25,0,30,5
1649821652712,COGS 102A,A01,083978,Johnson; Christine M.,26,0,30,4
1649821658734,COGS 107B,A01,083980,Staff,40,0,50,10
1649821664762,COGS 115,A01,083982,Staff,22,0,30,8
1649821670786,COGS 118B,A01,083367,Staff,6,0,40,34
1649821676809,COGS 172,A01,083984,Provenzano; Emily Kara,22,0,30,8
1649821682843,COGS 177,A00,083368,Staff,6,0,30,24
1649821688871,COGS 186,A01,083986,Staff,25,0,40,15
1649821694898,COGS 187A,A01,083988,Boyle; Mary E. T.,41,0,60,19
1649821700922,CSE 8A,A50,084003,Miranda; Gregory Joseph,9,0,15,6
1649821706945,CSE 11,A01,084005,Miranda; Gregory Joseph,49,0,55,6
1649821712973,CSE 20,A01,084007,Staff,16,0,20,4
1649821719000,CSE 21,A01,084009,Staff,38,0,50,12
1649821725030,CSE 30,A01,083370,Cao; Yingjun,21,0,40,19
1649821731053,CSE 100,A01,083372,Cao; Yingjun,20,0,40,20
1649821737076,CSE 101,A01,084011,Staff,0,6,40,40
1649821743103,CSE 141,A01,083374,Eldon; John,0,4,75,75
1649821749131,CSE 141L,A01,083376,Eldon; John,0,6,75,75
1649821755186,CSE 175,A01,084013,Kumar; Rakesh,24,0,25,1
1649821761209,CSE 190,A00,092508,Staff,15,0,15,0
1649821767231,ECE 5,A01,084049,Morris; Karcher William,17,0,20,3
1649821773259,ECE 100,A01,084051,Baghdadchi; Saharnaz,16,0,20,4
1649821773259,ECE 100,A02,091916,Baghdadchi; Saharnaz,18,0,20,2
1649821779286,ECE 101,A01,084053,Baghdadchi; Saharnaz,25,0,37,12
1649821779286,ECE 101,A02,084054,Baghdadchi; Saharnaz,37,0,37,0
1649821785310,ECE 107,A01,083390,Staff,33,0,40,7
1649821791340,ECE 148,A01,084056,Silberman; Jack,8,0,12,4
1649821797367,ECE 180,A00,083391,Abi Samra; Nicholas Camill,27,0,30,3
1649821797367,ECE 180,B00,083392,Abi Samra; Nicholas Camill,26,0,30,4
1649821803392,MATH 10B,A01,084110,Staff,20,0,30,10
1649821803392,MATH 10B,A02,084111,Staff,29,0,30,1
1649821803392,MATH 10B,A03,084112,Staff,29,0,30,1
1649821809419,MATH 10C,A01,083443,Staff,20,0,30,10
1649821809419,MATH 10C,A02,083444,Staff,26,0,30,4
1649821809419,MATH 10C,B01,084114,Staff,26,0,30,4
1649821809419,MATH 10C,B02,084115,Staff,30,0,30,0
1649821815456,MATH 18,A01,084117,Harel; Guershon,28,0,30,2
1649821815456,MATH 18,A02,084119,Harel; Guershon,29,0,30,1
1649821815456,MATH 18,A03,084120,Harel; Guershon,30,0,30,0
1649821815456,MATH 18,A04,084121,Harel; Guershon,30,0,30,0
1649821821479,MATH 20B,A01,084124,Um; Ko Woon,33,0,35,2
1649821821479,MATH 20B,B01,084126,Um; Ko Woon,35,0,35,0
1649821827508,MATH 20C,A01,083446,Hammock; Frances H,27,0,30,3
1649821827508,MATH 20C,A02,083447,Hammock; Frances H,30,0,30,0
1649821827508,MATH 20C,A03,083448,Hammock; Frances H,30,0,30,0
1649821827508,MATH 20C,A04,083449,Hammock; Frances H,30,0,30,0
1649821827508,MATH 20C,B01,083451,Hammock; Frances H,29,0,30,1
1649821827508,MATH 20C,B02,083452,Hammock; Frances H,30,0,30,0
1649821827508,MATH 20C,B03,083453,Hammock; Frances H,30,0,30,0
1649821827508,MATH 20C,B04,083454,Hammock; Frances H,30,0,30,0
1649821833545,MATH 20D,A01,084128,Staff,29,0,30,1
1649821833545,MATH 20D,A02,084129,Staff,30,0,30,0
1649821833545,MATH 20D,A03,084130,Staff,29,0,30,1
1649821833545,MATH 20D,B01,084133,Staff,28,0,30,2
1649821833545,MATH 20D,B02,084134,Staff,30,0,30,0
1649821833545,MATH 20D,B03,084135,Staff,30,0,30,0
1649821839570,MATH 20E,A01,084138,Staff,29,0,30,1
1649821839570,MATH 20E,A02,084139,Staff,29,0,30,1
1649821839570,MATH 20E,A03,084140,Staff,29,0,30,1
1649821839570,MATH 20E,A04,084141,Staff,30,0,30,0
1649821845594,MATH 102,A01,084143,Harel; Guershon,24,0,30,6
1649821845594,MATH 102,A02,084144,Harel; Guershon,25,0,30,5
1649821851618,MATH 103B,A01,083456,Staff,0,0,30,30
1649821851618,MATH 103B,A02,083457,Staff,23,0,30,7
1649821857639,MATH 109,A01,084146,Salehi Golsefidy; Alireza,30,0,30,0
1649821857639,MATH 109,A02,084147,Salehi Golsefidy; Alireza,27,0,30,3
1649821863676,MATH 120A,A01,085445,Eggers; John Dietrich,31,0,35,4
1649821863676,MATH 120A,A02,085446,Eggers; John Dietrich,31,0,35,4
1649821869699,MATH 142B,A01,084149,Verstraete; Jacques Allan,10,0,30,20
1649821869699,MATH 142B,A02,084150,Verstraete; Jacques Allan,25,0,30,5
1649821875727,MATH 170A,A01,083459,Nie; Jiawang,11,0,30,19
1649821875727,MATH 170A,A02,083460,Nie; Jiawang,25,0,30,5
1649821875727,MATH 170A,A03,083461,Nie; Jiawang,26,0,30,4
1649821881749,MATH 193B,A01,083463,Staff,18,0,30,12
1649821881749,MATH 193B,A02,083464,Staff,19,0,30,11
1649821881749,MATH 193B,A03,083465,Staff,27,0,30,3
1649821887798,COGS 2,A01,083966,Boyle; Mary E. T.,27,0,30,3
1649821893828,COGS 9,A01,083968,Staff,57,0,60,3
1649821899856,COGS 14B,A01,083970,Staff,48,0,50,2
1649821905886,COGS 17,A01,092679,Staff,73,0,75,2
1649821911916,COGS 100,A01,083972,Staff,47,0,60,13
1649821923970,COGS 101C,A01,083976,Staff,25,0,30,5
1649821929994,COGS 102A,A01,083978,Johnson; Christine M.,26,0,30,4
1649821936017,COGS 107B,A01,083980,Staff,40,0,50,10
1649821942050,COGS 115,A01,083982,Staff,22,0,30,8
1649821948074,COGS 118B,A01,083367,Staff,6,0,40,34
1649821954097,COGS 172,A01,083984,Provenzano; Emily Kara,22,0,30,8
1649821960124,COGS 177,A00,083368,Staff,6,0,30,24
1649821966151,COGS 186,A01,083986,Staff,25,0,40,15
1649821972174,COGS 187A,A01,083988,Boyle; Mary E. T.,41,0,60,19
1649821978202,CSE 8A,A50,084003,Miranda; Gregory Joseph,9,0,15,6
1649821984230,CSE 11,A01,084005,Miranda; Gregory Joseph,49,0,55,6
1649821990253,CSE 20,A01,084007,Staff,16,0,20,4
1649821996277,CSE 21,A01,084009,Staff,38,0,50,12
1649822002307,CSE 30,A01,083370,Cao; Yingjun,21,0,40,19
1649822008333,CSE 100,A01,083372,Cao; Yingjun,19,0,40,21
1649822014367,CSE 101,A01,084011,Staff,0,9,40,40
1649822020395,CSE 141,A01,083374,Eldon; John,0,5,75,75
1649822026430,CSE 141L,A01,083376,Eldon; John,0,7,75,75
1649822032457,CSE 175,A01,084013,Kumar; Rakesh,24,0,25,1
1649822038480,CSE 190,A00,092508,Staff,15,0,15,0
1649822044506,ECE 5,A01,084049,Morris; Karcher William,17,0,20,3
1649822050539,ECE 100,A01,084051,Baghdadchi; Saharnaz,16,0,20,4
1649822050539,ECE 100,A02,091916,Baghdadchi; Saharnaz,18,0,20,2
1649822056564,ECE 101,A01,084053,Baghdadchi; Saharnaz,25,0,37,12
1649822056564,ECE 101,A02,084054,Baghdadchi; Saharnaz,37,0,37,0
1649822062592,ECE 107,A01,083390,Staff,33,0,40,7
1649822068618,ECE 148,A01,084056,Silberman; Jack,8,0,12,4
1649822074642,ECE 180,A00,083391,Abi Samra; Nicholas Camill,27,0,30,3
1649822074642,ECE 180,B00,083392,Abi Samra; Nicholas Camill,26,0,30,4
1649822080679,MATH 10B,A01,084110,Staff,20,0,30,10
1649822080679,MATH 10B,A02,084111,Staff,29,0,30,1
1649822080679,MATH 10B,A03,084112,Staff,29,0,30,1
1649822086707,MATH 10C,A01,083443,Staff,20,0,30,10
1649822086707,MATH 10C,A02,083444,Staff,25,0,30,5
1649822086707,MATH 10C,B01,084114,Staff,26,0,30,4
1649822086707,MATH 10C,B02,084115,Staff,30,0,30,0
1649822092729,MATH 18,A01,084117,Harel; Guershon,28,0,30,2
1649822092729,MATH 18,A02,084119,Harel; Guershon,29,0,30,1
1649822092729,MATH 18,A03,084120,Harel; Guershon,30,0,30,0
1649822092729,MATH 18,A04,084121,Harel; Guershon,30,0,30,0
1649822098765,MATH 20B,A01,084124,Um; Ko Woon,33,0,35,2
1649822098765,MATH 20B,B01,084126,Um; Ko Woon,35,0,35,0
1649822104798,MATH 20C,A01,083446,Hammock; Frances H,27,0,30,3
1649822104798,MATH 20C,A02,083447,Hammock; Frances H,30,0,30,0
1649822104798,MATH 20C,A03,083448,Hammock; Frances H,30,0,30,0
1649822104798,MATH 20C,A04,083449,Hammock; Frances H,30,0,30,0
1649822104798,MATH 20C,B01,083451,Hammock; Frances H,29,0,30,1
1649822104798,MATH 20C,B02,083452,Hammock; Frances H,30,0,30,0
1649822104798,MATH 20C,B03,083453,Hammock; Frances H,30,0,30,0
1649822104798,MATH 20C,B04,083454,Hammock; Frances H,30,0,30,0
1649822110826,MATH 20D,A01,084128,Staff,29,0,30,1
1649822110826,MATH 20D,A02,084129,Staff,30,0,30,0
1649822110826,MATH 20D,A03,084130,Staff,29,0,30,1
1649822110826,MATH 20D,B01,084133,Staff,28,0,30,2
1649822110826,MATH 20D,B02,084134,Staff,30,0,30,0
1649822110826,MATH 20D,B03,084135,Staff,30,0,30,0
1649822116850,MATH 20E,A01,084138,Staff,29,0,30,1
1649822116850,MATH 20E,A02,084139,Staff,29,0,30,1
1649822116850,MATH 20E,A03,084140,Staff,29,0,30,1
1649822116850,MATH 20E,A04,084141,Staff,30,0,30,0
1649822122877,MATH 102,A01,084143,Harel; Guershon,24,0,30,6
1649822122877,MATH 102,A02,084144,Harel; Guershon,25,0,30,5
1649822128904,MATH 103B,A01,083456,Staff,0,0,30,30
1649822128904,MATH 103B,A02,083457,Staff,23,0,30,7
1649822134934,MATH 109,A01,084146,Salehi Golsefidy; Alireza,30,0,30,0
1649822134934,MATH 109,A02,084147,Salehi Golsefidy; Alireza,27,0,30,3
1649822140965,MATH 120A,A01,085445,Eggers; John Dietrich,31,0,35,4
1649822140965,MATH 120A,A02,085446,Eggers; John Dietrich,31,0,35,4
1649822146993,MATH 142B,A01,084149,Verstraete; Jacques Allan,10,0,30,20
1649822146993,MATH 142B,A02,084150,Verstraete; Jacques Allan,25,0,30,5
1649822153020,MATH 170A,A01,083459,Nie; Jiawang,11,0,30,19
1649822153020,MATH 170A,A02,083460,Nie; Jiawang,25,0,30,5
1649822153020,MATH 170A,A03,083461,Nie; Jiawang,26,0,30,4
1649822159047,MATH 193B,A01,083463,Staff,18,0,30,12
1649822159047,MATH 193B,A02,083464,Staff,19,0,30,11
1649822159047,MATH 193B,A03,083465,Staff,27,0,30,3
1649822165104,COGS 2,A01,083966,Boyle; Mary E. T.,27,0,30,3
1649822171127,COGS 9,A01,083968,Staff,57,0,60,3
1649822177154,COGS 14B,A01,083970,Staff,48,0,50,2
1649822183177,COGS 17,A01,092679,Staff,73,0,75,2
1649822189205,COGS 100,A01,083972,Staff,47,0,60,13
1649822201251,COGS 101C,A01,083976,Staff,25,0,30,5
1649822207278,COGS 102A,A01,083978,Johnson; Christine M.,24,0,30,6
1649822213304,COGS 107B,A01,083980,Staff,40,0,50,10
1649822219327,COGS 115,A01,083982,Staff,22,0,30,8
1649822225357,COGS 118B,A01,083367,Staff,6,0,40,34
1649822231381,COGS 172,A01,083984,Provenzano; Emily Kara,22,0,30,8
1649822237501,COGS 177,A00,083368,Staff,6,0,30,24
1649822243527,COGS 186,A01,083986,Staff,25,0,40,15
1649822249548,COGS 187A,A01,083988,Boyle; Mary E. T.,41,0,60,19
1649822255572,CSE 8A,A50,084003,Miranda; Gregory Joseph,9,0,15,6
1649822261598,CSE 11,A01,084005,Miranda; Gregory Joseph,49,0,55,6
1649822267625,CSE 20,A01,084007,Staff,16,0,20,4
1649822273649,CSE 21,A01,084009,Staff,38,0,50,12
1649822279671,CSE 30,A01,083370,Cao; Yingjun,21,0,40,19
1649822285697,CSE 100,A01,083372,Cao; Yingjun,19,0,40,21
1649822291719,CSE 101,A01,084011,Staff,0,10,40,40
1649822297742,CSE 141,A01,083374,Eldon; John,0,6,75,75
1649822303766,CSE 141L,A01,083376,Eldon; John,0,8,75,75
1649822309796,CSE 175,A01,084013,Kumar; Rakesh,24,0,25,1
1649822315831,CSE 190,A00,092508,Staff,15,0,15,0
1649822321854,ECE 5,A01,084049,Morris; Karcher William,17,0,20,3
1649822327881,ECE 100,A01,084051,Baghdadchi; Saharnaz,16,0,20,4
1649822327881,ECE 100,A02,091916,Baghdadchi; Saharnaz,18,0,20,2
1649822333916,ECE 101,A01,084053,Baghdadchi; Saharnaz,25,0,37,12
1649822333916,ECE 101,A02,084054,Baghdadchi; Saharnaz,37,0,37,0
1649822339941,ECE 107,A01,083390,Staff,33,0,40,7
1649822345968,ECE 148,A01,084056,Silberman; Jack,8,0,12,4
1649822351995,ECE 180,A00,083391,Abi Samra; Nicholas Camill,27,0,30,3
1649822351995,ECE 180,B00,083392,Abi Samra; Nicholas Camill,26,0,30,4
1649822358021,MATH 10B,A01,084110,Staff,20,0,30,10
1649822358021,MATH 10B,A02,084111,Staff,29,0,30,1
1649822358021,MATH 10B,A03,084112,Staff,29,0,30,1
1649822364044,MATH 10C,A01,083443,Staff,20,0,30,10
1649822364044,MATH 10C,A02,083444,Staff,25,0,30,5
1649822364044,MATH 10C,B01,084114,Staff,26,0,30,4
1649822364044,MATH 10C,B02,084115,Staff,30,0,30,0
1649822370067,MATH 18,A01,084117,Harel; Guershon,28,0,30,2
1649822370067,MATH 18,A02,084119,Harel; Guershon,29,0,30,1
1649822370067,MATH 18,A03,084120,Harel; Guershon,30,0,30,0
1649822370067,MATH 18,A04,084121,Harel; Guershon,30,0,30,0
1649822376095,MATH 20B,A01,084124,Um; Ko Woon,33,0,35,2
1649822376095,MATH 20B,B01,084126,Um; Ko Woon,35,0,35,0
1649822382120,MATH 20C,A01,083446,Hammock; Frances H,27,0,30,3
1649822382120,MATH 20C,A02,083447,Hammock; Frances H,30,0,30,0
1649822382120,MATH 20C,A03,083448,Hammock; Frances H,30,0,30,0
1649822382120,MATH 20C,A04,083449,Hammock; Frances H,30,0,30,0
1649822382120,MATH 20C,B01,083451,Hammock; Frances H,29,0,30,1
1649822382120,MATH 20C,B02,083452,Hammock; Frances H,30,0,30,0
1649822382120,MATH 20C,B03,083453,Hammock; Frances H,30,0,30,0
1649822382120,MATH 20C,B04,083454,Hammock; Frances H,30,0,30,0
1649822388148,MATH 20D,A01,084128,Staff,29,0,30,1
1649822388148,MATH 20D,A02,084129,Staff,30,0,30,0
1649822388148,MATH 20D,A03,084130,Staff,29,0,30,1
1649822388148,MATH 20D,B01,084133,Staff,28,0,30,2
1649822388148,MATH 20D,B02,084134,Staff,30,0,30,0
1649822388148,MATH 20D,B03,084135,Staff,30,0,30,0
1649822394174,MATH 20E,A01,084138,Staff,29,0,30,1
1649822394174,MATH 20E,A02,084139,Staff,29,0,30,1
1649822394174,MATH 20E,A03,084140,Staff,28,0,30,2
1649822394174,MATH 20E,A04,084141,Staff,30,0,30,0
1649822400197,MATH 102,A01,084143,Harel; Guershon,24,0,30,6
1649822400197,MATH 102,A02,084144,Harel; Guershon,25,0,30,5
1649822406222,MATH 103B,A01,083456,Staff,0,0,30,30
1649822406222,MATH 103B,A02,083457,Staff,23,0,30,7
1649822412244,MATH 109,A01,084146,Salehi Golsefidy; Alireza,30,0,30,0
1649822412244,MATH 109,A02,084147,Salehi Golsefidy; Alireza,27,0,30,3
1649822418272,MATH 120A,A01,085445,Eggers; John Dietrich,31,0,35,4
1649822418272,MATH 120A,A02,085446,Eggers; John Dietrich,31,0,35,4
1649822424298,MATH 142B,A01,084149,Verstraete; Jacques Allan,10,0,30,20
1649822424298,MATH 142B,A02,084150,Verstraete; Jacques Allan,25,0,30,5
1649822430333,MATH 170A,A01,083459,Nie; Jiawang,11,0,30,19
1649822430333,MATH 170A,A02,083460,Nie; Jiawang,25,0,30,5
1649822430333,MATH 170A,A03,083461,Nie; Jiawang,26,0,30,4
1649822436356,MATH 193B,A01,083463,Staff,18,0,30,12
1649822436356,MATH 193B,A02,083464,Staff,19,0,30,11
1649822436356,MATH 193B,A03,083465,Staff,27,0,30,3
1649822442417,COGS 2,A01,083966,Boyle; Mary E. T.,27,0,30,3
1649822448444,COGS 9,A01,083968,Staff,57,0,60,3
1649822454476,COGS 14B,A01,083970,Staff,48,0,50,2
1649822460499,COGS 17,A01,092679,Staff,73,0,75,2
1649822466522,COGS 100,A01,083972,Staff,47,0,60,13
1649822478573,COGS 101C,A01,083976,Staff,25,0,30,5
1649822484596,COGS 102A,A01,083978,Johnson; Christine M.,24,0,30,6
1649822490619,COGS 107B,A01,083980,Staff,40,0,50,10
1649822496651,COGS 115,A01,083982,Staff,22,0,30,8
1649822502675,COGS 118B,A01,083367,Staff,6,0,40,34
1649822508703,COGS 172,A01,083984,Provenzano; Emily Kara,22,0,30,8
1649822514729,COGS 177,A00,083368,Staff,6,0,30,24
1649822520755,COGS 186,A01,083986,Staff,25,0,40,15
1649822526778,COGS 187A,A01,083988,Boyle; Mary E. T.,41,0,60,19
1649822532807,CSE 8A,A50,084003,Miranda; Gregory Joseph,9,0,15,6
1649822538838,CSE 11,A01,084005,Miranda; Gregory Joseph,49,0,55,6
1649822544865,CSE 20,A01,084007,Staff,16,0,20,4
1649822550888,CSE 21,A01,084009,Staff,38,0,50,12
1649822556913,CSE 30,A01,083370,Cao; Yingjun,21,0,40,19
1649822562939,CSE 100,A01,083372,Cao; Yingjun,19,0,40,21
1649822568974,CSE 101,A01,084011,Staff,0,10,40,40
1649822575005,CSE 141,A01,083374,Eldon; John,0,6,75,75
1649822581032,CSE 141L,A01,083376,Eldon; John,0,8,75,75
1649822587063,CSE 175,A01,084013,Kumar; Rakesh,24,0,25,1
1649822593085,CSE 190,A00,092508,Staff,15,0,15,0
1649822599113,ECE 5,A01,084049,Morris; Karcher William,17,0,20,3
1649822605138,ECE 100,A01,084051,Baghdadchi; Saharnaz,16,0,20,4
1649822605138,ECE 100,A02,091916,Baghdadchi; Saharnaz,18,0,20,2
1649822611162,ECE 101,A01,084053,Baghdadchi; Saharnaz,25,0,37,12
1649822611162,ECE 101,A02,084054,Baghdadchi; Saharnaz,37,0,37,0
1649822617185,ECE 107,A01,083390,Staff,33,0,40,7
1649822623214,ECE 148,A01,084056,Silberman; Jack,8,0,12,4
1649822629243,ECE 180,A00,083391,Abi Samra; Nicholas Camill,27,0,30,3
1649822629243,ECE 180,B00,083392,Abi Samra; Nicholas Camill,26,0,30,4
1649822635265,MATH 10B,A01,084110,Staff,20,0,30,10
1649822635265,MATH 10B,A02,084111,Staff,29,0,30,1
1649822635265,MATH 10B,A03,084112,Staff,29,0,30,1
1649822641289,MATH 10C,A01,083443,Staff,20,0,30,10
1649822641289,MATH 10C,A02,083444,Staff,25,0,30,5
1649822641289,MATH 10C,B01,084114,Staff,26,0,30,4
1649822641289,MATH 10C,B02,084115,Staff,30,0,30,0
1649822647321,MATH 18,A01,084117,Harel; Guershon,28,0,30,2
1649822647321,MATH 18,A02,084119,Harel; Guershon,29,0,30,1
1649822647321,MATH 18,A03,084120,Harel; Guershon,30,0,30,0
1649822647321,MATH 18,A04,084121,Harel; Guershon,30,0,30,0
1649822653350,MATH 20B,A01,084124,Um; Ko Woon,33,0,35,2
1649822653350,MATH 20B,B01,084126,Um; Ko Woon,35,0,35,0
1649822659377,MATH 20C,A01,083446,Hammock; Frances H,27,0,30,3
1649822659377,MATH 20C,A02,083447,Hammock; Frances H,30,0,30,0
1649822659377,MATH 20C,A03,083448,Hammock; Frances H,30,0,30,0
1649822659377,MATH 20C,A04,083449,Hammock; Frances H,30,0,30,0
1649822659377,MATH 20C,B01,083451,Hammock; Frances H,29,0,30,1
1649822659377,MATH 20C,B02,083452,Hammock; Frances H,30,0,30,0
1649822659377,MATH 20C,B03,083453,Hammock; Frances H,30,0,30,0
1649822659377,MATH 20C,B04,083454,Hammock; Frances H,30,0,30,0
1649822665405,MATH 20D,A01,084128,Staff,29,0,30,1
1649822665405,MATH 20D,A02,084129,Staff,30,0,30,0
1649822665405,MATH 20D,A03,084130,Staff,29,0,30,1
1649822665405,MATH 20D,B01,084133,Staff,28,0,30,2
1649822665405,MATH 20D,B02,084134,Staff,30,0,30,0
1649822665405,MATH 20D,B03,084135,Staff,30,0,30,0
1649822671431,MATH 20E,A01,084138,Staff,29,0,30,1
1649822671431,MATH 20E,A02,084139,Staff,29,0,30,1
1649822671431,MATH 20E,A03,084140,Staff,28,0,30,2
1649822671431,MATH 20E,A04,084141,Staff,30,0,30,0
1649822677453,MATH 102,A01,084143,Harel; Guershon,24,0,30,6
1649822677453,MATH 102,A02,084144,Harel; Guershon,25,0,30,5
1649822683476,MATH 103B,A01,083456,Staff,0,0,30,30
1649822683476,MATH 103B,A02,083457,Staff,22,0,30,8
1649822689509,MATH 109,A01,084146,Salehi Golsefidy; Alireza,30,0,30,0
1649822689509,MATH 109,A02,084147,Salehi Golsefidy; Alireza,27,0,30,3
1649822695543,MATH 120A,A01,085445,Eggers; John Dietrich,31,0,35,4
1649822695543,MATH 120A,A02,085446,Eggers; John Dietrich,31,0,35,4
1649822701569,MATH 142B,A01,084149,Verstraete; Jacques Allan,10,0,30,20
1649822701569,MATH 142B,A02,084150,Verstraete; Jacques Allan,25,0,30,5
1649822707598,MATH 170A,A01,083459,Nie; Jiawang,11,0,30,19
1649822707598,MATH 170A,A02,083460,Nie; Jiawang,25,0,30,5
1649822707598,MATH 170A,A03,083461,Nie; Jiawang,26,0,30,4
1649822713625,MATH 193B,A01,083463,Staff,18,0,30,12
1649822713625,MATH 193B,A02,083464,Staff,19,0,30,11
1649822713625,MATH 193B,A03,083465,Staff,27,0,30,3
1649822719680,COGS 2,A01,083966,Boyle; Mary E. T.,27,0,30,3
1649822725703,COGS 9,A01,083968,Staff,57,0,60,3
1649822731728,COGS 14B,A01,083970,Staff,48,0,50,2
1649822737755,COGS 17,A01,092679,Staff,73,0,75,2
1649822743782,COGS 100,A01,083972,Staff,47,0,60,13
1649822755834,COGS 101C,A01,083976,Staff,25,0,30,5
1649822761860,COGS 102A,A01,083978,Johnson; Christine M.,24,0,30,6
1649822767894,COGS 107B,A01,083980,Staff,40,0,50,10
1649822773920,COGS 115,A01,083982,Staff,22,0,30,8
1649822779943,COGS 118B,A01,083367,Staff,6,0,40,34
1649822785964,COGS 172,A01,083984,Provenzano; Emily Kara,22,0,30,8
1649822791985,COGS 177,A00,083368,Staff,6,0,30,24
1649822798011,COGS 186,A01,083986,Staff,25,0,40,15
1649822804039,COGS 187A,A01,083988,Boyle; Mary E. T.,41,0,60,19
1649822810061,CSE 8A,A50,084003,Miranda; Gregory Joseph,9,0,15,6
1649822816085,CSE 11,A01,084005,Miranda; Gregory Joseph,49,0,55,6
1649822822113,CSE 20,A01,084007,Staff,16,0,20,4
1649822828147,CSE 21,A01,084009,Staff,38,0,50,12
1649822834955,CSE 30,A01,083370,Cao; Yingjun,20,0,40,20
1649822840981,CSE 100,A01,083372,Cao; Yingjun,19,0,40,21
1649822847004,CSE 101,A01,084011,Staff,0,10,40,40
1649822853027,CSE 141,A01,083374,Eldon; John,0,6,75,75
1649822859050,CSE 141L,A01,083376,Eldon; John,0,8,75,75
1649822865074,CSE 175,A01,084013,Kumar; Rakesh,24,0,25,1
1649822871100,CSE 190,A00,092508,Staff,15,0,15,0
1649822877128,ECE 5,A01,084049,Morris; Karcher William,17,0,20,3
1649822883151,ECE 100,A01,084051,Baghdadchi; Saharnaz,16,0,20,4
1649822883151,ECE 100,A02,091916,Baghdadchi; Saharnaz,18,0,20,2
1649822889176,ECE 101,A01,084053,Baghdadchi; Saharnaz,25,0,37,12
1649822889176,ECE 101,A02,084054,Baghdadchi; Saharnaz,37,0,37,0
1649822895202,ECE 107,A01,083390,Staff,33,0,40,7
1649822901225,ECE 148,A01,084056,Silberman; Jack,8,0,12,4
1649822907250,ECE 180,A00,083391,Abi Samra; Nicholas Camill,27,0,30,3
1649822907250,ECE 180,B00,083392,Abi Samra; Nicholas Camill,26,0,30,4
1649822913274,MATH 10B,A01,084110,Staff,20,0,30,10
1649822913274,MATH 10B,A02,084111,Staff,29,0,30,1
1649822913274,MATH 10B,A03,084112,Staff,29,0,30,1
1649822919296,MATH 10C,A01,083443,Staff,20,0,30,10
1649822919296,MATH 10C,A02,083444,Staff,25,0,30,5
1649822919296,MATH 10C,B01,084114,Staff,26,0,30,4
1649822919296,MATH 10C,B02,084115,Staff,30,0,30,0
1649822925327,MATH 18,A01,084117,Harel; Guershon,28,0,30,2
1649822925327,MATH 18,A02,084119,Harel; Guershon,29,0,30,1
1649822925327,MATH 18,A03,084120,Harel; Guershon,30,0,30,0
1649822925327,MATH 18,A04,084121,Harel; Guershon,30,0,30,0
1649822931360,MATH 20B,A01,084124,Um; Ko Woon,33,0,35,2
1649822931360,MATH 20B,B01,084126,Um; Ko Woon,35,0,35,0
1649822937383,MATH 20C,A01,083446,Hammock; Frances H,27,0,30,3
1649822937383,MATH 20C,A02,083447,Hammock; Frances H,30,0,30,0
1649822937383,MATH 20C,A03,083448,Hammock; Frances H,30,0,30,0
1649822937383,MATH 20C,A04,083449,Hammock; Frances H,30,0,30,0
1649822937383,MATH 20C,B01,083451,Hammock; Frances H,29,0,30,1
1649822937383,MATH 20C,B02,083452,Hammock; Frances H,30,0,30,0
1649822937383,MATH 20C,B03,083453,Hammock; Frances H,30,0,30,0
1649822937383,MATH 20C,B04,083454,Hammock; Frances H,30,0,30,0
1649822943412,MATH 20D,A01,084128,Staff,29,0,30,1
1649822943412,MATH 20D,A02,084129,Staff,30,0,30,0
1649822943412,MATH 20D,A03,084130,Staff,29,0,30,1
1649822943412,MATH 20D,B01,084133,Staff,28,0,30,2
1649822943412,MATH 20D,B02,084134,Staff,30,0,30,0
1649822943412,MATH 20D,B03,084135,Staff,30,0,30,0
1649822949439,MATH 20E,A01,084138,Staff,29,0,30,1
1649822949439,MATH 20E,A02,084139,Staff,29,0,30,1
1649822949439,MATH 20E,A03,084140,Staff,28,0,30,2
1649822949439,MATH 20E,A04,084141,Staff,30,0,30,0
1649822955464,MATH 102,A01,084143,Harel; Guershon,24,0,30,6
1649822955464,MATH 102,A02,084144,Harel; Guershon,25,0,30,5
1649822961490,MATH 103B,A01,083456,Staff,0,0,30,30
1649822961490,MATH 103B,A02,083457,Staff,22,0,30,8
1649822967515,MATH 109,A01,084146,Salehi Golsefidy; Alireza,30,0,30,0
1649822967515,MATH 109,A02,084147,Salehi Golsefidy; Alireza,27,0,30,3
1649822973537,MATH 120A,A01,085445,Eggers; John Dietrich,31,0,35,4
1649822973537,MATH 120A,A02,085446,Eggers; John Dietrich,31,0,35,4
1649822979571,MATH 142B,A01,084149,Verstraete; Jacques Allan,10,0,30,20
1649822979571,MATH 142B,A02,084150,Verstraete; Jacques Allan,25,0,30,5
1649822985595,MATH 170A,A01,083459,Nie; Jiawang,11,0,30,19
1649822985595,MATH 170A,A02,083460,Nie; Jiawang,25,0,30,5
1649822985595,MATH 170A,A03,083461,Nie; Jiawang,26,0,30,4
1649822991623,MATH 193B,A01,083463,Staff,18,0,30,12
1649822991623,MATH 193B,A02,083464,Staff,19,0,30,11
1649822991623,MATH 193B,A03,083465,Staff,27,0,30,3
1649822997685,COGS 2,A01,083966,Boyle; Mary E. T.,27,0,30,3
1649823003709,COGS 9,A01,083968,Staff,57,0,60,3
1649823009734,COGS 14B,A01,083970,Staff,48,0,50,2
1649823015758,COGS 17,A01,092679,Staff,73,0,75,2
1649823021790,COGS 100,A01,083972,Staff,47,0,60,13
1649823033839,COGS 101C,A01,083976,Staff,25,0,30,5
1649823039867,COGS 102A,A01,083978,Johnson; Christine M.,24,0,30,6
1649823045892,COGS 107B,A01,083980,Staff,40,0,50,10
1649823051915,COGS 115,A01,083982,Staff,22,0,30,8
1649823057938,COGS 118B,A01,083367,Staff,6,0,40,34
1649823063962,COGS 172,A01,083984,Provenzano; Emily Kara,22,0,30,8
1649823069985,COGS 177,A00,083368,Staff,6,0,30,24
1649823076012,COGS 186,A01,083986,Staff,25,0,40,15
1649823082036,COGS 187A,A01,083988,Boyle; Mary E. T.,41,0,60,19
1649823088060,CSE 8A,A50,084003,Miranda; Gregory Joseph,9,0,15,6
1649823094101,CSE 11,A01,084005,Miranda; Gregory Joseph,49,0,55,6
1649823100127,CSE 20,A01,084007,Staff,15,0,20,5
1649823106154,CSE 21,A01,084009,Staff,38,0,50,12
1649823112193,CSE 30,A01,083370,Cao; Yingjun,20,0,40,20
1649823118226,CSE 100,A01,083372,Cao; Yingjun,19,0,40,21
1649823124249,CSE 101,A01,084011,Staff,0,10,40,40
1649823130274,CSE 141,A01,083374,Eldon; John,0,6,75,75
1649823136300,CSE 141L,A01,083376,Eldon; John,0,8,75,75
1649823142332,CSE 175,A01,084013,Kumar; Rakesh,24,0,25,1
1649823148356,CSE 190,A00,092508,Staff,15,0,15,0
1649823154378,ECE 5,A01,084049,Morris; Karcher William,17,0,20,3
1649823160402,ECE 100,A01,084051,Baghdadchi; Saharnaz,16,0,20,4
1649823160402,ECE 100,A02,091916,Baghdadchi; Saharnaz,18,0,20,2
1649823166425,ECE 101,A01,084053,Baghdadchi; Saharnaz,25,0,37,12
1649823166425,ECE 101,A02,084054,Baghdadchi; Saharnaz,37,0,37,0
1649823172451,ECE 107,A01,083390,Staff,33,0,40,7
1649823178473,ECE 148,A01,084056,Silberman; Jack,8,0,12,4
1649823184495,ECE 180,A00,083391,Abi Samra; Nicholas Camill,27,0,30,3
1649823184495,ECE 180,B00,083392,Abi Samra; Nicholas Camill,26,0,30,4
1649823190522,MATH 10B,A01,084110,Staff,20,0,30,10
1649823190522,MATH 10B,A02,084111,Staff,29,0,30,1
1649823190522,MATH 10B,A03,084112,Staff,29,0,30,1
1649823196548,MATH 10C,A01,083443,Staff,20,0,30,10
1649823196548,MATH 10C,A02,083444,Staff,25,0,30,5
1649823196548,MATH 10C,B01,084114,Staff,26,0,30,4
1649823196548,MATH 10C,B02,084115,Staff,30,0,30,0
1649823202579,MATH 18,A01,084117,Harel; Guershon,28,0,30,2
1649823202579,MATH 18,A02,084119,Harel; Guershon,29,0,30,1
1649823202579,MATH 18,A03,084120,Harel; Guershon,30,0,30,0
1649823202579,MATH 18,A04,084121,Harel; Guershon,30,0,30,0
1649823208606,MATH 20B,A01,084124,Um; Ko Woon,33,0,35,2
1649823208606,MATH 20B,B01,084126,Um; Ko Woon,35,0,35,0
1649823214640,MATH 20C,A01,083446,Hammock; Frances H,27,0,30,3
1649823214640,MATH 20C,A02,083447,Hammock; Frances H,30,0,30,0
1649823214640,MATH 20C,A03,083448,Hammock; Frances H,30,0,30,0
1649823214640,MATH 20C,A04,083449,Hammock; Frances H,30,0,30,0
1649823214640,MATH 20C,B01,083451,Hammock; Frances H,29,0,30,1
1649823214640,MATH 20C,B02,083452,Hammock; Frances H,30,0,30,0
1649823214640,MATH 20C,B03,083453,Hammock; Frances H,30,0,30,0
1649823214640,MATH 20C,B04,083454,Hammock; Frances H,30,0,30,0
1649823220671,MATH 20D,A01,084128,Staff,29,0,30,1
1649823220671,MATH 20D,A02,084129,Staff,30,0,30,0
1649823220671,MATH 20D,A03,084130,Staff,29,0,30,1
1649823220671,MATH 20D,B01,084133,Staff,28,0,30,2
1649823220671,MATH 20D,B02,084134,Staff,30,0,30,0
1649823220671,MATH 20D,B03,084135,Staff,30,0,30,0
1649823226698,MATH 20E,A01,084138,Staff,29,0,30,1
1649823226698,MATH 20E,A02,084139,Staff,29,0,30,1
1649823226698,MATH 20E,A03,084140,Staff,28,0,30,2
1649823226698,MATH 20E,A04,084141,Staff,30,0,30,0
1649823232721,MATH 102,A01,084143,Harel; Guershon,24,0,30,6
1649823232721,MATH 102,A02,084144,Harel; Guershon,25,0,30,5
1649823238744,MATH 103B,A01,083456,Staff,0,0,30,30
1649823238744,MATH 103B,A02,083457,Staff,22,0,30,8
1649823244772,MATH 109,A01,084146,Salehi Golsefidy; Alireza,30,0,30,0
1649823244772,MATH 109,A02,084147,Salehi Golsefidy; Alireza,27,0,30,3
1649823250797,MATH 120A,A01,085445,Eggers; John Dietrich,31,0,35,4
1649823250797,MATH 120A,A02,085446,Eggers; John Dietrich,31,0,35,4
1649823256820,MATH 142B,A01,084149,Verstraete; Jacques Allan,10,0,30,20
1649823256820,MATH 142B,A02,084150,Verstraete; Jacques Allan,25,0,30,5
1649823262841,MATH 170A,A01,083459,Nie; Jiawang,11,0,30,19
1649823262841,MATH 170A,A02,083460,Nie; Jiawang,25,0,30,5
1649823262841,MATH 170A,A03,083461,Nie; Jiawang,26,0,30,4
1649823268867,MATH 193B,A01,083463,Staff,18,0,30,12
1649823268867,MATH 193B,A02,083464,Staff,19,0,30,11
1649823268867,MATH 193B,A03,083465,Staff,27,0,30,3
1649823274938,COGS 2,A01,083966,Boyle; Mary E. T.,27,0,30,3
1649823280960,COGS 9,A01,083968,Staff,57,0,60,3
1649823286984,COGS 14B,A01,083970,Staff,48,0,50,2
1649823293009,COGS 17,A01,092679,Staff,73,0,75,2
1649823299031,COGS 100,A01,083972,Staff,47,0,60,13
1649823311078,COGS 101C,A01,083976,Staff,25,0,30,5
1649823317104,COGS 102A,A01,083978,Johnson; Christine M.,24,0,30,6
1649823323137,COGS 107B,A01,083980,Staff,40,0,50,10
1649823329159,COGS 115,A01,083982,Staff,22,0,30,8
1649823335183,COGS 118B,A01,083367,Staff,6,0,40,34
1649823341209,COGS 172,A01,083984,Provenzano; Emily Kara,22,0,30,8
1649823347231,COGS 177,A00,083368,Staff,6,0,30,24
1649823353255,COGS 186,A01,083986,Staff,25,0,40,15
1649823359282,COGS 187A,A01,083988,Boyle; Mary E. T.,41,0,60,19
1649823365305,CSE 8A,A50,084003,Miranda; Gregory Joseph,9,0,15,6
1649823371333,CSE 11,A01,084005,Miranda; Gregory Joseph,49,0,55,6
1649823377354,CSE 20,A01,084007,Staff,15,0,20,5
1649823383377,CSE 21,A01,084009,Staff,38,0,50,12
1649823389403,CSE 30,A01,083370,Cao; Yingjun,20,0,40,20
1649823395429,CSE 100,A01,083372,Cao; Yingjun,18,0,40,22
1649823401452,CSE 101,A01,084011,Staff,0,10,40,40
1649823407475,CSE 141,A01,083374,Eldon; John,0,6,75,75
1649823413512,CSE 141L,A01,083376,Eldon; John,0,8,75,75
1649823419537,CSE 175,A01,084013,Kumar; Rakesh,24,0,25,1
1649823425567,CSE 190,A00,092508,Staff,15,0,15,0
1649823431665,ECE 5,A01,084049,Morris; Karcher William,17,0,20,3
1649823437692,ECE 100,A01,084051,Baghdadchi; Saharnaz,16,0,20,4
1649823437692,ECE 100,A02,091916,Baghdadchi; Saharnaz,18,0,20,2
1649823443719,ECE 101,A01,084053,Baghdadchi; Saharnaz,25,0,37,12
1649823443719,ECE 101,A02,084054,Baghdadchi; Saharnaz,37,0,37,0
1649823449746,ECE 107,A01,083390,Staff,33,0,40,7
1649823455777,ECE 148,A01,084056,Silberman; Jack,8,0,12,4
1649823461800,ECE 180,A00,083391,Abi Samra; Nicholas Camill,27,0,30,3
1649823461800,ECE 180,B00,083392,Abi Samra; Nicholas Camill,26,0,30,4
1649823467825,MATH 10B,A01,084110,Staff,20,0,30,10
1649823467825,MATH 10B,A02,084111,Staff,29,0,30,1
1649823467825,MATH 10B,A03,084112,Staff,29,0,30,1
1649823473853,MATH 10C,A01,083443,Staff,20,0,30,10
1649823473853,MATH 10C,A02,083444,Staff,25,0,30,5
1649823473853,MATH 10C,B01,084114,Staff,26,0,30,4
1649823473853,MATH 10C,B02,084115,Staff,30,0,30,0
1649823479882,MATH 18,A01,084117,Harel; Guershon,28,0,30,2
1649823479882,MATH 18,A02,084119,Harel; Guershon,29,0,30,1
1649823479882,MATH 18,A03,084120,Harel; Guershon,30,0,30,0
1649823479882,MATH 18,A04,084121,Harel; Guershon,30,0,30,0
1649823485909,MATH 20B,A01,084124,Um; Ko Woon,33,0,35,2
1649823485909,MATH 20B,B01,084126,Um; Ko Woon,35,0,35,0
1649823491943,MATH 20C,A01,083446,Hammock; Frances H,27,0,30,3
1649823491943,MATH 20C,A02,083447,Hammock; Frances H,30,0,30,0
1649823491943,MATH 20C,A03,083448,Hammock; Frances H,30,0,30,0
1649823491943,MATH 20C,A04,083449,Hammock; Frances H,30,0,30,0
1649823491943,MATH 20C,B01,083451,Hammock; Frances H,29,0,30,1
1649823491943,MATH 20C,B02,083452,Hammock; Frances H,30,0,30,0
1649823491943,MATH 20C,B03,083453,Hammock; Frances H,30,0,30,0
1649823491943,MATH 20C,B04,083454,Hammock; Frances H,30,0,30,0
1649823497967,MATH 20D,A01,084128,Staff,29,0,30,1
1649823497967,MATH 20D,A02,084129,Staff,30,0,30,0
1649823497967,MATH 20D,A03,084130,Staff,29,0,30,1
1649823497967,MATH 20D,B01,084133,Staff,28,0,30,2
1649823497967,MATH 20D,B02,084134,Staff,30,0,30,0
1649823497967,MATH 20D,B03,084135,Staff,30,0,30,0
1649823503992,MATH 20E,A01,084138,Staff,29,0,30,1
1649823503992,MATH 20E,A02,084139,Staff,29,0,30,1
1649823503992,MATH 20E,A03,084140,Staff,28,0,30,2
1649823503992,MATH 20E,A04,084141,Staff,30,0,30,0
1649823510022,MATH 102,A01,084143,Harel; Guershon,24,0,30,6
1649823510022,MATH 102,A02,084144,Harel; Guershon,25,0,30,5
1649823516179,MATH 103B,A01,083456,Staff,0,0,30,30
1649823516179,MATH 103B,A02,083457,Staff,22,0,30,8
1649823522207,MATH 109,A01,084146,Salehi Golsefidy; Alireza,30,0,30,0
1649823522207,MATH 109,A02,084147,Salehi Golsefidy; Alireza,27,0,30,3
1649823528235,MATH 120A,A01,085445,Eggers; John Dietrich,31,0,35,4
1649823528235,MATH 120A,A02,085446,Eggers; John Dietrich,31,0,35,4
1649823534263,MATH 142B,A01,084149,Verstraete; Jacques Allan,10,0,30,20
1649823534263,MATH 142B,A02,084150,Verstraete; Jacques Allan,25,0,30,5
1649823540301,MATH 170A,A01,083459,Nie; Jiawang,11,0,30,19
1649823540301,MATH 170A,A02,083460,Nie; Jiawang,25,0,30,5
1649823540301,MATH 170A,A03,083461,Nie; Jiawang,26,0,30,4
1649823546326,MATH 193B,A01,083463,Staff,18,0,30,12
1649823546326,MATH 193B,A02,083464,Staff,19,0,30,11
1649823546326,MATH 193B,A03,083465,Staff,27,0,30,3
1649823552381,COGS 2,A01,083966,Boyle; Mary E. T.,27,0,30,3
1649823558410,COGS 9,A01,083968,Staff,57,0,60,3
1649823564439,COGS 14B,A01,083970,Staff,47,0,50,3
1649823570466,COGS 17,A01,092679,Staff,73,0,75,2
1649823576507,COGS 100,A01,083972,Staff,47,0,60,13
1649823588556,COGS 101C,A01,083976,Staff,25,0,30,5
1649823594586,COGS 102A,A01,083978,Johnson; Christine M.,24,0,30,6
1649823600610,COGS 107B,A01,083980,Staff,40,0,50,10
1649823606641,COGS 115,A01,083982,Staff,22,0,30,8
1649823612675,COGS 118B,A01,083367,Staff,6,0,40,34
1649823618698,COGS 172,A01,083984,Provenzano; Emily Kara,21,0,30,9
1649823624721,COGS 177,A00,083368,Staff,6,0,30,24
1649823630744,COGS 186,A01,083986,Staff,25,0,40,15
1649823636780,COGS 187A,A01,083988,Boyle; Mary E. T.,41,0,60,19
1649823642804,CSE 8A,A50,084003,Miranda; Gregory Joseph,9,0,15,6
1649823648837,CSE 11,A01,084005,Miranda; Gregory Joseph,49,0,55,6
1649823654861,CSE 20,A01,084007,Staff,15,0,20,5
1649823660892,CSE 21,A01,084009,Staff,38,0,50,12
1649823666916,CSE 30,A01,083370,Cao; Yingjun,20,0,40,20
1649823672948,CSE 100,A01,083372,Cao; Yingjun,17,0,40,23
1649823678972,CSE 101,A01,084011,Staff,0,10,40,40
1649823685001,CSE 141,A01,083374,Eldon; John,0,7,75,75
1649823691029,CSE 141L,A01,083376,Eldon; John,0,9,75,75
1649823697059,CSE 175,A01,084013,Kumar; Rakesh,24,0,25,1
1649823703103,CSE 190,A00,092508,Staff,15,0,15,0
1649823709128,ECE 5,A01,084049,Morris; Karcher William,17,0,20,3
1649823715163,ECE 100,A01,084051,Baghdadchi; Saharnaz,16,0,20,4
1649823715163,ECE 100,A02,091916,Baghdadchi; Saharnaz,18,0,20,2
1649823721198,ECE 101,A01,084053,Baghdadchi; Saharnaz,25,0,37,12
1649823721198,ECE 101,A02,084054,Baghdadchi; Saharnaz,37,0,37,0
1649823727238,ECE 107,A01,083390,Staff,33,0,40,7
1649823733268,ECE 148,A01,084056,Silberman; Jack,8,0,12,4
1649823739296,ECE 180,A00,083391,Abi Samra; Nicholas Camill,27,0,30,3
1649823739296,ECE 180,B00,083392,Abi Samra; Nicholas Camill,26,0,30,4
1649823745340,MATH 10B,A01,084110,Staff,20,0,30,10
1649823745340,MATH 10B,A02,084111,Staff,29,0,30,1
1649823745340,MATH 10B,A03,084112,Staff,29,0,30,1
1649823751374,MATH 10C,A01,083443,Staff,20,0,30,10
1649823751374,MATH 10C,A02,083444,Staff,25,0,30,5
1649823751374,MATH 10C,B01,084114,Staff,26,0,30,4
1649823751374,MATH 10C,B02,084115,Staff,30,0,30,0
1649823757399,MATH 18,A01,084117,Harel; Guershon,28,0,30,2
1649823757399,MATH 18,A02,084119,Harel; Guershon,29,0,30,1
1649823757399,MATH 18,A03,084120,Harel; Guershon,30,0,30,0
1649823757399,MATH 18,A04,084121,Harel; Guershon,30,0,30,0
1649823763435,MATH 20B,A01,084124,Um; Ko Woon,33,0,35,2
1649823763435,MATH 20B,B01,084126,Um; Ko Woon,35,0,35,0
1649823769464,MATH 20C,A01,083446,Hammock; Frances H,27,0,30,3
1649823769464,MATH 20C,A02,083447,Hammock; Frances H,30,0,30,0
1649823769464,MATH 20C,A03,083448,Hammock; Frances H,30,0,30,0
1649823769464,MATH 20C,A04,083449,Hammock; Frances H,30,0,30,0
1649823769464,MATH 20C,B01,083451,Hammock; Frances H,29,0,30,1
1649823769464,MATH 20C,B02,083452,Hammock; Frances H,30,0,30,0
1649823769464,MATH 20C,B03,083453,Hammock; Frances H,30,0,30,0
1649823769464,MATH 20C,B04,083454,Hammock; Frances H,30,0,30,0
1649823775492,MATH 20D,A01,084128,Staff,29,0,30,1
1649823775492,MATH 20D,A02,084129,Staff,30,0,30,0
1649823775492,MATH 20D,A03,084130,Staff,29,0,30,1
1649823775492,MATH 20D,B01,084133,Staff,28,0,30,2
1649823775492,MATH 20D,B02,084134,Staff,30,0,30,0
1649823775492,MATH 20D,B03,084135,Staff,30,0,30,0
1649823781517,MATH 20E,A01,084138,Staff,29,0,30,1
1649823781517,MATH 20E,A02,084139,Staff,29,0,30,1
1649823781517,MATH 20E,A03,084140,Staff,28,0,30,2
1649823781517,MATH 20E,A04,084141,Staff,30,0,30,0
1649823787546,MATH 102,A01,084143,Harel; Guershon,24,0,30,6
1649823787546,MATH 102,A02,084144,Harel; Guershon,25,0,30,5
1649823793574,MATH 103B,A01,083456,Staff,0,0,30,30
1649823793574,MATH 103B,A02,083457,Staff,22,0,30,8
1649823799597,MATH 109,A01,084146,Salehi Golsefidy; Alireza,30,0,30,0
1649823799597,MATH 109,A02,084147,Salehi Golsefidy; Alireza,27,0,30,3
1649823805623,MATH 120A,A01,085445,Eggers; John Dietrich,31,0,35,4
1649823805623,MATH 120A,A02,085446,Eggers; John Dietrich,31,0,35,4
1649823811658,MATH 142B,A01,084149,Verstraete; Jacques Allan,10,0,30,20
1649823811658,MATH 142B,A02,084150,Verstraete; Jacques Allan,25,0,30,5
1649823817683,MATH 170A,A01,083459,Nie; Jiawang,11,0,30,19
1649823817683,MATH 170A,A02,083460,Nie; Jiawang,25,0,30,5
1649823817683,MATH 170A,A03,083461,Nie; Jiawang,26,0,30,4
1649823823720,MATH 193B,A01,083463,Staff,18,0,30,12
1649823823720,MATH 193B,A02,083464,Staff,19,0,30,11
1649823823720,MATH 193B,A03,083465,Staff,27,0,30,3
1649823829784,COGS 2,A01,083966,Boyle; Mary E. T.,27,0,30,3
1649823835810,COGS 9,A01,083968,Staff,57,0,60,3
1649823841834,COGS 14B,A01,083970,Staff,47,0,50,3
1649823847858,COGS 17,A01,092679,Staff,73,0,75,2
1649823853888,COGS 100,A01,083972,Staff,47,0,60,13
1649823865937,COGS 101C,A01,083976,Staff,25,0,30,5
1649823871961,COGS 102A,A01,083978,Johnson; Christine M.,24,0,30,6
1649823877987,COGS 107B,A01,083980,Staff,40,0,50,10
1649823884012,COGS 115,A01,083982,Staff,22,0,30,8
1649823890035,COGS 118B,A01,083367,Staff,6,0,40,34
1649823896060,COGS 172,A01,083984,Provenzano; Emily Kara,21,0,30,9
1649823902086,COGS 177,A00,083368,Staff,6,0,30,24
1649823908112,COGS 186,A01,083986,Staff,25,0,40,15
1649823914139,COGS 187A,A01,083988,Boyle; Mary E. T.,41,0,60,19
1649823920165,CSE 8A,A50,084003,Miranda; Gregory Joseph,9,0,15,6
1649823926196,CSE 11,A01,084005,Miranda; Gregory Joseph,49,0,55,6
1649823932220,CSE 20,A01,084007,Staff,15,0,20,5
1649823938246,CSE 21,A01,084009,Staff,38,0,50,12
1649823944275,CSE 30,A01,083370,Cao; Yingjun,20,0,40,20
1649823950300,CSE 100,A01,083372,Cao; Yingjun,17,0,40,23
1649823956327,CSE 101,A01,084011,Staff,0,10,40,40
1649823962353,CSE 141,A01,083374,Eldon; John,0,7,75,75
1649823968383,CSE 141L,A01,083376,Eldon; John,0,9,75,75
1649823974410,CSE 175,A01,084013,Kumar; Rakesh,24,0,25,1
1649823980436,CSE 190,A00,092508,Staff,15,0,15,0
1649823986463,ECE 5,A01,084049,Morris; Karcher William,17,0,20,3
1649823992506,ECE 100,A01,084051,Baghdadchi; Saharnaz,16,0,20,4
1649823992506,ECE 100,A02,091916,Baghdadchi; Saharnaz,18,0,20,2
1649823998540,ECE 101,A01,084053,Baghdadchi; Saharnaz,25,0,37,12
1649823998540,ECE 101,A02,084054,Baghdadchi; Saharnaz,37,0,37,0
1649824004568,ECE 107,A01,083390,Staff,33,0,40,7
1649824010601,ECE 148,A01,084056,Silberman; Jack,8,0,12,4
1649824016626,ECE 180,A00,083391,Abi Samra; Nicholas Camill,27,0,30,3
1649824016626,ECE 180,B00,083392,Abi Samra; Nicholas Camill,26,0,30,4
1649824022651,MATH 10B,A01,084110,Staff,20,0,30,10
1649824022651,MATH 10B,A02,084111,Staff,29,0,30,1
1649824022651,MATH 10B,A03,084112,Staff,29,0,30,1
1649824028750,MATH 10C,A01,083443,Staff,20,0,30,10
1649824028750,MATH 10C,A02,083444,Staff,25,0,30,5
1649824028750,MATH 10C,B01,084114,Staff,26,0,30,4
1649824028750,MATH 10C,B02,084115,Staff,30,0,30,0
1649824034775,MATH 18,A01,084117,Harel; Guershon,28,0,30,2
1649824034775,MATH 18,A02,084119,Harel; Guershon,29,0,30,1
1649824034775,MATH 18,A03,084120,Harel; Guershon,30,0,30,0
1649824034775,MATH 18,A04,084121,Harel; Guershon,30,0,30,0
1649824040798,MATH 20B,A01,084124,Um; Ko Woon,33,0,35,2
1649824040798,MATH 20B,B01,084126,Um; Ko Woon,35,0,35,0
1649824046831,MATH 20C,A01,083446,Hammock; Frances H,27,0,30,3
1649824046831,MATH 20C,A02,083447,Hammock; Frances H,30,0,30,0
1649824046831,MATH 20C,A03,083448,Hammock; Frances H,30,0,30,0
1649824046831,MATH 20C,A04,083449,Hammock; Frances H,30,0,30,0
1649824046831,MATH 20C,B01,083451,Hammock; Frances H,29,0,30,1
1649824046831,MATH 20C,B02,083452,Hammock; Frances H,30,0,30,0
1649824046831,MATH 20C,B03,083453,Hammock; Frances H,30,0,30,0
1649824046831,MATH 20C,B04,083454,Hammock; Frances H,30,0,30,0
1649824052855,MATH 20D,A01,084128,Staff,29,0,30,1
1649824052855,MATH 20D,A02,084129,Staff,30,0,30,0
1649824052855,MATH 20D,A03,084130,Staff,29,0,30,1
1649824052855,MATH 20D,B01,084133,Staff,28,0,30,2
1649824052855,MATH 20D,B02,084134,Staff,30,0,30,0
1649824052855,MATH 20D,B03,084135,Staff,30,0,30,0
1649824058877,MATH 20E,A01,084138,Staff,29,0,30,1
1649824058877,MATH 20E,A02,084139,Staff,29,0,30,1
1649824058877,MATH 20E,A03,084140,Staff,28,0,30,2
1649824058877,MATH 20E,A04,084141,Staff,30,0,30,0
1649824064898,MATH 102,A01,084143,Harel; Guershon,24,0,30,6
1649824064898,MATH 102,A02,084144,Harel; Guershon,25,0,30,5
1649824070924,MATH 103B,A01,083456,Staff,0,0,30,30
1649824070924,MATH 103B,A02,083457,Staff,22,0,30,8
1649824076946,MATH 109,A01,084146,Salehi Golsefidy; Alireza,30,0,30,0
1649824076946,MATH 109,A02,084147,Salehi Golsefidy; Alireza,27,0,30,3
1649824082971,MATH 120A,A01,085445,Eggers; John Dietrich,31,0,35,4
1649824082971,MATH 120A,A02,085446,Eggers; John Dietrich,31,0,35,4
1649824088993,MATH 142B,A01,084149,Verstraete; Jacques Allan,10,0,30,20
1649824088993,MATH 142B,A02,084150,Verstraete; Jacques Allan,25,0,30,5
1649824095020,MATH 170A,A01,083459,Nie; Jiawang,11,0,30,19
1649824095020,MATH 170A,A02,083460,Nie; Jiawang,25,0,30,5
1649824095020,MATH 170A,A03,083461,Nie; Jiawang,26,0,30,4
1649824101043,MATH 193B,A01,083463,Staff,18,0,30,12
1649824101043,MATH 193B,A02,083464,Staff,19,0,30,11
1649824101043,MATH 193B,A03,083465,Staff,27,0,30,3
1649824107114,COGS 2,A01,083966,Boyle; Mary E. T.,27,0,30,3
1649824113140,COGS 9,A01,083968,Staff,57,0,60,3
1649824119163,COGS 14B,A01,083970,Staff,47,0,50,3
1649824125193,COGS 17,A01,092679,Staff,73,0,75,2
1649824131217,COGS 100,A01,083972,Staff,47,0,60,13
1649824143270,COGS 101C,A01,083976,Staff,25,0,30,5
1649824149293,COGS 102A,A01,083978,Johnson; Christine M.,24,0,30,6
1649824155319,COGS 107B,A01,083980,Staff,40,0,50,10
1649824161342,COGS 115,A01,083982,Staff,22,0,30,8
1649824167367,COGS 118B,A01,083367,Staff,6,0,40,34
1649824173391,COGS 172,A01,083984,Provenzano; Emily Kara,21,0,30,9
1649824179424,COGS 177,A00,083368,Staff,6,0,30,24
1649824185447,COGS 186,A01,083986,Staff,25,0,40,15
1649824191470,COGS 187A,A01,083988,Boyle; Mary E. T.,41,0,60,19
1649824197494,CSE 8A,A50,084003,Miranda; Gregory Joseph,9,0,15,6
1649824203521,CSE 11,A01,084005,Miranda; Gregory Joseph,49,0,55,6
1649824209569,CSE 20,A01,084007,Staff,15,0,20,5
1649824215593,CSE 21,A01,084009,Staff,38,0,50,12
1649824221618,CSE 30,A01,083370,Cao; Yingjun,20,0,40,20
1649824227644,CSE 100,A01,083372,Cao; Yingjun,17,0,40,23
1649824233670,CSE 101,A01,084011,Staff,0,10,40,40
1649824239696,CSE 141,A01,083374,Eldon; John,0,8,75,75
1649824245734,CSE 141L,A01,083376,Eldon; John,0,10,75,75
1649824251761,CSE 175,A01,084013,Kumar; Rakesh,24,0,25,1
1649824257797,CSE 190,A00,092508,Staff,15,0,15,0
1649824263824,ECE 5,A01,084049,Morris; Karcher William,17,0,20,3
1649824269862,ECE 100,A01,084051,Baghdadchi; Saharnaz,16,0,20,4
1649824269862,ECE 100,A02,091916,Baghdadchi; Saharnaz,18,0,20,2
1649824275890,ECE 101,A01,084053,Baghdadchi; Saharnaz,25,0,37,12
1649824275890,ECE 101,A02,084054,Baghdadchi; Saharnaz,37,0,37,0
1649824281931,ECE 107,A01,083390,Staff,33,0,40,7
1649824287954,ECE 148,A01,084056,Silberman; Jack,8,0,12,4
1649824293977,ECE 180,A00,083391,Abi Samra; Nicholas Camill,27,0,30,3
1649824293977,ECE 180,B00,083392,Abi Samra; Nicholas Camill,26,0,30,4
1649824300012,MATH 10B,A01,084110,Staff,20,0,30,10
1649824300012,MATH 10B,A02,084111,Staff,29,0,30,1
1649824300012,MATH 10B,A03,084112,Staff,29,0,30,1
1649824306048,MATH 10C,A01,083443,Staff,20,0,30,10
1649824306048,MATH 10C,A02,083444,Staff,25,0,30,5
1649824306048,MATH 10C,B01,084114,Staff,26,0,30,4
1649824306048,MATH 10C,B02,084115,Staff,30,0,30,0
1649824312082,MATH 18,A01,084117,Harel; Guershon,28,0,30,2
1649824312082,MATH 18,A02,084119,Harel; Guershon,29,0,30,1
1649824312082,MATH 18,A03,084120,Harel; Guershon,30,0,30,0
1649824312082,MATH 18,A04,084121,Harel; Guershon,30,0,30,0
1649824318105,MATH 20B,A01,084124,Um; Ko Woon,33,0,35,2
1649824318105,MATH 20B,B01,084126,Um; Ko Woon,35,0,35,0
1649824324137,MATH 20C,A01,083446,Hammock; Frances H,27,0,30,3
1649824324137,MATH 20C,A02,083447,Hammock; Frances H,30,0,30,0
1649824324137,MATH 20C,A03,083448,Hammock; Frances H,30,0,30,0
1649824324137,MATH 20C,A04,083449,Hammock; Frances H,30,0,30,0
1649824324137,MATH 20C,B01,083451,Hammock; Frances H,29,0,30,1
1649824324137,MATH 20C,B02,083452,Hammock; Frances H,30,0,30,0
1649824324137,MATH 20C,B03,083453,Hammock; Frances H,30,0,30,0
1649824324137,MATH 20C,B04,083454,Hammock; Frances H,30,0,30,0
1649824330161,MATH 20D,A01,084128,Staff,29,0,30,1
1649824330161,MATH 20D,A02,084129,Staff,30,0,30,0
1649824330161,MATH 20D,A03,084130,Staff,29,0,30,1
1649824330161,MATH 20D,B01,084133,Staff,28,0,30,2
1649824330161,MATH 20D,B02,084134,Staff,30,0,30,0
1649824330161,MATH 20D,B03,084135,Staff,30,0,30,0
1649824336185,MATH 20E,A01,084138,Staff,29,0,30,1
1649824336185,MATH 20E,A02,084139,Staff,29,0,30,1
1649824336185,MATH 20E,A03,084140,Staff,28,0,30,2
1649824336185,MATH 20E,A04,084141,Staff,30,0,30,0
1649824342212,MATH 102,A01,084143,Harel; Guershon,24,0,30,6
1649824342212,MATH 102,A02,084144,Harel; Guershon,25,0,30,5
1649824348238,MATH 103B,A01,083456,Staff,0,0,30,30
1649824348238,MATH 103B,A02,083457,Staff,22,0,30,8
1649824354262,MATH 109,A01,084146,Salehi Golsefidy; Alireza,30,0,30,0
1649824354262,MATH 109,A02,084147,Salehi Golsefidy; Alireza,27,0,30,3
1649824360288,MATH 120A,A01,085445,Eggers; John Dietrich,31,0,35,4
1649824360288,MATH 120A,A02,085446,Eggers; John Dietrich,31,0,35,4
1649824366322,MATH 142B,A01,084149,Verstraete; Jacques Allan,10,0,30,20
1649824366322,MATH 142B,A02,084150,Verstraete; Jacques Allan,25,0,30,5
1649824372346,MATH 170A,A01,083459,Nie; Jiawang,11,0,30,19
1649824372346,MATH 170A,A02,083460,Nie; Jiawang,25,0,30,5
1649824372346,MATH 170A,A03,083461,Nie; Jiawang,26,0,30,4
1649824378376,MATH 193B,A01,083463,Staff,18,0,30,12
1649824378376,MATH 193B,A02,083464,Staff,19,0,30,11
1649824378376,MATH 193B,A03,083465,Staff,27,0,30,3
1649824384435,COGS 2,A01,083966,Boyle; Mary E. T.,27,0,30,3
1649824390462,COGS 9,A01,083968,Staff,57,0,60,3
1649824396501,COGS 14B,A01,083970,Staff,47,0,50,3
1649824402529,COGS 17,A01,092679,Staff,73,0,75,2
1649824408557,COGS 100,A01,083972,Staff,47,0,60,13
1649824420612,COGS 101C,A01,083976,Staff,25,0,30,5
1649824426640,COGS 102A,A01,083978,Johnson; Christine M.,24,0,30,6
1649824432666,COGS 107B,A01,083980,Staff,40,0,50,10
1649824438691,COGS 115,A01,083982,Staff,22,0,30,8
1649824444720,COGS 118B,A01,083367,Staff,6,0,40,34
1649824450744,COGS 172,A01,083984,Provenzano; Emily Kara,21,0,30,9
1649824456769,COGS 177,A00,083368,Staff,6,0,30,24
1649824462803,COGS 186,A01,083986,Staff,25,0,40,15
1649824468827,COGS 187A,A01,083988,Boyle; Mary E. T.,41,0,60,19
1649824474855,CSE 8A,A50,084003,Miranda; Gregory Joseph,9,0,15,6
1649824480883,CSE 11,A01,084005,Miranda; Gregory Joseph,49,0,55,6
1649824486907,CSE 20,A01,084007,Staff,15,0,20,5
1649824492935,CSE 21,A01,084009,Staff,38,0,50,12
1649824498959,CSE 30,A01,083370,Cao; Yingjun,20,0,40,20
1649824504998,CSE 100,A01,083372,Cao; Yingjun,17,0,40,23
1649824511021,CSE 101,A01,084011,Staff,0,10,40,40
1649824517045,CSE 141,A01,083374,Eldon; John,0,8,75,75
1649824523072,CSE 141L,A01,083376,Eldon; John,0,10,75,75
1649824529114,CSE 175,A01,084013,Kumar; Rakesh,24,0,25,1
1649824535140,CSE 190,A00,092508,Staff,15,0,15,0
1649824541173,ECE 5,A01,084049,Morris; Karcher William,17,0,20,3
1649824547205,ECE 100,A01,084051,Baghdadchi; Saharnaz,16,0,20,4
1649824547205,ECE 100,A02,091916,Baghdadchi; Saharnaz,18,0,20,2
1649824553231,ECE 101,A01,084053,Baghdadchi; Saharnaz,25,0,37,12
1649824553231,ECE 101,A02,084054,Baghdadchi; Saharnaz,37,0,37,0
1649824559256,ECE 107,A01,083390,Staff,33,0,40,7
1649824565283,ECE 148,A01,084056,Silberman; Jack,8,0,12,4
1649824571311,ECE 180,A00,083391,Abi Samra; Nicholas Camill,27,0,30,3
1649824571311,ECE 180,B00,083392,Abi Samra; Nicholas Camill,26,0,30,4
1649824577339,MATH 10B,A01,084110,Staff,20,0,30,10
1649824577339,MATH 10B,A02,084111,Staff,29,0,30,1
1649824577339,MATH 10B,A03,084112,Staff,29,0,30,1
1649824583364,MATH 10C,A01,083443,Staff,20,0,30,10
1649824583364,MATH 10C,A02,083444,Staff,25,0,30,5
1649824583364,MATH 10C,B01,084114,Staff,26,0,30,4
1649824583364,MATH 10C,B02,084115,Staff,30,0,30,0
1649824589391,MATH 18,A01,084117,Harel; Guershon,28,0,30,2
1649824589391,MATH 18,A02,084119,Harel; Guershon,29,0,30,1
1649824589391,MATH 18,A03,084120,Harel; Guershon,30,0,30,0
1649824589391,MATH 18,A04,084121,Harel; Guershon,30,0,30,0
1649824595415,MATH 20B,A01,084124,Um; Ko Woon,33,0,35,2
1649824595415,MATH 20B,B01,084126,Um; Ko Woon,35,0,35,0
1649824601441,MATH 20C,A01,083446,Hammock; Frances H,27,0,30,3
1649824601441,MATH 20C,A02,083447,Hammock; Frances H,30,0,30,0
1649824601441,MATH 20C,A03,083448,Hammock; Frances H,30,0,30,0
1649824601441,MATH 20C,A04,083449,Hammock; Frances H,30,0,30,0
1649824601441,MATH 20C,B01,083451,Hammock; Frances H,29,0,30,1
1649824601441,MATH 20C,B02,083452,Hammock; Frances H,30,0,30,0
1649824601441,MATH 20C,B03,083453,Hammock; Frances H,30,0,30,0
1649824601441,MATH 20C,B04,083454,Hammock; Frances H,30,0,30,0
1649824607465,MATH 20D,A01,084128,Staff,29,0,30,1
1649824607465,MATH 20D,A02,084129,Staff,30,0,30,0
1649824607465,MATH 20D,A03,084130,Staff,29,0,30,1
1649824607465,MATH 20D,B01,084133,Staff,28,0,30,2
1649824607465,MATH 20D,B02,084134,Staff,30,0,30,0
1649824607465,MATH 20D,B03,084135,Staff,30,0,30,0
1649824613492,MATH 20E,A01,084138,Staff,29,0,30,1
1649824613492,MATH 20E,A02,084139,Staff,29,0,30,1
1649824613492,MATH 20E,A03,084140,Staff,28,0,30,2
1649824613492,MATH 20E,A04,084141,Staff,30,0,30,0
1649824619516,MATH 102,A01,084143,Harel; Guershon,24,0,30,6
1649824619516,MATH 102,A02,084144,Harel; Guershon,25,0,30,5
1649824625633,MATH 103B,A01,083456,Staff,0,0,30,30
1649824625633,MATH 103B,A02,083457,Staff,22,0,30,8
1649824631663,MATH 109,A01,084146,Salehi Golsefidy; Alireza,30,0,30,0
1649824631663,MATH 109,A02,084147,Salehi Golsefidy; Alireza,27,0,30,3
1649824637686,MATH 120A,A01,085445,Eggers; John Dietrich,31,0,35,4
1649824637686,MATH 120A,A02,085446,Eggers; John Dietrich,31,0,35,4
1649824643718,MATH 142B,A01,084149,Verstraete; Jacques Allan,10,0,30,20
1649824643718,MATH 142B,A02,084150,Verstraete; Jacques Allan,25,0,30,5
1649824649745,MATH 170A,A01,083459,Nie; Jiawang,11,0,30,19
1649824649745,MATH 170A,A02,083460,Nie; Jiawang,25,0,30,5
1649824649745,MATH 170A,A03,083461,Nie; Jiawang,26,0,30,4
1649824655773,MATH 193B,A01,083463,Staff,18,0,30,12
1649824655773,MATH 193B,A02,083464,Staff,19,0,30,11
1649824655773,MATH 193B,A03,083465,Staff,27,0,30,3
1649824661825,COGS 2,A01,083966,Boyle; Mary E. T.,27,0,30,3
1649824667848,COGS 9,A01,083968,Staff,57,0,60,3
1649824673873,COGS 14B,A01,083970,Staff,47,0,50,3
1649824679897,COGS 17,A01,092679,Staff,73,0,75,2
1649824685923,COGS 100,A01,083972,Staff,47,0,60,13
1649824697977,COGS 101C,A01,083976,Staff,25,0,30,5
1649824704004,COGS 102A,A01,083978,Johnson; Christine M.,24,0,30,6
1649824710033,COGS 107B,A01,083980,Staff,40,0,50,10
1649824716065,COGS 115,A01,083982,Staff,22,0,30,8
1649824722091,COGS 118B,A01,083367,Staff,6,0,40,34
1649824728122,COGS 172,A01,083984,Provenzano; Emily Kara,21,0,30,9
1649824734147,COGS 177,A00,083368,Staff,6,0,30,24
1649824740170,COGS 186,A01,083986,Staff,25,0,40,15
1649824746205,COGS 187A,A01,083988,Boyle; Mary E. T.,41,0,60,19
1649824752237,CSE 8A,A50,084003,Miranda; Gregory Joseph,9,0,15,6
1649824758261,CSE 11,A01,084005,Miranda; Gregory Joseph,49,0,55,6
1649824764299,CSE 20,A01,084007,Staff,15,0,20,5
1649824770325,CSE 21,A01,084009,Staff,38,0,50,12
1649824776351,CSE 30,A01,083370,Cao; Yingjun,20,0,40,20
1649824782380,CSE 100,A01,083372,Cao; Yingjun,17,0,40,23
1649824788404,CSE 101,A01,084011,Staff,0,10,40,40
1649824794428,CSE 141,A01,083374,Eldon; John,0,8,75,75
1649824800456,CSE 141L,A01,083376,Eldon; John,0,10,75,75
1649824806484,CSE 175,A01,084013,Kumar; Rakesh,24,0,25,1
1649824812509,CSE 190,A00,092508,Staff,15,0,15,0
1649824818535,ECE 5,A01,084049,Morris; Karcher William,17,0,20,3
1649824824558,ECE 100,A01,084051,Baghdadchi; Saharnaz,16,0,20,4
1649824824558,ECE 100,A02,091916,Baghdadchi; Saharnaz,18,0,20,2
1649824830583,ECE 101,A01,084053,Baghdadchi; Saharnaz,25,0,37,12
1649824830583,ECE 101,A02,084054,Baghdadchi; Saharnaz,37,0,37,0
1649824836607,ECE 107,A01,083390,Staff,33,0,40,7
1649824842632,ECE 148,A01,084056,Silberman; Jack,8,0,12,4
1649824848668,ECE 180,A00,083391,Abi Samra; Nicholas Camill,27,0,30,3
1649824848668,ECE 180,B00,083392,Abi Samra; Nicholas Camill,26,0,30,4
1649824854691,MATH 10B,A01,084110,Staff,20,0,30,10
1649824854691,MATH 10B,A02,084111,Staff,29,0,30,1
1649824854691,MATH 10B,A03,084112,Staff,29,0,30,1
1649824860723,MATH 10C,A01,083443,Staff,20,0,30,10
1649824860723,MATH 10C,A02,083444,Staff,25,0,30,5
1649824860723,MATH 10C,B01,084114,Staff,26,0,30,4
1649824860723,MATH 10C,B02,084115,Staff,30,0,30,0
1649824866751,MATH 18,A01,084117,Harel; Guershon,28,0,30,2
1649824866751,MATH 18,A02,084119,Harel; Guershon,29,0,30,1
1649824866751,MATH 18,A03,084120,Harel; Guershon,30,0,30,0
1649824866751,MATH 18,A04,084121,Harel; Guershon,30,0,30,0
1649824872776,MATH 20B,A01,084124,Um; Ko Woon,33,0,35,2
1649824872776,MATH 20B,B01,084126,Um; Ko Woon,35,0,35,0
1649824878800,MATH 20C,A01,083446,Hammock; Frances H,27,0,30,3
1649824878800,MATH 20C,A02,083447,Hammock; Frances H,30,0,30,0
1649824878800,MATH 20C,A03,083448,Hammock; Frances H,30,0,30,0
1649824878800,MATH 20C,A04,083449,Hammock; Frances H,30,0,30,0
1649824878800,MATH 20C,B01,083451,Hammock; Frances H,29,0,30,1
1649824878800,MATH 20C,B02,083452,Hammock; Frances H,30,0,30,0
1649824878800,MATH 20C,B03,083453,Hammock; Frances H,30,0,30,0
1649824878800,MATH 20C,B04,083454,Hammock; Frances H,30,0,30,0
1649824884824,MATH 20D,A01,084128,Staff,29,0,30,1
1649824884824,MATH 20D,A02,084129,Staff,30,0,30,0
1649824884824,MATH 20D,A03,084130,Staff,29,0,30,1
1649824884824,MATH 20D,B01,084133,Staff,28,0,30,2
1649824884824,MATH 20D,B02,084134,Staff,30,0,30,0
1649824884824,MATH 20D,B03,084135,Staff,30,0,30,0
1649824890849,MATH 20E,A01,084138,Staff,29,0,30,1
1649824890849,MATH 20E,A02,084139,Staff,29,0,30,1
1649824890849,MATH 20E,A03,084140,Staff,28,0,30,2
1649824890849,MATH 20E,A04,084141,Staff,30,0,30,0
1649824896874,MATH 102,A01,084143,Harel; Guershon,24,0,30,6
1649824896874,MATH 102,A02,084144,Harel; Guershon,25,0,30,5
1649824902901,MATH 103B,A01,083456,Staff,0,0,30,30
1649824902901,MATH 103B,A02,083457,Staff,21,0,30,9
1649824908927,MATH 109,A01,084146,Salehi Golsefidy; Alireza,30,0,30,0
1649824908927,MATH 109,A02,084147,Salehi Golsefidy; Alireza,27,0,30,3
1649824914951,MATH 120A,A01,085445,Eggers; John Dietrich,31,0,35,4
1649824914951,MATH 120A,A02,085446,Eggers; John Dietrich,31,0,35,4
1649824920984,MATH 142B,A01,084149,Verstraete; Jacques Allan,9,0,30,21
1649824920984,MATH 142B,A02,084150,Verstraete; Jacques Allan,25,0,30,5
1649824927012,MATH 170A,A01,083459,Nie; Jiawang,11,0,30,19
1649824927012,MATH 170A,A02,083460,Nie; Jiawang,25,0,30,5
1649824927012,MATH 170A,A03,083461,Nie; Jiawang,26,0,30,4
1649824933038,MATH 193B,A01,083463,Staff,18,0,30,12
1649824933038,MATH 193B,A02,083464,Staff,19,0,30,11
1649824933038,MATH 193B,A03,083465,Staff,27,0,30,3
1649824939086,COGS 2,A01,083966,Boyle; Mary E. T.,27,0,30,3
1649824945114,COGS 9,A01,083968,Staff,57,0,60,3
1649824951143,COGS 14B,A01,083970,Staff,47,0,50,3
1649824957167,COGS 17,A01,092679,Staff,73,0,75,2
1649824963193,COGS 100,A01,083972,Staff,47,0,60,13
1649824975252,COGS 101C,A01,083976,Staff,25,0,30,5
1649824981276,COGS 102A,A01,083978,Johnson; Christine M.,24,0,30,6
1649824987301,COGS 107B,A01,083980,Staff,40,0,50,10
1649824993325,COGS 115,A01,083982,Staff,22,0,30,8
1649824999352,COGS 118B,A01,083367,Staff,6,0,40,34
1649825005378,COGS 172,A01,083984,Provenzano; Emily Kara,21,0,30,9
1649825011400,COGS 177,A00,083368,Staff,6,0,30,24
1649825017426,COGS 186,A01,083986,Staff,25,0,40,15
1649825023454,COGS 187A,A01,083988,Boyle; Mary E. T.,41,0,60,19
1649825029489,CSE 8A,A50,084003,Miranda; Gregory Joseph,9,0,15,6
1649825035518,CSE 11,A01,084005,Miranda; Gregory Joseph,49,0,55,6
1649825041546,CSE 20,A01,084007,Staff,15,0,20,5
1649825047572,CSE 21,A01,084009,Staff,38,0,50,12
1649825053597,CSE 30,A01,083370,Cao; Yingjun,20,0,40,20
1649825059622,CSE 100,A01,083372,Cao; Yingjun,17,0,40,23
1649825065647,CSE 101,A01,084011,Staff,0,11,40,40
1649825071671,CSE 141,A01,083374,Eldon; John,0,8,75,75
1649825077694,CSE 141L,A01,083376,Eldon; John,0,10,75,75
1649825083725,CSE 175,A01,084013,Kumar; Rakesh,24,0,25,1
1649825089748,CSE 190,A00,092508,Staff,15,0,15,0
1649825095771,ECE 5,A01,084049,Morris; Karcher William,17,0,20,3
1649825101799,ECE 100,A01,084051,Baghdadchi; Saharnaz,16,0,20,4
1649825101799,ECE 100,A02,091916,Baghdadchi; Saharnaz,18,0,20,2
1649825107833,ECE 101,A01,084053,Baghdadchi; Saharnaz,25,0,37,12
1649825107833,ECE 101,A02,084054,Baghdadchi; Saharnaz,37,0,37,0
1649825113863,ECE 107,A01,083390,Staff,33,0,40,7
1649825119886,ECE 148,A01,084056,Silberman; Jack,8,0,12,4
1649825125909,ECE 180,A00,083391,Abi Samra; Nicholas Camill,27,0,30,3
1649825125909,ECE 180,B00,083392,Abi Samra; Nicholas Camill,26,0,30,4
1649825131936,MATH 10B,A01,084110,Staff,20,0,30,10
1649825131936,MATH 10B,A02,084111,Staff,29,0,30,1
1649825131936,MATH 10B,A03,084112,Staff,29,0,30,1
1649825137966,MATH 10C,A01,083443,Staff,20,0,30,10
1649825137966,MATH 10C,A02,083444,Staff,25,0,30,5
1649825137966,MATH 10C,B01,084114,Staff,26,0,30,4
1649825137966,MATH 10C,B02,084115,Staff,30,0,30,0
1649825143990,MATH 18,A01,084117,Harel; Guershon,28,0,30,2
1649825143990,MATH 18,A02,084119,Harel; Guershon,29,0,30,1
1649825143990,MATH 18,A03,084120,Harel; Guershon,30,0,30,0
1649825143990,MATH 18,A04,084121,Harel; Guershon,30,0,30,0
1649825150014,MATH 20B,A01,084124,Um; Ko Woon,33,0,35,2
1649825150014,MATH 20B,B01,084126,Um; Ko Woon,35,0,35,0
1649825156044,MATH 20C,A01,083446,Hammock; Frances H,27,0,30,3
1649825156044,MATH 20C,A02,083447,Hammock; Frances H,30,0,30,0
1649825156044,MATH 20C,A03,083448,Hammock; Frances H,30,0,30,0
1649825156044,MATH 20C,A04,083449,Hammock; Frances H,30,0,30,0
1649825156044,MATH 20C,B01,083451,Hammock; Frances H,29,0,30,1
1649825156044,MATH 20C,B02,083452,Hammock; Frances H,30,0,30,0
1649825156044,MATH 20C,B03,083453,Hammock; Frances H,30,0,30,0
1649825156044,MATH 20C,B04,083454,Hammock; Frances H,30,0,30,0
1649825162073,MATH 20D,A01,084128,Staff,29,0,30,1
1649825162073,MATH 20D,A02,084129,Staff,30,0,30,0
1649825162073,MATH 20D,A03,084130,Staff,29,0,30,1
1649825162073,MATH 20D,B01,084133,Staff,28,0,30,2
1649825162073,MATH 20D,B02,084134,Staff,30,0,30,0
1649825162073,MATH 20D,B03,084135,Staff,30,0,30,0
1649825168106,MATH 20E,A01,084138,Staff,29,0,30,1
1649825168106,MATH 20E,A02,084139,Staff,29,0,30,1
1649825168106,MATH 20E,A03,084140,Staff,28,0,30,2
1649825168106,MATH 20E,A04,084141,Staff,30,0,30,0
1649825174135,MATH 102,A01,084143,Harel; Guershon,24,0,30,6
1649825174135,MATH 102,A02,084144,Harel; Guershon,25,0,30,5
1649825180162,MATH 103B,A01,083456,Staff,0,0,30,30
1649825180162,MATH 103B,A02,083457,Staff,21,0,30,9
1649825186186,MATH 109,A01,084146,Salehi Golsefidy; Alireza,30,0,30,0
1649825186186,MATH 109,A02,084147,Salehi Golsefidy; Alireza,27,0,30,3
1649825192214,MATH 120A,A01,085445,Eggers; John Dietrich,31,0,35,4
1649825192214,MATH 120A,A02,085446,Eggers; John Dietrich,31,0,35,4
1649825198237,MATH 142B,A01,084149,Verstraete; Jacques Allan,9,0,30,21
1649825198237,MATH 142B,A02,084150,Verstraete; Jacques Allan,25,0,30,5
1649825204265,MATH 170A,A01,083459,Nie; Jiawang,11,0,30,19
1649825204265,MATH 170A,A02,083460,Nie; Jiawang,25,0,30,5
1649825204265,MATH 170A,A03,083461,Nie; Jiawang,26,0,30,4
1649825210371,MATH 193B,A01,083463,Staff,18,0,30,12
1649825210371,MATH 193B,A02,083464,Staff,19,0,30,11
1649825210371,MATH 193B,A03,083465,Staff,27,0,30,3
1649825216430,COGS 2,A01,083966,Boyle; Mary E. T.,27,0,30,3
1649825222454,COGS 9,A01,083968,Staff,57,0,60,3
1649825228485,COGS 14B,A01,083970,Staff,47,0,50,3
1649825234512,COGS 17,A01,092679,Staff,73,0,75,2
1649825240538,COGS 100,A01,083972,Staff,47,0,60,13
1649825252590,COGS 101C,A01,083976,Staff,25,0,30,5
1649825258614,COGS 102A,A01,083978,Johnson; Christine M.,24,0,30,6
1649825264637,COGS 107B,A01,083980,Staff,40,0,50,10
1649825270661,COGS 115,A01,083982,Staff,22,0,30,8
1649825276693,COGS 118B,A01,083367,Staff,6,0,40,34
1649825282714,COGS 172,A01,083984,Provenzano; Emily Kara,21,0,30,9
1649825288740,COGS 177,A00,083368,Staff,6,0,30,24
1649825294764,COGS 186,A01,083986,Staff,25,0,40,15
1649825300789,COGS 187A,A01,083988,Boyle; Mary E. T.,41,0,60,19
1649825306814,CSE 8A,A50,084003,Miranda; Gregory Joseph,9,0,15,6
1649825312839,CSE 11,A01,084005,Miranda; Gregory Joseph,49,0,55,6
1649825318865,CSE 20,A01,084007,Staff,15,0,20,5
1649825324887,CSE 21,A01,084009,Staff,38,0,50,12
1649825330912,CSE 30,A01,083370,Cao; Yingjun,20,0,40,20
1649825336937,CSE 100,A01,083372,Cao; Yingjun,16,0,40,24
1649825342965,CSE 101,A01,084011,Staff,0,11,40,40
1649825348987,CSE 141,A01,083374,Eldon; John,0,8,75,75
1649825355015,CSE 141L,A01,083376,Eldon; John,0,10,75,75
1649825361036,CSE 175,A01,084013,Kumar; Rakesh,24,0,25,1
1649825367060,CSE 190,A00,092508,Staff,15,0,15,0
1649825373087,ECE 5,A01,084049,Morris; Karcher William,17,0,20,3
1649825379114,ECE 100,A01,084051,Baghdadchi; Saharnaz,16,0,20,4
1649825379114,ECE 100,A02,091916,Baghdadchi; Saharnaz,18,0,20,2
1649825385138,ECE 101,A01,084053,Baghdadchi; Saharnaz,25,0,37,12
1649825385138,ECE 101,A02,084054,Baghdadchi; Saharnaz,37,0,37,0
1649825391165,ECE 107,A01,083390,Staff,33,0,40,7
1649825397192,ECE 148,A01,084056,Silberman; Jack,8,0,12,4
1649825403219,ECE 180,A00,083391,Abi Samra; Nicholas Camill,27,0,30,3
1649825403219,ECE 180,B00,083392,Abi Samra; Nicholas Camill,26,0,30,4
1649825409254,MATH 10B,A01,084110,Staff,20,0,30,10
1649825409254,MATH 10B,A02,084111,Staff,29,0,30,1
1649825409254,MATH 10B,A03,084112,Staff,29,0,30,1
1649825415279,MATH 10C,A01,083443,Staff,20,0,30,10
1649825415279,MATH 10C,A02,083444,Staff,25,0,30,5
1649825415279,MATH 10C,B01,084114,Staff,26,0,30,4
1649825415279,MATH 10C,B02,084115,Staff,30,0,30,0
1649825421304,MATH 18,A01,084117,Harel; Guershon,28,0,30,2
1649825421304,MATH 18,A02,084119,Harel; Guershon,29,0,30,1
1649825421304,MATH 18,A03,084120,Harel; Guershon,30,0,30,0
1649825421304,MATH 18,A04,084121,Harel; Guershon,30,0,30,0
1649825427327,MATH 20B,A01,084124,Um; Ko Woon,33,0,35,2
1649825427327,MATH 20B,B01,084126,Um; Ko Woon,35,0,35,0
1649825433366,MATH 20C,A01,083446,Hammock; Frances H,27,0,30,3
1649825433366,MATH 20C,A02,083447,Hammock; Frances H,30,0,30,0
1649825433366,MATH 20C,A03,083448,Hammock; Frances H,30,0,30,0
1649825433366,MATH 20C,A04,083449,Hammock; Frances H,30,0,30,0
1649825433366,MATH 20C,B01,083451,Hammock; Frances H,29,0,30,1
1649825433366,MATH 20C,B02,083452,Hammock; Frances H,30,0,30,0
1649825433366,MATH 20C,B03,083453,Hammock; Frances H,30,0,30,0
1649825433366,MATH 20C,B04,083454,Hammock; Frances H,30,0,30,0
1649825439393,MATH 20D,A01,084128,Staff,29,0,30,1
1649825439393,MATH 20D,A02,084129,Staff,30,0,30,0
1649825439393,MATH 20D,A03,084130,Staff,29,0,30,1
1649825439393,MATH 20D,B01,084133,Staff,28,0,30,2
1649825439393,MATH 20D,B02,084134,Staff,30,0,30,0
1649825439393,MATH 20D,B03,084135,Staff,30,0,30,0
1649825445420,MATH 20E,A01,084138,Staff,29,0,30,1
1649825445420,MATH 20E,A02,084139,Staff,29,0,30,1
1649825445420,MATH 20E,A03,084140,Staff,28,0,30,2
1649825445420,MATH 20E,A04,084141,Staff,30,0,30,0
1649825451443,MATH 102,A01,084143,Harel; Guershon,24,0,30,6
1649825451443,MATH 102,A02,084144,Harel; Guershon,25,0,30,5
1649825457465,MATH 103B,A01,083456,Staff,0,0,30,30
1649825457465,MATH 103B,A02,083457,Staff,21,0,30,9
1649825463488,MATH 109,A01,084146,Salehi Golsefidy; Alireza,30,0,30,0
1649825463488,MATH 109,A02,084147,Salehi Golsefidy; Alireza,27,0,30,3
1649825469515,MATH 120A,A01,085445,Eggers; John Dietrich,31,0,35,4
1649825469515,MATH 120A,A02,085446,Eggers; John Dietrich,31,0,35,4
1649825475545,MATH 142B,A01,084149,Verstraete; Jacques Allan,9,0,30,21
1649825475545,MATH 142B,A02,084150,Verstraete; Jacques Allan,25,0,30,5
1649825481571,MATH 170A,A01,083459,Nie; Jiawang,11,0,30,19
1649825481571,MATH 170A,A02,083460,Nie; Jiawang,25,0,30,5
1649825481571,MATH 170A,A03,083461,Nie; Jiawang,26,0,30,4
1649825487595,MATH 193B,A01,083463,Staff,18,0,30,12
1649825487595,MATH 193B,A02,083464,Staff,19,0,30,11
1649825487595,MATH 193B,A03,083465,Staff,27,0,30,3
1649825493649,COGS 2,A01,083966,Boyle; Mary E. T.,27,0,30,3
1649825499676,COGS 9,A01,083968,Staff,57,0,60,3
1649825505707,COGS 14B,A01,083970,Staff,47,0,50,3
1649825511730,COGS 17,A01,092679,Staff,73,0,75,2
1649825517753,COGS 100,A01,083972,Staff,47,0,60,13
1649825529807,COGS 101C,A01,083976,Staff,25,0,30,5
1649825535832,COGS 102A,A01,083978,Johnson; Christine M.,24,0,30,6
1649825541855,COGS 107B,A01,083980,Staff,39,0,50,11
1649825547883,COGS 115,A01,083982,Staff,22,0,30,8
1649825553914,COGS 118B,A01,083367,Staff,6,0,40,34
1649825559941,COGS 172,A01,083984,Provenzano; Emily Kara,21,0,30,9
1649825565968,COGS 177,A00,083368,Staff,6,0,30,24
1649825571992,COGS 186,A01,083986,Staff,25,0,40,15
1649825578025,COGS 187A,A01,083988,Boyle; Mary E. T.,41,0,60,19
1649825584054,CSE 8A,A50,084003,Miranda; Gregory Joseph,9,0,15,6
1649825590077,CSE 11,A01,084005,Miranda; Gregory Joseph,49,0,55,6
1649825596099,CSE 20,A01,084007,Staff,15,0,20,5
1649825602126,CSE 21,A01,084009,Staff,37,0,50,13
1649825608152,CSE 30,A01,083370,Cao; Yingjun,20,0,40,20
1649825614180,CSE 100,A01,083372,Cao; Yingjun,16,0,40,24
1649825620204,CSE 101,A01,084011,Staff,0,11,40,40
1649825626228,CSE 141,A01,083374,Eldon; John,0,8,75,75
1649825632251,CSE 141L,A01,083376,Eldon; John,0,10,75,75
1649825638278,CSE 175,A01,084013,Kumar; Rakesh,24,0,25,1
1649825644309,CSE 190,A00,092508,Staff,15,0,15,0
1649825650336,ECE 5,A01,084049,Morris; Karcher William,17,0,20,3
1649825656360,ECE 100,A01,084051,Baghdadchi; Saharnaz,16,0,20,4
1649825656360,ECE 100,A02,091916,Baghdadchi; Saharnaz,18,0,20,2
1649825662392,ECE 101,A01,084053,Baghdadchi; Saharnaz,25,0,37,12
1649825662392,ECE 101,A02,084054,Baghdadchi; Saharnaz,37,0,37,0
1649825668416,ECE 107,A01,083390,Staff,33,0,40,7
1649825674441,ECE 148,A01,084056,Silberman; Jack,8,0,12,4
1649825680464,ECE 180,A00,083391,Abi Samra; Nicholas Camill,27,0,30,3
1649825680464,ECE 180,B00,083392,Abi Samra; Nicholas Camill,26,0,30,4
1649825686493,MATH 10B,A01,084110,Staff,20,0,30,10
1649825686493,MATH 10B,A02,084111,Staff,29,0,30,1
1649825686493,MATH 10B,A03,084112,Staff,29,0,30,1
1649825692532,MATH 10C,A01,083443,Staff,20,0,30,10
1649825692532,MATH 10C,A02,083444,Staff,25,0,30,5
1649825692532,MATH 10C,B01,084114,Staff,26,0,30,4
1649825692532,MATH 10C,B02,084115,Staff,30,0,30,0
1649825698569,MATH 18,A01,084117,Harel; Guershon,28,0,30,2
1649825698569,MATH 18,A02,084119,Harel; Guershon,29,0,30,1
1649825698569,MATH 18,A03,084120,Harel; Guershon,30,0,30,0
1649825698569,MATH 18,A04,084121,Harel; Guershon,30,0,30,0
1649825704593,MATH 20B,A01,084124,Um; Ko Woon,33,0,35,2
1649825704593,MATH 20B,B01,084126,Um; Ko Woon,35,0,35,0
1649825710626,MATH 20C,A01,083446,Hammock; Frances H,27,0,30,3
1649825710626,MATH 20C,A02,083447,Hammock; Frances H,30,0,30,0
1649825710626,MATH 20C,A03,083448,Hammock; Frances H,30,0,30,0
1649825710626,MATH 20C,A04,083449,Hammock; Frances H,30,0,30,0
1649825710626,MATH 20C,B01,083451,Hammock; Frances H,29,0,30,1
1649825710626,MATH 20C,B02,083452,Hammock; Frances H,30,0,30,0
1649825710626,MATH 20C,B03,083453,Hammock; Frances H,30,0,30,0
1649825710626,MATH 20C,B04,083454,Hammock; Frances H,30,0,30,0
1649825716650,MATH 20D,A01,084128,Staff,29,0,30,1
1649825716650,MATH 20D,A02,084129,Staff,30,0,30,0
1649825716650,MATH 20D,A03,084130,Staff,29,0,30,1
1649825716650,MATH 20D,B01,084133,Staff,28,0,30,2
1649825716650,MATH 20D,B02,084134,Staff,30,0,30,0
1649825716650,MATH 20D,B03,084135,Staff,30,0,30,0
1649825722676,MATH 20E,A01,084138,Staff,29,0,30,1
1649825722676,MATH 20E,A02,084139,Staff,29,0,30,1
1649825722676,MATH 20E,A03,084140,Staff,28,0,30,2
1649825722676,MATH 20E,A04,084141,Staff,30,0,30,0
1649825728702,MATH 102,A01,084143,Harel; Guershon,24,0,30,6
1649825728702,MATH 102,A02,084144,Harel; Guershon,25,0,30,5
1649825734726,MATH 103B,A01,083456,Staff,0,0,30,30
1649825734726,MATH 103B,A02,083457,Staff,21,0,30,9
1649825740749,MATH 109,A01,084146,Salehi Golsefidy; Alireza,30,0,30,0
1649825740749,MATH 109,A02,084147,Salehi Golsefidy; Alireza,27,0,30,3
1649825758149,MATH 120A,A01,085445,Eggers; John Dietrich,31,0,35,4
1649825758149,MATH 120A,A02,085446,Eggers; John Dietrich,31,0,35,4
1649825764177,MATH 142B,A01,084149,Verstraete; Jacques Allan,9,0,30,21
1649825764177,MATH 142B,A02,084150,Verstraete; Jacques Allan,25,0,30,5
1649825770205,MATH 170A,A01,083459,Nie; Jiawang,11,0,30,19
1649825770205,MATH 170A,A02,083460,Nie; Jiawang,25,0,30,5
1649825770205,MATH 170A,A03,083461,Nie; Jiawang,26,0,30,4
1649825776227,MATH 193B,A01,083463,Staff,18,0,30,12
1649825776227,MATH 193B,A02,083464,Staff,19,0,30,11
1649825776227,MATH 193B,A03,083465,Staff,27,0,30,3
1649825782287,COGS 2,A01,083966,Boyle; Mary E. T.,27,0,30,3
1649825788311,COGS 9,A01,083968,Staff,57,0,60,3
1649825794334,COGS 14B,A01,083970,Staff,47,0,50,3
1649825800360,COGS 17,A01,092679,Staff,73,0,75,2
1649825806382,COGS 100,A01,083972,Staff,47,0,60,13
1649825818520,COGS 101C,A01,083976,Staff,25,0,30,5
1649825824543,COGS 102A,A01,083978,Johnson; Christine M.,24,0,30,6
1649825830569,COGS 107B,A01,083980,Staff,39,0,50,11
1649825836598,COGS 115,A01,083982,Staff,22,0,30,8
1649825842625,COGS 118B,A01,083367,Staff,6,0,40,34
1649825848649,COGS 172,A01,083984,Provenzano; Emily Kara,21,0,30,9
1649825854672,COGS 177,A00,083368,Staff,6,0,30,24
1649825860768,COGS 186,A01,083986,Staff,25,0,40,15
1649825866795,COGS 187A,A01,083988,Boyle; Mary E. T.,41,0,60,19
1649825872832,CSE 8A,A50,084003,Miranda; Gregory Joseph,9,0,15,6
1649825878860,CSE 11,A01,084005,Miranda; Gregory Joseph,49,0,55,6
1649825884895,CSE 20,A01,084007,Staff,15,0,20,5
1649825890926,CSE 21,A01,084009,Staff,36,0,50,14
1649825896954,CSE 30,A01,083370,Cao; Yingjun,20,0,40,20
1649825902977,CSE 100,A01,083372,Cao; Yingjun,16,0,40,24
1649825909009,CSE 101,A01,084011,Staff,0,11,40,40
1649825915037,CSE 141,A01,083374,Eldon; John,0,8,75,75
1649825921061,CSE 141L,A01,083376,Eldon; John,0,10,75,75
1649825927085,CSE 175,A01,084013,Kumar; Rakesh,24,0,25,1
1649825933108,CSE 190,A00,092508,Staff,15,0,15,0
1649825939135,ECE 5,A01,084049,Morris; Karcher William,17,0,20,3
1649825945158,ECE 100,A01,084051,Baghdadchi; Saharnaz,16,0,20,4
1649825945158,ECE 100,A02,091916,Baghdadchi; Saharnaz,18,0,20,2
1649825951185,ECE 101,A01,084053,Baghdadchi; Saharnaz,25,0,37,12
1649825951185,ECE 101,A02,084054,Baghdadchi; Saharnaz,37,0,37,0
1649825957214,ECE 107,A01,083390,Staff,33,0,40,7
1649825963242,ECE 148,A01,084056,Silberman; Jack,8,0,12,4
1649825969267,ECE 180,A00,083391,Abi Samra; Nicholas Camill,27,0,30,3
1649825969267,ECE 180,B00,083392,Abi Samra; Nicholas Camill,26,0,30,4
1649825975290,MATH 10B,A01,084110,Staff,20,0,30,10
1649825975290,MATH 10B,A02,084111,Staff,29,0,30,1
1649825975290,MATH 10B,A03,084112,Staff,29,0,30,1
1649825981315,MATH 10C,A01,083443,Staff,20,0,30,10
1649825981315,MATH 10C,A02,083444,Staff,25,0,30,5
1649825981315,MATH 10C,B01,084114,Staff,26,0,30,4
1649825981315,MATH 10C,B02,084115,Staff,30,0,30,0
1649825987339,MATH 18,A01,084117,Harel; Guershon,28,0,30,2
1649825987339,MATH 18,A02,084119,Harel; Guershon,29,0,30,1
1649825987339,MATH 18,A03,084120,Harel; Guershon,30,0,30,0
1649825987339,MATH 18,A04,084121,Harel; Guershon,30,0,30,0
1649825993364,MATH 20B,A01,084124,Um; Ko Woon,33,0,35,2
1649825993364,MATH 20B,B01,084126,Um; Ko Woon,35,0,35,0
1649825999391,MATH 20C,A01,083446,Hammock; Frances H,27,0,30,3
1649825999391,MATH 20C,A02,083447,Hammock; Frances H,30,0,30,0
1649825999391,MATH 20C,A03,083448,Hammock; Frances H,30,0,30,0
1649825999391,MATH 20C,A04,083449,Hammock; Frances H,30,0,30,0
1649825999391,MATH 20C,B01,083451,Hammock; Frances H,29,0,30,1
1649825999391,MATH 20C,B02,083452,Hammock; Frances H,30,0,30,0
1649825999391,MATH 20C,B03,083453,Hammock; Frances H,30,0,30,0
1649825999391,MATH 20C,B04,083454,Hammock; Frances H,30,0,30,0
1649826005422,MATH 20D,A01,084128,Staff,29,0,30,1
1649826005422,MATH 20D,A02,084129,Staff,30,0,30,0
1649826005422,MATH 20D,A03,084130,Staff,29,0,30,1
1649826005422,MATH 20D,B01,084133,Staff,28,0,30,2
1649826005422,MATH 20D,B02,084134,Staff,30,0,30,0
1649826005422,MATH 20D,B03,084135,Staff,30,0,30,0
1649826011458,MATH 20E,A01,084138,Staff,29,0,30,1
1649826011458,MATH 20E,A02,084139,Staff,29,0,30,1
1649826011458,MATH 20E,A03,084140,Staff,28,0,30,2
1649826011458,MATH 20E,A04,084141,Staff,30,0,30,0
1649826017490,MATH 102,A01,084143,Harel; Guershon,24,0,30,6
1649826017490,MATH 102,A02,084144,Harel; Guershon,25,0,30,5
1649826023518,MATH 103B,A01,083456,Staff,0,0,30,30
1649826023518,MATH 103B,A02,083457,Staff,21,0,30,9
1649826029548,MATH 109,A01,084146,Salehi Golsefidy; Alireza,30,0,30,0
1649826029548,MATH 109,A02,084147,Salehi Golsefidy; Alireza,27,0,30,3
1649826035573,MATH 120A,A01,085445,Eggers; John Dietrich,31,0,35,4
1649826035573,MATH 120A,A02,085446,Eggers; John Dietrich,31,0,35,4
1649826041598,MATH 142B,A01,084149,Verstraete; Jacques Allan,9,0,30,21
1649826041598,MATH 142B,A02,084150,Verstraete; Jacques Allan,25,0,30,5
1649826047625,MATH 170A,A01,083459,Nie; Jiawang,11,0,30,19
1649826047625,MATH 170A,A02,083460,Nie; Jiawang,25,0,30,5
1649826047625,MATH 170A,A03,083461,Nie; Jiawang,26,0,30,4
1649826053649,MATH 193B,A01,083463,Staff,18,0,30,12
1649826053649,MATH 193B,A02,083464,Staff,19,0,30,11
1649826053649,MATH 193B,A03,083465,Staff,27,0,30,3
1649826059708,COGS 2,A01,083966,Boyle; Mary E. T.,27,0,30,3
1649826065739,COGS 9,A01,083968,Staff,57,0,60,3
1649826071768,COGS 14B,A01,083970,Staff,47,0,50,3
1649826077792,COGS 17,A01,092679,Staff,73,0,75,2
1649826083820,COGS 100,A01,083972,Staff,46,0,60,14
1649826095876,COGS 101C,A01,083976,Staff,25,0,30,5
1649826101898,COGS 102A,A01,083978,Johnson; Christine M.,24,0,30,6
1649826107922,COGS 107B,A01,083980,Staff,39,0,50,11
1649826113953,COGS 115,A01,083982,Staff,22,0,30,8
1649826119977,COGS 118B,A01,083367,Staff,6,0,40,34
1649826126004,COGS 172,A01,083984,Provenzano; Emily Kara,21,0,30,9
1649826132027,COGS 177,A00,083368,Staff,6,0,30,24
1649826138051,COGS 186,A01,083986,Staff,25,0,40,15
1649826144073,COGS 187A,A01,083988,Boyle; Mary E. T.,41,0,60,19
1649826150106,CSE 8A,A50,084003,Miranda; Gregory Joseph,9,0,15,6
1649826156132,CSE 11,A01,084005,Miranda; Gregory Joseph,49,0,55,6
1649826162158,CSE 20,A01,084007,Staff,15,0,20,5
1649826168185,CSE 21,A01,084009,Staff,35,0,50,15
1649826174208,CSE 30,A01,083370,Cao; Yingjun,20,0,40,20
1649826180235,CSE 100,A01,083372,Cao; Yingjun,16,0,40,24
1649826186259,CSE 101,A01,084011,Staff,0,11,40,40
1649826192282,CSE 141,A01,083374,Eldon; John,0,8,75,75
1649826198305,CSE 141L,A01,083376,Eldon; John,0,10,75,75
1649826204331,CSE 175,A01,084013,Kumar; Rakesh,24,0,25,1
1649826210356,CSE 190,A00,092508,Staff,15,0,15,0
1649826216378,ECE 5,A01,084049,Morris; Karcher William,17,0,20,3
1649826222402,ECE 100,A01,084051,Baghdadchi; Saharnaz,16,0,20,4
1649826222402,ECE 100,A02,091916,Baghdadchi; Saharnaz,18,0,20,2
1649826228430,ECE 101,A01,084053,Baghdadchi; Saharnaz,25,0,37,12
1649826228430,ECE 101,A02,084054,Baghdadchi; Saharnaz,37,0,37,0
1649826234464,ECE 107,A01,083390,Staff,33,0,40,7
1649826240491,ECE 148,A01,084056,Silberman; Jack,8,0,12,4
1649826246519,ECE 180,A00,083391,Abi Samra; Nicholas Camill,27,0,30,3
1649826246519,ECE 180,B00,083392,Abi Samra; Nicholas Camill,26,0,30,4
1649826252546,MATH 10B,A01,084110,Staff,20,0,30,10
1649826252546,MATH 10B,A02,084111,Staff,29,0,30,1
1649826252546,MATH 10B,A03,084112,Staff,29,0,30,1
1649826258575,MATH 10C,A01,083443,Staff,20,0,30,10
1649826258575,MATH 10C,A02,083444,Staff,25,0,30,5
1649826258575,MATH 10C,B01,084114,Staff,26,0,30,4
1649826258575,MATH 10C,B02,084115,Staff,30,0,30,0
1649826264598,MATH 18,A01,084117,Harel; Guershon,28,0,30,2
1649826264598,MATH 18,A02,084119,Harel; Guershon,29,0,30,1
1649826264598,MATH 18,A03,084120,Harel; Guershon,30,0,30,0
1649826264598,MATH 18,A04,084121,Harel; Guershon,30,0,30,0
1649826270622,MATH 20B,A01,084124,Um; Ko Woon,33,0,35,2
1649826270622,MATH 20B,B01,084126,Um; Ko Woon,35,0,35,0
1649826276650,MATH 20C,A01,083446,Hammock; Frances H,27,0,30,3
1649826276650,MATH 20C,A02,083447,Hammock; Frances H,30,0,30,0
1649826276650,MATH 20C,A03,083448,Hammock; Frances H,30,0,30,0
1649826276650,MATH 20C,A04,083449,Hammock; Frances H,30,0,30,0
1649826276650,MATH 20C,B01,083451,Hammock; Frances H,29,0,30,1
1649826276650,MATH 20C,B02,083452,Hammock; Frances H,30,0,30,0
1649826276650,MATH 20C,B03,083453,Hammock; Frances H,30,0,30,0
1649826276650,MATH 20C,B04,083454,Hammock; Frances H,30,0,30,0
1649826282677,MATH 20D,A01,084128,Staff,29,0,30,1
1649826282677,MATH 20D,A02,084129,Staff,30,0,30,0
1649826282677,MATH 20D,A03,084130,Staff,29,0,30,1
1649826282677,MATH 20D,B01,084133,Staff,28,0,30,2
1649826282677,MATH 20D,B02,084134,Staff,30,0,30,0
1649826282677,MATH 20D,B03,084135,Staff,30,0,30,0
1649826288699,MATH 20E,A01,084138,Staff,29,0,30,1
1649826288699,MATH 20E,A02,084139,Staff,29,0,30,1
1649826288699,MATH 20E,A03,084140,Staff,28,0,30,2
1649826288699,MATH 20E,A04,084141,Staff,30,0,30,0
1649826294723,MATH 102,A01,084143,Harel; Guershon,24,0,30,6
1649826294723,MATH 102,A02,084144,Harel; Guershon,25,0,30,5
1649826300751,MATH 103B,A01,083456,Staff,0,0,30,30
1649826300751,MATH 103B,A02,083457,Staff,21,0,30,9
1649826306775,MATH 109,A01,084146,Salehi Golsefidy; Alireza,30,0,30,0
1649826306775,MATH 109,A02,084147,Salehi Golsefidy; Alireza,27,0,30,3
1649826312802,MATH 120A,A01,085445,Eggers; John Dietrich,31,0,35,4
1649826312802,MATH 120A,A02,085446,Eggers; John Dietrich,31,0,35,4
1649826318826,MATH 142B,A01,084149,Verstraete; Jacques Allan,9,0,30,21
1649826318826,MATH 142B,A02,084150,Verstraete; Jacques Allan,25,0,30,5
1649826324853,MATH 170A,A01,083459,Nie; Jiawang,11,0,30,19
1649826324853,MATH 170A,A02,083460,Nie; Jiawang,25,0,30,5
1649826324853,MATH 170A,A03,083461,Nie; Jiawang,26,0,30,4
1649826330882,MATH 193B,A01,083463,Staff,18,0,30,12
1649826330882,MATH 193B,A02,083464,Staff,19,0,30,11
1649826330882,MATH 193B,A03,083465,Staff,27,0,30,3
1649826336938,COGS 2,A01,083966,Boyle; Mary E. T.,27,0,30,3
1649826342961,COGS 9,A01,083968,Staff,57,0,60,3
1649826348986,COGS 14B,A01,083970,Staff,47,0,50,3
1649826355011,COGS 17,A01,092679,Staff,73,0,75,2
1649826361035,COGS 100,A01,083972,Staff,46,0,60,14
1649826373085,COGS 101C,A01,083976,Staff,25,0,30,5
1649826379112,COGS 102A,A01,083978,Johnson; Christine M.,24,0,30,6
1649826385136,COGS 107B,A01,083980,Staff,39,0,50,11
1649826391162,COGS 115,A01,083982,Staff,21,0,30,9
1649826397186,COGS 118B,A01,083367,Staff,6,0,40,34
1649826403210,COGS 172,A01,083984,Provenzano; Emily Kara,21,0,30,9
1649826409233,COGS 177,A00,083368,Staff,6,0,30,24
1649826415257,COGS 186,A01,083986,Staff,25,0,40,15
1649826421280,COGS 187A,A01,083988,Boyle; Mary E. T.,41,0,60,19
1649826427309,CSE 8A,A50,084003,Miranda; Gregory Joseph,9,0,15,6
1649826433335,CSE 11,A01,084005,Miranda; Gregory Joseph,49,0,55,6
1649826439369,CSE 20,A01,084007,Staff,15,0,20,5
1649826445402,CSE 21,A01,084009,Staff,35,0,50,15
1649826451428,CSE 30,A01,083370,Cao; Yingjun,20,0,40,20
1649826457544,CSE 100,A01,083372,Cao; Yingjun,16,0,40,24
1649826463570,CSE 101,A01,084011,Staff,0,11,40,40
1649826469598,CSE 141,A01,083374,Eldon; John,0,8,75,75
1649826475623,CSE 141L,A01,083376,Eldon; John,0,10,75,75
1649826481651,CSE 175,A01,084013,Kumar; Rakesh,24,0,25,1
1649826487677,CSE 190,A00,092508,Staff,15,0,15,0
1649826493700,ECE 5,A01,084049,Morris; Karcher William,17,0,20,3
1649826499724,ECE 100,A01,084051,Baghdadchi; Saharnaz,16,0,20,4
1649826499724,ECE 100,A02,091916,Baghdadchi; Saharnaz,18,0,20,2
1649826505748,ECE 101,A01,084053,Baghdadchi; Saharnaz,25,0,37,12
1649826505748,ECE 101,A02,084054,Baghdadchi; Saharnaz,37,0,37,0
1649826511772,ECE 107,A01,083390,Staff,33,0,40,7
1649826517796,ECE 148,A01,084056,Silberman; Jack,8,0,12,4
1649826523819,ECE 180,A00,083391,Abi Samra; Nicholas Camill,27,0,30,3
1649826523819,ECE 180,B00,083392,Abi Samra; Nicholas Camill,26,0,30,4
1649826529841,MATH 10B,A01,084110,Staff,20,0,30,10
1649826529841,MATH 10B,A02,084111,Staff,29,0,30,1
1649826529841,MATH 10B,A03,084112,Staff,29,0,30,1
1649826535866,MATH 10C,A01,083443,Staff,20,0,30,10
1649826535866,MATH 10C,A02,083444,Staff,25,0,30,5
1649826535866,MATH 10C,B01,084114,Staff,26,0,30,4
1649826535866,MATH 10C,B02,084115,Staff,30,0,30,0
1649826541892,MATH 18,A01,084117,Harel; Guershon,28,0,30,2
1649826541892,MATH 18,A02,084119,Harel; Guershon,29,0,30,1
1649826541892,MATH 18,A03,084120,Harel; Guershon,30,0,30,0
1649826541892,MATH 18,A04,084121,Harel; Guershon,30,0,30,0
1649826547915,MATH 20B,A01,084124,Um; Ko Woon,33,0,35,2
1649826547915,MATH 20B,B01,084126,Um; Ko Woon,35,0,35,0
1649826553945,MATH 20C,A01,083446,Hammock; Frances H,27,0,30,3
1649826553945,MATH 20C,A02,083447,Hammock; Frances H,30,0,30,0
1649826553945,MATH 20C,A03,083448,Hammock; Frances H,30,0,30,0
1649826553945,MATH 20C,A04,083449,Hammock; Frances H,30,0,30,0
1649826553945,MATH 20C,B01,083451,Hammock; Frances H,29,0,30,1
1649826553945,MATH 20C,B02,083452,Hammock; Frances H,30,0,30,0
1649826553945,MATH 20C,B03,083453,Hammock; Frances H,30,0,30,0
1649826553945,MATH 20C,B04,083454,Hammock; Frances H,30,0,30,0
1649826559970,MATH 20D,A01,084128,Staff,29,0,30,1
1649826559970,MATH 20D,A02,084129,Staff,30,0,30,0
1649826559970,MATH 20D,A03,084130,Staff,29,0,30,1
1649826559970,MATH 20D,B01,084133,Staff,28,0,30,2
1649826559970,MATH 20D,B02,084134,Staff,30,0,30,0
1649826559970,MATH 20D,B03,084135,Staff,30,0,30,0
1649826565993,MATH 20E,A01,084138,Staff,29,0,30,1
1649826565993,MATH 20E,A02,084139,Staff,29,0,30,1
1649826565993,MATH 20E,A03,084140,Staff,28,0,30,2
1649826565993,MATH 20E,A04,084141,Staff,30,0,30,0
1649826572021,MATH 102,A01,084143,Harel; Guershon,24,0,30,6
1649826572021,MATH 102,A02,084144,Harel; Guershon,25,0,30,5
1649826578043,MATH 103B,A01,083456,Staff,0,0,30,30
1649826578043,MATH 103B,A02,083457,Staff,21,0,30,9
1649826584066,MATH 109,A01,084146,Salehi Golsefidy; Alireza,30,0,30,0
1649826584066,MATH 109,A02,084147,Salehi Golsefidy; Alireza,27,0,30,3
1649826590101,MATH 120A,A01,085445,Eggers; John Dietrich,31,0,35,4
1649826590101,MATH 120A,A02,085446,Eggers; John Dietrich,31,0,35,4
1649826596124,MATH 142B,A01,084149,Verstraete; Jacques Allan,9,0,30,21
1649826596124,MATH 142B,A02,084150,Verstraete; Jacques Allan,25,0,30,5
1649826602148,MATH 170A,A01,083459,Nie; Jiawang,10,0,30,20
1649826602148,MATH 170A,A02,083460,Nie; Jiawang,25,0,30,5
1649826602148,MATH 170A,A03,083461,Nie; Jiawang,26,0,30,4
1649826608172,MATH 193B,A01,083463,Staff,17,0,30,13
1649826608172,MATH 193B,A02,083464,Staff,19,0,30,11
1649826608172,MATH 193B,A03,083465,Staff,27,0,30,3
1649826614243,COGS 2,A01,083966,Boyle; Mary E. T.,27,0,30,3
1649826620268,COGS 9,A01,083968,Staff,57,0,60,3
1649826626298,COGS 14B,A01,083970,Staff,47,0,50,3
1649826632355,COGS 17,A01,092679,Staff,73,0,75,2
1649826638378,COGS 100,A01,083972,Staff,46,0,60,14
1649826650429,COGS 101C,A01,083976,Staff,25,0,30,5
1649826656452,COGS 102A,A01,083978,Johnson; Christine M.,24,0,30,6
1649826662477,COGS 107B,A01,083980,Staff,39,0,50,11
1649826668509,COGS 115,A01,083982,Staff,21,0,30,9
1649826674538,COGS 118B,A01,083367,Staff,6,0,40,34
1649826680561,COGS 172,A01,083984,Provenzano; Emily Kara,21,0,30,9
1649826686586,COGS 177,A00,083368,Staff,6,0,30,24
1649826692611,COGS 186,A01,083986,Staff,25,0,40,15
1649826698644,COGS 187A,A01,083988,Boyle; Mary E. T.,41,0,60,19
1649826704670,CSE 8A,A50,084003,Miranda; Gregory Joseph,9,0,15,6
1649826710697,CSE 11,A01,084005,Miranda; Gregory Joseph,49,0,55,6
1649826716732,CSE 20,A01,084007,Staff,15,0,20,5
1649826722757,CSE 21,A01,084009,Staff,35,0,50,15
1649826728781,CSE 30,A01,083370,Cao; Yingjun,20,0,40,20
1649826734803,CSE 100,A01,083372,Cao; Yingjun,16,0,40,24
1649826740827,CSE 101,A01,084011,Staff,0,11,40,40
1649826746858,CSE 141,A01,083374,Eldon; John,0,9,75,75
1649826752881,CSE 141L,A01,083376,Eldon; John,0,11,75,75
1649826758905,CSE 175,A01,084013,Kumar; Rakesh,24,0,25,1
1649826764930,CSE 190,A00,092508,Staff,15,0,15,0
1649826770960,ECE 5,A01,084049,Morris; Karcher William,17,0,20,3
1649826776993,ECE 100,A01,084051,Baghdadchi; Saharnaz,16,0,20,4
1649826776993,ECE 100,A02,091916,Baghdadchi; Saharnaz,18,0,20,2
1649826783021,ECE 101,A01,084053,Baghdadchi; Saharnaz,25,0,37,12
1649826783021,ECE 101,A02,084054,Baghdadchi; Saharnaz,37,0,37,0
1649826789043,ECE 107,A01,083390,Staff,33,0,40,7
1649826795669,ECE 148,A01,084056,Silberman; Jack,8,0,12,4
1649826801692,ECE 180,A00,083391,Abi Samra; Nicholas Camill,27,0,30,3
1649826801692,ECE 180,B00,083392,Abi Samra; Nicholas Camill,26,0,30,4
1649826807716,MATH 10B,A01,084110,Staff,20,0,30,10
1649826807716,MATH 10B,A02,084111,Staff,29,0,30,1
1649826807716,MATH 10B,A03,084112,Staff,29,0,30,1
1649826813744,MATH 10C,A01,083443,Staff,20,0,30,10
1649826813744,MATH 10C,A02,083444,Staff,25,0,30,5
1649826813744,MATH 10C,B01,084114,Staff,26,0,30,4
1649826813744,MATH 10C,B02,084115,Staff,30,0,30,0
1649826819771,MATH 18,A01,084117,Harel; Guershon,28,0,30,2
1649826819771,MATH 18,A02,084119,Harel; Guershon,29,0,30,1
1649826819771,MATH 18,A03,084120,Harel; Guershon,30,0,30,0
1649826819771,MATH 18,A04,084121,Harel; Guershon,30,0,30,0
1649826825798,MATH 20B,A01,084124,Um; Ko Woon,33,0,35,2
1649826825798,MATH 20B,B01,084126,Um; Ko Woon,35,0,35,0
1649826831824,MATH 20C,A01,083446,Hammock; Frances H,27,0,30,3
1649826831824,MATH 20C,A02,083447,Hammock; Frances H,30,0,30,0
1649826831824,MATH 20C,A03,083448,Hammock; Frances H,30,0,30,0
1649826831824,MATH 20C,A04,083449,Hammock; Frances H,30,0,30,0
1649826831824,MATH 20C,B01,083451,Hammock; Frances H,29,0,30,1
1649826831824,MATH 20C,B02,083452,Hammock; Frances H,30,0,30,0
1649826831824,MATH 20C,B03,083453,Hammock; Frances H,30,0,30,0
1649826831824,MATH 20C,B04,083454,Hammock; Frances H,30,0,30,0
1649826837863,MATH 20D,A01,084128,Staff,29,0,30,1
1649826837863,MATH 20D,A02,084129,Staff,30,0,30,0
1649826837863,MATH 20D,A03,084130,Staff,29,0,30,1
1649826837863,MATH 20D,B01,084133,Staff,28,0,30,2
1649826837863,MATH 20D,B02,084134,Staff,30,0,30,0
1649826837863,MATH 20D,B03,084135,Staff,30,0,30,0
1649826843886,MATH 20E,A01,084138,Staff,29,0,30,1
1649826843886,MATH 20E,A02,084139,Staff,29,0,30,1
1649826843886,MATH 20E,A03,084140,Staff,28,0,30,2
1649826843886,MATH 20E,A04,084141,Staff,30,0,30,0
1649826849907,MATH 102,A01,084143,Harel; Guershon,24,0,30,6
1649826849907,MATH 102,A02,084144,Harel; Guershon,25,0,30,5
1649826855931,MATH 103B,A01,083456,Staff,0,0,30,30
1649826855931,MATH 103B,A02,083457,Staff,21,0,30,9
1649826861958,MATH 109,A01,084146,Salehi Golsefidy; Alireza,30,0,30,0
1649826861958,MATH 109,A02,084147,Salehi Golsefidy; Alireza,27,0,30,3
1649826867985,MATH 120A,A01,085445,Eggers; John Dietrich,31,0,35,4
1649826867985,MATH 120A,A02,085446,Eggers; John Dietrich,31,0,35,4
1649826874017,MATH 142B,A01,084149,Verstraete; Jacques Allan,9,0,30,21
1649826874017,MATH 142B,A02,084150,Verstraete; Jacques Allan,25,0,30,5
1649826880040,MATH 170A,A01,083459,Nie; Jiawang,10,0,30,20
1649826880040,MATH 170A,A02,083460,Nie; Jiawang,25,0,30,5
1649826880040,MATH 170A,A03,083461,Nie; Jiawang,26,0,30,4
1649826886070,MATH 193B,A01,083463,Staff,16,0,30,14
1649826886070,MATH 193B,A02,083464,Staff,19,0,30,11
1649826886070,MATH 193B,A03,083465,Staff,27,0,30,3
1649826892123,COGS 2,A01,083966,Boyle; Mary E. T.,27,0,30,3
1649826898149,COGS 9,A01,083968,Staff,57,0,60,3
1649826904175,COGS 14B,A01,083970,Staff,47,0,50,3
1649826910205,COGS 17,A01,092679,Staff,73,0,75,2
1649826916234,COGS 100,A01,083972,Staff,46,0,60,14
1649826928283,COGS 101C,A01,083976,Staff,25,0,30,5
1649826934308,COGS 102A,A01,083978,Johnson; Christine M.,24,0,30,6
1649826940334,COGS 107B,A01,083980,Staff,39,0,50,11
1649826946364,COGS 115,A01,083982,Staff,21,0,30,9
1649826952397,COGS 118B,A01,083367,Staff,6,0,40,34
1649826958421,COGS 172,A01,083984,Provenzano; Emily Kara,21,0,30,9
1649826964455,COGS 177,A00,083368,Staff,6,0,30,24
1649826970480,COGS 186,A01,083986,Staff,25,0,40,15
1649826976503,COGS 187A,A01,083988,Boyle; Mary E. T.,41,0,60,19
1649826982525,CSE 8A,A50,084003,Miranda; Gregory Joseph,9,0,15,6
1649826988550,CSE 11,A01,084005,Miranda; Gregory Joseph,49,0,55,6
1649826994577,CSE 20,A01,084007,Staff,15,0,20,5
1649827000604,CSE 21,A01,084009,Staff,35,0,50,15
1649827006630,CSE 30,A01,083370,Cao; Yingjun,20,0,40,20
1649827012654,CSE 100,A01,083372,Cao; Yingjun,16,0,40,24
1649827018678,CSE 101,A01,084011,Staff,0,11,40,40
1649827024705,CSE 141,A01,083374,Eldon; John,0,9,75,75
1649827030728,CSE 141L,A01,083376,Eldon; John,0,11,75,75
1649827036751,CSE 175,A01,084013,Kumar; Rakesh,24,0,25,1
1649827042776,CSE 190,A00,092508,Staff,15,0,15,0
1649827048803,ECE 5,A01,084049,Morris; Karcher William,17,0,20,3
1649827054927,ECE 100,A01,084051,Baghdadchi; Saharnaz,16,0,20,4
1649827054927,ECE 100,A02,091916,Baghdadchi; Saharnaz,18,0,20,2
1649827060949,ECE 101,A01,084053,Baghdadchi; Saharnaz,25,0,37,12
1649827060949,ECE 101,A02,084054,Baghdadchi; Saharnaz,37,0,37,0
1649827066971,ECE 107,A01,083390,Staff,33,0,40,7
1649827072995,ECE 148,A01,084056,Silberman; Jack,8,0,12,4
1649827079018,ECE 180,A00,083391,Abi Samra; Nicholas Camill,27,0,30,3
1649827079018,ECE 180,B00,083392,Abi Samra; Nicholas Camill,26,0,30,4
1649827085056,MATH 10B,A01,084110,Staff,20,0,30,10
1649827085056,MATH 10B,A02,084111,Staff,29,0,30,1
1649827085056,MATH 10B,A03,084112,Staff,29,0,30,1
1649827091081,MATH 10C,A01,083443,Staff,20,0,30,10
1649827091081,MATH 10C,A02,083444,Staff,25,0,30,5
1649827091081,MATH 10C,B01,084114,Staff,26,0,30,4
1649827091081,MATH 10C,B02,084115,Staff,30,0,30,0
1649827097110,MATH 18,A01,084117,Harel; Guershon,28,0,30,2
1649827097110,MATH 18,A02,084119,Harel; Guershon,29,0,30,1
1649827097110,MATH 18,A03,084120,Harel; Guershon,30,0,30,0
1649827097110,MATH 18,A04,084121,Harel; Guershon,30,0,30,0
1649827103134,MATH 20B,A01,084124,Um; Ko Woon,33,0,35,2
1649827103134,MATH 20B,B01,084126,Um; Ko Woon,35,0,35,0
1649827109158,MATH 20C,A01,083446,Hammock; Frances H,27,0,30,3
1649827109158,MATH 20C,A02,083447,Hammock; Frances H,30,0,30,0
1649827109158,MATH 20C,A03,083448,Hammock; Frances H,30,0,30,0
1649827109158,MATH 20C,A04,083449,Hammock; Frances H,30,0,30,0
1649827109158,MATH 20C,B01,083451,Hammock; Frances H,29,0,30,1
1649827109158,MATH 20C,B02,083452,Hammock; Frances H,30,0,30,0
1649827109158,MATH 20C,B03,083453,Hammock; Frances H,30,0,30,0
1649827109158,MATH 20C,B04,083454,Hammock; Frances H,30,0,30,0
1649827115190,MATH 20D,A01,084128,Staff,29,0,30,1
1649827115190,MATH 20D,A02,084129,Staff,30,0,30,0
1649827115190,MATH 20D,A03,084130,Staff,29,0,30,1
1649827115190,MATH 20D,B01,084133,Staff,28,0,30,2
1649827115190,MATH 20D,B02,084134,Staff,30,0,30,0
1649827115190,MATH 20D,B03,084135,Staff,30,0,30,0
1649827121216,MATH 20E,A01,084138,Staff,29,0,30,1
1649827121216,MATH 20E,A02,084139,Staff,29,0,30,1
1649827121216,MATH 20E,A03,084140,Staff,28,0,30,2
1649827121216,MATH 20E,A04,084141,Staff,30,0,30,0
1649827127243,MATH 102,A01,084143,Harel; Guershon,24,0,30,6
1649827127243,MATH 102,A02,084144,Harel; Guershon,25,0,30,5
1649827133266,MATH 103B,A01,083456,Staff,0,0,30,30
1649827133266,MATH 103B,A02,083457,Staff,21,0,30,9
1649827139292,MATH 109,A01,084146,Salehi Golsefidy; Alireza,30,0,30,0
1649827139292,MATH 109,A02,084147,Salehi Golsefidy; Alireza,27,0,30,3
1649827145316,MATH 120A,A01,085445,Eggers; John Dietrich,31,0,35,4
1649827145316,MATH 120A,A02,085446,Eggers; John Dietrich,31,0,35,4
1649827151351,MATH 142B,A01,084149,Verstraete; Jacques Allan,9,0,30,21
1649827151351,MATH 142B,A02,084150,Verstraete; Jacques Allan,25,0,30,5
1649827157375,MATH 170A,A01,083459,Nie; Jiawang,10,0,30,20
1649827157375,MATH 170A,A02,083460,Nie; Jiawang,25,0,30,5
1649827157375,MATH 170A,A03,083461,Nie; Jiawang,26,0,30,4
1649827163398,MATH 193B,A01,083463,Staff,16,0,30,14
1649827163398,MATH 193B,A02,083464,Staff,19,0,30,11
1649827163398,MATH 193B,A03,083465,Staff,27,0,30,3
1649827169450,COGS 2,A01,083966,Boyle; Mary E. T.,27,0,30,3
1649827175474,COGS 9,A01,083968,Staff,57,0,60,3
1649827181498,COGS 14B,A01,083970,Staff,47,0,50,3
1649827187521,COGS 17,A01,092679,Staff,73,0,75,2
1649827193549,COGS 100,A01,083972,Staff,46,0,60,14
1649827205606,COGS 101C,A01,083976,Staff,25,0,30,5
1649827211630,COGS 102A,A01,083978,Johnson; Christine M.,24,0,30,6
1649827217654,COGS 107B,A01,083980,Staff,38,0,50,12
1649827223689,COGS 115,A01,083982,Staff,21,0,30,9
1649827229716,COGS 118B,A01,083367,Staff,6,0,40,34
1649827235741,COGS 172,A01,083984,Provenzano; Emily Kara,21,0,30,9
1649827241765,COGS 177,A00,083368,Staff,6,0,30,24
1649827247790,COGS 186,A01,083986,Staff,25,0,40,15
1649827253814,COGS 187A,A01,083988,Boyle; Mary E. T.,41,0,60,19
1649827259838,CSE 8A,A50,084003,Miranda; Gregory Joseph,9,0,15,6
1649827265871,CSE 11,A01,084005,Miranda; Gregory Joseph,49,0,55,6
1649827271894,CSE 20,A01,084007,Staff,15,0,20,5
1649827277919,CSE 21,A01,084009,Staff,35,0,50,15
1649827283947,CSE 30,A01,083370,Cao; Yingjun,20,0,40,20
1649827289971,CSE 100,A01,083372,Cao; Yingjun,16,0,40,24
1649827295997,CSE 101,A01,084011,Staff,0,11,40,40
1649827302021,CSE 141,A01,083374,Eldon; John,0,9,75,75
1649827308045,CSE 141L,A01,083376,Eldon; John,0,11,75,75
1649827314068,CSE 175,A01,084013,Kumar; Rakesh,24,0,25,1
1649827320091,CSE 190,A00,092508,Staff,15,0,15,0
1649827326118,ECE 5,A01,084049,Morris; Karcher William,17,0,20,3
1649827332143,ECE 100,A01,084051,Baghdadchi; Saharnaz,16,0,20,4
1649827332143,ECE 100,A02,091916,Baghdadchi; Saharnaz,18,0,20,2
1649827338166,ECE 101,A01,084053,Baghdadchi; Saharnaz,25,0,37,12
1649827338166,ECE 101,A02,084054,Baghdadchi; Saharnaz,37,0,37,0
1649827344193,ECE 107,A01,083390,Staff,33,0,40,7
1649827350216,ECE 148,A01,084056,Silberman; Jack,8,0,12,4
1649827356244,ECE 180,A00,083391,Abi Samra; Nicholas Camill,27,0,30,3
1649827356244,ECE 180,B00,083392,Abi Samra; Nicholas Camill,26,0,30,4
1649827362267,MATH 10B,A01,084110,Staff,20,0,30,10
1649827362267,MATH 10B,A02,084111,Staff,29,0,30,1
1649827362267,MATH 10B,A03,084112,Staff,29,0,30,1
1649827368292,MATH 10C,A01,083443,Staff,20,0,30,10
1649827368292,MATH 10C,A02,083444,Staff,25,0,30,5
1649827368292,MATH 10C,B01,084114,Staff,26,0,30,4
1649827368292,MATH 10C,B02,084115,Staff,30,0,30,0
1649827374329,MATH 18,A01,084117,Harel; Guershon,28,0,30,2
1649827374329,MATH 18,A02,084119,Harel; Guershon,29,0,30,1
1649827374329,MATH 18,A03,084120,Harel; Guershon,30,0,30,0
1649827374329,MATH 18,A04,084121,Harel; Guershon,30,0,30,0
1649827380354,MATH 20B,A01,084124,Um; Ko Woon,33,0,35,2
1649827380354,MATH 20B,B01,084126,Um; Ko Woon,35,0,35,0
1649827386378,MATH 20C,A01,083446,Hammock; Frances H,27,0,30,3
1649827386378,MATH 20C,A02,083447,Hammock; Frances H,30,0,30,0
1649827386378,MATH 20C,A03,083448,Hammock; Frances H,30,0,30,0
1649827386378,MATH 20C,A04,083449,Hammock; Frances H,30,0,30,0
1649827386378,MATH 20C,B01,083451,Hammock; Frances H,29,0,30,1
1649827386378,MATH 20C,B02,083452,Hammock; Frances H,30,0,30,0
1649827386378,MATH 20C,B03,083453,Hammock; Frances H,30,0,30,0
1649827386378,MATH 20C,B04,083454,Hammock; Frances H,30,0,30,0
1649827392401,MATH 20D,A01,084128,Staff,29,0,30,1
1649827392401,MATH 20D,A02,084129,Staff,30,0,30,0
1649827392401,MATH 20D,A03,084130,Staff,29,0,30,1
1649827392401,MATH 20D,B01,084133,Staff,28,0,30,2
1649827392401,MATH 20D,B02,084134,Staff,30,0,30,0
1649827392401,MATH 20D,B03,084135,Staff,30,0,30,0
1649827398429,MATH 20E,A01,084138,Staff,29,0,30,1
1649827398429,MATH 20E,A02,084139,Staff,29,0,30,1
1649827398429,MATH 20E,A03,084140,Staff,28,0,30,2
1649827398429,MATH 20E,A04,084141,Staff,30,0,30,0
1649827404456,MATH 102,A01,084143,Harel; Guershon,24,0,30,6
1649827404456,MATH 102,A02,084144,Harel; Guershon,25,0,30,5
1649827410483,MATH 103B,A01,083456,Staff,0,0,30,30
1649827410483,MATH 103B,A02,083457,Staff,21,0,30,9
1649827416507,MATH 109,A01,084146,Salehi Golsefidy; Alireza,30,0,30,0
1649827416507,MATH 109,A02,084147,Salehi Golsefidy; Alireza,27,0,30,3
1649827422533,MATH 120A,A01,085445,Eggers; John Dietrich,31,0,35,4
1649827422533,MATH 120A,A02,085446,Eggers; John Dietrich,31,0,35,4
1649827428555,MATH 142B,A01,084149,Verstraete; Jacques Allan,9,0,30,21
1649827428555,MATH 142B,A02,084150,Verstraete; Jacques Allan,25,0,30,5
1649827434583,MATH 170A,A01,083459,Nie; Jiawang,10,0,30,20
1649827434583,MATH 170A,A02,083460,Nie; Jiawang,25,0,30,5
1649827434583,MATH 170A,A03,083461,Nie; Jiawang,26,0,30,4
1649827440610,MATH 193B,A01,083463,Staff,16,0,30,14
1649827440610,MATH 193B,A02,083464,Staff,19,0,30,11
1649827440610,MATH 193B,A03,083465,Staff,27,0,30,3
1649827446660,COGS 2,A01,083966,Boyle; Mary E. T.,27,0,30,3
1649827452687,COGS 9,A01,083968,Staff,57,0,60,3
1649827458720,COGS 14B,A01,083970,Staff,47,0,50,3
1649827464749,COGS 17,A01,092679,Staff,73,0,75,2
1649827470775,COGS 100,A01,083972,Staff,46,0,60,14
1649827482827,COGS 101C,A01,083976,Staff,25,0,30,5
1649827488855,COGS 102A,A01,083978,Johnson; Christine M.,24,0,30,6
1649827494876,COGS 107B,A01,083980,Staff,38,0,50,12
1649827500903,COGS 115,A01,083982,Staff,21,0,30,9
1649827506929,COGS 118B,A01,083367,Staff,6,0,40,34
1649827512951,COGS 172,A01,083984,Provenzano; Emily Kara,21,0,30,9
1649827518988,COGS 177,A00,083368,Staff,6,0,30,24
1649827525012,COGS 186,A01,083986,Staff,25,0,40,15
1649827531038,COGS 187A,A01,083988,Boyle; Mary E. T.,41,0,60,19
1649827537061,CSE 8A,A50,084003,Miranda; Gregory Joseph,9,0,15,6
1649827543095,CSE 11,A01,084005,Miranda; Gregory Joseph,49,0,55,6
1649827549122,CSE 20,A01,084007,Staff,15,0,20,5
1649827555147,CSE 21,A01,084009,Staff,35,0,50,15
1649827561174,CSE 30,A01,083370,Cao; Yingjun,20,0,40,20
1649827567198,CSE 100,A01,083372,Cao; Yingjun,16,0,40,24
1649827573224,CSE 101,A01,084011,Staff,0,11,40,40
1649827579265,CSE 141,A01,083374,Eldon; John,0,9,75,75
1649827585294,CSE 141L,A01,083376,Eldon; John,0,11,75,75
1649827591319,CSE 175,A01,084013,Kumar; Rakesh,24,0,25,1
1649827597342,CSE 190,A00,092508,Staff,15,0,15,0
1649827603382,ECE 5,A01,084049,Morris; Karcher William,17,0,20,3
1649827609408,ECE 100,A01,084051,Baghdadchi; Saharnaz,16,0,20,4
1649827609408,ECE 100,A02,091916,Baghdadchi; Saharnaz,18,0,20,2
1649827615431,ECE 101,A01,084053,Baghdadchi; Saharnaz,25,0,37,12
1649827615431,ECE 101,A02,084054,Baghdadchi; Saharnaz,37,0,37,0
1649827621460,ECE 107,A01,083390,Staff,33,0,40,7
1649827627494,ECE 148,A01,084056,Silberman; Jack,8,0,12,4
1649827633519,ECE 180,A00,083391,Abi Samra; Nicholas Camill,27,0,30,3
1649827633519,ECE 180,B00,083392,Abi Samra; Nicholas Camill,26,0,30,4
1649827639551,MATH 10B,A01,084110,Staff,20,0,30,10
1649827639551,MATH 10B,A02,084111,Staff,29,0,30,1
1649827639551,MATH 10B,A03,084112,Staff,29,0,30,1
1649827645586,MATH 10C,A01,083443,Staff,20,0,30,10
1649827645586,MATH 10C,A02,083444,Staff,25,0,30,5
1649827645586,MATH 10C,B01,084114,Staff,26,0,30,4
1649827645586,MATH 10C,B02,084115,Staff,30,0,30,0
1649827651697,MATH 18,A01,084117,Harel; Guershon,28,0,30,2
1649827651697,MATH 18,A02,084119,Harel; Guershon,29,0,30,1
1649827651697,MATH 18,A03,084120,Harel; Guershon,30,0,30,0
1649827651697,MATH 18,A04,084121,Harel; Guershon,30,0,30,0
1649827657725,MATH 20B,A01,084124,Um; Ko Woon,33,0,35,2
1649827657725,MATH 20B,B01,084126,Um; Ko Woon,35,0,35,0
1649827663755,MATH 20C,A01,083446,Hammock; Frances H,27,0,30,3
1649827663755,MATH 20C,A02,083447,Hammock; Frances H,30,0,30,0
1649827663755,MATH 20C,A03,083448,Hammock; Frances H,30,0,30,0
1649827663755,MATH 20C,A04,083449,Hammock; Frances H,30,0,30,0
1649827663755,MATH 20C,B01,083451,Hammock; Frances H,29,0,30,1
1649827663755,MATH 20C,B02,083452,Hammock; Frances H,30,0,30,0
1649827663755,MATH 20C,B03,083453,Hammock; Frances H,30,0,30,0
1649827663755,MATH 20C,B04,083454,Hammock; Frances H,30,0,30,0
1649827669784,MATH 20D,A01,084128,Staff,29,0,30,1
1649827669784,MATH 20D,A02,084129,Staff,30,0,30,0
1649827669784,MATH 20D,A03,084130,Staff,29,0,30,1
1649827669784,MATH 20D,B01,084133,Staff,28,0,30,2
1649827669784,MATH 20D,B02,084134,Staff,30,0,30,0
1649827669784,MATH 20D,B03,084135,Staff,30,0,30,0
1649827675810,MATH 20E,A01,084138,Staff,29,0,30,1
1649827675810,MATH 20E,A02,084139,Staff,29,0,30,1
1649827675810,MATH 20E,A03,084140,Staff,28,0,30,2
1649827675810,MATH 20E,A04,084141,Staff,30,0,30,0
1649827681837,MATH 102,A01,084143,Harel; Guershon,24,0,30,6
1649827681837,MATH 102,A02,084144,Harel; Guershon,25,0,30,5
1649827687860,MATH 103B,A01,083456,Staff,0,0,30,30
1649827687860,MATH 103B,A02,083457,Staff,21,0,30,9
1649827693888,MATH 109,A01,084146,Salehi Golsefidy; Alireza,30,0,30,0
1649827693888,MATH 109,A02,084147,Salehi Golsefidy; Alireza,27,0,30,3
1649827699920,MATH 120A,A01,085445,Eggers; John Dietrich,31,0,35,4
1649827699920,MATH 120A,A02,085446,Eggers; John Dietrich,31,0,35,4
1649827705949,MATH 142B,A01,084149,Verstraete; Jacques Allan,9,0,30,21
1649827705949,MATH 142B,A02,084150,Verstraete; Jacques Allan,25,0,30,5
1649827711977,MATH 170A,A01,083459,Nie; Jiawang,10,0,30,20
1649827711977,MATH 170A,A02,083460,Nie; Jiawang,25,0,30,5
1649827711977,MATH 170A,A03,083461,Nie; Jiawang,26,0,30,4
1649827718003,MATH 193B,A01,083463,Staff,16,0,30,14
1649827718003,MATH 193B,A02,083464,Staff,19,0,30,11
1649827718003,MATH 193B,A03,083465,Staff,27,0,30,3
1649827724055,COGS 2,A01,083966,Boyle; Mary E. T.,27,0,30,3
1649827730083,COGS 9,A01,083968,Staff,57,0,60,3
1649827736106,COGS 14B,A01,083970,Staff,47,0,50,3
1649827742132,COGS 17,A01,092679,Staff,73,0,75,2
1649827748157,COGS 100,A01,083972,Staff,46,0,60,14
1649827760207,COGS 101C,A01,083976,Staff,25,0,30,5
1649827766233,COGS 102A,A01,083978,Johnson; Christine M.,24,0,30,6
1649827772256,COGS 107B,A01,083980,Staff,38,0,50,12
1649827778283,COGS 115,A01,083982,Staff,21,0,30,9
1649827784306,COGS 118B,A01,083367,Staff,6,0,40,34
1649827790338,COGS 172,A01,083984,Provenzano; Emily Kara,21,0,30,9
1649827796368,COGS 177,A00,083368,Staff,6,0,30,24
1649827802404,COGS 186,A01,083986,Staff,25,0,40,15
1649827808427,COGS 187A,A01,083988,Boyle; Mary E. T.,41,0,60,19
1649827814451,CSE 8A,A50,084003,Miranda; Gregory Joseph,9,0,15,6
1649827820474,CSE 11,A01,084005,Miranda; Gregory Joseph,49,0,55,6
1649827826515,CSE 20,A01,084007,Staff,15,0,20,5
1649827832555,CSE 21,A01,084009,Staff,35,0,50,15
1649827838581,CSE 30,A01,083370,Cao; Yingjun,20,0,40,20
1649827844612,CSE 100,A01,083372,Cao; Yingjun,16,0,40,24
1649827850639,CSE 101,A01,084011,Staff,0,11,40,40
1649827856666,CSE 141,A01,083374,Eldon; John,0,9,75,75
1649827862697,CSE 141L,A01,083376,Eldon; John,0,11,75,75
1649827868732,CSE 175,A01,084013,Kumar; Rakesh,24,0,25,1
1649827874767,CSE 190,A00,092508,Staff,15,0,15,0
1649827880793,ECE 5,A01,084049,Morris; Karcher William,17,0,20,3
1649827886819,ECE 100,A01,084051,Baghdadchi; Saharnaz,16,0,20,4
1649827886819,ECE 100,A02,091916,Baghdadchi; Saharnaz,18,0,20,2
1649827892857,ECE 101,A01,084053,Baghdadchi; Saharnaz,25,0,37,12
1649827892857,ECE 101,A02,084054,Baghdadchi; Saharnaz,37,0,37,0
1649827898882,ECE 107,A01,083390,Staff,33,0,40,7
1649827904903,ECE 148,A01,084056,Silberman; Jack,8,0,12,4
1649827910931,ECE 180,A00,083391,Abi Samra; Nicholas Camill,27,0,30,3
1649827910931,ECE 180,B00,083392,Abi Samra; Nicholas Camill,26,0,30,4
1649827916960,MATH 10B,A01,084110,Staff,20,0,30,10
1649827916960,MATH 10B,A02,084111,Staff,29,0,30,1
1649827916960,MATH 10B,A03,084112,Staff,29,0,30,1
1649827922993,MATH 10C,A01,083443,Staff,20,0,30,10
1649827922993,MATH 10C,A02,083444,Staff,25,0,30,5
1649827922993,MATH 10C,B01,084114,Staff,26,0,30,4
1649827922993,MATH 10C,B02,084115,Staff,30,0,30,0
1649827929015,MATH 18,A01,084117,Harel; Guershon,28,0,30,2
1649827929015,MATH 18,A02,084119,Harel; Guershon,29,0,30,1
1649827929015,MATH 18,A03,084120,Harel; Guershon,30,0,30,0
1649827929015,MATH 18,A04,084121,Harel; Guershon,30,0,30,0
1649827935046,MATH 20B,A01,084124,Um; Ko Woon,33,0,35,2
1649827935046,MATH 20B,B01,084126,Um; Ko Woon,35,0,35,0
1649827941072,MATH 20C,A01,083446,Hammock; Frances H,27,0,30,3
1649827941072,MATH 20C,A02,083447,Hammock; Frances H,30,0,30,0
1649827941072,MATH 20C,A03,083448,Hammock; Frances H,30,0,30,0
1649827941072,MATH 20C,A04,083449,Hammock; Frances H,30,0,30,0
1649827941072,MATH 20C,B01,083451,Hammock; Frances H,29,0,30,1
1649827941072,MATH 20C,B02,083452,Hammock; Frances H,30,0,30,0
1649827941072,MATH 20C,B03,083453,Hammock; Frances H,30,0,30,0
1649827941072,MATH 20C,B04,083454,Hammock; Frances H,30,0,30,0
1649827947096,MATH 20D,A01,084128,Staff,29,0,30,1
1649827947096,MATH 20D,A02,084129,Staff,30,0,30,0
1649827947096,MATH 20D,A03,084130,Staff,29,0,30,1
1649827947096,MATH 20D,B01,084133,Staff,28,0,30,2
1649827947096,MATH 20D,B02,084134,Staff,30,0,30,0
1649827947096,MATH 20D,B03,084135,Staff,30,0,30,0
1649827953123,MATH 20E,A01,084138,Staff,29,0,30,1
1649827953123,MATH 20E,A02,084139,Staff,29,0,30,1
1649827953123,MATH 20E,A03,084140,Staff,28,0,30,2
1649827953123,MATH 20E,A04,084141,Staff,30,0,30,0
1649827959154,MATH 102,A01,084143,Harel; Guershon,24,0,30,6
1649827959154,MATH 102,A02,084144,Harel; Guershon,25,0,30,5
1649827965178,MATH 103B,A01,083456,Staff,0,0,30,30
1649827965178,MATH 103B,A02,083457,Staff,21,0,30,9
1649827971213,MATH 109,A01,084146,Salehi Golsefidy; Alireza,30,0,30,0
1649827971213,MATH 109,A02,084147,Salehi Golsefidy; Alireza,27,0,30,3
1649827977242,MATH 120A,A01,085445,Eggers; John Dietrich,31,0,35,4
1649827977242,MATH 120A,A02,085446,Eggers; John Dietrich,31,0,35,4
1649827983268,MATH 142B,A01,084149,Verstraete; Jacques Allan,9,0,30,21
1649827983268,MATH 142B,A02,084150,Verstraete; Jacques Allan,25,0,30,5
1649827989291,MATH 170A,A01,083459,Nie; Jiawang,10,0,30,20
1649827989291,MATH 170A,A02,083460,Nie; Jiawang,25,0,30,5
1649827989291,MATH 170A,A03,083461,Nie; Jiawang,26,0,30,4
1649827995319,MATH 193B,A01,083463,Staff,16,0,30,14
1649827995319,MATH 193B,A02,083464,Staff,19,0,30,11
1649827995319,MATH 193B,A03,083465,Staff,27,0,30,3
1649828001380,COGS 2,A01,083966,Boyle; Mary E. T.,27,0,30,3
1649828007419,COGS 9,A01,083968,Staff,57,0,60,3
1649828013462,COGS 14B,A01,083970,Staff,47,0,50,3
1649828019486,COGS 17,A01,092679,Staff,73,0,75,2
1649828025513,COGS 100,A01,083972,Staff,46,0,60,14
1649828037561,COGS 101C,A01,083976,Staff,25,0,30,5
1649828043589,COGS 102A,A01,083978,Johnson; Christine M.,24,0,30,6
1649828049614,COGS 107B,A01,083980,Staff,38,0,50,12
1649828055636,COGS 115,A01,083982,Staff,21,0,30,9
1649828061662,COGS 118B,A01,083367,Staff,6,0,40,34
1649828067692,COGS 172,A01,083984,Provenzano; Emily Kara,21,0,30,9
1649828073716,COGS 177,A00,083368,Staff,6,0,30,24
1649828079740,COGS 186,A01,083986,Staff,25,0,40,15
1649828085763,COGS 187A,A01,083988,Boyle; Mary E. T.,41,0,60,19
1649828091788,CSE 8A,A50,084003,Miranda; Gregory Joseph,9,0,15,6
1649828097811,CSE 11,A01,084005,Miranda; Gregory Joseph,49,0,55,6
1649828103835,CSE 20,A01,084007,Staff,15,0,20,5
1649828109870,CSE 21,A01,084009,Staff,35,0,50,15
1649828115905,CSE 30,A01,083370,Cao; Yingjun,20,0,40,20
1649828121944,CSE 100,A01,083372,Cao; Yingjun,16,0,40,24
1649828127974,CSE 101,A01,084011,Staff,0,11,40,40
1649828134002,CSE 141,A01,083374,Eldon; John,0,9,75,75
1649828140029,CSE 141L,A01,083376,Eldon; John,0,12,75,75
1649828146055,CSE 175,A01,084013,Kumar; Rakesh,24,0,25,1
1649828152088,CSE 190,A00,092508,Staff,15,0,15,0
1649828158122,ECE 5,A01,084049,Morris; Karcher William,17,0,20,3
1649828164150,ECE 100,A01,084051,Baghdadchi; Saharnaz,16,0,20,4
1649828164150,ECE 100,A02,091916,Baghdadchi; Saharnaz,18,0,20,2
1649828170174,ECE 101,A01,084053,Baghdadchi; Saharnaz,25,0,37,12
1649828170174,ECE 101,A02,084054,Baghdadchi; Saharnaz,37,0,37,0
1649828176198,ECE 107,A01,083390,Staff,33,0,40,7
1649828182225,ECE 148,A01,084056,Silberman; Jack,8,0,12,4
1649828188251,ECE 180,A00,083391,Abi Samra; Nicholas Camill,27,0,30,3
1649828188251,ECE 180,B00,083392,Abi Samra; Nicholas Camill,26,0,30,4
1649828194276,MATH 10B,A01,084110,Staff,20,0,30,10
1649828194276,MATH 10B,A02,084111,Staff,29,0,30,1
1649828194276,MATH 10B,A03,084112,Staff,29,0,30,1
1649828200317,MATH 10C,A01,083443,Staff,20,0,30,10
1649828200317,MATH 10C,A02,083444,Staff,25,0,30,5
1649828200317,MATH 10C,B01,084114,Staff,26,0,30,4
1649828200317,MATH 10C,B02,084115,Staff,30,0,30,0
1649828206341,MATH 18,A01,084117,Harel; Guershon,28,0,30,2
1649828206341,MATH 18,A02,084119,Harel; Guershon,29,0,30,1
1649828206341,MATH 18,A03,084120,Harel; Guershon,30,0,30,0
1649828206341,MATH 18,A04,084121,Harel; Guershon,30,0,30,0
1649828212365,MATH 20B,A01,084124,Um; Ko Woon,33,0,35,2
1649828212365,MATH 20B,B01,084126,Um; Ko Woon,35,0,35,0
1649828218390,MATH 20C,A01,083446,Hammock; Frances H,27,0,30,3
1649828218390,MATH 20C,A02,083447,Hammock; Frances H,30,0,30,0
1649828218390,MATH 20C,A03,083448,Hammock; Frances H,30,0,30,0
1649828218390,MATH 20C,A04,083449,Hammock; Frances H,30,0,30,0
1649828218390,MATH 20C,B01,083451,Hammock; Frances H,29,0,30,1
1649828218390,MATH 20C,B02,083452,Hammock; Frances H,30,0,30,0
1649828218390,MATH 20C,B03,083453,Hammock; Frances H,30,0,30,0
1649828218390,MATH 20C,B04,083454,Hammock; Frances H,30,0,30,0
1649828224412,MATH 20D,A01,084128,Staff,29,0,30,1
1649828224412,MATH 20D,A02,084129,Staff,30,0,30,0
1649828224412,MATH 20D,A03,084130,Staff,29,0,30,1
1649828224412,MATH 20D,B01,084133,Staff,28,0,30,2
1649828224412,MATH 20D,B02,084134,Staff,30,0,30,0
1649828224412,MATH 20D,B03,084135,Staff,30,0,30,0
1649828230436,MATH 20E,A01,084138,Staff,29,0,30,1
1649828230436,MATH 20E,A02,084139,Staff,29,0,30,1
1649828230436,MATH 20E,A03,084140,Staff,28,0,30,2
1649828230436,MATH 20E,A04,084141,Staff,30,0,30,0
1649828236464,MATH 102,A01,084143,Harel; Guershon,24,0,30,6
1649828236464,MATH 102,A02,084144,Harel; Guershon,25,0,30,5
1649828242491,MATH 103B,A01,083456,Staff,0,0,30,30
1649828242491,MATH 103B,A02,083457,Staff,21,0,30,9
1649828248612,MATH 109,A01,084146,Salehi Golsefidy; Alireza,30,0,30,0
1649828248612,MATH 109,A02,084147,Salehi Golsefidy; Alireza,27,0,30,3
1649828254640,MATH 120A,A01,085445,Eggers; John Dietrich,31,0,35,4
1649828254640,MATH 120A,A02,085446,Eggers; John Dietrich,31,0,35,4
1649828260662,MATH 142B,A01,084149,Verstraete; Jacques Allan,9,0,30,21
1649828260662,MATH 142B,A02,084150,Verstraete; Jacques Allan,25,0,30,5
1649828266684,MATH 170A,A01,083459,Nie; Jiawang,10,0,30,20
1649828266684,MATH 170A,A02,083460,Nie; Jiawang,25,0,30,5
1649828266684,MATH 170A,A03,083461,Nie; Jiawang,26,0,30,4
1649828272706,MATH 193B,A01,083463,Staff,16,0,30,14
1649828272706,MATH 193B,A02,083464,Staff,19,0,30,11
1649828272706,MATH 193B,A03,083465,Staff,27,0,30,3
1649828278757,COGS 2,A01,083966,Boyle; Mary E. T.,27,0,30,3
1649828284782,COGS 9,A01,083968,Staff,57,0,60,3
1649828290804,COGS 14B,A01,083970,Staff,47,0,50,3
1649828296831,COGS 17,A01,092679,Staff,73,0,75,2
1649828302862,COGS 100,A01,083972,Staff,46,0,60,14
1649828314920,COGS 101C,A01,083976,Staff,25,0,30,5
1649828320952,COGS 102A,A01,083978,Johnson; Christine M.,24,0,30,6
1649828326978,COGS 107B,A01,083980,Staff,38,0,50,12
1649828333002,COGS 115,A01,083982,Staff,21,0,30,9
1649828339026,COGS 118B,A01,083367,Staff,6,0,40,34
1649828345054,COGS 172,A01,083984,Provenzano; Emily Kara,21,0,30,9
1649828351087,COGS 177,A00,083368,Staff,6,0,30,24
1649828357117,COGS 186,A01,083986,Staff,25,0,40,15
1649828363143,COGS 187A,A01,083988,Boyle; Mary E. T.,41,0,60,19
1649828369166,CSE 8A,A50,084003,Miranda; Gregory Joseph,9,0,15,6
1649828375193,CSE 11,A01,084005,Miranda; Gregory Joseph,49,0,55,6
1649828381217,CSE 20,A01,084007,Staff,15,0,20,5
1649828387242,CSE 21,A01,084009,Staff,35,0,50,15
1649828393269,CSE 30,A01,083370,Cao; Yingjun,20,0,40,20
1649828399292,CSE 100,A01,083372,Cao; Yingjun,15,0,40,25
1649828405319,CSE 101,A01,084011,Staff,0,11,40,40
1649828411343,CSE 141,A01,083374,Eldon; John,0,9,75,75
1649828417365,CSE 141L,A01,083376,Eldon; John,0,12,75,75
1649828423388,CSE 175,A01,084013,Kumar; Rakesh,24,0,25,1
1649828429415,CSE 190,A00,092508,Staff,15,0,15,0
1649828435445,ECE 5,A01,084049,Morris; Karcher William,17,0,20,3
1649828441469,ECE 100,A01,084051,Baghdadchi; Saharnaz,16,0,20,4
1649828441469,ECE 100,A02,091916,Baghdadchi; Saharnaz,18,0,20,2
1649828447492,ECE 101,A01,084053,Baghdadchi; Saharnaz,25,0,37,12
1649828447492,ECE 101,A02,084054,Baghdadchi; Saharnaz,37,0,37,0
1649828453521,ECE 107,A01,083390,Staff,33,0,40,7
1649828459553,ECE 148,A01,084056,Silberman; Jack,8,0,12,4
1649828465576,ECE 180,A00,083391,Abi Samra; Nicholas Camill,27,0,30,3
1649828465576,ECE 180,B00,083392,Abi Samra; Nicholas Camill,26,0,30,4
1649828471600,MATH 10B,A01,084110,Staff,20,0,30,10
1649828471600,MATH 10B,A02,084111,Staff,29,0,30,1
1649828471600,MATH 10B,A03,084112,Staff,29,0,30,1
1649828477629,MATH 10C,A01,083443,Staff,20,0,30,10
1649828477629,MATH 10C,A02,083444,Staff,25,0,30,5
1649828477629,MATH 10C,B01,084114,Staff,26,0,30,4
1649828477629,MATH 10C,B02,084115,Staff,30,0,30,0
1649828483652,MATH 18,A01,084117,Harel; Guershon,28,0,30,2
1649828483652,MATH 18,A02,084119,Harel; Guershon,29,0,30,1
1649828483652,MATH 18,A03,084120,Harel; Guershon,30,0,30,0
1649828483652,MATH 18,A04,084121,Harel; Guershon,30,0,30,0
1649828489676,MATH 20B,A01,084124,Um; Ko Woon,33,0,35,2
1649828489676,MATH 20B,B01,084126,Um; Ko Woon,35,0,35,0
1649828495708,MATH 20C,A01,083446,Hammock; Frances H,27,0,30,3
1649828495708,MATH 20C,A02,083447,Hammock; Frances H,30,0,30,0
1649828495708,MATH 20C,A03,083448,Hammock; Frances H,30,0,30,0
1649828495708,MATH 20C,A04,083449,Hammock; Frances H,30,0,30,0
1649828495708,MATH 20C,B01,083451,Hammock; Frances H,29,0,30,1
1649828495708,MATH 20C,B02,083452,Hammock; Frances H,30,0,30,0
1649828495708,MATH 20C,B03,083453,Hammock; Frances H,30,0,30,0
1649828495708,MATH 20C,B04,083454,Hammock; Frances H,30,0,30,0
1649828501730,MATH 20D,A01,084128,Staff,29,0,30,1
1649828501730,MATH 20D,A02,084129,Staff,30,0,30,0
1649828501730,MATH 20D,A03,084130,Staff,29,0,30,1
1649828501730,MATH 20D,B01,084133,Staff,28,0,30,2
1649828501730,MATH 20D,B02,084134,Staff,30,0,30,0
1649828501730,MATH 20D,B03,084135,Staff,30,0,30,0
1649828507752,MATH 20E,A01,084138,Staff,29,0,30,1
1649828507752,MATH 20E,A02,084139,Staff,29,0,30,1
1649828507752,MATH 20E,A03,084140,Staff,28,0,30,2
1649828507752,MATH 20E,A04,084141,Staff,30,0,30,0
1649828513782,MATH 102,A01,084143,Harel; Guershon,24,0,30,6
1649828513782,MATH 102,A02,084144,Harel; Guershon,25,0,30,5
1649828519807,MATH 103B,A01,083456,Staff,0,0,30,30
1649828519807,MATH 103B,A02,083457,Staff,20,0,30,10
1649828525833,MATH 109,A01,084146,Salehi Golsefidy; Alireza,30,0,30,0
1649828525833,MATH 109,A02,084147,Salehi Golsefidy; Alireza,27,0,30,3
1649828531856,MATH 120A,A01,085445,Eggers; John Dietrich,31,0,35,4
1649828531856,MATH 120A,A02,085446,Eggers; John Dietrich,31,0,35,4
1649828537881,MATH 142B,A01,084149,Verstraete; Jacques Allan,9,0,30,21
1649828537881,MATH 142B,A02,084150,Verstraete; Jacques Allan,25,0,30,5
1649828543906,MATH 170A,A01,083459,Nie; Jiawang,10,0,30,20
1649828543906,MATH 170A,A02,083460,Nie; Jiawang,25,0,30,5
1649828543906,MATH 170A,A03,083461,Nie; Jiawang,26,0,30,4
1649828549929,MATH 193B,A01,083463,Staff,16,0,30,14
1649828549929,MATH 193B,A02,083464,Staff,19,0,30,11
1649828549929,MATH 193B,A03,083465,Staff,27,0,30,3
1649828555980,COGS 2,A01,083966,Boyle; Mary E. T.,27,0,30,3
1649828562001,COGS 9,A01,083968,Staff,57,0,60,3
1649828568028,COGS 14B,A01,083970,Staff,47,0,50,3
1649828574050,COGS 17,A01,092679,Staff,73,0,75,2
1649828580073,COGS 100,A01,083972,Staff,46,0,60,14
1649828592120,COGS 101C,A01,083976,Staff,25,0,30,5
1649828598142,COGS 102A,A01,083978,Johnson; Christine M.,24,0,30,6
1649828604171,COGS 107B,A01,083980,Staff,38,0,50,12
1649828610195,COGS 115,A01,083982,Staff,21,0,30,9
1649828616218,COGS 118B,A01,083367,Staff,6,0,40,34
1649828622241,COGS 172,A01,083984,Provenzano; Emily Kara,21,0,30,9
1649828628264,COGS 177,A00,083368,Staff,6,0,30,24
1649828634297,COGS 186,A01,083986,Staff,25,0,40,15
1649828640323,COGS 187A,A01,083988,Boyle; Mary E. T.,41,0,60,19
1649828646346,CSE 8A,A50,084003,Miranda; Gregory Joseph,9,0,15,6
1649828652370,CSE 11,A01,084005,Miranda; Gregory Joseph,49,0,55,6
1649828658396,CSE 20,A01,084007,Staff,15,0,20,5
1649828664423,CSE 21,A01,084009,Staff,35,0,50,15
1649828670446,CSE 30,A01,083370,Cao; Yingjun,20,0,40,20
1649828676474,CSE 100,A01,083372,Cao; Yingjun,15,0,40,25
1649828682497,CSE 101,A01,084011,Staff,0,11,40,40
1649828688523,CSE 141,A01,083374,Eldon; John,0,9,75,75
1649828694547,CSE 141L,A01,083376,Eldon; John,0,12,75,75
1649828700574,CSE 175,A01,084013,Kumar; Rakesh,24,0,25,1
1649828706600,CSE 190,A00,092508,Staff,15,0,15,0
1649828712631,ECE 5,A01,084049,Morris; Karcher William,17,0,20,3
1649828718653,ECE 100,A01,084051,Baghdadchi; Saharnaz,16,0,20,4
1649828718653,ECE 100,A02,091916,Baghdadchi; Saharnaz,18,0,20,2
1649828724677,ECE 101,A01,084053,Baghdadchi; Saharnaz,25,0,37,12
1649828724677,ECE 101,A02,084054,Baghdadchi; Saharnaz,37,0,37,0
1649828730703,ECE 107,A01,083390,Staff,33,0,40,7
1649828736728,ECE 148,A01,084056,Silberman; Jack,8,0,12,4
1649828742762,ECE 180,A00,083391,Abi Samra; Nicholas Camill,27,0,30,3
1649828742762,ECE 180,B00,083392,Abi Samra; Nicholas Camill,26,0,30,4
1649828748787,MATH 10B,A01,084110,Staff,20,0,30,10
1649828748787,MATH 10B,A02,084111,Staff,29,0,30,1
1649828748787,MATH 10B,A03,084112,Staff,29,0,30,1
1649828754811,MATH 10C,A01,083443,Staff,19,0,30,11
1649828754811,MATH 10C,A02,083444,Staff,25,0,30,5
1649828754811,MATH 10C,B01,084114,Staff,26,0,30,4
1649828754811,MATH 10C,B02,084115,Staff,30,0,30,0
1649828760838,MATH 18,A01,084117,Harel; Guershon,28,0,30,2
1649828760838,MATH 18,A02,084119,Harel; Guershon,29,0,30,1
1649828760838,MATH 18,A03,084120,Harel; Guershon,30,0,30,0
1649828760838,MATH 18,A04,084121,Harel; Guershon,30,0,30,0
1649828766868,MATH 20B,A01,084124,Um; Ko Woon,33,0,35,2
1649828766868,MATH 20B,B01,084126,Um; Ko Woon,35,0,35,0
1649828772896,MATH 20C,A01,083446,Hammock; Frances H,27,0,30,3
1649828772896,MATH 20C,A02,083447,Hammock; Frances H,30,0,30,0
1649828772896,MATH 20C,A03,083448,Hammock; Frances H,30,0,30,0
1649828772896,MATH 20C,A04,083449,Hammock; Frances H,30,0,30,0
1649828772896,MATH 20C,B01,083451,Hammock; Frances H,29,0,30,1
1649828772896,MATH 20C,B02,083452,Hammock; Frances H,30,0,30,0
1649828772896,MATH 20C,B03,083453,Hammock; Frances H,30,0,30,0
1649828772896,MATH 20C,B04,083454,Hammock; Frances H,30,0,30,0
1649828778919,MATH 20D,A01,084128,Staff,29,0,30,1
1649828778919,MATH 20D,A02,084129,Staff,30,0,30,0
1649828778919,MATH 20D,A03,084130,Staff,29,0,30,1
1649828778919,MATH 20D,B01,084133,Staff,28,0,30,2
1649828778919,MATH 20D,B02,084134,Staff,30,0,30,0
1649828778919,MATH 20D,B03,084135,Staff,30,0,30,0
1649828784942,MATH 20E,A01,084138,Staff,29,0,30,1
1649828784942,MATH 20E,A02,084139,Staff,29,0,30,1
1649828784942,MATH 20E,A03,084140,Staff,28,0,30,2
1649828784942,MATH 20E,A04,084141,Staff,30,0,30,0
1649828790966,MATH 102,A01,084143,Harel; Guershon,24,0,30,6
1649828790966,MATH 102,A02,084144,Harel; Guershon,25,0,30,5
1649828796990,MATH 103B,A01,083456,Staff,0,0,30,30
1649828796990,MATH 103B,A02,083457,Staff,20,0,30,10
1649828803024,MATH 109,A01,084146,Salehi Golsefidy; Alireza,30,0,30,0
1649828803024,MATH 109,A02,084147,Salehi Golsefidy; Alireza,27,0,30,3
1649828809052,MATH 120A,A01,085445,Eggers; John Dietrich,31,0,35,4
1649828809052,MATH 120A,A02,085446,Eggers; John Dietrich,31,0,35,4
1649828815078,MATH 142B,A01,084149,Verstraete; Jacques Allan,8,0,30,22
1649828815078,MATH 142B,A02,084150,Verstraete; Jacques Allan,25,0,30,5
1649828821106,MATH 170A,A01,083459,Nie; Jiawang,10,0,30,20
1649828821106,MATH 170A,A02,083460,Nie; Jiawang,25,0,30,5
1649828821106,MATH 170A,A03,083461,Nie; Jiawang,26,0,30,4
1649828827139,MATH 193B,A01,083463,Staff,16,0,30,14
1649828827139,MATH 193B,A02,083464,Staff,19,0,30,11
1649828827139,MATH 193B,A03,083465,Staff,27,0,30,3
1649828833197,COGS 2,A01,083966,Boyle; Mary E. T.,27,0,30,3
1649828839290,COGS 9,A01,083968,Staff,57,0,60,3
1649828845315,COGS 14B,A01,083970,Staff,47,0,50,3
1649828851341,COGS 17,A01,092679,Staff,73,0,75,2
1649828857366,COGS 100,A01,083972,Staff,46,0,60,14
1649828869421,COGS 101C,A01,083976,Staff,25,0,30,5
1649828875447,COGS 102A,A01,083978,Johnson; Christine M.,24,0,30,6
1649828881473,COGS 107B,A01,083980,Staff,38,0,50,12
1649828887494,COGS 115,A01,083982,Staff,21,0,30,9
1649828893520,COGS 118B,A01,083367,Staff,6,0,40,34
1649828899544,COGS 172,A01,083984,Provenzano; Emily Kara,21,0,30,9
1649828905568,COGS 177,A00,083368,Staff,6,0,30,24
1649828911594,COGS 186,A01,083986,Staff,25,0,40,15
1649828917696,COGS 187A,A01,083988,Boyle; Mary E. T.,41,0,60,19
1649828923720,CSE 8A,A50,084003,Miranda; Gregory Joseph,9,0,15,6
1649828929746,CSE 11,A01,084005,Miranda; Gregory Joseph,49,0,55,6
1649828935768,CSE 20,A01,084007,Staff,15,0,20,5
1649828941791,CSE 21,A01,084009,Staff,35,0,50,15
1649828947816,CSE 30,A01,083370,Cao; Yingjun,20,0,40,20
1649828953840,CSE 100,A01,083372,Cao; Yingjun,15,0,40,25
1649828959863,CSE 101,A01,084011,Staff,0,12,40,40
1649828965887,CSE 141,A01,083374,Eldon; John,0,10,75,75
1649828971917,CSE 141L,A01,083376,Eldon; John,0,13,75,75
1649828977943,CSE 175,A01,084013,Kumar; Rakesh,24,0,25,1
1649828983966,CSE 190,A00,092508,Staff,15,0,15,0
1649828989990,ECE 5,A01,084049,Morris; Karcher William,17,0,20,3
1649828996019,ECE 100,A01,084051,Baghdadchi; Saharnaz,16,0,20,4
1649828996019,ECE 100,A02,091916,Baghdadchi; Saharnaz,18,0,20,2
1649829002044,ECE 101,A01,084053,Baghdadchi; Saharnaz,25,0,37,12
1649829002044,ECE 101,A02,084054,Baghdadchi; Saharnaz,37,0,37,0
1649829008069,ECE 107,A01,083390,Staff,33,0,40,7
1649829014092,ECE 148,A01,084056,Silberman; Jack,8,0,12,4
1649829020118,ECE 180,A00,083391,Abi Samra; Nicholas Camill,27,0,30,3
1649829020118,ECE 180,B00,083392,Abi Samra; Nicholas Camill,26,0,30,4
1649829026144,MATH 10B,A01,084110,Staff,20,0,30,10
1649829026144,MATH 10B,A02,084111,Staff,29,0,30,1
1649829026144,MATH 10B,A03,084112,Staff,29,0,30,1
1649829032175,MATH 10C,A01,083443,Staff,19,0,30,11
1649829032175,MATH 10C,A02,083444,Staff,25,0,30,5
1649829032175,MATH 10C,B01,084114,Staff,26,0,30,4
1649829032175,MATH 10C,B02,084115,Staff,30,0,30,0
1649829038202,MATH 18,A01,084117,Harel; Guershon,28,0,30,2
1649829038202,MATH 18,A02,084119,Harel; Guershon,29,0,30,1
1649829038202,MATH 18,A03,084120,Harel; Guershon,30,0,30,0
1649829038202,MATH 18,A04,084121,Harel; Guershon,30,0,30,0
1649829044230,MATH 20B,A01,084124,Um; Ko Woon,33,0,35,2
1649829044230,MATH 20B,B01,084126,Um; Ko Woon,35,0,35,0
1649829050258,MATH 20C,A01,083446,Hammock; Frances H,27,0,30,3
1649829050258,MATH 20C,A02,083447,Hammock; Frances H,30,0,30,0
1649829050258,MATH 20C,A03,083448,Hammock; Frances H,30,0,30,0
1649829050258,MATH 20C,A04,083449,Hammock; Frances H,30,0,30,0
1649829050258,MATH 20C,B01,083451,Hammock; Frances H,29,0,30,1
1649829050258,MATH 20C,B02,083452,Hammock; Frances H,30,0,30,0
1649829050258,MATH 20C,B03,083453,Hammock; Frances H,30,0,30,0
1649829050258,MATH 20C,B04,083454,Hammock; Frances H,30,0,30,0
1649829056282,MATH 20D,A01,084128,Staff,29,0,30,1
1649829056282,MATH 20D,A02,084129,Staff,30,0,30,0
1649829056282,MATH 20D,A03,084130,Staff,29,0,30,1
1649829056282,MATH 20D,B01,084133,Staff,28,0,30,2
1649829056282,MATH 20D,B02,084134,Staff,30,0,30,0
1649829056282,MATH 20D,B03,084135,Staff,30,0,30,0
1649829062306,MATH 20E,A01,084138,Staff,29,0,30,1
1649829062306,MATH 20E,A02,084139,Staff,29,0,30,1
1649829062306,MATH 20E,A03,084140,Staff,28,0,30,2
1649829062306,MATH 20E,A04,084141,Staff,30,0,30,0
1649829068332,MATH 102,A01,084143,Harel; Guershon,24,0,30,6
1649829068332,MATH 102,A02,084144,Harel; Guershon,25,0,30,5
1649829074356,MATH 103B,A01,083456,Staff,0,0,30,30
1649829074356,MATH 103B,A02,083457,Staff,20,0,30,10
1649829080379,MATH 109,A01,084146,Salehi Golsefidy; Alireza,30,0,30,0
1649829080379,MATH 109,A02,084147,Salehi Golsefidy; Alireza,27,0,30,3
1649829086402,MATH 120A,A01,085445,Eggers; John Dietrich,31,0,35,4
1649829086402,MATH 120A,A02,085446,Eggers; John Dietrich,31,0,35,4
1649829092432,MATH 142B,A01,084149,Verstraete; Jacques Allan,8,0,30,22
1649829092432,MATH 142B,A02,084150,Verstraete; Jacques Allan,25,0,30,5
1649829098454,MATH 170A,A01,083459,Nie; Jiawang,10,0,30,20
1649829098454,MATH 170A,A02,083460,Nie; Jiawang,25,0,30,5
1649829098454,MATH 170A,A03,083461,Nie; Jiawang,26,0,30,4
1649829104478,MATH 193B,A01,083463,Staff,16,0,30,14
1649829104478,MATH 193B,A02,083464,Staff,19,0,30,11
1649829104478,MATH 193B,A03,083465,Staff,27,0,30,3
1649829110536,COGS 2,A01,083966,Boyle; Mary E. T.,27,0,30,3
1649829116561,COGS 9,A01,083968,Staff,57,0,60,3
1649829122584,COGS 14B,A01,083970,Staff,46,0,50,4
1649829128611,COGS 17,A01,092679,Staff,73,0,75,2
1649829134634,COGS 100,A01,083972,Staff,46,0,60,14
1649829146685,COGS 101C,A01,083976,Staff,25,0,30,5
1649829152719,COGS 102A,A01,083978,Johnson; Christine M.,24,0,30,6
1649829158744,COGS 107B,A01,083980,Staff,37,0,50,13
1649829164767,COGS 115,A01,083982,Staff,22,0,30,8
1649829170795,COGS 118B,A01,083367,Staff,6,0,40,34
1649829176821,COGS 172,A01,083984,Provenzano; Emily Kara,21,0,30,9
1649829182849,COGS 177,A00,083368,Staff,6,0,30,24
1649829188870,COGS 186,A01,083986,Staff,25,0,40,15
1649829194892,COGS 187A,A01,083988,Boyle; Mary E. T.,41,0,60,19
1649829200914,CSE 8A,A50,084003,Miranda; Gregory Joseph,9,0,15,6
1649829206940,CSE 11,A01,084005,Miranda; Gregory Joseph,49,0,55,6
1649829212974,CSE 20,A01,084007,Staff,15,0,20,5
1649829218999,CSE 21,A01,084009,Staff,35,0,50,15
1649829225022,CSE 30,A01,083370,Cao; Yingjun,20,0,40,20
1649829231045,CSE 100,A01,083372,Cao; Yingjun,15,0,40,25
1649829237068,CSE 101,A01,084011,Staff,0,12,40,40
1649829243099,CSE 141,A01,083374,Eldon; John,0,10,75,75
1649829249130,CSE 141L,A01,083376,Eldon; John,0,13,75,75
1649829255155,CSE 175,A01,084013,Kumar; Rakesh,24,0,25,1
1649829261183,CSE 190,A00,092508,Staff,15,0,15,0
1649829267209,ECE 5,A01,084049,Morris; Karcher William,17,0,20,3
1649829273233,ECE 100,A01,084051,Baghdadchi; Saharnaz,16,0,20,4
1649829273233,ECE 100,A02,091916,Baghdadchi; Saharnaz,18,0,20,2
1649829279261,ECE 101,A01,084053,Baghdadchi; Saharnaz,25,0,37,12
1649829279261,ECE 101,A02,084054,Baghdadchi; Saharnaz,37,0,37,0
1649829285294,ECE 107,A01,083390,Staff,33,0,40,7
1649829291320,ECE 148,A01,084056,Silberman; Jack,8,0,12,4
1649829297344,ECE 180,A00,083391,Abi Samra; Nicholas Camill,27,0,30,3
1649829297344,ECE 180,B00,083392,Abi Samra; Nicholas Camill,26,0,30,4
1649829303371,MATH 10B,A01,084110,Staff,20,0,30,10
1649829303371,MATH 10B,A02,084111,Staff,29,0,30,1
1649829303371,MATH 10B,A03,084112,Staff,29,0,30,1
1649829309398,MATH 10C,A01,083443,Staff,19,0,30,11
1649829309398,MATH 10C,A02,083444,Staff,25,0,30,5
1649829309398,MATH 10C,B01,084114,Staff,26,0,30,4
1649829309398,MATH 10C,B02,084115,Staff,30,0,30,0
1649829315426,MATH 18,A01,084117,Harel; Guershon,28,0,30,2
1649829315426,MATH 18,A02,084119,Harel; Guershon,29,0,30,1
1649829315426,MATH 18,A03,084120,Harel; Guershon,30,0,30,0
1649829315426,MATH 18,A04,084121,Harel; Guershon,30,0,30,0
1649829321451,MATH 20B,A01,084124,Um; Ko Woon,33,0,35,2
1649829321451,MATH 20B,B01,084126,Um; Ko Woon,35,0,35,0
1649829327481,MATH 20C,A01,083446,Hammock; Frances H,27,0,30,3
1649829327481,MATH 20C,A02,083447,Hammock; Frances H,30,0,30,0
1649829327481,MATH 20C,A03,083448,Hammock; Frances H,30,0,30,0
1649829327481,MATH 20C,A04,083449,Hammock; Frances H,30,0,30,0
1649829327481,MATH 20C,B01,083451,Hammock; Frances H,29,0,30,1
1649829327481,MATH 20C,B02,083452,Hammock; Frances H,30,0,30,0
1649829327481,MATH 20C,B03,083453,Hammock; Frances H,30,0,30,0
1649829327481,MATH 20C,B04,083454,Hammock; Frances H,30,0,30,0
1649829333505,MATH 20D,A01,084128,Staff,29,0,30,1
1649829333505,MATH 20D,A02,084129,Staff,30,0,30,0
1649829333505,MATH 20D,A03,084130,Staff,29,0,30,1
1649829333505,MATH 20D,B01,084133,Staff,28,0,30,2
1649829333505,MATH 20D,B02,084134,Staff,30,0,30,0
1649829333505,MATH 20D,B03,084135,Staff,30,0,30,0
1649829339530,MATH 20E,A01,084138,Staff,28,0,30,2
1649829339530,MATH 20E,A02,084139,Staff,29,0,30,1
1649829339530,MATH 20E,A03,084140,Staff,28,0,30,2
1649829339530,MATH 20E,A04,084141,Staff,30,0,30,0
1649829345558,MATH 102,A01,084143,Harel; Guershon,24,0,30,6
1649829345558,MATH 102,A02,084144,Harel; Guershon,25,0,30,5
1649829351582,MATH 103B,A01,083456,Staff,0,0,30,30
1649829351582,MATH 103B,A02,083457,Staff,20,0,30,10
1649829357605,MATH 109,A01,084146,Salehi Golsefidy; Alireza,30,0,30,0
1649829357605,MATH 109,A02,084147,Salehi Golsefidy; Alireza,27,0,30,3
1649829363630,MATH 120A,A01,085445,Eggers; John Dietrich,31,0,35,4
1649829363630,MATH 120A,A02,085446,Eggers; John Dietrich,31,0,35,4
1649829369654,MATH 142B,A01,084149,Verstraete; Jacques Allan,8,0,30,22
1649829369654,MATH 142B,A02,084150,Verstraete; Jacques Allan,25,0,30,5
1649829375679,MATH 170A,A01,083459,Nie; Jiawang,10,0,30,20
1649829375679,MATH 170A,A02,083460,Nie; Jiawang,25,0,30,5
1649829375679,MATH 170A,A03,083461,Nie; Jiawang,26,0,30,4
1649829381705,MATH 193B,A01,083463,Staff,16,0,30,14
1649829381705,MATH 193B,A02,083464,Staff,19,0,30,11
1649829381705,MATH 193B,A03,083465,Staff,27,0,30,3
1649829387758,COGS 2,A01,083966,Boyle; Mary E. T.,27,0,30,3
1649829393781,COGS 9,A01,083968,Staff,57,0,60,3
1649829399815,COGS 14B,A01,083970,Staff,46,0,50,4
1649829405839,COGS 17,A01,092679,Staff,73,0,75,2
1649829411862,COGS 100,A01,083972,Staff,46,0,60,14
1649829423906,COGS 101C,A01,083976,Staff,25,0,30,5
1649829429929,COGS 102A,A01,083978,Johnson; Christine M.,24,0,30,6
1649829436042,COGS 107B,A01,083980,Staff,37,0,50,13
1649829442066,COGS 115,A01,083982,Staff,22,0,30,8
1649829448092,COGS 118B,A01,083367,Staff,5,0,40,35
1649829454119,COGS 172,A01,083984,Provenzano; Emily Kara,21,0,30,9
1649829460142,COGS 177,A00,083368,Staff,6,0,30,24
1649829466167,COGS 186,A01,083986,Staff,25,0,40,15
1649829472195,COGS 187A,A01,083988,Boyle; Mary E. T.,41,0,60,19
1649829478219,CSE 8A,A50,084003,Miranda; Gregory Joseph,9,0,15,6
1649829484246,CSE 11,A01,084005,Miranda; Gregory Joseph,49,0,55,6
1649829490273,CSE 20,A01,084007,Staff,15,0,20,5
1649829496297,CSE 21,A01,084009,Staff,35,0,50,15
1649829502323,CSE 30,A01,083370,Cao; Yingjun,20,0,40,20
1649829508349,CSE 100,A01,083372,Cao; Yingjun,15,0,40,25
1649829514371,CSE 101,A01,084011,Staff,0,12,40,40
1649829520398,CSE 141,A01,083374,Eldon; John,0,10,75,75
1649829526431,CSE 141L,A01,083376,Eldon; John,0,13,75,75
1649829532460,CSE 175,A01,084013,Kumar; Rakesh,24,0,25,1
1649829538483,CSE 190,A00,092508,Staff,15,0,15,0
1649829544506,ECE 5,A01,084049,Morris; Karcher William,17,0,20,3
1649829550531,ECE 100,A01,084051,Baghdadchi; Saharnaz,16,0,20,4
1649829550531,ECE 100,A02,091916,Baghdadchi; Saharnaz,18,0,20,2
1649829556558,ECE 101,A01,084053,Baghdadchi; Saharnaz,25,0,37,12
1649829556558,ECE 101,A02,084054,Baghdadchi; Saharnaz,37,0,37,0
1649829562581,ECE 107,A01,083390,Staff,33,0,40,7
1649829568605,ECE 148,A01,084056,Silberman; Jack,8,0,12,4
1649829574632,ECE 180,A00,083391,Abi Samra; Nicholas Camill,27,0,30,3
1649829574632,ECE 180,B00,083392,Abi Samra; Nicholas Camill,26,0,30,4
1649829580655,MATH 10B,A01,084110,Staff,20,0,30,10
1649829580655,MATH 10B,A02,084111,Staff,29,0,30,1
1649829580655,MATH 10B,A03,084112,Staff,29,0,30,1
1649829586677,MATH 10C,A01,083443,Staff,19,0,30,11
1649829586677,MATH 10C,A02,083444,Staff,25,0,30,5
1649829586677,MATH 10C,B01,084114,Staff,26,0,30,4
1649829586677,MATH 10C,B02,084115,Staff,30,0,30,0
1649829592702,MATH 18,A01,084117,Harel; Guershon,28,0,30,2
1649829592702,MATH 18,A02,084119,Harel; Guershon,29,0,30,1
1649829592702,MATH 18,A03,084120,Harel; Guershon,30,0,30,0
1649829592702,MATH 18,A04,084121,Harel; Guershon,30,0,30,0
1649829598730,MATH 20B,A01,084124,Um; Ko Woon,33,0,35,2
1649829598730,MATH 20B,B01,084126,Um; Ko Woon,35,0,35,0
1649829604774,MATH 20C,A01,083446,Hammock; Frances H,27,0,30,3
1649829604774,MATH 20C,A02,083447,Hammock; Frances H,30,0,30,0
1649829604774,MATH 20C,A03,083448,Hammock; Frances H,30,0,30,0
1649829604774,MATH 20C,A04,083449,Hammock; Frances H,30,0,30,0
1649829604774,MATH 20C,B01,083451,Hammock; Frances H,29,0,30,1
1649829604774,MATH 20C,B02,083452,Hammock; Frances H,30,0,30,0
1649829604774,MATH 20C,B03,083453,Hammock; Frances H,30,0,30,0
1649829604774,MATH 20C,B04,083454,Hammock; Frances H,30,0,30,0
1649829610799,MATH 20D,A01,084128,Staff,29,0,30,1
1649829610799,MATH 20D,A02,084129,Staff,30,0,30,0
1649829610799,MATH 20D,A03,084130,Staff,29,0,30,1
1649829610799,MATH 20D,B01,084133,Staff,28,0,30,2
1649829610799,MATH 20D,B02,084134,Staff,30,0,30,0
1649829610799,MATH 20D,B03,084135,Staff,30,0,30,0
1649829616827,MATH 20E,A01,084138,Staff,28,0,30,2
1649829616827,MATH 20E,A02,084139,Staff,29,0,30,1
1649829616827,MATH 20E,A03,084140,Staff,28,0,30,2
1649829616827,MATH 20E,A04,084141,Staff,30,0,30,0
1649829622857,MATH 102,A01,084143,Harel; Guershon,24,0,30,6
1649829622857,MATH 102,A02,084144,Harel; Guershon,25,0,30,5
1649829628882,MATH 103B,A01,083456,Staff,0,0,30,30
1649829628882,MATH 103B,A02,083457,Staff,20,0,30,10
1649829634908,MATH 109,A01,084146,Salehi Golsefidy; Alireza,30,0,30,0
1649829634908,MATH 109,A02,084147,Salehi Golsefidy; Alireza,27,0,30,3
1649829640934,MATH 120A,A01,085445,Eggers; John Dietrich,31,0,35,4
1649829640934,MATH 120A,A02,085446,Eggers; John Dietrich,31,0,35,4
1649829646958,MATH 142B,A01,084149,Verstraete; Jacques Allan,8,0,30,22
1649829646958,MATH 142B,A02,084150,Verstraete; Jacques Allan,25,0,30,5
1649829652987,MATH 170A,A01,083459,Nie; Jiawang,10,0,30,20
1649829652987,MATH 170A,A02,083460,Nie; Jiawang,25,0,30,5
1649829652987,MATH 170A,A03,083461,Nie; Jiawang,26,0,30,4
1649829659010,MATH 193B,A01,083463,Staff,16,0,30,14
1649829659010,MATH 193B,A02,083464,Staff,19,0,30,11
1649829659010,MATH 193B,A03,083465,Staff,27,0,30,3
1649829665109,COGS 2,A01,083966,Boyle; Mary E. T.,27,0,30,3
1649829671138,COGS 9,A01,083968,Staff,57,0,60,3
1649829677162,COGS 14B,A01,083970,Staff,46,0,50,4
1649829683188,COGS 17,A01,092679,Staff,73,0,75,2
1649829689215,COGS 100,A01,083972,Staff,46,0,60,14
1649829701264,COGS 101C,A01,083976,Staff,25,0,30,5
1649829707294,COGS 102A,A01,083978,Johnson; Christine M.,24,0,30,6
1649829713316,COGS 107B,A01,083980,Staff,37,0,50,13
1649829719341,COGS 115,A01,083982,Staff,22,0,30,8
1649829725370,COGS 118B,A01,083367,Staff,5,0,40,35
1649829731398,COGS 172,A01,083984,Provenzano; Emily Kara,21,0,30,9
1649829737422,COGS 177,A00,083368,Staff,6,0,30,24
1649829743444,COGS 186,A01,083986,Staff,25,0,40,15
1649829749467,COGS 187A,A01,083988,Boyle; Mary E. T.,41,0,60,19
1649829755505,CSE 8A,A50,084003,Miranda; Gregory Joseph,9,0,15,6
1649829761530,CSE 11,A01,084005,Miranda; Gregory Joseph,49,0,55,6
1649829767556,CSE 20,A01,084007,Staff,15,0,20,5
1649829773580,CSE 21,A01,084009,Staff,35,0,50,15
1649829779603,CSE 30,A01,083370,Cao; Yingjun,20,0,40,20
1649829785631,CSE 100,A01,083372,Cao; Yingjun,15,0,40,25
1649829791665,CSE 101,A01,084011,Staff,0,12,40,40
1649829797692,CSE 141,A01,083374,Eldon; John,0,10,75,75
1649829803721,CSE 141L,A01,083376,Eldon; John,0,13,75,75
1649829809744,CSE 175,A01,084013,Kumar; Rakesh,24,0,25,1
1649829815772,CSE 190,A00,092508,Staff,15,0,15,0
1649829821796,ECE 5,A01,084049,Morris; Karcher William,17,0,20,3
1649829827822,ECE 100,A01,084051,Baghdadchi; Saharnaz,16,0,20,4
1649829827822,ECE 100,A02,091916,Baghdadchi; Saharnaz,18,0,20,2
1649829833852,ECE 101,A01,084053,Baghdadchi; Saharnaz,25,0,37,12
1649829833852,ECE 101,A02,084054,Baghdadchi; Saharnaz,37,0,37,0
1649829839889,ECE 107,A01,083390,Staff,33,0,40,7
1649829845914,ECE 148,A01,084056,Silberman; Jack,8,0,12,4
1649829851940,ECE 180,A00,083391,Abi Samra; Nicholas Camill,27,0,30,3
1649829851940,ECE 180,B00,083392,Abi Samra; Nicholas Camill,26,0,30,4
1649829857976,MATH 10B,A01,084110,Staff,20,0,30,10
1649829857976,MATH 10B,A02,084111,Staff,29,0,30,1
1649829857976,MATH 10B,A03,084112,Staff,29,0,30,1
1649829864003,MATH 10C,A01,083443,Staff,19,0,30,11
1649829864003,MATH 10C,A02,083444,Staff,25,0,30,5
1649829864003,MATH 10C,B01,084114,Staff,26,0,30,4
1649829864003,MATH 10C,B02,084115,Staff,30,0,30,0
1649829870038,MATH 18,A01,084117,Harel; Guershon,28,0,30,2
1649829870038,MATH 18,A02,084119,Harel; Guershon,29,0,30,1
1649829870038,MATH 18,A03,084120,Harel; Guershon,30,0,30,0
1649829870038,MATH 18,A04,084121,Harel; Guershon,30,0,30,0
1649829876069,MATH 20B,A01,084124,Um; Ko Woon,33,0,35,2
1649829876069,MATH 20B,B01,084126,Um; Ko Woon,35,0,35,0
1649829882106,MATH 20C,A01,083446,Hammock; Frances H,27,0,30,3
1649829882106,MATH 20C,A02,083447,Hammock; Frances H,30,0,30,0
1649829882106,MATH 20C,A03,083448,Hammock; Frances H,30,0,30,0
1649829882106,MATH 20C,A04,083449,Hammock; Frances H,30,0,30,0
1649829882106,MATH 20C,B01,083451,Hammock; Frances H,29,0,30,1
1649829882106,MATH 20C,B02,083452,Hammock; Frances H,30,0,30,0
1649829882106,MATH 20C,B03,083453,Hammock; Frances H,30,0,30,0
1649829882106,MATH 20C,B04,083454,Hammock; Frances H,30,0,30,0
1649829888138,MATH 20D,A01,084128,Staff,29,0,30,1
1649829888138,MATH 20D,A02,084129,Staff,30,0,30,0
1649829888138,MATH 20D,A03,084130,Staff,29,0,30,1
1649829888138,MATH 20D,B01,084133,Staff,28,0,30,2
1649829888138,MATH 20D,B02,084134,Staff,30,0,30,0
1649829888138,MATH 20D,B03,084135,Staff,30,0,30,0
1649829894161,MATH 20E,A01,084138,Staff,28,0,30,2
1649829894161,MATH 20E,A02,084139,Staff,29,0,30,1
1649829894161,MATH 20E,A03,084140,Staff,28,0,30,2
1649829894161,MATH 20E,A04,084141,Staff,30,0,30,0
1649829900189,MATH 102,A01,084143,Harel; Guershon,24,0,30,6
1649829900189,MATH 102,A02,084144,Harel; Guershon,25,0,30,5
1649829906218,MATH 103B,A01,083456,Staff,0,0,30,30
1649829906218,MATH 103B,A02,083457,Staff,20,0,30,10
1649829912244,MATH 109,A01,084146,Salehi Golsefidy; Alireza,30,0,30,0
1649829912244,MATH 109,A02,084147,Salehi Golsefidy; Alireza,27,0,30,3
1649829918267,MATH 120A,A01,085445,Eggers; John Dietrich,31,0,35,4
1649829918267,MATH 120A,A02,085446,Eggers; John Dietrich,31,0,35,4
1649829924298,MATH 142B,A01,084149,Verstraete; Jacques Allan,7,0,30,23
1649829924298,MATH 142B,A02,084150,Verstraete; Jacques Allan,25,0,30,5
1649829930322,MATH 170A,A01,083459,Nie; Jiawang,10,0,30,20
1649829930322,MATH 170A,A02,083460,Nie; Jiawang,25,0,30,5
1649829930322,MATH 170A,A03,083461,Nie; Jiawang,26,0,30,4
1649829936350,MATH 193B,A01,083463,Staff,16,0,30,14
1649829936350,MATH 193B,A02,083464,Staff,19,0,30,11
1649829936350,MATH 193B,A03,083465,Staff,27,0,30,3
1649829942406,COGS 2,A01,083966,Boyle; Mary E. T.,27,0,30,3
1649829948429,COGS 9,A01,083968,Staff,57,0,60,3
1649829954453,COGS 14B,A01,083970,Staff,46,0,50,4
1649829960491,COGS 17,A01,092679,Staff,73,0,75,2
1649829966517,COGS 100,A01,083972,Staff,46,0,60,14
1649829978567,COGS 101C,A01,083976,Staff,25,0,30,5
1649829984600,COGS 102A,A01,083978,Johnson; Christine M.,24,0,30,6
1649829990632,COGS 107B,A01,083980,Staff,37,0,50,13
1649829996659,COGS 115,A01,083982,Staff,22,0,30,8
1649830002688,COGS 118B,A01,083367,Staff,5,0,40,35
1649830008712,COGS 172,A01,083984,Provenzano; Emily Kara,21,0,30,9
1649830014735,COGS 177,A00,083368,Staff,6,0,30,24
1649830020759,COGS 186,A01,083986,Staff,25,0,40,15
1649830026783,COGS 187A,A01,083988,Boyle; Mary E. T.,41,0,60,19
1649830032901,CSE 8A,A50,084003,Miranda; Gregory Joseph,9,0,15,6
1649830038925,CSE 11,A01,084005,Miranda; Gregory Joseph,49,0,55,6
1649830044947,CSE 20,A01,084007,Staff,15,0,20,5
1649830050971,CSE 21,A01,084009,Staff,35,0,50,15
1649830056998,CSE 30,A01,083370,Cao; Yingjun,20,0,40,20
1649830063032,CSE 100,A01,083372,Cao; Yingjun,15,0,40,25
1649830069068,CSE 101,A01,084011,Staff,0,12,40,40
1649830075107,CSE 141,A01,083374,Eldon; John,0,10,75,75
1649830081131,CSE 141L,A01,083376,Eldon; John,0,13,75,75
1649830087156,CSE 175,A01,084013,Kumar; Rakesh,24,0,25,1
1649830093179,CSE 190,A00,092508,Staff,15,0,15,0
1649830099205,ECE 5,A01,084049,Morris; Karcher William,17,0,20,3
1649830105228,ECE 100,A01,084051,Baghdadchi; Saharnaz,16,0,20,4
1649830105228,ECE 100,A02,091916,Baghdadchi; Saharnaz,18,0,20,2
1649830111254,ECE 101,A01,084053,Baghdadchi; Saharnaz,25,0,37,12
1649830111254,ECE 101,A02,084054,Baghdadchi; Saharnaz,37,0,37,0
1649830117284,ECE 107,A01,083390,Staff,33,0,40,7
1649830123307,ECE 148,A01,084056,Silberman; Jack,8,0,12,4
1649830129340,ECE 180,A00,083391,Abi Samra; Nicholas Camill,27,0,30,3
1649830129340,ECE 180,B00,083392,Abi Samra; Nicholas Camill,26,0,30,4
1649830135368,MATH 10B,A01,084110,Staff,20,0,30,10
1649830135368,MATH 10B,A02,084111,Staff,29,0,30,1
1649830135368,MATH 10B,A03,084112,Staff,29,0,30,1
1649830141396,MATH 10C,A01,083443,Staff,19,0,30,11
1649830141396,MATH 10C,A02,083444,Staff,25,0,30,5
1649830141396,MATH 10C,B01,084114,Staff,26,0,30,4
1649830141396,MATH 10C,B02,084115,Staff,30,0,30,0
1649830147421,MATH 18,A01,084117,Harel; Guershon,28,0,30,2
1649830147421,MATH 18,A02,084119,Harel; Guershon,29,0,30,1
1649830147421,MATH 18,A03,084120,Harel; Guershon,30,0,30,0
1649830147421,MATH 18,A04,084121,Harel; Guershon,30,0,30,0
1649830153470,MATH 20B,A01,084124,Um; Ko Woon,33,0,35,2
1649830153470,MATH 20B,B01,084126,Um; Ko Woon,35,0,35,0
1649830159494,MATH 20C,A01,083446,Hammock; Frances H,27,0,30,3
1649830159494,MATH 20C,A02,083447,Hammock; Frances H,30,0,30,0
1649830159494,MATH 20C,A03,083448,Hammock; Frances H,30,0,30,0
1649830159494,MATH 20C,A04,083449,Hammock; Frances H,30,0,30,0
1649830159494,MATH 20C,B01,083451,Hammock; Frances H,29,0,30,1
1649830159494,MATH 20C,B02,083452,Hammock; Frances H,30,0,30,0
1649830159494,MATH 20C,B03,083453,Hammock; Frances H,30,0,30,0
1649830159494,MATH 20C,B04,083454,Hammock; Frances H,30,0,30,0
1649830165518,MATH 20D,A01,084128,Staff,29,0,30,1
1649830165518,MATH 20D,A02,084129,Staff,30,0,30,0
1649830165518,MATH 20D,A03,084130,Staff,29,0,30,1
1649830165518,MATH 20D,B01,084133,Staff,28,0,30,2
1649830165518,MATH 20D,B02,084134,Staff,30,0,30,0
1649830165518,MATH 20D,B03,084135,Staff,30,0,30,0
1649830171545,MATH 20E,A01,084138,Staff,28,0,30,2
1649830171545,MATH 20E,A02,084139,Staff,29,0,30,1
1649830171545,MATH 20E,A03,084140,Staff,28,0,30,2
1649830171545,MATH 20E,A04,084141,Staff,30,0,30,0
1649830177568,MATH 102,A01,084143,Harel; Guershon,24,0,30,6
1649830177568,MATH 102,A02,084144,Harel; Guershon,25,0,30,5
1649830183594,MATH 103B,A01,083456,Staff,0,0,30,30
1649830183594,MATH 103B,A02,083457,Staff,20,0,30,10
1649830189621,MATH 109,A01,084146,Salehi Golsefidy; Alireza,30,0,30,0
1649830189621,MATH 109,A02,084147,Salehi Golsefidy; Alireza,27,0,30,3
1649830195645,MATH 120A,A01,085445,Eggers; John Dietrich,31,0,35,4
1649830195645,MATH 120A,A02,085446,Eggers; John Dietrich,31,0,35,4
1649830201672,MATH 142B,A01,084149,Verstraete; Jacques Allan,7,0,30,23
1649830201672,MATH 142B,A02,084150,Verstraete; Jacques Allan,25,0,30,5
1649830207697,MATH 170A,A01,083459,Nie; Jiawang,9,0,30,21
1649830207697,MATH 170A,A02,083460,Nie; Jiawang,25,0,30,5
1649830207697,MATH 170A,A03,083461,Nie; Jiawang,26,0,30,4
1649830213721,MATH 193B,A01,083463,Staff,16,0,30,14
1649830213721,MATH 193B,A02,083464,Staff,19,0,30,11
1649830213721,MATH 193B,A03,083465,Staff,27,0,30,3
1649830219771,COGS 2,A01,083966,Boyle; Mary E. T.,27,0,30,3
1649830225794,COGS 9,A01,083968,Staff,57,0,60,3
1649830231822,COGS 14B,A01,083970,Staff,46,0,50,4
1649830237844,COGS 17,A01,092679,Staff,73,0,75,2
1649830243868,COGS 100,A01,083972,Staff,46,0,60,14
1649830255917,COGS 101C,A01,083976,Staff,25,0,30,5
1649830261944,COGS 102A,A01,083978,Johnson; Christine M.,24,0,30,6
1649830267971,COGS 107B,A01,083980,Staff,37,0,50,13
1649830273992,COGS 115,A01,083982,Staff,22,0,30,8
1649830280030,COGS 118B,A01,083367,Staff,5,0,40,35
1649830286059,COGS 172,A01,083984,Provenzano; Emily Kara,21,0,30,9
1649830292082,COGS 177,A00,083368,Staff,6,0,30,24
1649830298106,COGS 186,A01,083986,Staff,25,0,40,15
1649830304129,COGS 187A,A01,083988,Boyle; Mary E. T.,41,0,60,19
1649830310152,CSE 8A,A50,084003,Miranda; Gregory Joseph,9,0,15,6
1649830316175,CSE 11,A01,084005,Miranda; Gregory Joseph,49,0,55,6
1649830322198,CSE 20,A01,084007,Staff,15,0,20,5
1649830328222,CSE 21,A01,084009,Staff,35,0,50,15
1649830334250,CSE 30,A01,083370,Cao; Yingjun,20,0,40,20
1649830340274,CSE 100,A01,083372,Cao; Yingjun,15,0,40,25
1649830346301,CSE 101,A01,084011,Staff,0,12,40,40
1649830352334,CSE 141,A01,083374,Eldon; John,0,10,75,75
1649830358363,CSE 141L,A01,083376,Eldon; John,0,13,75,75
1649830364389,CSE 175,A01,084013,Kumar; Rakesh,24,0,25,1
1649830370417,CSE 190,A00,092508,Staff,15,0,15,0
1649830376447,ECE 5,A01,084049,Morris; Karcher William,17,0,20,3
1649830382483,ECE 100,A01,084051,Baghdadchi; Saharnaz,16,0,20,4
1649830382483,ECE 100,A02,091916,Baghdadchi; Saharnaz,18,0,20,2
1649830388507,ECE 101,A01,084053,Baghdadchi; Saharnaz,25,0,37,12
1649830388507,ECE 101,A02,084054,Baghdadchi; Saharnaz,37,0,37,0
1649830394549,ECE 107,A01,083390,Staff,32,0,40,8
1649830400574,ECE 148,A01,084056,Silberman; Jack,8,0,12,4
1649830406602,ECE 180,A00,083391,Abi Samra; Nicholas Camill,27,0,30,3
1649830406602,ECE 180,B00,083392,Abi Samra; Nicholas Camill,26,0,30,4
1649830412627,MATH 10B,A01,084110,Staff,20,0,30,10
1649830412627,MATH 10B,A02,084111,Staff,29,0,30,1
1649830412627,MATH 10B,A03,084112,Staff,29,0,30,1
1649830418661,MATH 10C,A01,083443,Staff,19,0,30,11
1649830418661,MATH 10C,A02,083444,Staff,24,0,30,6
1649830418661,MATH 10C,B01,084114,Staff,26,0,30,4
1649830418661,MATH 10C,B02,084115,Staff,30,0,30,0
1649830424695,MATH 18,A01,084117,Harel; Guershon,28,0,30,2
1649830424695,MATH 18,A02,084119,Harel; Guershon,29,0,30,1
1649830424695,MATH 18,A03,084120,Harel; Guershon,30,0,30,0
1649830424695,MATH 18,A04,084121,Harel; Guershon,30,0,30,0
1649830430723,MATH 20B,A01,084124,Um; Ko Woon,33,0,35,2
1649830430723,MATH 20B,B01,084126,Um; Ko Woon,35,0,35,0
1649830436755,MATH 20C,A01,083446,Hammock; Frances H,27,0,30,3
1649830436755,MATH 20C,A02,083447,Hammock; Frances H,30,0,30,0
1649830436755,MATH 20C,A03,083448,Hammock; Frances H,30,0,30,0
1649830436755,MATH 20C,A04,083449,Hammock; Frances H,30,0,30,0
1649830436755,MATH 20C,B01,083451,Hammock; Frances H,29,0,30,1
1649830436755,MATH 20C,B02,083452,Hammock; Frances H,30,0,30,0
1649830436755,MATH 20C,B03,083453,Hammock; Frances H,30,0,30,0
1649830436755,MATH 20C,B04,083454,Hammock; Frances H,30,0,30,0
1649830442801,MATH 20D,A01,084128,Staff,29,0,30,1
1649830442801,MATH 20D,A02,084129,Staff,30,0,30,0
1649830442801,MATH 20D,A03,084130,Staff,29,0,30,1
1649830442801,MATH 20D,B01,084133,Staff,28,0,30,2
1649830442801,MATH 20D,B02,084134,Staff,30,0,30,0
1649830442801,MATH 20D,B03,084135,Staff,30,0,30,0
1649830448837,MATH 20E,A01,084138,Staff,28,0,30,2
1649830448837,MATH 20E,A02,084139,Staff,29,0,30,1
1649830448837,MATH 20E,A03,084140,Staff,28,0,30,2
1649830448837,MATH 20E,A04,084141,Staff,30,0,30,0
1649830454865,MATH 102,A01,084143,Harel; Guershon,24,0,30,6
1649830454865,MATH 102,A02,084144,Harel; Guershon,25,0,30,5
1649830460892,MATH 103B,A01,083456,Staff,0,0,30,30
1649830460892,MATH 103B,A02,083457,Staff,20,0,30,10
1649830466920,MATH 109,A01,084146,Salehi Golsefidy; Alireza,30,0,30,0
1649830466920,MATH 109,A02,084147,Salehi Golsefidy; Alireza,27,0,30,3
1649830472942,MATH 120A,A01,085445,Eggers; John Dietrich,31,0,35,4
1649830472942,MATH 120A,A02,085446,Eggers; John Dietrich,31,0,35,4
1649830478964,MATH 142B,A01,084149,Verstraete; Jacques Allan,7,0,30,23
1649830478964,MATH 142B,A02,084150,Verstraete; Jacques Allan,25,0,30,5
1649830484987,MATH 170A,A01,083459,Nie; Jiawang,9,0,30,21
1649830484987,MATH 170A,A02,083460,Nie; Jiawang,25,0,30,5
1649830484987,MATH 170A,A03,083461,Nie; Jiawang,26,0,30,4
1649830491013,MATH 193B,A01,083463,Staff,16,0,30,14
1649830491013,MATH 193B,A02,083464,Staff,19,0,30,11
1649830491013,MATH 193B,A03,083465,Staff,27,0,30,3
1649830497075,COGS 2,A01,083966,Boyle; Mary E. T.,27,0,30,3
1649830503099,COGS 9,A01,083968,Staff,57,0,60,3
1649830509122,COGS 14B,A01,083970,Staff,46,0,50,4
1649830515149,COGS 17,A01,092679,Staff,73,0,75,2
1649830521173,COGS 100,A01,083972,Staff,46,0,60,14
1649830533231,COGS 101C,A01,083976,Staff,25,0,30,5
1649830539258,COGS 102A,A01,083978,Johnson; Christine M.,24,0,30,6
1649830545282,COGS 107B,A01,083980,Staff,37,0,50,13
1649830551305,COGS 115,A01,083982,Staff,22,0,30,8
1649830557332,COGS 118B,A01,083367,Staff,5,0,40,35
1649830563365,COGS 172,A01,083984,Provenzano; Emily Kara,21,0,30,9
1649830569388,COGS 177,A00,083368,Staff,6,0,30,24
1649830575412,COGS 186,A01,083986,Staff,25,0,40,15
1649830581439,COGS 187A,A01,083988,Boyle; Mary E. T.,41,0,60,19
1649830587463,CSE 8A,A50,084003,Miranda; Gregory Joseph,9,0,15,6
1649830593488,CSE 11,A01,084005,Miranda; Gregory Joseph,49,0,55,6
1649830599512,CSE 20,A01,084007,Staff,15,0,20,5
1649830605535,CSE 21,A01,084009,Staff,35,0,50,15
1649830611561,CSE 30,A01,083370,Cao; Yingjun,20,0,40,20
1649830617588,CSE 100,A01,083372,Cao; Yingjun,15,0,40,25
1649830623617,CSE 101,A01,084011,Staff,0,12,40,40
1649830629729,CSE 141,A01,083374,Eldon; John,0,10,75,75
1649830635752,CSE 141L,A01,083376,Eldon; John,0,13,75,75
1649830641776,CSE 175,A01,084013,Kumar; Rakesh,24,0,25,1
1649830647799,CSE 190,A00,092508,Staff,15,0,15,0
1649830653826,ECE 5,A01,084049,Morris; Karcher William,17,0,20,3
1649830659850,ECE 100,A01,084051,Baghdadchi; Saharnaz,16,0,20,4
1649830659850,ECE 100,A02,091916,Baghdadchi; Saharnaz,18,0,20,2
1649830665874,ECE 101,A01,084053,Baghdadchi; Saharnaz,25,0,37,12
1649830665874,ECE 101,A02,084054,Baghdadchi; Saharnaz,37,0,37,0
1649830671906,ECE 107,A01,083390,Staff,32,0,40,8
1649830677930,ECE 148,A01,084056,Silberman; Jack,8,0,12,4
1649830683953,ECE 180,A00,083391,Abi Samra; Nicholas Camill,27,0,30,3
1649830683953,ECE 180,B00,083392,Abi Samra; Nicholas Camill,26,0,30,4
1649830689979,MATH 10B,A01,084110,Staff,20,0,30,10
1649830689979,MATH 10B,A02,084111,Staff,29,0,30,1
1649830689979,MATH 10B,A03,084112,Staff,29,0,30,1
1649830696009,MATH 10C,A01,083443,Staff,19,0,30,11
1649830696009,MATH 10C,A02,083444,Staff,24,0,30,6
1649830696009,MATH 10C,B01,084114,Staff,26,0,30,4
1649830696009,MATH 10C,B02,084115,Staff,30,0,30,0
1649830702038,MATH 18,A01,084117,Harel; Guershon,28,0,30,2
1649830702038,MATH 18,A02,084119,Harel; Guershon,29,0,30,1
1649830702038,MATH 18,A03,084120,Harel; Guershon,30,0,30,0
1649830702038,MATH 18,A04,084121,Harel; Guershon,30,0,30,0
1649830708068,MATH 20B,A01,084124,Um; Ko Woon,33,0,35,2
1649830708068,MATH 20B,B01,084126,Um; Ko Woon,35,0,35,0
1649830714092,MATH 20C,A01,083446,Hammock; Frances H,27,0,30,3
1649830714092,MATH 20C,A02,083447,Hammock; Frances H,30,0,30,0
1649830714092,MATH 20C,A03,083448,Hammock; Frances H,30,0,30,0
1649830714092,MATH 20C,A04,083449,Hammock; Frances H,30,0,30,0
1649830714092,MATH 20C,B01,083451,Hammock; Frances H,29,0,30,1
1649830714092,MATH 20C,B02,083452,Hammock; Frances H,30,0,30,0
1649830714092,MATH 20C,B03,083453,Hammock; Frances H,30,0,30,0
1649830714092,MATH 20C,B04,083454,Hammock; Frances H,30,0,30,0
1649830720121,MATH 20D,A01,084128,Staff,29,0,30,1
1649830720121,MATH 20D,A02,084129,Staff,30,0,30,0
1649830720121,MATH 20D,A03,084130,Staff,29,0,30,1
1649830720121,MATH 20D,B01,084133,Staff,28,0,30,2
1649830720121,MATH 20D,B02,084134,Staff,30,0,30,0
1649830720121,MATH 20D,B03,084135,Staff,30,0,30,0
1649830726155,MATH 20E,A01,084138,Staff,28,0,30,2
1649830726155,MATH 20E,A02,084139,Staff,29,0,30,1
1649830726155,MATH 20E,A03,084140,Staff,28,0,30,2
1649830726155,MATH 20E,A04,084141,Staff,30,0,30,0
1649830732190,MATH 102,A01,084143,Harel; Guershon,24,0,30,6
1649830732190,MATH 102,A02,084144,Harel; Guershon,25,0,30,5
1649830738214,MATH 103B,A01,083456,Staff,0,0,30,30
1649830738214,MATH 103B,A02,083457,Staff,20,0,30,10
1649830744243,MATH 109,A01,084146,Salehi Golsefidy; Alireza,30,0,30,0
1649830744243,MATH 109,A02,084147,Salehi Golsefidy; Alireza,27,0,30,3
1649830750266,MATH 120A,A01,085445,Eggers; John Dietrich,31,0,35,4
1649830750266,MATH 120A,A02,085446,Eggers; John Dietrich,31,0,35,4
1649830756293,MATH 142B,A01,084149,Verstraete; Jacques Allan,7,0,30,23
1649830756293,MATH 142B,A02,084150,Verstraete; Jacques Allan,25,0,30,5
1649830762322,MATH 170A,A01,083459,Nie; Jiawang,9,0,30,21
1649830762322,MATH 170A,A02,083460,Nie; Jiawang,25,0,30,5
1649830762322,MATH 170A,A03,083461,Nie; Jiawang,26,0,30,4
1649830768346,MATH 193B,A01,083463,Staff,16,0,30,14
1649830768346,MATH 193B,A02,083464,Staff,19,0,30,11
1649830768346,MATH 193B,A03,083465,Staff,27,0,30,3
1649830774406,COGS 2,A01,083966,Boyle; Mary E. T.,27,0,30,3
1649830780429,COGS 9,A01,083968,Staff,57,0,60,3
1649830786456,COGS 14B,A01,083970,Staff,46,0,50,4
1649830792485,COGS 17,A01,092679,Staff,73,0,75,2
1649830798509,COGS 100,A01,083972,Staff,46,0,60,14
1649830810563,COGS 101C,A01,083976,Staff,25,0,30,5
1649830816590,COGS 102A,A01,083978,Johnson; Christine M.,24,0,30,6
1649830822616,COGS 107B,A01,083980,Staff,37,0,50,13
1649830828640,COGS 115,A01,083982,Staff,22,0,30,8
1649830834670,COGS 118B,A01,083367,Staff,5,0,40,35
1649830840694,COGS 172,A01,083984,Provenzano; Emily Kara,21,0,30,9
1649830846717,COGS 177,A00,083368,Staff,6,0,30,24
1649830852743,COGS 186,A01,083986,Staff,25,0,40,15
1649830858765,COGS 187A,A01,083988,Boyle; Mary E. T.,41,0,60,19
1649830864801,CSE 8A,A50,084003,Miranda; Gregory Joseph,9,0,15,6
1649830870828,CSE 11,A01,084005,Miranda; Gregory Joseph,49,0,55,6
1649830876852,CSE 20,A01,084007,Staff,15,0,20,5
1649830882874,CSE 21,A01,084009,Staff,34,0,50,16
1649830888898,CSE 30,A01,083370,Cao; Yingjun,20,0,40,20
1649830894933,CSE 100,A01,083372,Cao; Yingjun,15,0,40,25
1649830900959,CSE 101,A01,084011,Staff,0,12,40,40
1649830906985,CSE 141,A01,083374,Eldon; John,0,10,75,75
1649830913011,CSE 141L,A01,083376,Eldon; John,0,13,75,75
1649830919033,CSE 175,A01,084013,Kumar; Rakesh,24,0,25,1
1649830925061,CSE 190,A00,092508,Staff,15,0,15,0
1649830931100,ECE 5,A01,084049,Morris; Karcher William,17,0,20,3
1649830937124,ECE 100,A01,084051,Baghdadchi; Saharnaz,16,0,20,4
1649830937124,ECE 100,A02,091916,Baghdadchi; Saharnaz,18,0,20,2
1649830943150,ECE 101,A01,084053,Baghdadchi; Saharnaz,25,0,37,12
1649830943150,ECE 101,A02,084054,Baghdadchi; Saharnaz,37,0,37,0
1649830949181,ECE 107,A01,083390,Staff,32,0,40,8
1649830955207,ECE 148,A01,084056,Silberman; Jack,8,0,12,4
1649830961230,ECE 180,A00,083391,Abi Samra; Nicholas Camill,27,0,30,3
1649830961230,ECE 180,B00,083392,Abi Samra; Nicholas Camill,26,0,30,4
1649830967257,MATH 10B,A01,084110,Staff,20,0,30,10
1649830967257,MATH 10B,A02,084111,Staff,29,0,30,1
1649830967257,MATH 10B,A03,084112,Staff,29,0,30,1
1649830973285,MATH 10C,A01,083443,Staff,19,0,30,11
1649830973285,MATH 10C,A02,083444,Staff,24,0,30,6
1649830973285,MATH 10C,B01,084114,Staff,26,0,30,4
1649830973285,MATH 10C,B02,084115,Staff,30,0,30,0
1649830979309,MATH 18,A01,084117,Harel; Guershon,28,0,30,2
1649830979309,MATH 18,A02,084119,Harel; Guershon,29,0,30,1
1649830979309,MATH 18,A03,084120,Harel; Guershon,30,0,30,0
1649830979309,MATH 18,A04,084121,Harel; Guershon,30,0,30,0
1649830985337,MATH 20B,A01,084124,Um; Ko Woon,33,0,35,2
1649830985337,MATH 20B,B01,084126,Um; Ko Woon,35,0,35,0
1649830991363,MATH 20C,A01,083446,Hammock; Frances H,27,0,30,3
1649830991363,MATH 20C,A02,083447,Hammock; Frances H,30,0,30,0
1649830991363,MATH 20C,A03,083448,Hammock; Frances H,30,0,30,0
1649830991363,MATH 20C,A04,083449,Hammock; Frances H,30,0,30,0
1649830991363,MATH 20C,B01,083451,Hammock; Frances H,29,0,30,1
1649830991363,MATH 20C,B02,083452,Hammock; Frances H,30,0,30,0
1649830991363,MATH 20C,B03,083453,Hammock; Frances H,30,0,30,0
1649830991363,MATH 20C,B04,083454,Hammock; Frances H,30,0,30,0
1649830997390,MATH 20D,A01,084128,Staff,29,0,30,1
1649830997390,MATH 20D,A02,084129,Staff,30,0,30,0
1649830997390,MATH 20D,A03,084130,Staff,29,0,30,1
1649830997390,MATH 20D,B01,084133,Staff,28,0,30,2
1649830997390,MATH 20D,B02,084134,Staff,30,0,30,0
1649830997390,MATH 20D,B03,084135,Staff,30,0,30,0
1649831003415,MATH 20E,A01,084138,Staff,28,0,30,2
1649831003415,MATH 20E,A02,084139,Staff,29,0,30,1
1649831003415,MATH 20E,A03,084140,Staff,28,0,30,2
1649831003415,MATH 20E,A04,084141,Staff,30,0,30,0
1649831009442,MATH 102,A01,084143,Harel; Guershon,24,0,30,6
1649831009442,MATH 102,A02,084144,Harel; Guershon,25,0,30,5
1649831015467,MATH 103B,A01,083456,Staff,0,0,30,30
1649831015467,MATH 103B,A02,083457,Staff,20,0,30,10
1649831021499,MATH 109,A01,084146,Salehi Golsefidy; Alireza,30,0,30,0
1649831021499,MATH 109,A02,084147,Salehi Golsefidy; Alireza,27,0,30,3
1649831027523,MATH 120A,A01,085445,Eggers; John Dietrich,31,0,35,4
1649831027523,MATH 120A,A02,085446,Eggers; John Dietrich,31,0,35,4
1649831033560,MATH 142B,A01,084149,Verstraete; Jacques Allan,7,0,30,23
1649831033560,MATH 142B,A02,084150,Verstraete; Jacques Allan,25,0,30,5
1649831039590,MATH 170A,A01,083459,Nie; Jiawang,9,0,30,21
1649831039590,MATH 170A,A02,083460,Nie; Jiawang,25,0,30,5
1649831039590,MATH 170A,A03,083461,Nie; Jiawang,26,0,30,4
1649831045622,MATH 193B,A01,083463,Staff,16,0,30,14
1649831045622,MATH 193B,A02,083464,Staff,19,0,30,11
1649831045622,MATH 193B,A03,083465,Staff,27,0,30,3
1649831051684,COGS 2,A01,083966,Boyle; Mary E. T.,27,0,30,3
1649831057720,COGS 9,A01,083968,Staff,57,0,60,3
1649831063741,COGS 14B,A01,083970,Staff,46,0,50,4
1649831069777,COGS 17,A01,092679,Staff,73,0,75,2
1649831075809,COGS 100,A01,083972,Staff,46,0,60,14
1649831087868,COGS 101C,A01,083976,Staff,25,0,30,5
1649831093890,COGS 102A,A01,083978,Johnson; Christine M.,24,0,30,6
1649831113592,COGS 107B,A01,083980,Staff,37,0,50,13
1649831119614,COGS 115,A01,083982,Staff,22,0,30,8
1649831125642,COGS 118B,A01,083367,Staff,5,0,40,35
1649831131665,COGS 172,A01,083984,Provenzano; Emily Kara,21,0,30,9
1649831137694,COGS 177,A00,083368,Staff,6,0,30,24
1649831143722,COGS 186,A01,083986,Staff,25,0,40,15
1649831149746,COGS 187A,A01,083988,Boyle; Mary E. T.,41,0,60,19
1649831155771,CSE 8A,A50,084003,Miranda; Gregory Joseph,9,0,15,6
1649831161816,CSE 11,A01,084005,Miranda; Gregory Joseph,49,0,55,6
1649831167839,CSE 20,A01,084007,Staff,15,0,20,5
1649831173873,CSE 21,A01,084009,Staff,34,0,50,16
1649831179902,CSE 30,A01,083370,Cao; Yingjun,20,0,40,20
1649831185932,CSE 100,A01,083372,Cao; Yingjun,15,0,40,25
1649831191960,CSE 101,A01,084011,Staff,0,12,40,40
1649831198018,CSE 141,A01,083374,Eldon; John,0,10,75,75
1649831204045,CSE 141L,A01,083376,Eldon; John,0,13,75,75
1649831210072,CSE 175,A01,084013,Kumar; Rakesh,24,0,25,1
1649831216101,CSE 190,A00,092508,Staff,15,0,15,0
1649831222122,ECE 5,A01,084049,Morris; Karcher William,17,0,20,3
1649831228146,ECE 100,A01,084051,Baghdadchi; Saharnaz,16,0,20,4
1649831228146,ECE 100,A02,091916,Baghdadchi; Saharnaz,18,0,20,2
1649831234169,ECE 101,A01,084053,Baghdadchi; Saharnaz,25,0,37,12
1649831234169,ECE 101,A02,084054,Baghdadchi; Saharnaz,37,0,37,0
1649831240286,ECE 107,A01,083390,Staff,32,0,40,8
1649831246313,ECE 148,A01,084056,Silberman; Jack,8,0,12,4
1649831252337,ECE 180,A00,083391,Abi Samra; Nicholas Camill,27,0,30,3
1649831252337,ECE 180,B00,083392,Abi Samra; Nicholas Camill,26,0,30,4
1649831258363,MATH 10B,A01,084110,Staff,20,0,30,10
1649831258363,MATH 10B,A02,084111,Staff,29,0,30,1
1649831258363,MATH 10B,A03,084112,Staff,29,0,30,1
1649831264388,MATH 10C,A01,083443,Staff,19,0,30,11
1649831264388,MATH 10C,A02,083444,Staff,24,0,30,6
1649831264388,MATH 10C,B01,084114,Staff,26,0,30,4
1649831264388,MATH 10C,B02,084115,Staff,30,0,30,0
1649831270417,MATH 18,A01,084117,Harel; Guershon,28,0,30,2
1649831270417,MATH 18,A02,084119,Harel; Guershon,29,0,30,1
1649831270417,MATH 18,A03,084120,Harel; Guershon,30,0,30,0
1649831270417,MATH 18,A04,084121,Harel; Guershon,30,0,30,0
1649831276446,MATH 20B,A01,084124,Um; Ko Woon,33,0,35,2
1649831276446,MATH 20B,B01,084126,Um; Ko Woon,35,0,35,0
1649831282470,MATH 20C,A01,083446,Hammock; Frances H,27,0,30,3
1649831282470,MATH 20C,A02,083447,Hammock; Frances H,30,0,30,0
1649831282470,MATH 20C,A03,083448,Hammock; Frances H,30,0,30,0
1649831282470,MATH 20C,A04,083449,Hammock; Frances H,30,0,30,0
1649831282470,MATH 20C,B01,083451,Hammock; Frances H,29,0,30,1
1649831282470,MATH 20C,B02,083452,Hammock; Frances H,30,0,30,0
1649831282470,MATH 20C,B03,083453,Hammock; Frances H,30,0,30,0
1649831282470,MATH 20C,B04,083454,Hammock; Frances H,30,0,30,0
1649831288499,MATH 20D,A01,084128,Staff,29,0,30,1
1649831288499,MATH 20D,A02,084129,Staff,30,0,30,0
1649831288499,MATH 20D,A03,084130,Staff,29,0,30,1
1649831288499,MATH 20D,B01,084133,Staff,28,0,30,2
1649831288499,MATH 20D,B02,084134,Staff,30,0,30,0
1649831288499,MATH 20D,B03,084135,Staff,30,0,30,0
1649831294524,MATH 20E,A01,084138,Staff,28,0,30,2
1649831294524,MATH 20E,A02,084139,Staff,29,0,30,1
1649831294524,MATH 20E,A03,084140,Staff,28,0,30,2
1649831294524,MATH 20E,A04,084141,Staff,30,0,30,0
1649831300548,MATH 102,A01,084143,Harel; Guershon,24,0,30,6
1649831300548,MATH 102,A02,084144,Harel; Guershon,25,0,30,5
1649831306571,MATH 103B,A01,083456,Staff,0,0,30,30
1649831306571,MATH 103B,A02,083457,Staff,20,0,30,10
1649831312595,MATH 109,A01,084146,Salehi Golsefidy; Alireza,30,0,30,0
1649831312595,MATH 109,A02,084147,Salehi Golsefidy; Alireza,27,0,30,3
1649831318624,MATH 120A,A01,085445,Eggers; John Dietrich,31,0,35,4
1649831318624,MATH 120A,A02,085446,Eggers; John Dietrich,31,0,35,4
1649831324647,MATH 142B,A01,084149,Verstraete; Jacques Allan,7,0,30,23
1649831324647,MATH 142B,A02,084150,Verstraete; Jacques Allan,25,0,30,5
1649831330680,MATH 170A,A01,083459,Nie; Jiawang,9,0,30,21
1649831330680,MATH 170A,A02,083460,Nie; Jiawang,25,0,30,5
1649831330680,MATH 170A,A03,083461,Nie; Jiawang,26,0,30,4
1649831336710,MATH 193B,A01,083463,Staff,16,0,30,14
1649831336710,MATH 193B,A02,083464,Staff,19,0,30,11
1649831336710,MATH 193B,A03,083465,Staff,27,0,30,3
1649831342770,COGS 2,A01,083966,Boyle; Mary E. T.,27,0,30,3
1649831348795,COGS 9,A01,083968,Staff,57,0,60,3
1649831354822,COGS 14B,A01,083970,Staff,46,0,50,4
1649831360849,COGS 17,A01,092679,Staff,73,0,75,2
1649831366872,COGS 100,A01,083972,Staff,46,0,60,14
1649831378920,COGS 101C,A01,083976,Staff,25,0,30,5
1649831385023,COGS 102A,A01,083978,Johnson; Christine M.,24,0,30,6
1649831391045,COGS 107B,A01,083980,Staff,36,0,50,14
1649831397067,COGS 115,A01,083982,Staff,22,0,30,8
1649831403113,COGS 118B,A01,083367,Staff,5,0,40,35
1649831409135,COGS 172,A01,083984,Provenzano; Emily Kara,21,0,30,9
1649831415164,COGS 177,A00,083368,Staff,4,0,30,26
1649831421206,COGS 186,A01,083986,Staff,25,0,40,15
1649831427230,COGS 187A,A01,083988,Boyle; Mary E. T.,41,0,60,19
1649831433255,CSE 8A,A50,084003,Miranda; Gregory Joseph,9,0,15,6
1649831439285,CSE 11,A01,084005,Miranda; Gregory Joseph,49,0,55,6
1649831445312,CSE 20,A01,084007,Staff,15,0,20,5
1649831451338,CSE 21,A01,084009,Staff,34,0,50,16
1649831457361,CSE 30,A01,083370,Cao; Yingjun,20,0,40,20
1649831463385,CSE 100,A01,083372,Cao; Yingjun,15,0,40,25
1649831469412,CSE 101,A01,084011,Staff,0,12,40,40
1649831475435,CSE 141,A01,083374,Eldon; John,0,10,75,75
1649831481458,CSE 141L,A01,083376,Eldon; John,0,13,75,75
1649831487488,CSE 175,A01,084013,Kumar; Rakesh,24,0,25,1
1649831493511,CSE 190,A00,092508,Staff,15,0,15,0
1649831499534,ECE 5,A01,084049,Morris; Karcher William,17,0,20,3
1649831505561,ECE 100,A01,084051,Baghdadchi; Saharnaz,16,0,20,4
1649831505561,ECE 100,A02,091916,Baghdadchi; Saharnaz,18,0,20,2
1649831511586,ECE 101,A01,084053,Baghdadchi; Saharnaz,25,0,37,12
1649831511586,ECE 101,A02,084054,Baghdadchi; Saharnaz,37,0,37,0
1649831517610,ECE 107,A01,083390,Staff,32,0,40,8
1649831523633,ECE 148,A01,084056,Silberman; Jack,8,0,12,4
1649831529660,ECE 180,A00,083391,Abi Samra; Nicholas Camill,27,0,30,3
1649831529660,ECE 180,B00,083392,Abi Samra; Nicholas Camill,26,0,30,4
1649831535685,MATH 10B,A01,084110,Staff,20,0,30,10
1649831535685,MATH 10B,A02,084111,Staff,29,0,30,1
1649831535685,MATH 10B,A03,084112,Staff,29,0,30,1
1649831541709,MATH 10C,A01,083443,Staff,19,0,30,11
1649831541709,MATH 10C,A02,083444,Staff,24,0,30,6
1649831541709,MATH 10C,B01,084114,Staff,26,0,30,4
1649831541709,MATH 10C,B02,084115,Staff,30,0,30,0
1649831547734,MATH 18,A01,084117,Harel; Guershon,28,0,30,2
1649831547734,MATH 18,A02,084119,Harel; Guershon,29,0,30,1
1649831547734,MATH 18,A03,084120,Harel; Guershon,30,0,30,0
1649831547734,MATH 18,A04,084121,Harel; Guershon,30,0,30,0
1649831553757,MATH 20B,A01,084124,Um; Ko Woon,33,0,35,2
1649831553757,MATH 20B,B01,084126,Um; Ko Woon,35,0,35,0
1649831559802,MATH 20C,A01,083446,Hammock; Frances H,26,0,30,4
1649831559802,MATH 20C,A02,083447,Hammock; Frances H,30,0,30,0
1649831559802,MATH 20C,A03,083448,Hammock; Frances H,30,0,30,0
1649831559802,MATH 20C,A04,083449,Hammock; Frances H,30,0,30,0
1649831559802,MATH 20C,B01,083451,Hammock; Frances H,29,0,30,1
1649831559802,MATH 20C,B02,083452,Hammock; Frances H,30,0,30,0
1649831559802,MATH 20C,B03,083453,Hammock; Frances H,30,0,30,0
1649831559802,MATH 20C,B04,083454,Hammock; Frances H,30,0,30,0
1649831565825,MATH 20D,A01,084128,Staff,29,0,30,1
1649831565825,MATH 20D,A02,084129,Staff,30,0,30,0
1649831565825,MATH 20D,A03,084130,Staff,29,0,30,1
1649831565825,MATH 20D,B01,084133,Staff,28,0,30,2
1649831565825,MATH 20D,B02,084134,Staff,30,0,30,0
1649831565825,MATH 20D,B03,084135,Staff,30,0,30,0
1649831571848,MATH 20E,A01,084138,Staff,28,0,30,2
1649831571848,MATH 20E,A02,084139,Staff,29,0,30,1
1649831571848,MATH 20E,A03,084140,Staff,28,0,30,2
1649831571848,MATH 20E,A04,084141,Staff,30,0,30,0
1649831577882,MATH 102,A01,084143,Harel; Guershon,24,0,30,6
1649831577882,MATH 102,A02,084144,Harel; Guershon,25,0,30,5
1649831583911,MATH 103B,A01,083456,Staff,0,0,30,30
1649831583911,MATH 103B,A02,083457,Staff,20,0,30,10
1649831589947,MATH 109,A01,084146,Salehi Golsefidy; Alireza,30,0,30,0
1649831589947,MATH 109,A02,084147,Salehi Golsefidy; Alireza,27,0,30,3
1649831595974,MATH 120A,A01,085445,Eggers; John Dietrich,31,0,35,4
1649831595974,MATH 120A,A02,085446,Eggers; John Dietrich,31,0,35,4
1649831601999,MATH 142B,A01,084149,Verstraete; Jacques Allan,7,0,30,23
1649831601999,MATH 142B,A02,084150,Verstraete; Jacques Allan,25,0,30,5
1649831608022,MATH 170A,A01,083459,Nie; Jiawang,9,0,30,21
1649831608022,MATH 170A,A02,083460,Nie; Jiawang,25,0,30,5
1649831608022,MATH 170A,A03,083461,Nie; Jiawang,26,0,30,4
1649831614048,MATH 193B,A01,083463,Staff,16,0,30,14
1649831614048,MATH 193B,A02,083464,Staff,19,0,30,11
1649831614048,MATH 193B,A03,083465,Staff,27,0,30,3
1649831620126,COGS 2,A01,083966,Boyle; Mary E. T.,27,0,30,3
1649831626151,COGS 9,A01,083968,Staff,57,0,60,3
1649831632174,COGS 14B,A01,083970,Staff,46,0,50,4
1649831638197,COGS 17,A01,092679,Staff,73,0,75,2
1649831644222,COGS 100,A01,083972,Staff,46,0,60,14
1649831656282,COGS 101C,A01,083976,Staff,25,0,30,5
1649831662325,COGS 102A,A01,083978,Johnson; Christine M.,24,0,30,6
1649831668354,COGS 107B,A01,083980,Staff,36,0,50,14
1649831674382,COGS 115,A01,083982,Staff,22,0,30,8
1649831680407,COGS 118B,A01,083367,Staff,5,0,40,35
1649831686433,COGS 172,A01,083984,Provenzano; Emily Kara,21,0,30,9
1649831692457,COGS 177,A00,083368,Staff,4,0,30,26
1649831698482,COGS 186,A01,083986,Staff,25,0,40,15
1649831704506,COGS 187A,A01,083988,Boyle; Mary E. T.,41,0,60,19
1649831710534,CSE 8A,A50,084003,Miranda; Gregory Joseph,9,0,15,6
1649831716559,CSE 11,A01,084005,Miranda; Gregory Joseph,49,0,55,6
1649831722585,CSE 20,A01,084007,Staff,15,0,20,5
1649831728609,CSE 21,A01,084009,Staff,34,0,50,16
1649831734632,CSE 30,A01,083370,Cao; Yingjun,20,0,40,20
1649831740664,CSE 100,A01,083372,Cao; Yingjun,15,0,40,25
1649831746693,CSE 101,A01,084011,Staff,0,12,40,40
1649831752716,CSE 141,A01,083374,Eldon; John,0,11,75,75
1649831758742,CSE 141L,A01,083376,Eldon; John,0,14,75,75
1649831764765,CSE 175,A01,084013,Kumar; Rakesh,24,0,25,1
1649831770788,CSE 190,A00,092508,Staff,15,0,15,0
1649831776812,ECE 5,A01,084049,Morris; Karcher William,17,0,20,3
1649831782836,ECE 100,A01,084051,Baghdadchi; Saharnaz,16,0,20,4
1649831782836,ECE 100,A02,091916,Baghdadchi; Saharnaz,18,0,20,2
1649831788863,ECE 101,A01,084053,Baghdadchi; Saharnaz,25,0,37,12
1649831788863,ECE 101,A02,084054,Baghdadchi; Saharnaz,37,0,37,0
1649831794888,ECE 107,A01,083390,Staff,32,0,40,8
1649831800912,ECE 148,A01,084056,Silberman; Jack,8,0,12,4
1649831806936,ECE 180,A00,083391,Abi Samra; Nicholas Camill,27,0,30,3
1649831806936,ECE 180,B00,083392,Abi Samra; Nicholas Camill,26,0,30,4
1649831812962,MATH 10B,A01,084110,Staff,20,0,30,10
1649831812962,MATH 10B,A02,084111,Staff,29,0,30,1
1649831812962,MATH 10B,A03,084112,Staff,29,0,30,1
1649831818991,MATH 10C,A01,083443,Staff,19,0,30,11
1649831818991,MATH 10C,A02,083444,Staff,24,0,30,6
1649831818991,MATH 10C,B01,084114,Staff,26,0,30,4
1649831818991,MATH 10C,B02,084115,Staff,30,0,30,0
1649831825017,MATH 18,A01,084117,Harel; Guershon,28,0,30,2
1649831825017,MATH 18,A02,084119,Harel; Guershon,29,0,30,1
1649831825017,MATH 18,A03,084120,Harel; Guershon,30,0,30,0
1649831825017,MATH 18,A04,084121,Harel; Guershon,30,0,30,0
1649831831041,MATH 20B,A01,084124,Um; Ko Woon,33,0,35,2
1649831831041,MATH 20B,B01,084126,Um; Ko Woon,35,0,35,0
1649831837172,MATH 20C,A01,083446,Hammock; Frances H,26,0,30,4
1649831837172,MATH 20C,A02,083447,Hammock; Frances H,30,0,30,0
1649831837172,MATH 20C,A03,083448,Hammock; Frances H,30,0,30,0
1649831837172,MATH 20C,A04,083449,Hammock; Frances H,30,0,30,0
1649831837172,MATH 20C,B01,083451,Hammock; Frances H,29,0,30,1
1649831837172,MATH 20C,B02,083452,Hammock; Frances H,30,0,30,0
1649831837172,MATH 20C,B03,083453,Hammock; Frances H,30,0,30,0
1649831837172,MATH 20C,B04,083454,Hammock; Frances H,30,0,30,0
1649831843205,MATH 20D,A01,084128,Staff,29,0,30,1
1649831843205,MATH 20D,A02,084129,Staff,30,0,30,0
1649831843205,MATH 20D,A03,084130,Staff,29,0,30,1
1649831843205,MATH 20D,B01,084133,Staff,28,0,30,2
1649831843205,MATH 20D,B02,084134,Staff,30,0,30,0
1649831843205,MATH 20D,B03,084135,Staff,30,0,30,0
1649831849244,MATH 20E,A01,084138,Staff,28,0,30,2
1649831849244,MATH 20E,A02,084139,Staff,29,0,30,1
1649831849244,MATH 20E,A03,084140,Staff,28,0,30,2
1649831849244,MATH 20E,A04,084141,Staff,30,0,30,0
1649831855267,MATH 102,A01,084143,Harel; Guershon,24,0,30,6
1649831855267,MATH 102,A02,084144,Harel; Guershon,25,0,30,5
1649831861295,MATH 103B,A01,083456,Staff,0,0,30,30
1649831861295,MATH 103B,A02,083457,Staff,20,0,30,10
1649831867320,MATH 109,A01,084146,Salehi Golsefidy; Alireza,30,0,30,0
1649831867320,MATH 109,A02,084147,Salehi Golsefidy; Alireza,27,0,30,3
1649831873356,MATH 120A,A01,085445,Eggers; John Dietrich,31,0,35,4
1649831873356,MATH 120A,A02,085446,Eggers; John Dietrich,31,0,35,4
1649831879391,MATH 142B,A01,084149,Verstraete; Jacques Allan,7,0,30,23
1649831879391,MATH 142B,A02,084150,Verstraete; Jacques Allan,25,0,30,5
1649831885438,MATH 170A,A01,083459,Nie; Jiawang,9,0,30,21
1649831885438,MATH 170A,A02,083460,Nie; Jiawang,25,0,30,5
1649831885438,MATH 170A,A03,083461,Nie; Jiawang,26,0,30,4
1649831891489,MATH 193B,A01,083463,Staff,16,0,30,14
1649831891489,MATH 193B,A02,083464,Staff,19,0,30,11
1649831891489,MATH 193B,A03,083465,Staff,27,0,30,3
1649831897565,COGS 2,A01,083966,Boyle; Mary E. T.,27,0,30,3
1649831903591,COGS 9,A01,083968,Staff,57,0,60,3
1649831909628,COGS 14B,A01,083970,Staff,46,0,50,4
1649831915667,COGS 17,A01,092679,Staff,73,0,75,2
1649831921702,COGS 100,A01,083972,Staff,46,0,60,14
1649831933751,COGS 101C,A01,083976,Staff,25,0,30,5
1649831939777,COGS 102A,A01,083978,Johnson; Christine M.,24,0,30,6
1649831945812,COGS 107B,A01,083980,Staff,36,0,50,14
1649831951846,COGS 115,A01,083982,Staff,22,0,30,8
1649831957880,COGS 118B,A01,083367,Staff,5,0,40,35
1649831963904,COGS 172,A01,083984,Provenzano; Emily Kara,21,0,30,9
1649831969928,COGS 177,A00,083368,Staff,4,0,30,26
1649831975950,COGS 186,A01,083986,Staff,25,0,40,15
1649831981978,COGS 187A,A01,083988,Boyle; Mary E. T.,41,0,60,19
1649831988001,CSE 8A,A50,084003,Miranda; Gregory Joseph,9,0,15,6
1649831994026,CSE 11,A01,084005,Miranda; Gregory Joseph,49,0,55,6
1649832000050,CSE 20,A01,084007,Staff,15,0,20,5
1649832006078,CSE 21,A01,084009,Staff,34,0,50,16
1649832012105,CSE 30,A01,083370,Cao; Yingjun,20,0,40,20
1649832018133,CSE 100,A01,083372,Cao; Yingjun,14,0,40,26
1649832024162,CSE 101,A01,084011,Staff,0,12,40,40
1649832030186,CSE 141,A01,083374,Eldon; John,0,12,75,75
1649832036213,CSE 141L,A01,083376,Eldon; John,0,15,75,75
1649832042239,CSE 175,A01,084013,Kumar; Rakesh,24,0,25,1
1649832048263,CSE 190,A00,092508,Staff,15,0,15,0
1649832054289,ECE 5,A01,084049,Morris; Karcher William,17,0,20,3
1649832060316,ECE 100,A01,084051,Baghdadchi; Saharnaz,16,0,20,4
1649832060316,ECE 100,A02,091916,Baghdadchi; Saharnaz,18,0,20,2
1649832066351,ECE 101,A01,084053,Baghdadchi; Saharnaz,25,0,37,12
1649832066351,ECE 101,A02,084054,Baghdadchi; Saharnaz,37,0,37,0
1649832072378,ECE 107,A01,083390,Staff,32,0,40,8
1649832078402,ECE 148,A01,084056,Silberman; Jack,8,0,12,4
1649832084429,ECE 180,A00,083391,Abi Samra; Nicholas Camill,27,0,30,3
1649832084429,ECE 180,B00,083392,Abi Samra; Nicholas Camill,26,0,30,4
1649832090462,MATH 10B,A01,084110,Staff,20,0,30,10
1649832090462,MATH 10B,A02,084111,Staff,29,0,30,1
1649832090462,MATH 10B,A03,084112,Staff,29,0,30,1
1649832096488,MATH 10C,A01,083443,Staff,19,0,30,11
1649832096488,MATH 10C,A02,083444,Staff,24,0,30,6
1649832096488,MATH 10C,B01,084114,Staff,26,0,30,4
1649832096488,MATH 10C,B02,084115,Staff,30,0,30,0
1649832102523,MATH 18,A01,084117,Harel; Guershon,28,0,30,2
1649832102523,MATH 18,A02,084119,Harel; Guershon,29,0,30,1
1649832102523,MATH 18,A03,084120,Harel; Guershon,30,0,30,0
1649832102523,MATH 18,A04,084121,Harel; Guershon,30,0,30,0
1649832108548,MATH 20B,A01,084124,Um; Ko Woon,33,0,35,2
1649832108548,MATH 20B,B01,084126,Um; Ko Woon,35,0,35,0
1649832114585,MATH 20C,A01,083446,Hammock; Frances H,26,0,30,4
1649832114585,MATH 20C,A02,083447,Hammock; Frances H,30,0,30,0
1649832114585,MATH 20C,A03,083448,Hammock; Frances H,30,0,30,0
1649832114585,MATH 20C,A04,083449,Hammock; Frances H,30,0,30,0
1649832114585,MATH 20C,B01,083451,Hammock; Frances H,29,0,30,1
1649832114585,MATH 20C,B02,083452,Hammock; Frances H,30,0,30,0
1649832114585,MATH 20C,B03,083453,Hammock; Frances H,30,0,30,0
1649832114585,MATH 20C,B04,083454,Hammock; Frances H,30,0,30,0
1649832120611,MATH 20D,A01,084128,Staff,29,0,30,1
1649832120611,MATH 20D,A02,084129,Staff,30,0,30,0
1649832120611,MATH 20D,A03,084130,Staff,29,0,30,1
1649832120611,MATH 20D,B01,084133,Staff,28,0,30,2
1649832120611,MATH 20D,B02,084134,Staff,30,0,30,0
1649832120611,MATH 20D,B03,084135,Staff,30,0,30,0
1649832126643,MATH 20E,A01,084138,Staff,28,0,30,2
1649832126643,MATH 20E,A02,084139,Staff,29,0,30,1
1649832126643,MATH 20E,A03,084140,Staff,28,0,30,2
1649832126643,MATH 20E,A04,084141,Staff,30,0,30,0
1649832132671,MATH 102,A01,084143,Harel; Guershon,24,0,30,6
1649832132671,MATH 102,A02,084144,Harel; Guershon,25,0,30,5
1649832138697,MATH 103B,A01,083456,Staff,0,0,30,30
1649832138697,MATH 103B,A02,083457,Staff,20,0,30,10
1649832144729,MATH 109,A01,084146,Salehi Golsefidy; Alireza,30,0,30,0
1649832144729,MATH 109,A02,084147,Salehi Golsefidy; Alireza,27,0,30,3
1649832150757,MATH 120A,A01,085445,Eggers; John Dietrich,31,0,35,4
1649832150757,MATH 120A,A02,085446,Eggers; John Dietrich,31,0,35,4
1649832156785,MATH 142B,A01,084149,Verstraete; Jacques Allan,7,0,30,23
1649832156785,MATH 142B,A02,084150,Verstraete; Jacques Allan,25,0,30,5
1649832162812,MATH 170A,A01,083459,Nie; Jiawang,9,0,30,21
1649832162812,MATH 170A,A02,083460,Nie; Jiawang,25,0,30,5
1649832162812,MATH 170A,A03,083461,Nie; Jiawang,26,0,30,4
1649832168843,MATH 193B,A01,083463,Staff,16,0,30,14
1649832168843,MATH 193B,A02,083464,Staff,19,0,30,11
1649832168843,MATH 193B,A03,083465,Staff,27,0,30,3
1649832174897,COGS 2,A01,083966,Boyle; Mary E. T.,27,0,30,3
1649832180925,COGS 9,A01,083968,Staff,57,0,60,3
1649832186957,COGS 14B,A01,083970,Staff,46,0,50,4
1649832192984,COGS 17,A01,092679,Staff,73,0,75,2
1649832199011,COGS 100,A01,083972,Staff,46,0,60,14
1649832211063,COGS 101C,A01,083976,Staff,25,0,30,5
1649832217090,COGS 102A,A01,083978,Johnson; Christine M.,24,0,30,6
1649832223116,COGS 107B,A01,083980,Staff,36,0,50,14
1649832229139,COGS 115,A01,083982,Staff,22,0,30,8
1649832235178,COGS 118B,A01,083367,Staff,5,0,40,35
1649832241205,COGS 172,A01,083984,Provenzano; Emily Kara,21,0,30,9
1649832247229,COGS 177,A00,083368,Staff,4,0,30,26
1649832253257,COGS 186,A01,083986,Staff,25,0,40,15
1649832259280,COGS 187A,A01,083988,Boyle; Mary E. T.,41,0,60,19
1649832265309,CSE 8A,A50,084003,Miranda; Gregory Joseph,9,0,15,6
1649832271333,CSE 11,A01,084005,Miranda; Gregory Joseph,49,0,55,6
1649832277357,CSE 20,A01,084007,Staff,15,0,20,5
1649832283391,CSE 21,A01,084009,Staff,34,0,50,16
1649832289420,CSE 30,A01,083370,Cao; Yingjun,20,0,40,20
1649832295445,CSE 100,A01,083372,Cao; Yingjun,14,0,40,26
1649832301467,CSE 101,A01,084011,Staff,0,12,40,40
1649832307495,CSE 141,A01,083374,Eldon; John,0,12,75,75
1649832313519,CSE 141L,A01,083376,Eldon; John,0,15,75,75
1649832319542,CSE 175,A01,084013,Kumar; Rakesh,24,0,25,1
1649832325571,CSE 190,A00,092508,Staff,15,0,15,0
1649832331594,ECE 5,A01,084049,Morris; Karcher William,17,0,20,3
1649832337622,ECE 100,A01,084051,Baghdadchi; Saharnaz,16,0,20,4
1649832337622,ECE 100,A02,091916,Baghdadchi; Saharnaz,18,0,20,2
1649832343645,ECE 101,A01,084053,Baghdadchi; Saharnaz,25,0,37,12
1649832343645,ECE 101,A02,084054,Baghdadchi; Saharnaz,37,0,37,0
1649832349670,ECE 107,A01,083390,Staff,32,0,40,8
1649832355703,ECE 148,A01,084056,Silberman; Jack,8,0,12,4
1649832361726,ECE 180,A00,083391,Abi Samra; Nicholas Camill,27,0,30,3
1649832361726,ECE 180,B00,083392,Abi Samra; Nicholas Camill,26,0,30,4
1649832367755,MATH 10B,A01,084110,Staff,20,0,30,10
1649832367755,MATH 10B,A02,084111,Staff,29,0,30,1
1649832367755,MATH 10B,A03,084112,Staff,29,0,30,1
1649832373788,MATH 10C,A01,083443,Staff,19,0,30,11
1649832373788,MATH 10C,A02,083444,Staff,24,0,30,6
1649832373788,MATH 10C,B01,084114,Staff,26,0,30,4
1649832373788,MATH 10C,B02,084115,Staff,30,0,30,0
1649832379816,MATH 18,A01,084117,Harel; Guershon,28,0,30,2
1649832379816,MATH 18,A02,084119,Harel; Guershon,29,0,30,1
1649832379816,MATH 18,A03,084120,Harel; Guershon,30,0,30,0
1649832379816,MATH 18,A04,084121,Harel; Guershon,30,0,30,0
1649832385841,MATH 20B,A01,084124,Um; Ko Woon,33,0,35,2
1649832385841,MATH 20B,B01,084126,Um; Ko Woon,35,0,35,0
1649832391867,MATH 20C,A01,083446,Hammock; Frances H,26,0,30,4
1649832391867,MATH 20C,A02,083447,Hammock; Frances H,30,0,30,0
1649832391867,MATH 20C,A03,083448,Hammock; Frances H,30,0,30,0
1649832391867,MATH 20C,A04,083449,Hammock; Frances H,30,0,30,0
1649832391867,MATH 20C,B01,083451,Hammock; Frances H,29,0,30,1
1649832391867,MATH 20C,B02,083452,Hammock; Frances H,30,0,30,0
1649832391867,MATH 20C,B03,083453,Hammock; Frances H,30,0,30,0
1649832391867,MATH 20C,B04,083454,Hammock; Frances H,30,0,30,0
1649832397896,MATH 20D,A01,084128,Staff,29,0,30,1
1649832397896,MATH 20D,A02,084129,Staff,30,0,30,0
1649832397896,MATH 20D,A03,084130,Staff,29,0,30,1
1649832397896,MATH 20D,B01,084133,Staff,28,0,30,2
1649832397896,MATH 20D,B02,084134,Staff,30,0,30,0
1649832397896,MATH 20D,B03,084135,Staff,30,0,30,0
1649832403922,MATH 20E,A01,084138,Staff,28,0,30,2
1649832403922,MATH 20E,A02,084139,Staff,29,0,30,1
1649832403922,MATH 20E,A03,084140,Staff,28,0,30,2
1649832403922,MATH 20E,A04,084141,Staff,30,0,30,0
1649832409946,MATH 102,A01,084143,Harel; Guershon,24,0,30,6
1649832409946,MATH 102,A02,084144,Harel; Guershon,25,0,30,5
1649832415989,MATH 103B,A01,083456,Staff,0,0,30,30
1649832415989,MATH 103B,A02,083457,Staff,20,0,30,10
1649832422022,MATH 109,A01,084146,Salehi Golsefidy; Alireza,30,0,30,0
1649832422022,MATH 109,A02,084147,Salehi Golsefidy; Alireza,27,0,30,3
1649832428046,MATH 120A,A01,085445,Eggers; John Dietrich,31,0,35,4
1649832428046,MATH 120A,A02,085446,Eggers; John Dietrich,31,0,35,4
1649832434208,MATH 142B,A01,084149,Verstraete; Jacques Allan,7,0,30,23
1649832434208,MATH 142B,A02,084150,Verstraete; Jacques Allan,25,0,30,5
1649832440231,MATH 170A,A01,083459,Nie; Jiawang,9,0,30,21
1649832440231,MATH 170A,A02,083460,Nie; Jiawang,25,0,30,5
1649832440231,MATH 170A,A03,083461,Nie; Jiawang,26,0,30,4
1649832446256,MATH 193B,A01,083463,Staff,16,0,30,14
1649832446256,MATH 193B,A02,083464,Staff,19,0,30,11
1649832446256,MATH 193B,A03,083465,Staff,27,0,30,3
1649832452316,COGS 2,A01,083966,Boyle; Mary E. T.,27,0,30,3
1649832458344,COGS 9,A01,083968,Staff,57,0,60,3
1649832464367,COGS 14B,A01,083970,Staff,46,0,50,4
1649832470389,COGS 17,A01,092679,Staff,73,0,75,2
1649832476413,COGS 100,A01,083972,Staff,46,0,60,14
1649832488466,COGS 101C,A01,083976,Staff,25,0,30,5
1649832494493,COGS 102A,A01,083978,Johnson; Christine M.,24,0,30,6
1649832500516,COGS 107B,A01,083980,Staff,36,0,50,14
1649832506541,COGS 115,A01,083982,Staff,22,0,30,8
1649832512565,COGS 118B,A01,083367,Staff,5,0,40,35
1649832518588,COGS 172,A01,083984,Provenzano; Emily Kara,21,0,30,9
1649832524611,COGS 177,A00,083368,Staff,4,0,30,26
1649832530639,COGS 186,A01,083986,Staff,25,0,40,15
1649832536666,COGS 187A,A01,083988,Boyle; Mary E. T.,41,0,60,19
1649832542691,CSE 8A,A50,084003,Miranda; Gregory Joseph,9,0,15,6
1649832548717,CSE 11,A01,084005,Miranda; Gregory Joseph,49,0,55,6
1649832554746,CSE 20,A01,084007,Staff,15,0,20,5
1649832560769,CSE 21,A01,084009,Staff,34,0,50,16
1649832566801,CSE 30,A01,083370,Cao; Yingjun,20,0,40,20
1649832572827,CSE 100,A01,083372,Cao; Yingjun,14,0,40,26
1649832578850,CSE 101,A01,084011,Staff,0,12,40,40
1649832584873,CSE 141,A01,083374,Eldon; John,0,12,75,75
1649832590896,CSE 141L,A01,083376,Eldon; John,0,15,75,75
1649832596919,CSE 175,A01,084013,Kumar; Rakesh,24,0,25,1
1649832602943,CSE 190,A00,092508,Staff,15,0,15,0
1649832608969,ECE 5,A01,084049,Morris; Karcher William,17,0,20,3
1649832614993,ECE 100,A01,084051,Baghdadchi; Saharnaz,16,0,20,4
1649832614993,ECE 100,A02,091916,Baghdadchi; Saharnaz,18,0,20,2
1649832621020,ECE 101,A01,084053,Baghdadchi; Saharnaz,25,0,37,12
1649832621020,ECE 101,A02,084054,Baghdadchi; Saharnaz,37,0,37,0
1649832627047,ECE 107,A01,083390,Staff,32,0,40,8
1649832633073,ECE 148,A01,084056,Silberman; Jack,8,0,12,4
1649832639097,ECE 180,A00,083391,Abi Samra; Nicholas Camill,27,0,30,3
1649832639097,ECE 180,B00,083392,Abi Samra; Nicholas Camill,26,0,30,4
1649832645125,MATH 10B,A01,084110,Staff,20,0,30,10
1649832645125,MATH 10B,A02,084111,Staff,29,0,30,1
1649832645125,MATH 10B,A03,084112,Staff,29,0,30,1
1649832651150,MATH 10C,A01,083443,Staff,19,0,30,11
1649832651150,MATH 10C,A02,083444,Staff,24,0,30,6
1649832651150,MATH 10C,B01,084114,Staff,26,0,30,4
1649832651150,MATH 10C,B02,084115,Staff,30,0,30,0
1649832657175,MATH 18,A01,084117,Harel; Guershon,28,0,30,2
1649832657175,MATH 18,A02,084119,Harel; Guershon,29,0,30,1
1649832657175,MATH 18,A03,084120,Harel; Guershon,30,0,30,0
1649832657175,MATH 18,A04,084121,Harel; Guershon,30,0,30,0
1649832663204,MATH 20B,A01,084124,Um; Ko Woon,33,0,35,2
1649832663204,MATH 20B,B01,084126,Um; Ko Woon,35,0,35,0
1649832669233,MATH 20C,A01,083446,Hammock; Frances H,26,0,30,4
1649832669233,MATH 20C,A02,083447,Hammock; Frances H,30,0,30,0
1649832669233,MATH 20C,A03,083448,Hammock; Frances H,30,0,30,0
1649832669233,MATH 20C,A04,083449,Hammock; Frances H,30,0,30,0
1649832669233,MATH 20C,B01,083451,Hammock; Frances H,29,0,30,1
1649832669233,MATH 20C,B02,083452,Hammock; Frances H,30,0,30,0
1649832669233,MATH 20C,B03,083453,Hammock; Frances H,30,0,30,0
1649832669233,MATH 20C,B04,083454,Hammock; Frances H,30,0,30,0
1649832675258,MATH 20D,A01,084128,Staff,29,0,30,1
1649832675258,MATH 20D,A02,084129,Staff,30,0,30,0
1649832675258,MATH 20D,A03,084130,Staff,29,0,30,1
1649832675258,MATH 20D,B01,084133,Staff,28,0,30,2
1649832675258,MATH 20D,B02,084134,Staff,30,0,30,0
1649832675258,MATH 20D,B03,084135,Staff,30,0,30,0
1649832681281,MATH 20E,A01,084138,Staff,28,0,30,2
1649832681281,MATH 20E,A02,084139,Staff,29,0,30,1
1649832681281,MATH 20E,A03,084140,Staff,28,0,30,2
1649832681281,MATH 20E,A04,084141,Staff,30,0,30,0
1649832687312,MATH 102,A01,084143,Harel; Guershon,24,0,30,6
1649832687312,MATH 102,A02,084144,Harel; Guershon,25,0,30,5
1649832693337,MATH 103B,A01,083456,Staff,0,0,30,30
1649832693337,MATH 103B,A02,083457,Staff,20,0,30,10
1649832699364,MATH 109,A01,084146,Salehi Golsefidy; Alireza,30,0,30,0
1649832699364,MATH 109,A02,084147,Salehi Golsefidy; Alireza,27,0,30,3
1649832705389,MATH 120A,A01,085445,Eggers; John Dietrich,31,0,35,4
1649832705389,MATH 120A,A02,085446,Eggers; John Dietrich,31,0,35,4
1649832711415,MATH 142B,A01,084149,Verstraete; Jacques Allan,7,0,30,23
1649832711415,MATH 142B,A02,084150,Verstraete; Jacques Allan,25,0,30,5
1649832717438,MATH 170A,A01,083459,Nie; Jiawang,9,0,30,21
1649832717438,MATH 170A,A02,083460,Nie; Jiawang,25,0,30,5
1649832717438,MATH 170A,A03,083461,Nie; Jiawang,26,0,30,4
1649832723464,MATH 193B,A01,083463,Staff,16,0,30,14
1649832723464,MATH 193B,A02,083464,Staff,19,0,30,11
1649832723464,MATH 193B,A03,083465,Staff,27,0,30,3
1649832729516,COGS 2,A01,083966,Boyle; Mary E. T.,27,0,30,3
1649832735540,COGS 9,A01,083968,Staff,57,0,60,3
1649832741563,COGS 14B,A01,083970,Staff,46,0,50,4
1649832747589,COGS 17,A01,092679,Staff,73,0,75,2
1649832753617,COGS 100,A01,083972,Staff,46,0,60,14
1649832765665,COGS 101C,A01,083976,Staff,25,0,30,5
1649832771688,COGS 102A,A01,083978,Johnson; Christine M.,24,0,30,6
1649832777715,COGS 107B,A01,083980,Staff,36,0,50,14
1649832783742,COGS 115,A01,083982,Staff,22,0,30,8
1649832789765,COGS 118B,A01,083367,Staff,5,0,40,35
1649832795792,COGS 172,A01,083984,Provenzano; Emily Kara,21,0,30,9
1649832801819,COGS 177,A00,083368,Staff,4,0,30,26
1649832807842,COGS 186,A01,083986,Staff,25,0,40,15
1649832813865,COGS 187A,A01,083988,Boyle; Mary E. T.,41,0,60,19
1649832819889,CSE 8A,A50,084003,Miranda; Gregory Joseph,9,0,15,6
1649832825917,CSE 11,A01,084005,Miranda; Gregory Joseph,49,0,55,6
1649832831945,CSE 20,A01,084007,Staff,15,0,20,5
1649832837972,CSE 21,A01,084009,Staff,34,0,50,16
1649832843999,CSE 30,A01,083370,Cao; Yingjun,20,0,40,20
1649832850025,CSE 100,A01,083372,Cao; Yingjun,14,0,40,26
1649832856049,CSE 101,A01,084011,Staff,0,12,40,40
1649832862072,CSE 141,A01,083374,Eldon; John,0,12,75,75
1649832868096,CSE 141L,A01,083376,Eldon; John,0,15,75,75
1649832874119,CSE 175,A01,084013,Kumar; Rakesh,24,0,25,1
1649832880142,CSE 190,A00,092508,Staff,15,0,15,0
1649832886165,ECE 5,A01,084049,Morris; Karcher William,17,0,20,3
1649832892188,ECE 100,A01,084051,Baghdadchi; Saharnaz,16,0,20,4
1649832892188,ECE 100,A02,091916,Baghdadchi; Saharnaz,18,0,20,2
1649832898210,ECE 101,A01,084053,Baghdadchi; Saharnaz,25,0,37,12
1649832898210,ECE 101,A02,084054,Baghdadchi; Saharnaz,37,0,37,0
1649832904241,ECE 107,A01,083390,Staff,32,0,40,8
1649832910264,ECE 148,A01,084056,Silberman; Jack,8,0,12,4
1649832916290,ECE 180,A00,083391,Abi Samra; Nicholas Camill,27,0,30,3
1649832916290,ECE 180,B00,083392,Abi Samra; Nicholas Camill,26,0,30,4
1649832922317,MATH 10B,A01,084110,Staff,20,0,30,10
1649832922317,MATH 10B,A02,084111,Staff,29,0,30,1
1649832922317,MATH 10B,A03,084112,Staff,29,0,30,1
1649832928345,MATH 10C,A01,083443,Staff,19,0,30,11
1649832928345,MATH 10C,A02,083444,Staff,24,0,30,6
1649832928345,MATH 10C,B01,084114,Staff,26,0,30,4
1649832928345,MATH 10C,B02,084115,Staff,30,0,30,0
1649832934372,MATH 18,A01,084117,Harel; Guershon,28,0,30,2
1649832934372,MATH 18,A02,084119,Harel; Guershon,29,0,30,1
1649832934372,MATH 18,A03,084120,Harel; Guershon,30,0,30,0
1649832934372,MATH 18,A04,084121,Harel; Guershon,30,0,30,0
1649832940397,MATH 20B,A01,084124,Um; Ko Woon,33,0,35,2
1649832940397,MATH 20B,B01,084126,Um; Ko Woon,35,0,35,0
1649832946427,MATH 20C,A01,083446,Hammock; Frances H,26,0,30,4
1649832946427,MATH 20C,A02,083447,Hammock; Frances H,30,0,30,0
1649832946427,MATH 20C,A03,083448,Hammock; Frances H,30,0,30,0
1649832946427,MATH 20C,A04,083449,Hammock; Frances H,30,0,30,0
1649832946427,MATH 20C,B01,083451,Hammock; Frances H,29,0,30,1
1649832946427,MATH 20C,B02,083452,Hammock; Frances H,30,0,30,0
1649832946427,MATH 20C,B03,083453,Hammock; Frances H,30,0,30,0
1649832946427,MATH 20C,B04,083454,Hammock; Frances H,30,0,30,0
1649832952450,MATH 20D,A01,084128,Staff,29,0,30,1
1649832952450,MATH 20D,A02,084129,Staff,30,0,30,0
1649832952450,MATH 20D,A03,084130,Staff,29,0,30,1
1649832952450,MATH 20D,B01,084133,Staff,28,0,30,2
1649832952450,MATH 20D,B02,084134,Staff,30,0,30,0
1649832952450,MATH 20D,B03,084135,Staff,30,0,30,0
1649832958482,MATH 20E,A01,084138,Staff,28,0,30,2
1649832958482,MATH 20E,A02,084139,Staff,29,0,30,1
1649832958482,MATH 20E,A03,084140,Staff,28,0,30,2
1649832958482,MATH 20E,A04,084141,Staff,30,0,30,0
1649832964506,MATH 102,A01,084143,Harel; Guershon,24,0,30,6
1649832964506,MATH 102,A02,084144,Harel; Guershon,25,0,30,5
1649832970541,MATH 103B,A01,083456,Staff,0,0,30,30
1649832970541,MATH 103B,A02,083457,Staff,20,0,30,10
1649832976573,MATH 109,A01,084146,Salehi Golsefidy; Alireza,30,0,30,0
1649832976573,MATH 109,A02,084147,Salehi Golsefidy; Alireza,27,0,30,3
1649832982600,MATH 120A,A01,085445,Eggers; John Dietrich,31,0,35,4
1649832982600,MATH 120A,A02,085446,Eggers; John Dietrich,31,0,35,4
1649832988622,MATH 142B,A01,084149,Verstraete; Jacques Allan,7,0,30,23
1649832988622,MATH 142B,A02,084150,Verstraete; Jacques Allan,25,0,30,5
1649832994649,MATH 170A,A01,083459,Nie; Jiawang,9,0,30,21
1649832994649,MATH 170A,A02,083460,Nie; Jiawang,25,0,30,5
1649832994649,MATH 170A,A03,083461,Nie; Jiawang,26,0,30,4
1649833000675,MATH 193B,A01,083463,Staff,16,0,30,14
1649833000675,MATH 193B,A02,083464,Staff,19,0,30,11
1649833000675,MATH 193B,A03,083465,Staff,27,0,30,3
1649833006794,COGS 2,A01,083966,Boyle; Mary E. T.,27,0,30,3
1649833012818,COGS 9,A01,083968,Staff,57,0,60,3
1649833018840,COGS 14B,A01,083970,Staff,46,0,50,4
1649833024960,COGS 17,A01,092679,Staff,73,0,75,2
1649833030983,COGS 100,A01,083972,Staff,46,0,60,14
1649833043029,COGS 101C,A01,083976,Staff,25,0,30,5
1649833049053,COGS 102A,A01,083978,Johnson; Christine M.,24,0,30,6
1649833055075,COGS 107B,A01,083980,Staff,35,0,50,15
1649833061098,COGS 115,A01,083982,Staff,22,0,30,8
1649833067123,COGS 118B,A01,083367,Staff,5,0,40,35
1649833073149,COGS 172,A01,083984,Provenzano; Emily Kara,21,0,30,9
1649833079174,COGS 177,A00,083368,Staff,4,0,30,26
1649833085201,COGS 186,A01,083986,Staff,25,0,40,15
1649833091229,COGS 187A,A01,083988,Boyle; Mary E. T.,41,0,60,19
1649833097255,CSE 8A,A50,084003,Miranda; Gregory Joseph,9,0,15,6
1649833103279,CSE 11,A01,084005,Miranda; Gregory Joseph,49,0,55,6
1649833109301,CSE 20,A01,084007,Staff,15,0,20,5
1649833115325,CSE 21,A01,084009,Staff,34,0,50,16
1649833121351,CSE 30,A01,083370,Cao; Yingjun,20,0,40,20
1649833127375,CSE 100,A01,083372,Cao; Yingjun,14,0,40,26
1649833133401,CSE 101,A01,084011,Staff,0,12,40,40
1649833139426,CSE 141,A01,083374,Eldon; John,0,12,75,75
1649833145453,CSE 141L,A01,083376,Eldon; John,0,15,75,75
1649833151480,CSE 175,A01,084013,Kumar; Rakesh,24,0,25,1
1649833157503,CSE 190,A00,092508,Staff,15,0,15,0
1649833163527,ECE 5,A01,084049,Morris; Karcher William,17,0,20,3
1649833169551,ECE 100,A01,084051,Baghdadchi; Saharnaz,16,0,20,4
1649833169551,ECE 100,A02,091916,Baghdadchi; Saharnaz,18,0,20,2
1649833175572,ECE 101,A01,084053,Baghdadchi; Saharnaz,25,0,37,12
1649833175572,ECE 101,A02,084054,Baghdadchi; Saharnaz,37,0,37,0
1649833181595,ECE 107,A01,083390,Staff,32,0,40,8
1649833187622,ECE 148,A01,084056,Silberman; Jack,8,0,12,4
1649833193647,ECE 180,A00,083391,Abi Samra; Nicholas Camill,27,0,30,3
1649833193647,ECE 180,B00,083392,Abi Samra; Nicholas Camill,26,0,30,4
1649833199682,MATH 10B,A01,084110,Staff,20,0,30,10
1649833199682,MATH 10B,A02,084111,Staff,29,0,30,1
1649833199682,MATH 10B,A03,084112,Staff,29,0,30,1
1649833205705,MATH 10C,A01,083443,Staff,19,0,30,11
1649833205705,MATH 10C,A02,083444,Staff,24,0,30,6
1649833205705,MATH 10C,B01,084114,Staff,26,0,30,4
1649833205705,MATH 10C,B02,084115,Staff,30,0,30,0
1649833211728,MATH 18,A01,084117,Harel; Guershon,28,0,30,2
1649833211728,MATH 18,A02,084119,Harel; Guershon,29,0,30,1
1649833211728,MATH 18,A03,084120,Harel; Guershon,30,0,30,0
1649833211728,MATH 18,A04,084121,Harel; Guershon,30,0,30,0
1649833217757,MATH 20B,A01,084124,Um; Ko Woon,33,0,35,2
1649833217757,MATH 20B,B01,084126,Um; Ko Woon,35,0,35,0
1649833223785,MATH 20C,A01,083446,Hammock; Frances H,26,0,30,4
1649833223785,MATH 20C,A02,083447,Hammock; Frances H,30,0,30,0
1649833223785,MATH 20C,A03,083448,Hammock; Frances H,30,0,30,0
1649833223785,MATH 20C,A04,083449,Hammock; Frances H,30,0,30,0
1649833223785,MATH 20C,B01,083451,Hammock; Frances H,29,0,30,1
1649833223785,MATH 20C,B02,083452,Hammock; Frances H,30,0,30,0
1649833223785,MATH 20C,B03,083453,Hammock; Frances H,30,0,30,0
1649833223785,MATH 20C,B04,083454,Hammock; Frances H,30,0,30,0
1649833229826,MATH 20D,A01,084128,Staff,29,0,30,1
1649833229826,MATH 20D,A02,084129,Staff,30,0,30,0
1649833229826,MATH 20D,A03,084130,Staff,29,0,30,1
1649833229826,MATH 20D,B01,084133,Staff,28,0,30,2
1649833229826,MATH 20D,B02,084134,Staff,30,0,30,0
1649833229826,MATH 20D,B03,084135,Staff,30,0,30,0
1649833235851,MATH 20E,A01,084138,Staff,28,0,30,2
1649833235851,MATH 20E,A02,084139,Staff,29,0,30,1
1649833235851,MATH 20E,A03,084140,Staff,28,0,30,2
1649833235851,MATH 20E,A04,084141,Staff,30,0,30,0
1649833241878,MATH 102,A01,084143,Harel; Guershon,24,0,30,6
1649833241878,MATH 102,A02,084144,Harel; Guershon,25,0,30,5
1649833247906,MATH 103B,A01,083456,Staff,0,0,30,30
1649833247906,MATH 103B,A02,083457,Staff,20,0,30,10
1649833253932,MATH 109,A01,084146,Salehi Golsefidy; Alireza,30,0,30,0
1649833253932,MATH 109,A02,084147,Salehi Golsefidy; Alireza,27,0,30,3
1649833259962,MATH 120A,A01,085445,Eggers; John Dietrich,31,0,35,4
1649833259962,MATH 120A,A02,085446,Eggers; John Dietrich,31,0,35,4
1649833265988,MATH 142B,A01,084149,Verstraete; Jacques Allan,7,0,30,23
1649833265988,MATH 142B,A02,084150,Verstraete; Jacques Allan,25,0,30,5
1649833272011,MATH 170A,A01,083459,Nie; Jiawang,9,0,30,21
1649833272011,MATH 170A,A02,083460,Nie; Jiawang,25,0,30,5
1649833272011,MATH 170A,A03,083461,Nie; Jiawang,26,0,30,4
1649833278035,MATH 193B,A01,083463,Staff,16,0,30,14
1649833278035,MATH 193B,A02,083464,Staff,19,0,30,11
1649833278035,MATH 193B,A03,083465,Staff,27,0,30,3
1649833284098,COGS 2,A01,083966,Boyle; Mary E. T.,27,0,30,3
1649833290122,COGS 9,A01,083968,Staff,57,0,60,3
1649833296146,COGS 14B,A01,083970,Staff,46,0,50,4
1649833302175,COGS 17,A01,092679,Staff,73,0,75,2
1649833308199,COGS 100,A01,083972,Staff,46,0,60,14
1649833320252,COGS 101C,A01,083976,Staff,25,0,30,5
1649833326284,COGS 102A,A01,083978,Johnson; Christine M.,24,0,30,6
1649833332311,COGS 107B,A01,083980,Staff,34,0,50,16
1649833338335,COGS 115,A01,083982,Staff,22,0,30,8
1649833344362,COGS 118B,A01,083367,Staff,5,0,40,35
1649833350396,COGS 172,A01,083984,Provenzano; Emily Kara,21,0,30,9
1649833356425,COGS 177,A00,083368,Staff,4,0,30,26
1649833362449,COGS 186,A01,083986,Staff,25,0,40,15
1649833368485,COGS 187A,A01,083988,Boyle; Mary E. T.,41,0,60,19
1649833374512,CSE 8A,A50,084003,Miranda; Gregory Joseph,9,0,15,6
1649833380536,CSE 11,A01,084005,Miranda; Gregory Joseph,49,0,55,6
1649833386565,CSE 20,A01,084007,Staff,15,0,20,5
1649833392597,CSE 21,A01,084009,Staff,34,0,50,16
1649833398632,CSE 30,A01,083370,Cao; Yingjun,20,0,40,20
1649833404663,CSE 100,A01,083372,Cao; Yingjun,14,0,40,26
1649833410694,CSE 101,A01,084011,Staff,0,12,40,40
1649833416724,CSE 141,A01,083374,Eldon; John,0,12,75,75
1649833422751,CSE 141L,A01,083376,Eldon; John,0,15,75,75
1649833428781,CSE 175,A01,084013,Kumar; Rakesh,24,0,25,1
1649833434805,CSE 190,A00,092508,Staff,15,0,15,0
1649833440837,ECE 5,A01,084049,Morris; Karcher William,17,0,20,3
1649833446863,ECE 100,A01,084051,Baghdadchi; Saharnaz,16,0,20,4
1649833446863,ECE 100,A02,091916,Baghdadchi; Saharnaz,18,0,20,2
1649833452892,ECE 101,A01,084053,Baghdadchi; Saharnaz,25,0,37,12
1649833452892,ECE 101,A02,084054,Baghdadchi; Saharnaz,37,0,37,0
1649833458917,ECE 107,A01,083390,Staff,32,0,40,8
1649833464946,ECE 148,A01,084056,Silberman; Jack,8,0,12,4
1649833470975,ECE 180,A00,083391,Abi Samra; Nicholas Camill,27,0,30,3
1649833470975,ECE 180,B00,083392,Abi Samra; Nicholas Camill,26,0,30,4
1649833477000,MATH 10B,A01,084110,Staff,20,0,30,10
1649833477000,MATH 10B,A02,084111,Staff,29,0,30,1
1649833477000,MATH 10B,A03,084112,Staff,29,0,30,1
1649833483030,MATH 10C,A01,083443,Staff,19,0,30,11
1649833483030,MATH 10C,A02,083444,Staff,24,0,30,6
1649833483030,MATH 10C,B01,084114,Staff,26,0,30,4
1649833483030,MATH 10C,B02,084115,Staff,30,0,30,0
1649833489055,MATH 18,A01,084117,Harel; Guershon,28,0,30,2
1649833489055,MATH 18,A02,084119,Harel; Guershon,29,0,30,1
1649833489055,MATH 18,A03,084120,Harel; Guershon,30,0,30,0
1649833489055,MATH 18,A04,084121,Harel; Guershon,30,0,30,0
1649833495079,MATH 20B,A01,084124,Um; Ko Woon,33,0,35,2
1649833495079,MATH 20B,B01,084126,Um; Ko Woon,35,0,35,0
1649833501115,MATH 20C,A01,083446,Hammock; Frances H,26,0,30,4
1649833501115,MATH 20C,A02,083447,Hammock; Frances H,30,0,30,0
1649833501115,MATH 20C,A03,083448,Hammock; Frances H,30,0,30,0
1649833501115,MATH 20C,A04,083449,Hammock; Frances H,30,0,30,0
1649833501115,MATH 20C,B01,083451,Hammock; Frances H,29,0,30,1
1649833501115,MATH 20C,B02,083452,Hammock; Frances H,30,0,30,0
1649833501115,MATH 20C,B03,083453,Hammock; Frances H,30,0,30,0
1649833501115,MATH 20C,B04,083454,Hammock; Frances H,30,0,30,0
1649833507141,MATH 20D,A01,084128,Staff,29,0,30,1
1649833507141,MATH 20D,A02,084129,Staff,30,0,30,0
1649833507141,MATH 20D,A03,084130,Staff,29,0,30,1
1649833507141,MATH 20D,B01,084133,Staff,28,0,30,2
1649833507141,MATH 20D,B02,084134,Staff,30,0,30,0
1649833507141,MATH 20D,B03,084135,Staff,30,0,30,0
1649833513168,MATH 20E,A01,084138,Staff,28,0,30,2
1649833513168,MATH 20E,A02,084139,Staff,29,0,30,1
1649833513168,MATH 20E,A03,084140,Staff,28,0,30,2
1649833513168,MATH 20E,A04,084141,Staff,30,0,30,0
1649833519193,MATH 102,A01,084143,Harel; Guershon,24,0,30,6
1649833519193,MATH 102,A02,084144,Harel; Guershon,25,0,30,5
1649833525218,MATH 103B,A01,083456,Staff,0,0,30,30
1649833525218,MATH 103B,A02,083457,Staff,20,0,30,10
1649833531250,MATH 109,A01,084146,Salehi Golsefidy; Alireza,30,0,30,0
1649833531250,MATH 109,A02,084147,Salehi Golsefidy; Alireza,27,0,30,3
1649833537274,MATH 120A,A01,085445,Eggers; John Dietrich,31,0,35,4
1649833537274,MATH 120A,A02,085446,Eggers; John Dietrich,31,0,35,4
1649833543311,MATH 142B,A01,084149,Verstraete; Jacques Allan,7,0,30,23
1649833543311,MATH 142B,A02,084150,Verstraete; Jacques Allan,25,0,30,5
1649833549338,MATH 170A,A01,083459,Nie; Jiawang,9,0,30,21
1649833549338,MATH 170A,A02,083460,Nie; Jiawang,25,0,30,5
1649833549338,MATH 170A,A03,083461,Nie; Jiawang,26,0,30,4
1649833555366,MATH 193B,A01,083463,Staff,16,0,30,14
1649833555366,MATH 193B,A02,083464,Staff,19,0,30,11
1649833555366,MATH 193B,A03,083465,Staff,27,0,30,3
1649833561429,COGS 2,A01,083966,Boyle; Mary E. T.,27,0,30,3
1649833567452,COGS 9,A01,083968,Staff,56,0,60,4
1649833573477,COGS 14B,A01,083970,Staff,46,0,50,4
1649833579505,COGS 17,A01,092679,Staff,73,0,75,2
1649833585529,COGS 100,A01,083972,Staff,46,0,60,14
1649833597583,COGS 101C,A01,083976,Staff,25,0,30,5
1649833603609,COGS 102A,A01,083978,Johnson; Christine M.,24,0,30,6
1649833609637,COGS 107B,A01,083980,Staff,34,0,50,16
1649833615662,COGS 115,A01,083982,Staff,22,0,30,8
1649833621779,COGS 118B,A01,083367,Staff,5,0,40,35
1649833627803,COGS 172,A01,083984,Provenzano; Emily Kara,21,0,30,9
1649833633829,COGS 177,A00,083368,Staff,4,0,30,26
1649833639855,COGS 186,A01,083986,Staff,25,0,40,15
1649833645884,COGS 187A,A01,083988,Boyle; Mary E. T.,41,0,60,19
1649833651908,CSE 8A,A50,084003,Miranda; Gregory Joseph,9,0,15,6
1649833657940,CSE 11,A01,084005,Miranda; Gregory Joseph,49,0,55,6
1649833663968,CSE 20,A01,084007,Staff,15,0,20,5
1649833669993,CSE 21,A01,084009,Staff,34,0,50,16
1649833676015,CSE 30,A01,083370,Cao; Yingjun,20,0,40,20
1649833682041,CSE 100,A01,083372,Cao; Yingjun,14,0,40,26
1649833688072,CSE 101,A01,084011,Staff,0,13,40,40
1649833694094,CSE 141,A01,083374,Eldon; John,0,12,75,75
1649833700122,CSE 141L,A01,083376,Eldon; John,0,15,75,75
1649833706146,CSE 175,A01,084013,Kumar; Rakesh,24,0,25,1
1649833712172,CSE 190,A00,092508,Staff,15,0,15,0
1649833718200,ECE 5,A01,084049,Morris; Karcher William,17,0,20,3
1649833724235,ECE 100,A01,084051,Baghdadchi; Saharnaz,16,0,20,4
1649833724235,ECE 100,A02,091916,Baghdadchi; Saharnaz,18,0,20,2
1649833730259,ECE 101,A01,084053,Baghdadchi; Saharnaz,25,0,37,12
1649833730259,ECE 101,A02,084054,Baghdadchi; Saharnaz,37,0,37,0
1649833736284,ECE 107,A01,083390,Staff,32,0,40,8
1649833742308,ECE 148,A01,084056,Silberman; Jack,8,0,12,4
1649833748337,ECE 180,A00,083391,Abi Samra; Nicholas Camill,27,0,30,3
1649833748337,ECE 180,B00,083392,Abi Samra; Nicholas Camill,26,0,30,4
1649833754361,MATH 10B,A01,084110,Staff,20,0,30,10
1649833754361,MATH 10B,A02,084111,Staff,29,0,30,1
1649833754361,MATH 10B,A03,084112,Staff,29,0,30,1
1649833760386,MATH 10C,A01,083443,Staff,19,0,30,11
1649833760386,MATH 10C,A02,083444,Staff,24,0,30,6
1649833760386,MATH 10C,B01,084114,Staff,26,0,30,4
1649833760386,MATH 10C,B02,084115,Staff,30,0,30,0
1649833766411,MATH 18,A01,084117,Harel; Guershon,28,0,30,2
1649833766411,MATH 18,A02,084119,Harel; Guershon,29,0,30,1
1649833766411,MATH 18,A03,084120,Harel; Guershon,30,0,30,0
1649833766411,MATH 18,A04,084121,Harel; Guershon,30,0,30,0
1649833772441,MATH 20B,A01,084124,Um; Ko Woon,33,0,35,2
1649833772441,MATH 20B,B01,084126,Um; Ko Woon,35,0,35,0
1649833778471,MATH 20C,A01,083446,Hammock; Frances H,26,0,30,4
1649833778471,MATH 20C,A02,083447,Hammock; Frances H,30,0,30,0
1649833778471,MATH 20C,A03,083448,Hammock; Frances H,30,0,30,0
1649833778471,MATH 20C,A04,083449,Hammock; Frances H,30,0,30,0
1649833778471,MATH 20C,B01,083451,Hammock; Frances H,29,0,30,1
1649833778471,MATH 20C,B02,083452,Hammock; Frances H,30,0,30,0
1649833778471,MATH 20C,B03,083453,Hammock; Frances H,30,0,30,0
1649833778471,MATH 20C,B04,083454,Hammock; Frances H,30,0,30,0
1649833784496,MATH 20D,A01,084128,Staff,29,0,30,1
1649833784496,MATH 20D,A02,084129,Staff,30,0,30,0
1649833784496,MATH 20D,A03,084130,Staff,29,0,30,1
1649833784496,MATH 20D,B01,084133,Staff,28,0,30,2
1649833784496,MATH 20D,B02,084134,Staff,30,0,30,0
1649833784496,MATH 20D,B03,084135,Staff,30,0,30,0
1649833790521,MATH 20E,A01,084138,Staff,28,0,30,2
1649833790521,MATH 20E,A02,084139,Staff,29,0,30,1
1649833790521,MATH 20E,A03,084140,Staff,28,0,30,2
1649833790521,MATH 20E,A04,084141,Staff,30,0,30,0
1649833796545,MATH 102,A01,084143,Harel; Guershon,24,0,30,6
1649833796545,MATH 102,A02,084144,Harel; Guershon,25,0,30,5
1649833802569,MATH 103B,A01,083456,Staff,0,0,30,30
1649833802569,MATH 103B,A02,083457,Staff,20,0,30,10
1649833808599,MATH 109,A01,084146,Salehi Golsefidy; Alireza,30,0,30,0
1649833808599,MATH 109,A02,084147,Salehi Golsefidy; Alireza,27,0,30,3
1649833814622,MATH 120A,A01,085445,Eggers; John Dietrich,31,0,35,4
1649833814622,MATH 120A,A02,085446,Eggers; John Dietrich,31,0,35,4
1649833820650,MATH 142B,A01,084149,Verstraete; Jacques Allan,7,0,30,23
1649833820650,MATH 142B,A02,084150,Verstraete; Jacques Allan,25,0,30,5
1649833826675,MATH 170A,A01,083459,Nie; Jiawang,9,0,30,21
1649833826675,MATH 170A,A02,083460,Nie; Jiawang,25,0,30,5
1649833826675,MATH 170A,A03,083461,Nie; Jiawang,26,0,30,4
1649833832698,MATH 193B,A01,083463,Staff,16,0,30,14
1649833832698,MATH 193B,A02,083464,Staff,19,0,30,11
1649833832698,MATH 193B,A03,083465,Staff,27,0,30,3
1649833838758,COGS 2,A01,083966,Boyle; Mary E. T.,27,0,30,3
1649833844781,COGS 9,A01,083968,Staff,56,0,60,4
1649833850803,COGS 14B,A01,083970,Staff,46,0,50,4
1649833856826,COGS 17,A01,092679,Staff,73,0,75,2
1649833862864,COGS 100,A01,083972,Staff,46,0,60,14
1649833874958,COGS 101C,A01,083976,Staff,25,0,30,5
1649833881004,COGS 102A,A01,083978,Johnson; Christine M.,24,0,30,6
1649833887032,COGS 107B,A01,083980,Staff,34,0,50,16
1649833893088,COGS 115,A01,083982,Staff,22,0,30,8
1649833899122,COGS 118B,A01,083367,Staff,5,0,40,35
1649833905147,COGS 172,A01,083984,Provenzano; Emily Kara,21,0,30,9
1649833911174,COGS 177,A00,083368,Staff,4,0,30,26
1649833917207,COGS 186,A01,083986,Staff,25,0,40,15
1649833923241,COGS 187A,A01,083988,Boyle; Mary E. T.,41,0,60,19
1649833929277,CSE 8A,A50,084003,Miranda; Gregory Joseph,9,0,15,6
1649833935318,CSE 11,A01,084005,Miranda; Gregory Joseph,49,0,55,6
1649833941347,CSE 20,A01,084007,Staff,15,0,20,5
1649833947373,CSE 21,A01,084009,Staff,34,0,50,16
1649833953400,CSE 30,A01,083370,Cao; Yingjun,20,0,40,20
1649833959425,CSE 100,A01,083372,Cao; Yingjun,14,0,40,26
1649833965456,CSE 101,A01,084011,Staff,0,14,40,40
1649833971485,CSE 141,A01,083374,Eldon; John,0,12,75,75
1649833977514,CSE 141L,A01,083376,Eldon; John,0,15,75,75
1649833983555,CSE 175,A01,084013,Kumar; Rakesh,24,0,25,1
1649833989581,CSE 190,A00,092508,Staff,15,0,15,0
1649833995611,ECE 5,A01,084049,Morris; Karcher William,17,0,20,3
1649834001634,ECE 100,A01,084051,Baghdadchi; Saharnaz,16,0,20,4
1649834001634,ECE 100,A02,091916,Baghdadchi; Saharnaz,18,0,20,2
1649834007657,ECE 101,A01,084053,Baghdadchi; Saharnaz,25,0,37,12
1649834007657,ECE 101,A02,084054,Baghdadchi; Saharnaz,37,0,37,0
1649834013680,ECE 107,A01,083390,Staff,32,0,40,8
1649834019707,ECE 148,A01,084056,Silberman; Jack,8,0,12,4
1649834025736,ECE 180,A00,083391,Abi Samra; Nicholas Camill,27,0,30,3
1649834025736,ECE 180,B00,083392,Abi Samra; Nicholas Camill,26,0,30,4
1649834031766,MATH 10B,A01,084110,Staff,20,0,30,10
1649834031766,MATH 10B,A02,084111,Staff,29,0,30,1
1649834031766,MATH 10B,A03,084112,Staff,29,0,30,1
1649834037792,MATH 10C,A01,083443,Staff,19,0,30,11
1649834037792,MATH 10C,A02,083444,Staff,24,0,30,6
1649834037792,MATH 10C,B01,084114,Staff,26,0,30,4
1649834037792,MATH 10C,B02,084115,Staff,30,0,30,0
1649834043827,MATH 18,A01,084117,Harel; Guershon,28,0,30,2
1649834043827,MATH 18,A02,084119,Harel; Guershon,29,0,30,1
1649834043827,MATH 18,A03,084120,Harel; Guershon,30,0,30,0
1649834043827,MATH 18,A04,084121,Harel; Guershon,30,0,30,0
1649834049865,MATH 20B,A01,084124,Um; Ko Woon,33,0,35,2
1649834049865,MATH 20B,B01,084126,Um; Ko Woon,35,0,35,0
1649834055898,MATH 20C,A01,083446,Hammock; Frances H,26,0,30,4
1649834055898,MATH 20C,A02,083447,Hammock; Frances H,30,0,30,0
1649834055898,MATH 20C,A03,083448,Hammock; Frances H,30,0,30,0
1649834055898,MATH 20C,A04,083449,Hammock; Frances H,30,0,30,0
1649834055898,MATH 20C,B01,083451,Hammock; Frances H,29,0,30,1
1649834055898,MATH 20C,B02,083452,Hammock; Frances H,30,0,30,0
1649834055898,MATH 20C,B03,083453,Hammock; Frances H,30,0,30,0
1649834055898,MATH 20C,B04,083454,Hammock; Frances H,30,0,30,0
1649834061922,MATH 20D,A01,084128,Staff,29,0,30,1
1649834061922,MATH 20D,A02,084129,Staff,30,0,30,0
1649834061922,MATH 20D,A03,084130,Staff,29,0,30,1
1649834061922,MATH 20D,B01,084133,Staff,28,0,30,2
1649834061922,MATH 20D,B02,084134,Staff,30,0,30,0
1649834061922,MATH 20D,B03,084135,Staff,30,0,30,0
1649834067955,MATH 20E,A01,084138,Staff,28,0,30,2
1649834067955,MATH 20E,A02,084139,Staff,29,0,30,1
1649834067955,MATH 20E,A03,084140,Staff,28,0,30,2
1649834067955,MATH 20E,A04,084141,Staff,30,0,30,0
1649834073983,MATH 102,A01,084143,Harel; Guershon,24,0,30,6
1649834073983,MATH 102,A02,084144,Harel; Guershon,25,0,30,5
1649834080013,MATH 103B,A01,083456,Staff,0,0,30,30
1649834080013,MATH 103B,A02,083457,Staff,20,0,30,10
1649834086046,MATH 109,A01,084146,Salehi Golsefidy; Alireza,30,0,30,0
1649834086046,MATH 109,A02,084147,Salehi Golsefidy; Alireza,27,0,30,3
1649834092079,MATH 120A,A01,085445,Eggers; John Dietrich,31,0,35,4
1649834092079,MATH 120A,A02,085446,Eggers; John Dietrich,31,0,35,4
1649834098107,MATH 142B,A01,084149,Verstraete; Jacques Allan,7,0,30,23
1649834098107,MATH 142B,A02,084150,Verstraete; Jacques Allan,25,0,30,5
1649834104134,MATH 170A,A01,083459,Nie; Jiawang,9,0,30,21
1649834104134,MATH 170A,A02,083460,Nie; Jiawang,25,0,30,5
1649834104134,MATH 170A,A03,083461,Nie; Jiawang,26,0,30,4
1649834110158,MATH 193B,A01,083463,Staff,15,0,30,15
1649834110158,MATH 193B,A02,083464,Staff,19,0,30,11
1649834110158,MATH 193B,A03,083465,Staff,27,0,30,3
1649834116225,COGS 2,A01,083966,Boyle; Mary E. T.,27,0,30,3
1649834122248,COGS 9,A01,083968,Staff,56,0,60,4
1649834128286,COGS 14B,A01,083970,Staff,46,0,50,4
1649834134315,COGS 17,A01,092679,Staff,73,0,75,2
1649834140338,COGS 100,A01,083972,Staff,46,0,60,14
1649834152389,COGS 101C,A01,083976,Staff,25,0,30,5
1649834158416,COGS 102A,A01,083978,Johnson; Christine M.,24,0,30,6
1649834164441,COGS 107B,A01,083980,Staff,34,0,50,16
1649834170465,COGS 115,A01,083982,Staff,22,0,30,8
1649834176489,COGS 118B,A01,083367,Staff,5,0,40,35
1649834182518,COGS 172,A01,083984,Provenzano; Emily Kara,21,0,30,9
1649834188543,COGS 177,A00,083368,Staff,4,0,30,26
1649834194585,COGS 186,A01,083986,Staff,25,0,40,15
1649834200614,COGS 187A,A01,083988,Boyle; Mary E. T.,41,0,60,19
1649834206637,CSE 8A,A50,084003,Miranda; Gregory Joseph,9,0,15,6
1649834212661,CSE 11,A01,084005,Miranda; Gregory Joseph,49,0,55,6
1649834218771,CSE 20,A01,084007,Staff,15,0,20,5
1649834224794,CSE 21,A01,084009,Staff,34,0,50,16
1649834230817,CSE 30,A01,083370,Cao; Yingjun,20,0,40,20
1649834236842,CSE 100,A01,083372,Cao; Yingjun,14,0,40,26
1649834242866,CSE 101,A01,084011,Staff,0,14,40,40
1649834248890,CSE 141,A01,083374,Eldon; John,0,12,75,75
1649834254924,CSE 141L,A01,083376,Eldon; John,0,15,75,75
1649834260950,CSE 175,A01,084013,Kumar; Rakesh,24,0,25,1
1649834266975,CSE 190,A00,092508,Staff,15,0,15,0
1649834273013,ECE 5,A01,084049,Morris; Karcher William,17,0,20,3
1649834279037,ECE 100,A01,084051,Baghdadchi; Saharnaz,16,0,20,4
1649834279037,ECE 100,A02,091916,Baghdadchi; Saharnaz,18,0,20,2
1649834285061,ECE 101,A01,084053,Baghdadchi; Saharnaz,25,0,37,12
1649834285061,ECE 101,A02,084054,Baghdadchi; Saharnaz,37,0,37,0
1649834291085,ECE 107,A01,083390,Staff,32,0,40,8
1649834297112,ECE 148,A01,084056,Silberman; Jack,8,0,12,4
1649834303149,ECE 180,A00,083391,Abi Samra; Nicholas Camill,27,0,30,3
1649834303149,ECE 180,B00,083392,Abi Samra; Nicholas Camill,26,0,30,4
1649834309173,MATH 10B,A01,084110,Staff,20,0,30,10
1649834309173,MATH 10B,A02,084111,Staff,29,0,30,1
1649834309173,MATH 10B,A03,084112,Staff,29,0,30,1
1649834315203,MATH 10C,A01,083443,Staff,19,0,30,11
1649834315203,MATH 10C,A02,083444,Staff,24,0,30,6
1649834315203,MATH 10C,B01,084114,Staff,26,0,30,4
1649834315203,MATH 10C,B02,084115,Staff,30,0,30,0
1649834321228,MATH 18,A01,084117,Harel; Guershon,28,0,30,2
1649834321228,MATH 18,A02,084119,Harel; Guershon,29,0,30,1
1649834321228,MATH 18,A03,084120,Harel; Guershon,30,0,30,0
1649834321228,MATH 18,A04,084121,Harel; Guershon,30,0,30,0
1649834327253,MATH 20B,A01,084124,Um; Ko Woon,33,0,35,2
1649834327253,MATH 20B,B01,084126,Um; Ko Woon,35,0,35,0
1649834333285,MATH 20C,A01,083446,Hammock; Frances H,26,0,30,4
1649834333285,MATH 20C,A02,083447,Hammock; Frances H,30,0,30,0
1649834333285,MATH 20C,A03,083448,Hammock; Frances H,30,0,30,0
1649834333285,MATH 20C,A04,083449,Hammock; Frances H,30,0,30,0
1649834333285,MATH 20C,B01,083451,Hammock; Frances H,29,0,30,1
1649834333285,MATH 20C,B02,083452,Hammock; Frances H,30,0,30,0
1649834333285,MATH 20C,B03,083453,Hammock; Frances H,30,0,30,0
1649834333285,MATH 20C,B04,083454,Hammock; Frances H,30,0,30,0
1649834339311,MATH 20D,A01,084128,Staff,29,0,30,1
1649834339311,MATH 20D,A02,084129,Staff,30,0,30,0
1649834339311,MATH 20D,A03,084130,Staff,29,0,30,1
1649834339311,MATH 20D,B01,084133,Staff,28,0,30,2
1649834339311,MATH 20D,B02,084134,Staff,30,0,30,0
1649834339311,MATH 20D,B03,084135,Staff,30,0,30,0
1649834345334,MATH 20E,A01,084138,Staff,28,0,30,2
1649834345334,MATH 20E,A02,084139,Staff,29,0,30,1
1649834345334,MATH 20E,A03,084140,Staff,28,0,30,2
1649834345334,MATH 20E,A04,084141,Staff,30,0,30,0
1649834351364,MATH 102,A01,084143,Harel; Guershon,24,0,30,6
1649834351364,MATH 102,A02,084144,Harel; Guershon,25,0,30,5
1649834357390,MATH 103B,A01,083456,Staff,0,0,30,30
1649834357390,MATH 103B,A02,083457,Staff,20,0,30,10
1649834363416,MATH 109,A01,084146,Salehi Golsefidy; Alireza,30,0,30,0
1649834363416,MATH 109,A02,084147,Salehi Golsefidy; Alireza,27,0,30,3
1649834369444,MATH 120A,A01,085445,Eggers; John Dietrich,31,0,35,4
1649834369444,MATH 120A,A02,085446,Eggers; John Dietrich,31,0,35,4
1649834375467,MATH 142B,A01,084149,Verstraete; Jacques Allan,7,0,30,23
1649834375467,MATH 142B,A02,084150,Verstraete; Jacques Allan,25,0,30,5
1649834381495,MATH 170A,A01,083459,Nie; Jiawang,9,0,30,21
1649834381495,MATH 170A,A02,083460,Nie; Jiawang,25,0,30,5
1649834381495,MATH 170A,A03,083461,Nie; Jiawang,26,0,30,4
1649834387527,MATH 193B,A01,083463,Staff,15,0,30,15
1649834387527,MATH 193B,A02,083464,Staff,19,0,30,11
1649834387527,MATH 193B,A03,083465,Staff,27,0,30,3
1649834393580,COGS 2,A01,083966,Boyle; Mary E. T.,27,0,30,3
1649834399605,COGS 9,A01,083968,Staff,56,0,60,4
1649834405627,COGS 14B,A01,083970,Staff,46,0,50,4
1649834411661,COGS 17,A01,092679,Staff,73,0,75,2
1649834417685,COGS 100,A01,083972,Staff,46,0,60,14
1649834429732,COGS 101C,A01,083976,Staff,25,0,30,5
1649834435755,COGS 102A,A01,083978,Johnson; Christine M.,24,0,30,6
1649834441781,COGS 107B,A01,083980,Staff,34,0,50,16
1649834447810,COGS 115,A01,083982,Staff,22,0,30,8
1649834453837,COGS 118B,A01,083367,Staff,5,0,40,35
1649834459866,COGS 172,A01,083984,Provenzano; Emily Kara,21,0,30,9
1649834465894,COGS 177,A00,083368,Staff,4,0,30,26
1649834471920,COGS 186,A01,083986,Staff,25,0,40,15
1649834477943,COGS 187A,A01,083988,Boyle; Mary E. T.,41,0,60,19
1649834483966,CSE 8A,A50,084003,Miranda; Gregory Joseph,9,0,15,6
1649834489993,CSE 11,A01,084005,Miranda; Gregory Joseph,49,0,55,6
1649834496017,CSE 20,A01,084007,Staff,15,0,20,5
1649834502043,CSE 21,A01,084009,Staff,34,0,50,16
1649834508066,CSE 30,A01,083370,Cao; Yingjun,20,0,40,20
1649834514088,CSE 100,A01,083372,Cao; Yingjun,14,0,40,26
1649834520116,CSE 101,A01,084011,Staff,0,14,40,40
1649834526150,CSE 141,A01,083374,Eldon; John,0,12,75,75
1649834532173,CSE 141L,A01,083376,Eldon; John,0,15,75,75
1649834538198,CSE 175,A01,084013,Kumar; Rakesh,24,0,25,1
1649834544223,CSE 190,A00,092508,Staff,15,0,15,0
1649834550251,ECE 5,A01,084049,Morris; Karcher William,17,0,20,3
1649834556277,ECE 100,A01,084051,Baghdadchi; Saharnaz,16,0,20,4
1649834556277,ECE 100,A02,091916,Baghdadchi; Saharnaz,18,0,20,2
1649834562306,ECE 101,A01,084053,Baghdadchi; Saharnaz,25,0,37,12
1649834562306,ECE 101,A02,084054,Baghdadchi; Saharnaz,37,0,37,0
1649834568330,ECE 107,A01,083390,Staff,32,0,40,8
1649834574358,ECE 148,A01,084056,Silberman; Jack,8,0,12,4
1649834580384,ECE 180,A00,083391,Abi Samra; Nicholas Camill,27,0,30,3
1649834580384,ECE 180,B00,083392,Abi Samra; Nicholas Camill,26,0,30,4
1649834586410,MATH 10B,A01,084110,Staff,20,0,30,10
1649834586410,MATH 10B,A02,084111,Staff,29,0,30,1
1649834586410,MATH 10B,A03,084112,Staff,29,0,30,1
1649834592432,MATH 10C,A01,083443,Staff,19,0,30,11
1649834592432,MATH 10C,A02,083444,Staff,24,0,30,6
1649834592432,MATH 10C,B01,084114,Staff,26,0,30,4
1649834592432,MATH 10C,B02,084115,Staff,30,0,30,0
1649834598456,MATH 18,A01,084117,Harel; Guershon,28,0,30,2
1649834598456,MATH 18,A02,084119,Harel; Guershon,29,0,30,1
1649834598456,MATH 18,A03,084120,Harel; Guershon,30,0,30,0
1649834598456,MATH 18,A04,084121,Harel; Guershon,30,0,30,0
1649834604483,MATH 20B,A01,084124,Um; Ko Woon,33,0,35,2
1649834604483,MATH 20B,B01,084126,Um; Ko Woon,35,0,35,0
1649834610521,MATH 20C,A01,083446,Hammock; Frances H,26,0,30,4
1649834610521,MATH 20C,A02,083447,Hammock; Frances H,30,0,30,0
1649834610521,MATH 20C,A03,083448,Hammock; Frances H,30,0,30,0
1649834610521,MATH 20C,A04,083449,Hammock; Frances H,30,0,30,0
1649834610521,MATH 20C,B01,083451,Hammock; Frances H,29,0,30,1
1649834610521,MATH 20C,B02,083452,Hammock; Frances H,30,0,30,0
1649834610521,MATH 20C,B03,083453,Hammock; Frances H,30,0,30,0
1649834610521,MATH 20C,B04,083454,Hammock; Frances H,30,0,30,0
1649834616549,MATH 20D,A01,084128,Staff,29,0,30,1
1649834616549,MATH 20D,A02,084129,Staff,30,0,30,0
1649834616549,MATH 20D,A03,084130,Staff,29,0,30,1
1649834616549,MATH 20D,B01,084133,Staff,28,0,30,2
1649834616549,MATH 20D,B02,084134,Staff,30,0,30,0
1649834616549,MATH 20D,B03,084135,Staff,30,0,30,0
1649834622572,MATH 20E,A01,084138,Staff,28,0,30,2
1649834622572,MATH 20E,A02,084139,Staff,29,0,30,1
1649834622572,MATH 20E,A03,084140,Staff,28,0,30,2
1649834622572,MATH 20E,A04,084141,Staff,30,0,30,0
1649834628600,MATH 102,A01,084143,Harel; Guershon,24,0,30,6
1649834628600,MATH 102,A02,084144,Harel; Guershon,25,0,30,5
1649834634624,MATH 103B,A01,083456,Staff,0,0,30,30
1649834634624,MATH 103B,A02,083457,Staff,19,0,30,11
1649834640655,MATH 109,A01,084146,Salehi Golsefidy; Alireza,30,0,30,0
1649834640655,MATH 109,A02,084147,Salehi Golsefidy; Alireza,27,0,30,3
1649834646678,MATH 120A,A01,085445,Eggers; John Dietrich,31,0,35,4
1649834646678,MATH 120A,A02,085446,Eggers; John Dietrich,31,0,35,4
1649834652703,MATH 142B,A01,084149,Verstraete; Jacques Allan,7,0,30,23
1649834652703,MATH 142B,A02,084150,Verstraete; Jacques Allan,25,0,30,5
1649834658727,MATH 170A,A01,083459,Nie; Jiawang,10,0,30,20
1649834658727,MATH 170A,A02,083460,Nie; Jiawang,25,0,30,5
1649834658727,MATH 170A,A03,083461,Nie; Jiawang,26,0,30,4
1649834664749,MATH 193B,A01,083463,Staff,15,0,30,15
1649834664749,MATH 193B,A02,083464,Staff,19,0,30,11
1649834664749,MATH 193B,A03,083465,Staff,27,0,30,3
1649834670800,COGS 2,A01,083966,Boyle; Mary E. T.,27,0,30,3
1649834676826,COGS 9,A01,083968,Staff,56,0,60,4
1649834682855,COGS 14B,A01,083970,Staff,46,0,50,4
1649834688877,COGS 17,A01,092679,Staff,73,0,75,2
1649834694901,COGS 100,A01,083972,Staff,46,0,60,14
1649834706950,COGS 101C,A01,083976,Staff,25,0,30,5
1649834712973,COGS 102A,A01,083978,Johnson; Christine M.,24,0,30,6
1649834718997,COGS 107B,A01,083980,Staff,34,0,50,16
1649834725025,COGS 115,A01,083982,Staff,22,0,30,8
1649834731057,COGS 118B,A01,083367,Staff,5,0,40,35
1649834737085,COGS 172,A01,083984,Provenzano; Emily Kara,21,0,30,9
1649834743109,COGS 177,A00,083368,Staff,4,0,30,26
1649834749135,COGS 186,A01,083986,Staff,25,0,40,15
1649834755169,COGS 187A,A01,083988,Boyle; Mary E. T.,41,0,60,19
1649834761194,CSE 8A,A50,084003,Miranda; Gregory Joseph,9,0,15,6
1649834767220,CSE 11,A01,084005,Miranda; Gregory Joseph,49,0,55,6
1649834773252,CSE 20,A01,084007,Staff,15,0,20,5
1649834779275,CSE 21,A01,084009,Staff,34,0,50,16
1649834785301,CSE 30,A01,083370,Cao; Yingjun,20,0,40,20
1649834791323,CSE 100,A01,083372,Cao; Yingjun,13,0,40,27
1649834797347,CSE 101,A01,084011,Staff,0,14,40,40
1649834803370,CSE 141,A01,083374,Eldon; John,0,12,75,75
1649834809399,CSE 141L,A01,083376,Eldon; John,0,15,75,75
1649834815532,CSE 175,A01,084013,Kumar; Rakesh,24,0,25,1
1649834821561,CSE 190,A00,092508,Staff,15,0,15,0
1649834827584,ECE 5,A01,084049,Morris; Karcher William,17,0,20,3
1649834833613,ECE 100,A01,084051,Baghdadchi; Saharnaz,16,0,20,4
1649834833613,ECE 100,A02,091916,Baghdadchi; Saharnaz,18,0,20,2
1649834839637,ECE 101,A01,084053,Baghdadchi; Saharnaz,25,0,37,12
1649834839637,ECE 101,A02,084054,Baghdadchi; Saharnaz,37,0,37,0
1649834845661,ECE 107,A01,083390,Staff,32,0,40,8
1649834851684,ECE 148,A01,084056,Silberman; Jack,8,0,12,4
1649834857710,ECE 180,A00,083391,Abi Samra; Nicholas Camill,27,0,30,3
1649834857710,ECE 180,B00,083392,Abi Samra; Nicholas Camill,26,0,30,4
1649834863746,MATH 10B,A01,084110,Staff,20,0,30,10
1649834863746,MATH 10B,A02,084111,Staff,29,0,30,1
1649834863746,MATH 10B,A03,084112,Staff,29,0,30,1
1649834869770,MATH 10C,A01,083443,Staff,19,0,30,11
1649834869770,MATH 10C,A02,083444,Staff,24,0,30,6
1649834869770,MATH 10C,B01,084114,Staff,26,0,30,4
1649834869770,MATH 10C,B02,084115,Staff,30,0,30,0
1649834875797,MATH 18,A01,084117,Harel; Guershon,28,0,30,2
1649834875797,MATH 18,A02,084119,Harel; Guershon,29,0,30,1
1649834875797,MATH 18,A03,084120,Harel; Guershon,30,0,30,0
1649834875797,MATH 18,A04,084121,Harel; Guershon,30,0,30,0
1649834881826,MATH 20B,A01,084124,Um; Ko Woon,33,0,35,2
1649834881826,MATH 20B,B01,084126,Um; Ko Woon,35,0,35,0
1649834887852,MATH 20C,A01,083446,Hammock; Frances H,26,0,30,4
1649834887852,MATH 20C,A02,083447,Hammock; Frances H,30,0,30,0
1649834887852,MATH 20C,A03,083448,Hammock; Frances H,30,0,30,0
1649834887852,MATH 20C,A04,083449,Hammock; Frances H,30,0,30,0
1649834887852,MATH 20C,B01,083451,Hammock; Frances H,29,0,30,1
1649834887852,MATH 20C,B02,083452,Hammock; Frances H,30,0,30,0
1649834887852,MATH 20C,B03,083453,Hammock; Frances H,30,0,30,0
1649834887852,MATH 20C,B04,083454,Hammock; Frances H,30,0,30,0
1649834893881,MATH 20D,A01,084128,Staff,29,0,30,1
1649834893881,MATH 20D,A02,084129,Staff,30,0,30,0
1649834893881,MATH 20D,A03,084130,Staff,29,0,30,1
1649834893881,MATH 20D,B01,084133,Staff,28,0,30,2
1649834893881,MATH 20D,B02,084134,Staff,30,0,30,0
1649834893881,MATH 20D,B03,084135,Staff,30,0,30,0
1649834899903,MATH 20E,A01,084138,Staff,28,0,30,2
1649834899903,MATH 20E,A02,084139,Staff,29,0,30,1
1649834899903,MATH 20E,A03,084140,Staff,28,0,30,2
1649834899903,MATH 20E,A04,084141,Staff,30,0,30,0
1649834905925,MATH 102,A01,084143,Harel; Guershon,24,0,30,6
1649834905925,MATH 102,A02,084144,Harel; Guershon,25,0,30,5
1649834911948,MATH 103B,A01,083456,Staff,0,0,30,30
1649834911948,MATH 103B,A02,083457,Staff,19,0,30,11
1649834917990,MATH 109,A01,084146,Salehi Golsefidy; Alireza,30,0,30,0
1649834917990,MATH 109,A02,084147,Salehi Golsefidy; Alireza,27,0,30,3
1649834924016,MATH 120A,A01,085445,Eggers; John Dietrich,30,0,35,5
1649834924016,MATH 120A,A02,085446,Eggers; John Dietrich,31,0,35,4
1649834930040,MATH 142B,A01,084149,Verstraete; Jacques Allan,7,0,30,23
1649834930040,MATH 142B,A02,084150,Verstraete; Jacques Allan,25,0,30,5
1649834936063,MATH 170A,A01,083459,Nie; Jiawang,10,0,30,20
1649834936063,MATH 170A,A02,083460,Nie; Jiawang,25,0,30,5
1649834936063,MATH 170A,A03,083461,Nie; Jiawang,26,0,30,4
1649834942087,MATH 193B,A01,083463,Staff,15,0,30,15
1649834942087,MATH 193B,A02,083464,Staff,19,0,30,11
1649834942087,MATH 193B,A03,083465,Staff,27,0,30,3
1649834948152,COGS 2,A01,083966,Boyle; Mary E. T.,27,0,30,3
1649834954176,COGS 9,A01,083968,Staff,56,0,60,4
1649834960201,COGS 14B,A01,083970,Staff,46,0,50,4
1649834966225,COGS 17,A01,092679,Staff,73,0,75,2
1649834972250,COGS 100,A01,083972,Staff,46,0,60,14
1649834984294,COGS 101C,A01,083976,Staff,25,0,30,5
1649834990318,COGS 102A,A01,083978,Johnson; Christine M.,24,0,30,6
1649834996339,COGS 107B,A01,083980,Staff,33,0,50,17
1649835002361,COGS 115,A01,083982,Staff,22,0,30,8
1649835008387,COGS 118B,A01,083367,Staff,5,0,40,35
1649835014412,COGS 172,A01,083984,Provenzano; Emily Kara,21,0,30,9
1649835020439,COGS 177,A00,083368,Staff,4,0,30,26
1649835026461,COGS 186,A01,083986,Staff,25,0,40,15
1649835032484,COGS 187A,A01,083988,Boyle; Mary E. T.,41,0,60,19
1649835038508,CSE 8A,A50,084003,Miranda; Gregory Joseph,9,0,15,6
1649835044545,CSE 11,A01,084005,Miranda; Gregory Joseph,49,0,55,6
1649835050571,CSE 20,A01,084007,Staff,15,0,20,5
1649835056593,CSE 21,A01,084009,Staff,34,0,50,16
1649835062616,CSE 30,A01,083370,Cao; Yingjun,20,0,40,20
1649835068640,CSE 100,A01,083372,Cao; Yingjun,13,0,40,27
1649835074663,CSE 101,A01,084011,Staff,0,14,40,40
1649835080690,CSE 141,A01,083374,Eldon; John,0,12,75,75
1649835086720,CSE 141L,A01,083376,Eldon; John,0,15,75,75
1649835092745,CSE 175,A01,084013,Kumar; Rakesh,24,0,25,1
1649835098770,CSE 190,A00,092508,Staff,15,0,15,0
1649835104794,ECE 5,A01,084049,Morris; Karcher William,17,0,20,3
1649835110830,ECE 100,A01,084051,Baghdadchi; Saharnaz,16,0,20,4
1649835110830,ECE 100,A02,091916,Baghdadchi; Saharnaz,18,0,20,2
1649835116858,ECE 101,A01,084053,Baghdadchi; Saharnaz,25,0,37,12
1649835116858,ECE 101,A02,084054,Baghdadchi; Saharnaz,37,0,37,0
1649835122880,ECE 107,A01,083390,Staff,32,0,40,8
1649835128902,ECE 148,A01,084056,Silberman; Jack,8,0,12,4
1649835134928,ECE 180,A00,083391,Abi Samra; Nicholas Camill,27,0,30,3
1649835134928,ECE 180,B00,083392,Abi Samra; Nicholas Camill,26,0,30,4
1649835140956,MATH 10B,A01,084110,Staff,20,0,30,10
1649835140956,MATH 10B,A02,084111,Staff,29,0,30,1
1649835140956,MATH 10B,A03,084112,Staff,29,0,30,1
1649835146982,MATH 10C,A01,083443,Staff,19,0,30,11
1649835146982,MATH 10C,A02,083444,Staff,24,0,30,6
1649835146982,MATH 10C,B01,084114,Staff,26,0,30,4
1649835146982,MATH 10C,B02,084115,Staff,30,0,30,0
1649835153010,MATH 18,A01,084117,Harel; Guershon,28,0,30,2
1649835153010,MATH 18,A02,084119,Harel; Guershon,29,0,30,1
1649835153010,MATH 18,A03,084120,Harel; Guershon,30,0,30,0
1649835153010,MATH 18,A04,084121,Harel; Guershon,30,0,30,0
1649835159035,MATH 20B,A01,084124,Um; Ko Woon,33,0,35,2
1649835159035,MATH 20B,B01,084126,Um; Ko Woon,35,0,35,0
1649835165062,MATH 20C,A01,083446,Hammock; Frances H,26,0,30,4
1649835165062,MATH 20C,A02,083447,Hammock; Frances H,30,0,30,0
1649835165062,MATH 20C,A03,083448,Hammock; Frances H,30,0,30,0
1649835165062,MATH 20C,A04,083449,Hammock; Frances H,30,0,30,0
1649835165062,MATH 20C,B01,083451,Hammock; Frances H,29,0,30,1
1649835165062,MATH 20C,B02,083452,Hammock; Frances H,30,0,30,0
1649835165062,MATH 20C,B03,083453,Hammock; Frances H,30,0,30,0
1649835165062,MATH 20C,B04,083454,Hammock; Frances H,30,0,30,0
1649835171089,MATH 20D,A01,084128,Staff,29,0,30,1
1649835171089,MATH 20D,A02,084129,Staff,30,0,30,0
1649835171089,MATH 20D,A03,084130,Staff,29,0,30,1
1649835171089,MATH 20D,B01,084133,Staff,28,0,30,2
1649835171089,MATH 20D,B02,084134,Staff,30,0,30,0
1649835171089,MATH 20D,B03,084135,Staff,30,0,30,0
1649835177112,MATH 20E,A01,084138,Staff,28,0,30,2
1649835177112,MATH 20E,A02,084139,Staff,29,0,30,1
1649835177112,MATH 20E,A03,084140,Staff,28,0,30,2
1649835177112,MATH 20E,A04,084141,Staff,30,0,30,0
1649835183137,MATH 102,A01,084143,Harel; Guershon,24,0,30,6
1649835183137,MATH 102,A02,084144,Harel; Guershon,25,0,30,5
1649835189160,MATH 103B,A01,083456,Staff,0,0,30,30
1649835189160,MATH 103B,A02,083457,Staff,19,0,30,11
1649835195197,MATH 109,A01,084146,Salehi Golsefidy; Alireza,30,0,30,0
1649835195197,MATH 109,A02,084147,Salehi Golsefidy; Alireza,27,0,30,3
1649835201225,MATH 120A,A01,085445,Eggers; John Dietrich,30,0,35,5
1649835201225,MATH 120A,A02,085446,Eggers; John Dietrich,31,0,35,4
1649835207248,MATH 142B,A01,084149,Verstraete; Jacques Allan,7,0,30,23
1649835207248,MATH 142B,A02,084150,Verstraete; Jacques Allan,25,0,30,5
1649835213281,MATH 170A,A01,083459,Nie; Jiawang,10,0,30,20
1649835213281,MATH 170A,A02,083460,Nie; Jiawang,25,0,30,5
1649835213281,MATH 170A,A03,083461,Nie; Jiawang,26,0,30,4
1649835219310,MATH 193B,A01,083463,Staff,15,0,30,15
1649835219310,MATH 193B,A02,083464,Staff,19,0,30,11
1649835219310,MATH 193B,A03,083465,Staff,27,0,30,3
1649835225401,COGS 2,A01,083966,Boyle; Mary E. T.,27,0,30,3
1649835231429,COGS 9,A01,083968,Staff,56,0,60,4
1649835237452,COGS 14B,A01,083970,Staff,46,0,50,4
1649835243481,COGS 17,A01,092679,Staff,73,0,75,2
1649835249505,COGS 100,A01,083972,Staff,46,0,60,14
1649835261552,COGS 101C,A01,083976,Staff,25,0,30,5
1649835267577,COGS 102A,A01,083978,Johnson; Christine M.,24,0,30,6
1649835273601,COGS 107B,A01,083980,Staff,34,0,50,16
1649835279628,COGS 115,A01,083982,Staff,22,0,30,8
1649835285652,COGS 118B,A01,083367,Staff,5,0,40,35
1649835291678,COGS 172,A01,083984,Provenzano; Emily Kara,21,0,30,9
1649835297705,COGS 177,A00,083368,Staff,4,0,30,26
1649835303730,COGS 186,A01,083986,Staff,25,0,40,15
1649835309763,COGS 187A,A01,083988,Boyle; Mary E. T.,41,0,60,19
1649835315788,CSE 8A,A50,084003,Miranda; Gregory Joseph,9,0,15,6
1649835321810,CSE 11,A01,084005,Miranda; Gregory Joseph,49,0,55,6
1649835327844,CSE 20,A01,084007,Staff,15,0,20,5
1649835333881,CSE 21,A01,084009,Staff,34,0,50,16
1649835339907,CSE 30,A01,083370,Cao; Yingjun,20,0,40,20
1649835345936,CSE 100,A01,083372,Cao; Yingjun,13,0,40,27
1649835351960,CSE 101,A01,084011,Staff,0,14,40,40
1649835357988,CSE 141,A01,083374,Eldon; John,0,13,75,75
1649835364012,CSE 141L,A01,083376,Eldon; John,0,16,75,75
1649835370047,CSE 175,A01,084013,Kumar; Rakesh,24,0,25,1
1649835376071,CSE 190,A00,092508,Staff,15,0,15,0
1649835382096,ECE 5,A01,084049,Morris; Karcher William,17,0,20,3
1649835388122,ECE 100,A01,084051,Baghdadchi; Saharnaz,16,0,20,4
1649835388122,ECE 100,A02,091916,Baghdadchi; Saharnaz,18,0,20,2
1649835394148,ECE 101,A01,084053,Baghdadchi; Saharnaz,25,0,37,12
1649835394148,ECE 101,A02,084054,Baghdadchi; Saharnaz,37,0,37,0
1649835400171,ECE 107,A01,083390,Staff,32,0,40,8
1649835406202,ECE 148,A01,084056,Silberman; Jack,8,0,12,4
1649835412314,ECE 180,A00,083391,Abi Samra; Nicholas Camill,27,0,30,3
1649835412314,ECE 180,B00,083392,Abi Samra; Nicholas Camill,26,0,30,4
1649835418346,MATH 10B,A01,084110,Staff,20,0,30,10
1649835418346,MATH 10B,A02,084111,Staff,29,0,30,1
1649835418346,MATH 10B,A03,084112,Staff,29,0,30,1
1649835424371,MATH 10C,A01,083443,Staff,19,0,30,11
1649835424371,MATH 10C,A02,083444,Staff,24,0,30,6
1649835424371,MATH 10C,B01,084114,Staff,26,0,30,4
1649835424371,MATH 10C,B02,084115,Staff,30,0,30,0
1649835430395,MATH 18,A01,084117,Harel; Guershon,28,0,30,2
1649835430395,MATH 18,A02,084119,Harel; Guershon,29,0,30,1
1649835430395,MATH 18,A03,084120,Harel; Guershon,30,0,30,0
1649835430395,MATH 18,A04,084121,Harel; Guershon,30,0,30,0
1649835436427,MATH 20B,A01,084124,Um; Ko Woon,33,0,35,2
1649835436427,MATH 20B,B01,084126,Um; Ko Woon,35,0,35,0
1649835442460,MATH 20C,A01,083446,Hammock; Frances H,26,0,30,4
1649835442460,MATH 20C,A02,083447,Hammock; Frances H,30,0,30,0
1649835442460,MATH 20C,A03,083448,Hammock; Frances H,30,0,30,0
1649835442460,MATH 20C,A04,083449,Hammock; Frances H,30,0,30,0
1649835442460,MATH 20C,B01,083451,Hammock; Frances H,29,0,30,1
1649835442460,MATH 20C,B02,083452,Hammock; Frances H,30,0,30,0
1649835442460,MATH 20C,B03,083453,Hammock; Frances H,30,0,30,0
1649835442460,MATH 20C,B04,083454,Hammock; Frances H,30,0,30,0
1649835448489,MATH 20D,A01,084128,Staff,29,0,30,1
1649835448489,MATH 20D,A02,084129,Staff,30,0,30,0
1649835448489,MATH 20D,A03,084130,Staff,29,0,30,1
1649835448489,MATH 20D,B01,084133,Staff,28,0,30,2
1649835448489,MATH 20D,B02,084134,Staff,30,0,30,0
1649835448489,MATH 20D,B03,084135,Staff,30,0,30,0
1649835454513,MATH 20E,A01,084138,Staff,28,0,30,2
1649835454513,MATH 20E,A02,084139,Staff,29,0,30,1
1649835454513,MATH 20E,A03,084140,Staff,28,0,30,2
1649835454513,MATH 20E,A04,084141,Staff,30,0,30,0
1649835460537,MATH 102,A01,084143,Harel; Guershon,24,0,30,6
1649835460537,MATH 102,A02,084144,Harel; Guershon,25,0,30,5
1649835466563,MATH 103B,A01,083456,Staff,0,0,30,30
1649835466563,MATH 103B,A02,083457,Staff,19,0,30,11
1649835472589,MATH 109,A01,084146,Salehi Golsefidy; Alireza,30,0,30,0
1649835472589,MATH 109,A02,084147,Salehi Golsefidy; Alireza,27,0,30,3
1649835478614,MATH 120A,A01,085445,Eggers; John Dietrich,30,0,35,5
1649835478614,MATH 120A,A02,085446,Eggers; John Dietrich,31,0,35,4
1649835484639,MATH 142B,A01,084149,Verstraete; Jacques Allan,7,0,30,23
1649835484639,MATH 142B,A02,084150,Verstraete; Jacques Allan,25,0,30,5
1649835490671,MATH 170A,A01,083459,Nie; Jiawang,10,0,30,20
1649835490671,MATH 170A,A02,083460,Nie; Jiawang,25,0,30,5
1649835490671,MATH 170A,A03,083461,Nie; Jiawang,26,0,30,4
1649835496694,MATH 193B,A01,083463,Staff,15,0,30,15
1649835496694,MATH 193B,A02,083464,Staff,19,0,30,11
1649835496694,MATH 193B,A03,083465,Staff,27,0,30,3
1649835502760,COGS 2,A01,083966,Boyle; Mary E. T.,27,0,30,3
1649835508784,COGS 9,A01,083968,Staff,56,0,60,4
1649835514813,COGS 14B,A01,083970,Staff,46,0,50,4
1649835520847,COGS 17,A01,092679,Staff,73,0,75,2
1649835526871,COGS 100,A01,083972,Staff,46,0,60,14
1649835538920,COGS 101C,A01,083976,Staff,25,0,30,5
1649835544947,COGS 102A,A01,083978,Johnson; Christine M.,24,0,30,6
1649835550971,COGS 107B,A01,083980,Staff,34,0,50,16
1649835556995,COGS 115,A01,083982,Staff,22,0,30,8
1649835563024,COGS 118B,A01,083367,Staff,5,0,40,35
1649835569050,COGS 172,A01,083984,Provenzano; Emily Kara,21,0,30,9
1649835575075,COGS 177,A00,083368,Staff,4,0,30,26
1649835581102,COGS 186,A01,083986,Staff,25,0,40,15
1649835587134,COGS 187A,A01,083988,Boyle; Mary E. T.,41,0,60,19
1649835593158,CSE 8A,A50,084003,Miranda; Gregory Joseph,9,0,15,6
1649835599189,CSE 11,A01,084005,Miranda; Gregory Joseph,49,0,55,6
1649835605213,CSE 20,A01,084007,Staff,15,0,20,5
1649835611239,CSE 21,A01,084009,Staff,34,0,50,16
1649835617264,CSE 30,A01,083370,Cao; Yingjun,20,0,40,20
1649835623287,CSE 100,A01,083372,Cao; Yingjun,13,0,40,27
1649835629316,CSE 101,A01,084011,Staff,0,14,40,40
1649835635343,CSE 141,A01,083374,Eldon; John,0,13,75,75
1649835641369,CSE 141L,A01,083376,Eldon; John,0,16,75,75
1649835647392,CSE 175,A01,084013,Kumar; Rakesh,24,0,25,1
1649835653416,CSE 190,A00,092508,Staff,15,0,15,0
1649835659449,ECE 5,A01,084049,Morris; Karcher William,17,0,20,3
1649835665476,ECE 100,A01,084051,Baghdadchi; Saharnaz,16,0,20,4
1649835665476,ECE 100,A02,091916,Baghdadchi; Saharnaz,18,0,20,2
1649835671520,ECE 101,A01,084053,Baghdadchi; Saharnaz,25,0,37,12
1649835671520,ECE 101,A02,084054,Baghdadchi; Saharnaz,37,0,37,0
1649835677549,ECE 107,A01,083390,Staff,32,0,40,8
1649835683577,ECE 148,A01,084056,Silberman; Jack,8,0,12,4
1649835689602,ECE 180,A00,083391,Abi Samra; Nicholas Camill,27,0,30,3
1649835689602,ECE 180,B00,083392,Abi Samra; Nicholas Camill,26,0,30,4
1649835695634,MATH 10B,A01,084110,Staff,20,0,30,10
1649835695634,MATH 10B,A02,084111,Staff,29,0,30,1
1649835695634,MATH 10B,A03,084112,Staff,29,0,30,1
1649835701664,MATH 10C,A01,083443,Staff,19,0,30,11
1649835701664,MATH 10C,A02,083444,Staff,24,0,30,6
1649835701664,MATH 10C,B01,084114,Staff,26,0,30,4
1649835701664,MATH 10C,B02,084115,Staff,30,0,30,0
1649835707688,MATH 18,A01,084117,Harel; Guershon,28,0,30,2
1649835707688,MATH 18,A02,084119,Harel; Guershon,29,0,30,1
1649835707688,MATH 18,A03,084120,Harel; Guershon,30,0,30,0
1649835707688,MATH 18,A04,084121,Harel; Guershon,30,0,30,0
1649835713720,MATH 20B,A01,084124,Um; Ko Woon,33,0,35,2
1649835713720,MATH 20B,B01,084126,Um; Ko Woon,35,0,35,0
1649835719749,MATH 20C,A01,083446,Hammock; Frances H,26,0,30,4
1649835719749,MATH 20C,A02,083447,Hammock; Frances H,30,0,30,0
1649835719749,MATH 20C,A03,083448,Hammock; Frances H,30,0,30,0
1649835719749,MATH 20C,A04,083449,Hammock; Frances H,30,0,30,0
1649835719749,MATH 20C,B01,083451,Hammock; Frances H,29,0,30,1
1649835719749,MATH 20C,B02,083452,Hammock; Frances H,30,0,30,0
1649835719749,MATH 20C,B03,083453,Hammock; Frances H,30,0,30,0
1649835719749,MATH 20C,B04,083454,Hammock; Frances H,30,0,30,0
1649835725780,MATH 20D,A01,084128,Staff,29,0,30,1
1649835725780,MATH 20D,A02,084129,Staff,30,0,30,0
1649835725780,MATH 20D,A03,084130,Staff,29,0,30,1
1649835725780,MATH 20D,B01,084133,Staff,28,0,30,2
1649835725780,MATH 20D,B02,084134,Staff,30,0,30,0
1649835725780,MATH 20D,B03,084135,Staff,30,0,30,0
1649835731812,MATH 20E,A01,084138,Staff,28,0,30,2
1649835731812,MATH 20E,A02,084139,Staff,29,0,30,1
1649835731812,MATH 20E,A03,084140,Staff,28,0,30,2
1649835731812,MATH 20E,A04,084141,Staff,30,0,30,0
1649835737836,MATH 102,A01,084143,Harel; Guershon,24,0,30,6
1649835737836,MATH 102,A02,084144,Harel; Guershon,25,0,30,5
1649835743863,MATH 103B,A01,083456,Staff,0,0,30,30
1649835743863,MATH 103B,A02,083457,Staff,19,0,30,11
1649835749894,MATH 109,A01,084146,Salehi Golsefidy; Alireza,30,0,30,0
1649835749894,MATH 109,A02,084147,Salehi Golsefidy; Alireza,27,0,30,3
1649835755920,MATH 120A,A01,085445,Eggers; John Dietrich,30,0,35,5
1649835755920,MATH 120A,A02,085446,Eggers; John Dietrich,31,0,35,4
1649835761949,MATH 142B,A01,084149,Verstraete; Jacques Allan,7,0,30,23
1649835761949,MATH 142B,A02,084150,Verstraete; Jacques Allan,25,0,30,5
1649835767978,MATH 170A,A01,083459,Nie; Jiawang,10,0,30,20
1649835767978,MATH 170A,A02,083460,Nie; Jiawang,25,0,30,5
1649835767978,MATH 170A,A03,083461,Nie; Jiawang,26,0,30,4
1649835774001,MATH 193B,A01,083463,Staff,15,0,30,15
1649835774001,MATH 193B,A02,083464,Staff,19,0,30,11
1649835774001,MATH 193B,A03,083465,Staff,27,0,30,3
1649835780083,COGS 2,A01,083966,Boyle; Mary E. T.,27,0,30,3
1649835786111,COGS 9,A01,083968,Staff,56,0,60,4
1649835792136,COGS 14B,A01,083970,Staff,46,0,50,4
1649835798160,COGS 17,A01,092679,Staff,73,0,75,2
1649835804185,COGS 100,A01,083972,Staff,46,0,60,14
1649835816243,COGS 101C,A01,083976,Staff,25,0,30,5
1649835822271,COGS 102A,A01,083978,Johnson; Christine M.,24,0,30,6
1649835828296,COGS 107B,A01,083980,Staff,34,0,50,16
1649835834320,COGS 115,A01,083982,Staff,22,0,30,8
1649835840348,COGS 118B,A01,083367,Staff,5,0,40,35
1649835846394,COGS 172,A01,083984,Provenzano; Emily Kara,21,0,30,9
1649835852417,COGS 177,A00,083368,Staff,4,0,30,26
1649835858443,COGS 186,A01,083986,Staff,25,0,40,15
1649835864469,COGS 187A,A01,083988,Boyle; Mary E. T.,41,0,60,19
1649835870499,CSE 8A,A50,084003,Miranda; Gregory Joseph,9,0,15,6
1649835876529,CSE 11,A01,084005,Miranda; Gregory Joseph,49,0,55,6
1649835882554,CSE 20,A01,084007,Staff,15,0,20,5
1649835888584,CSE 21,A01,084009,Staff,32,0,50,18
1649835894612,CSE 30,A01,083370,Cao; Yingjun,20,0,40,20
1649835900639,CSE 100,A01,083372,Cao; Yingjun,13,0,40,27
1649835906669,CSE 101,A01,084011,Staff,0,15,40,40
1649835912697,CSE 141,A01,083374,Eldon; John,0,13,75,75
1649835918722,CSE 141L,A01,083376,Eldon; John,0,16,75,75
1649835924746,CSE 175,A01,084013,Kumar; Rakesh,24,0,25,1
1649835930769,CSE 190,A00,092508,Staff,15,0,15,0
1649835936800,ECE 5,A01,084049,Morris; Karcher William,17,0,20,3
1649835942833,ECE 100,A01,084051,Baghdadchi; Saharnaz,16,0,20,4
1649835942833,ECE 100,A02,091916,Baghdadchi; Saharnaz,18,0,20,2
1649835948869,ECE 101,A01,084053,Baghdadchi; Saharnaz,25,0,37,12
1649835948869,ECE 101,A02,084054,Baghdadchi; Saharnaz,37,0,37,0
1649835954894,ECE 107,A01,083390,Staff,32,0,40,8
1649835960945,ECE 148,A01,084056,Silberman; Jack,8,0,12,4
1649835966976,ECE 180,A00,083391,Abi Samra; Nicholas Camill,27,0,30,3
1649835966976,ECE 180,B00,083392,Abi Samra; Nicholas Camill,26,0,30,4
1649835973008,MATH 10B,A01,084110,Staff,20,0,30,10
1649835973008,MATH 10B,A02,084111,Staff,29,0,30,1
1649835973008,MATH 10B,A03,084112,Staff,29,0,30,1
1649835979033,MATH 10C,A01,083443,Staff,19,0,30,11
1649835979033,MATH 10C,A02,083444,Staff,24,0,30,6
1649835979033,MATH 10C,B01,084114,Staff,26,0,30,4
1649835979033,MATH 10C,B02,084115,Staff,30,0,30,0
1649835985059,MATH 18,A01,084117,Harel; Guershon,28,0,30,2
1649835985059,MATH 18,A02,084119,Harel; Guershon,29,0,30,1
1649835985059,MATH 18,A03,084120,Harel; Guershon,30,0,30,0
1649835985059,MATH 18,A04,084121,Harel; Guershon,30,0,30,0
1649835991084,MATH 20B,A01,084124,Um; Ko Woon,33,0,35,2
1649835991084,MATH 20B,B01,084126,Um; Ko Woon,35,0,35,0
1649835997111,MATH 20C,A01,083446,Hammock; Frances H,26,0,30,4
1649835997111,MATH 20C,A02,083447,Hammock; Frances H,30,0,30,0
1649835997111,MATH 20C,A03,083448,Hammock; Frances H,30,0,30,0
1649835997111,MATH 20C,A04,083449,Hammock; Frances H,30,0,30,0
1649835997111,MATH 20C,B01,083451,Hammock; Frances H,29,0,30,1
1649835997111,MATH 20C,B02,083452,Hammock; Frances H,30,0,30,0
1649835997111,MATH 20C,B03,083453,Hammock; Frances H,30,0,30,0
1649835997111,MATH 20C,B04,083454,Hammock; Frances H,30,0,30,0
1649836003138,MATH 20D,A01,084128,Staff,29,0,30,1
1649836003138,MATH 20D,A02,084129,Staff,30,0,30,0
1649836003138,MATH 20D,A03,084130,Staff,29,0,30,1
1649836003138,MATH 20D,B01,084133,Staff,28,0,30,2
1649836003138,MATH 20D,B02,084134,Staff,30,0,30,0
1649836003138,MATH 20D,B03,084135,Staff,30,0,30,0
1649836009261,MATH 20E,A01,084138,Staff,28,0,30,2
1649836009261,MATH 20E,A02,084139,Staff,29,0,30,1
1649836009261,MATH 20E,A03,084140,Staff,28,0,30,2
1649836009261,MATH 20E,A04,084141,Staff,30,0,30,0
1649836015292,MATH 102,A01,084143,Harel; Guershon,24,0,30,6
1649836015292,MATH 102,A02,084144,Harel; Guershon,25,0,30,5
1649836021326,MATH 103B,A01,083456,Staff,0,0,30,30
1649836021326,MATH 103B,A02,083457,Staff,19,0,30,11
1649836027357,MATH 109,A01,084146,Salehi Golsefidy; Alireza,30,0,30,0
1649836027357,MATH 109,A02,084147,Salehi Golsefidy; Alireza,27,0,30,3
1649836033389,MATH 120A,A01,085445,Eggers; John Dietrich,30,0,35,5
1649836033389,MATH 120A,A02,085446,Eggers; John Dietrich,31,0,35,4
1649836039414,MATH 142B,A01,084149,Verstraete; Jacques Allan,7,0,30,23
1649836039414,MATH 142B,A02,084150,Verstraete; Jacques Allan,25,0,30,5
1649836045440,MATH 170A,A01,083459,Nie; Jiawang,10,0,30,20
1649836045440,MATH 170A,A02,083460,Nie; Jiawang,25,0,30,5
1649836045440,MATH 170A,A03,083461,Nie; Jiawang,26,0,30,4
1649836051470,MATH 193B,A01,083463,Staff,15,0,30,15
1649836051470,MATH 193B,A02,083464,Staff,19,0,30,11
1649836051470,MATH 193B,A03,083465,Staff,27,0,30,3
1649836057538,COGS 2,A01,083966,Boyle; Mary E. T.,27,0,30,3
1649836063561,COGS 9,A01,083968,Staff,56,0,60,4
1649836069588,COGS 14B,A01,083970,Staff,46,0,50,4
1649836075617,COGS 17,A01,092679,Staff,73,0,75,2
1649836081646,COGS 100,A01,083972,Staff,46,0,60,14
1649836093703,COGS 101C,A01,083976,Staff,25,0,30,5
1649836099727,COGS 102A,A01,083978,Johnson; Christine M.,24,0,30,6
1649836105755,COGS 107B,A01,083980,Staff,34,0,50,16
1649836111778,COGS 115,A01,083982,Staff,22,0,30,8
1649836117814,COGS 118B,A01,083367,Staff,5,0,40,35
1649836123851,COGS 172,A01,083984,Provenzano; Emily Kara,21,0,30,9
1649836129876,COGS 177,A00,083368,Staff,4,0,30,26
1649836135901,COGS 186,A01,083986,Staff,25,0,40,15
1649836141930,COGS 187A,A01,083988,Boyle; Mary E. T.,40,0,60,20
1649836147957,CSE 8A,A50,084003,Miranda; Gregory Joseph,9,0,15,6
1649836153981,CSE 11,A01,084005,Miranda; Gregory Joseph,49,0,55,6
1649836160007,CSE 20,A01,084007,Staff,15,0,20,5
1649836166033,CSE 21,A01,084009,Staff,32,0,50,18
1649836172061,CSE 30,A01,083370,Cao; Yingjun,20,0,40,20
1649836178083,CSE 100,A01,083372,Cao; Yingjun,13,0,40,27
1649836184108,CSE 101,A01,084011,Staff,0,15,40,40
1649836190132,CSE 141,A01,083374,Eldon; John,0,13,75,75
1649836196157,CSE 141L,A01,083376,Eldon; John,0,16,75,75
1649836202199,CSE 175,A01,084013,Kumar; Rakesh,24,0,25,1
1649836208224,CSE 190,A00,092508,Staff,15,0,15,0
1649836214254,ECE 5,A01,084049,Morris; Karcher William,17,0,20,3
1649836220279,ECE 100,A01,084051,Baghdadchi; Saharnaz,16,0,20,4
1649836220279,ECE 100,A02,091916,Baghdadchi; Saharnaz,18,0,20,2
1649836226304,ECE 101,A01,084053,Baghdadchi; Saharnaz,25,0,37,12
1649836226304,ECE 101,A02,084054,Baghdadchi; Saharnaz,37,0,37,0
1649836232331,ECE 107,A01,083390,Staff,32,0,40,8
1649836238363,ECE 148,A01,084056,Silberman; Jack,8,0,12,4
1649836244392,ECE 180,A00,083391,Abi Samra; Nicholas Camill,27,0,30,3
1649836244392,ECE 180,B00,083392,Abi Samra; Nicholas Camill,26,0,30,4
1649836250423,MATH 10B,A01,084110,Staff,20,0,30,10
1649836250423,MATH 10B,A02,084111,Staff,29,0,30,1
1649836250423,MATH 10B,A03,084112,Staff,29,0,30,1
1649836256455,MATH 10C,A01,083443,Staff,19,0,30,11
1649836256455,MATH 10C,A02,083444,Staff,24,0,30,6
1649836256455,MATH 10C,B01,084114,Staff,26,0,30,4
1649836256455,MATH 10C,B02,084115,Staff,30,0,30,0
1649836262480,MATH 18,A01,084117,Harel; Guershon,28,0,30,2
1649836262480,MATH 18,A02,084119,Harel; Guershon,29,0,30,1
1649836262480,MATH 18,A03,084120,Harel; Guershon,30,0,30,0
1649836262480,MATH 18,A04,084121,Harel; Guershon,30,0,30,0
1649836268507,MATH 20B,A01,084124,Um; Ko Woon,33,0,35,2
1649836268507,MATH 20B,B01,084126,Um; Ko Woon,35,0,35,0
1649836274539,MATH 20C,A01,083446,Hammock; Frances H,26,0,30,4
1649836274539,MATH 20C,A02,083447,Hammock; Frances H,30,0,30,0
1649836274539,MATH 20C,A03,083448,Hammock; Frances H,30,0,30,0
1649836274539,MATH 20C,A04,083449,Hammock; Frances H,30,0,30,0
1649836274539,MATH 20C,B01,083451,Hammock; Frances H,29,0,30,1
1649836274539,MATH 20C,B02,083452,Hammock; Frances H,30,0,30,0
1649836274539,MATH 20C,B03,083453,Hammock; Frances H,30,0,30,0
1649836274539,MATH 20C,B04,083454,Hammock; Frances H,30,0,30,0
1649836280573,MATH 20D,A01,084128,Staff,29,0,30,1
1649836280573,MATH 20D,A02,084129,Staff,30,0,30,0
1649836280573,MATH 20D,A03,084130,Staff,29,0,30,1
1649836280573,MATH 20D,B01,084133,Staff,28,0,30,2
1649836280573,MATH 20D,B02,084134,Staff,30,0,30,0
1649836280573,MATH 20D,B03,084135,Staff,30,0,30,0
1649836286605,MATH 20E,A01,084138,Staff,28,0,30,2
1649836286605,MATH 20E,A02,084139,Staff,29,0,30,1
1649836286605,MATH 20E,A03,084140,Staff,28,0,30,2
1649836286605,MATH 20E,A04,084141,Staff,30,0,30,0
1649836292628,MATH 102,A01,084143,Harel; Guershon,24,0,30,6
1649836292628,MATH 102,A02,084144,Harel; Guershon,25,0,30,5
1649836298653,MATH 103B,A01,083456,Staff,0,0,30,30
1649836298653,MATH 103B,A02,083457,Staff,19,0,30,11
1649836304689,MATH 109,A01,084146,Salehi Golsefidy; Alireza,30,0,30,0
1649836304689,MATH 109,A02,084147,Salehi Golsefidy; Alireza,27,0,30,3
1649836310720,MATH 120A,A01,085445,Eggers; John Dietrich,30,0,35,5
1649836310720,MATH 120A,A02,085446,Eggers; John Dietrich,31,0,35,4
1649836316750,MATH 142B,A01,084149,Verstraete; Jacques Allan,7,0,30,23
1649836316750,MATH 142B,A02,084150,Verstraete; Jacques Allan,25,0,30,5
1649836322781,MATH 170A,A01,083459,Nie; Jiawang,10,0,30,20
1649836322781,MATH 170A,A02,083460,Nie; Jiawang,25,0,30,5
1649836322781,MATH 170A,A03,083461,Nie; Jiawang,26,0,30,4
1649836328808,MATH 193B,A01,083463,Staff,15,0,30,15
1649836328808,MATH 193B,A02,083464,Staff,19,0,30,11
1649836328808,MATH 193B,A03,083465,Staff,27,0,30,3
1649836334889,COGS 2,A01,083966,Boyle; Mary E. T.,27,0,30,3
1649836340917,COGS 9,A01,083968,Staff,56,0,60,4
1649836346943,COGS 14B,A01,083970,Staff,46,0,50,4
1649836352972,COGS 17,A01,092679,Staff,73,0,75,2
1649836358994,COGS 100,A01,083972,Staff,46,0,60,14
1649836371049,COGS 101C,A01,083976,Staff,25,0,30,5
1649836377073,COGS 102A,A01,083978,Johnson; Christine M.,24,0,30,6
1649836383109,COGS 107B,A01,083980,Staff,34,0,50,16
1649836389137,COGS 115,A01,083982,Staff,22,0,30,8
1649836395159,COGS 118B,A01,083367,Staff,5,0,40,35
1649836401199,COGS 172,A01,083984,Provenzano; Emily Kara,21,0,30,9
1649836407223,COGS 177,A00,083368,Staff,4,0,30,26
1649836413254,COGS 186,A01,083986,Staff,25,0,40,15
1649836419278,COGS 187A,A01,083988,Boyle; Mary E. T.,40,0,60,20
1649836425308,CSE 8A,A50,084003,Miranda; Gregory Joseph,9,0,15,6
1649836431334,CSE 11,A01,084005,Miranda; Gregory Joseph,49,0,55,6
1649836437358,CSE 20,A01,084007,Staff,15,0,20,5
1649836443390,CSE 21,A01,084009,Staff,32,0,50,18
1649836449417,CSE 30,A01,083370,Cao; Yingjun,20,0,40,20
1649836455450,CSE 100,A01,083372,Cao; Yingjun,13,0,40,27
1649836461474,CSE 101,A01,084011,Staff,0,16,40,40
1649836467503,CSE 141,A01,083374,Eldon; John,0,13,75,75
1649836473526,CSE 141L,A01,083376,Eldon; John,0,16,75,75
1649836479555,CSE 175,A01,084013,Kumar; Rakesh,24,0,25,1
1649836485580,CSE 190,A00,092508,Staff,15,0,15,0
1649836491608,ECE 5,A01,084049,Morris; Karcher William,17,0,20,3
1649836497642,ECE 100,A01,084051,Baghdadchi; Saharnaz,16,0,20,4
1649836497642,ECE 100,A02,091916,Baghdadchi; Saharnaz,18,0,20,2
1649836503676,ECE 101,A01,084053,Baghdadchi; Saharnaz,25,0,37,12
1649836503676,ECE 101,A02,084054,Baghdadchi; Saharnaz,37,0,37,0
1649836509703,ECE 107,A01,083390,Staff,32,0,40,8
1649836515740,ECE 148,A01,084056,Silberman; Jack,8,0,12,4
1649836521770,ECE 180,A00,083391,Abi Samra; Nicholas Camill,27,0,30,3
1649836521770,ECE 180,B00,083392,Abi Samra; Nicholas Camill,26,0,30,4
1649836527800,MATH 10B,A01,084110,Staff,20,0,30,10
1649836527800,MATH 10B,A02,084111,Staff,29,0,30,1
1649836527800,MATH 10B,A03,084112,Staff,29,0,30,1
1649836533834,MATH 10C,A01,083443,Staff,19,0,30,11
1649836533834,MATH 10C,A02,083444,Staff,24,0,30,6
1649836533834,MATH 10C,B01,084114,Staff,26,0,30,4
1649836533834,MATH 10C,B02,084115,Staff,30,0,30,0
1649836539858,MATH 18,A01,084117,Harel; Guershon,28,0,30,2
1649836539858,MATH 18,A02,084119,Harel; Guershon,29,0,30,1
1649836539858,MATH 18,A03,084120,Harel; Guershon,30,0,30,0
1649836539858,MATH 18,A04,084121,Harel; Guershon,30,0,30,0
1649836545883,MATH 20B,A01,084124,Um; Ko Woon,33,0,35,2
1649836545883,MATH 20B,B01,084126,Um; Ko Woon,35,0,35,0
1649836551915,MATH 20C,A01,083446,Hammock; Frances H,26,0,30,4
1649836551915,MATH 20C,A02,083447,Hammock; Frances H,30,0,30,0
1649836551915,MATH 20C,A03,083448,Hammock; Frances H,30,0,30,0
1649836551915,MATH 20C,A04,083449,Hammock; Frances H,30,0,30,0
1649836551915,MATH 20C,B01,083451,Hammock; Frances H,29,0,30,1
1649836551915,MATH 20C,B02,083452,Hammock; Frances H,30,0,30,0
1649836551915,MATH 20C,B03,083453,Hammock; Frances H,30,0,30,0
1649836551915,MATH 20C,B04,083454,Hammock; Frances H,30,0,30,0
1649836557939,MATH 20D,A01,084128,Staff,29,0,30,1
1649836557939,MATH 20D,A02,084129,Staff,30,0,30,0
1649836557939,MATH 20D,A03,084130,Staff,29,0,30,1
1649836557939,MATH 20D,B01,084133,Staff,28,0,30,2
1649836557939,MATH 20D,B02,084134,Staff,30,0,30,0
1649836557939,MATH 20D,B03,084135,Staff,30,0,30,0
1649836563970,MATH 20E,A01,084138,Staff,28,0,30,2
1649836563970,MATH 20E,A02,084139,Staff,29,0,30,1
1649836563970,MATH 20E,A03,084140,Staff,28,0,30,2
1649836563970,MATH 20E,A04,084141,Staff,30,0,30,0
1649836569999,MATH 102,A01,084143,Harel; Guershon,24,0,30,6
1649836569999,MATH 102,A02,084144,Harel; Guershon,25,0,30,5
1649836576025,MATH 103B,A01,083456,Staff,0,0,30,30
1649836576025,MATH 103B,A02,083457,Staff,19,0,30,11
1649836582053,MATH 109,A01,084146,Salehi Golsefidy; Alireza,30,0,30,0
1649836582053,MATH 109,A02,084147,Salehi Golsefidy; Alireza,27,0,30,3
1649836588078,MATH 120A,A01,085445,Eggers; John Dietrich,30,0,35,5
1649836588078,MATH 120A,A02,085446,Eggers; John Dietrich,31,0,35,4
1649836594110,MATH 142B,A01,084149,Verstraete; Jacques Allan,7,0,30,23
1649836594110,MATH 142B,A02,084150,Verstraete; Jacques Allan,25,0,30,5
1649836600136,MATH 170A,A01,083459,Nie; Jiawang,9,0,30,21
1649836600136,MATH 170A,A02,083460,Nie; Jiawang,25,0,30,5
1649836600136,MATH 170A,A03,083461,Nie; Jiawang,26,0,30,4
1649836606249,MATH 193B,A01,083463,Staff,15,0,30,15
1649836606249,MATH 193B,A02,083464,Staff,19,0,30,11
1649836606249,MATH 193B,A03,083465,Staff,27,0,30,3
1649836612346,COGS 2,A01,083966,Boyle; Mary E. T.,27,0,30,3
1649836618384,COGS 9,A01,083968,Staff,56,0,60,4
1649836624413,COGS 14B,A01,083970,Staff,46,0,50,4
1649836630443,COGS 17,A01,092679,Staff,73,0,75,2
1649836636468,COGS 100,A01,083972,Staff,46,0,60,14
1649836648529,COGS 101C,A01,083976,Staff,25,0,30,5
1649836654555,COGS 102A,A01,083978,Johnson; Christine M.,24,0,30,6
1649836660584,COGS 107B,A01,083980,Staff,34,0,50,16
1649836666608,COGS 115,A01,083982,Staff,22,0,30,8
1649836672633,COGS 118B,A01,083367,Staff,5,0,40,35
1649836678663,COGS 172,A01,083984,Provenzano; Emily Kara,21,0,30,9
1649836684692,COGS 177,A00,083368,Staff,4,0,30,26
1649836690720,COGS 186,A01,083986,Staff,25,0,40,15
1649836696752,COGS 187A,A01,083988,Boyle; Mary E. T.,40,0,60,20
1649836702784,CSE 8A,A50,084003,Miranda; Gregory Joseph,9,0,15,6
1649836708810,CSE 11,A01,084005,Miranda; Gregory Joseph,49,0,55,6
1649836714856,CSE 20,A01,084007,Staff,15,0,20,5
1649836720885,CSE 21,A01,084009,Staff,32,0,50,18
1649836726909,CSE 30,A01,083370,Cao; Yingjun,20,0,40,20
1649836732938,CSE 100,A01,083372,Cao; Yingjun,13,0,40,27
1649836738968,CSE 101,A01,084011,Staff,0,16,40,40
1649836744991,CSE 141,A01,083374,Eldon; John,0,13,75,75
1649836751016,CSE 141L,A01,083376,Eldon; John,0,16,75,75
1649836757052,CSE 175,A01,084013,Kumar; Rakesh,24,0,25,1
1649836763083,CSE 190,A00,092508,Staff,15,0,15,0
1649836769119,ECE 5,A01,084049,Morris; Karcher William,17,0,20,3
1649836775149,ECE 100,A01,084051,Baghdadchi; Saharnaz,16,0,20,4
1649836775149,ECE 100,A02,091916,Baghdadchi; Saharnaz,18,0,20,2
1649836781179,ECE 101,A01,084053,Baghdadchi; Saharnaz,25,0,37,12
1649836781179,ECE 101,A02,084054,Baghdadchi; Saharnaz,37,0,37,0
1649836787212,ECE 107,A01,083390,Staff,32,0,40,8
1649836793247,ECE 148,A01,084056,Silberman; Jack,8,0,12,4
1649836799280,ECE 180,A00,083391,Abi Samra; Nicholas Camill,27,0,30,3
1649836799280,ECE 180,B00,083392,Abi Samra; Nicholas Camill,26,0,30,4
1649836805309,MATH 10B,A01,084110,Staff,20,0,30,10
1649836805309,MATH 10B,A02,084111,Staff,29,0,30,1
1649836805309,MATH 10B,A03,084112,Staff,29,0,30,1
1649836811335,MATH 10C,A01,083443,Staff,19,0,30,11
1649836811335,MATH 10C,A02,083444,Staff,24,0,30,6
1649836811335,MATH 10C,B01,084114,Staff,26,0,30,4
1649836811335,MATH 10C,B02,084115,Staff,30,0,30,0
1649836817361,MATH 18,A01,084117,Harel; Guershon,28,0,30,2
1649836817361,MATH 18,A02,084119,Harel; Guershon,29,0,30,1
1649836817361,MATH 18,A03,084120,Harel; Guershon,30,0,30,0
1649836817361,MATH 18,A04,084121,Harel; Guershon,30,0,30,0
1649836823397,MATH 20B,A01,084124,Um; Ko Woon,33,0,35,2
1649836823397,MATH 20B,B01,084126,Um; Ko Woon,35,0,35,0
1649836829429,MATH 20C,A01,083446,Hammock; Frances H,26,0,30,4
1649836829429,MATH 20C,A02,083447,Hammock; Frances H,30,0,30,0
1649836829429,MATH 20C,A03,083448,Hammock; Frances H,30,0,30,0
1649836829429,MATH 20C,A04,083449,Hammock; Frances H,30,0,30,0
1649836829429,MATH 20C,B01,083451,Hammock; Frances H,29,0,30,1
1649836829429,MATH 20C,B02,083452,Hammock; Frances H,30,0,30,0
1649836829429,MATH 20C,B03,083453,Hammock; Frances H,30,0,30,0
1649836829429,MATH 20C,B04,083454,Hammock; Frances H,30,0,30,0
1649836835465,MATH 20D,A01,084128,Staff,29,0,30,1
1649836835465,MATH 20D,A02,084129,Staff,30,0,30,0
1649836835465,MATH 20D,A03,084130,Staff,29,0,30,1
1649836835465,MATH 20D,B01,084133,Staff,28,0,30,2
1649836835465,MATH 20D,B02,084134,Staff,30,0,30,0
1649836835465,MATH 20D,B03,084135,Staff,30,0,30,0
1649836841493,MATH 20E,A01,084138,Staff,28,0,30,2
1649836841493,MATH 20E,A02,084139,Staff,29,0,30,1
1649836841493,MATH 20E,A03,084140,Staff,28,0,30,2
1649836841493,MATH 20E,A04,084141,Staff,30,0,30,0
1649836847518,MATH 102,A01,084143,Harel; Guershon,24,0,30,6
1649836847518,MATH 102,A02,084144,Harel; Guershon,25,0,30,5
1649836853543,MATH 103B,A01,083456,Staff,0,0,30,30
1649836853543,MATH 103B,A02,083457,Staff,19,0,30,11
1649836859568,MATH 109,A01,084146,Salehi Golsefidy; Alireza,30,0,30,0
1649836859568,MATH 109,A02,084147,Salehi Golsefidy; Alireza,27,0,30,3
1649836865603,MATH 120A,A01,085445,Eggers; John Dietrich,30,0,35,5
1649836865603,MATH 120A,A02,085446,Eggers; John Dietrich,31,0,35,4
1649836871642,MATH 142B,A01,084149,Verstraete; Jacques Allan,7,0,30,23
1649836871642,MATH 142B,A02,084150,Verstraete; Jacques Allan,25,0,30,5
1649836877670,MATH 170A,A01,083459,Nie; Jiawang,9,0,30,21
1649836877670,MATH 170A,A02,083460,Nie; Jiawang,25,0,30,5
1649836877670,MATH 170A,A03,083461,Nie; Jiawang,26,0,30,4
1649836883694,MATH 193B,A01,083463,Staff,15,0,30,15
1649836883694,MATH 193B,A02,083464,Staff,19,0,30,11
1649836883694,MATH 193B,A03,083465,Staff,27,0,30,3
1649836889775,COGS 2,A01,083966,Boyle; Mary E. T.,27,0,30,3
1649836895800,COGS 9,A01,083968,Staff,56,0,60,4
1649836901825,COGS 14B,A01,083970,Staff,46,0,50,4
1649836907855,COGS 17,A01,092679,Staff,73,0,75,2
1649836913881,COGS 100,A01,083972,Staff,46,0,60,14
1649836925938,COGS 101C,A01,083976,Staff,25,0,30,5
1649836931962,COGS 102A,A01,083978,Johnson; Christine M.,24,0,30,6
1649836937985,COGS 107B,A01,083980,Staff,34,0,50,16
1649836944018,COGS 115,A01,083982,Staff,22,0,30,8
1649836950049,COGS 118B,A01,083367,Staff,5,0,40,35
1649836956074,COGS 172,A01,083984,Provenzano; Emily Kara,21,0,30,9
1649836962101,COGS 177,A00,083368,Staff,4,0,30,26
1649836968128,COGS 186,A01,083986,Staff,25,0,40,15
1649836974153,COGS 187A,A01,083988,Boyle; Mary E. T.,40,0,60,20
1649836980178,CSE 8A,A50,084003,Miranda; Gregory Joseph,9,0,15,6
1649836986205,CSE 11,A01,084005,Miranda; Gregory Joseph,49,0,55,6
1649836992230,CSE 20,A01,084007,Staff,15,0,20,5
1649836998254,CSE 21,A01,084009,Staff,32,0,50,18
1649837004279,CSE 30,A01,083370,Cao; Yingjun,20,0,40,20
1649837010309,CSE 100,A01,083372,Cao; Yingjun,13,0,40,27
1649837016333,CSE 101,A01,084011,Staff,0,16,40,40
1649837022358,CSE 141,A01,083374,Eldon; John,0,13,75,75
1649837028389,CSE 141L,A01,083376,Eldon; John,0,16,75,75
1649837034417,CSE 175,A01,084013,Kumar; Rakesh,24,0,25,1
1649837040448,CSE 190,A00,092508,Staff,15,0,15,0
1649837046481,ECE 5,A01,084049,Morris; Karcher William,17,0,20,3
1649837052511,ECE 100,A01,084051,Baghdadchi; Saharnaz,16,0,20,4
1649837052511,ECE 100,A02,091916,Baghdadchi; Saharnaz,18,0,20,2
1649837058535,ECE 101,A01,084053,Baghdadchi; Saharnaz,25,0,37,12
1649837058535,ECE 101,A02,084054,Baghdadchi; Saharnaz,37,0,37,0
1649837064560,ECE 107,A01,083390,Staff,32,0,40,8
1649837070586,ECE 148,A01,084056,Silberman; Jack,8,0,12,4
1649837076610,ECE 180,A00,083391,Abi Samra; Nicholas Camill,27,0,30,3
1649837076610,ECE 180,B00,083392,Abi Samra; Nicholas Camill,26,0,30,4
1649837082635,MATH 10B,A01,084110,Staff,20,0,30,10
1649837082635,MATH 10B,A02,084111,Staff,29,0,30,1
1649837082635,MATH 10B,A03,084112,Staff,29,0,30,1
1649837088664,MATH 10C,A01,083443,Staff,19,0,30,11
1649837088664,MATH 10C,A02,083444,Staff,24,0,30,6
1649837088664,MATH 10C,B01,084114,Staff,26,0,30,4
1649837088664,MATH 10C,B02,084115,Staff,30,0,30,0
1649837094689,MATH 18,A01,084117,Harel; Guershon,28,0,30,2
1649837094689,MATH 18,A02,084119,Harel; Guershon,29,0,30,1
1649837094689,MATH 18,A03,084120,Harel; Guershon,30,0,30,0
1649837094689,MATH 18,A04,084121,Harel; Guershon,30,0,30,0
1649837100715,MATH 20B,A01,084124,Um; Ko Woon,33,0,35,2
1649837100715,MATH 20B,B01,084126,Um; Ko Woon,35,0,35,0
1649837106742,MATH 20C,A01,083446,Hammock; Frances H,26,0,30,4
1649837106742,MATH 20C,A02,083447,Hammock; Frances H,30,0,30,0
1649837106742,MATH 20C,A03,083448,Hammock; Frances H,30,0,30,0
1649837106742,MATH 20C,A04,083449,Hammock; Frances H,30,0,30,0
1649837106742,MATH 20C,B01,083451,Hammock; Frances H,29,0,30,1
1649837106742,MATH 20C,B02,083452,Hammock; Frances H,30,0,30,0
1649837106742,MATH 20C,B03,083453,Hammock; Frances H,30,0,30,0
1649837106742,MATH 20C,B04,083454,Hammock; Frances H,30,0,30,0
1649837112766,MATH 20D,A01,084128,Staff,29,0,30,1
1649837112766,MATH 20D,A02,084129,Staff,30,0,30,0
1649837112766,MATH 20D,A03,084130,Staff,29,0,30,1
1649837112766,MATH 20D,B01,084133,Staff,28,0,30,2
1649837112766,MATH 20D,B02,084134,Staff,30,0,30,0
1649837112766,MATH 20D,B03,084135,Staff,30,0,30,0
1649837118791,MATH 20E,A01,084138,Staff,28,0,30,2
1649837118791,MATH 20E,A02,084139,Staff,29,0,30,1
1649837118791,MATH 20E,A03,084140,Staff,28,0,30,2
1649837118791,MATH 20E,A04,084141,Staff,30,0,30,0
1649837124816,MATH 102,A01,084143,Harel; Guershon,24,0,30,6
1649837124816,MATH 102,A02,084144,Harel; Guershon,25,0,30,5
1649837130840,MATH 103B,A01,083456,Staff,0,0,30,30
1649837130840,MATH 103B,A02,083457,Staff,19,0,30,11
1649837136864,MATH 109,A01,084146,Salehi Golsefidy; Alireza,30,0,30,0
1649837136864,MATH 109,A02,084147,Salehi Golsefidy; Alireza,27,0,30,3
1649837142894,MATH 120A,A01,085445,Eggers; John Dietrich,30,0,35,5
1649837142894,MATH 120A,A02,085446,Eggers; John Dietrich,31,0,35,4
1649837148919,MATH 142B,A01,084149,Verstraete; Jacques Allan,7,0,30,23
1649837148919,MATH 142B,A02,084150,Verstraete; Jacques Allan,25,0,30,5
1649837154944,MATH 170A,A01,083459,Nie; Jiawang,9,0,30,21
1649837154944,MATH 170A,A02,083460,Nie; Jiawang,25,0,30,5
1649837154944,MATH 170A,A03,083461,Nie; Jiawang,26,0,30,4
1649837160975,MATH 193B,A01,083463,Staff,15,0,30,15
1649837160975,MATH 193B,A02,083464,Staff,19,0,30,11
1649837160975,MATH 193B,A03,083465,Staff,27,0,30,3
1649837167032,COGS 2,A01,083966,Boyle; Mary E. T.,27,0,30,3
1649837173063,COGS 9,A01,083968,Staff,56,0,60,4
1649837179089,COGS 14B,A01,083970,Staff,46,0,50,4
1649837185113,COGS 17,A01,092679,Staff,73,0,75,2
1649837191140,COGS 100,A01,083972,Staff,46,0,60,14
1649837203280,COGS 101C,A01,083976,Staff,25,0,30,5
1649837209313,COGS 102A,A01,083978,Johnson; Christine M.,24,0,30,6
1649837215336,COGS 107B,A01,083980,Staff,34,0,50,16
1649837221359,COGS 115,A01,083982,Staff,22,0,30,8
1649837227381,COGS 118B,A01,083367,Staff,5,0,40,35
1649837233412,COGS 172,A01,083984,Provenzano; Emily Kara,21,0,30,9
1649837239435,COGS 177,A00,083368,Staff,4,0,30,26
1649837245460,COGS 186,A01,083986,Staff,25,0,40,15
1649837251484,COGS 187A,A01,083988,Boyle; Mary E. T.,40,0,60,20
1649837257513,CSE 8A,A50,084003,Miranda; Gregory Joseph,9,0,15,6
1649837263546,CSE 11,A01,084005,Miranda; Gregory Joseph,49,0,55,6
1649837269571,CSE 20,A01,084007,Staff,15,0,20,5
1649837275598,CSE 21,A01,084009,Staff,32,0,50,18
1649837281622,CSE 30,A01,083370,Cao; Yingjun,20,0,40,20
1649837287653,CSE 100,A01,083372,Cao; Yingjun,13,0,40,27
1649837293686,CSE 101,A01,084011,Staff,0,16,40,40
1649837299710,CSE 141,A01,083374,Eldon; John,0,13,75,75
1649837305734,CSE 141L,A01,083376,Eldon; John,0,16,75,75
1649837311760,CSE 175,A01,084013,Kumar; Rakesh,24,0,25,1
1649837317789,CSE 190,A00,092508,Staff,15,0,15,0
1649837323813,ECE 5,A01,084049,Morris; Karcher William,17,0,20,3
1649837329844,ECE 100,A01,084051,Baghdadchi; Saharnaz,16,0,20,4
1649837329844,ECE 100,A02,091916,Baghdadchi; Saharnaz,18,0,20,2
1649837335872,ECE 101,A01,084053,Baghdadchi; Saharnaz,25,0,37,12
1649837335872,ECE 101,A02,084054,Baghdadchi; Saharnaz,37,0,37,0
1649837341900,ECE 107,A01,083390,Staff,32,0,40,8
1649837347934,ECE 148,A01,084056,Silberman; Jack,8,0,12,4
1649837353959,ECE 180,A00,083391,Abi Samra; Nicholas Camill,27,0,30,3
1649837353959,ECE 180,B00,083392,Abi Samra; Nicholas Camill,26,0,30,4
1649837359987,MATH 10B,A01,084110,Staff,20,0,30,10
1649837359987,MATH 10B,A02,084111,Staff,29,0,30,1
1649837359987,MATH 10B,A03,084112,Staff,29,0,30,1
1649837366020,MATH 10C,A01,083443,Staff,19,0,30,11
1649837366020,MATH 10C,A02,083444,Staff,24,0,30,6
1649837366020,MATH 10C,B01,084114,Staff,26,0,30,4
1649837366020,MATH 10C,B02,084115,Staff,30,0,30,0
1649837372046,MATH 18,A01,084117,Harel; Guershon,28,0,30,2
1649837372046,MATH 18,A02,084119,Harel; Guershon,29,0,30,1
1649837372046,MATH 18,A03,084120,Harel; Guershon,30,0,30,0
1649837372046,MATH 18,A04,084121,Harel; Guershon,30,0,30,0
1649837378072,MATH 20B,A01,084124,Um; Ko Woon,33,0,35,2
1649837378072,MATH 20B,B01,084126,Um; Ko Woon,35,0,35,0
1649837384103,MATH 20C,A01,083446,Hammock; Frances H,26,0,30,4
1649837384103,MATH 20C,A02,083447,Hammock; Frances H,30,0,30,0
1649837384103,MATH 20C,A03,083448,Hammock; Frances H,30,0,30,0
1649837384103,MATH 20C,A04,083449,Hammock; Frances H,30,0,30,0
1649837384103,MATH 20C,B01,083451,Hammock; Frances H,29,0,30,1
1649837384103,MATH 20C,B02,083452,Hammock; Frances H,30,0,30,0
1649837384103,MATH 20C,B03,083453,Hammock; Frances H,30,0,30,0
1649837384103,MATH 20C,B04,083454,Hammock; Frances H,30,0,30,0
1649837390129,MATH 20D,A01,084128,Staff,29,0,30,1
1649837390129,MATH 20D,A02,084129,Staff,30,0,30,0
1649837390129,MATH 20D,A03,084130,Staff,29,0,30,1
1649837390129,MATH 20D,B01,084133,Staff,28,0,30,2
1649837390129,MATH 20D,B02,084134,Staff,30,0,30,0
1649837390129,MATH 20D,B03,084135,Staff,30,0,30,0
1649837396153,MATH 20E,A01,084138,Staff,28,0,30,2
1649837396153,MATH 20E,A02,084139,Staff,29,0,30,1
1649837396153,MATH 20E,A03,084140,Staff,28,0,30,2
1649837396153,MATH 20E,A04,084141,Staff,30,0,30,0
1649837402182,MATH 102,A01,084143,Harel; Guershon,24,0,30,6
1649837402182,MATH 102,A02,084144,Harel; Guershon,25,0,30,5
1649837408205,MATH 103B,A01,083456,Staff,0,0,30,30
1649837408205,MATH 103B,A02,083457,Staff,19,0,30,11
1649837414239,MATH 109,A01,084146,Salehi Golsefidy; Alireza,30,0,30,0
1649837414239,MATH 109,A02,084147,Salehi Golsefidy; Alireza,27,0,30,3
1649837420269,MATH 120A,A01,085445,Eggers; John Dietrich,30,0,35,5
1649837420269,MATH 120A,A02,085446,Eggers; John Dietrich,31,0,35,4
1649837426294,MATH 142B,A01,084149,Verstraete; Jacques Allan,7,0,30,23
1649837426294,MATH 142B,A02,084150,Verstraete; Jacques Allan,25,0,30,5
1649837432325,MATH 170A,A01,083459,Nie; Jiawang,9,0,30,21
1649837432325,MATH 170A,A02,083460,Nie; Jiawang,25,0,30,5
1649837432325,MATH 170A,A03,083461,Nie; Jiawang,26,0,30,4
1649837438353,MATH 193B,A01,083463,Staff,15,0,30,15
1649837438353,MATH 193B,A02,083464,Staff,19,0,30,11
1649837438353,MATH 193B,A03,083465,Staff,27,0,30,3
1649837444420,COGS 2,A01,083966,Boyle; Mary E. T.,27,0,30,3
1649837450447,COGS 9,A01,083968,Staff,56,0,60,4
1649837456472,COGS 14B,A01,083970,Staff,46,0,50,4
1649837462500,COGS 17,A01,092679,Staff,73,0,75,2
1649837468525,COGS 100,A01,083972,Staff,46,0,60,14
1649837480575,COGS 101C,A01,083976,Staff,25,0,30,5
1649837486605,COGS 102A,A01,083978,Johnson; Christine M.,24,0,30,6
1649837492630,COGS 107B,A01,083980,Staff,34,0,50,16
1649837498659,COGS 115,A01,083982,Staff,22,0,30,8
1649837504692,COGS 118B,A01,083367,Staff,5,0,40,35
1649837510720,COGS 172,A01,083984,Provenzano; Emily Kara,21,0,30,9
1649837516745,COGS 177,A00,083368,Staff,4,0,30,26
1649837522771,COGS 186,A01,083986,Staff,25,0,40,15
1649837528799,COGS 187A,A01,083988,Boyle; Mary E. T.,40,0,60,20
1649837534832,CSE 8A,A50,084003,Miranda; Gregory Joseph,9,0,15,6
1649837540859,CSE 11,A01,084005,Miranda; Gregory Joseph,49,0,55,6
1649837546888,CSE 20,A01,084007,Staff,15,0,20,5
1649837552917,CSE 21,A01,084009,Staff,32,0,50,18
1649837558946,CSE 30,A01,083370,Cao; Yingjun,20,0,40,20
1649837564971,CSE 100,A01,083372,Cao; Yingjun,13,0,40,27
1649837570995,CSE 101,A01,084011,Staff,0,16,40,40
1649837577044,CSE 141,A01,083374,Eldon; John,0,13,75,75
1649837583070,CSE 141L,A01,083376,Eldon; John,0,16,75,75
1649837589094,CSE 175,A01,084013,Kumar; Rakesh,24,0,25,1
1649837595120,CSE 190,A00,092508,Staff,15,0,15,0
1649837601152,ECE 5,A01,084049,Morris; Karcher William,17,0,20,3
1649837607181,ECE 100,A01,084051,Baghdadchi; Saharnaz,16,0,20,4
1649837607181,ECE 100,A02,091916,Baghdadchi; Saharnaz,18,0,20,2
1649837613209,ECE 101,A01,084053,Baghdadchi; Saharnaz,25,0,37,12
1649837613209,ECE 101,A02,084054,Baghdadchi; Saharnaz,37,0,37,0
1649837619234,ECE 107,A01,083390,Staff,32,0,40,8
1649837625264,ECE 148,A01,084056,Silberman; Jack,8,0,12,4
1649837631288,ECE 180,A00,083391,Abi Samra; Nicholas Camill,27,0,30,3
1649837631288,ECE 180,B00,083392,Abi Samra; Nicholas Camill,26,0,30,4
1649837637317,MATH 10B,A01,084110,Staff,20,0,30,10
1649837637317,MATH 10B,A02,084111,Staff,29,0,30,1
1649837637317,MATH 10B,A03,084112,Staff,29,0,30,1
1649837643341,MATH 10C,A01,083443,Staff,19,0,30,11
1649837643341,MATH 10C,A02,083444,Staff,24,0,30,6
1649837643341,MATH 10C,B01,084114,Staff,26,0,30,4
1649837643341,MATH 10C,B02,084115,Staff,30,0,30,0
1649837649369,MATH 18,A01,084117,Harel; Guershon,28,0,30,2
1649837649369,MATH 18,A02,084119,Harel; Guershon,29,0,30,1
1649837649369,MATH 18,A03,084120,Harel; Guershon,30,0,30,0
1649837649369,MATH 18,A04,084121,Harel; Guershon,30,0,30,0
1649837655397,MATH 20B,A01,084124,Um; Ko Woon,33,0,35,2
1649837655397,MATH 20B,B01,084126,Um; Ko Woon,35,0,35,0
1649837661421,MATH 20C,A01,083446,Hammock; Frances H,26,0,30,4
1649837661421,MATH 20C,A02,083447,Hammock; Frances H,30,0,30,0
1649837661421,MATH 20C,A03,083448,Hammock; Frances H,30,0,30,0
1649837661421,MATH 20C,A04,083449,Hammock; Frances H,30,0,30,0
1649837661421,MATH 20C,B01,083451,Hammock; Frances H,29,0,30,1
1649837661421,MATH 20C,B02,083452,Hammock; Frances H,30,0,30,0
1649837661421,MATH 20C,B03,083453,Hammock; Frances H,30,0,30,0
1649837661421,MATH 20C,B04,083454,Hammock; Frances H,30,0,30,0
1649837667451,MATH 20D,A01,084128,Staff,29,0,30,1
1649837667451,MATH 20D,A02,084129,Staff,30,0,30,0
1649837667451,MATH 20D,A03,084130,Staff,29,0,30,1
1649837667451,MATH 20D,B01,084133,Staff,28,0,30,2
1649837667451,MATH 20D,B02,084134,Staff,30,0,30,0
1649837667451,MATH 20D,B03,084135,Staff,30,0,30,0
1649837673476,MATH 20E,A01,084138,Staff,28,0,30,2
1649837673476,MATH 20E,A02,084139,Staff,29,0,30,1
1649837673476,MATH 20E,A03,084140,Staff,28,0,30,2
1649837673476,MATH 20E,A04,084141,Staff,30,0,30,0
1649837679501,MATH 102,A01,084143,Harel; Guershon,24,0,30,6
1649837679501,MATH 102,A02,084144,Harel; Guershon,25,0,30,5
1649837685532,MATH 103B,A01,083456,Staff,0,0,30,30
1649837685532,MATH 103B,A02,083457,Staff,19,0,30,11
1649837691558,MATH 109,A01,084146,Salehi Golsefidy; Alireza,30,0,30,0
1649837691558,MATH 109,A02,084147,Salehi Golsefidy; Alireza,27,0,30,3
1649837697583,MATH 120A,A01,085445,Eggers; John Dietrich,30,0,35,5
1649837697583,MATH 120A,A02,085446,Eggers; John Dietrich,31,0,35,4
1649837703610,MATH 142B,A01,084149,Verstraete; Jacques Allan,7,0,30,23
1649837703610,MATH 142B,A02,084150,Verstraete; Jacques Allan,25,0,30,5
1649837709639,MATH 170A,A01,083459,Nie; Jiawang,9,0,30,21
1649837709639,MATH 170A,A02,083460,Nie; Jiawang,25,0,30,5
1649837709639,MATH 170A,A03,083461,Nie; Jiawang,26,0,30,4
1649837715677,MATH 193B,A01,083463,Staff,15,0,30,15
1649837715677,MATH 193B,A02,083464,Staff,19,0,30,11
1649837715677,MATH 193B,A03,083465,Staff,27,0,30,3
1649837721730,COGS 2,A01,083966,Boyle; Mary E. T.,27,0,30,3
1649837727755,COGS 9,A01,083968,Staff,56,0,60,4
1649837733784,COGS 14B,A01,083970,Staff,46,0,50,4
1649837739809,COGS 17,A01,092679,Staff,73,0,75,2
1649837745844,COGS 100,A01,083972,Staff,46,0,60,14
1649837757911,COGS 101C,A01,083976,Staff,25,0,30,5
1649837763933,COGS 102A,A01,083978,Johnson; Christine M.,24,0,30,6
1649837769961,COGS 107B,A01,083980,Staff,34,0,50,16
1649837775989,COGS 115,A01,083982,Staff,22,0,30,8
1649837782021,COGS 118B,A01,083367,Staff,5,0,40,35
1649837788048,COGS 172,A01,083984,Provenzano; Emily Kara,21,0,30,9
1649837794175,COGS 177,A00,083368,Staff,4,0,30,26
1649837800200,COGS 186,A01,083986,Staff,25,0,40,15
1649837806225,COGS 187A,A01,083988,Boyle; Mary E. T.,40,0,60,20
1649837812254,CSE 8A,A50,084003,Miranda; Gregory Joseph,9,0,15,6
1649837818281,CSE 11,A01,084005,Miranda; Gregory Joseph,49,0,55,6
1649837824306,CSE 20,A01,084007,Staff,15,0,20,5
1649837830330,CSE 21,A01,084009,Staff,32,0,50,18
1649837836353,CSE 30,A01,083370,Cao; Yingjun,20,0,40,20
1649837842380,CSE 100,A01,083372,Cao; Yingjun,13,0,40,27
1649837848406,CSE 101,A01,084011,Staff,0,16,40,40
1649837854431,CSE 141,A01,083374,Eldon; John,0,13,75,75
1649837860459,CSE 141L,A01,083376,Eldon; John,0,16,75,75
1649837866485,CSE 175,A01,084013,Kumar; Rakesh,24,0,25,1
1649837872510,CSE 190,A00,092508,Staff,15,0,15,0
1649837878535,ECE 5,A01,084049,Morris; Karcher William,17,0,20,3
1649837884575,ECE 100,A01,084051,Baghdadchi; Saharnaz,16,0,20,4
1649837884575,ECE 100,A02,091916,Baghdadchi; Saharnaz,18,0,20,2
1649837890599,ECE 101,A01,084053,Baghdadchi; Saharnaz,25,0,37,12
1649837890599,ECE 101,A02,084054,Baghdadchi; Saharnaz,37,0,37,0
1649837896629,ECE 107,A01,083390,Staff,32,0,40,8
1649837902654,ECE 148,A01,084056,Silberman; Jack,8,0,12,4
1649837908682,ECE 180,A00,083391,Abi Samra; Nicholas Camill,27,0,30,3
1649837908682,ECE 180,B00,083392,Abi Samra; Nicholas Camill,26,0,30,4
1649837914704,MATH 10B,A01,084110,Staff,20,0,30,10
1649837914704,MATH 10B,A02,084111,Staff,29,0,30,1
1649837914704,MATH 10B,A03,084112,Staff,29,0,30,1
1649837920728,MATH 10C,A01,083443,Staff,19,0,30,11
1649837920728,MATH 10C,A02,083444,Staff,24,0,30,6
1649837920728,MATH 10C,B01,084114,Staff,26,0,30,4
1649837920728,MATH 10C,B02,084115,Staff,30,0,30,0
1649837926752,MATH 18,A01,084117,Harel; Guershon,28,0,30,2
1649837926752,MATH 18,A02,084119,Harel; Guershon,29,0,30,1
1649837926752,MATH 18,A03,084120,Harel; Guershon,30,0,30,0
1649837926752,MATH 18,A04,084121,Harel; Guershon,30,0,30,0
1649837932777,MATH 20B,A01,084124,Um; Ko Woon,33,0,35,2
1649837932777,MATH 20B,B01,084126,Um; Ko Woon,35,0,35,0
1649837938803,MATH 20C,A01,083446,Hammock; Frances H,26,0,30,4
1649837938803,MATH 20C,A02,083447,Hammock; Frances H,30,0,30,0
1649837938803,MATH 20C,A03,083448,Hammock; Frances H,30,0,30,0
1649837938803,MATH 20C,A04,083449,Hammock; Frances H,30,0,30,0
1649837938803,MATH 20C,B01,083451,Hammock; Frances H,29,0,30,1
1649837938803,MATH 20C,B02,083452,Hammock; Frances H,30,0,30,0
1649837938803,MATH 20C,B03,083453,Hammock; Frances H,30,0,30,0
1649837938803,MATH 20C,B04,083454,Hammock; Frances H,30,0,30,0
1649837944826,MATH 20D,A01,084128,Staff,29,0,30,1
1649837944826,MATH 20D,A02,084129,Staff,30,0,30,0
1649837944826,MATH 20D,A03,084130,Staff,29,0,30,1
1649837944826,MATH 20D,B01,084133,Staff,28,0,30,2
1649837944826,MATH 20D,B02,084134,Staff,30,0,30,0
1649837944826,MATH 20D,B03,084135,Staff,30,0,30,0
1649837950854,MATH 20E,A01,084138,Staff,28,0,30,2
1649837950854,MATH 20E,A02,084139,Staff,29,0,30,1
1649837950854,MATH 20E,A03,084140,Staff,28,0,30,2
1649837950854,MATH 20E,A04,084141,Staff,30,0,30,0
1649837956879,MATH 102,A01,084143,Harel; Guershon,24,0,30,6
1649837956879,MATH 102,A02,084144,Harel; Guershon,25,0,30,5
1649837962903,MATH 103B,A01,083456,Staff,0,0,30,30
1649837962903,MATH 103B,A02,083457,Staff,19,0,30,11
1649837968931,MATH 109,A01,084146,Salehi Golsefidy; Alireza,30,0,30,0
1649837968931,MATH 109,A02,084147,Salehi Golsefidy; Alireza,27,0,30,3
1649837974955,MATH 120A,A01,085445,Eggers; John Dietrich,30,0,35,5
1649837974955,MATH 120A,A02,085446,Eggers; John Dietrich,31,0,35,4
1649837980980,MATH 142B,A01,084149,Verstraete; Jacques Allan,7,0,30,23
1649837980980,MATH 142B,A02,084150,Verstraete; Jacques Allan,25,0,30,5
1649837987005,MATH 170A,A01,083459,Nie; Jiawang,9,0,30,21
1649837987005,MATH 170A,A02,083460,Nie; Jiawang,25,0,30,5
1649837987005,MATH 170A,A03,083461,Nie; Jiawang,26,0,30,4
1649837993029,MATH 193B,A01,083463,Staff,15,0,30,15
1649837993029,MATH 193B,A02,083464,Staff,19,0,30,11
1649837993029,MATH 193B,A03,083465,Staff,27,0,30,3
1649837999091,COGS 2,A01,083966,Boyle; Mary E. T.,27,0,30,3
1649838005119,COGS 9,A01,083968,Staff,56,0,60,4
1649838011147,COGS 14B,A01,083970,Staff,46,0,50,4
1649838017173,COGS 17,A01,092679,Staff,73,0,75,2
1649838023197,COGS 100,A01,083972,Staff,46,0,60,14
1649838035248,COGS 101C,A01,083976,Staff,25,0,30,5
1649838041273,COGS 102A,A01,083978,Johnson; Christine M.,24,0,30,6
1649838047297,COGS 107B,A01,083980,Staff,34,0,50,16
1649838053324,COGS 115,A01,083982,Staff,22,0,30,8
1649838059350,COGS 118B,A01,083367,Staff,5,0,40,35
1649838065382,COGS 172,A01,083984,Provenzano; Emily Kara,21,0,30,9
1649838071405,COGS 177,A00,083368,Staff,4,0,30,26
1649838077429,COGS 186,A01,083986,Staff,25,0,40,15
1649838083457,COGS 187A,A01,083988,Boyle; Mary E. T.,40,0,60,20
1649838089481,CSE 8A,A50,084003,Miranda; Gregory Joseph,9,0,15,6
1649838095506,CSE 11,A01,084005,Miranda; Gregory Joseph,49,0,55,6
1649838101532,CSE 20,A01,084007,Staff,15,0,20,5
1649838107561,CSE 21,A01,084009,Staff,32,0,50,18
1649838113584,CSE 30,A01,083370,Cao; Yingjun,20,0,40,20
1649838119612,CSE 100,A01,083372,Cao; Yingjun,13,0,40,27
1649838125634,CSE 101,A01,084011,Staff,0,16,40,40
1649838131662,CSE 141,A01,083374,Eldon; John,0,13,75,75
1649838137686,CSE 141L,A01,083376,Eldon; John,0,16,75,75
1649838143719,CSE 175,A01,084013,Kumar; Rakesh,24,0,25,1
1649838149743,CSE 190,A00,092508,Staff,15,0,15,0
1649838155767,ECE 5,A01,084049,Morris; Karcher William,17,0,20,3
1649838161792,ECE 100,A01,084051,Baghdadchi; Saharnaz,16,0,20,4
1649838161792,ECE 100,A02,091916,Baghdadchi; Saharnaz,18,0,20,2
1649838167820,ECE 101,A01,084053,Baghdadchi; Saharnaz,25,0,37,12
1649838167820,ECE 101,A02,084054,Baghdadchi; Saharnaz,37,0,37,0
1649838173850,ECE 107,A01,083390,Staff,32,0,40,8
1649838179876,ECE 148,A01,084056,Silberman; Jack,8,0,12,4
1649838185908,ECE 180,A00,083391,Abi Samra; Nicholas Camill,27,0,30,3
1649838185908,ECE 180,B00,083392,Abi Samra; Nicholas Camill,26,0,30,4
1649838191935,MATH 10B,A01,084110,Staff,20,0,30,10
1649838191935,MATH 10B,A02,084111,Staff,29,0,30,1
1649838191935,MATH 10B,A03,084112,Staff,29,0,30,1
1649838197962,MATH 10C,A01,083443,Staff,19,0,30,11
1649838197962,MATH 10C,A02,083444,Staff,24,0,30,6
1649838197962,MATH 10C,B01,084114,Staff,26,0,30,4
1649838197962,MATH 10C,B02,084115,Staff,30,0,30,0
1649838203987,MATH 18,A01,084117,Harel; Guershon,28,0,30,2
1649838203987,MATH 18,A02,084119,Harel; Guershon,29,0,30,1
1649838203987,MATH 18,A03,084120,Harel; Guershon,30,0,30,0
1649838203987,MATH 18,A04,084121,Harel; Guershon,30,0,30,0
1649838210018,MATH 20B,A01,084124,Um; Ko Woon,33,0,35,2
1649838210018,MATH 20B,B01,084126,Um; Ko Woon,35,0,35,0
1649838216044,MATH 20C,A01,083446,Hammock; Frances H,26,0,30,4
1649838216044,MATH 20C,A02,083447,Hammock; Frances H,30,0,30,0
1649838216044,MATH 20C,A03,083448,Hammock; Frances H,30,0,30,0
1649838216044,MATH 20C,A04,083449,Hammock; Frances H,30,0,30,0
1649838216044,MATH 20C,B01,083451,Hammock; Frances H,29,0,30,1
1649838216044,MATH 20C,B02,083452,Hammock; Frances H,30,0,30,0
1649838216044,MATH 20C,B03,083453,Hammock; Frances H,30,0,30,0
1649838216044,MATH 20C,B04,083454,Hammock; Frances H,30,0,30,0
1649838222067,MATH 20D,A01,084128,Staff,29,0,30,1
1649838222067,MATH 20D,A02,084129,Staff,30,0,30,0
1649838222067,MATH 20D,A03,084130,Staff,29,0,30,1
1649838222067,MATH 20D,B01,084133,Staff,28,0,30,2
1649838222067,MATH 20D,B02,084134,Staff,30,0,30,0
1649838222067,MATH 20D,B03,084135,Staff,30,0,30,0
1649838228095,MATH 20E,A01,084138,Staff,27,0,30,3
1649838228095,MATH 20E,A02,084139,Staff,29,0,30,1
1649838228095,MATH 20E,A03,084140,Staff,28,0,30,2
1649838228095,MATH 20E,A04,084141,Staff,30,0,30,0
1649838234118,MATH 102,A01,084143,Harel; Guershon,24,0,30,6
1649838234118,MATH 102,A02,084144,Harel; Guershon,25,0,30,5
1649838240142,MATH 103B,A01,083456,Staff,0,0,30,30
1649838240142,MATH 103B,A02,083457,Staff,19,0,30,11
1649838246178,MATH 109,A01,084146,Salehi Golsefidy; Alireza,30,0,30,0
1649838246178,MATH 109,A02,084147,Salehi Golsefidy; Alireza,26,0,30,4
1649838252202,MATH 120A,A01,085445,Eggers; John Dietrich,30,0,35,5
1649838252202,MATH 120A,A02,085446,Eggers; John Dietrich,31,0,35,4
1649838258236,MATH 142B,A01,084149,Verstraete; Jacques Allan,7,0,30,23
1649838258236,MATH 142B,A02,084150,Verstraete; Jacques Allan,25,0,30,5
1649838264265,MATH 170A,A01,083459,Nie; Jiawang,9,0,30,21
1649838264265,MATH 170A,A02,083460,Nie; Jiawang,25,0,30,5
1649838264265,MATH 170A,A03,083461,Nie; Jiawang,26,0,30,4
1649838270291,MATH 193B,A01,083463,Staff,15,0,30,15
1649838270291,MATH 193B,A02,083464,Staff,19,0,30,11
1649838270291,MATH 193B,A03,083465,Staff,27,0,30,3
1649838276349,COGS 2,A01,083966,Boyle; Mary E. T.,27,0,30,3
1649838282372,COGS 9,A01,083968,Staff,56,0,60,4
1649838288395,COGS 14B,A01,083970,Staff,46,0,50,4
1649838294420,COGS 17,A01,092679,Staff,73,0,75,2
1649838300447,COGS 100,A01,083972,Staff,46,0,60,14
1649838312498,COGS 101C,A01,083976,Staff,25,0,30,5
1649838318521,COGS 102A,A01,083978,Johnson; Christine M.,24,0,30,6
1649838324546,COGS 107B,A01,083980,Staff,34,0,50,16
1649838330573,COGS 115,A01,083982,Staff,22,0,30,8
1649838336598,COGS 118B,A01,083367,Staff,5,0,40,35
1649838342622,COGS 172,A01,083984,Provenzano; Emily Kara,21,0,30,9
1649838348645,COGS 177,A00,083368,Staff,4,0,30,26
1649838354668,COGS 186,A01,083986,Staff,25,0,40,15
1649838360708,COGS 187A,A01,083988,Boyle; Mary E. T.,40,0,60,20
1649838366733,CSE 8A,A50,084003,Miranda; Gregory Joseph,9,0,15,6
1649838372758,CSE 11,A01,084005,Miranda; Gregory Joseph,49,0,55,6
1649838378785,CSE 20,A01,084007,Staff,15,0,20,5
1649838384813,CSE 21,A01,084009,Staff,32,0,50,18
1649838390926,CSE 30,A01,083370,Cao; Yingjun,20,0,40,20
1649838396949,CSE 100,A01,083372,Cao; Yingjun,13,0,40,27
1649838402976,CSE 101,A01,084011,Staff,0,16,40,40
1649838409017,CSE 141,A01,083374,Eldon; John,0,13,75,75
1649838415042,CSE 141L,A01,083376,Eldon; John,0,16,75,75
1649838421069,CSE 175,A01,084013,Kumar; Rakesh,24,0,25,1
1649838427093,CSE 190,A00,092508,Staff,15,0,15,0
1649838433118,ECE 5,A01,084049,Morris; Karcher William,17,0,20,3
1649838439150,ECE 100,A01,084051,Baghdadchi; Saharnaz,16,0,20,4
1649838439150,ECE 100,A02,091916,Baghdadchi; Saharnaz,18,0,20,2
1649838445174,ECE 101,A01,084053,Baghdadchi; Saharnaz,25,0,37,12
1649838445174,ECE 101,A02,084054,Baghdadchi; Saharnaz,37,0,37,0
1649838451199,ECE 107,A01,083390,Staff,32,0,40,8
1649838457223,ECE 148,A01,084056,Silberman; Jack,8,0,12,4
1649838463246,ECE 180,A00,083391,Abi Samra; Nicholas Camill,27,0,30,3
1649838463246,ECE 180,B00,083392,Abi Samra; Nicholas Camill,26,0,30,4
1649838469271,MATH 10B,A01,084110,Staff,20,0,30,10
1649838469271,MATH 10B,A02,084111,Staff,29,0,30,1
1649838469271,MATH 10B,A03,084112,Staff,29,0,30,1
1649838475302,MATH 10C,A01,083443,Staff,19,0,30,11
1649838475302,MATH 10C,A02,083444,Staff,24,0,30,6
1649838475302,MATH 10C,B01,084114,Staff,26,0,30,4
1649838475302,MATH 10C,B02,084115,Staff,30,0,30,0
1649838481330,MATH 18,A01,084117,Harel; Guershon,28,0,30,2
1649838481330,MATH 18,A02,084119,Harel; Guershon,29,0,30,1
1649838481330,MATH 18,A03,084120,Harel; Guershon,30,0,30,0
1649838481330,MATH 18,A04,084121,Harel; Guershon,30,0,30,0
1649838487360,MATH 20B,A01,084124,Um; Ko Woon,33,0,35,2
1649838487360,MATH 20B,B01,084126,Um; Ko Woon,35,0,35,0
1649838493384,MATH 20C,A01,083446,Hammock; Frances H,26,0,30,4
1649838493384,MATH 20C,A02,083447,Hammock; Frances H,30,0,30,0
1649838493384,MATH 20C,A03,083448,Hammock; Frances H,30,0,30,0
1649838493384,MATH 20C,A04,083449,Hammock; Frances H,30,0,30,0
1649838493384,MATH 20C,B01,083451,Hammock; Frances H,29,0,30,1
1649838493384,MATH 20C,B02,083452,Hammock; Frances H,30,0,30,0
1649838493384,MATH 20C,B03,083453,Hammock; Frances H,30,0,30,0
1649838493384,MATH 20C,B04,083454,Hammock; Frances H,30,0,30,0
1649838499412,MATH 20D,A01,084128,Staff,29,0,30,1
1649838499412,MATH 20D,A02,084129,Staff,30,0,30,0
1649838499412,MATH 20D,A03,084130,Staff,29,0,30,1
1649838499412,MATH 20D,B01,084133,Staff,28,0,30,2
1649838499412,MATH 20D,B02,084134,Staff,30,0,30,0
1649838499412,MATH 20D,B03,084135,Staff,30,0,30,0
1649838505437,MATH 20E,A01,084138,Staff,27,0,30,3
1649838505437,MATH 20E,A02,084139,Staff,29,0,30,1
1649838505437,MATH 20E,A03,084140,Staff,28,0,30,2
1649838505437,MATH 20E,A04,084141,Staff,30,0,30,0
1649838511461,MATH 102,A01,084143,Harel; Guershon,24,0,30,6
1649838511461,MATH 102,A02,084144,Harel; Guershon,25,0,30,5
1649838517485,MATH 103B,A01,083456,Staff,0,0,30,30
1649838517485,MATH 103B,A02,083457,Staff,19,0,30,11
1649838523513,MATH 109,A01,084146,Salehi Golsefidy; Alireza,30,0,30,0
1649838523513,MATH 109,A02,084147,Salehi Golsefidy; Alireza,26,0,30,4
1649838529541,MATH 120A,A01,085445,Eggers; John Dietrich,30,0,35,5
1649838529541,MATH 120A,A02,085446,Eggers; John Dietrich,31,0,35,4
1649838535577,MATH 142B,A01,084149,Verstraete; Jacques Allan,7,0,30,23
1649838535577,MATH 142B,A02,084150,Verstraete; Jacques Allan,25,0,30,5
1649838541602,MATH 170A,A01,083459,Nie; Jiawang,9,0,30,21
1649838541602,MATH 170A,A02,083460,Nie; Jiawang,25,0,30,5
1649838541602,MATH 170A,A03,083461,Nie; Jiawang,26,0,30,4
1649838547627,MATH 193B,A01,083463,Staff,15,0,30,15
1649838547627,MATH 193B,A02,083464,Staff,19,0,30,11
1649838547627,MATH 193B,A03,083465,Staff,27,0,30,3
1649838553696,COGS 2,A01,083966,Boyle; Mary E. T.,27,0,30,3
1649838559732,COGS 9,A01,083968,Staff,56,0,60,4
1649838565757,COGS 14B,A01,083970,Staff,46,0,50,4
1649838571781,COGS 17,A01,092679,Staff,73,0,75,2
1649838577804,COGS 100,A01,083972,Staff,46,0,60,14
1649838589851,COGS 101C,A01,083976,Staff,25,0,30,5
1649838595880,COGS 102A,A01,083978,Johnson; Christine M.,24,0,30,6
1649838601904,COGS 107B,A01,083980,Staff,33,0,50,17
1649838607935,COGS 115,A01,083982,Staff,22,0,30,8
1649838613959,COGS 118B,A01,083367,Staff,5,0,40,35
1649838619988,COGS 172,A01,083984,Provenzano; Emily Kara,21,0,30,9
1649838626013,COGS 177,A00,083368,Staff,4,0,30,26
1649838632039,COGS 186,A01,083986,Staff,25,0,40,15
1649838638067,COGS 187A,A01,083988,Boyle; Mary E. T.,40,0,60,20
1649838644093,CSE 8A,A50,084003,Miranda; Gregory Joseph,9,0,15,6
1649838650118,CSE 11,A01,084005,Miranda; Gregory Joseph,49,0,55,6
1649838656146,CSE 20,A01,084007,Staff,15,0,20,5
1649838662170,CSE 21,A01,084009,Staff,32,0,50,18
1649838668198,CSE 30,A01,083370,Cao; Yingjun,20,0,40,20
1649838674228,CSE 100,A01,083372,Cao; Yingjun,13,0,40,27
1649838680256,CSE 101,A01,084011,Staff,0,16,40,40
1649838686282,CSE 141,A01,083374,Eldon; John,0,13,75,75
1649838692311,CSE 141L,A01,083376,Eldon; John,0,16,75,75
1649838698335,CSE 175,A01,084013,Kumar; Rakesh,24,0,25,1
1649838704361,CSE 190,A00,092508,Staff,15,0,15,0
1649838710384,ECE 5,A01,084049,Morris; Karcher William,17,0,20,3
1649838716409,ECE 100,A01,084051,Baghdadchi; Saharnaz,16,0,20,4
1649838716409,ECE 100,A02,091916,Baghdadchi; Saharnaz,18,0,20,2
1649838722435,ECE 101,A01,084053,Baghdadchi; Saharnaz,25,0,37,12
1649838722435,ECE 101,A02,084054,Baghdadchi; Saharnaz,37,0,37,0
1649838728465,ECE 107,A01,083390,Staff,31,0,40,9
1649838734490,ECE 148,A01,084056,Silberman; Jack,8,0,12,4
1649838740513,ECE 180,A00,083391,Abi Samra; Nicholas Camill,27,0,30,3
1649838740513,ECE 180,B00,083392,Abi Samra; Nicholas Camill,26,0,30,4
1649838746548,MATH 10B,A01,084110,Staff,20,0,30,10
1649838746548,MATH 10B,A02,084111,Staff,29,0,30,1
1649838746548,MATH 10B,A03,084112,Staff,29,0,30,1
1649838752577,MATH 10C,A01,083443,Staff,19,0,30,11
1649838752577,MATH 10C,A02,083444,Staff,24,0,30,6
1649838752577,MATH 10C,B01,084114,Staff,26,0,30,4
1649838752577,MATH 10C,B02,084115,Staff,30,0,30,0
1649838758603,MATH 18,A01,084117,Harel; Guershon,28,0,30,2
1649838758603,MATH 18,A02,084119,Harel; Guershon,29,0,30,1
1649838758603,MATH 18,A03,084120,Harel; Guershon,30,0,30,0
1649838758603,MATH 18,A04,084121,Harel; Guershon,30,0,30,0
1649838764642,MATH 20B,A01,084124,Um; Ko Woon,33,0,35,2
1649838764642,MATH 20B,B01,084126,Um; Ko Woon,35,0,35,0
1649838770669,MATH 20C,A01,083446,Hammock; Frances H,26,0,30,4
1649838770669,MATH 20C,A02,083447,Hammock; Frances H,30,0,30,0
1649838770669,MATH 20C,A03,083448,Hammock; Frances H,30,0,30,0
1649838770669,MATH 20C,A04,083449,Hammock; Frances H,30,0,30,0
1649838770669,MATH 20C,B01,083451,Hammock; Frances H,29,0,30,1
1649838770669,MATH 20C,B02,083452,Hammock; Frances H,30,0,30,0
1649838770669,MATH 20C,B03,083453,Hammock; Frances H,30,0,30,0
1649838770669,MATH 20C,B04,083454,Hammock; Frances H,30,0,30,0
1649838776694,MATH 20D,A01,084128,Staff,29,0,30,1
1649838776694,MATH 20D,A02,084129,Staff,30,0,30,0
1649838776694,MATH 20D,A03,084130,Staff,29,0,30,1
1649838776694,MATH 20D,B01,084133,Staff,28,0,30,2
1649838776694,MATH 20D,B02,084134,Staff,30,0,30,0
1649838776694,MATH 20D,B03,084135,Staff,30,0,30,0
1649838782720,MATH 20E,A01,084138,Staff,27,0,30,3
1649838782720,MATH 20E,A02,084139,Staff,29,0,30,1
1649838782720,MATH 20E,A03,084140,Staff,28,0,30,2
1649838782720,MATH 20E,A04,084141,Staff,30,0,30,0
1649838788749,MATH 102,A01,084143,Harel; Guershon,24,0,30,6
1649838788749,MATH 102,A02,084144,Harel; Guershon,25,0,30,5
1649838794775,MATH 103B,A01,083456,Staff,0,0,30,30
1649838794775,MATH 103B,A02,083457,Staff,19,0,30,11
1649838800809,MATH 109,A01,084146,Salehi Golsefidy; Alireza,30,0,30,0
1649838800809,MATH 109,A02,084147,Salehi Golsefidy; Alireza,26,0,30,4
1649838806837,MATH 120A,A01,085445,Eggers; John Dietrich,30,0,35,5
1649838806837,MATH 120A,A02,085446,Eggers; John Dietrich,31,0,35,4
1649838812859,MATH 142B,A01,084149,Verstraete; Jacques Allan,7,0,30,23
1649838812859,MATH 142B,A02,084150,Verstraete; Jacques Allan,25,0,30,5
1649838818887,MATH 170A,A01,083459,Nie; Jiawang,9,0,30,21
1649838818887,MATH 170A,A02,083460,Nie; Jiawang,25,0,30,5
1649838818887,MATH 170A,A03,083461,Nie; Jiawang,26,0,30,4
1649838824910,MATH 193B,A01,083463,Staff,15,0,30,15
1649838824910,MATH 193B,A02,083464,Staff,19,0,30,11
1649838824910,MATH 193B,A03,083465,Staff,27,0,30,3
1649838830973,COGS 2,A01,083966,Boyle; Mary E. T.,27,0,30,3
1649838836996,COGS 9,A01,083968,Staff,56,0,60,4
1649838843025,COGS 14B,A01,083970,Staff,46,0,50,4
1649838849052,COGS 17,A01,092679,Staff,73,0,75,2
1649838855075,COGS 100,A01,083972,Staff,46,0,60,14
1649838867122,COGS 101C,A01,083976,Staff,25,0,30,5
1649838873146,COGS 102A,A01,083978,Johnson; Christine M.,24,0,30,6
1649838879171,COGS 107B,A01,083980,Staff,33,0,50,17
1649838885195,COGS 115,A01,083982,Staff,21,0,30,9
1649838891219,COGS 118B,A01,083367,Staff,5,0,40,35
1649838897247,COGS 172,A01,083984,Provenzano; Emily Kara,20,0,30,10
1649838903272,COGS 177,A00,083368,Staff,4,0,30,26
1649838909295,COGS 186,A01,083986,Staff,25,0,40,15
1649838915320,COGS 187A,A01,083988,Boyle; Mary E. T.,40,0,60,20
1649838921349,CSE 8A,A50,084003,Miranda; Gregory Joseph,9,0,15,6
1649838927372,CSE 11,A01,084005,Miranda; Gregory Joseph,49,0,55,6
1649838933400,CSE 20,A01,084007,Staff,15,0,20,5
1649838939428,CSE 21,A01,084009,Staff,32,0,50,18
1649838945454,CSE 30,A01,083370,Cao; Yingjun,20,0,40,20
1649838951484,CSE 100,A01,083372,Cao; Yingjun,13,0,40,27
1649838957509,CSE 101,A01,084011,Staff,0,16,40,40
1649838963552,CSE 141,A01,083374,Eldon; John,0,13,75,75
1649838969576,CSE 141L,A01,083376,Eldon; John,0,16,75,75
1649838975602,CSE 175,A01,084013,Kumar; Rakesh,24,0,25,1
1649838981636,CSE 190,A00,092508,Staff,15,0,15,0
1649838987752,ECE 5,A01,084049,Morris; Karcher William,17,0,20,3
1649838993791,ECE 100,A01,084051,Baghdadchi; Saharnaz,16,0,20,4
1649838993791,ECE 100,A02,091916,Baghdadchi; Saharnaz,18,0,20,2
1649838999820,ECE 101,A01,084053,Baghdadchi; Saharnaz,25,0,37,12
1649838999820,ECE 101,A02,084054,Baghdadchi; Saharnaz,37,0,37,0
1649839005848,ECE 107,A01,083390,Staff,31,0,40,9
1649839011876,ECE 148,A01,084056,Silberman; Jack,8,0,12,4
1649839017909,ECE 180,A00,083391,Abi Samra; Nicholas Camill,27,0,30,3
1649839017909,ECE 180,B00,083392,Abi Samra; Nicholas Camill,26,0,30,4
1649839023944,MATH 10B,A01,084110,Staff,20,0,30,10
1649839023944,MATH 10B,A02,084111,Staff,29,0,30,1
1649839023944,MATH 10B,A03,084112,Staff,29,0,30,1
1649839029972,MATH 10C,A01,083443,Staff,19,0,30,11
1649839029972,MATH 10C,A02,083444,Staff,24,0,30,6
1649839029972,MATH 10C,B01,084114,Staff,26,0,30,4
1649839029972,MATH 10C,B02,084115,Staff,30,0,30,0
1649839035998,MATH 18,A01,084117,Harel; Guershon,28,0,30,2
1649839035998,MATH 18,A02,084119,Harel; Guershon,29,0,30,1
1649839035998,MATH 18,A03,084120,Harel; Guershon,30,0,30,0
1649839035998,MATH 18,A04,084121,Harel; Guershon,30,0,30,0
1649839042026,MATH 20B,A01,084124,Um; Ko Woon,33,0,35,2
1649839042026,MATH 20B,B01,084126,Um; Ko Woon,35,0,35,0
1649839048060,MATH 20C,A01,083446,Hammock; Frances H,26,0,30,4
1649839048060,MATH 20C,A02,083447,Hammock; Frances H,30,0,30,0
1649839048060,MATH 20C,A03,083448,Hammock; Frances H,30,0,30,0
1649839048060,MATH 20C,A04,083449,Hammock; Frances H,30,0,30,0
1649839048060,MATH 20C,B01,083451,Hammock; Frances H,29,0,30,1
1649839048060,MATH 20C,B02,083452,Hammock; Frances H,30,0,30,0
1649839048060,MATH 20C,B03,083453,Hammock; Frances H,30,0,30,0
1649839048060,MATH 20C,B04,083454,Hammock; Frances H,30,0,30,0
1649839054092,MATH 20D,A01,084128,Staff,29,0,30,1
1649839054092,MATH 20D,A02,084129,Staff,30,0,30,0
1649839054092,MATH 20D,A03,084130,Staff,29,0,30,1
1649839054092,MATH 20D,B01,084133,Staff,28,0,30,2
1649839054092,MATH 20D,B02,084134,Staff,30,0,30,0
1649839054092,MATH 20D,B03,084135,Staff,30,0,30,0
1649839060119,MATH 20E,A01,084138,Staff,27,0,30,3
1649839060119,MATH 20E,A02,084139,Staff,29,0,30,1
1649839060119,MATH 20E,A03,084140,Staff,28,0,30,2
1649839060119,MATH 20E,A04,084141,Staff,30,0,30,0
1649839066150,MATH 102,A01,084143,Harel; Guershon,24,0,30,6
1649839066150,MATH 102,A02,084144,Harel; Guershon,25,0,30,5
1649839072177,MATH 103B,A01,083456,Staff,0,0,30,30
1649839072177,MATH 103B,A02,083457,Staff,19,0,30,11
1649839078205,MATH 109,A01,084146,Salehi Golsefidy; Alireza,30,0,30,0
1649839078205,MATH 109,A02,084147,Salehi Golsefidy; Alireza,26,0,30,4
1649839084237,MATH 120A,A01,085445,Eggers; John Dietrich,30,0,35,5
1649839084237,MATH 120A,A02,085446,Eggers; John Dietrich,31,0,35,4
1649839090265,MATH 142B,A01,084149,Verstraete; Jacques Allan,7,0,30,23
1649839090265,MATH 142B,A02,084150,Verstraete; Jacques Allan,25,0,30,5
1649839096308,MATH 170A,A01,083459,Nie; Jiawang,9,0,30,21
1649839096308,MATH 170A,A02,083460,Nie; Jiawang,25,0,30,5
1649839096308,MATH 170A,A03,083461,Nie; Jiawang,26,0,30,4
1649839102335,MATH 193B,A01,083463,Staff,15,0,30,15
1649839102335,MATH 193B,A02,083464,Staff,19,0,30,11
1649839102335,MATH 193B,A03,083465,Staff,27,0,30,3
1649839108391,COGS 2,A01,083966,Boyle; Mary E. T.,27,0,30,3
1649839114414,COGS 9,A01,083968,Staff,56,0,60,4
1649839120439,COGS 14B,A01,083970,Staff,46,0,50,4
1649839126463,COGS 17,A01,092679,Staff,73,0,75,2
1649839132488,COGS 100,A01,083972,Staff,46,0,60,14
1649839144538,COGS 101C,A01,083976,Staff,25,0,30,5
1649839150562,COGS 102A,A01,083978,Johnson; Christine M.,24,0,30,6
1649839156588,COGS 107B,A01,083980,Staff,33,0,50,17
1649839162616,COGS 115,A01,083982,Staff,21,0,30,9
1649839168641,COGS 118B,A01,083367,Staff,5,0,40,35
1649839174667,COGS 172,A01,083984,Provenzano; Emily Kara,20,0,30,10
1649839180690,COGS 177,A00,083368,Staff,4,0,30,26
1649839186724,COGS 186,A01,083986,Staff,25,0,40,15
1649839192748,COGS 187A,A01,083988,Boyle; Mary E. T.,40,0,60,20
1649839198776,CSE 8A,A50,084003,Miranda; Gregory Joseph,9,0,15,6
1649839204800,CSE 11,A01,084005,Miranda; Gregory Joseph,49,0,55,6
1649839210828,CSE 20,A01,084007,Staff,15,0,20,5
1649839216852,CSE 21,A01,084009,Staff,32,0,50,18
1649839222877,CSE 30,A01,083370,Cao; Yingjun,20,0,40,20
1649839228907,CSE 100,A01,083372,Cao; Yingjun,13,0,40,27
1649839234931,CSE 101,A01,084011,Staff,0,16,40,40
1649839240957,CSE 141,A01,083374,Eldon; John,0,13,75,75
1649839246986,CSE 141L,A01,083376,Eldon; John,0,16,75,75
1649839253010,CSE 175,A01,084013,Kumar; Rakesh,24,0,25,1
1649839259033,CSE 190,A00,092508,Staff,15,0,15,0
1649839265059,ECE 5,A01,084049,Morris; Karcher William,17,0,20,3
1649839271084,ECE 100,A01,084051,Baghdadchi; Saharnaz,16,0,20,4
1649839271084,ECE 100,A02,091916,Baghdadchi; Saharnaz,18,0,20,2
1649839277108,ECE 101,A01,084053,Baghdadchi; Saharnaz,25,0,37,12
1649839277108,ECE 101,A02,084054,Baghdadchi; Saharnaz,37,0,37,0
1649839283136,ECE 107,A01,083390,Staff,31,0,40,9
1649839289163,ECE 148,A01,084056,Silberman; Jack,8,0,12,4
1649839295195,ECE 180,A00,083391,Abi Samra; Nicholas Camill,27,0,30,3
1649839295195,ECE 180,B00,083392,Abi Samra; Nicholas Camill,26,0,30,4
1649839301222,MATH 10B,A01,084110,Staff,20,0,30,10
1649839301222,MATH 10B,A02,084111,Staff,29,0,30,1
1649839301222,MATH 10B,A03,084112,Staff,29,0,30,1
1649839307246,MATH 10C,A01,083443,Staff,19,0,30,11
1649839307246,MATH 10C,A02,083444,Staff,24,0,30,6
1649839307246,MATH 10C,B01,084114,Staff,26,0,30,4
1649839307246,MATH 10C,B02,084115,Staff,30,0,30,0
1649839313270,MATH 18,A01,084117,Harel; Guershon,28,0,30,2
1649839313270,MATH 18,A02,084119,Harel; Guershon,29,0,30,1
1649839313270,MATH 18,A03,084120,Harel; Guershon,30,0,30,0
1649839313270,MATH 18,A04,084121,Harel; Guershon,30,0,30,0
1649839319296,MATH 20B,A01,084124,Um; Ko Woon,33,0,35,2
1649839319296,MATH 20B,B01,084126,Um; Ko Woon,35,0,35,0
1649839325320,MATH 20C,A01,083446,Hammock; Frances H,26,0,30,4
1649839325320,MATH 20C,A02,083447,Hammock; Frances H,30,0,30,0
1649839325320,MATH 20C,A03,083448,Hammock; Frances H,30,0,30,0
1649839325320,MATH 20C,A04,083449,Hammock; Frances H,30,0,30,0
1649839325320,MATH 20C,B01,083451,Hammock; Frances H,29,0,30,1
1649839325320,MATH 20C,B02,083452,Hammock; Frances H,30,0,30,0
1649839325320,MATH 20C,B03,083453,Hammock; Frances H,30,0,30,0
1649839325320,MATH 20C,B04,083454,Hammock; Frances H,30,0,30,0
1649839331350,MATH 20D,A01,084128,Staff,29,0,30,1
1649839331350,MATH 20D,A02,084129,Staff,30,0,30,0
1649839331350,MATH 20D,A03,084130,Staff,29,0,30,1
1649839331350,MATH 20D,B01,084133,Staff,28,0,30,2
1649839331350,MATH 20D,B02,084134,Staff,30,0,30,0
1649839331350,MATH 20D,B03,084135,Staff,30,0,30,0
1649839337378,MATH 20E,A01,084138,Staff,27,0,30,3
1649839337378,MATH 20E,A02,084139,Staff,29,0,30,1
1649839337378,MATH 20E,A03,084140,Staff,28,0,30,2
1649839337378,MATH 20E,A04,084141,Staff,30,0,30,0
1649839343407,MATH 102,A01,084143,Harel; Guershon,24,0,30,6
1649839343407,MATH 102,A02,084144,Harel; Guershon,25,0,30,5
1649839349435,MATH 103B,A01,083456,Staff,0,0,30,30
1649839349435,MATH 103B,A02,083457,Staff,19,0,30,11
1649839355462,MATH 109,A01,084146,Salehi Golsefidy; Alireza,30,0,30,0
1649839355462,MATH 109,A02,084147,Salehi Golsefidy; Alireza,26,0,30,4
1649839361491,MATH 120A,A01,085445,Eggers; John Dietrich,30,0,35,5
1649839361491,MATH 120A,A02,085446,Eggers; John Dietrich,31,0,35,4
1649839367515,MATH 142B,A01,084149,Verstraete; Jacques Allan,7,0,30,23
1649839367515,MATH 142B,A02,084150,Verstraete; Jacques Allan,25,0,30,5
1649839373538,MATH 170A,A01,083459,Nie; Jiawang,9,0,30,21
1649839373538,MATH 170A,A02,083460,Nie; Jiawang,25,0,30,5
1649839373538,MATH 170A,A03,083461,Nie; Jiawang,26,0,30,4
1649839379566,MATH 193B,A01,083463,Staff,15,0,30,15
1649839379566,MATH 193B,A02,083464,Staff,19,0,30,11
1649839379566,MATH 193B,A03,083465,Staff,27,0,30,3
1649839385633,COGS 2,A01,083966,Boyle; Mary E. T.,27,0,30,3
1649839391657,COGS 9,A01,083968,Staff,56,0,60,4
1649839397685,COGS 14B,A01,083970,Staff,46,0,50,4
1649839403713,COGS 17,A01,092679,Staff,73,0,75,2
1649839409741,COGS 100,A01,083972,Staff,46,0,60,14
1649839421792,COGS 101C,A01,083976,Staff,25,0,30,5
1649839427817,COGS 102A,A01,083978,Johnson; Christine M.,24,0,30,6
1649839433841,COGS 107B,A01,083980,Staff,33,0,50,17
1649839439864,COGS 115,A01,083982,Staff,21,0,30,9
1649839445888,COGS 118B,A01,083367,Staff,5,0,40,35
1649839451911,COGS 172,A01,083984,Provenzano; Emily Kara,20,0,30,10
1649839468393,COGS 177,A00,083368,Staff,4,0,30,26
1649839474416,COGS 186,A01,083986,Staff,25,0,40,15
1649839480440,COGS 187A,A01,083988,Boyle; Mary E. T.,40,0,60,20
1649839486480,CSE 8A,A50,084003,Miranda; Gregory Joseph,9,0,15,6
1649839492507,CSE 11,A01,084005,Miranda; Gregory Joseph,49,0,55,6
1649839498531,CSE 20,A01,084007,Staff,15,0,20,5
1649839504556,CSE 21,A01,084009,Staff,32,0,50,18
1649839510580,CSE 30,A01,083370,Cao; Yingjun,20,0,40,20
1649839516603,CSE 100,A01,083372,Cao; Yingjun,13,0,40,27
1649839522626,CSE 101,A01,084011,Staff,0,16,40,40
1649839528654,CSE 141,A01,083374,Eldon; John,0,13,75,75
1649839534679,CSE 141L,A01,083376,Eldon; John,0,16,75,75
1649839540703,CSE 175,A01,084013,Kumar; Rakesh,24,0,25,1
1649839546730,CSE 190,A00,092508,Staff,15,0,15,0
1649839552753,ECE 5,A01,084049,Morris; Karcher William,17,0,20,3
1649839558783,ECE 100,A01,084051,Baghdadchi; Saharnaz,16,0,20,4
1649839558783,ECE 100,A02,091916,Baghdadchi; Saharnaz,18,0,20,2
1649839564809,ECE 101,A01,084053,Baghdadchi; Saharnaz,25,0,37,12
1649839564809,ECE 101,A02,084054,Baghdadchi; Saharnaz,37,0,37,0
1649839570834,ECE 107,A01,083390,Staff,31,0,40,9
1649839576860,ECE 148,A01,084056,Silberman; Jack,8,0,12,4
1649839582888,ECE 180,A00,083391,Abi Samra; Nicholas Camill,27,0,30,3
1649839582888,ECE 180,B00,083392,Abi Samra; Nicholas Camill,26,0,30,4
1649839588912,MATH 10B,A01,084110,Staff,20,0,30,10
1649839588912,MATH 10B,A02,084111,Staff,29,0,30,1
1649839588912,MATH 10B,A03,084112,Staff,29,0,30,1
1649839595015,MATH 10C,A01,083443,Staff,19,0,30,11
1649839595015,MATH 10C,A02,083444,Staff,24,0,30,6
1649839595015,MATH 10C,B01,084114,Staff,26,0,30,4
1649839595015,MATH 10C,B02,084115,Staff,30,0,30,0
1649839601041,MATH 18,A01,084117,Harel; Guershon,28,0,30,2
1649839601041,MATH 18,A02,084119,Harel; Guershon,29,0,30,1
1649839601041,MATH 18,A03,084120,Harel; Guershon,30,0,30,0
1649839601041,MATH 18,A04,084121,Harel; Guershon,30,0,30,0
1649839607079,MATH 20B,A01,084124,Um; Ko Woon,33,0,35,2
1649839607079,MATH 20B,B01,084126,Um; Ko Woon,35,0,35,0
1649839613108,MATH 20C,A01,083446,Hammock; Frances H,26,0,30,4
1649839613108,MATH 20C,A02,083447,Hammock; Frances H,30,0,30,0
1649839613108,MATH 20C,A03,083448,Hammock; Frances H,30,0,30,0
1649839613108,MATH 20C,A04,083449,Hammock; Frances H,30,0,30,0
1649839613108,MATH 20C,B01,083451,Hammock; Frances H,29,0,30,1
1649839613108,MATH 20C,B02,083452,Hammock; Frances H,30,0,30,0
1649839613108,MATH 20C,B03,083453,Hammock; Frances H,30,0,30,0
1649839613108,MATH 20C,B04,083454,Hammock; Frances H,30,0,30,0
1649839619138,MATH 20D,A01,084128,Staff,29,0,30,1
1649839619138,MATH 20D,A02,084129,Staff,30,0,30,0
1649839619138,MATH 20D,A03,084130,Staff,29,0,30,1
1649839619138,MATH 20D,B01,084133,Staff,28,0,30,2
1649839619138,MATH 20D,B02,084134,Staff,30,0,30,0
1649839619138,MATH 20D,B03,084135,Staff,30,0,30,0
1649839625233,MATH 20E,A01,084138,Staff,27,0,30,3
1649839625233,MATH 20E,A02,084139,Staff,29,0,30,1
1649839625233,MATH 20E,A03,084140,Staff,28,0,30,2
1649839625233,MATH 20E,A04,084141,Staff,30,0,30,0
1649839631259,MATH 102,A01,084143,Harel; Guershon,24,0,30,6
1649839631259,MATH 102,A02,084144,Harel; Guershon,25,0,30,5
1649839637285,MATH 103B,A01,083456,Staff,0,0,30,30
1649839637285,MATH 103B,A02,083457,Staff,19,0,30,11
1649839643311,MATH 109,A01,084146,Salehi Golsefidy; Alireza,30,0,30,0
1649839643311,MATH 109,A02,084147,Salehi Golsefidy; Alireza,26,0,30,4
1649839649339,MATH 120A,A01,085445,Eggers; John Dietrich,30,0,35,5
1649839649339,MATH 120A,A02,085446,Eggers; John Dietrich,31,0,35,4
1649839655363,MATH 142B,A01,084149,Verstraete; Jacques Allan,7,0,30,23
1649839655363,MATH 142B,A02,084150,Verstraete; Jacques Allan,25,0,30,5
1649839661386,MATH 170A,A01,083459,Nie; Jiawang,9,0,30,21
1649839661386,MATH 170A,A02,083460,Nie; Jiawang,25,0,30,5
1649839661386,MATH 170A,A03,083461,Nie; Jiawang,26,0,30,4
1649839667413,MATH 193B,A01,083463,Staff,15,0,30,15
1649839667413,MATH 193B,A02,083464,Staff,19,0,30,11
1649839667413,MATH 193B,A03,083465,Staff,27,0,30,3
1649839673478,COGS 2,A01,083966,Boyle; Mary E. T.,27,0,30,3
1649839679503,COGS 9,A01,083968,Staff,56,0,60,4
1649839685525,COGS 14B,A01,083970,Staff,46,0,50,4
1649839691558,COGS 17,A01,092679,Staff,73,0,75,2
1649839697590,COGS 100,A01,083972,Staff,46,0,60,14
1649839709639,COGS 101C,A01,083976,Staff,25,0,30,5
1649839715665,COGS 102A,A01,083978,Johnson; Christine M.,24,0,30,6
1649839721696,COGS 107B,A01,083980,Staff,33,0,50,17
1649839727723,COGS 115,A01,083982,Staff,21,0,30,9
1649839733746,COGS 118B,A01,083367,Staff,5,0,40,35
1649839739770,COGS 172,A01,083984,Provenzano; Emily Kara,20,0,30,10
1649839745801,COGS 177,A00,083368,Staff,4,0,30,26
1649839751828,COGS 186,A01,083986,Staff,25,0,40,15
1649839757854,COGS 187A,A01,083988,Boyle; Mary E. T.,40,0,60,20
1649839763885,CSE 8A,A50,084003,Miranda; Gregory Joseph,9,0,15,6
1649839769913,CSE 11,A01,084005,Miranda; Gregory Joseph,49,0,55,6
1649839775941,CSE 20,A01,084007,Staff,15,0,20,5
1649839781969,CSE 21,A01,084009,Staff,32,0,50,18
1649839788013,CSE 30,A01,083370,Cao; Yingjun,20,0,40,20
1649839794035,CSE 100,A01,083372,Cao; Yingjun,13,0,40,27
1649839800070,CSE 101,A01,084011,Staff,0,16,40,40
1649839806113,CSE 141,A01,083374,Eldon; John,0,13,75,75
1649839812137,CSE 141L,A01,083376,Eldon; John,0,16,75,75
1649839818173,CSE 175,A01,084013,Kumar; Rakesh,24,0,25,1
1649839824201,CSE 190,A00,092508,Staff,15,0,15,0
1649839830235,ECE 5,A01,084049,Morris; Karcher William,17,0,20,3
1649839836261,ECE 100,A01,084051,Baghdadchi; Saharnaz,16,0,20,4
1649839836261,ECE 100,A02,091916,Baghdadchi; Saharnaz,18,0,20,2
1649839842284,ECE 101,A01,084053,Baghdadchi; Saharnaz,25,0,37,12
1649839842284,ECE 101,A02,084054,Baghdadchi; Saharnaz,37,0,37,0
1649839848313,ECE 107,A01,083390,Staff,31,0,40,9
1649839854337,ECE 148,A01,084056,Silberman; Jack,8,0,12,4
1649839860365,ECE 180,A00,083391,Abi Samra; Nicholas Camill,27,0,30,3
1649839860365,ECE 180,B00,083392,Abi Samra; Nicholas Camill,26,0,30,4
1649839866390,MATH 10B,A01,084110,Staff,20,0,30,10
1649839866390,MATH 10B,A02,084111,Staff,29,0,30,1
1649839866390,MATH 10B,A03,084112,Staff,29,0,30,1
1649839872418,MATH 10C,A01,083443,Staff,19,0,30,11
1649839872418,MATH 10C,A02,083444,Staff,24,0,30,6
1649839872418,MATH 10C,B01,084114,Staff,26,0,30,4
1649839872418,MATH 10C,B02,084115,Staff,30,0,30,0
1649839878449,MATH 18,A01,084117,Harel; Guershon,28,0,30,2
1649839878449,MATH 18,A02,084119,Harel; Guershon,29,0,30,1
1649839878449,MATH 18,A03,084120,Harel; Guershon,30,0,30,0
1649839878449,MATH 18,A04,084121,Harel; Guershon,30,0,30,0
1649839884475,MATH 20B,A01,084124,Um; Ko Woon,33,0,35,2
1649839884475,MATH 20B,B01,084126,Um; Ko Woon,35,0,35,0
1649839890500,MATH 20C,A01,083446,Hammock; Frances H,26,0,30,4
1649839890500,MATH 20C,A02,083447,Hammock; Frances H,30,0,30,0
1649839890500,MATH 20C,A03,083448,Hammock; Frances H,30,0,30,0
1649839890500,MATH 20C,A04,083449,Hammock; Frances H,30,0,30,0
1649839890500,MATH 20C,B01,083451,Hammock; Frances H,29,0,30,1
1649839890500,MATH 20C,B02,083452,Hammock; Frances H,30,0,30,0
1649839890500,MATH 20C,B03,083453,Hammock; Frances H,30,0,30,0
1649839890500,MATH 20C,B04,083454,Hammock; Frances H,30,0,30,0
1649839896538,MATH 20D,A01,084128,Staff,29,0,30,1
1649839896538,MATH 20D,A02,084129,Staff,30,0,30,0
1649839896538,MATH 20D,A03,084130,Staff,29,0,30,1
1649839896538,MATH 20D,B01,084133,Staff,28,0,30,2
1649839896538,MATH 20D,B02,084134,Staff,30,0,30,0
1649839896538,MATH 20D,B03,084135,Staff,30,0,30,0
1649839902564,MATH 20E,A01,084138,Staff,27,0,30,3
1649839902564,MATH 20E,A02,084139,Staff,29,0,30,1
1649839902564,MATH 20E,A03,084140,Staff,28,0,30,2
1649839902564,MATH 20E,A04,084141,Staff,30,0,30,0
1649839908594,MATH 102,A01,084143,Harel; Guershon,24,0,30,6
1649839908594,MATH 102,A02,084144,Harel; Guershon,25,0,30,5
1649839914622,MATH 103B,A01,083456,Staff,0,0,30,30
1649839914622,MATH 103B,A02,083457,Staff,19,0,30,11
1649839920663,MATH 109,A01,084146,Salehi Golsefidy; Alireza,30,0,30,0
1649839920663,MATH 109,A02,084147,Salehi Golsefidy; Alireza,26,0,30,4
1649839926694,MATH 120A,A01,085445,Eggers; John Dietrich,30,0,35,5
1649839926694,MATH 120A,A02,085446,Eggers; John Dietrich,31,0,35,4
1649839932718,MATH 142B,A01,084149,Verstraete; Jacques Allan,7,0,30,23
1649839932718,MATH 142B,A02,084150,Verstraete; Jacques Allan,25,0,30,5
1649839938747,MATH 170A,A01,083459,Nie; Jiawang,9,0,30,21
1649839938747,MATH 170A,A02,083460,Nie; Jiawang,25,0,30,5
1649839938747,MATH 170A,A03,083461,Nie; Jiawang,26,0,30,4
1649839944776,MATH 193B,A01,083463,Staff,15,0,30,15
1649839944776,MATH 193B,A02,083464,Staff,19,0,30,11
1649839944776,MATH 193B,A03,083465,Staff,27,0,30,3
1649839950836,COGS 2,A01,083966,Boyle; Mary E. T.,27,0,30,3
1649839956859,COGS 9,A01,083968,Staff,56,0,60,4
1649839962881,COGS 14B,A01,083970,Staff,46,0,50,4
1649839968909,COGS 17,A01,092679,Staff,73,0,75,2
1649839974932,COGS 100,A01,083972,Staff,46,0,60,14
1649839986981,COGS 101C,A01,083976,Staff,25,0,30,5
1649839993008,COGS 102A,A01,083978,Johnson; Christine M.,24,0,30,6
1649839999032,COGS 107B,A01,083980,Staff,33,0,50,17
1649840005060,COGS 115,A01,083982,Staff,21,0,30,9
1649840011083,COGS 118B,A01,083367,Staff,5,0,40,35
1649840017107,COGS 172,A01,083984,Provenzano; Emily Kara,20,0,30,10
1649840023135,COGS 177,A00,083368,Staff,4,0,30,26
1649840029159,COGS 186,A01,083986,Staff,25,0,40,15
1649840035186,COGS 187A,A01,083988,Boyle; Mary E. T.,40,0,60,20
1649840041214,CSE 8A,A50,084003,Miranda; Gregory Joseph,9,0,15,6
1649840047242,CSE 11,A01,084005,Miranda; Gregory Joseph,49,0,55,6
1649840053265,CSE 20,A01,084007,Staff,15,0,20,5
1649840059289,CSE 21,A01,084009,Staff,32,0,50,18
1649840065314,CSE 30,A01,083370,Cao; Yingjun,20,0,40,20
1649840071337,CSE 100,A01,083372,Cao; Yingjun,13,0,40,27
1649840077361,CSE 101,A01,084011,Staff,0,16,40,40
1649840083389,CSE 141,A01,083374,Eldon; John,0,13,75,75
1649840089411,CSE 141L,A01,083376,Eldon; John,0,16,75,75
1649840095437,CSE 175,A01,084013,Kumar; Rakesh,24,0,25,1
1649840101463,CSE 190,A00,092508,Staff,15,0,15,0
1649840107490,ECE 5,A01,084049,Morris; Karcher William,17,0,20,3
1649840113520,ECE 100,A01,084051,Baghdadchi; Saharnaz,16,0,20,4
1649840113520,ECE 100,A02,091916,Baghdadchi; Saharnaz,18,0,20,2
1649840119544,ECE 101,A01,084053,Baghdadchi; Saharnaz,25,0,37,12
1649840119544,ECE 101,A02,084054,Baghdadchi; Saharnaz,37,0,37,0
1649840125568,ECE 107,A01,083390,Staff,31,0,40,9
1649840131591,ECE 148,A01,084056,Silberman; Jack,8,0,12,4
1649840137615,ECE 180,A00,083391,Abi Samra; Nicholas Camill,27,0,30,3
1649840137615,ECE 180,B00,083392,Abi Samra; Nicholas Camill,26,0,30,4
1649840143641,MATH 10B,A01,084110,Staff,20,0,30,10
1649840143641,MATH 10B,A02,084111,Staff,29,0,30,1
1649840143641,MATH 10B,A03,084112,Staff,29,0,30,1
1649840149666,MATH 10C,A01,083443,Staff,19,0,30,11
1649840149666,MATH 10C,A02,083444,Staff,24,0,30,6
1649840149666,MATH 10C,B01,084114,Staff,26,0,30,4
1649840149666,MATH 10C,B02,084115,Staff,30,0,30,0
1649840155691,MATH 18,A01,084117,Harel; Guershon,28,0,30,2
1649840155691,MATH 18,A02,084119,Harel; Guershon,29,0,30,1
1649840155691,MATH 18,A03,084120,Harel; Guershon,30,0,30,0
1649840155691,MATH 18,A04,084121,Harel; Guershon,30,0,30,0
1649840161715,MATH 20B,A01,084124,Um; Ko Woon,33,0,35,2
1649840161715,MATH 20B,B01,084126,Um; Ko Woon,35,0,35,0
1649840167741,MATH 20C,A01,083446,Hammock; Frances H,26,0,30,4
1649840167741,MATH 20C,A02,083447,Hammock; Frances H,30,0,30,0
1649840167741,MATH 20C,A03,083448,Hammock; Frances H,30,0,30,0
1649840167741,MATH 20C,A04,083449,Hammock; Frances H,30,0,30,0
1649840167741,MATH 20C,B01,083451,Hammock; Frances H,29,0,30,1
1649840167741,MATH 20C,B02,083452,Hammock; Frances H,30,0,30,0
1649840167741,MATH 20C,B03,083453,Hammock; Frances H,30,0,30,0
1649840167741,MATH 20C,B04,083454,Hammock; Frances H,30,0,30,0
1649840173772,MATH 20D,A01,084128,Staff,29,0,30,1
1649840173772,MATH 20D,A02,084129,Staff,30,0,30,0
1649840173772,MATH 20D,A03,084130,Staff,29,0,30,1
1649840173772,MATH 20D,B01,084133,Staff,28,0,30,2
1649840173772,MATH 20D,B02,084134,Staff,30,0,30,0
1649840173772,MATH 20D,B03,084135,Staff,30,0,30,0
1649840179803,MATH 20E,A01,084138,Staff,27,0,30,3
1649840179803,MATH 20E,A02,084139,Staff,29,0,30,1
1649840179803,MATH 20E,A03,084140,Staff,28,0,30,2
1649840179803,MATH 20E,A04,084141,Staff,30,0,30,0
1649840185831,MATH 102,A01,084143,Harel; Guershon,24,0,30,6
1649840185831,MATH 102,A02,084144,Harel; Guershon,25,0,30,5
1649840191942,MATH 103B,A01,083456,Staff,0,0,30,30
1649840191942,MATH 103B,A02,083457,Staff,18,0,30,12
1649840197966,MATH 109,A01,084146,Salehi Golsefidy; Alireza,30,0,30,0
1649840197966,MATH 109,A02,084147,Salehi Golsefidy; Alireza,26,0,30,4
1649840203992,MATH 120A,A01,085445,Eggers; John Dietrich,30,0,35,5
1649840203992,MATH 120A,A02,085446,Eggers; John Dietrich,31,0,35,4
1649840210020,MATH 142B,A01,084149,Verstraete; Jacques Allan,7,0,30,23
1649840210020,MATH 142B,A02,084150,Verstraete; Jacques Allan,25,0,30,5
1649840216047,MATH 170A,A01,083459,Nie; Jiawang,9,0,30,21
1649840216047,MATH 170A,A02,083460,Nie; Jiawang,25,0,30,5
1649840216047,MATH 170A,A03,083461,Nie; Jiawang,26,0,30,4
1649840222071,MATH 193B,A01,083463,Staff,15,0,30,15
1649840222071,MATH 193B,A02,083464,Staff,19,0,30,11
1649840222071,MATH 193B,A03,083465,Staff,27,0,30,3
1649840228135,COGS 2,A01,083966,Boyle; Mary E. T.,27,0,30,3
1649840234159,COGS 9,A01,083968,Staff,56,0,60,4
1649840240183,COGS 14B,A01,083970,Staff,46,0,50,4
1649840246213,COGS 17,A01,092679,Staff,73,0,75,2
1649840252250,COGS 100,A01,083972,Staff,46,0,60,14
1649840264300,COGS 101C,A01,083976,Staff,25,0,30,5
1649840270324,COGS 102A,A01,083978,Johnson; Christine M.,24,0,30,6
1649840276348,COGS 107B,A01,083980,Staff,33,0,50,17
1649840282375,COGS 115,A01,083982,Staff,21,0,30,9
1649840288402,COGS 118B,A01,083367,Staff,5,0,40,35
1649840294425,COGS 172,A01,083984,Provenzano; Emily Kara,20,0,30,10
1649840300448,COGS 177,A00,083368,Staff,4,0,30,26
1649840306476,COGS 186,A01,083986,Staff,25,0,40,15
1649840312502,COGS 187A,A01,083988,Boyle; Mary E. T.,40,0,60,20
1649840318526,CSE 8A,A50,084003,Miranda; Gregory Joseph,9,0,15,6
1649840324554,CSE 11,A01,084005,Miranda; Gregory Joseph,49,0,55,6
1649840330580,CSE 20,A01,084007,Staff,15,0,20,5
1649840336604,CSE 21,A01,084009,Staff,32,0,50,18
1649840342627,CSE 30,A01,083370,Cao; Yingjun,20,0,40,20
1649840348662,CSE 100,A01,083372,Cao; Yingjun,13,0,40,27
1649840354688,CSE 101,A01,084011,Staff,0,16,40,40
1649840360712,CSE 141,A01,083374,Eldon; John,0,13,75,75
1649840366739,CSE 141L,A01,083376,Eldon; John,0,16,75,75
1649840372764,CSE 175,A01,084013,Kumar; Rakesh,24,0,25,1
1649840378791,CSE 190,A00,092508,Staff,15,0,15,0
1649840384829,ECE 5,A01,084049,Morris; Karcher William,17,0,20,3
1649840390862,ECE 100,A01,084051,Baghdadchi; Saharnaz,16,0,20,4
1649840390862,ECE 100,A02,091916,Baghdadchi; Saharnaz,18,0,20,2
1649840396886,ECE 101,A01,084053,Baghdadchi; Saharnaz,25,0,37,12
1649840396886,ECE 101,A02,084054,Baghdadchi; Saharnaz,37,0,37,0
1649840402916,ECE 107,A01,083390,Staff,31,0,40,9
1649840408938,ECE 148,A01,084056,Silberman; Jack,8,0,12,4
1649840414966,ECE 180,A00,083391,Abi Samra; Nicholas Camill,27,0,30,3
1649840414966,ECE 180,B00,083392,Abi Samra; Nicholas Camill,26,0,30,4
1649840420995,MATH 10B,A01,084110,Staff,20,0,30,10
1649840420995,MATH 10B,A02,084111,Staff,29,0,30,1
1649840420995,MATH 10B,A03,084112,Staff,29,0,30,1
1649840427022,MATH 10C,A01,083443,Staff,19,0,30,11
1649840427022,MATH 10C,A02,083444,Staff,24,0,30,6
1649840427022,MATH 10C,B01,084114,Staff,26,0,30,4
1649840427022,MATH 10C,B02,084115,Staff,30,0,30,0
1649840433051,MATH 18,A01,084117,Harel; Guershon,28,0,30,2
1649840433051,MATH 18,A02,084119,Harel; Guershon,29,0,30,1
1649840433051,MATH 18,A03,084120,Harel; Guershon,30,0,30,0
1649840433051,MATH 18,A04,084121,Harel; Guershon,30,0,30,0
1649840439080,MATH 20B,A01,084124,Um; Ko Woon,33,0,35,2
1649840439080,MATH 20B,B01,084126,Um; Ko Woon,35,0,35,0
1649840445104,MATH 20C,A01,083446,Hammock; Frances H,26,0,30,4
1649840445104,MATH 20C,A02,083447,Hammock; Frances H,30,0,30,0
1649840445104,MATH 20C,A03,083448,Hammock; Frances H,30,0,30,0
1649840445104,MATH 20C,A04,083449,Hammock; Frances H,30,0,30,0
1649840445104,MATH 20C,B01,083451,Hammock; Frances H,29,0,30,1
1649840445104,MATH 20C,B02,083452,Hammock; Frances H,30,0,30,0
1649840445104,MATH 20C,B03,083453,Hammock; Frances H,30,0,30,0
1649840445104,MATH 20C,B04,083454,Hammock; Frances H,30,0,30,0
1649840451130,MATH 20D,A01,084128,Staff,29,0,30,1
1649840451130,MATH 20D,A02,084129,Staff,30,0,30,0
1649840451130,MATH 20D,A03,084130,Staff,29,0,30,1
1649840451130,MATH 20D,B01,084133,Staff,28,0,30,2
1649840451130,MATH 20D,B02,084134,Staff,30,0,30,0
1649840451130,MATH 20D,B03,084135,Staff,30,0,30,0
1649840457154,MATH 20E,A01,084138,Staff,27,0,30,3
1649840457154,MATH 20E,A02,084139,Staff,29,0,30,1
1649840457154,MATH 20E,A03,084140,Staff,28,0,30,2
1649840457154,MATH 20E,A04,084141,Staff,30,0,30,0
1649840463183,MATH 102,A01,084143,Harel; Guershon,24,0,30,6
1649840463183,MATH 102,A02,084144,Harel; Guershon,25,0,30,5
1649840469217,MATH 103B,A01,083456,Staff,0,0,30,30
1649840469217,MATH 103B,A02,083457,Staff,18,0,30,12
1649840475243,MATH 109,A01,084146,Salehi Golsefidy; Alireza,30,0,30,0
1649840475243,MATH 109,A02,084147,Salehi Golsefidy; Alireza,26,0,30,4
1649840481270,MATH 120A,A01,085445,Eggers; John Dietrich,30,0,35,5
1649840481270,MATH 120A,A02,085446,Eggers; John Dietrich,31,0,35,4
1649840487295,MATH 142B,A01,084149,Verstraete; Jacques Allan,7,0,30,23
1649840487295,MATH 142B,A02,084150,Verstraete; Jacques Allan,25,0,30,5
1649840493326,MATH 170A,A01,083459,Nie; Jiawang,9,0,30,21
1649840493326,MATH 170A,A02,083460,Nie; Jiawang,25,0,30,5
1649840493326,MATH 170A,A03,083461,Nie; Jiawang,26,0,30,4
1649840499348,MATH 193B,A01,083463,Staff,15,0,30,15
1649840499348,MATH 193B,A02,083464,Staff,19,0,30,11
1649840499348,MATH 193B,A03,083465,Staff,27,0,30,3
1649840505405,COGS 2,A01,083966,Boyle; Mary E. T.,27,0,30,3
1649840511435,COGS 9,A01,083968,Staff,56,0,60,4
1649840517471,COGS 14B,A01,083970,Staff,46,0,50,4
1649840523497,COGS 17,A01,092679,Staff,73,0,75,2
1649840529524,COGS 100,A01,083972,Staff,46,0,60,14
1649840541578,COGS 101C,A01,083976,Staff,25,0,30,5
1649840547602,COGS 102A,A01,083978,Johnson; Christine M.,24,0,30,6
1649840553653,COGS 107B,A01,083980,Staff,33,0,50,17
1649840559677,COGS 115,A01,083982,Staff,21,0,30,9
1649840565706,COGS 118B,A01,083367,Staff,5,0,40,35
1649840571732,COGS 172,A01,083984,Provenzano; Emily Kara,20,0,30,10
1649840577760,COGS 177,A00,083368,Staff,4,0,30,26
1649840583784,COGS 186,A01,083986,Staff,25,0,40,15
1649840589812,COGS 187A,A01,083988,Boyle; Mary E. T.,40,0,60,20
1649840595844,CSE 8A,A50,084003,Miranda; Gregory Joseph,9,0,15,6
1649840601876,CSE 11,A01,084005,Miranda; Gregory Joseph,49,0,55,6
1649840607900,CSE 20,A01,084007,Staff,15,0,20,5
1649840613923,CSE 21,A01,084009,Staff,32,0,50,18
1649840619951,CSE 30,A01,083370,Cao; Yingjun,20,0,40,20
1649840625977,CSE 100,A01,083372,Cao; Yingjun,13,0,40,27
1649840632002,CSE 101,A01,084011,Staff,0,16,40,40
1649840638026,CSE 141,A01,083374,Eldon; John,0,13,75,75
1649840644049,CSE 141L,A01,083376,Eldon; John,0,16,75,75
1649840650073,CSE 175,A01,084013,Kumar; Rakesh,24,0,25,1
1649840656102,CSE 190,A00,092508,Staff,15,0,15,0
1649840662132,ECE 5,A01,084049,Morris; Karcher William,17,0,20,3
1649840668161,ECE 100,A01,084051,Baghdadchi; Saharnaz,16,0,20,4
1649840668161,ECE 100,A02,091916,Baghdadchi; Saharnaz,18,0,20,2
1649840674188,ECE 101,A01,084053,Baghdadchi; Saharnaz,25,0,37,12
1649840674188,ECE 101,A02,084054,Baghdadchi; Saharnaz,37,0,37,0
1649840680215,ECE 107,A01,083390,Staff,31,0,40,9
1649840686239,ECE 148,A01,084056,Silberman; Jack,8,0,12,4
1649840692269,ECE 180,A00,083391,Abi Samra; Nicholas Camill,27,0,30,3
1649840692269,ECE 180,B00,083392,Abi Samra; Nicholas Camill,26,0,30,4
1649840698301,MATH 10B,A01,084110,Staff,20,0,30,10
1649840698301,MATH 10B,A02,084111,Staff,29,0,30,1
1649840698301,MATH 10B,A03,084112,Staff,29,0,30,1
1649840704328,MATH 10C,A01,083443,Staff,19,0,30,11
1649840704328,MATH 10C,A02,083444,Staff,24,0,30,6
1649840704328,MATH 10C,B01,084114,Staff,26,0,30,4
1649840704328,MATH 10C,B02,084115,Staff,30,0,30,0
1649840710352,MATH 18,A01,084117,Harel; Guershon,28,0,30,2
1649840710352,MATH 18,A02,084119,Harel; Guershon,29,0,30,1
1649840710352,MATH 18,A03,084120,Harel; Guershon,30,0,30,0
1649840710352,MATH 18,A04,084121,Harel; Guershon,30,0,30,0
1649840716382,MATH 20B,A01,084124,Um; Ko Woon,33,0,35,2
1649840716382,MATH 20B,B01,084126,Um; Ko Woon,35,0,35,0
1649840722409,MATH 20C,A01,083446,Hammock; Frances H,26,0,30,4
1649840722409,MATH 20C,A02,083447,Hammock; Frances H,30,0,30,0
1649840722409,MATH 20C,A03,083448,Hammock; Frances H,30,0,30,0
1649840722409,MATH 20C,A04,083449,Hammock; Frances H,30,0,30,0
1649840722409,MATH 20C,B01,083451,Hammock; Frances H,29,0,30,1
1649840722409,MATH 20C,B02,083452,Hammock; Frances H,30,0,30,0
1649840722409,MATH 20C,B03,083453,Hammock; Frances H,30,0,30,0
1649840722409,MATH 20C,B04,083454,Hammock; Frances H,30,0,30,0
1649840728432,MATH 20D,A01,084128,Staff,29,0,30,1
1649840728432,MATH 20D,A02,084129,Staff,30,0,30,0
1649840728432,MATH 20D,A03,084130,Staff,29,0,30,1
1649840728432,MATH 20D,B01,084133,Staff,28,0,30,2
1649840728432,MATH 20D,B02,084134,Staff,30,0,30,0
1649840728432,MATH 20D,B03,084135,Staff,30,0,30,0
1649840734456,MATH 20E,A01,084138,Staff,27,0,30,3
1649840734456,MATH 20E,A02,084139,Staff,29,0,30,1
1649840734456,MATH 20E,A03,084140,Staff,28,0,30,2
1649840734456,MATH 20E,A04,084141,Staff,30,0,30,0
1649840740479,MATH 102,A01,084143,Harel; Guershon,24,0,30,6
1649840740479,MATH 102,A02,084144,Harel; Guershon,25,0,30,5
1649840746506,MATH 103B,A01,083456,Staff,0,0,30,30
1649840746506,MATH 103B,A02,083457,Staff,18,0,30,12
1649840752530,MATH 109,A01,084146,Salehi Golsefidy; Alireza,30,0,30,0
1649840752530,MATH 109,A02,084147,Salehi Golsefidy; Alireza,26,0,30,4
1649840758551,MATH 120A,A01,085445,Eggers; John Dietrich,30,0,35,5
1649840758551,MATH 120A,A02,085446,Eggers; John Dietrich,31,0,35,4
1649840764574,MATH 142B,A01,084149,Verstraete; Jacques Allan,7,0,30,23
1649840764574,MATH 142B,A02,084150,Verstraete; Jacques Allan,25,0,30,5
1649840770604,MATH 170A,A01,083459,Nie; Jiawang,9,0,30,21
1649840770604,MATH 170A,A02,083460,Nie; Jiawang,25,0,30,5
1649840770604,MATH 170A,A03,083461,Nie; Jiawang,26,0,30,4
1649840776631,MATH 193B,A01,083463,Staff,15,0,30,15
1649840776631,MATH 193B,A02,083464,Staff,19,0,30,11
1649840776631,MATH 193B,A03,083465,Staff,27,0,30,3
1649840782799,COGS 2,A01,083966,Boyle; Mary E. T.,27,0,30,3
1649840788833,COGS 9,A01,083968,Staff,56,0,60,4
1649840794856,COGS 14B,A01,083970,Staff,46,0,50,4
1649840800878,COGS 17,A01,092679,Staff,73,0,75,2
1649840806902,COGS 100,A01,083972,Staff,46,0,60,14
1649840818958,COGS 101C,A01,083976,Staff,25,0,30,5
1649840824982,COGS 102A,A01,083978,Johnson; Christine M.,24,0,30,6
1649840831009,COGS 107B,A01,083980,Staff,33,0,50,17
1649840837031,COGS 115,A01,083982,Staff,21,0,30,9
1649840843055,COGS 118B,A01,083367,Staff,5,0,40,35
1649840849085,COGS 172,A01,083984,Provenzano; Emily Kara,20,0,30,10
1649840855111,COGS 177,A00,083368,Staff,4,0,30,26
1649840861137,COGS 186,A01,083986,Staff,25,0,40,15
1649840867165,COGS 187A,A01,083988,Boyle; Mary E. T.,40,0,60,20
1649840873193,CSE 8A,A50,084003,Miranda; Gregory Joseph,9,0,15,6
1649840879224,CSE 11,A01,084005,Miranda; Gregory Joseph,49,0,55,6
1649840885254,CSE 20,A01,084007,Staff,15,0,20,5
1649840891278,CSE 21,A01,084009,Staff,32,0,50,18
1649840897313,CSE 30,A01,083370,Cao; Yingjun,20,0,40,20
1649840903340,CSE 100,A01,083372,Cao; Yingjun,13,0,40,27
1649840909372,CSE 101,A01,084011,Staff,0,16,40,40
1649840915395,CSE 141,A01,083374,Eldon; John,0,13,75,75
1649840921419,CSE 141L,A01,083376,Eldon; John,0,16,75,75
1649840927445,CSE 175,A01,084013,Kumar; Rakesh,24,0,25,1
1649840933470,CSE 190,A00,092508,Staff,15,0,15,0
1649840939502,ECE 5,A01,084049,Morris; Karcher William,17,0,20,3
1649840945530,ECE 100,A01,084051,Baghdadchi; Saharnaz,16,0,20,4
1649840945530,ECE 100,A02,091916,Baghdadchi; Saharnaz,18,0,20,2
1649840951555,ECE 101,A01,084053,Baghdadchi; Saharnaz,25,0,37,12
1649840951555,ECE 101,A02,084054,Baghdadchi; Saharnaz,37,0,37,0
1649840957587,ECE 107,A01,083390,Staff,31,0,40,9
1649840963613,ECE 148,A01,084056,Silberman; Jack,8,0,12,4
1649840969647,ECE 180,A00,083391,Abi Samra; Nicholas Camill,27,0,30,3
1649840969647,ECE 180,B00,083392,Abi Samra; Nicholas Camill,26,0,30,4
1649840975674,MATH 10B,A01,084110,Staff,20,0,30,10
1649840975674,MATH 10B,A02,084111,Staff,29,0,30,1
1649840975674,MATH 10B,A03,084112,Staff,29,0,30,1
1649840981700,MATH 10C,A01,083443,Staff,19,0,30,11
1649840981700,MATH 10C,A02,083444,Staff,24,0,30,6
1649840981700,MATH 10C,B01,084114,Staff,26,0,30,4
1649840981700,MATH 10C,B02,084115,Staff,30,0,30,0
1649840987724,MATH 18,A01,084117,Harel; Guershon,28,0,30,2
1649840987724,MATH 18,A02,084119,Harel; Guershon,29,0,30,1
1649840987724,MATH 18,A03,084120,Harel; Guershon,30,0,30,0
1649840987724,MATH 18,A04,084121,Harel; Guershon,30,0,30,0
1649840993753,MATH 20B,A01,084124,Um; Ko Woon,33,0,35,2
1649840993753,MATH 20B,B01,084126,Um; Ko Woon,35,0,35,0
1649840999784,MATH 20C,A01,083446,Hammock; Frances H,26,0,30,4
1649840999784,MATH 20C,A02,083447,Hammock; Frances H,30,0,30,0
1649840999784,MATH 20C,A03,083448,Hammock; Frances H,30,0,30,0
1649840999784,MATH 20C,A04,083449,Hammock; Frances H,30,0,30,0
1649840999784,MATH 20C,B01,083451,Hammock; Frances H,29,0,30,1
1649840999784,MATH 20C,B02,083452,Hammock; Frances H,30,0,30,0
1649840999784,MATH 20C,B03,083453,Hammock; Frances H,30,0,30,0
1649840999784,MATH 20C,B04,083454,Hammock; Frances H,30,0,30,0
1649841005811,MATH 20D,A01,084128,Staff,29,0,30,1
1649841005811,MATH 20D,A02,084129,Staff,30,0,30,0
1649841005811,MATH 20D,A03,084130,Staff,29,0,30,1
1649841005811,MATH 20D,B01,084133,Staff,28,0,30,2
1649841005811,MATH 20D,B02,084134,Staff,30,0,30,0
1649841005811,MATH 20D,B03,084135,Staff,30,0,30,0
1649841011838,MATH 20E,A01,084138,Staff,27,0,30,3
1649841011838,MATH 20E,A02,084139,Staff,29,0,30,1
1649841011838,MATH 20E,A03,084140,Staff,28,0,30,2
1649841011838,MATH 20E,A04,084141,Staff,30,0,30,0
1649841017863,MATH 102,A01,084143,Harel; Guershon,24,0,30,6
1649841017863,MATH 102,A02,084144,Harel; Guershon,25,0,30,5
1649841023892,MATH 103B,A01,083456,Staff,0,0,30,30
1649841023892,MATH 103B,A02,083457,Staff,18,0,30,12
1649841029920,MATH 109,A01,084146,Salehi Golsefidy; Alireza,30,0,30,0
1649841029920,MATH 109,A02,084147,Salehi Golsefidy; Alireza,26,0,30,4
1649841035950,MATH 120A,A01,085445,Eggers; John Dietrich,30,0,35,5
1649841035950,MATH 120A,A02,085446,Eggers; John Dietrich,31,0,35,4
1649841041982,MATH 142B,A01,084149,Verstraete; Jacques Allan,7,0,30,23
1649841041982,MATH 142B,A02,084150,Verstraete; Jacques Allan,25,0,30,5
1649841048009,MATH 170A,A01,083459,Nie; Jiawang,9,0,30,21
1649841048009,MATH 170A,A02,083460,Nie; Jiawang,25,0,30,5
1649841048009,MATH 170A,A03,083461,Nie; Jiawang,26,0,30,4
1649841054043,MATH 193B,A01,083463,Staff,15,0,30,15
1649841054043,MATH 193B,A02,083464,Staff,19,0,30,11
1649841054043,MATH 193B,A03,083465,Staff,27,0,30,3
1649841060143,COGS 2,A01,083966,Boyle; Mary E. T.,27,0,30,3
1649841066171,COGS 9,A01,083968,Staff,56,0,60,4
1649841072206,COGS 14B,A01,083970,Staff,46,0,50,4
1649841078232,COGS 17,A01,092679,Staff,73,0,75,2
1649841084256,COGS 100,A01,083972,Staff,46,0,60,14
1649841096312,COGS 101C,A01,083976,Staff,25,0,30,5
1649841102341,COGS 102A,A01,083978,Johnson; Christine M.,24,0,30,6
1649841108367,COGS 107B,A01,083980,Staff,33,0,50,17
1649841114391,COGS 115,A01,083982,Staff,21,0,30,9
1649841120421,COGS 118B,A01,083367,Staff,5,0,40,35
1649841126452,COGS 172,A01,083984,Provenzano; Emily Kara,20,0,30,10
1649841132479,COGS 177,A00,083368,Staff,4,0,30,26
1649841138501,COGS 186,A01,083986,Staff,25,0,40,15
1649841144530,COGS 187A,A01,083988,Boyle; Mary E. T.,40,0,60,20
1649841150559,CSE 8A,A50,084003,Miranda; Gregory Joseph,9,0,15,6
1649841156585,CSE 11,A01,084005,Miranda; Gregory Joseph,49,0,55,6
1649841162615,CSE 20,A01,084007,Staff,15,0,20,5
1649841168641,CSE 21,A01,084009,Staff,32,0,50,18
1649841174670,CSE 30,A01,083370,Cao; Yingjun,20,0,40,20
1649841180693,CSE 100,A01,083372,Cao; Yingjun,13,0,40,27
1649841186718,CSE 101,A01,084011,Staff,0,16,40,40
1649841192743,CSE 141,A01,083374,Eldon; John,0,13,75,75
1649841198767,CSE 141L,A01,083376,Eldon; John,0,16,75,75
1649841204796,CSE 175,A01,084013,Kumar; Rakesh,24,0,25,1
1649841210834,CSE 190,A00,092508,Staff,15,0,15,0
1649841216869,ECE 5,A01,084049,Morris; Karcher William,17,0,20,3
1649841222910,ECE 100,A01,084051,Baghdadchi; Saharnaz,16,0,20,4
1649841222910,ECE 100,A02,091916,Baghdadchi; Saharnaz,18,0,20,2
1649841228936,ECE 101,A01,084053,Baghdadchi; Saharnaz,25,0,37,12
1649841228936,ECE 101,A02,084054,Baghdadchi; Saharnaz,37,0,37,0
1649841234961,ECE 107,A01,083390,Staff,31,0,40,9
1649841240990,ECE 148,A01,084056,Silberman; Jack,8,0,12,4
1649841247017,ECE 180,A00,083391,Abi Samra; Nicholas Camill,27,0,30,3
1649841247017,ECE 180,B00,083392,Abi Samra; Nicholas Camill,26,0,30,4
1649841253047,MATH 10B,A01,084110,Staff,20,0,30,10
1649841253047,MATH 10B,A02,084111,Staff,29,0,30,1
1649841253047,MATH 10B,A03,084112,Staff,29,0,30,1
1649841259074,MATH 10C,A01,083443,Staff,19,0,30,11
1649841259074,MATH 10C,A02,083444,Staff,24,0,30,6
1649841259074,MATH 10C,B01,084114,Staff,26,0,30,4
1649841259074,MATH 10C,B02,084115,Staff,30,0,30,0
1649841265105,MATH 18,A01,084117,Harel; Guershon,28,0,30,2
1649841265105,MATH 18,A02,084119,Harel; Guershon,29,0,30,1
1649841265105,MATH 18,A03,084120,Harel; Guershon,30,0,30,0
1649841265105,MATH 18,A04,084121,Harel; Guershon,30,0,30,0
1649841271132,MATH 20B,A01,084124,Um; Ko Woon,33,0,35,2
1649841271132,MATH 20B,B01,084126,Um; Ko Woon,35,0,35,0
1649841277165,MATH 20C,A01,083446,Hammock; Frances H,26,0,30,4
1649841277165,MATH 20C,A02,083447,Hammock; Frances H,30,0,30,0
1649841277165,MATH 20C,A03,083448,Hammock; Frances H,30,0,30,0
1649841277165,MATH 20C,A04,083449,Hammock; Frances H,30,0,30,0
1649841277165,MATH 20C,B01,083451,Hammock; Frances H,29,0,30,1
1649841277165,MATH 20C,B02,083452,Hammock; Frances H,30,0,30,0
1649841277165,MATH 20C,B03,083453,Hammock; Frances H,30,0,30,0
1649841277165,MATH 20C,B04,083454,Hammock; Frances H,30,0,30,0
1649841283200,MATH 20D,A01,084128,Staff,29,0,30,1
1649841283200,MATH 20D,A02,084129,Staff,30,0,30,0
1649841283200,MATH 20D,A03,084130,Staff,29,0,30,1
1649841283200,MATH 20D,B01,084133,Staff,28,0,30,2
1649841283200,MATH 20D,B02,084134,Staff,30,0,30,0
1649841283200,MATH 20D,B03,084135,Staff,30,0,30,0
1649841289228,MATH 20E,A01,084138,Staff,27,0,30,3
1649841289228,MATH 20E,A02,084139,Staff,29,0,30,1
1649841289228,MATH 20E,A03,084140,Staff,28,0,30,2
1649841289228,MATH 20E,A04,084141,Staff,30,0,30,0
1649841295250,MATH 102,A01,084143,Harel; Guershon,24,0,30,6
1649841295250,MATH 102,A02,084144,Harel; Guershon,25,0,30,5
1649841301274,MATH 103B,A01,083456,Staff,0,0,30,30
1649841301274,MATH 103B,A02,083457,Staff,18,0,30,12
1649841307305,MATH 109,A01,084146,Salehi Golsefidy; Alireza,30,0,30,0
1649841307305,MATH 109,A02,084147,Salehi Golsefidy; Alireza,26,0,30,4
1649841313337,MATH 120A,A01,085445,Eggers; John Dietrich,30,0,35,5
1649841313337,MATH 120A,A02,085446,Eggers; John Dietrich,31,0,35,4
1649841319362,MATH 142B,A01,084149,Verstraete; Jacques Allan,7,0,30,23
1649841319362,MATH 142B,A02,084150,Verstraete; Jacques Allan,25,0,30,5
1649841325393,MATH 170A,A01,083459,Nie; Jiawang,9,0,30,21
1649841325393,MATH 170A,A02,083460,Nie; Jiawang,25,0,30,5
1649841325393,MATH 170A,A03,083461,Nie; Jiawang,26,0,30,4
1649841331422,MATH 193B,A01,083463,Staff,15,0,30,15
1649841331422,MATH 193B,A02,083464,Staff,19,0,30,11
1649841331422,MATH 193B,A03,083465,Staff,27,0,30,3
1649841337508,COGS 2,A01,083966,Boyle; Mary E. T.,27,0,30,3
1649841343532,COGS 9,A01,083968,Staff,56,0,60,4
1649841349562,COGS 14B,A01,083970,Staff,46,0,50,4
1649841355588,COGS 17,A01,092679,Staff,73,0,75,2
1649841361611,COGS 100,A01,083972,Staff,46,0,60,14
1649841373667,COGS 101C,A01,083976,Staff,25,0,30,5
1649841379799,COGS 102A,A01,083978,Johnson; Christine M.,24,0,30,6
1649841385828,COGS 107B,A01,083980,Staff,33,0,50,17
1649841391858,COGS 115,A01,083982,Staff,21,0,30,9
1649841397888,COGS 118B,A01,083367,Staff,5,0,40,35
1649841403913,COGS 172,A01,083984,Provenzano; Emily Kara,20,0,30,10
1649841409938,COGS 177,A00,083368,Staff,4,0,30,26
1649841415962,COGS 186,A01,083986,Staff,25,0,40,15
1649841422003,COGS 187A,A01,083988,Boyle; Mary E. T.,40,0,60,20
1649841428033,CSE 8A,A50,084003,Miranda; Gregory Joseph,9,0,15,6
1649841434058,CSE 11,A01,084005,Miranda; Gregory Joseph,49,0,55,6
1649841442096,CSE 20,A01,084007,Staff,15,0,20,5
1649841448122,CSE 21,A01,084009,Staff,32,0,50,18
1649841454151,CSE 30,A01,083370,Cao; Yingjun,20,0,40,20
1649841460178,CSE 100,A01,083372,Cao; Yingjun,13,0,40,27
1649841466206,CSE 101,A01,084011,Staff,0,16,40,40
1649841472230,CSE 141,A01,083374,Eldon; John,0,13,75,75
1649841478258,CSE 141L,A01,083376,Eldon; John,0,16,75,75
1649841484284,CSE 175,A01,084013,Kumar; Rakesh,24,0,25,1
1649841490313,CSE 190,A00,092508,Staff,15,0,15,0
1649841496344,ECE 5,A01,084049,Morris; Karcher William,17,0,20,3
1649841502384,ECE 100,A01,084051,Baghdadchi; Saharnaz,16,0,20,4
1649841502384,ECE 100,A02,091916,Baghdadchi; Saharnaz,18,0,20,2
1649841508409,ECE 101,A01,084053,Baghdadchi; Saharnaz,25,0,37,12
1649841508409,ECE 101,A02,084054,Baghdadchi; Saharnaz,37,0,37,0
1649841514436,ECE 107,A01,083390,Staff,31,0,40,9
1649841520465,ECE 148,A01,084056,Silberman; Jack,8,0,12,4
1649841526490,ECE 180,A00,083391,Abi Samra; Nicholas Camill,27,0,30,3
1649841526490,ECE 180,B00,083392,Abi Samra; Nicholas Camill,26,0,30,4
1649841532517,MATH 10B,A01,084110,Staff,20,0,30,10
1649841532517,MATH 10B,A02,084111,Staff,29,0,30,1
1649841532517,MATH 10B,A03,084112,Staff,29,0,30,1
1649841538543,MATH 10C,A01,083443,Staff,19,0,30,11
1649841538543,MATH 10C,A02,083444,Staff,24,0,30,6
1649841538543,MATH 10C,B01,084114,Staff,26,0,30,4
1649841538543,MATH 10C,B02,084115,Staff,30,0,30,0
1649841544570,MATH 18,A01,084117,Harel; Guershon,28,0,30,2
1649841544570,MATH 18,A02,084119,Harel; Guershon,29,0,30,1
1649841544570,MATH 18,A03,084120,Harel; Guershon,30,0,30,0
1649841544570,MATH 18,A04,084121,Harel; Guershon,30,0,30,0
1649841550601,MATH 20B,A01,084124,Um; Ko Woon,33,0,35,2
1649841550601,MATH 20B,B01,084126,Um; Ko Woon,35,0,35,0
1649841556625,MATH 20C,A01,083446,Hammock; Frances H,26,0,30,4
1649841556625,MATH 20C,A02,083447,Hammock; Frances H,30,0,30,0
1649841556625,MATH 20C,A03,083448,Hammock; Frances H,30,0,30,0
1649841556625,MATH 20C,A04,083449,Hammock; Frances H,30,0,30,0
1649841556625,MATH 20C,B01,083451,Hammock; Frances H,29,0,30,1
1649841556625,MATH 20C,B02,083452,Hammock; Frances H,30,0,30,0
1649841556625,MATH 20C,B03,083453,Hammock; Frances H,30,0,30,0
1649841556625,MATH 20C,B04,083454,Hammock; Frances H,30,0,30,0
1649841562651,MATH 20D,A01,084128,Staff,29,0,30,1
1649841562651,MATH 20D,A02,084129,Staff,30,0,30,0
1649841562651,MATH 20D,A03,084130,Staff,29,0,30,1
1649841562651,MATH 20D,B01,084133,Staff,28,0,30,2
1649841562651,MATH 20D,B02,084134,Staff,30,0,30,0
1649841562651,MATH 20D,B03,084135,Staff,30,0,30,0
1649841568674,MATH 20E,A01,084138,Staff,27,0,30,3
1649841568674,MATH 20E,A02,084139,Staff,29,0,30,1
1649841568674,MATH 20E,A03,084140,Staff,28,0,30,2
1649841568674,MATH 20E,A04,084141,Staff,30,0,30,0
1649841574699,MATH 102,A01,084143,Harel; Guershon,24,0,30,6
1649841574699,MATH 102,A02,084144,Harel; Guershon,25,0,30,5
1649841580725,MATH 103B,A01,083456,Staff,0,0,30,30
1649841580725,MATH 103B,A02,083457,Staff,18,0,30,12
1649841586750,MATH 109,A01,084146,Salehi Golsefidy; Alireza,30,0,30,0
1649841586750,MATH 109,A02,084147,Salehi Golsefidy; Alireza,26,0,30,4
1649841592775,MATH 120A,A01,085445,Eggers; John Dietrich,30,0,35,5
1649841592775,MATH 120A,A02,085446,Eggers; John Dietrich,31,0,35,4
1649841598801,MATH 142B,A01,084149,Verstraete; Jacques Allan,7,0,30,23
1649841598801,MATH 142B,A02,084150,Verstraete; Jacques Allan,25,0,30,5
1649841604825,MATH 170A,A01,083459,Nie; Jiawang,9,0,30,21
1649841604825,MATH 170A,A02,083460,Nie; Jiawang,25,0,30,5
1649841604825,MATH 170A,A03,083461,Nie; Jiawang,26,0,30,4
1649841610851,MATH 193B,A01,083463,Staff,15,0,30,15
1649841610851,MATH 193B,A02,083464,Staff,19,0,30,11
1649841610851,MATH 193B,A03,083465,Staff,27,0,30,3
1649841616916,COGS 2,A01,083966,Boyle; Mary E. T.,27,0,30,3
1649841622938,COGS 9,A01,083968,Staff,56,0,60,4
1649841628963,COGS 14B,A01,083970,Staff,46,0,50,4
1649841634987,COGS 17,A01,092679,Staff,73,0,75,2
1649841641011,COGS 100,A01,083972,Staff,46,0,60,14
1649841653066,COGS 101C,A01,083976,Staff,25,0,30,5
1649841659089,COGS 102A,A01,083978,Johnson; Christine M.,24,0,30,6
1649841665117,COGS 107B,A01,083980,Staff,33,0,50,17
1649841671142,COGS 115,A01,083982,Staff,21,0,30,9
1649841677168,COGS 118B,A01,083367,Staff,5,0,40,35
1649841683193,COGS 172,A01,083984,Provenzano; Emily Kara,20,0,30,10
1649841689215,COGS 177,A00,083368,Staff,4,0,30,26
1649841695247,COGS 186,A01,083986,Staff,25,0,40,15
1649841701275,COGS 187A,A01,083988,Boyle; Mary E. T.,40,0,60,20
1649841707304,CSE 8A,A50,084003,Miranda; Gregory Joseph,9,0,15,6
1649841713335,CSE 11,A01,084005,Miranda; Gregory Joseph,49,0,55,6
1649841719358,CSE 20,A01,084007,Staff,15,0,20,5
1649841725388,CSE 21,A01,084009,Staff,32,0,50,18
1649841731412,CSE 30,A01,083370,Cao; Yingjun,20,0,40,20
1649841737439,CSE 100,A01,083372,Cao; Yingjun,13,0,40,27
1649841743468,CSE 101,A01,084011,Staff,0,16,40,40
1649841749502,CSE 141,A01,083374,Eldon; John,0,13,75,75
1649841755526,CSE 141L,A01,083376,Eldon; John,0,16,75,75
1649841761557,CSE 175,A01,084013,Kumar; Rakesh,24,0,25,1
1649841767582,CSE 190,A00,092508,Staff,15,0,15,0
1649841773613,ECE 5,A01,084049,Morris; Karcher William,17,0,20,3
1649841779638,ECE 100,A01,084051,Baghdadchi; Saharnaz,16,0,20,4
1649841779638,ECE 100,A02,091916,Baghdadchi; Saharnaz,18,0,20,2
1649841785663,ECE 101,A01,084053,Baghdadchi; Saharnaz,25,0,37,12
1649841785663,ECE 101,A02,084054,Baghdadchi; Saharnaz,37,0,37,0
1649841791691,ECE 107,A01,083390,Staff,31,0,40,9
1649841797721,ECE 148,A01,084056,Silberman; Jack,8,0,12,4
1649841803745,ECE 180,A00,083391,Abi Samra; Nicholas Camill,27,0,30,3
1649841803745,ECE 180,B00,083392,Abi Samra; Nicholas Camill,26,0,30,4
1649841809770,MATH 10B,A01,084110,Staff,20,0,30,10
1649841809770,MATH 10B,A02,084111,Staff,29,0,30,1
1649841809770,MATH 10B,A03,084112,Staff,29,0,30,1
1649841815795,MATH 10C,A01,083443,Staff,19,0,30,11
1649841815795,MATH 10C,A02,083444,Staff,24,0,30,6
1649841815795,MATH 10C,B01,084114,Staff,26,0,30,4
1649841815795,MATH 10C,B02,084115,Staff,30,0,30,0
1649841821819,MATH 18,A01,084117,Harel; Guershon,28,0,30,2
1649841821819,MATH 18,A02,084119,Harel; Guershon,29,0,30,1
1649841821819,MATH 18,A03,084120,Harel; Guershon,30,0,30,0
1649841821819,MATH 18,A04,084121,Harel; Guershon,30,0,30,0
1649841827850,MATH 20B,A01,084124,Um; Ko Woon,33,0,35,2
1649841827850,MATH 20B,B01,084126,Um; Ko Woon,35,0,35,0
1649841833888,MATH 20C,A01,083446,Hammock; Frances H,26,0,30,4
1649841833888,MATH 20C,A02,083447,Hammock; Frances H,30,0,30,0
1649841833888,MATH 20C,A03,083448,Hammock; Frances H,30,0,30,0
1649841833888,MATH 20C,A04,083449,Hammock; Frances H,30,0,30,0
1649841833888,MATH 20C,B01,083451,Hammock; Frances H,29,0,30,1
1649841833888,MATH 20C,B02,083452,Hammock; Frances H,30,0,30,0
1649841833888,MATH 20C,B03,083453,Hammock; Frances H,30,0,30,0
1649841833888,MATH 20C,B04,083454,Hammock; Frances H,30,0,30,0
1649841839916,MATH 20D,A01,084128,Staff,29,0,30,1
1649841839916,MATH 20D,A02,084129,Staff,30,0,30,0
1649841839916,MATH 20D,A03,084130,Staff,29,0,30,1
1649841839916,MATH 20D,B01,084133,Staff,28,0,30,2
1649841839916,MATH 20D,B02,084134,Staff,30,0,30,0
1649841839916,MATH 20D,B03,084135,Staff,30,0,30,0
1649841845939,MATH 20E,A01,084138,Staff,27,0,30,3
1649841845939,MATH 20E,A02,084139,Staff,29,0,30,1
1649841845939,MATH 20E,A03,084140,Staff,28,0,30,2
1649841845939,MATH 20E,A04,084141,Staff,30,0,30,0
1649841851966,MATH 102,A01,084143,Harel; Guershon,24,0,30,6
1649841851966,MATH 102,A02,084144,Harel; Guershon,25,0,30,5
1649841857990,MATH 103B,A01,083456,Staff,0,0,30,30
1649841857990,MATH 103B,A02,083457,Staff,18,0,30,12
1649841864015,MATH 109,A01,084146,Salehi Golsefidy; Alireza,30,0,30,0
1649841864015,MATH 109,A02,084147,Salehi Golsefidy; Alireza,26,0,30,4
1649841870039,MATH 120A,A01,085445,Eggers; John Dietrich,30,0,35,5
1649841870039,MATH 120A,A02,085446,Eggers; John Dietrich,31,0,35,4
1649841876063,MATH 142B,A01,084149,Verstraete; Jacques Allan,7,0,30,23
1649841876063,MATH 142B,A02,084150,Verstraete; Jacques Allan,25,0,30,5
1649841882090,MATH 170A,A01,083459,Nie; Jiawang,9,0,30,21
1649841882090,MATH 170A,A02,083460,Nie; Jiawang,25,0,30,5
1649841882090,MATH 170A,A03,083461,Nie; Jiawang,26,0,30,4
1649841888114,MATH 193B,A01,083463,Staff,15,0,30,15
1649841888114,MATH 193B,A02,083464,Staff,19,0,30,11
1649841888114,MATH 193B,A03,083465,Staff,27,0,30,3
1649841894178,COGS 2,A01,083966,Boyle; Mary E. T.,27,0,30,3
1649841900203,COGS 9,A01,083968,Staff,56,0,60,4
1649841906227,COGS 14B,A01,083970,Staff,46,0,50,4
1649841912251,COGS 17,A01,092679,Staff,73,0,75,2
1649841918275,COGS 100,A01,083972,Staff,46,0,60,14
1649841930333,COGS 101C,A01,083976,Staff,25,0,30,5
1649841936361,COGS 102A,A01,083978,Johnson; Christine M.,24,0,30,6
1649841942385,COGS 107B,A01,083980,Staff,33,0,50,17
1649841948412,COGS 115,A01,083982,Staff,21,0,30,9
1649841954437,COGS 118B,A01,083367,Staff,5,0,40,35
1649841960461,COGS 172,A01,083984,Provenzano; Emily Kara,20,0,30,10
1649841966485,COGS 177,A00,083368,Staff,4,0,30,26
1649841972510,COGS 186,A01,083986,Staff,25,0,40,15
1649841978631,COGS 187A,A01,083988,Boyle; Mary E. T.,40,0,60,20
1649841984657,CSE 8A,A50,084003,Miranda; Gregory Joseph,9,0,15,6
1649841990685,CSE 11,A01,084005,Miranda; Gregory Joseph,49,0,55,6
1649841996733,CSE 20,A01,084007,Staff,15,0,20,5
1649842002756,CSE 21,A01,084009,Staff,32,0,50,18
1649842008778,CSE 30,A01,083370,Cao; Yingjun,20,0,40,20
1649842014801,CSE 100,A01,083372,Cao; Yingjun,13,0,40,27
1649842020826,CSE 101,A01,084011,Staff,0,16,40,40
1649842026850,CSE 141,A01,083374,Eldon; John,0,13,75,75
1649842032876,CSE 141L,A01,083376,Eldon; John,0,16,75,75
1649842038899,CSE 175,A01,084013,Kumar; Rakesh,24,0,25,1
1649842044926,CSE 190,A00,092508,Staff,15,0,15,0
1649842050951,ECE 5,A01,084049,Morris; Karcher William,17,0,20,3
1649842056977,ECE 100,A01,084051,Baghdadchi; Saharnaz,16,0,20,4
1649842056977,ECE 100,A02,091916,Baghdadchi; Saharnaz,18,0,20,2
1649842063003,ECE 101,A01,084053,Baghdadchi; Saharnaz,25,0,37,12
1649842063003,ECE 101,A02,084054,Baghdadchi; Saharnaz,37,0,37,0
1649842069028,ECE 107,A01,083390,Staff,31,0,40,9
1649842075055,ECE 148,A01,084056,Silberman; Jack,8,0,12,4
1649842081078,ECE 180,A00,083391,Abi Samra; Nicholas Camill,27,0,30,3
1649842081078,ECE 180,B00,083392,Abi Samra; Nicholas Camill,26,0,30,4
1649842087104,MATH 10B,A01,084110,Staff,20,0,30,10
1649842087104,MATH 10B,A02,084111,Staff,29,0,30,1
1649842087104,MATH 10B,A03,084112,Staff,29,0,30,1
1649842093132,MATH 10C,A01,083443,Staff,19,0,30,11
1649842093132,MATH 10C,A02,083444,Staff,24,0,30,6
1649842093132,MATH 10C,B01,084114,Staff,26,0,30,4
1649842093132,MATH 10C,B02,084115,Staff,30,0,30,0
1649842099158,MATH 18,A01,084117,Harel; Guershon,28,0,30,2
1649842099158,MATH 18,A02,084119,Harel; Guershon,29,0,30,1
1649842099158,MATH 18,A03,084120,Harel; Guershon,30,0,30,0
1649842099158,MATH 18,A04,084121,Harel; Guershon,30,0,30,0
1649842105182,MATH 20B,A01,084124,Um; Ko Woon,33,0,35,2
1649842105182,MATH 20B,B01,084126,Um; Ko Woon,35,0,35,0
1649842111219,MATH 20C,A01,083446,Hammock; Frances H,26,0,30,4
1649842111219,MATH 20C,A02,083447,Hammock; Frances H,30,0,30,0
1649842111219,MATH 20C,A03,083448,Hammock; Frances H,30,0,30,0
1649842111219,MATH 20C,A04,083449,Hammock; Frances H,30,0,30,0
1649842111219,MATH 20C,B01,083451,Hammock; Frances H,29,0,30,1
1649842111219,MATH 20C,B02,083452,Hammock; Frances H,30,0,30,0
1649842111219,MATH 20C,B03,083453,Hammock; Frances H,30,0,30,0
1649842111219,MATH 20C,B04,083454,Hammock; Frances H,30,0,30,0
1649842117243,MATH 20D,A01,084128,Staff,29,0,30,1
1649842117243,MATH 20D,A02,084129,Staff,30,0,30,0
1649842117243,MATH 20D,A03,084130,Staff,29,0,30,1
1649842117243,MATH 20D,B01,084133,Staff,28,0,30,2
1649842117243,MATH 20D,B02,084134,Staff,30,0,30,0
1649842117243,MATH 20D,B03,084135,Staff,30,0,30,0
1649842123272,MATH 20E,A01,084138,Staff,27,0,30,3
1649842123272,MATH 20E,A02,084139,Staff,29,0,30,1
1649842123272,MATH 20E,A03,084140,Staff,28,0,30,2
1649842123272,MATH 20E,A04,084141,Staff,30,0,30,0
1649842129296,MATH 102,A01,084143,Harel; Guershon,24,0,30,6
1649842129296,MATH 102,A02,084144,Harel; Guershon,25,0,30,5
1649842135322,MATH 103B,A01,083456,Staff,0,0,30,30
1649842135322,MATH 103B,A02,083457,Staff,18,0,30,12
1649842141353,MATH 109,A01,084146,Salehi Golsefidy; Alireza,30,0,30,0
1649842141353,MATH 109,A02,084147,Salehi Golsefidy; Alireza,26,0,30,4
1649842147384,MATH 120A,A01,085445,Eggers; John Dietrich,30,0,35,5
1649842147384,MATH 120A,A02,085446,Eggers; John Dietrich,31,0,35,4
1649842153415,MATH 142B,A01,084149,Verstraete; Jacques Allan,7,0,30,23
1649842153415,MATH 142B,A02,084150,Verstraete; Jacques Allan,25,0,30,5
1649842159440,MATH 170A,A01,083459,Nie; Jiawang,9,0,30,21
1649842159440,MATH 170A,A02,083460,Nie; Jiawang,25,0,30,5
1649842159440,MATH 170A,A03,083461,Nie; Jiawang,26,0,30,4
1649842165464,MATH 193B,A01,083463,Staff,15,0,30,15
1649842165464,MATH 193B,A02,083464,Staff,19,0,30,11
1649842165464,MATH 193B,A03,083465,Staff,27,0,30,3
1649842171531,COGS 2,A01,083966,Boyle; Mary E. T.,27,0,30,3
1649842177560,COGS 9,A01,083968,Staff,56,0,60,4
1649842183598,COGS 14B,A01,083970,Staff,46,0,50,4
1649842189623,COGS 17,A01,092679,Staff,73,0,75,2
1649842195651,COGS 100,A01,083972,Staff,46,0,60,14
1649842207705,COGS 101C,A01,083976,Staff,25,0,30,5
1649842213732,COGS 102A,A01,083978,Johnson; Christine M.,24,0,30,6
1649842219758,COGS 107B,A01,083980,Staff,33,0,50,17
1649842225786,COGS 115,A01,083982,Staff,21,0,30,9
1649842231813,COGS 118B,A01,083367,Staff,5,0,40,35
1649842237846,COGS 172,A01,083984,Provenzano; Emily Kara,20,0,30,10
1649842243869,COGS 177,A00,083368,Staff,4,0,30,26
1649842249897,COGS 186,A01,083986,Staff,25,0,40,15
1649842255928,COGS 187A,A01,083988,Boyle; Mary E. T.,40,0,60,20
1649842261955,CSE 8A,A50,084003,Miranda; Gregory Joseph,9,0,15,6
1649842267980,CSE 11,A01,084005,Miranda; Gregory Joseph,49,0,55,6
1649842274010,CSE 20,A01,084007,Staff,15,0,20,5
1649842280040,CSE 21,A01,084009,Staff,32,0,50,18
1649842286064,CSE 30,A01,083370,Cao; Yingjun,20,0,40,20
1649842292091,CSE 100,A01,083372,Cao; Yingjun,13,0,40,27
1649842298118,CSE 101,A01,084011,Staff,0,16,40,40
1649842304145,CSE 141,A01,083374,Eldon; John,0,13,75,75
1649842310172,CSE 141L,A01,083376,Eldon; John,0,16,75,75
1649842316199,CSE 175,A01,084013,Kumar; Rakesh,24,0,25,1
1649842322223,CSE 190,A00,092508,Staff,15,0,15,0
1649842328250,ECE 5,A01,084049,Morris; Karcher William,17,0,20,3
1649842334279,ECE 100,A01,084051,Baghdadchi; Saharnaz,16,0,20,4
1649842334279,ECE 100,A02,091916,Baghdadchi; Saharnaz,18,0,20,2
1649842340302,ECE 101,A01,084053,Baghdadchi; Saharnaz,25,0,37,12
1649842340302,ECE 101,A02,084054,Baghdadchi; Saharnaz,37,0,37,0
1649842346327,ECE 107,A01,083390,Staff,31,0,40,9
1649842352352,ECE 148,A01,084056,Silberman; Jack,8,0,12,4
1649842358377,ECE 180,A00,083391,Abi Samra; Nicholas Camill,27,0,30,3
1649842358377,ECE 180,B00,083392,Abi Samra; Nicholas Camill,26,0,30,4
1649842364411,MATH 10B,A01,084110,Staff,20,0,30,10
1649842364411,MATH 10B,A02,084111,Staff,29,0,30,1
1649842364411,MATH 10B,A03,084112,Staff,29,0,30,1
1649842370449,MATH 10C,A01,083443,Staff,19,0,30,11
1649842370449,MATH 10C,A02,083444,Staff,24,0,30,6
1649842370449,MATH 10C,B01,084114,Staff,26,0,30,4
1649842370449,MATH 10C,B02,084115,Staff,30,0,30,0
1649842376488,MATH 18,A01,084117,Harel; Guershon,28,0,30,2
1649842376488,MATH 18,A02,084119,Harel; Guershon,29,0,30,1
1649842376488,MATH 18,A03,084120,Harel; Guershon,30,0,30,0
1649842376488,MATH 18,A04,084121,Harel; Guershon,30,0,30,0
1649842382513,MATH 20B,A01,084124,Um; Ko Woon,33,0,35,2
1649842382513,MATH 20B,B01,084126,Um; Ko Woon,35,0,35,0
1649842388538,MATH 20C,A01,083446,Hammock; Frances H,26,0,30,4
1649842388538,MATH 20C,A02,083447,Hammock; Frances H,30,0,30,0
1649842388538,MATH 20C,A03,083448,Hammock; Frances H,30,0,30,0
1649842388538,MATH 20C,A04,083449,Hammock; Frances H,30,0,30,0
1649842388538,MATH 20C,B01,083451,Hammock; Frances H,29,0,30,1
1649842388538,MATH 20C,B02,083452,Hammock; Frances H,30,0,30,0
1649842388538,MATH 20C,B03,083453,Hammock; Frances H,30,0,30,0
1649842388538,MATH 20C,B04,083454,Hammock; Frances H,30,0,30,0
1649842394569,MATH 20D,A01,084128,Staff,29,0,30,1
1649842394569,MATH 20D,A02,084129,Staff,30,0,30,0
1649842394569,MATH 20D,A03,084130,Staff,29,0,30,1
1649842394569,MATH 20D,B01,084133,Staff,28,0,30,2
1649842394569,MATH 20D,B02,084134,Staff,30,0,30,0
1649842394569,MATH 20D,B03,084135,Staff,30,0,30,0
1649842400594,MATH 20E,A01,084138,Staff,27,0,30,3
1649842400594,MATH 20E,A02,084139,Staff,29,0,30,1
1649842400594,MATH 20E,A03,084140,Staff,28,0,30,2
1649842400594,MATH 20E,A04,084141,Staff,30,0,30,0
1649842406618,MATH 102,A01,084143,Harel; Guershon,24,0,30,6
1649842406618,MATH 102,A02,084144,Harel; Guershon,25,0,30,5
1649842412645,MATH 103B,A01,083456,Staff,0,0,30,30
1649842412645,MATH 103B,A02,083457,Staff,18,0,30,12
1649842418671,MATH 109,A01,084146,Salehi Golsefidy; Alireza,30,0,30,0
1649842418671,MATH 109,A02,084147,Salehi Golsefidy; Alireza,26,0,30,4
1649842424703,MATH 120A,A01,085445,Eggers; John Dietrich,30,0,35,5
1649842424703,MATH 120A,A02,085446,Eggers; John Dietrich,31,0,35,4
1649842430727,MATH 142B,A01,084149,Verstraete; Jacques Allan,7,0,30,23
1649842430727,MATH 142B,A02,084150,Verstraete; Jacques Allan,25,0,30,5
1649842436752,MATH 170A,A01,083459,Nie; Jiawang,9,0,30,21
1649842436752,MATH 170A,A02,083460,Nie; Jiawang,25,0,30,5
1649842436752,MATH 170A,A03,083461,Nie; Jiawang,26,0,30,4
1649842442785,MATH 193B,A01,083463,Staff,15,0,30,15
1649842442785,MATH 193B,A02,083464,Staff,19,0,30,11
1649842442785,MATH 193B,A03,083465,Staff,27,0,30,3
1649842448854,COGS 2,A01,083966,Boyle; Mary E. T.,27,0,30,3
1649842454881,COGS 9,A01,083968,Staff,56,0,60,4
1649842460905,COGS 14B,A01,083970,Staff,46,0,50,4
1649842466932,COGS 17,A01,092679,Staff,73,0,75,2
1649842472957,COGS 100,A01,083972,Staff,46,0,60,14
1649842485012,COGS 101C,A01,083976,Staff,25,0,30,5
1649842491037,COGS 102A,A01,083978,Johnson; Christine M.,24,0,30,6
1649842497062,COGS 107B,A01,083980,Staff,33,0,50,17
1649842503087,COGS 115,A01,083982,Staff,21,0,30,9
1649842509110,COGS 118B,A01,083367,Staff,5,0,40,35
1649842515137,COGS 172,A01,083984,Provenzano; Emily Kara,20,0,30,10
1649842521160,COGS 177,A00,083368,Staff,4,0,30,26
1649842527184,COGS 186,A01,083986,Staff,25,0,40,15
1649842533209,COGS 187A,A01,083988,Boyle; Mary E. T.,40,0,60,20
1649842539242,CSE 8A,A50,084003,Miranda; Gregory Joseph,9,0,15,6
1649842545267,CSE 11,A01,084005,Miranda; Gregory Joseph,49,0,55,6
1649842551298,CSE 20,A01,084007,Staff,15,0,20,5
1649842557322,CSE 21,A01,084009,Staff,32,0,50,18
1649842563346,CSE 30,A01,083370,Cao; Yingjun,20,0,40,20
1649842569375,CSE 100,A01,083372,Cao; Yingjun,13,0,40,27
1649842575491,CSE 101,A01,084011,Staff,0,16,40,40
1649842581521,CSE 141,A01,083374,Eldon; John,0,13,75,75
1649842587544,CSE 141L,A01,083376,Eldon; John,0,16,75,75
1649842593569,CSE 175,A01,084013,Kumar; Rakesh,24,0,25,1
1649842599595,CSE 190,A00,092508,Staff,15,0,15,0
1649842605625,ECE 5,A01,084049,Morris; Karcher William,17,0,20,3
1649842611651,ECE 100,A01,084051,Baghdadchi; Saharnaz,16,0,20,4
1649842611651,ECE 100,A02,091916,Baghdadchi; Saharnaz,18,0,20,2
1649842617676,ECE 101,A01,084053,Baghdadchi; Saharnaz,25,0,37,12
1649842617676,ECE 101,A02,084054,Baghdadchi; Saharnaz,37,0,37,0
1649842623702,ECE 107,A01,083390,Staff,31,0,40,9
1649842629733,ECE 148,A01,084056,Silberman; Jack,8,0,12,4
1649842635760,ECE 180,A00,083391,Abi Samra; Nicholas Camill,27,0,30,3
1649842635760,ECE 180,B00,083392,Abi Samra; Nicholas Camill,26,0,30,4
1649842641786,MATH 10B,A01,084110,Staff,20,0,30,10
1649842641786,MATH 10B,A02,084111,Staff,29,0,30,1
1649842641786,MATH 10B,A03,084112,Staff,29,0,30,1
1649842647812,MATH 10C,A01,083443,Staff,19,0,30,11
1649842647812,MATH 10C,A02,083444,Staff,24,0,30,6
1649842647812,MATH 10C,B01,084114,Staff,26,0,30,4
1649842647812,MATH 10C,B02,084115,Staff,30,0,30,0
1649842653837,MATH 18,A01,084117,Harel; Guershon,28,0,30,2
1649842653837,MATH 18,A02,084119,Harel; Guershon,29,0,30,1
1649842653837,MATH 18,A03,084120,Harel; Guershon,30,0,30,0
1649842653837,MATH 18,A04,084121,Harel; Guershon,30,0,30,0
1649842659881,MATH 20B,A01,084124,Um; Ko Woon,33,0,35,2
1649842659881,MATH 20B,B01,084126,Um; Ko Woon,35,0,35,0
1649842665905,MATH 20C,A01,083446,Hammock; Frances H,26,0,30,4
1649842665905,MATH 20C,A02,083447,Hammock; Frances H,30,0,30,0
1649842665905,MATH 20C,A03,083448,Hammock; Frances H,30,0,30,0
1649842665905,MATH 20C,A04,083449,Hammock; Frances H,30,0,30,0
1649842665905,MATH 20C,B01,083451,Hammock; Frances H,29,0,30,1
1649842665905,MATH 20C,B02,083452,Hammock; Frances H,30,0,30,0
1649842665905,MATH 20C,B03,083453,Hammock; Frances H,30,0,30,0
1649842665905,MATH 20C,B04,083454,Hammock; Frances H,30,0,30,0
1649842671935,MATH 20D,A01,084128,Staff,29,0,30,1
1649842671935,MATH 20D,A02,084129,Staff,30,0,30,0
1649842671935,MATH 20D,A03,084130,Staff,29,0,30,1
1649842671935,MATH 20D,B01,084133,Staff,28,0,30,2
1649842671935,MATH 20D,B02,084134,Staff,30,0,30,0
1649842671935,MATH 20D,B03,084135,Staff,30,0,30,0
1649842677960,MATH 20E,A01,084138,Staff,27,0,30,3
1649842677960,MATH 20E,A02,084139,Staff,29,0,30,1
1649842677960,MATH 20E,A03,084140,Staff,28,0,30,2
1649842677960,MATH 20E,A04,084141,Staff,30,0,30,0
1649842683990,MATH 102,A01,084143,Harel; Guershon,24,0,30,6
1649842683990,MATH 102,A02,084144,Harel; Guershon,25,0,30,5
1649842690016,MATH 103B,A01,083456,Staff,0,0,30,30
1649842690016,MATH 103B,A02,083457,Staff,18,0,30,12
1649842696042,MATH 109,A01,084146,Salehi Golsefidy; Alireza,30,0,30,0
1649842696042,MATH 109,A02,084147,Salehi Golsefidy; Alireza,26,0,30,4
1649842702071,MATH 120A,A01,085445,Eggers; John Dietrich,30,0,35,5
1649842702071,MATH 120A,A02,085446,Eggers; John Dietrich,31,0,35,4
1649842708098,MATH 142B,A01,084149,Verstraete; Jacques Allan,7,0,30,23
1649842708098,MATH 142B,A02,084150,Verstraete; Jacques Allan,25,0,30,5
1649842714128,MATH 170A,A01,083459,Nie; Jiawang,9,0,30,21
1649842714128,MATH 170A,A02,083460,Nie; Jiawang,25,0,30,5
1649842714128,MATH 170A,A03,083461,Nie; Jiawang,26,0,30,4
1649842720154,MATH 193B,A01,083463,Staff,15,0,30,15
1649842720154,MATH 193B,A02,083464,Staff,19,0,30,11
1649842720154,MATH 193B,A03,083465,Staff,27,0,30,3
1649842726230,COGS 2,A01,083966,Boyle; Mary E. T.,27,0,30,3
1649842732260,COGS 9,A01,083968,Staff,56,0,60,4
1649842738287,COGS 14B,A01,083970,Staff,46,0,50,4
1649842744317,COGS 17,A01,092679,Staff,73,0,75,2
1649842750342,COGS 100,A01,083972,Staff,46,0,60,14
1649842762397,COGS 101C,A01,083976,Staff,25,0,30,5
1649842768421,COGS 102A,A01,083978,Johnson; Christine M.,24,0,30,6
1649842774448,COGS 107B,A01,083980,Staff,33,0,50,17
1649842780473,COGS 115,A01,083982,Staff,21,0,30,9
1649842786505,COGS 118B,A01,083367,Staff,5,0,40,35
1649842792531,COGS 172,A01,083984,Provenzano; Emily Kara,20,0,30,10
1649842798555,COGS 177,A00,083368,Staff,4,0,30,26
1649842804581,COGS 186,A01,083986,Staff,25,0,40,15
1649842810613,COGS 187A,A01,083988,Boyle; Mary E. T.,40,0,60,20
1649842816650,CSE 8A,A50,084003,Miranda; Gregory Joseph,9,0,15,6
1649842822678,CSE 11,A01,084005,Miranda; Gregory Joseph,49,0,55,6
1649842828703,CSE 20,A01,084007,Staff,15,0,20,5
1649842834729,CSE 21,A01,084009,Staff,32,0,50,18
1649842840755,CSE 30,A01,083370,Cao; Yingjun,20,0,40,20
1649842846781,CSE 100,A01,083372,Cao; Yingjun,13,0,40,27
1649842852808,CSE 101,A01,084011,Staff,0,16,40,40
1649842858839,CSE 141,A01,083374,Eldon; John,0,13,75,75
1649842864871,CSE 141L,A01,083376,Eldon; John,0,16,75,75
1649842870898,CSE 175,A01,084013,Kumar; Rakesh,24,0,25,1
1649842876922,CSE 190,A00,092508,Staff,15,0,15,0
1649842882947,ECE 5,A01,084049,Morris; Karcher William,17,0,20,3
1649842888974,ECE 100,A01,084051,Baghdadchi; Saharnaz,16,0,20,4
1649842888974,ECE 100,A02,091916,Baghdadchi; Saharnaz,18,0,20,2
1649842895006,ECE 101,A01,084053,Baghdadchi; Saharnaz,25,0,37,12
1649842895006,ECE 101,A02,084054,Baghdadchi; Saharnaz,37,0,37,0
1649842901044,ECE 107,A01,083390,Staff,31,0,40,9
1649842907071,ECE 148,A01,084056,Silberman; Jack,8,0,12,4
1649842913094,ECE 180,A00,083391,Abi Samra; Nicholas Camill,27,0,30,3
1649842913094,ECE 180,B00,083392,Abi Samra; Nicholas Camill,26,0,30,4
1649842919120,MATH 10B,A01,084110,Staff,20,0,30,10
1649842919120,MATH 10B,A02,084111,Staff,29,0,30,1
1649842919120,MATH 10B,A03,084112,Staff,29,0,30,1
1649842925147,MATH 10C,A01,083443,Staff,19,0,30,11
1649842925147,MATH 10C,A02,083444,Staff,24,0,30,6
1649842925147,MATH 10C,B01,084114,Staff,26,0,30,4
1649842925147,MATH 10C,B02,084115,Staff,30,0,30,0
1649842931172,MATH 18,A01,084117,Harel; Guershon,28,0,30,2
1649842931172,MATH 18,A02,084119,Harel; Guershon,29,0,30,1
1649842931172,MATH 18,A03,084120,Harel; Guershon,30,0,30,0
1649842931172,MATH 18,A04,084121,Harel; Guershon,30,0,30,0
1649842937199,MATH 20B,A01,084124,Um; Ko Woon,33,0,35,2
1649842937199,MATH 20B,B01,084126,Um; Ko Woon,35,0,35,0
1649842943226,MATH 20C,A01,083446,Hammock; Frances H,26,0,30,4
1649842943226,MATH 20C,A02,083447,Hammock; Frances H,30,0,30,0
1649842943226,MATH 20C,A03,083448,Hammock; Frances H,30,0,30,0
1649842943226,MATH 20C,A04,083449,Hammock; Frances H,30,0,30,0
1649842943226,MATH 20C,B01,083451,Hammock; Frances H,29,0,30,1
1649842943226,MATH 20C,B02,083452,Hammock; Frances H,30,0,30,0
1649842943226,MATH 20C,B03,083453,Hammock; Frances H,30,0,30,0
1649842943226,MATH 20C,B04,083454,Hammock; Frances H,30,0,30,0
1649842949252,MATH 20D,A01,084128,Staff,29,0,30,1
1649842949252,MATH 20D,A02,084129,Staff,30,0,30,0
1649842949252,MATH 20D,A03,084130,Staff,29,0,30,1
1649842949252,MATH 20D,B01,084133,Staff,28,0,30,2
1649842949252,MATH 20D,B02,084134,Staff,30,0,30,0
1649842949252,MATH 20D,B03,084135,Staff,30,0,30,0
1649842955282,MATH 20E,A01,084138,Staff,27,0,30,3
1649842955282,MATH 20E,A02,084139,Staff,29,0,30,1
1649842955282,MATH 20E,A03,084140,Staff,28,0,30,2
1649842955282,MATH 20E,A04,084141,Staff,30,0,30,0
1649842961316,MATH 102,A01,084143,Harel; Guershon,24,0,30,6
1649842961316,MATH 102,A02,084144,Harel; Guershon,25,0,30,5
1649842967339,MATH 103B,A01,083456,Staff,0,0,30,30
1649842967339,MATH 103B,A02,083457,Staff,18,0,30,12
1649842973369,MATH 109,A01,084146,Salehi Golsefidy; Alireza,30,0,30,0
1649842973369,MATH 109,A02,084147,Salehi Golsefidy; Alireza,26,0,30,4
1649842979395,MATH 120A,A01,085445,Eggers; John Dietrich,30,0,35,5
1649842979395,MATH 120A,A02,085446,Eggers; John Dietrich,31,0,35,4
1649842985424,MATH 142B,A01,084149,Verstraete; Jacques Allan,7,0,30,23
1649842985424,MATH 142B,A02,084150,Verstraete; Jacques Allan,25,0,30,5
1649842991454,MATH 170A,A01,083459,Nie; Jiawang,9,0,30,21
1649842991454,MATH 170A,A02,083460,Nie; Jiawang,25,0,30,5
1649842991454,MATH 170A,A03,083461,Nie; Jiawang,26,0,30,4
1649842997477,MATH 193B,A01,083463,Staff,15,0,30,15
1649842997477,MATH 193B,A02,083464,Staff,19,0,30,11
1649842997477,MATH 193B,A03,083465,Staff,27,0,30,3
1649843003549,COGS 2,A01,083966,Boyle; Mary E. T.,27,0,30,3
1649843009572,COGS 9,A01,083968,Staff,56,0,60,4
1649843015599,COGS 14B,A01,083970,Staff,46,0,50,4
1649843021623,COGS 17,A01,092679,Staff,73,0,75,2
1649843027651,COGS 100,A01,083972,Staff,46,0,60,14
1649843039695,COGS 101C,A01,083976,Staff,25,0,30,5
1649843045723,COGS 102A,A01,083978,Johnson; Christine M.,24,0,30,6
1649843051745,COGS 107B,A01,083980,Staff,33,0,50,17
1649843057769,COGS 115,A01,083982,Staff,21,0,30,9
1649843063793,COGS 118B,A01,083367,Staff,5,0,40,35
1649843069825,COGS 172,A01,083984,Provenzano; Emily Kara,20,0,30,10
1649843075847,COGS 177,A00,083368,Staff,4,0,30,26
1649843081872,COGS 186,A01,083986,Staff,25,0,40,15
1649843087898,COGS 187A,A01,083988,Boyle; Mary E. T.,40,0,60,20
1649843093929,CSE 8A,A50,084003,Miranda; Gregory Joseph,9,0,15,6
1649843099952,CSE 11,A01,084005,Miranda; Gregory Joseph,49,0,55,6
1649843105983,CSE 20,A01,084007,Staff,15,0,20,5
1649843112007,CSE 21,A01,084009,Staff,32,0,50,18
1649843118030,CSE 30,A01,083370,Cao; Yingjun,20,0,40,20
1649843124053,CSE 100,A01,083372,Cao; Yingjun,13,0,40,27
1649843130152,CSE 101,A01,084011,Staff,0,16,40,40
1649843136176,CSE 141,A01,083374,Eldon; John,0,13,75,75
1649843142200,CSE 141L,A01,083376,Eldon; John,0,16,75,75
1649843148224,CSE 175,A01,084013,Kumar; Rakesh,24,0,25,1
1649843154252,CSE 190,A00,092508,Staff,15,0,15,0
1649843160278,ECE 5,A01,084049,Morris; Karcher William,17,0,20,3
1649843166303,ECE 100,A01,084051,Baghdadchi; Saharnaz,16,0,20,4
1649843166303,ECE 100,A02,091916,Baghdadchi; Saharnaz,18,0,20,2
1649843172417,ECE 101,A01,084053,Baghdadchi; Saharnaz,25,0,37,12
1649843172417,ECE 101,A02,084054,Baghdadchi; Saharnaz,37,0,37,0
1649843178452,ECE 107,A01,083390,Staff,31,0,40,9
1649843184476,ECE 148,A01,084056,Silberman; Jack,8,0,12,4
1649843190505,ECE 180,A00,083391,Abi Samra; Nicholas Camill,27,0,30,3
1649843190505,ECE 180,B00,083392,Abi Samra; Nicholas Camill,26,0,30,4
1649843196534,MATH 10B,A01,084110,Staff,20,0,30,10
1649843196534,MATH 10B,A02,084111,Staff,29,0,30,1
1649843196534,MATH 10B,A03,084112,Staff,29,0,30,1
1649843202565,MATH 10C,A01,083443,Staff,19,0,30,11
1649843202565,MATH 10C,A02,083444,Staff,24,0,30,6
1649843202565,MATH 10C,B01,084114,Staff,26,0,30,4
1649843202565,MATH 10C,B02,084115,Staff,30,0,30,0
1649843208587,MATH 18,A01,084117,Harel; Guershon,28,0,30,2
1649843208587,MATH 18,A02,084119,Harel; Guershon,29,0,30,1
1649843208587,MATH 18,A03,084120,Harel; Guershon,30,0,30,0
1649843208587,MATH 18,A04,084121,Harel; Guershon,30,0,30,0
1649843214610,MATH 20B,A01,084124,Um; Ko Woon,33,0,35,2
1649843214610,MATH 20B,B01,084126,Um; Ko Woon,35,0,35,0
1649843220636,MATH 20C,A01,083446,Hammock; Frances H,26,0,30,4
1649843220636,MATH 20C,A02,083447,Hammock; Frances H,30,0,30,0
1649843220636,MATH 20C,A03,083448,Hammock; Frances H,30,0,30,0
1649843220636,MATH 20C,A04,083449,Hammock; Frances H,30,0,30,0
1649843220636,MATH 20C,B01,083451,Hammock; Frances H,29,0,30,1
1649843220636,MATH 20C,B02,083452,Hammock; Frances H,30,0,30,0
1649843220636,MATH 20C,B03,083453,Hammock; Frances H,30,0,30,0
1649843220636,MATH 20C,B04,083454,Hammock; Frances H,30,0,30,0
1649843226661,MATH 20D,A01,084128,Staff,29,0,30,1
1649843226661,MATH 20D,A02,084129,Staff,30,0,30,0
1649843226661,MATH 20D,A03,084130,Staff,29,0,30,1
1649843226661,MATH 20D,B01,084133,Staff,28,0,30,2
1649843226661,MATH 20D,B02,084134,Staff,30,0,30,0
1649843226661,MATH 20D,B03,084135,Staff,30,0,30,0
1649843232689,MATH 20E,A01,084138,Staff,27,0,30,3
1649843232689,MATH 20E,A02,084139,Staff,29,0,30,1
1649843232689,MATH 20E,A03,084140,Staff,28,0,30,2
1649843232689,MATH 20E,A04,084141,Staff,30,0,30,0
1649843238720,MATH 102,A01,084143,Harel; Guershon,24,0,30,6
1649843238720,MATH 102,A02,084144,Harel; Guershon,25,0,30,5
1649843244743,MATH 103B,A01,083456,Staff,0,0,30,30
1649843244743,MATH 103B,A02,083457,Staff,18,0,30,12
1649843250767,MATH 109,A01,084146,Salehi Golsefidy; Alireza,30,0,30,0
1649843250767,MATH 109,A02,084147,Salehi Golsefidy; Alireza,26,0,30,4
1649843256797,MATH 120A,A01,085445,Eggers; John Dietrich,30,0,35,5
1649843256797,MATH 120A,A02,085446,Eggers; John Dietrich,31,0,35,4
1649843262822,MATH 142B,A01,084149,Verstraete; Jacques Allan,7,0,30,23
1649843262822,MATH 142B,A02,084150,Verstraete; Jacques Allan,25,0,30,5
1649843268847,MATH 170A,A01,083459,Nie; Jiawang,9,0,30,21
1649843268847,MATH 170A,A02,083460,Nie; Jiawang,25,0,30,5
1649843268847,MATH 170A,A03,083461,Nie; Jiawang,26,0,30,4
1649843274877,MATH 193B,A01,083463,Staff,15,0,30,15
1649843274877,MATH 193B,A02,083464,Staff,19,0,30,11
1649843274877,MATH 193B,A03,083465,Staff,27,0,30,3
1649843280939,COGS 2,A01,083966,Boyle; Mary E. T.,27,0,30,3
1649843286962,COGS 9,A01,083968,Staff,56,0,60,4
1649843292989,COGS 14B,A01,083970,Staff,46,0,50,4
1649843299012,COGS 17,A01,092679,Staff,73,0,75,2
1649843305036,COGS 100,A01,083972,Staff,46,0,60,14
1649843317084,COGS 101C,A01,083976,Staff,25,0,30,5
1649843323113,COGS 102A,A01,083978,Johnson; Christine M.,24,0,30,6
1649843329136,COGS 107B,A01,083980,Staff,33,0,50,17
1649843335160,COGS 115,A01,083982,Staff,21,0,30,9
1649843341187,COGS 118B,A01,083367,Staff,5,0,40,35
1649843347218,COGS 172,A01,083984,Provenzano; Emily Kara,20,0,30,10
1649843353240,COGS 177,A00,083368,Staff,4,0,30,26
1649843359263,COGS 186,A01,083986,Staff,25,0,40,15
1649843365290,COGS 187A,A01,083988,Boyle; Mary E. T.,40,0,60,20
1649843371320,CSE 8A,A50,084003,Miranda; Gregory Joseph,9,0,15,6
1649843377345,CSE 11,A01,084005,Miranda; Gregory Joseph,49,0,55,6
1649843383369,CSE 20,A01,084007,Staff,15,0,20,5
1649843389393,CSE 21,A01,084009,Staff,32,0,50,18
1649843395424,CSE 30,A01,083370,Cao; Yingjun,20,0,40,20
1649843401454,CSE 100,A01,083372,Cao; Yingjun,13,0,40,27
1649843407479,CSE 101,A01,084011,Staff,0,16,40,40
1649843413502,CSE 141,A01,083374,Eldon; John,0,13,75,75
1649843419531,CSE 141L,A01,083376,Eldon; John,0,16,75,75
1649843425555,CSE 175,A01,084013,Kumar; Rakesh,24,0,25,1
1649843431586,CSE 190,A00,092508,Staff,15,0,15,0
1649843437616,ECE 5,A01,084049,Morris; Karcher William,17,0,20,3
1649843443640,ECE 100,A01,084051,Baghdadchi; Saharnaz,16,0,20,4
1649843443640,ECE 100,A02,091916,Baghdadchi; Saharnaz,18,0,20,2
1649843449668,ECE 101,A01,084053,Baghdadchi; Saharnaz,25,0,37,12
1649843449668,ECE 101,A02,084054,Baghdadchi; Saharnaz,37,0,37,0
1649843455694,ECE 107,A01,083390,Staff,31,0,40,9
1649843461720,ECE 148,A01,084056,Silberman; Jack,8,0,12,4
1649843467757,ECE 180,A00,083391,Abi Samra; Nicholas Camill,27,0,30,3
1649843467757,ECE 180,B00,083392,Abi Samra; Nicholas Camill,26,0,30,4
1649843473789,MATH 10B,A01,084110,Staff,20,0,30,10
1649843473789,MATH 10B,A02,084111,Staff,29,0,30,1
1649843473789,MATH 10B,A03,084112,Staff,29,0,30,1
1649843479815,MATH 10C,A01,083443,Staff,19,0,30,11
1649843479815,MATH 10C,A02,083444,Staff,24,0,30,6
1649843479815,MATH 10C,B01,084114,Staff,26,0,30,4
1649843479815,MATH 10C,B02,084115,Staff,30,0,30,0
1649843485845,MATH 18,A01,084117,Harel; Guershon,28,0,30,2
1649843485845,MATH 18,A02,084119,Harel; Guershon,29,0,30,1
1649843485845,MATH 18,A03,084120,Harel; Guershon,30,0,30,0
1649843485845,MATH 18,A04,084121,Harel; Guershon,30,0,30,0
1649843491878,MATH 20B,A01,084124,Um; Ko Woon,33,0,35,2
1649843491878,MATH 20B,B01,084126,Um; Ko Woon,35,0,35,0
1649843497912,MATH 20C,A01,083446,Hammock; Frances H,26,0,30,4
1649843497912,MATH 20C,A02,083447,Hammock; Frances H,30,0,30,0
1649843497912,MATH 20C,A03,083448,Hammock; Frances H,30,0,30,0
1649843497912,MATH 20C,A04,083449,Hammock; Frances H,30,0,30,0
1649843497912,MATH 20C,B01,083451,Hammock; Frances H,29,0,30,1
1649843497912,MATH 20C,B02,083452,Hammock; Frances H,30,0,30,0
1649843497912,MATH 20C,B03,083453,Hammock; Frances H,30,0,30,0
1649843497912,MATH 20C,B04,083454,Hammock; Frances H,30,0,30,0
1649843503950,MATH 20D,A01,084128,Staff,29,0,30,1
1649843503950,MATH 20D,A02,084129,Staff,30,0,30,0
1649843503950,MATH 20D,A03,084130,Staff,29,0,30,1
1649843503950,MATH 20D,B01,084133,Staff,28,0,30,2
1649843503950,MATH 20D,B02,084134,Staff,30,0,30,0
1649843503950,MATH 20D,B03,084135,Staff,30,0,30,0
1649843509979,MATH 20E,A01,084138,Staff,27,0,30,3
1649843509979,MATH 20E,A02,084139,Staff,29,0,30,1
1649843509979,MATH 20E,A03,084140,Staff,28,0,30,2
1649843509979,MATH 20E,A04,084141,Staff,30,0,30,0
1649843516009,MATH 102,A01,084143,Harel; Guershon,24,0,30,6
1649843516009,MATH 102,A02,084144,Harel; Guershon,25,0,30,5
1649843522046,MATH 103B,A01,083456,Staff,0,0,30,30
1649843522046,MATH 103B,A02,083457,Staff,18,0,30,12
1649843528096,MATH 109,A01,084146,Salehi Golsefidy; Alireza,30,0,30,0
1649843528096,MATH 109,A02,084147,Salehi Golsefidy; Alireza,26,0,30,4
1649843534128,MATH 120A,A01,085445,Eggers; John Dietrich,30,0,35,5
1649843534128,MATH 120A,A02,085446,Eggers; John Dietrich,31,0,35,4
1649843540153,MATH 142B,A01,084149,Verstraete; Jacques Allan,7,0,30,23
1649843540153,MATH 142B,A02,084150,Verstraete; Jacques Allan,25,0,30,5
1649843546177,MATH 170A,A01,083459,Nie; Jiawang,9,0,30,21
1649843546177,MATH 170A,A02,083460,Nie; Jiawang,25,0,30,5
1649843546177,MATH 170A,A03,083461,Nie; Jiawang,26,0,30,4
1649843552201,MATH 193B,A01,083463,Staff,15,0,30,15
1649843552201,MATH 193B,A02,083464,Staff,19,0,30,11
1649843552201,MATH 193B,A03,083465,Staff,27,0,30,3
1649843558273,COGS 2,A01,083966,Boyle; Mary E. T.,27,0,30,3
1649843564299,COGS 9,A01,083968,Staff,56,0,60,4
1649843570335,COGS 14B,A01,083970,Staff,46,0,50,4
1649843576360,COGS 17,A01,092679,Staff,73,0,75,2
1649843582383,COGS 100,A01,083972,Staff,46,0,60,14
1649843594433,COGS 101C,A01,083976,Staff,25,0,30,5
1649843600458,COGS 102A,A01,083978,Johnson; Christine M.,24,0,30,6
1649843606483,COGS 107B,A01,083980,Staff,33,0,50,17
1649843612506,COGS 115,A01,083982,Staff,21,0,30,9
1649843618531,COGS 118B,A01,083367,Staff,5,0,40,35
1649843624559,COGS 172,A01,083984,Provenzano; Emily Kara,20,0,30,10
1649843630587,COGS 177,A00,083368,Staff,4,0,30,26
1649843636614,COGS 186,A01,083986,Staff,25,0,40,15
1649843642641,COGS 187A,A01,083988,Boyle; Mary E. T.,40,0,60,20
1649843648672,CSE 8A,A50,084003,Miranda; Gregory Joseph,9,0,15,6
1649843654699,CSE 11,A01,084005,Miranda; Gregory Joseph,49,0,55,6
1649843660724,CSE 20,A01,084007,Staff,15,0,20,5
1649843666748,CSE 21,A01,084009,Staff,32,0,50,18
1649843672778,CSE 30,A01,083370,Cao; Yingjun,20,0,40,20
1649843678807,CSE 100,A01,083372,Cao; Yingjun,13,0,40,27
1649843684833,CSE 101,A01,084011,Staff,0,16,40,40
1649843690862,CSE 141,A01,083374,Eldon; John,0,13,75,75
1649843696887,CSE 141L,A01,083376,Eldon; John,0,16,75,75
1649843702912,CSE 175,A01,084013,Kumar; Rakesh,24,0,25,1
1649843708937,CSE 190,A00,092508,Staff,15,0,15,0
1649843714971,ECE 5,A01,084049,Morris; Karcher William,17,0,20,3
1649843720998,ECE 100,A01,084051,Baghdadchi; Saharnaz,16,0,20,4
1649843720998,ECE 100,A02,091916,Baghdadchi; Saharnaz,18,0,20,2
1649843727039,ECE 101,A01,084053,Baghdadchi; Saharnaz,25,0,37,12
1649843727039,ECE 101,A02,084054,Baghdadchi; Saharnaz,37,0,37,0
1649843733065,ECE 107,A01,083390,Staff,31,0,40,9
1649843739091,ECE 148,A01,084056,Silberman; Jack,8,0,12,4
1649843745118,ECE 180,A00,083391,Abi Samra; Nicholas Camill,27,0,30,3
1649843745118,ECE 180,B00,083392,Abi Samra; Nicholas Camill,26,0,30,4
1649843751151,MATH 10B,A01,084110,Staff,20,0,30,10
1649843751151,MATH 10B,A02,084111,Staff,29,0,30,1
1649843751151,MATH 10B,A03,084112,Staff,29,0,30,1
1649843757185,MATH 10C,A01,083443,Staff,19,0,30,11
1649843757185,MATH 10C,A02,083444,Staff,24,0,30,6
1649843757185,MATH 10C,B01,084114,Staff,26,0,30,4
1649843757185,MATH 10C,B02,084115,Staff,30,0,30,0
1649843763219,MATH 18,A01,084117,Harel; Guershon,28,0,30,2
1649843763219,MATH 18,A02,084119,Harel; Guershon,29,0,30,1
1649843763219,MATH 18,A03,084120,Harel; Guershon,30,0,30,0
1649843763219,MATH 18,A04,084121,Harel; Guershon,30,0,30,0
1649843769334,MATH 20B,A01,084124,Um; Ko Woon,33,0,35,2
1649843769334,MATH 20B,B01,084126,Um; Ko Woon,35,0,35,0
1649843775360,MATH 20C,A01,083446,Hammock; Frances H,26,0,30,4
1649843775360,MATH 20C,A02,083447,Hammock; Frances H,30,0,30,0
1649843775360,MATH 20C,A03,083448,Hammock; Frances H,30,0,30,0
1649843775360,MATH 20C,A04,083449,Hammock; Frances H,30,0,30,0
1649843775360,MATH 20C,B01,083451,Hammock; Frances H,29,0,30,1
1649843775360,MATH 20C,B02,083452,Hammock; Frances H,30,0,30,0
1649843775360,MATH 20C,B03,083453,Hammock; Frances H,30,0,30,0
1649843775360,MATH 20C,B04,083454,Hammock; Frances H,30,0,30,0
1649843781387,MATH 20D,A01,084128,Staff,29,0,30,1
1649843781387,MATH 20D,A02,084129,Staff,30,0,30,0
1649843781387,MATH 20D,A03,084130,Staff,29,0,30,1
1649843781387,MATH 20D,B01,084133,Staff,28,0,30,2
1649843781387,MATH 20D,B02,084134,Staff,30,0,30,0
1649843781387,MATH 20D,B03,084135,Staff,30,0,30,0
1649843787419,MATH 20E,A01,084138,Staff,27,0,30,3
1649843787419,MATH 20E,A02,084139,Staff,29,0,30,1
1649843787419,MATH 20E,A03,084140,Staff,28,0,30,2
1649843787419,MATH 20E,A04,084141,Staff,30,0,30,0
1649843793445,MATH 102,A01,084143,Harel; Guershon,24,0,30,6
1649843793445,MATH 102,A02,084144,Harel; Guershon,25,0,30,5
1649843799470,MATH 103B,A01,083456,Staff,0,0,30,30
1649843799470,MATH 103B,A02,083457,Staff,18,0,30,12
1649843805496,MATH 109,A01,084146,Salehi Golsefidy; Alireza,30,0,30,0
1649843805496,MATH 109,A02,084147,Salehi Golsefidy; Alireza,26,0,30,4
1649843811521,MATH 120A,A01,085445,Eggers; John Dietrich,30,0,35,5
1649843811521,MATH 120A,A02,085446,Eggers; John Dietrich,31,0,35,4
1649843817548,MATH 142B,A01,084149,Verstraete; Jacques Allan,7,0,30,23
1649843817548,MATH 142B,A02,084150,Verstraete; Jacques Allan,25,0,30,5
1649843823579,MATH 170A,A01,083459,Nie; Jiawang,9,0,30,21
1649843823579,MATH 170A,A02,083460,Nie; Jiawang,25,0,30,5
1649843823579,MATH 170A,A03,083461,Nie; Jiawang,26,0,30,4
1649843829603,MATH 193B,A01,083463,Staff,15,0,30,15
1649843829603,MATH 193B,A02,083464,Staff,19,0,30,11
1649843829603,MATH 193B,A03,083465,Staff,27,0,30,3
1649843835664,COGS 2,A01,083966,Boyle; Mary E. T.,27,0,30,3
1649843841693,COGS 9,A01,083968,Staff,56,0,60,4
1649843847724,COGS 14B,A01,083970,Staff,46,0,50,4
1649843853747,COGS 17,A01,092679,Staff,73,0,75,2
1649843859775,COGS 100,A01,083972,Staff,46,0,60,14
1649843871829,COGS 101C,A01,083976,Staff,25,0,30,5
1649843877856,COGS 102A,A01,083978,Johnson; Christine M.,24,0,30,6
1649843883881,COGS 107B,A01,083980,Staff,33,0,50,17
1649843889921,COGS 115,A01,083982,Staff,21,0,30,9
1649843895948,COGS 118B,A01,083367,Staff,5,0,40,35
1649843901974,COGS 172,A01,083984,Provenzano; Emily Kara,20,0,30,10
1649843907998,COGS 177,A00,083368,Staff,3,0,30,27
1649843914027,COGS 186,A01,083986,Staff,25,0,40,15
1649843920051,COGS 187A,A01,083988,Boyle; Mary E. T.,40,0,60,20
1649843926081,CSE 8A,A50,084003,Miranda; Gregory Joseph,9,0,15,6
1649843932107,CSE 11,A01,084005,Miranda; Gregory Joseph,49,0,55,6
1649843938131,CSE 20,A01,084007,Staff,15,0,20,5
1649843944170,CSE 21,A01,084009,Staff,32,0,50,18
1649843950199,CSE 30,A01,083370,Cao; Yingjun,20,0,40,20
1649843956228,CSE 100,A01,083372,Cao; Yingjun,13,0,40,27
1649843962256,CSE 101,A01,084011,Staff,0,16,40,40
1649843968279,CSE 141,A01,083374,Eldon; John,0,13,75,75
1649843974308,CSE 141L,A01,083376,Eldon; John,0,16,75,75
1649843980344,CSE 175,A01,084013,Kumar; Rakesh,24,0,25,1
1649843986372,CSE 190,A00,092508,Staff,15,0,15,0
1649843992403,ECE 5,A01,084049,Morris; Karcher William,17,0,20,3
1649843998434,ECE 100,A01,084051,Baghdadchi; Saharnaz,16,0,20,4
1649843998434,ECE 100,A02,091916,Baghdadchi; Saharnaz,18,0,20,2
1649844004460,ECE 101,A01,084053,Baghdadchi; Saharnaz,25,0,37,12
1649844004460,ECE 101,A02,084054,Baghdadchi; Saharnaz,37,0,37,0
1649844010490,ECE 107,A01,083390,Staff,31,0,40,9
1649844016514,ECE 148,A01,084056,Silberman; Jack,8,0,12,4
1649844022538,ECE 180,A00,083391,Abi Samra; Nicholas Camill,27,0,30,3
1649844022538,ECE 180,B00,083392,Abi Samra; Nicholas Camill,26,0,30,4
1649844028564,MATH 10B,A01,084110,Staff,20,0,30,10
1649844028564,MATH 10B,A02,084111,Staff,29,0,30,1
1649844028564,MATH 10B,A03,084112,Staff,29,0,30,1
1649844034587,MATH 10C,A01,083443,Staff,19,0,30,11
1649844034587,MATH 10C,A02,083444,Staff,24,0,30,6
1649844034587,MATH 10C,B01,084114,Staff,26,0,30,4
1649844034587,MATH 10C,B02,084115,Staff,30,0,30,0
1649844040618,MATH 18,A01,084117,Harel; Guershon,28,0,30,2
1649844040618,MATH 18,A02,084119,Harel; Guershon,29,0,30,1
1649844040618,MATH 18,A03,084120,Harel; Guershon,30,0,30,0
1649844040618,MATH 18,A04,084121,Harel; Guershon,30,0,30,0
1649844046644,MATH 20B,A01,084124,Um; Ko Woon,33,0,35,2
1649844046644,MATH 20B,B01,084126,Um; Ko Woon,35,0,35,0
1649844052668,MATH 20C,A01,083446,Hammock; Frances H,26,0,30,4
1649844052668,MATH 20C,A02,083447,Hammock; Frances H,30,0,30,0
1649844052668,MATH 20C,A03,083448,Hammock; Frances H,30,0,30,0
1649844052668,MATH 20C,A04,083449,Hammock; Frances H,30,0,30,0
1649844052668,MATH 20C,B01,083451,Hammock; Frances H,29,0,30,1
1649844052668,MATH 20C,B02,083452,Hammock; Frances H,30,0,30,0
1649844052668,MATH 20C,B03,083453,Hammock; Frances H,30,0,30,0
1649844052668,MATH 20C,B04,083454,Hammock; Frances H,30,0,30,0
1649844058695,MATH 20D,A01,084128,Staff,29,0,30,1
1649844058695,MATH 20D,A02,084129,Staff,30,0,30,0
1649844058695,MATH 20D,A03,084130,Staff,29,0,30,1
1649844058695,MATH 20D,B01,084133,Staff,28,0,30,2
1649844058695,MATH 20D,B02,084134,Staff,30,0,30,0
1649844058695,MATH 20D,B03,084135,Staff,30,0,30,0
1649844064720,MATH 20E,A01,084138,Staff,27,0,30,3
1649844064720,MATH 20E,A02,084139,Staff,29,0,30,1
1649844064720,MATH 20E,A03,084140,Staff,28,0,30,2
1649844064720,MATH 20E,A04,084141,Staff,30,0,30,0
1649844070751,MATH 102,A01,084143,Harel; Guershon,24,0,30,6
1649844070751,MATH 102,A02,084144,Harel; Guershon,25,0,30,5
1649844076781,MATH 103B,A01,083456,Staff,0,0,30,30
1649844076781,MATH 103B,A02,083457,Staff,18,0,30,12
1649844082812,MATH 109,A01,084146,Salehi Golsefidy; Alireza,30,0,30,0
1649844082812,MATH 109,A02,084147,Salehi Golsefidy; Alireza,26,0,30,4
1649844088838,MATH 120A,A01,085445,Eggers; John Dietrich,30,0,35,5
1649844088838,MATH 120A,A02,085446,Eggers; John Dietrich,31,0,35,4
1649844094864,MATH 142B,A01,084149,Verstraete; Jacques Allan,7,0,30,23
1649844094864,MATH 142B,A02,084150,Verstraete; Jacques Allan,25,0,30,5
1649844100897,MATH 170A,A01,083459,Nie; Jiawang,9,0,30,21
1649844100897,MATH 170A,A02,083460,Nie; Jiawang,25,0,30,5
1649844100897,MATH 170A,A03,083461,Nie; Jiawang,26,0,30,4
1649844106921,MATH 193B,A01,083463,Staff,15,0,30,15
1649844106921,MATH 193B,A02,083464,Staff,19,0,30,11
1649844106921,MATH 193B,A03,083465,Staff,27,0,30,3
1649844112990,COGS 2,A01,083966,Boyle; Mary E. T.,27,0,30,3
1649844119018,COGS 9,A01,083968,Staff,56,0,60,4
1649844125046,COGS 14B,A01,083970,Staff,46,0,50,4
1649844131069,COGS 17,A01,092679,Staff,73,0,75,2
1649844137094,COGS 100,A01,083972,Staff,46,0,60,14
1649844149144,COGS 101C,A01,083976,Staff,25,0,30,5
1649844155174,COGS 102A,A01,083978,Johnson; Christine M.,24,0,30,6
1649844161198,COGS 107B,A01,083980,Staff,33,0,50,17
1649844167228,COGS 115,A01,083982,Staff,21,0,30,9
1649844173256,COGS 118B,A01,083367,Staff,5,0,40,35
1649844179291,COGS 172,A01,083984,Provenzano; Emily Kara,20,0,30,10
1649844185314,COGS 177,A00,083368,Staff,3,0,30,27
1649844191349,COGS 186,A01,083986,Staff,25,0,40,15
1649844197380,COGS 187A,A01,083988,Boyle; Mary E. T.,40,0,60,20
1649844203412,CSE 8A,A50,084003,Miranda; Gregory Joseph,9,0,15,6
1649844209435,CSE 11,A01,084005,Miranda; Gregory Joseph,49,0,55,6
1649844215459,CSE 20,A01,084007,Staff,15,0,20,5
1649844221488,CSE 21,A01,084009,Staff,32,0,50,18
1649844227515,CSE 30,A01,083370,Cao; Yingjun,20,0,40,20
1649844233548,CSE 100,A01,083372,Cao; Yingjun,13,0,40,27
1649844239572,CSE 101,A01,084011,Staff,0,16,40,40
1649844245597,CSE 141,A01,083374,Eldon; John,0,13,75,75
1649844251623,CSE 141L,A01,083376,Eldon; John,0,16,75,75
1649844257650,CSE 175,A01,084013,Kumar; Rakesh,24,0,25,1
1649844263675,CSE 190,A00,092508,Staff,15,0,15,0
1649844269698,ECE 5,A01,084049,Morris; Karcher William,17,0,20,3
1649844275731,ECE 100,A01,084051,Baghdadchi; Saharnaz,16,0,20,4
1649844275731,ECE 100,A02,091916,Baghdadchi; Saharnaz,18,0,20,2
1649844281753,ECE 101,A01,084053,Baghdadchi; Saharnaz,25,0,37,12
1649844281753,ECE 101,A02,084054,Baghdadchi; Saharnaz,37,0,37,0
1649844287777,ECE 107,A01,083390,Staff,31,0,40,9
1649844293804,ECE 148,A01,084056,Silberman; Jack,8,0,12,4
1649844299833,ECE 180,A00,083391,Abi Samra; Nicholas Camill,27,0,30,3
1649844299833,ECE 180,B00,083392,Abi Samra; Nicholas Camill,26,0,30,4
1649844305862,MATH 10B,A01,084110,Staff,20,0,30,10
1649844305862,MATH 10B,A02,084111,Staff,29,0,30,1
1649844305862,MATH 10B,A03,084112,Staff,29,0,30,1
1649844311886,MATH 10C,A01,083443,Staff,19,0,30,11
1649844311886,MATH 10C,A02,083444,Staff,24,0,30,6
1649844311886,MATH 10C,B01,084114,Staff,26,0,30,4
1649844311886,MATH 10C,B02,084115,Staff,30,0,30,0
1649844317920,MATH 18,A01,084117,Harel; Guershon,28,0,30,2
1649844317920,MATH 18,A02,084119,Harel; Guershon,29,0,30,1
1649844317920,MATH 18,A03,084120,Harel; Guershon,30,0,30,0
1649844317920,MATH 18,A04,084121,Harel; Guershon,30,0,30,0
1649844323946,MATH 20B,A01,084124,Um; Ko Woon,33,0,35,2
1649844323946,MATH 20B,B01,084126,Um; Ko Woon,35,0,35,0
1649844329979,MATH 20C,A01,083446,Hammock; Frances H,26,0,30,4
1649844329979,MATH 20C,A02,083447,Hammock; Frances H,30,0,30,0
1649844329979,MATH 20C,A03,083448,Hammock; Frances H,30,0,30,0
1649844329979,MATH 20C,A04,083449,Hammock; Frances H,30,0,30,0
1649844329979,MATH 20C,B01,083451,Hammock; Frances H,29,0,30,1
1649844329979,MATH 20C,B02,083452,Hammock; Frances H,30,0,30,0
1649844329979,MATH 20C,B03,083453,Hammock; Frances H,30,0,30,0
1649844329979,MATH 20C,B04,083454,Hammock; Frances H,30,0,30,0
1649844336009,MATH 20D,A01,084128,Staff,29,0,30,1
1649844336009,MATH 20D,A02,084129,Staff,30,0,30,0
1649844336009,MATH 20D,A03,084130,Staff,29,0,30,1
1649844336009,MATH 20D,B01,084133,Staff,28,0,30,2
1649844336009,MATH 20D,B02,084134,Staff,30,0,30,0
1649844336009,MATH 20D,B03,084135,Staff,30,0,30,0
1649844342037,MATH 20E,A01,084138,Staff,27,0,30,3
1649844342037,MATH 20E,A02,084139,Staff,29,0,30,1
1649844342037,MATH 20E,A03,084140,Staff,28,0,30,2
1649844342037,MATH 20E,A04,084141,Staff,30,0,30,0
1649844348061,MATH 102,A01,084143,Harel; Guershon,24,0,30,6
1649844348061,MATH 102,A02,084144,Harel; Guershon,25,0,30,5
1649844354088,MATH 103B,A01,083456,Staff,0,0,30,30
1649844354088,MATH 103B,A02,083457,Staff,18,0,30,12
1649844360111,MATH 109,A01,084146,Salehi Golsefidy; Alireza,30,0,30,0
1649844360111,MATH 109,A02,084147,Salehi Golsefidy; Alireza,26,0,30,4
1649844366228,MATH 120A,A01,085445,Eggers; John Dietrich,30,0,35,5
1649844366228,MATH 120A,A02,085446,Eggers; John Dietrich,31,0,35,4
1649844372253,MATH 142B,A01,084149,Verstraete; Jacques Allan,7,0,30,23
1649844372253,MATH 142B,A02,084150,Verstraete; Jacques Allan,25,0,30,5
1649844378282,MATH 170A,A01,083459,Nie; Jiawang,9,0,30,21
1649844378282,MATH 170A,A02,083460,Nie; Jiawang,25,0,30,5
1649844378282,MATH 170A,A03,083461,Nie; Jiawang,26,0,30,4
1649844384307,MATH 193B,A01,083463,Staff,15,0,30,15
1649844384307,MATH 193B,A02,083464,Staff,19,0,30,11
1649844384307,MATH 193B,A03,083465,Staff,27,0,30,3
1649844390368,COGS 2,A01,083966,Boyle; Mary E. T.,27,0,30,3
1649844396397,COGS 9,A01,083968,Staff,56,0,60,4
1649844402424,COGS 14B,A01,083970,Staff,46,0,50,4
1649844408449,COGS 17,A01,092679,Staff,73,0,75,2
1649844414477,COGS 100,A01,083972,Staff,46,0,60,14
1649844426522,COGS 101C,A01,083976,Staff,25,0,30,5
1649844432545,COGS 102A,A01,083978,Johnson; Christine M.,24,0,30,6
1649844438573,COGS 107B,A01,083980,Staff,33,0,50,17
1649844444606,COGS 115,A01,083982,Staff,21,0,30,9
1649844450629,COGS 118B,A01,083367,Staff,5,0,40,35
1649844456654,COGS 172,A01,083984,Provenzano; Emily Kara,20,0,30,10
1649844462685,COGS 177,A00,083368,Staff,3,0,30,27
1649844468713,COGS 186,A01,083986,Staff,25,0,40,15
1649844474737,COGS 187A,A01,083988,Boyle; Mary E. T.,40,0,60,20
1649844480762,CSE 8A,A50,084003,Miranda; Gregory Joseph,9,0,15,6
1649844486785,CSE 11,A01,084005,Miranda; Gregory Joseph,49,0,55,6
1649844492814,CSE 20,A01,084007,Staff,15,0,20,5
1649844498842,CSE 21,A01,084009,Staff,32,0,50,18
1649844504870,CSE 30,A01,083370,Cao; Yingjun,20,0,40,20
1649844510898,CSE 100,A01,083372,Cao; Yingjun,13,0,40,27
1649844516922,CSE 101,A01,084011,Staff,0,16,40,40
1649844522946,CSE 141,A01,083374,Eldon; John,0,13,75,75
1649844528973,CSE 141L,A01,083376,Eldon; John,0,16,75,75
1649844535001,CSE 175,A01,084013,Kumar; Rakesh,24,0,25,1
1649844541025,CSE 190,A00,092508,Staff,15,0,15,0
1649844547056,ECE 5,A01,084049,Morris; Karcher William,17,0,20,3
1649844553082,ECE 100,A01,084051,Baghdadchi; Saharnaz,16,0,20,4
1649844553082,ECE 100,A02,091916,Baghdadchi; Saharnaz,18,0,20,2
1649844559107,ECE 101,A01,084053,Baghdadchi; Saharnaz,25,0,37,12
1649844559107,ECE 101,A02,084054,Baghdadchi; Saharnaz,37,0,37,0
1649844565132,ECE 107,A01,083390,Staff,31,0,40,9
1649844571156,ECE 148,A01,084056,Silberman; Jack,8,0,12,4
1649844577185,ECE 180,A00,083391,Abi Samra; Nicholas Camill,27,0,30,3
1649844577185,ECE 180,B00,083392,Abi Samra; Nicholas Camill,26,0,30,4
1649844583210,MATH 10B,A01,084110,Staff,20,0,30,10
1649844583210,MATH 10B,A02,084111,Staff,29,0,30,1
1649844583210,MATH 10B,A03,084112,Staff,29,0,30,1
1649844589238,MATH 10C,A01,083443,Staff,19,0,30,11
1649844589238,MATH 10C,A02,083444,Staff,24,0,30,6
1649844589238,MATH 10C,B01,084114,Staff,26,0,30,4
1649844589238,MATH 10C,B02,084115,Staff,30,0,30,0
1649844595262,MATH 18,A01,084117,Harel; Guershon,28,0,30,2
1649844595262,MATH 18,A02,084119,Harel; Guershon,29,0,30,1
1649844595262,MATH 18,A03,084120,Harel; Guershon,30,0,30,0
1649844595262,MATH 18,A04,084121,Harel; Guershon,30,0,30,0
1649844601287,MATH 20B,A01,084124,Um; Ko Woon,33,0,35,2
1649844601287,MATH 20B,B01,084126,Um; Ko Woon,35,0,35,0
1649844607323,MATH 20C,A01,083446,Hammock; Frances H,26,0,30,4
1649844607323,MATH 20C,A02,083447,Hammock; Frances H,30,0,30,0
1649844607323,MATH 20C,A03,083448,Hammock; Frances H,30,0,30,0
1649844607323,MATH 20C,A04,083449,Hammock; Frances H,30,0,30,0
1649844607323,MATH 20C,B01,083451,Hammock; Frances H,29,0,30,1
1649844607323,MATH 20C,B02,083452,Hammock; Frances H,30,0,30,0
1649844607323,MATH 20C,B03,083453,Hammock; Frances H,30,0,30,0
1649844607323,MATH 20C,B04,083454,Hammock; Frances H,30,0,30,0
1649844613353,MATH 20D,A01,084128,Staff,29,0,30,1
1649844613353,MATH 20D,A02,084129,Staff,30,0,30,0
1649844613353,MATH 20D,A03,084130,Staff,29,0,30,1
1649844613353,MATH 20D,B01,084133,Staff,28,0,30,2
1649844613353,MATH 20D,B02,084134,Staff,30,0,30,0
1649844613353,MATH 20D,B03,084135,Staff,30,0,30,0
1649844619377,MATH 20E,A01,084138,Staff,27,0,30,3
1649844619377,MATH 20E,A02,084139,Staff,29,0,30,1
1649844619377,MATH 20E,A03,084140,Staff,28,0,30,2
1649844619377,MATH 20E,A04,084141,Staff,30,0,30,0
1649844625401,MATH 102,A01,084143,Harel; Guershon,24,0,30,6
1649844625401,MATH 102,A02,084144,Harel; Guershon,25,0,30,5
1649844631427,MATH 103B,A01,083456,Staff,0,0,30,30
1649844631427,MATH 103B,A02,083457,Staff,18,0,30,12
1649844637451,MATH 109,A01,084146,Salehi Golsefidy; Alireza,30,0,30,0
1649844637451,MATH 109,A02,084147,Salehi Golsefidy; Alireza,26,0,30,4
1649844643478,MATH 120A,A01,085445,Eggers; John Dietrich,30,0,35,5
1649844643478,MATH 120A,A02,085446,Eggers; John Dietrich,31,0,35,4
1649844649503,MATH 142B,A01,084149,Verstraete; Jacques Allan,7,0,30,23
1649844649503,MATH 142B,A02,084150,Verstraete; Jacques Allan,25,0,30,5
1649844655534,MATH 170A,A01,083459,Nie; Jiawang,9,0,30,21
1649844655534,MATH 170A,A02,083460,Nie; Jiawang,25,0,30,5
1649844655534,MATH 170A,A03,083461,Nie; Jiawang,26,0,30,4
1649844661558,MATH 193B,A01,083463,Staff,15,0,30,15
1649844661558,MATH 193B,A02,083464,Staff,19,0,30,11
1649844661558,MATH 193B,A03,083465,Staff,27,0,30,3
1649844667623,COGS 2,A01,083966,Boyle; Mary E. T.,27,0,30,3
1649844673647,COGS 9,A01,083968,Staff,56,0,60,4
1649844679670,COGS 14B,A01,083970,Staff,46,0,50,4
1649844685698,COGS 17,A01,092679,Staff,73,0,75,2
1649844691720,COGS 100,A01,083972,Staff,46,0,60,14
1649844703777,COGS 101C,A01,083976,Staff,25,0,30,5
1649844709799,COGS 102A,A01,083978,Johnson; Christine M.,24,0,30,6
1649844715825,COGS 107B,A01,083980,Staff,33,0,50,17
1649844721858,COGS 115,A01,083982,Staff,21,0,30,9
1649844727892,COGS 118B,A01,083367,Staff,5,0,40,35
1649844733917,COGS 172,A01,083984,Provenzano; Emily Kara,20,0,30,10
1649844739942,COGS 177,A00,083368,Staff,3,0,30,27
1649844745965,COGS 186,A01,083986,Staff,25,0,40,15
1649844751989,COGS 187A,A01,083988,Boyle; Mary E. T.,40,0,60,20
1649844758012,CSE 8A,A50,084003,Miranda; Gregory Joseph,9,0,15,6
1649844764037,CSE 11,A01,084005,Miranda; Gregory Joseph,49,0,55,6
1649844770089,CSE 20,A01,084007,Staff,15,0,20,5
1649844776112,CSE 21,A01,084009,Staff,32,0,50,18
1649844782136,CSE 30,A01,083370,Cao; Yingjun,20,0,40,20
1649844788160,CSE 100,A01,083372,Cao; Yingjun,13,0,40,27
1649844794184,CSE 101,A01,084011,Staff,0,16,40,40
1649844800208,CSE 141,A01,083374,Eldon; John,0,13,75,75
1649844806231,CSE 141L,A01,083376,Eldon; John,0,16,75,75
1649844812254,CSE 175,A01,084013,Kumar; Rakesh,24,0,25,1
1649844818287,CSE 190,A00,092508,Staff,15,0,15,0
1649844824311,ECE 5,A01,084049,Morris; Karcher William,17,0,20,3
1649844830362,ECE 100,A01,084051,Baghdadchi; Saharnaz,16,0,20,4
1649844830362,ECE 100,A02,091916,Baghdadchi; Saharnaz,18,0,20,2
1649844836389,ECE 101,A01,084053,Baghdadchi; Saharnaz,25,0,37,12
1649844836389,ECE 101,A02,084054,Baghdadchi; Saharnaz,37,0,37,0
1649844842414,ECE 107,A01,083390,Staff,31,0,40,9
1649844848444,ECE 148,A01,084056,Silberman; Jack,8,0,12,4
1649844854468,ECE 180,A00,083391,Abi Samra; Nicholas Camill,27,0,30,3
1649844854468,ECE 180,B00,083392,Abi Samra; Nicholas Camill,26,0,30,4
1649844860503,MATH 10B,A01,084110,Staff,20,0,30,10
1649844860503,MATH 10B,A02,084111,Staff,29,0,30,1
1649844860503,MATH 10B,A03,084112,Staff,29,0,30,1
1649844866527,MATH 10C,A01,083443,Staff,19,0,30,11
1649844866527,MATH 10C,A02,083444,Staff,24,0,30,6
1649844866527,MATH 10C,B01,084114,Staff,26,0,30,4
1649844866527,MATH 10C,B02,084115,Staff,30,0,30,0
1649844872557,MATH 18,A01,084117,Harel; Guershon,28,0,30,2
1649844872557,MATH 18,A02,084119,Harel; Guershon,29,0,30,1
1649844872557,MATH 18,A03,084120,Harel; Guershon,30,0,30,0
1649844872557,MATH 18,A04,084121,Harel; Guershon,30,0,30,0
1649844878580,MATH 20B,A01,084124,Um; Ko Woon,33,0,35,2
1649844878580,MATH 20B,B01,084126,Um; Ko Woon,35,0,35,0
1649844884606,MATH 20C,A01,083446,Hammock; Frances H,26,0,30,4
1649844884606,MATH 20C,A02,083447,Hammock; Frances H,30,0,30,0
1649844884606,MATH 20C,A03,083448,Hammock; Frances H,30,0,30,0
1649844884606,MATH 20C,A04,083449,Hammock; Frances H,30,0,30,0
1649844884606,MATH 20C,B01,083451,Hammock; Frances H,29,0,30,1
1649844884606,MATH 20C,B02,083452,Hammock; Frances H,30,0,30,0
1649844884606,MATH 20C,B03,083453,Hammock; Frances H,30,0,30,0
1649844884606,MATH 20C,B04,083454,Hammock; Frances H,30,0,30,0
1649844890635,MATH 20D,A01,084128,Staff,29,0,30,1
1649844890635,MATH 20D,A02,084129,Staff,30,0,30,0
1649844890635,MATH 20D,A03,084130,Staff,29,0,30,1
1649844890635,MATH 20D,B01,084133,Staff,28,0,30,2
1649844890635,MATH 20D,B02,084134,Staff,30,0,30,0
1649844890635,MATH 20D,B03,084135,Staff,30,0,30,0
1649844896665,MATH 20E,A01,084138,Staff,27,0,30,3
1649844896665,MATH 20E,A02,084139,Staff,29,0,30,1
1649844896665,MATH 20E,A03,084140,Staff,28,0,30,2
1649844896665,MATH 20E,A04,084141,Staff,30,0,30,0
1649844902689,MATH 102,A01,084143,Harel; Guershon,24,0,30,6
1649844902689,MATH 102,A02,084144,Harel; Guershon,25,0,30,5
1649844908717,MATH 103B,A01,083456,Staff,0,0,30,30
1649844908717,MATH 103B,A02,083457,Staff,18,0,30,12
1649844914742,MATH 109,A01,084146,Salehi Golsefidy; Alireza,30,0,30,0
1649844914742,MATH 109,A02,084147,Salehi Golsefidy; Alireza,26,0,30,4
1649844920765,MATH 120A,A01,085445,Eggers; John Dietrich,30,0,35,5
1649844920765,MATH 120A,A02,085446,Eggers; John Dietrich,31,0,35,4
1649844926792,MATH 142B,A01,084149,Verstraete; Jacques Allan,7,0,30,23
1649844926792,MATH 142B,A02,084150,Verstraete; Jacques Allan,25,0,30,5
1649844932822,MATH 170A,A01,083459,Nie; Jiawang,9,0,30,21
1649844932822,MATH 170A,A02,083460,Nie; Jiawang,25,0,30,5
1649844932822,MATH 170A,A03,083461,Nie; Jiawang,26,0,30,4
1649844938849,MATH 193B,A01,083463,Staff,15,0,30,15
1649844938849,MATH 193B,A02,083464,Staff,19,0,30,11
1649844938849,MATH 193B,A03,083465,Staff,27,0,30,3
1649844944902,COGS 2,A01,083966,Boyle; Mary E. T.,27,0,30,3
1649844950927,COGS 9,A01,083968,Staff,56,0,60,4
1649844957042,COGS 14B,A01,083970,Staff,46,0,50,4
1649844963064,COGS 17,A01,092679,Staff,73,0,75,2
1649844969088,COGS 100,A01,083972,Staff,46,0,60,14
1649844981139,COGS 101C,A01,083976,Staff,25,0,30,5
1649844987163,COGS 102A,A01,083978,Johnson; Christine M.,24,0,30,6
1649844993185,COGS 107B,A01,083980,Staff,33,0,50,17
1649844999213,COGS 115,A01,083982,Staff,21,0,30,9
1649845005252,COGS 118B,A01,083367,Staff,5,0,40,35
1649845011276,COGS 172,A01,083984,Provenzano; Emily Kara,20,0,30,10
1649845017299,COGS 177,A00,083368,Staff,3,0,30,27
1649845023334,COGS 186,A01,083986,Staff,25,0,40,15
1649845029358,COGS 187A,A01,083988,Boyle; Mary E. T.,40,0,60,20
1649845035384,CSE 8A,A50,084003,Miranda; Gregory Joseph,9,0,15,6
1649845041412,CSE 11,A01,084005,Miranda; Gregory Joseph,49,0,55,6
1649845047436,CSE 20,A01,084007,Staff,15,0,20,5
1649845053457,CSE 21,A01,084009,Staff,32,0,50,18
1649845059480,CSE 30,A01,083370,Cao; Yingjun,20,0,40,20
1649845065503,CSE 100,A01,083372,Cao; Yingjun,13,0,40,27
1649845071529,CSE 101,A01,084011,Staff,0,16,40,40
1649845077551,CSE 141,A01,083374,Eldon; John,0,13,75,75
1649845083574,CSE 141L,A01,083376,Eldon; John,0,16,75,75
1649845089615,CSE 175,A01,084013,Kumar; Rakesh,24,0,25,1
1649845095641,CSE 190,A00,092508,Staff,15,0,15,0
1649845101664,ECE 5,A01,084049,Morris; Karcher William,17,0,20,3
1649845107693,ECE 100,A01,084051,Baghdadchi; Saharnaz,16,0,20,4
1649845107693,ECE 100,A02,091916,Baghdadchi; Saharnaz,18,0,20,2
1649845113719,ECE 101,A01,084053,Baghdadchi; Saharnaz,25,0,37,12
1649845113719,ECE 101,A02,084054,Baghdadchi; Saharnaz,37,0,37,0
1649845119743,ECE 107,A01,083390,Staff,31,0,40,9
1649845125771,ECE 148,A01,084056,Silberman; Jack,8,0,12,4
1649845131797,ECE 180,A00,083391,Abi Samra; Nicholas Camill,27,0,30,3
1649845131797,ECE 180,B00,083392,Abi Samra; Nicholas Camill,26,0,30,4
1649845137823,MATH 10B,A01,084110,Staff,20,0,30,10
1649845137823,MATH 10B,A02,084111,Staff,29,0,30,1
1649845137823,MATH 10B,A03,084112,Staff,29,0,30,1
1649845143848,MATH 10C,A01,083443,Staff,19,0,30,11
1649845143848,MATH 10C,A02,083444,Staff,24,0,30,6
1649845143848,MATH 10C,B01,084114,Staff,26,0,30,4
1649845143848,MATH 10C,B02,084115,Staff,30,0,30,0
1649845149877,MATH 18,A01,084117,Harel; Guershon,28,0,30,2
1649845149877,MATH 18,A02,084119,Harel; Guershon,29,0,30,1
1649845149877,MATH 18,A03,084120,Harel; Guershon,30,0,30,0
1649845149877,MATH 18,A04,084121,Harel; Guershon,30,0,30,0
1649845155908,MATH 20B,A01,084124,Um; Ko Woon,33,0,35,2
1649845155908,MATH 20B,B01,084126,Um; Ko Woon,35,0,35,0
1649845161934,MATH 20C,A01,083446,Hammock; Frances H,26,0,30,4
1649845161934,MATH 20C,A02,083447,Hammock; Frances H,30,0,30,0
1649845161934,MATH 20C,A03,083448,Hammock; Frances H,30,0,30,0
1649845161934,MATH 20C,A04,083449,Hammock; Frances H,30,0,30,0
1649845161934,MATH 20C,B01,083451,Hammock; Frances H,29,0,30,1
1649845161934,MATH 20C,B02,083452,Hammock; Frances H,30,0,30,0
1649845161934,MATH 20C,B03,083453,Hammock; Frances H,30,0,30,0
1649845161934,MATH 20C,B04,083454,Hammock; Frances H,30,0,30,0
1649845167962,MATH 20D,A01,084128,Staff,29,0,30,1
1649845167962,MATH 20D,A02,084129,Staff,30,0,30,0
1649845167962,MATH 20D,A03,084130,Staff,29,0,30,1
1649845167962,MATH 20D,B01,084133,Staff,28,0,30,2
1649845167962,MATH 20D,B02,084134,Staff,30,0,30,0
1649845167962,MATH 20D,B03,084135,Staff,30,0,30,0
1649845173987,MATH 20E,A01,084138,Staff,27,0,30,3
1649845173987,MATH 20E,A02,084139,Staff,29,0,30,1
1649845173987,MATH 20E,A03,084140,Staff,28,0,30,2
1649845173987,MATH 20E,A04,084141,Staff,30,0,30,0
1649845180017,MATH 102,A01,084143,Harel; Guershon,24,0,30,6
1649845180017,MATH 102,A02,084144,Harel; Guershon,25,0,30,5
1649845186047,MATH 103B,A01,083456,Staff,0,0,30,30
1649845186047,MATH 103B,A02,083457,Staff,18,0,30,12
1649845192071,MATH 109,A01,084146,Salehi Golsefidy; Alireza,30,0,30,0
1649845192071,MATH 109,A02,084147,Salehi Golsefidy; Alireza,26,0,30,4
1649845198102,MATH 120A,A01,085445,Eggers; John Dietrich,30,0,35,5
1649845198102,MATH 120A,A02,085446,Eggers; John Dietrich,31,0,35,4
1649845204127,MATH 142B,A01,084149,Verstraete; Jacques Allan,7,0,30,23
1649845204127,MATH 142B,A02,084150,Verstraete; Jacques Allan,25,0,30,5
1649845210154,MATH 170A,A01,083459,Nie; Jiawang,9,0,30,21
1649845210154,MATH 170A,A02,083460,Nie; Jiawang,25,0,30,5
1649845210154,MATH 170A,A03,083461,Nie; Jiawang,26,0,30,4
1649845216183,MATH 193B,A01,083463,Staff,15,0,30,15
1649845216183,MATH 193B,A02,083464,Staff,19,0,30,11
1649845216183,MATH 193B,A03,083465,Staff,27,0,30,3
1649845222249,COGS 2,A01,083966,Boyle; Mary E. T.,27,0,30,3
1649845228277,COGS 9,A01,083968,Staff,56,0,60,4
1649845234301,COGS 14B,A01,083970,Staff,46,0,50,4
1649845240325,COGS 17,A01,092679,Staff,73,0,75,2
1649845246358,COGS 100,A01,083972,Staff,46,0,60,14
1649845258405,COGS 101C,A01,083976,Staff,25,0,30,5
1649845264437,COGS 102A,A01,083978,Johnson; Christine M.,24,0,30,6
1649845270462,COGS 107B,A01,083980,Staff,33,0,50,17
1649845276491,COGS 115,A01,083982,Staff,21,0,30,9
1649845282515,COGS 118B,A01,083367,Staff,5,0,40,35
1649845288546,COGS 172,A01,083984,Provenzano; Emily Kara,20,0,30,10
1649845294571,COGS 177,A00,083368,Staff,3,0,30,27
1649845300600,COGS 186,A01,083986,Staff,25,0,40,15
1649845306625,COGS 187A,A01,083988,Boyle; Mary E. T.,40,0,60,20
1649845312653,CSE 8A,A50,084003,Miranda; Gregory Joseph,9,0,15,6
1649845318680,CSE 11,A01,084005,Miranda; Gregory Joseph,49,0,55,6
1649845324708,CSE 20,A01,084007,Staff,15,0,20,5
1649845330731,CSE 21,A01,084009,Staff,32,0,50,18
1649845336755,CSE 30,A01,083370,Cao; Yingjun,20,0,40,20
1649845342779,CSE 100,A01,083372,Cao; Yingjun,13,0,40,27
1649845348803,CSE 101,A01,084011,Staff,0,16,40,40
1649845354827,CSE 141,A01,083374,Eldon; John,0,13,75,75
1649845360851,CSE 141L,A01,083376,Eldon; John,0,16,75,75
1649845366876,CSE 175,A01,084013,Kumar; Rakesh,24,0,25,1
1649845372900,CSE 190,A00,092508,Staff,15,0,15,0
1649845378927,ECE 5,A01,084049,Morris; Karcher William,17,0,20,3
1649845384955,ECE 100,A01,084051,Baghdadchi; Saharnaz,16,0,20,4
1649845384955,ECE 100,A02,091916,Baghdadchi; Saharnaz,18,0,20,2
1649845390979,ECE 101,A01,084053,Baghdadchi; Saharnaz,25,0,37,12
1649845390979,ECE 101,A02,084054,Baghdadchi; Saharnaz,37,0,37,0
1649845397005,ECE 107,A01,083390,Staff,31,0,40,9
1649845403033,ECE 148,A01,084056,Silberman; Jack,8,0,12,4
1649845409060,ECE 180,A00,083391,Abi Samra; Nicholas Camill,27,0,30,3
1649845409060,ECE 180,B00,083392,Abi Samra; Nicholas Camill,26,0,30,4
1649845415089,MATH 10B,A01,084110,Staff,20,0,30,10
1649845415089,MATH 10B,A02,084111,Staff,29,0,30,1
1649845415089,MATH 10B,A03,084112,Staff,29,0,30,1
1649845421119,MATH 10C,A01,083443,Staff,19,0,30,11
1649845421119,MATH 10C,A02,083444,Staff,24,0,30,6
1649845421119,MATH 10C,B01,084114,Staff,26,0,30,4
1649845421119,MATH 10C,B02,084115,Staff,30,0,30,0
1649845427160,MATH 18,A01,084117,Harel; Guershon,28,0,30,2
1649845427160,MATH 18,A02,084119,Harel; Guershon,29,0,30,1
1649845427160,MATH 18,A03,084120,Harel; Guershon,30,0,30,0
1649845427160,MATH 18,A04,084121,Harel; Guershon,30,0,30,0
1649845433185,MATH 20B,A01,084124,Um; Ko Woon,33,0,35,2
1649845433185,MATH 20B,B01,084126,Um; Ko Woon,35,0,35,0
1649845439210,MATH 20C,A01,083446,Hammock; Frances H,26,0,30,4
1649845439210,MATH 20C,A02,083447,Hammock; Frances H,30,0,30,0
1649845439210,MATH 20C,A03,083448,Hammock; Frances H,30,0,30,0
1649845439210,MATH 20C,A04,083449,Hammock; Frances H,30,0,30,0
1649845439210,MATH 20C,B01,083451,Hammock; Frances H,29,0,30,1
1649845439210,MATH 20C,B02,083452,Hammock; Frances H,30,0,30,0
1649845439210,MATH 20C,B03,083453,Hammock; Frances H,30,0,30,0
1649845439210,MATH 20C,B04,083454,Hammock; Frances H,30,0,30,0
1649845445240,MATH 20D,A01,084128,Staff,29,0,30,1
1649845445240,MATH 20D,A02,084129,Staff,30,0,30,0
1649845445240,MATH 20D,A03,084130,Staff,29,0,30,1
1649845445240,MATH 20D,B01,084133,Staff,28,0,30,2
1649845445240,MATH 20D,B02,084134,Staff,30,0,30,0
1649845445240,MATH 20D,B03,084135,Staff,30,0,30,0
1649845451270,MATH 20E,A01,084138,Staff,27,0,30,3
1649845451270,MATH 20E,A02,084139,Staff,29,0,30,1
1649845451270,MATH 20E,A03,084140,Staff,28,0,30,2
1649845451270,MATH 20E,A04,084141,Staff,30,0,30,0
1649845457293,MATH 102,A01,084143,Harel; Guershon,24,0,30,6
1649845457293,MATH 102,A02,084144,Harel; Guershon,25,0,30,5
1649845463318,MATH 103B,A01,083456,Staff,0,0,30,30
1649845463318,MATH 103B,A02,083457,Staff,18,0,30,12
1649845469343,MATH 109,A01,084146,Salehi Golsefidy; Alireza,30,0,30,0
1649845469343,MATH 109,A02,084147,Salehi Golsefidy; Alireza,26,0,30,4
1649845475372,MATH 120A,A01,085445,Eggers; John Dietrich,30,0,35,5
1649845475372,MATH 120A,A02,085446,Eggers; John Dietrich,31,0,35,4
1649845481398,MATH 142B,A01,084149,Verstraete; Jacques Allan,7,0,30,23
1649845481398,MATH 142B,A02,084150,Verstraete; Jacques Allan,25,0,30,5
1649845487428,MATH 170A,A01,083459,Nie; Jiawang,9,0,30,21
1649845487428,MATH 170A,A02,083460,Nie; Jiawang,25,0,30,5
1649845487428,MATH 170A,A03,083461,Nie; Jiawang,26,0,30,4
1649845493450,MATH 193B,A01,083463,Staff,15,0,30,15
1649845493450,MATH 193B,A02,083464,Staff,19,0,30,11
1649845493450,MATH 193B,A03,083465,Staff,27,0,30,3
1649845499509,COGS 2,A01,083966,Boyle; Mary E. T.,27,0,30,3
1649845505533,COGS 9,A01,083968,Staff,56,0,60,4
1649845511558,COGS 14B,A01,083970,Staff,46,0,50,4
1649845517583,COGS 17,A01,092679,Staff,73,0,75,2
1649845523610,COGS 100,A01,083972,Staff,46,0,60,14
1649845535666,COGS 101C,A01,083976,Staff,25,0,30,5
1649845541690,COGS 102A,A01,083978,Johnson; Christine M.,24,0,30,6
1649845547717,COGS 107B,A01,083980,Staff,33,0,50,17
1649845553833,COGS 115,A01,083982,Staff,21,0,30,9
1649845559859,COGS 118B,A01,083367,Staff,5,0,40,35
1649845565880,COGS 172,A01,083984,Provenzano; Emily Kara,20,0,30,10
1649845571903,COGS 177,A00,083368,Staff,3,0,30,27
1649845577928,COGS 186,A01,083986,Staff,25,0,40,15
1649845583957,COGS 187A,A01,083988,Boyle; Mary E. T.,40,0,60,20
1649845589978,CSE 8A,A50,084003,Miranda; Gregory Joseph,9,0,15,6
1649845596006,CSE 11,A01,084005,Miranda; Gregory Joseph,49,0,55,6
1649845602028,CSE 20,A01,084007,Staff,15,0,20,5
1649845608053,CSE 21,A01,084009,Staff,32,0,50,18
1649845614083,CSE 30,A01,083370,Cao; Yingjun,20,0,40,20
1649845620107,CSE 100,A01,083372,Cao; Yingjun,13,0,40,27
1649845626136,CSE 101,A01,084011,Staff,0,16,40,40
1649845632161,CSE 141,A01,083374,Eldon; John,0,13,75,75
1649845638184,CSE 141L,A01,083376,Eldon; John,0,16,75,75
1649845644208,CSE 175,A01,084013,Kumar; Rakesh,24,0,25,1
1649845650235,CSE 190,A00,092508,Staff,15,0,15,0
1649845656258,ECE 5,A01,084049,Morris; Karcher William,17,0,20,3
1649845662281,ECE 100,A01,084051,Baghdadchi; Saharnaz,16,0,20,4
1649845662281,ECE 100,A02,091916,Baghdadchi; Saharnaz,18,0,20,2
1649845668304,ECE 101,A01,084053,Baghdadchi; Saharnaz,25,0,37,12
1649845668304,ECE 101,A02,084054,Baghdadchi; Saharnaz,37,0,37,0
1649845674333,ECE 107,A01,083390,Staff,31,0,40,9
1649845680364,ECE 148,A01,084056,Silberman; Jack,8,0,12,4
1649845686388,ECE 180,A00,083391,Abi Samra; Nicholas Camill,27,0,30,3
1649845686388,ECE 180,B00,083392,Abi Samra; Nicholas Camill,26,0,30,4
1649845692412,MATH 10B,A01,084110,Staff,20,0,30,10
1649845692412,MATH 10B,A02,084111,Staff,29,0,30,1
1649845692412,MATH 10B,A03,084112,Staff,29,0,30,1
1649845698436,MATH 10C,A01,083443,Staff,19,0,30,11
1649845698436,MATH 10C,A02,083444,Staff,24,0,30,6
1649845698436,MATH 10C,B01,084114,Staff,26,0,30,4
1649845698436,MATH 10C,B02,084115,Staff,30,0,30,0
1649845704465,MATH 18,A01,084117,Harel; Guershon,28,0,30,2
1649845704465,MATH 18,A02,084119,Harel; Guershon,29,0,30,1
1649845704465,MATH 18,A03,084120,Harel; Guershon,30,0,30,0
1649845704465,MATH 18,A04,084121,Harel; Guershon,30,0,30,0
1649845710495,MATH 20B,A01,084124,Um; Ko Woon,33,0,35,2
1649845710495,MATH 20B,B01,084126,Um; Ko Woon,35,0,35,0
1649845716525,MATH 20C,A01,083446,Hammock; Frances H,26,0,30,4
1649845716525,MATH 20C,A02,083447,Hammock; Frances H,30,0,30,0
1649845716525,MATH 20C,A03,083448,Hammock; Frances H,30,0,30,0
1649845716525,MATH 20C,A04,083449,Hammock; Frances H,30,0,30,0
1649845716525,MATH 20C,B01,083451,Hammock; Frances H,29,0,30,1
1649845716525,MATH 20C,B02,083452,Hammock; Frances H,30,0,30,0
1649845716525,MATH 20C,B03,083453,Hammock; Frances H,30,0,30,0
1649845716525,MATH 20C,B04,083454,Hammock; Frances H,30,0,30,0
1649845722549,MATH 20D,A01,084128,Staff,29,0,30,1
1649845722549,MATH 20D,A02,084129,Staff,30,0,30,0
1649845722549,MATH 20D,A03,084130,Staff,29,0,30,1
1649845722549,MATH 20D,B01,084133,Staff,28,0,30,2
1649845722549,MATH 20D,B02,084134,Staff,30,0,30,0
1649845722549,MATH 20D,B03,084135,Staff,30,0,30,0
1649845728574,MATH 20E,A01,084138,Staff,27,0,30,3
1649845728574,MATH 20E,A02,084139,Staff,29,0,30,1
1649845728574,MATH 20E,A03,084140,Staff,28,0,30,2
1649845728574,MATH 20E,A04,084141,Staff,30,0,30,0
1649845734599,MATH 102,A01,084143,Harel; Guershon,24,0,30,6
1649845734599,MATH 102,A02,084144,Harel; Guershon,25,0,30,5
1649845740627,MATH 103B,A01,083456,Staff,0,0,30,30
1649845740627,MATH 103B,A02,083457,Staff,18,0,30,12
1649845746657,MATH 109,A01,084146,Salehi Golsefidy; Alireza,30,0,30,0
1649845746657,MATH 109,A02,084147,Salehi Golsefidy; Alireza,26,0,30,4
1649845752685,MATH 120A,A01,085445,Eggers; John Dietrich,30,0,35,5
1649845752685,MATH 120A,A02,085446,Eggers; John Dietrich,31,0,35,4
1649845758715,MATH 142B,A01,084149,Verstraete; Jacques Allan,7,0,30,23
1649845758715,MATH 142B,A02,084150,Verstraete; Jacques Allan,25,0,30,5
1649845764740,MATH 170A,A01,083459,Nie; Jiawang,9,0,30,21
1649845764740,MATH 170A,A02,083460,Nie; Jiawang,25,0,30,5
1649845764740,MATH 170A,A03,083461,Nie; Jiawang,26,0,30,4
1649845770769,MATH 193B,A01,083463,Staff,15,0,30,15
1649845770769,MATH 193B,A02,083464,Staff,19,0,30,11
1649845770769,MATH 193B,A03,083465,Staff,27,0,30,3
1649845776828,COGS 2,A01,083966,Boyle; Mary E. T.,27,0,30,3
1649845782863,COGS 9,A01,083968,Staff,56,0,60,4
1649845788886,COGS 14B,A01,083970,Staff,46,0,50,4
1649845794909,COGS 17,A01,092679,Staff,73,0,75,2
1649845800936,COGS 100,A01,083972,Staff,46,0,60,14
1649845812985,COGS 101C,A01,083976,Staff,25,0,30,5
1649845819010,COGS 102A,A01,083978,Johnson; Christine M.,24,0,30,6
1649845825375,COGS 107B,A01,083980,Staff,33,0,50,17
1649845831399,COGS 115,A01,083982,Staff,21,0,30,9
1649845837424,COGS 118B,A01,083367,Staff,5,0,40,35
1649845843453,COGS 172,A01,083984,Provenzano; Emily Kara,20,0,30,10
1649845849480,COGS 177,A00,083368,Staff,3,0,30,27
1649845855504,COGS 186,A01,083986,Staff,25,0,40,15
1649845861528,COGS 187A,A01,083988,Boyle; Mary E. T.,40,0,60,20
1649845867553,CSE 8A,A50,084003,Miranda; Gregory Joseph,9,0,15,6
1649845873577,CSE 11,A01,084005,Miranda; Gregory Joseph,49,0,55,6
1649845879603,CSE 20,A01,084007,Staff,15,0,20,5
1649845885630,CSE 21,A01,084009,Staff,32,0,50,18
1649845891654,CSE 30,A01,083370,Cao; Yingjun,20,0,40,20
1649845897683,CSE 100,A01,083372,Cao; Yingjun,13,0,40,27
1649845903719,CSE 101,A01,084011,Staff,0,16,40,40
1649845909744,CSE 141,A01,083374,Eldon; John,0,13,75,75
1649845915768,CSE 141L,A01,083376,Eldon; John,0,17,75,75
1649845921792,CSE 175,A01,084013,Kumar; Rakesh,24,0,25,1
1649845927823,CSE 190,A00,092508,Staff,15,0,15,0
1649845933847,ECE 5,A01,084049,Morris; Karcher William,17,0,20,3
1649845939871,ECE 100,A01,084051,Baghdadchi; Saharnaz,16,0,20,4
1649845939871,ECE 100,A02,091916,Baghdadchi; Saharnaz,18,0,20,2
1649845945895,ECE 101,A01,084053,Baghdadchi; Saharnaz,25,0,37,12
1649845945895,ECE 101,A02,084054,Baghdadchi; Saharnaz,37,0,37,0
1649845951920,ECE 107,A01,083390,Staff,31,0,40,9
1649845957944,ECE 148,A01,084056,Silberman; Jack,8,0,12,4
1649845963973,ECE 180,A00,083391,Abi Samra; Nicholas Camill,27,0,30,3
1649845963973,ECE 180,B00,083392,Abi Samra; Nicholas Camill,26,0,30,4
1649845970000,MATH 10B,A01,084110,Staff,20,0,30,10
1649845970000,MATH 10B,A02,084111,Staff,29,0,30,1
1649845970000,MATH 10B,A03,084112,Staff,29,0,30,1
1649845976024,MATH 10C,A01,083443,Staff,19,0,30,11
1649845976024,MATH 10C,A02,083444,Staff,24,0,30,6
1649845976024,MATH 10C,B01,084114,Staff,26,0,30,4
1649845976024,MATH 10C,B02,084115,Staff,30,0,30,0
1649845982046,MATH 18,A01,084117,Harel; Guershon,28,0,30,2
1649845982046,MATH 18,A02,084119,Harel; Guershon,29,0,30,1
1649845982046,MATH 18,A03,084120,Harel; Guershon,30,0,30,0
1649845982046,MATH 18,A04,084121,Harel; Guershon,30,0,30,0
1649845988070,MATH 20B,A01,084124,Um; Ko Woon,33,0,35,2
1649845988070,MATH 20B,B01,084126,Um; Ko Woon,35,0,35,0
1649845994096,MATH 20C,A01,083446,Hammock; Frances H,26,0,30,4
1649845994096,MATH 20C,A02,083447,Hammock; Frances H,30,0,30,0
1649845994096,MATH 20C,A03,083448,Hammock; Frances H,30,0,30,0
1649845994096,MATH 20C,A04,083449,Hammock; Frances H,30,0,30,0
1649845994096,MATH 20C,B01,083451,Hammock; Frances H,29,0,30,1
1649845994096,MATH 20C,B02,083452,Hammock; Frances H,30,0,30,0
1649845994096,MATH 20C,B03,083453,Hammock; Frances H,30,0,30,0
1649845994096,MATH 20C,B04,083454,Hammock; Frances H,30,0,30,0
1649846000120,MATH 20D,A01,084128,Staff,29,0,30,1
1649846000120,MATH 20D,A02,084129,Staff,30,0,30,0
1649846000120,MATH 20D,A03,084130,Staff,29,0,30,1
1649846000120,MATH 20D,B01,084133,Staff,28,0,30,2
1649846000120,MATH 20D,B02,084134,Staff,30,0,30,0
1649846000120,MATH 20D,B03,084135,Staff,30,0,30,0
1649846006148,MATH 20E,A01,084138,Staff,27,0,30,3
1649846006148,MATH 20E,A02,084139,Staff,29,0,30,1
1649846006148,MATH 20E,A03,084140,Staff,28,0,30,2
1649846006148,MATH 20E,A04,084141,Staff,30,0,30,0
1649846012176,MATH 102,A01,084143,Harel; Guershon,24,0,30,6
1649846012176,MATH 102,A02,084144,Harel; Guershon,25,0,30,5
1649846018201,MATH 103B,A01,083456,Staff,0,0,30,30
1649846018201,MATH 103B,A02,083457,Staff,18,0,30,12
1649846024224,MATH 109,A01,084146,Salehi Golsefidy; Alireza,30,0,30,0
1649846024224,MATH 109,A02,084147,Salehi Golsefidy; Alireza,26,0,30,4
1649846030249,MATH 120A,A01,085445,Eggers; John Dietrich,30,0,35,5
1649846030249,MATH 120A,A02,085446,Eggers; John Dietrich,31,0,35,4
1649846036272,MATH 142B,A01,084149,Verstraete; Jacques Allan,7,0,30,23
1649846036272,MATH 142B,A02,084150,Verstraete; Jacques Allan,25,0,30,5
1649846042298,MATH 170A,A01,083459,Nie; Jiawang,9,0,30,21
1649846042298,MATH 170A,A02,083460,Nie; Jiawang,25,0,30,5
1649846042298,MATH 170A,A03,083461,Nie; Jiawang,26,0,30,4
1649846048327,MATH 193B,A01,083463,Staff,15,0,30,15
1649846048327,MATH 193B,A02,083464,Staff,19,0,30,11
1649846048327,MATH 193B,A03,083465,Staff,27,0,30,3
1649846054392,COGS 2,A01,083966,Boyle; Mary E. T.,27,0,30,3
1649846060416,COGS 9,A01,083968,Staff,56,0,60,4
1649846066440,COGS 14B,A01,083970,Staff,46,0,50,4
1649846072466,COGS 17,A01,092679,Staff,73,0,75,2
1649846078488,COGS 100,A01,083972,Staff,46,0,60,14
1649846090535,COGS 101C,A01,083976,Staff,25,0,30,5
1649846096558,COGS 102A,A01,083978,Johnson; Christine M.,24,0,30,6
1649846102584,COGS 107B,A01,083980,Staff,33,0,50,17
1649846108609,COGS 115,A01,083982,Staff,21,0,30,9
1649846114633,COGS 118B,A01,083367,Staff,5,0,40,35
1649846120658,COGS 172,A01,083984,Provenzano; Emily Kara,20,0,30,10
1649846126682,COGS 177,A00,083368,Staff,3,0,30,27
1649846132707,COGS 186,A01,083986,Staff,25,0,40,15
1649846138730,COGS 187A,A01,083988,Boyle; Mary E. T.,40,0,60,20
1649846144757,CSE 8A,A50,084003,Miranda; Gregory Joseph,9,0,15,6
1649846150878,CSE 11,A01,084005,Miranda; Gregory Joseph,49,0,55,6
1649846156903,CSE 20,A01,084007,Staff,15,0,20,5
1649846162927,CSE 21,A01,084009,Staff,32,0,50,18
1649846168950,CSE 30,A01,083370,Cao; Yingjun,20,0,40,20
1649846174978,CSE 100,A01,083372,Cao; Yingjun,13,0,40,27
1649846181005,CSE 101,A01,084011,Staff,0,16,40,40
1649846187028,CSE 141,A01,083374,Eldon; John,0,13,75,75
1649846193058,CSE 141L,A01,083376,Eldon; John,0,17,75,75
1649846199083,CSE 175,A01,084013,Kumar; Rakesh,24,0,25,1
1649846205107,CSE 190,A00,092508,Staff,15,0,15,0
1649846211134,ECE 5,A01,084049,Morris; Karcher William,17,0,20,3
1649846217163,ECE 100,A01,084051,Baghdadchi; Saharnaz,16,0,20,4
1649846217163,ECE 100,A02,091916,Baghdadchi; Saharnaz,18,0,20,2
1649846223193,ECE 101,A01,084053,Baghdadchi; Saharnaz,25,0,37,12
1649846223193,ECE 101,A02,084054,Baghdadchi; Saharnaz,37,0,37,0
1649846229224,ECE 107,A01,083390,Staff,31,0,40,9
1649846235248,ECE 148,A01,084056,Silberman; Jack,8,0,12,4
1649846241272,ECE 180,A00,083391,Abi Samra; Nicholas Camill,27,0,30,3
1649846241272,ECE 180,B00,083392,Abi Samra; Nicholas Camill,26,0,30,4
1649846247307,MATH 10B,A01,084110,Staff,20,0,30,10
1649846247307,MATH 10B,A02,084111,Staff,29,0,30,1
1649846247307,MATH 10B,A03,084112,Staff,29,0,30,1
1649846253332,MATH 10C,A01,083443,Staff,19,0,30,11
1649846253332,MATH 10C,A02,083444,Staff,24,0,30,6
1649846253332,MATH 10C,B01,084114,Staff,26,0,30,4
1649846253332,MATH 10C,B02,084115,Staff,30,0,30,0
1649846259361,MATH 18,A01,084117,Harel; Guershon,28,0,30,2
1649846259361,MATH 18,A02,084119,Harel; Guershon,29,0,30,1
1649846259361,MATH 18,A03,084120,Harel; Guershon,30,0,30,0
1649846259361,MATH 18,A04,084121,Harel; Guershon,30,0,30,0
1649846265391,MATH 20B,A01,084124,Um; Ko Woon,33,0,35,2
1649846265391,MATH 20B,B01,084126,Um; Ko Woon,35,0,35,0
1649846271417,MATH 20C,A01,083446,Hammock; Frances H,26,0,30,4
1649846271417,MATH 20C,A02,083447,Hammock; Frances H,30,0,30,0
1649846271417,MATH 20C,A03,083448,Hammock; Frances H,30,0,30,0
1649846271417,MATH 20C,A04,083449,Hammock; Frances H,30,0,30,0
1649846271417,MATH 20C,B01,083451,Hammock; Frances H,29,0,30,1
1649846271417,MATH 20C,B02,083452,Hammock; Frances H,30,0,30,0
1649846271417,MATH 20C,B03,083453,Hammock; Frances H,30,0,30,0
1649846271417,MATH 20C,B04,083454,Hammock; Frances H,30,0,30,0
1649846277442,MATH 20D,A01,084128,Staff,29,0,30,1
1649846277442,MATH 20D,A02,084129,Staff,30,0,30,0
1649846277442,MATH 20D,A03,084130,Staff,29,0,30,1
1649846277442,MATH 20D,B01,084133,Staff,28,0,30,2
1649846277442,MATH 20D,B02,084134,Staff,30,0,30,0
1649846277442,MATH 20D,B03,084135,Staff,30,0,30,0
1649846283466,MATH 20E,A01,084138,Staff,27,0,30,3
1649846283466,MATH 20E,A02,084139,Staff,29,0,30,1
1649846283466,MATH 20E,A03,084140,Staff,28,0,30,2
1649846283466,MATH 20E,A04,084141,Staff,30,0,30,0
1649846289489,MATH 102,A01,084143,Harel; Guershon,24,0,30,6
1649846289489,MATH 102,A02,084144,Harel; Guershon,25,0,30,5
1649846295513,MATH 103B,A01,083456,Staff,0,0,30,30
1649846295513,MATH 103B,A02,083457,Staff,18,0,30,12
1649846301538,MATH 109,A01,084146,Salehi Golsefidy; Alireza,30,0,30,0
1649846301538,MATH 109,A02,084147,Salehi Golsefidy; Alireza,26,0,30,4
1649846307563,MATH 120A,A01,085445,Eggers; John Dietrich,30,0,35,5
1649846307563,MATH 120A,A02,085446,Eggers; John Dietrich,31,0,35,4
1649846313587,MATH 142B,A01,084149,Verstraete; Jacques Allan,7,0,30,23
1649846313587,MATH 142B,A02,084150,Verstraete; Jacques Allan,25,0,30,5
1649846319613,MATH 170A,A01,083459,Nie; Jiawang,9,0,30,21
1649846319613,MATH 170A,A02,083460,Nie; Jiawang,25,0,30,5
1649846319613,MATH 170A,A03,083461,Nie; Jiawang,26,0,30,4
1649846325644,MATH 193B,A01,083463,Staff,15,0,30,15
1649846325644,MATH 193B,A02,083464,Staff,19,0,30,11
1649846325644,MATH 193B,A03,083465,Staff,27,0,30,3
1649846331707,COGS 2,A01,083966,Boyle; Mary E. T.,27,0,30,3
1649846337734,COGS 9,A01,083968,Staff,56,0,60,4
1649846343765,COGS 14B,A01,083970,Staff,46,0,50,4
1649846349793,COGS 17,A01,092679,Staff,73,0,75,2
1649846355815,COGS 100,A01,083972,Staff,46,0,60,14
1649846367867,COGS 101C,A01,083976,Staff,25,0,30,5
1649846373892,COGS 102A,A01,083978,Johnson; Christine M.,24,0,30,6
1649846379915,COGS 107B,A01,083980,Staff,33,0,50,17
1649846385938,COGS 115,A01,083982,Staff,21,0,30,9
1649846391968,COGS 118B,A01,083367,Staff,5,0,40,35
1649846397995,COGS 172,A01,083984,Provenzano; Emily Kara,20,0,30,10
1649846404019,COGS 177,A00,083368,Staff,3,0,30,27
1649846410047,COGS 186,A01,083986,Staff,25,0,40,15
1649846416070,COGS 187A,A01,083988,Boyle; Mary E. T.,40,0,60,20
1649846422094,CSE 8A,A50,084003,Miranda; Gregory Joseph,9,0,15,6
1649846428122,CSE 11,A01,084005,Miranda; Gregory Joseph,49,0,55,6
1649846434146,CSE 20,A01,084007,Staff,15,0,20,5
1649846440173,CSE 21,A01,084009,Staff,32,0,50,18
1649846446197,CSE 30,A01,083370,Cao; Yingjun,20,0,40,20
1649846452226,CSE 100,A01,083372,Cao; Yingjun,13,0,40,27
1649846458250,CSE 101,A01,084011,Staff,0,16,40,40
1649846464275,CSE 141,A01,083374,Eldon; John,0,13,75,75
1649846470312,CSE 141L,A01,083376,Eldon; John,0,17,75,75
1649846476344,CSE 175,A01,084013,Kumar; Rakesh,24,0,25,1
1649846482370,CSE 190,A00,092508,Staff,15,0,15,0
1649846488395,ECE 5,A01,084049,Morris; Karcher William,17,0,20,3
1649846494428,ECE 100,A01,084051,Baghdadchi; Saharnaz,16,0,20,4
1649846494428,ECE 100,A02,091916,Baghdadchi; Saharnaz,18,0,20,2
1649846500460,ECE 101,A01,084053,Baghdadchi; Saharnaz,25,0,37,12
1649846500460,ECE 101,A02,084054,Baghdadchi; Saharnaz,37,0,37,0
1649846506488,ECE 107,A01,083390,Staff,31,0,40,9
1649846512514,ECE 148,A01,084056,Silberman; Jack,8,0,12,4
1649846518538,ECE 180,A00,083391,Abi Samra; Nicholas Camill,27,0,30,3
1649846518538,ECE 180,B00,083392,Abi Samra; Nicholas Camill,26,0,30,4
1649846524568,MATH 10B,A01,084110,Staff,20,0,30,10
1649846524568,MATH 10B,A02,084111,Staff,29,0,30,1
1649846524568,MATH 10B,A03,084112,Staff,29,0,30,1
1649846530593,MATH 10C,A01,083443,Staff,19,0,30,11
1649846530593,MATH 10C,A02,083444,Staff,24,0,30,6
1649846530593,MATH 10C,B01,084114,Staff,26,0,30,4
1649846530593,MATH 10C,B02,084115,Staff,30,0,30,0
1649846536625,MATH 18,A01,084117,Harel; Guershon,28,0,30,2
1649846536625,MATH 18,A02,084119,Harel; Guershon,29,0,30,1
1649846536625,MATH 18,A03,084120,Harel; Guershon,30,0,30,0
1649846536625,MATH 18,A04,084121,Harel; Guershon,30,0,30,0
1649846542650,MATH 20B,A01,084124,Um; Ko Woon,33,0,35,2
1649846542650,MATH 20B,B01,084126,Um; Ko Woon,35,0,35,0
1649846548682,MATH 20C,A01,083446,Hammock; Frances H,26,0,30,4
1649846548682,MATH 20C,A02,083447,Hammock; Frances H,30,0,30,0
1649846548682,MATH 20C,A03,083448,Hammock; Frances H,30,0,30,0
1649846548682,MATH 20C,A04,083449,Hammock; Frances H,30,0,30,0
1649846548682,MATH 20C,B01,083451,Hammock; Frances H,29,0,30,1
1649846548682,MATH 20C,B02,083452,Hammock; Frances H,30,0,30,0
1649846548682,MATH 20C,B03,083453,Hammock; Frances H,30,0,30,0
1649846548682,MATH 20C,B04,083454,Hammock; Frances H,30,0,30,0
1649846554709,MATH 20D,A01,084128,Staff,29,0,30,1
1649846554709,MATH 20D,A02,084129,Staff,30,0,30,0
1649846554709,MATH 20D,A03,084130,Staff,29,0,30,1
1649846554709,MATH 20D,B01,084133,Staff,28,0,30,2
1649846554709,MATH 20D,B02,084134,Staff,30,0,30,0
1649846554709,MATH 20D,B03,084135,Staff,30,0,30,0
1649846560733,MATH 20E,A01,084138,Staff,27,0,30,3
1649846560733,MATH 20E,A02,084139,Staff,29,0,30,1
1649846560733,MATH 20E,A03,084140,Staff,28,0,30,2
1649846560733,MATH 20E,A04,084141,Staff,30,0,30,0
1649846566757,MATH 102,A01,084143,Harel; Guershon,24,0,30,6
1649846566757,MATH 102,A02,084144,Harel; Guershon,25,0,30,5
1649846572785,MATH 103B,A01,083456,Staff,0,0,30,30
1649846572785,MATH 103B,A02,083457,Staff,18,0,30,12
1649846578810,MATH 109,A01,084146,Salehi Golsefidy; Alireza,30,0,30,0
1649846578810,MATH 109,A02,084147,Salehi Golsefidy; Alireza,26,0,30,4
1649846584836,MATH 120A,A01,085445,Eggers; John Dietrich,30,0,35,5
1649846584836,MATH 120A,A02,085446,Eggers; John Dietrich,31,0,35,4
1649846590864,MATH 142B,A01,084149,Verstraete; Jacques Allan,7,0,30,23
1649846590864,MATH 142B,A02,084150,Verstraete; Jacques Allan,25,0,30,5
1649846596903,MATH 170A,A01,083459,Nie; Jiawang,9,0,30,21
1649846596903,MATH 170A,A02,083460,Nie; Jiawang,25,0,30,5
1649846596903,MATH 170A,A03,083461,Nie; Jiawang,26,0,30,4
1649846602932,MATH 193B,A01,083463,Staff,15,0,30,15
1649846602932,MATH 193B,A02,083464,Staff,19,0,30,11
1649846602932,MATH 193B,A03,083465,Staff,27,0,30,3
1649846608987,COGS 2,A01,083966,Boyle; Mary E. T.,27,0,30,3
1649846615014,COGS 9,A01,083968,Staff,56,0,60,4
1649846621043,COGS 14B,A01,083970,Staff,46,0,50,4
1649846627066,COGS 17,A01,092679,Staff,73,0,75,2
1649846633092,COGS 100,A01,083972,Staff,46,0,60,14
1649846645145,COGS 101C,A01,083976,Staff,25,0,30,5
1649846651168,COGS 102A,A01,083978,Johnson; Christine M.,24,0,30,6
1649846657192,COGS 107B,A01,083980,Staff,33,0,50,17
1649846663219,COGS 115,A01,083982,Staff,21,0,30,9
1649846669245,COGS 118B,A01,083367,Staff,5,0,40,35
1649846675270,COGS 172,A01,083984,Provenzano; Emily Kara,20,0,30,10
1649846681310,COGS 177,A00,083368,Staff,3,0,30,27
1649846687338,COGS 186,A01,083986,Staff,25,0,40,15
1649846693380,COGS 187A,A01,083988,Boyle; Mary E. T.,40,0,60,20
1649846699411,CSE 8A,A50,084003,Miranda; Gregory Joseph,9,0,15,6
1649846705447,CSE 11,A01,084005,Miranda; Gregory Joseph,49,0,55,6
1649846711476,CSE 20,A01,084007,Staff,15,0,20,5
1649846717504,CSE 21,A01,084009,Staff,32,0,50,18
1649846723528,CSE 30,A01,083370,Cao; Yingjun,20,0,40,20
1649846729552,CSE 100,A01,083372,Cao; Yingjun,13,0,40,27
1649846735577,CSE 101,A01,084011,Staff,0,16,40,40
1649846741610,CSE 141,A01,083374,Eldon; John,0,13,75,75
1649846747727,CSE 141L,A01,083376,Eldon; John,0,17,75,75
1649846753754,CSE 175,A01,084013,Kumar; Rakesh,24,0,25,1
1649846759785,CSE 190,A00,092508,Staff,15,0,15,0
1649846765811,ECE 5,A01,084049,Morris; Karcher William,17,0,20,3
1649846771839,ECE 100,A01,084051,Baghdadchi; Saharnaz,16,0,20,4
1649846771839,ECE 100,A02,091916,Baghdadchi; Saharnaz,18,0,20,2
1649846777863,ECE 101,A01,084053,Baghdadchi; Saharnaz,25,0,37,12
1649846777863,ECE 101,A02,084054,Baghdadchi; Saharnaz,37,0,37,0
1649846783887,ECE 107,A01,083390,Staff,31,0,40,9
1649846789913,ECE 148,A01,084056,Silberman; Jack,8,0,12,4
1649846795944,ECE 180,A00,083391,Abi Samra; Nicholas Camill,27,0,30,3
1649846795944,ECE 180,B00,083392,Abi Samra; Nicholas Camill,26,0,30,4
1649846801970,MATH 10B,A01,084110,Staff,20,0,30,10
1649846801970,MATH 10B,A02,084111,Staff,29,0,30,1
1649846801970,MATH 10B,A03,084112,Staff,29,0,30,1
1649846807999,MATH 10C,A01,083443,Staff,19,0,30,11
1649846807999,MATH 10C,A02,083444,Staff,24,0,30,6
1649846807999,MATH 10C,B01,084114,Staff,26,0,30,4
1649846807999,MATH 10C,B02,084115,Staff,30,0,30,0
1649846814028,MATH 18,A01,084117,Harel; Guershon,28,0,30,2
1649846814028,MATH 18,A02,084119,Harel; Guershon,29,0,30,1
1649846814028,MATH 18,A03,084120,Harel; Guershon,30,0,30,0
1649846814028,MATH 18,A04,084121,Harel; Guershon,30,0,30,0
1649846820053,MATH 20B,A01,084124,Um; Ko Woon,33,0,35,2
1649846820053,MATH 20B,B01,084126,Um; Ko Woon,35,0,35,0
1649846826084,MATH 20C,A01,083446,Hammock; Frances H,26,0,30,4
1649846826084,MATH 20C,A02,083447,Hammock; Frances H,30,0,30,0
1649846826084,MATH 20C,A03,083448,Hammock; Frances H,30,0,30,0
1649846826084,MATH 20C,A04,083449,Hammock; Frances H,30,0,30,0
1649846826084,MATH 20C,B01,083451,Hammock; Frances H,29,0,30,1
1649846826084,MATH 20C,B02,083452,Hammock; Frances H,30,0,30,0
1649846826084,MATH 20C,B03,083453,Hammock; Frances H,30,0,30,0
1649846826084,MATH 20C,B04,083454,Hammock; Frances H,30,0,30,0
1649846832108,MATH 20D,A01,084128,Staff,29,0,30,1
1649846832108,MATH 20D,A02,084129,Staff,30,0,30,0
1649846832108,MATH 20D,A03,084130,Staff,29,0,30,1
1649846832108,MATH 20D,B01,084133,Staff,28,0,30,2
1649846832108,MATH 20D,B02,084134,Staff,30,0,30,0
1649846832108,MATH 20D,B03,084135,Staff,30,0,30,0
1649846838135,MATH 20E,A01,084138,Staff,27,0,30,3
1649846838135,MATH 20E,A02,084139,Staff,29,0,30,1
1649846838135,MATH 20E,A03,084140,Staff,28,0,30,2
1649846838135,MATH 20E,A04,084141,Staff,30,0,30,0
1649846844158,MATH 102,A01,084143,Harel; Guershon,24,0,30,6
1649846844158,MATH 102,A02,084144,Harel; Guershon,25,0,30,5
1649846850184,MATH 103B,A01,083456,Staff,0,0,30,30
1649846850184,MATH 103B,A02,083457,Staff,18,0,30,12
1649846856208,MATH 109,A01,084146,Salehi Golsefidy; Alireza,30,0,30,0
1649846856208,MATH 109,A02,084147,Salehi Golsefidy; Alireza,26,0,30,4
1649846862236,MATH 120A,A01,085445,Eggers; John Dietrich,30,0,35,5
1649846862236,MATH 120A,A02,085446,Eggers; John Dietrich,31,0,35,4
1649846868265,MATH 142B,A01,084149,Verstraete; Jacques Allan,7,0,30,23
1649846868265,MATH 142B,A02,084150,Verstraete; Jacques Allan,25,0,30,5
1649846874289,MATH 170A,A01,083459,Nie; Jiawang,9,0,30,21
1649846874289,MATH 170A,A02,083460,Nie; Jiawang,25,0,30,5
1649846874289,MATH 170A,A03,083461,Nie; Jiawang,26,0,30,4
1649846880314,MATH 193B,A01,083463,Staff,15,0,30,15
1649846880314,MATH 193B,A02,083464,Staff,19,0,30,11
1649846880314,MATH 193B,A03,083465,Staff,27,0,30,3
1649846886364,COGS 2,A01,083966,Boyle; Mary E. T.,27,0,30,3
1649846892388,COGS 9,A01,083968,Staff,56,0,60,4
1649846898417,COGS 14B,A01,083970,Staff,46,0,50,4
1649846904443,COGS 17,A01,092679,Staff,73,0,75,2
1649846910480,COGS 100,A01,083972,Staff,46,0,60,14
1649846922541,COGS 101C,A01,083976,Staff,25,0,30,5
1649846928566,COGS 102A,A01,083978,Johnson; Christine M.,24,0,30,6
1649846934591,COGS 107B,A01,083980,Staff,33,0,50,17
1649846940622,COGS 115,A01,083982,Staff,21,0,30,9
1649846946647,COGS 118B,A01,083367,Staff,5,0,40,35
1649846952672,COGS 172,A01,083984,Provenzano; Emily Kara,20,0,30,10
1649846958699,COGS 177,A00,083368,Staff,3,0,30,27
1649846964726,COGS 186,A01,083986,Staff,25,0,40,15
1649846970753,COGS 187A,A01,083988,Boyle; Mary E. T.,40,0,60,20
1649846976778,CSE 8A,A50,084003,Miranda; Gregory Joseph,9,0,15,6
1649846982804,CSE 11,A01,084005,Miranda; Gregory Joseph,49,0,55,6
1649846988827,CSE 20,A01,084007,Staff,15,0,20,5
1649846994851,CSE 21,A01,084009,Staff,32,0,50,18
1649847000876,CSE 30,A01,083370,Cao; Yingjun,20,0,40,20
1649847006903,CSE 100,A01,083372,Cao; Yingjun,13,0,40,27
1649847012931,CSE 101,A01,084011,Staff,0,16,40,40
1649847018960,CSE 141,A01,083374,Eldon; John,0,13,75,75
1649847024986,CSE 141L,A01,083376,Eldon; John,0,17,75,75
1649847031012,CSE 175,A01,084013,Kumar; Rakesh,24,0,25,1
1649847037038,CSE 190,A00,092508,Staff,15,0,15,0
1649847043069,ECE 5,A01,084049,Morris; Karcher William,17,0,20,3
1649847049101,ECE 100,A01,084051,Baghdadchi; Saharnaz,16,0,20,4
1649847049101,ECE 100,A02,091916,Baghdadchi; Saharnaz,18,0,20,2
1649847055126,ECE 101,A01,084053,Baghdadchi; Saharnaz,25,0,37,12
1649847055126,ECE 101,A02,084054,Baghdadchi; Saharnaz,37,0,37,0
1649847061149,ECE 107,A01,083390,Staff,31,0,40,9
1649847067175,ECE 148,A01,084056,Silberman; Jack,8,0,12,4
1649847073199,ECE 180,A00,083391,Abi Samra; Nicholas Camill,27,0,30,3
1649847073199,ECE 180,B00,083392,Abi Samra; Nicholas Camill,26,0,30,4
1649847079224,MATH 10B,A01,084110,Staff,20,0,30,10
1649847079224,MATH 10B,A02,084111,Staff,29,0,30,1
1649847079224,MATH 10B,A03,084112,Staff,29,0,30,1
1649847085254,MATH 10C,A01,083443,Staff,19,0,30,11
1649847085254,MATH 10C,A02,083444,Staff,24,0,30,6
1649847085254,MATH 10C,B01,084114,Staff,26,0,30,4
1649847085254,MATH 10C,B02,084115,Staff,30,0,30,0
1649847091287,MATH 18,A01,084117,Harel; Guershon,28,0,30,2
1649847091287,MATH 18,A02,084119,Harel; Guershon,29,0,30,1
1649847091287,MATH 18,A03,084120,Harel; Guershon,30,0,30,0
1649847091287,MATH 18,A04,084121,Harel; Guershon,30,0,30,0
1649847097313,MATH 20B,A01,084124,Um; Ko Woon,33,0,35,2
1649847097313,MATH 20B,B01,084126,Um; Ko Woon,35,0,35,0
1649847103340,MATH 20C,A01,083446,Hammock; Frances H,26,0,30,4
1649847103340,MATH 20C,A02,083447,Hammock; Frances H,30,0,30,0
1649847103340,MATH 20C,A03,083448,Hammock; Frances H,30,0,30,0
1649847103340,MATH 20C,A04,083449,Hammock; Frances H,30,0,30,0
1649847103340,MATH 20C,B01,083451,Hammock; Frances H,29,0,30,1
1649847103340,MATH 20C,B02,083452,Hammock; Frances H,30,0,30,0
1649847103340,MATH 20C,B03,083453,Hammock; Frances H,30,0,30,0
1649847103340,MATH 20C,B04,083454,Hammock; Frances H,30,0,30,0
1649847109365,MATH 20D,A01,084128,Staff,29,0,30,1
1649847109365,MATH 20D,A02,084129,Staff,30,0,30,0
1649847109365,MATH 20D,A03,084130,Staff,29,0,30,1
1649847109365,MATH 20D,B01,084133,Staff,28,0,30,2
1649847109365,MATH 20D,B02,084134,Staff,30,0,30,0
1649847109365,MATH 20D,B03,084135,Staff,30,0,30,0
1649847115390,MATH 20E,A01,084138,Staff,27,0,30,3
1649847115390,MATH 20E,A02,084139,Staff,29,0,30,1
1649847115390,MATH 20E,A03,084140,Staff,28,0,30,2
1649847115390,MATH 20E,A04,084141,Staff,30,0,30,0
1649847121416,MATH 102,A01,084143,Harel; Guershon,24,0,30,6
1649847121416,MATH 102,A02,084144,Harel; Guershon,25,0,30,5
1649847127441,MATH 103B,A01,083456,Staff,0,0,30,30
1649847127441,MATH 103B,A02,083457,Staff,18,0,30,12
1649847133470,MATH 109,A01,084146,Salehi Golsefidy; Alireza,30,0,30,0
1649847133470,MATH 109,A02,084147,Salehi Golsefidy; Alireza,26,0,30,4
1649847139495,MATH 120A,A01,085445,Eggers; John Dietrich,30,0,35,5
1649847139495,MATH 120A,A02,085446,Eggers; John Dietrich,31,0,35,4
1649847145524,MATH 142B,A01,084149,Verstraete; Jacques Allan,7,0,30,23
1649847145524,MATH 142B,A02,084150,Verstraete; Jacques Allan,25,0,30,5
1649847151550,MATH 170A,A01,083459,Nie; Jiawang,9,0,30,21
1649847151550,MATH 170A,A02,083460,Nie; Jiawang,25,0,30,5
1649847151550,MATH 170A,A03,083461,Nie; Jiawang,26,0,30,4
1649847157576,MATH 193B,A01,083463,Staff,15,0,30,15
1649847157576,MATH 193B,A02,083464,Staff,19,0,30,11
1649847157576,MATH 193B,A03,083465,Staff,27,0,30,3
1649847163640,COGS 2,A01,083966,Boyle; Mary E. T.,27,0,30,3
1649847169662,COGS 9,A01,083968,Staff,56,0,60,4
1649847175686,COGS 14B,A01,083970,Staff,46,0,50,4
1649847181715,COGS 17,A01,092679,Staff,73,0,75,2
1649847187737,COGS 100,A01,083972,Staff,46,0,60,14
1649847199795,COGS 101C,A01,083976,Staff,25,0,30,5
1649847205820,COGS 102A,A01,083978,Johnson; Christine M.,24,0,30,6
1649847211844,COGS 107B,A01,083980,Staff,33,0,50,17
1649847217872,COGS 115,A01,083982,Staff,21,0,30,9
1649847223896,COGS 118B,A01,083367,Staff,5,0,40,35
1649847229929,COGS 172,A01,083984,Provenzano; Emily Kara,20,0,30,10
1649847235957,COGS 177,A00,083368,Staff,3,0,30,27
1649847241985,COGS 186,A01,083986,Staff,25,0,40,15
1649847248014,COGS 187A,A01,083988,Boyle; Mary E. T.,40,0,60,20
1649847254046,CSE 8A,A50,084003,Miranda; Gregory Joseph,9,0,15,6
1649847260070,CSE 11,A01,084005,Miranda; Gregory Joseph,49,0,55,6
1649847266099,CSE 20,A01,084007,Staff,15,0,20,5
1649847272124,CSE 21,A01,084009,Staff,32,0,50,18
1649847278150,CSE 30,A01,083370,Cao; Yingjun,20,0,40,20
1649847284179,CSE 100,A01,083372,Cao; Yingjun,13,0,40,27
1649847290205,CSE 101,A01,084011,Staff,0,16,40,40
1649847296234,CSE 141,A01,083374,Eldon; John,0,13,75,75
1649847302261,CSE 141L,A01,083376,Eldon; John,0,17,75,75
1649847308285,CSE 175,A01,084013,Kumar; Rakesh,24,0,25,1
1649847314313,CSE 190,A00,092508,Staff,15,0,15,0
1649847320340,ECE 5,A01,084049,Morris; Karcher William,17,0,20,3
1649847326372,ECE 100,A01,084051,Baghdadchi; Saharnaz,16,0,20,4
1649847326372,ECE 100,A02,091916,Baghdadchi; Saharnaz,18,0,20,2
1649847332396,ECE 101,A01,084053,Baghdadchi; Saharnaz,25,0,37,12
1649847332396,ECE 101,A02,084054,Baghdadchi; Saharnaz,37,0,37,0
1649847338423,ECE 107,A01,083390,Staff,31,0,40,9
1649847344539,ECE 148,A01,084056,Silberman; Jack,8,0,12,4
1649847350563,ECE 180,A00,083391,Abi Samra; Nicholas Camill,27,0,30,3
1649847350563,ECE 180,B00,083392,Abi Samra; Nicholas Camill,26,0,30,4
1649847356587,MATH 10B,A01,084110,Staff,20,0,30,10
1649847356587,MATH 10B,A02,084111,Staff,29,0,30,1
1649847356587,MATH 10B,A03,084112,Staff,29,0,30,1
1649847362611,MATH 10C,A01,083443,Staff,19,0,30,11
1649847362611,MATH 10C,A02,083444,Staff,24,0,30,6
1649847362611,MATH 10C,B01,084114,Staff,26,0,30,4
1649847362611,MATH 10C,B02,084115,Staff,30,0,30,0
1649847368638,MATH 18,A01,084117,Harel; Guershon,28,0,30,2
1649847368638,MATH 18,A02,084119,Harel; Guershon,29,0,30,1
1649847368638,MATH 18,A03,084120,Harel; Guershon,30,0,30,0
1649847368638,MATH 18,A04,084121,Harel; Guershon,30,0,30,0
1649847374668,MATH 20B,A01,084124,Um; Ko Woon,33,0,35,2
1649847374668,MATH 20B,B01,084126,Um; Ko Woon,35,0,35,0
1649847380700,MATH 20C,A01,083446,Hammock; Frances H,26,0,30,4
1649847380700,MATH 20C,A02,083447,Hammock; Frances H,30,0,30,0
1649847380700,MATH 20C,A03,083448,Hammock; Frances H,30,0,30,0
1649847380700,MATH 20C,A04,083449,Hammock; Frances H,30,0,30,0
1649847380700,MATH 20C,B01,083451,Hammock; Frances H,29,0,30,1
1649847380700,MATH 20C,B02,083452,Hammock; Frances H,30,0,30,0
1649847380700,MATH 20C,B03,083453,Hammock; Frances H,30,0,30,0
1649847380700,MATH 20C,B04,083454,Hammock; Frances H,30,0,30,0
1649847386730,MATH 20D,A01,084128,Staff,29,0,30,1
1649847386730,MATH 20D,A02,084129,Staff,30,0,30,0
1649847386730,MATH 20D,A03,084130,Staff,29,0,30,1
1649847386730,MATH 20D,B01,084133,Staff,28,0,30,2
1649847386730,MATH 20D,B02,084134,Staff,30,0,30,0
1649847386730,MATH 20D,B03,084135,Staff,30,0,30,0
1649847392759,MATH 20E,A01,084138,Staff,27,0,30,3
1649847392759,MATH 20E,A02,084139,Staff,29,0,30,1
1649847392759,MATH 20E,A03,084140,Staff,28,0,30,2
1649847392759,MATH 20E,A04,084141,Staff,30,0,30,0
1649847398785,MATH 102,A01,084143,Harel; Guershon,24,0,30,6
1649847398785,MATH 102,A02,084144,Harel; Guershon,25,0,30,5
1649847404824,MATH 103B,A01,083456,Staff,0,0,30,30
1649847404824,MATH 103B,A02,083457,Staff,18,0,30,12
1649847410850,MATH 109,A01,084146,Salehi Golsefidy; Alireza,30,0,30,0
1649847410850,MATH 109,A02,084147,Salehi Golsefidy; Alireza,26,0,30,4
1649847416880,MATH 120A,A01,085445,Eggers; John Dietrich,30,0,35,5
1649847416880,MATH 120A,A02,085446,Eggers; John Dietrich,31,0,35,4
1649847422912,MATH 142B,A01,084149,Verstraete; Jacques Allan,7,0,30,23
1649847422912,MATH 142B,A02,084150,Verstraete; Jacques Allan,25,0,30,5
1649847428943,MATH 170A,A01,083459,Nie; Jiawang,9,0,30,21
1649847428943,MATH 170A,A02,083460,Nie; Jiawang,25,0,30,5
1649847428943,MATH 170A,A03,083461,Nie; Jiawang,26,0,30,4
1649847434965,MATH 193B,A01,083463,Staff,15,0,30,15
1649847434965,MATH 193B,A02,083464,Staff,19,0,30,11
1649847434965,MATH 193B,A03,083465,Staff,27,0,30,3
1649847441023,COGS 2,A01,083966,Boyle; Mary E. T.,27,0,30,3
1649847447045,COGS 9,A01,083968,Staff,56,0,60,4
1649847453069,COGS 14B,A01,083970,Staff,46,0,50,4
1649847459105,COGS 17,A01,092679,Staff,73,0,75,2
1649847465130,COGS 100,A01,083972,Staff,46,0,60,14
1649847477182,COGS 101C,A01,083976,Staff,25,0,30,5
1649847483207,COGS 102A,A01,083978,Johnson; Christine M.,24,0,30,6
1649847489231,COGS 107B,A01,083980,Staff,33,0,50,17
1649847495255,COGS 115,A01,083982,Staff,21,0,30,9
1649847501284,COGS 118B,A01,083367,Staff,5,0,40,35
1649847507312,COGS 172,A01,083984,Provenzano; Emily Kara,20,0,30,10
1649847513337,COGS 177,A00,083368,Staff,3,0,30,27
1649847519365,COGS 186,A01,083986,Staff,25,0,40,15
1649847525393,COGS 187A,A01,083988,Boyle; Mary E. T.,40,0,60,20
1649847531420,CSE 8A,A50,084003,Miranda; Gregory Joseph,9,0,15,6
1649847537444,CSE 11,A01,084005,Miranda; Gregory Joseph,49,0,55,6
1649847543469,CSE 20,A01,084007,Staff,15,0,20,5
1649847549493,CSE 21,A01,084009,Staff,32,0,50,18
1649847555521,CSE 30,A01,083370,Cao; Yingjun,20,0,40,20
1649847561547,CSE 100,A01,083372,Cao; Yingjun,13,0,40,27
1649847567572,CSE 101,A01,084011,Staff,0,16,40,40
1649847573604,CSE 141,A01,083374,Eldon; John,0,13,75,75
1649847579632,CSE 141L,A01,083376,Eldon; John,0,17,75,75
1649847585660,CSE 175,A01,084013,Kumar; Rakesh,24,0,25,1
1649847591688,CSE 190,A00,092508,Staff,15,0,15,0
1649847597713,ECE 5,A01,084049,Morris; Karcher William,17,0,20,3
1649847603741,ECE 100,A01,084051,Baghdadchi; Saharnaz,16,0,20,4
1649847603741,ECE 100,A02,091916,Baghdadchi; Saharnaz,18,0,20,2
1649847609771,ECE 101,A01,084053,Baghdadchi; Saharnaz,25,0,37,12
1649847609771,ECE 101,A02,084054,Baghdadchi; Saharnaz,37,0,37,0
1649847615798,ECE 107,A01,083390,Staff,31,0,40,9
1649847621822,ECE 148,A01,084056,Silberman; Jack,8,0,12,4
1649847627853,ECE 180,A00,083391,Abi Samra; Nicholas Camill,27,0,30,3
1649847627853,ECE 180,B00,083392,Abi Samra; Nicholas Camill,26,0,30,4
1649847633880,MATH 10B,A01,084110,Staff,20,0,30,10
1649847633880,MATH 10B,A02,084111,Staff,29,0,30,1
1649847633880,MATH 10B,A03,084112,Staff,29,0,30,1
1649847639904,MATH 10C,A01,083443,Staff,19,0,30,11
1649847639904,MATH 10C,A02,083444,Staff,24,0,30,6
1649847639904,MATH 10C,B01,084114,Staff,26,0,30,4
1649847639904,MATH 10C,B02,084115,Staff,30,0,30,0
1649847645938,MATH 18,A01,084117,Harel; Guershon,28,0,30,2
1649847645938,MATH 18,A02,084119,Harel; Guershon,29,0,30,1
1649847645938,MATH 18,A03,084120,Harel; Guershon,30,0,30,0
1649847645938,MATH 18,A04,084121,Harel; Guershon,30,0,30,0
1649847651971,MATH 20B,A01,084124,Um; Ko Woon,33,0,35,2
1649847651971,MATH 20B,B01,084126,Um; Ko Woon,35,0,35,0
1649847658072,MATH 20C,A01,083446,Hammock; Frances H,26,0,30,4
1649847658072,MATH 20C,A02,083447,Hammock; Frances H,30,0,30,0
1649847658072,MATH 20C,A03,083448,Hammock; Frances H,30,0,30,0
1649847658072,MATH 20C,A04,083449,Hammock; Frances H,30,0,30,0
1649847658072,MATH 20C,B01,083451,Hammock; Frances H,29,0,30,1
1649847658072,MATH 20C,B02,083452,Hammock; Frances H,30,0,30,0
1649847658072,MATH 20C,B03,083453,Hammock; Frances H,30,0,30,0
1649847658072,MATH 20C,B04,083454,Hammock; Frances H,30,0,30,0
1649847664098,MATH 20D,A01,084128,Staff,29,0,30,1
1649847664098,MATH 20D,A02,084129,Staff,30,0,30,0
1649847664098,MATH 20D,A03,084130,Staff,29,0,30,1
1649847664098,MATH 20D,B01,084133,Staff,28,0,30,2
1649847664098,MATH 20D,B02,084134,Staff,30,0,30,0
1649847664098,MATH 20D,B03,084135,Staff,30,0,30,0
1649847670128,MATH 20E,A01,084138,Staff,27,0,30,3
1649847670128,MATH 20E,A02,084139,Staff,29,0,30,1
1649847670128,MATH 20E,A03,084140,Staff,28,0,30,2
1649847670128,MATH 20E,A04,084141,Staff,30,0,30,0
1649847676153,MATH 102,A01,084143,Harel; Guershon,24,0,30,6
1649847676153,MATH 102,A02,084144,Harel; Guershon,25,0,30,5
1649847682177,MATH 103B,A01,083456,Staff,0,0,30,30
1649847682177,MATH 103B,A02,083457,Staff,18,0,30,12
1649847688216,MATH 109,A01,084146,Salehi Golsefidy; Alireza,30,0,30,0
1649847688216,MATH 109,A02,084147,Salehi Golsefidy; Alireza,26,0,30,4
1649847694246,MATH 120A,A01,085445,Eggers; John Dietrich,30,0,35,5
1649847694246,MATH 120A,A02,085446,Eggers; John Dietrich,31,0,35,4
1649847700272,MATH 142B,A01,084149,Verstraete; Jacques Allan,7,0,30,23
1649847700272,MATH 142B,A02,084150,Verstraete; Jacques Allan,25,0,30,5
1649847706302,MATH 170A,A01,083459,Nie; Jiawang,9,0,30,21
1649847706302,MATH 170A,A02,083460,Nie; Jiawang,25,0,30,5
1649847706302,MATH 170A,A03,083461,Nie; Jiawang,26,0,30,4
1649847712325,MATH 193B,A01,083463,Staff,15,0,30,15
1649847712325,MATH 193B,A02,083464,Staff,19,0,30,11
1649847712325,MATH 193B,A03,083465,Staff,27,0,30,3
1649847718408,COGS 2,A01,083966,Boyle; Mary E. T.,27,0,30,3
1649847724432,COGS 9,A01,083968,Staff,56,0,60,4
1649847730459,COGS 14B,A01,083970,Staff,45,0,50,5
1649847736483,COGS 17,A01,092679,Staff,73,0,75,2
1649847742512,COGS 100,A01,083972,Staff,46,0,60,14
1649847754563,COGS 101C,A01,083976,Staff,25,0,30,5
1649847760588,COGS 102A,A01,083978,Johnson; Christine M.,24,0,30,6
1649847766615,COGS 107B,A01,083980,Staff,32,0,50,18
1649847772642,COGS 115,A01,083982,Staff,21,0,30,9
1649847778666,COGS 118B,A01,083367,Staff,5,0,40,35
1649847784699,COGS 172,A01,083984,Provenzano; Emily Kara,20,0,30,10
1649847790723,COGS 177,A00,083368,Staff,3,0,30,27
1649847796747,COGS 186,A01,083986,Staff,25,0,40,15
1649847802776,COGS 187A,A01,083988,Boyle; Mary E. T.,40,0,60,20
1649847808803,CSE 8A,A50,084003,Miranda; Gregory Joseph,9,0,15,6
1649847814828,CSE 11,A01,084005,Miranda; Gregory Joseph,49,0,55,6
1649847820853,CSE 20,A01,084007,Staff,15,0,20,5
1649847826882,CSE 21,A01,084009,Staff,32,0,50,18
1649847832906,CSE 30,A01,083370,Cao; Yingjun,20,0,40,20
1649847838928,CSE 100,A01,083372,Cao; Yingjun,13,0,40,27
1649847844951,CSE 101,A01,084011,Staff,0,16,40,40
1649847850977,CSE 141,A01,083374,Eldon; John,0,13,75,75
1649847857001,CSE 141L,A01,083376,Eldon; John,0,17,75,75
1649847863030,CSE 175,A01,084013,Kumar; Rakesh,24,0,25,1
1649847869056,CSE 190,A00,092508,Staff,15,0,15,0
1649847875083,ECE 5,A01,084049,Morris; Karcher William,17,0,20,3
1649847881110,ECE 100,A01,084051,Baghdadchi; Saharnaz,16,0,20,4
1649847881110,ECE 100,A02,091916,Baghdadchi; Saharnaz,18,0,20,2
1649847887134,ECE 101,A01,084053,Baghdadchi; Saharnaz,25,0,37,12
1649847887134,ECE 101,A02,084054,Baghdadchi; Saharnaz,37,0,37,0
1649847893236,ECE 107,A01,083390,Staff,31,0,40,9
1649847899272,ECE 148,A01,084056,Silberman; Jack,8,0,12,4
1649847905305,ECE 180,A00,083391,Abi Samra; Nicholas Camill,27,0,30,3
1649847905305,ECE 180,B00,083392,Abi Samra; Nicholas Camill,26,0,30,4
1649847911333,MATH 10B,A01,084110,Staff,20,0,30,10
1649847911333,MATH 10B,A02,084111,Staff,29,0,30,1
1649847911333,MATH 10B,A03,084112,Staff,29,0,30,1
1649847917365,MATH 10C,A01,083443,Staff,19,0,30,11
1649847917365,MATH 10C,A02,083444,Staff,24,0,30,6
1649847917365,MATH 10C,B01,084114,Staff,26,0,30,4
1649847917365,MATH 10C,B02,084115,Staff,30,0,30,0
1649847923411,MATH 18,A01,084117,Harel; Guershon,28,0,30,2
1649847923411,MATH 18,A02,084119,Harel; Guershon,29,0,30,1
1649847923411,MATH 18,A03,084120,Harel; Guershon,30,0,30,0
1649847923411,MATH 18,A04,084121,Harel; Guershon,30,0,30,0
1649847929437,MATH 20B,A01,084124,Um; Ko Woon,33,0,35,2
1649847929437,MATH 20B,B01,084126,Um; Ko Woon,35,0,35,0
1649847935469,MATH 20C,A01,083446,Hammock; Frances H,26,0,30,4
1649847935469,MATH 20C,A02,083447,Hammock; Frances H,30,0,30,0
1649847935469,MATH 20C,A03,083448,Hammock; Frances H,30,0,30,0
1649847935469,MATH 20C,A04,083449,Hammock; Frances H,30,0,30,0
1649847935469,MATH 20C,B01,083451,Hammock; Frances H,29,0,30,1
1649847935469,MATH 20C,B02,083452,Hammock; Frances H,30,0,30,0
1649847935469,MATH 20C,B03,083453,Hammock; Frances H,30,0,30,0
1649847935469,MATH 20C,B04,083454,Hammock; Frances H,30,0,30,0
1649847941497,MATH 20D,A01,084128,Staff,29,0,30,1
1649847941497,MATH 20D,A02,084129,Staff,30,0,30,0
1649847941497,MATH 20D,A03,084130,Staff,29,0,30,1
1649847941497,MATH 20D,B01,084133,Staff,28,0,30,2
1649847941497,MATH 20D,B02,084134,Staff,30,0,30,0
1649847941497,MATH 20D,B03,084135,Staff,30,0,30,0
1649847947521,MATH 20E,A01,084138,Staff,27,0,30,3
1649847947521,MATH 20E,A02,084139,Staff,29,0,30,1
1649847947521,MATH 20E,A03,084140,Staff,28,0,30,2
1649847947521,MATH 20E,A04,084141,Staff,30,0,30,0
1649847953547,MATH 102,A01,084143,Harel; Guershon,24,0,30,6
1649847953547,MATH 102,A02,084144,Harel; Guershon,25,0,30,5
1649847959571,MATH 103B,A01,083456,Staff,0,0,30,30
1649847959571,MATH 103B,A02,083457,Staff,18,0,30,12
1649847965614,MATH 109,A01,084146,Salehi Golsefidy; Alireza,30,0,30,0
1649847965614,MATH 109,A02,084147,Salehi Golsefidy; Alireza,26,0,30,4
1649847971641,MATH 120A,A01,085445,Eggers; John Dietrich,30,0,35,5
1649847971641,MATH 120A,A02,085446,Eggers; John Dietrich,31,0,35,4
1649847977664,MATH 142B,A01,084149,Verstraete; Jacques Allan,7,0,30,23
1649847977664,MATH 142B,A02,084150,Verstraete; Jacques Allan,25,0,30,5
1649847983696,MATH 170A,A01,083459,Nie; Jiawang,9,0,30,21
1649847983696,MATH 170A,A02,083460,Nie; Jiawang,25,0,30,5
1649847983696,MATH 170A,A03,083461,Nie; Jiawang,26,0,30,4
1649847989721,MATH 193B,A01,083463,Staff,15,0,30,15
1649847989721,MATH 193B,A02,083464,Staff,19,0,30,11
1649847989721,MATH 193B,A03,083465,Staff,27,0,30,3
1649847995784,COGS 2,A01,083966,Boyle; Mary E. T.,27,0,30,3
1649848001812,COGS 9,A01,083968,Staff,56,0,60,4
1649848007833,COGS 14B,A01,083970,Staff,46,0,50,4
1649848013858,COGS 17,A01,092679,Staff,73,0,75,2
1649848019880,COGS 100,A01,083972,Staff,46,0,60,14
1649848031931,COGS 101C,A01,083976,Staff,25,0,30,5
1649848037959,COGS 102A,A01,083978,Johnson; Christine M.,24,0,30,6
1649848043987,COGS 107B,A01,083980,Staff,32,0,50,18
1649848050014,COGS 115,A01,083982,Staff,21,0,30,9
1649848056043,COGS 118B,A01,083367,Staff,5,0,40,35
1649848062069,COGS 172,A01,083984,Provenzano; Emily Kara,20,0,30,10
1649848068092,COGS 177,A00,083368,Staff,3,0,30,27
1649848074122,COGS 186,A01,083986,Staff,25,0,40,15
1649848080145,COGS 187A,A01,083988,Boyle; Mary E. T.,40,0,60,20
1649848086181,CSE 8A,A50,084003,Miranda; Gregory Joseph,9,0,15,6
1649848092209,CSE 11,A01,084005,Miranda; Gregory Joseph,49,0,55,6
1649848098249,CSE 20,A01,084007,Staff,15,0,20,5
1649848104283,CSE 21,A01,084009,Staff,32,0,50,18
1649848110309,CSE 30,A01,083370,Cao; Yingjun,20,0,40,20
1649848116332,CSE 100,A01,083372,Cao; Yingjun,13,0,40,27
1649848122361,CSE 101,A01,084011,Staff,0,16,40,40
1649848128386,CSE 141,A01,083374,Eldon; John,0,13,75,75
1649848134409,CSE 141L,A01,083376,Eldon; John,0,17,75,75
1649848140436,CSE 175,A01,084013,Kumar; Rakesh,24,0,25,1
1649848146465,CSE 190,A00,092508,Staff,15,0,15,0
1649848152497,ECE 5,A01,084049,Morris; Karcher William,17,0,20,3
1649848158524,ECE 100,A01,084051,Baghdadchi; Saharnaz,16,0,20,4
1649848158524,ECE 100,A02,091916,Baghdadchi; Saharnaz,18,0,20,2
1649848164549,ECE 101,A01,084053,Baghdadchi; Saharnaz,25,0,37,12
1649848164549,ECE 101,A02,084054,Baghdadchi; Saharnaz,37,0,37,0
1649848170575,ECE 107,A01,083390,Staff,31,0,40,9
1649848176599,ECE 148,A01,084056,Silberman; Jack,8,0,12,4
1649848182629,ECE 180,A00,083391,Abi Samra; Nicholas Camill,27,0,30,3
1649848182629,ECE 180,B00,083392,Abi Samra; Nicholas Camill,26,0,30,4
1649848188659,MATH 10B,A01,084110,Staff,20,0,30,10
1649848188659,MATH 10B,A02,084111,Staff,29,0,30,1
1649848188659,MATH 10B,A03,084112,Staff,29,0,30,1
1649848194682,MATH 10C,A01,083443,Staff,19,0,30,11
1649848194682,MATH 10C,A02,083444,Staff,24,0,30,6
1649848194682,MATH 10C,B01,084114,Staff,26,0,30,4
1649848194682,MATH 10C,B02,084115,Staff,30,0,30,0
1649848200712,MATH 18,A01,084117,Harel; Guershon,28,0,30,2
1649848200712,MATH 18,A02,084119,Harel; Guershon,29,0,30,1
1649848200712,MATH 18,A03,084120,Harel; Guershon,30,0,30,0
1649848200712,MATH 18,A04,084121,Harel; Guershon,30,0,30,0
1649848206749,MATH 20B,A01,084124,Um; Ko Woon,33,0,35,2
1649848206749,MATH 20B,B01,084126,Um; Ko Woon,35,0,35,0
1649848212784,MATH 20C,A01,083446,Hammock; Frances H,26,0,30,4
1649848212784,MATH 20C,A02,083447,Hammock; Frances H,30,0,30,0
1649848212784,MATH 20C,A03,083448,Hammock; Frances H,30,0,30,0
1649848212784,MATH 20C,A04,083449,Hammock; Frances H,30,0,30,0
1649848212784,MATH 20C,B01,083451,Hammock; Frances H,29,0,30,1
1649848212784,MATH 20C,B02,083452,Hammock; Frances H,30,0,30,0
1649848212784,MATH 20C,B03,083453,Hammock; Frances H,30,0,30,0
1649848212784,MATH 20C,B04,083454,Hammock; Frances H,30,0,30,0
1649848218810,MATH 20D,A01,084128,Staff,29,0,30,1
1649848218810,MATH 20D,A02,084129,Staff,30,0,30,0
1649848218810,MATH 20D,A03,084130,Staff,29,0,30,1
1649848218810,MATH 20D,B01,084133,Staff,28,0,30,2
1649848218810,MATH 20D,B02,084134,Staff,30,0,30,0
1649848218810,MATH 20D,B03,084135,Staff,30,0,30,0
1649848224840,MATH 20E,A01,084138,Staff,27,0,30,3
1649848224840,MATH 20E,A02,084139,Staff,29,0,30,1
1649848224840,MATH 20E,A03,084140,Staff,28,0,30,2
1649848224840,MATH 20E,A04,084141,Staff,30,0,30,0
1649848230864,MATH 102,A01,084143,Harel; Guershon,24,0,30,6
1649848230864,MATH 102,A02,084144,Harel; Guershon,25,0,30,5
1649848236894,MATH 103B,A01,083456,Staff,0,0,30,30
1649848236894,MATH 103B,A02,083457,Staff,18,0,30,12
1649848242923,MATH 109,A01,084146,Salehi Golsefidy; Alireza,30,0,30,0
1649848242923,MATH 109,A02,084147,Salehi Golsefidy; Alireza,26,0,30,4
1649848248950,MATH 120A,A01,085445,Eggers; John Dietrich,30,0,35,5
1649848248950,MATH 120A,A02,085446,Eggers; John Dietrich,31,0,35,4
1649848254980,MATH 142B,A01,084149,Verstraete; Jacques Allan,7,0,30,23
1649848254980,MATH 142B,A02,084150,Verstraete; Jacques Allan,25,0,30,5
1649848261006,MATH 170A,A01,083459,Nie; Jiawang,9,0,30,21
1649848261006,MATH 170A,A02,083460,Nie; Jiawang,25,0,30,5
1649848261006,MATH 170A,A03,083461,Nie; Jiawang,26,0,30,4
1649848267031,MATH 193B,A01,083463,Staff,15,0,30,15
1649848267031,MATH 193B,A02,083464,Staff,19,0,30,11
1649848267031,MATH 193B,A03,083465,Staff,27,0,30,3
1649848273113,COGS 2,A01,083966,Boyle; Mary E. T.,27,0,30,3
1649848279140,COGS 9,A01,083968,Staff,56,0,60,4
1649848285171,COGS 14B,A01,083970,Staff,46,0,50,4
1649848291204,COGS 17,A01,092679,Staff,73,0,75,2
1649848297234,COGS 100,A01,083972,Staff,46,0,60,14
1649848309291,COGS 101C,A01,083976,Staff,25,0,30,5
1649848315319,COGS 102A,A01,083978,Johnson; Christine M.,24,0,30,6
1649848321360,COGS 107B,A01,083980,Staff,32,0,50,18
1649848327384,COGS 115,A01,083982,Staff,21,0,30,9
1649848333414,COGS 118B,A01,083367,Staff,5,0,40,35
1649848339438,COGS 172,A01,083984,Provenzano; Emily Kara,20,0,30,10
1649848345462,COGS 177,A00,083368,Staff,3,0,30,27
1649848351492,COGS 186,A01,083986,Staff,25,0,40,15
1649848357533,COGS 187A,A01,083988,Boyle; Mary E. T.,40,0,60,20
1649848363560,CSE 8A,A50,084003,Miranda; Gregory Joseph,9,0,15,6
1649848369584,CSE 11,A01,084005,Miranda; Gregory Joseph,49,0,55,6
1649848375607,CSE 20,A01,084007,Staff,15,0,20,5
1649848381637,CSE 21,A01,084009,Staff,32,0,50,18
1649848387664,CSE 30,A01,083370,Cao; Yingjun,20,0,40,20
1649848393688,CSE 100,A01,083372,Cao; Yingjun,13,0,40,27
1649848399715,CSE 101,A01,084011,Staff,0,16,40,40
1649848405745,CSE 141,A01,083374,Eldon; John,0,13,75,75
1649848411769,CSE 141L,A01,083376,Eldon; John,0,17,75,75
1649848417793,CSE 175,A01,084013,Kumar; Rakesh,24,0,25,1
1649848423822,CSE 190,A00,092508,Staff,15,0,15,0
1649848429855,ECE 5,A01,084049,Morris; Karcher William,17,0,20,3
1649848435883,ECE 100,A01,084051,Baghdadchi; Saharnaz,16,0,20,4
1649848435883,ECE 100,A02,091916,Baghdadchi; Saharnaz,18,0,20,2
1649848441907,ECE 101,A01,084053,Baghdadchi; Saharnaz,25,0,37,12
1649848441907,ECE 101,A02,084054,Baghdadchi; Saharnaz,37,0,37,0
1649848447933,ECE 107,A01,083390,Staff,31,0,40,9
1649848453962,ECE 148,A01,084056,Silberman; Jack,8,0,12,4
1649848459985,ECE 180,A00,083391,Abi Samra; Nicholas Camill,27,0,30,3
1649848459985,ECE 180,B00,083392,Abi Samra; Nicholas Camill,26,0,30,4
1649848466009,MATH 10B,A01,084110,Staff,20,0,30,10
1649848466009,MATH 10B,A02,084111,Staff,29,0,30,1
1649848466009,MATH 10B,A03,084112,Staff,29,0,30,1
1649848472033,MATH 10C,A01,083443,Staff,19,0,30,11
1649848472033,MATH 10C,A02,083444,Staff,24,0,30,6
1649848472033,MATH 10C,B01,084114,Staff,26,0,30,4
1649848472033,MATH 10C,B02,084115,Staff,30,0,30,0
1649848478060,MATH 18,A01,084117,Harel; Guershon,28,0,30,2
1649848478060,MATH 18,A02,084119,Harel; Guershon,29,0,30,1
1649848478060,MATH 18,A03,084120,Harel; Guershon,30,0,30,0
1649848478060,MATH 18,A04,084121,Harel; Guershon,30,0,30,0
1649848484084,MATH 20B,A01,084124,Um; Ko Woon,33,0,35,2
1649848484084,MATH 20B,B01,084126,Um; Ko Woon,35,0,35,0
1649848490199,MATH 20C,A01,083446,Hammock; Frances H,26,0,30,4
1649848490199,MATH 20C,A02,083447,Hammock; Frances H,30,0,30,0
1649848490199,MATH 20C,A03,083448,Hammock; Frances H,30,0,30,0
1649848490199,MATH 20C,A04,083449,Hammock; Frances H,30,0,30,0
1649848490199,MATH 20C,B01,083451,Hammock; Frances H,29,0,30,1
1649848490199,MATH 20C,B02,083452,Hammock; Frances H,30,0,30,0
1649848490199,MATH 20C,B03,083453,Hammock; Frances H,30,0,30,0
1649848490199,MATH 20C,B04,083454,Hammock; Frances H,30,0,30,0
1649848496231,MATH 20D,A01,084128,Staff,29,0,30,1
1649848496231,MATH 20D,A02,084129,Staff,30,0,30,0
1649848496231,MATH 20D,A03,084130,Staff,29,0,30,1
1649848496231,MATH 20D,B01,084133,Staff,28,0,30,2
1649848496231,MATH 20D,B02,084134,Staff,30,0,30,0
1649848496231,MATH 20D,B03,084135,Staff,30,0,30,0
1649848502261,MATH 20E,A01,084138,Staff,27,0,30,3
1649848502261,MATH 20E,A02,084139,Staff,29,0,30,1
1649848502261,MATH 20E,A03,084140,Staff,28,0,30,2
1649848502261,MATH 20E,A04,084141,Staff,30,0,30,0
1649848508285,MATH 102,A01,084143,Harel; Guershon,24,0,30,6
1649848508285,MATH 102,A02,084144,Harel; Guershon,25,0,30,5
1649848514326,MATH 103B,A01,083456,Staff,0,0,30,30
1649848514326,MATH 103B,A02,083457,Staff,18,0,30,12
1649848520350,MATH 109,A01,084146,Salehi Golsefidy; Alireza,30,0,30,0
1649848520350,MATH 109,A02,084147,Salehi Golsefidy; Alireza,26,0,30,4
1649848526379,MATH 120A,A01,085445,Eggers; John Dietrich,30,0,35,5
1649848526379,MATH 120A,A02,085446,Eggers; John Dietrich,31,0,35,4
1649848532403,MATH 142B,A01,084149,Verstraete; Jacques Allan,7,0,30,23
1649848532403,MATH 142B,A02,084150,Verstraete; Jacques Allan,25,0,30,5
1649848538427,MATH 170A,A01,083459,Nie; Jiawang,9,0,30,21
1649848538427,MATH 170A,A02,083460,Nie; Jiawang,25,0,30,5
1649848538427,MATH 170A,A03,083461,Nie; Jiawang,26,0,30,4
1649848544451,MATH 193B,A01,083463,Staff,15,0,30,15
1649848544451,MATH 193B,A02,083464,Staff,19,0,30,11
1649848544451,MATH 193B,A03,083465,Staff,27,0,30,3
1649848550508,COGS 2,A01,083966,Boyle; Mary E. T.,27,0,30,3
1649848556533,COGS 9,A01,083968,Staff,56,0,60,4
1649848562561,COGS 14B,A01,083970,Staff,46,0,50,4
1649848568591,COGS 17,A01,092679,Staff,73,0,75,2
1649848574618,COGS 100,A01,083972,Staff,46,0,60,14
1649848586671,COGS 101C,A01,083976,Staff,25,0,30,5
1649848592700,COGS 102A,A01,083978,Johnson; Christine M.,24,0,30,6
1649848598722,COGS 107B,A01,083980,Staff,32,0,50,18
1649848604752,COGS 115,A01,083982,Staff,21,0,30,9
1649848610776,COGS 118B,A01,083367,Staff,5,0,40,35
1649848616805,COGS 172,A01,083984,Provenzano; Emily Kara,20,0,30,10
1649848622826,COGS 177,A00,083368,Staff,3,0,30,27
1649848628852,COGS 186,A01,083986,Staff,25,0,40,15
