time,subj_course_id,sec_code,sec_id,prof,available,waitlist,total,enrolled_ct
1649849207246,COGS 2,A01,083966,Boyle; Mary E. T.,27,0,30,3
1649849213280,COGS 9,A01,083968,Staff,56,0,60,4
1649849219310,COGS 14B,A01,083970,Staff,46,0,50,4
1649849225352,COGS 17,A01,092679,Staff,73,0,75,2
1649849231389,COGS 100,A01,083972,Staff,46,0,60,14
1649849243449,COGS 101C,A01,083976,Staff,25,0,30,5
1649849249481,COGS 102A,A01,083978,Johnson; Christine M.,24,0,30,6
1649849255509,COGS 107B,A01,083980,Staff,32,0,50,18
1649849261536,COGS 115,A01,083982,Staff,21,0,30,9
1649849267570,COGS 118B,A01,083367,Staff,5,0,40,35
1649849273596,COGS 172,A01,083984,Provenzano; Emily Kara,20,0,30,10
1649849279631,COGS 177,A00,083368,Staff,3,0,30,27
1649849285668,COGS 186,A01,083986,Staff,25,0,40,15
1649849291698,COGS 187A,A01,083988,Boyle; Mary E. T.,40,0,60,20
1649849297730,CSE 8A,A50,084003,Miranda; Gregory Joseph,9,0,15,6
1649849303764,CSE 11,A01,084005,Miranda; Gregory Joseph,49,0,55,6
1649849309789,CSE 20,A01,084007,Staff,15,0,20,5
1649849315816,CSE 21,A01,084009,Staff,32,0,50,18
1649849321842,CSE 30,A01,083370,Cao; Yingjun,20,0,40,20
1649849327873,CSE 100,A01,083372,Cao; Yingjun,13,0,40,27
1649849333904,CSE 101,A01,084011,Staff,0,16,40,40
1649849339933,CSE 141,A01,083374,Eldon; John,0,13,75,75
1649849345963,CSE 141L,A01,083376,Eldon; John,0,17,75,75
1649849351992,CSE 175,A01,084013,Kumar; Rakesh,24,0,25,1
1649849358021,CSE 190,A00,092508,Staff,15,0,15,0
1649849364054,ECE 5,A01,084049,Morris; Karcher William,17,0,20,3
1649849370084,ECE 100,A01,084051,Baghdadchi; Saharnaz,16,0,20,4
1649849370084,ECE 100,A02,091916,Baghdadchi; Saharnaz,18,0,20,2
1649849376112,ECE 101,A01,084053,Baghdadchi; Saharnaz,25,0,37,12
1649849376112,ECE 101,A02,084054,Baghdadchi; Saharnaz,37,0,37,0
1649849382143,ECE 107,A01,083390,Staff,31,0,40,9
1649849388176,ECE 148,A01,084056,Silberman; Jack,8,0,12,4
1649849394210,ECE 180,A00,083391,Abi Samra; Nicholas Camill,27,0,30,3
1649849394210,ECE 180,B00,083392,Abi Samra; Nicholas Camill,26,0,30,4
1649849400241,MATH 10B,A01,084110,Staff,20,0,30,10
1649849400241,MATH 10B,A02,084111,Staff,29,0,30,1
1649849400241,MATH 10B,A03,084112,Staff,29,0,30,1
1649849406271,MATH 10C,A01,083443,Staff,19,0,30,11
1649849406271,MATH 10C,A02,083444,Staff,24,0,30,6
1649849406271,MATH 10C,B01,084114,Staff,26,0,30,4
1649849406271,MATH 10C,B02,084115,Staff,30,0,30,0
1649849412297,MATH 18,A01,084117,Harel; Guershon,28,0,30,2
1649849412297,MATH 18,A02,084119,Harel; Guershon,29,0,30,1
1649849412297,MATH 18,A03,084120,Harel; Guershon,30,0,30,0
1649849412297,MATH 18,A04,084121,Harel; Guershon,30,0,30,0
1649849418325,MATH 20B,A01,084124,Um; Ko Woon,33,0,35,2
1649849418325,MATH 20B,B01,084126,Um; Ko Woon,35,0,35,0
1649849424358,MATH 20C,A01,083446,Hammock; Frances H,26,0,30,4
1649849424358,MATH 20C,A02,083447,Hammock; Frances H,30,0,30,0
1649849424358,MATH 20C,A03,083448,Hammock; Frances H,30,0,30,0
1649849424358,MATH 20C,A04,083449,Hammock; Frances H,30,0,30,0
1649849424358,MATH 20C,B01,083451,Hammock; Frances H,29,0,30,1
1649849424358,MATH 20C,B02,083452,Hammock; Frances H,30,0,30,0
1649849424358,MATH 20C,B03,083453,Hammock; Frances H,30,0,30,0
1649849424358,MATH 20C,B04,083454,Hammock; Frances H,30,0,30,0
1649849430391,MATH 20D,A01,084128,Staff,29,0,30,1
1649849430391,MATH 20D,A02,084129,Staff,30,0,30,0
1649849430391,MATH 20D,A03,084130,Staff,29,0,30,1
1649849430391,MATH 20D,B01,084133,Staff,28,0,30,2
1649849430391,MATH 20D,B02,084134,Staff,30,0,30,0
1649849430391,MATH 20D,B03,084135,Staff,30,0,30,0
1649849436420,MATH 20E,A01,084138,Staff,27,0,30,3
1649849436420,MATH 20E,A02,084139,Staff,29,0,30,1
1649849436420,MATH 20E,A03,084140,Staff,28,0,30,2
1649849436420,MATH 20E,A04,084141,Staff,30,0,30,0
1649849442446,MATH 102,A01,084143,Harel; Guershon,24,0,30,6
1649849442446,MATH 102,A02,084144,Harel; Guershon,25,0,30,5
1649849448476,MATH 103B,A01,083456,Staff,0,0,30,30
1649849448476,MATH 103B,A02,083457,Staff,18,0,30,12
1649849454509,MATH 109,A01,084146,Salehi Golsefidy; Alireza,30,0,30,0
1649849454509,MATH 109,A02,084147,Salehi Golsefidy; Alireza,26,0,30,4
1649849460539,MATH 120A,A01,085445,Eggers; John Dietrich,30,0,35,5
1649849460539,MATH 120A,A02,085446,Eggers; John Dietrich,31,0,35,4
1649849466573,MATH 142B,A01,084149,Verstraete; Jacques Allan,7,0,30,23
1649849466573,MATH 142B,A02,084150,Verstraete; Jacques Allan,25,0,30,5
1649849472605,MATH 170A,A01,083459,Nie; Jiawang,9,0,30,21
1649849472605,MATH 170A,A02,083460,Nie; Jiawang,25,0,30,5
1649849472605,MATH 170A,A03,083461,Nie; Jiawang,26,0,30,4
1649849478631,MATH 193B,A01,083463,Staff,15,0,30,15
1649849478631,MATH 193B,A02,083464,Staff,19,0,30,11
1649849478631,MATH 193B,A03,083465,Staff,27,0,30,3
1649849484696,COGS 2,A01,083966,Boyle; Mary E. T.,27,0,30,3
1649849490723,COGS 9,A01,083968,Staff,56,0,60,4
1649849496752,COGS 14B,A01,083970,Staff,46,0,50,4
1649849502784,COGS 17,A01,092679,Staff,73,0,75,2
1649849508808,COGS 100,A01,083972,Staff,46,0,60,14
1649849520862,COGS 101C,A01,083976,Staff,25,0,30,5
1649849526887,COGS 102A,A01,083978,Johnson; Christine M.,24,0,30,6
1649849532914,COGS 107B,A01,083980,Staff,32,0,50,18
1649849538942,COGS 115,A01,083982,Staff,21,0,30,9
1649849544970,COGS 118B,A01,083367,Staff,5,0,40,35
1649849550999,COGS 172,A01,083984,Provenzano; Emily Kara,20,0,30,10
1649849557023,COGS 177,A00,083368,Staff,3,0,30,27
1649849563049,COGS 186,A01,083986,Staff,25,0,40,15
1649849569081,COGS 187A,A01,083988,Boyle; Mary E. T.,40,0,60,20
1649849575108,CSE 8A,A50,084003,Miranda; Gregory Joseph,9,0,15,6
1649849581133,CSE 11,A01,084005,Miranda; Gregory Joseph,49,0,55,6
1649849587164,CSE 20,A01,084007,Staff,15,0,20,5
1649849593191,CSE 21,A01,084009,Staff,32,0,50,18
1649849599221,CSE 30,A01,083370,Cao; Yingjun,20,0,40,20
1649849605244,CSE 100,A01,083372,Cao; Yingjun,13,0,40,27
1649849611269,CSE 101,A01,084011,Staff,0,16,40,40
1649849617293,CSE 141,A01,083374,Eldon; John,0,14,75,75
1649849623322,CSE 141L,A01,083376,Eldon; John,0,18,75,75
1649849629348,CSE 175,A01,084013,Kumar; Rakesh,24,0,25,1
1649849635379,CSE 190,A00,092508,Staff,15,0,15,0
1649849641411,ECE 5,A01,084049,Morris; Karcher William,17,0,20,3
1649849647437,ECE 100,A01,084051,Baghdadchi; Saharnaz,16,0,20,4
1649849647437,ECE 100,A02,091916,Baghdadchi; Saharnaz,18,0,20,2
1649849653468,ECE 101,A01,084053,Baghdadchi; Saharnaz,25,0,37,12
1649849653468,ECE 101,A02,084054,Baghdadchi; Saharnaz,37,0,37,0
1649849659496,ECE 107,A01,083390,Staff,31,0,40,9
1649849665520,ECE 148,A01,084056,Silberman; Jack,8,0,12,4
1649849671546,ECE 180,A00,083391,Abi Samra; Nicholas Camill,27,0,30,3
1649849671546,ECE 180,B00,083392,Abi Samra; Nicholas Camill,26,0,30,4
1649849677579,MATH 10B,A01,084110,Staff,20,0,30,10
1649849677579,MATH 10B,A02,084111,Staff,29,0,30,1
1649849677579,MATH 10B,A03,084112,Staff,29,0,30,1
1649849683609,MATH 10C,A01,083443,Staff,19,0,30,11
1649849683609,MATH 10C,A02,083444,Staff,24,0,30,6
1649849683609,MATH 10C,B01,084114,Staff,26,0,30,4
1649849683609,MATH 10C,B02,084115,Staff,30,0,30,0
1649849689635,MATH 18,A01,084117,Harel; Guershon,28,0,30,2
1649849689635,MATH 18,A02,084119,Harel; Guershon,29,0,30,1
1649849689635,MATH 18,A03,084120,Harel; Guershon,30,0,30,0
1649849689635,MATH 18,A04,084121,Harel; Guershon,30,0,30,0
1649849695660,MATH 20B,A01,084124,Um; Ko Woon,33,0,35,2
1649849695660,MATH 20B,B01,084126,Um; Ko Woon,35,0,35,0
1649849701695,MATH 20C,A01,083446,Hammock; Frances H,26,0,30,4
1649849701695,MATH 20C,A02,083447,Hammock; Frances H,30,0,30,0
1649849701695,MATH 20C,A03,083448,Hammock; Frances H,30,0,30,0
1649849701695,MATH 20C,A04,083449,Hammock; Frances H,30,0,30,0
1649849701695,MATH 20C,B01,083451,Hammock; Frances H,29,0,30,1
1649849701695,MATH 20C,B02,083452,Hammock; Frances H,30,0,30,0
1649849701695,MATH 20C,B03,083453,Hammock; Frances H,30,0,30,0
1649849701695,MATH 20C,B04,083454,Hammock; Frances H,30,0,30,0
1649849707735,MATH 20D,A01,084128,Staff,29,0,30,1
1649849707735,MATH 20D,A02,084129,Staff,30,0,30,0
1649849707735,MATH 20D,A03,084130,Staff,29,0,30,1
1649849707735,MATH 20D,B01,084133,Staff,28,0,30,2
1649849707735,MATH 20D,B02,084134,Staff,30,0,30,0
1649849707735,MATH 20D,B03,084135,Staff,30,0,30,0
1649849713759,MATH 20E,A01,084138,Staff,27,0,30,3
1649849713759,MATH 20E,A02,084139,Staff,29,0,30,1
1649849713759,MATH 20E,A03,084140,Staff,28,0,30,2
1649849713759,MATH 20E,A04,084141,Staff,30,0,30,0
1649849719788,MATH 102,A01,084143,Harel; Guershon,24,0,30,6
1649849719788,MATH 102,A02,084144,Harel; Guershon,25,0,30,5
1649849725819,MATH 103B,A01,083456,Staff,0,0,30,30
1649849725819,MATH 103B,A02,083457,Staff,18,0,30,12
1649849731844,MATH 109,A01,084146,Salehi Golsefidy; Alireza,30,0,30,0
1649849731844,MATH 109,A02,084147,Salehi Golsefidy; Alireza,26,0,30,4
1649849737869,MATH 120A,A01,085445,Eggers; John Dietrich,30,0,35,5
1649849737869,MATH 120A,A02,085446,Eggers; John Dietrich,31,0,35,4
1649849743893,MATH 142B,A01,084149,Verstraete; Jacques Allan,7,0,30,23
1649849743893,MATH 142B,A02,084150,Verstraete; Jacques Allan,25,0,30,5
1649849749924,MATH 170A,A01,083459,Nie; Jiawang,9,0,30,21
1649849749924,MATH 170A,A02,083460,Nie; Jiawang,25,0,30,5
1649849749924,MATH 170A,A03,083461,Nie; Jiawang,26,0,30,4
1649849755950,MATH 193B,A01,083463,Staff,15,0,30,15
1649849755950,MATH 193B,A02,083464,Staff,19,0,30,11
1649849755950,MATH 193B,A03,083465,Staff,27,0,30,3
1649849762008,COGS 2,A01,083966,Boyle; Mary E. T.,27,0,30,3
1649849768034,COGS 9,A01,083968,Staff,56,0,60,4
1649849774061,COGS 14B,A01,083970,Staff,46,0,50,4
1649849780158,COGS 17,A01,092679,Staff,73,0,75,2
1649849786181,COGS 100,A01,083972,Staff,46,0,60,14
1649849798231,COGS 101C,A01,083976,Staff,25,0,30,5
1649849804257,COGS 102A,A01,083978,Johnson; Christine M.,24,0,30,6
1649849810280,COGS 107B,A01,083980,Staff,32,0,50,18
1649849816305,COGS 115,A01,083982,Staff,21,0,30,9
1649849822329,COGS 118B,A01,083367,Staff,5,0,40,35
1649849828356,COGS 172,A01,083984,Provenzano; Emily Kara,20,0,30,10
1649849834382,COGS 177,A00,083368,Staff,3,0,30,27
1649849840414,COGS 186,A01,083986,Staff,25,0,40,15
1649849846441,COGS 187A,A01,083988,Boyle; Mary E. T.,40,0,60,20
1649849852467,CSE 8A,A50,084003,Miranda; Gregory Joseph,9,0,15,6
1649849858500,CSE 11,A01,084005,Miranda; Gregory Joseph,49,0,55,6
1649849864525,CSE 20,A01,084007,Staff,15,0,20,5
1649849870552,CSE 21,A01,084009,Staff,32,0,50,18
1649849876582,CSE 30,A01,083370,Cao; Yingjun,20,0,40,20
1649849891809,CSE 100,A01,083372,Cao; Yingjun,13,0,40,27
1649849897929,CSE 101,A01,084011,Staff,0,16,40,40
1649849914233,CSE 141,A01,083374,Eldon; John,0,14,75,75
1649849920262,CSE 141L,A01,083376,Eldon; John,0,18,75,75
1649849936805,CSE 175,A01,084013,Kumar; Rakesh,24,0,25,1
1649849942836,CSE 190,A00,092508,Staff,15,0,15,0
1649849959418,ECE 5,A01,084049,Morris; Karcher William,17,0,20,3
1649849965446,ECE 100,A01,084051,Baghdadchi; Saharnaz,16,0,20,4
1649849965446,ECE 100,A02,091916,Baghdadchi; Saharnaz,18,0,20,2
1649849981673,ECE 101,A01,084053,Baghdadchi; Saharnaz,25,0,37,12
1649849981673,ECE 101,A02,084054,Baghdadchi; Saharnaz,37,0,37,0
1649849987702,ECE 107,A01,083390,Staff,31,0,40,9
1649850004776,ECE 148,A01,084056,Silberman; Jack,8,0,12,4
1649850010807,ECE 180,A00,083391,Abi Samra; Nicholas Camill,27,0,30,3
1649850010807,ECE 180,B00,083392,Abi Samra; Nicholas Camill,26,0,30,4
1649850021563,MATH 10B,A01,084110,Staff,20,0,30,10
1649850021563,MATH 10B,A02,084111,Staff,29,0,30,1
1649850021563,MATH 10B,A03,084112,Staff,29,0,30,1
1649850027595,MATH 10C,A01,083443,Staff,19,0,30,11
1649850027595,MATH 10C,A02,083444,Staff,24,0,30,6
1649850027595,MATH 10C,B01,084114,Staff,26,0,30,4
1649850027595,MATH 10C,B02,084115,Staff,30,0,30,0
1649850033630,MATH 18,A01,084117,Harel; Guershon,28,0,30,2
1649850033630,MATH 18,A02,084119,Harel; Guershon,29,0,30,1
1649850033630,MATH 18,A03,084120,Harel; Guershon,30,0,30,0
1649850033630,MATH 18,A04,084121,Harel; Guershon,30,0,30,0
1649850039655,MATH 20B,A01,084124,Um; Ko Woon,33,0,35,2
1649850039655,MATH 20B,B01,084126,Um; Ko Woon,35,0,35,0
1649850045692,MATH 20C,A01,083446,Hammock; Frances H,26,0,30,4
1649850045692,MATH 20C,A02,083447,Hammock; Frances H,30,0,30,0
1649850045692,MATH 20C,A03,083448,Hammock; Frances H,30,0,30,0
1649850045692,MATH 20C,A04,083449,Hammock; Frances H,30,0,30,0
1649850045692,MATH 20C,B01,083451,Hammock; Frances H,29,0,30,1
1649850045692,MATH 20C,B02,083452,Hammock; Frances H,30,0,30,0
1649850045692,MATH 20C,B03,083453,Hammock; Frances H,30,0,30,0
1649850045692,MATH 20C,B04,083454,Hammock; Frances H,30,0,30,0
1649850051727,MATH 20D,A01,084128,Staff,29,0,30,1
1649850051727,MATH 20D,A02,084129,Staff,30,0,30,0
1649850051727,MATH 20D,A03,084130,Staff,29,0,30,1
1649850051727,MATH 20D,B01,084133,Staff,28,0,30,2
1649850051727,MATH 20D,B02,084134,Staff,30,0,30,0
1649850051727,MATH 20D,B03,084135,Staff,30,0,30,0
1649850057754,MATH 20E,A01,084138,Staff,27,0,30,3
1649850057754,MATH 20E,A02,084139,Staff,29,0,30,1
1649850057754,MATH 20E,A03,084140,Staff,28,0,30,2
1649850057754,MATH 20E,A04,084141,Staff,30,0,30,0
1649850063789,MATH 102,A01,084143,Harel; Guershon,24,0,30,6
1649850063789,MATH 102,A02,084144,Harel; Guershon,25,0,30,5
1649850069821,MATH 103B,A01,083456,Staff,0,0,30,30
1649850069821,MATH 103B,A02,083457,Staff,18,0,30,12
1649850075856,MATH 109,A01,084146,Salehi Golsefidy; Alireza,30,0,30,0
1649850075856,MATH 109,A02,084147,Salehi Golsefidy; Alireza,26,0,30,4
1649850081892,MATH 120A,A01,085445,Eggers; John Dietrich,30,0,35,5
1649850081892,MATH 120A,A02,085446,Eggers; John Dietrich,31,0,35,4
1649850087926,MATH 142B,A01,084149,Verstraete; Jacques Allan,7,0,30,23
1649850087926,MATH 142B,A02,084150,Verstraete; Jacques Allan,25,0,30,5
1649850093953,MATH 170A,A01,083459,Nie; Jiawang,9,0,30,21
1649850093953,MATH 170A,A02,083460,Nie; Jiawang,25,0,30,5
1649850093953,MATH 170A,A03,083461,Nie; Jiawang,26,0,30,4
1649850099991,MATH 193B,A01,083463,Staff,15,0,30,15
1649850099991,MATH 193B,A02,083464,Staff,19,0,30,11
1649850099991,MATH 193B,A03,083465,Staff,27,0,30,3
1649850106072,COGS 2,A01,083966,Boyle; Mary E. T.,27,0,30,3
1649850112098,COGS 9,A01,083968,Staff,56,0,60,4
1649850118135,COGS 14B,A01,083970,Staff,46,0,50,4
1649850124161,COGS 17,A01,092679,Staff,73,0,75,2
1649850130192,COGS 100,A01,083972,Staff,46,0,60,14
1649850142252,COGS 101C,A01,083976,Staff,25,0,30,5
1649850148282,COGS 102A,A01,083978,Johnson; Christine M.,24,0,30,6
1649850154317,COGS 107B,A01,083980,Staff,32,0,50,18
1649850160346,COGS 115,A01,083982,Staff,21,0,30,9
1649850166375,COGS 118B,A01,083367,Staff,5,0,40,35
1649850172409,COGS 172,A01,083984,Provenzano; Emily Kara,20,0,30,10
1649850178438,COGS 177,A00,083368,Staff,3,0,30,27
1649850184465,COGS 186,A01,083986,Staff,25,0,40,15
1649850190491,COGS 187A,A01,083988,Boyle; Mary E. T.,40,0,60,20
1649850196526,CSE 8A,A50,084003,Miranda; Gregory Joseph,9,0,15,6
1649850202557,CSE 11,A01,084005,Miranda; Gregory Joseph,49,0,55,6
1649850208584,CSE 20,A01,084007,Staff,15,0,20,5
1649850214615,CSE 21,A01,084009,Staff,32,0,50,18
1649850220645,CSE 30,A01,083370,Cao; Yingjun,20,0,40,20
1649850226675,CSE 100,A01,083372,Cao; Yingjun,13,0,40,27
1649850232707,CSE 101,A01,084011,Staff,0,16,40,40
1649850238732,CSE 141,A01,083374,Eldon; John,0,14,75,75
1649850244764,CSE 141L,A01,083376,Eldon; John,0,18,75,75
1649850250802,CSE 175,A01,084013,Kumar; Rakesh,24,0,25,1
1649850256837,CSE 190,A00,092508,Staff,15,0,15,0
1649850262870,ECE 5,A01,084049,Morris; Karcher William,17,0,20,3
1649850268907,ECE 100,A01,084051,Baghdadchi; Saharnaz,16,0,20,4
1649850268907,ECE 100,A02,091916,Baghdadchi; Saharnaz,18,0,20,2
1649850274934,ECE 101,A01,084053,Baghdadchi; Saharnaz,25,0,37,12
1649850274934,ECE 101,A02,084054,Baghdadchi; Saharnaz,37,0,37,0
1649850280967,ECE 107,A01,083390,Staff,31,0,40,9
1649850286993,ECE 148,A01,084056,Silberman; Jack,8,0,12,4
1649850293025,ECE 180,A00,083391,Abi Samra; Nicholas Camill,27,0,30,3
1649850293025,ECE 180,B00,083392,Abi Samra; Nicholas Camill,26,0,30,4
1649850299053,MATH 10B,A01,084110,Staff,20,0,30,10
1649850299053,MATH 10B,A02,084111,Staff,29,0,30,1
1649850299053,MATH 10B,A03,084112,Staff,29,0,30,1
1649850305087,MATH 10C,A01,083443,Staff,19,0,30,11
1649850305087,MATH 10C,A02,083444,Staff,24,0,30,6
1649850305087,MATH 10C,B01,084114,Staff,26,0,30,4
1649850305087,MATH 10C,B02,084115,Staff,30,0,30,0
1649850311120,MATH 18,A01,084117,Harel; Guershon,28,0,30,2
1649850311120,MATH 18,A02,084119,Harel; Guershon,29,0,30,1
1649850311120,MATH 18,A03,084120,Harel; Guershon,30,0,30,0
1649850311120,MATH 18,A04,084121,Harel; Guershon,30,0,30,0
1649850317156,MATH 20B,A01,084124,Um; Ko Woon,33,0,35,2
1649850317156,MATH 20B,B01,084126,Um; Ko Woon,35,0,35,0
1649850323185,MATH 20C,A01,083446,Hammock; Frances H,26,0,30,4
1649850323185,MATH 20C,A02,083447,Hammock; Frances H,30,0,30,0
1649850323185,MATH 20C,A03,083448,Hammock; Frances H,30,0,30,0
1649850323185,MATH 20C,A04,083449,Hammock; Frances H,30,0,30,0
1649850323185,MATH 20C,B01,083451,Hammock; Frances H,29,0,30,1
1649850323185,MATH 20C,B02,083452,Hammock; Frances H,30,0,30,0
1649850323185,MATH 20C,B03,083453,Hammock; Frances H,30,0,30,0
1649850323185,MATH 20C,B04,083454,Hammock; Frances H,30,0,30,0
1649850329214,MATH 20D,A01,084128,Staff,29,0,30,1
1649850329214,MATH 20D,A02,084129,Staff,30,0,30,0
1649850329214,MATH 20D,A03,084130,Staff,29,0,30,1
1649850329214,MATH 20D,B01,084133,Staff,28,0,30,2
1649850329214,MATH 20D,B02,084134,Staff,30,0,30,0
1649850329214,MATH 20D,B03,084135,Staff,30,0,30,0
1649850335241,MATH 20E,A01,084138,Staff,27,0,30,3
1649850335241,MATH 20E,A02,084139,Staff,29,0,30,1
1649850335241,MATH 20E,A03,084140,Staff,28,0,30,2
1649850335241,MATH 20E,A04,084141,Staff,30,0,30,0
1649850341272,MATH 102,A01,084143,Harel; Guershon,24,0,30,6
1649850341272,MATH 102,A02,084144,Harel; Guershon,25,0,30,5
1649850347303,MATH 103B,A01,083456,Staff,0,0,30,30
1649850347303,MATH 103B,A02,083457,Staff,18,0,30,12
1649850353329,MATH 109,A01,084146,Salehi Golsefidy; Alireza,30,0,30,0
1649850353329,MATH 109,A02,084147,Salehi Golsefidy; Alireza,26,0,30,4
1649850359361,MATH 120A,A01,085445,Eggers; John Dietrich,30,0,35,5
1649850359361,MATH 120A,A02,085446,Eggers; John Dietrich,31,0,35,4
1649850365387,MATH 142B,A01,084149,Verstraete; Jacques Allan,7,0,30,23
1649850365387,MATH 142B,A02,084150,Verstraete; Jacques Allan,25,0,30,5
1649850371415,MATH 170A,A01,083459,Nie; Jiawang,9,0,30,21
1649850371415,MATH 170A,A02,083460,Nie; Jiawang,25,0,30,5
1649850371415,MATH 170A,A03,083461,Nie; Jiawang,26,0,30,4
1649850377448,MATH 193B,A01,083463,Staff,15,0,30,15
1649850377448,MATH 193B,A02,083464,Staff,19,0,30,11
1649850377448,MATH 193B,A03,083465,Staff,27,0,30,3
1649850383518,COGS 2,A01,083966,Boyle; Mary E. T.,27,0,30,3
1649850389555,COGS 9,A01,083968,Staff,56,0,60,4
1649850395583,COGS 14B,A01,083970,Staff,46,0,50,4
1649850401610,COGS 17,A01,092679,Staff,73,0,75,2
1649850407635,COGS 100,A01,083972,Staff,46,0,60,14
1649850419700,COGS 101C,A01,083976,Staff,25,0,30,5
1649850425727,COGS 102A,A01,083978,Johnson; Christine M.,24,0,30,6
1649850439815,COGS 107B,A01,083980,Staff,32,0,50,18
1649850445843,COGS 115,A01,083982,Staff,21,0,30,9
1649850456681,COGS 118B,A01,083367,Staff,5,0,40,35
1649850462756,COGS 172,A01,083984,Provenzano; Emily Kara,20,0,30,10
1649850468783,COGS 177,A00,083368,Staff,3,0,30,27
1649850474808,COGS 186,A01,083986,Staff,25,0,40,15
1649850480836,COGS 187A,A01,083988,Boyle; Mary E. T.,40,0,60,20
1649850486869,CSE 8A,A50,084003,Miranda; Gregory Joseph,9,0,15,6
1649850492895,CSE 11,A01,084005,Miranda; Gregory Joseph,49,0,55,6
1649850498926,CSE 20,A01,084007,Staff,15,0,20,5
1649850504954,CSE 21,A01,084009,Staff,32,0,50,18
1649850510978,CSE 30,A01,083370,Cao; Yingjun,20,0,40,20
1649850517003,CSE 100,A01,083372,Cao; Yingjun,13,0,40,27
1649850523028,CSE 101,A01,084011,Staff,0,16,40,40
1649850529053,CSE 141,A01,083374,Eldon; John,0,14,75,75
1649850535087,CSE 141L,A01,083376,Eldon; John,0,18,75,75
1649850541117,CSE 175,A01,084013,Kumar; Rakesh,24,0,25,1
1649850547148,CSE 190,A00,092508,Staff,15,0,15,0
1649850553176,ECE 5,A01,084049,Morris; Karcher William,17,0,20,3
1649850559210,ECE 100,A01,084051,Baghdadchi; Saharnaz,16,0,20,4
1649850559210,ECE 100,A02,091916,Baghdadchi; Saharnaz,18,0,20,2
1649850565236,ECE 101,A01,084053,Baghdadchi; Saharnaz,25,0,37,12
1649850565236,ECE 101,A02,084054,Baghdadchi; Saharnaz,37,0,37,0
1649850571262,ECE 107,A01,083390,Staff,31,0,40,9
1649850577293,ECE 148,A01,084056,Silberman; Jack,8,0,12,4
1649850583325,ECE 180,A00,083391,Abi Samra; Nicholas Camill,27,0,30,3
1649850583325,ECE 180,B00,083392,Abi Samra; Nicholas Camill,26,0,30,4
1649850589351,MATH 10B,A01,084110,Staff,20,0,30,10
1649850589351,MATH 10B,A02,084111,Staff,29,0,30,1
1649850589351,MATH 10B,A03,084112,Staff,29,0,30,1
1649850595378,MATH 10C,A01,083443,Staff,19,0,30,11
1649850595378,MATH 10C,A02,083444,Staff,24,0,30,6
1649850595378,MATH 10C,B01,084114,Staff,26,0,30,4
1649850595378,MATH 10C,B02,084115,Staff,30,0,30,0
1649850601403,MATH 18,A01,084117,Harel; Guershon,28,0,30,2
1649850601403,MATH 18,A02,084119,Harel; Guershon,29,0,30,1
1649850601403,MATH 18,A03,084120,Harel; Guershon,30,0,30,0
1649850601403,MATH 18,A04,084121,Harel; Guershon,30,0,30,0
1649850607429,MATH 20B,A01,084124,Um; Ko Woon,33,0,35,2
1649850607429,MATH 20B,B01,084126,Um; Ko Woon,35,0,35,0
1649850613454,MATH 20C,A01,083446,Hammock; Frances H,26,0,30,4
1649850613454,MATH 20C,A02,083447,Hammock; Frances H,30,0,30,0
1649850613454,MATH 20C,A03,083448,Hammock; Frances H,30,0,30,0
1649850613454,MATH 20C,A04,083449,Hammock; Frances H,30,0,30,0
1649850613454,MATH 20C,B01,083451,Hammock; Frances H,29,0,30,1
1649850613454,MATH 20C,B02,083452,Hammock; Frances H,30,0,30,0
1649850613454,MATH 20C,B03,083453,Hammock; Frances H,30,0,30,0
1649850613454,MATH 20C,B04,083454,Hammock; Frances H,30,0,30,0
1649850619483,MATH 20D,A01,084128,Staff,29,0,30,1
1649850619483,MATH 20D,A02,084129,Staff,30,0,30,0
1649850619483,MATH 20D,A03,084130,Staff,29,0,30,1
1649850619483,MATH 20D,B01,084133,Staff,28,0,30,2
1649850619483,MATH 20D,B02,084134,Staff,30,0,30,0
1649850619483,MATH 20D,B03,084135,Staff,30,0,30,0
1649850625509,MATH 20E,A01,084138,Staff,27,0,30,3
1649850625509,MATH 20E,A02,084139,Staff,29,0,30,1
1649850625509,MATH 20E,A03,084140,Staff,28,0,30,2
1649850625509,MATH 20E,A04,084141,Staff,30,0,30,0
1649850631539,MATH 102,A01,084143,Harel; Guershon,24,0,30,6
1649850631539,MATH 102,A02,084144,Harel; Guershon,25,0,30,5
1649850637567,MATH 103B,A01,083456,Staff,0,0,30,30
1649850637567,MATH 103B,A02,083457,Staff,18,0,30,12
1649850643596,MATH 109,A01,084146,Salehi Golsefidy; Alireza,30,0,30,0
1649850643596,MATH 109,A02,084147,Salehi Golsefidy; Alireza,26,0,30,4
1649850649628,MATH 120A,A01,085445,Eggers; John Dietrich,30,0,35,5
1649850649628,MATH 120A,A02,085446,Eggers; John Dietrich,31,0,35,4
1649850655660,MATH 142B,A01,084149,Verstraete; Jacques Allan,7,0,30,23
1649850655660,MATH 142B,A02,084150,Verstraete; Jacques Allan,25,0,30,5
1649850661691,MATH 170A,A01,083459,Nie; Jiawang,9,0,30,21
1649850661691,MATH 170A,A02,083460,Nie; Jiawang,25,0,30,5
1649850661691,MATH 170A,A03,083461,Nie; Jiawang,26,0,30,4
1649850667719,MATH 193B,A01,083463,Staff,15,0,30,15
1649850667719,MATH 193B,A02,083464,Staff,19,0,30,11
1649850667719,MATH 193B,A03,083465,Staff,27,0,30,3
1649850673790,COGS 2,A01,083966,Boyle; Mary E. T.,27,0,30,3
1649850679822,COGS 9,A01,083968,Staff,56,0,60,4
1649850685849,COGS 14B,A01,083970,Staff,46,0,50,4
1649850691876,COGS 17,A01,092679,Staff,73,0,75,2
1649850697902,COGS 100,A01,083972,Staff,46,0,60,14
1649850709958,COGS 101C,A01,083976,Staff,25,0,30,5
1649850715985,COGS 102A,A01,083978,Johnson; Christine M.,24,0,30,6
1649850722015,COGS 107B,A01,083980,Staff,32,0,50,18
1649850728046,COGS 115,A01,083982,Staff,21,0,30,9
1649850734076,COGS 118B,A01,083367,Staff,5,0,40,35
1649850740104,COGS 172,A01,083984,Provenzano; Emily Kara,20,0,30,10
1649850746130,COGS 177,A00,083368,Staff,3,0,30,27
1649850752156,COGS 186,A01,083986,Staff,25,0,40,15
1649850758187,COGS 187A,A01,083988,Boyle; Mary E. T.,40,0,60,20
1649850764217,CSE 8A,A50,084003,Miranda; Gregory Joseph,9,0,15,6
1649850770241,CSE 11,A01,084005,Miranda; Gregory Joseph,49,0,55,6
1649850776268,CSE 20,A01,084007,Staff,15,0,20,5
1649850782300,CSE 21,A01,084009,Staff,32,0,50,18
1649850788327,CSE 30,A01,083370,Cao; Yingjun,20,0,40,20
1649850794354,CSE 100,A01,083372,Cao; Yingjun,13,0,40,27
1649850800379,CSE 101,A01,084011,Staff,0,16,40,40
1649850806409,CSE 141,A01,083374,Eldon; John,0,14,75,75
1649850812438,CSE 141L,A01,083376,Eldon; John,0,18,75,75
1649850818468,CSE 175,A01,084013,Kumar; Rakesh,24,0,25,1
1649850824494,CSE 190,A00,092508,Staff,15,0,15,0
1649850830521,ECE 5,A01,084049,Morris; Karcher William,17,0,20,3
1649850836556,ECE 100,A01,084051,Baghdadchi; Saharnaz,16,0,20,4
1649850836556,ECE 100,A02,091916,Baghdadchi; Saharnaz,18,0,20,2
1649850842582,ECE 101,A01,084053,Baghdadchi; Saharnaz,25,0,37,12
1649850842582,ECE 101,A02,084054,Baghdadchi; Saharnaz,37,0,37,0
1649850848610,ECE 107,A01,083390,Staff,31,0,40,9
1649850854637,ECE 148,A01,084056,Silberman; Jack,8,0,12,4
1649850860667,ECE 180,A00,083391,Abi Samra; Nicholas Camill,27,0,30,3
1649850860667,ECE 180,B00,083392,Abi Samra; Nicholas Camill,26,0,30,4
1649850866698,MATH 10B,A01,084110,Staff,20,0,30,10
1649850866698,MATH 10B,A02,084111,Staff,29,0,30,1
1649850866698,MATH 10B,A03,084112,Staff,29,0,30,1
1649850872723,MATH 10C,A01,083443,Staff,19,0,30,11
1649850872723,MATH 10C,A02,083444,Staff,24,0,30,6
1649850872723,MATH 10C,B01,084114,Staff,26,0,30,4
1649850872723,MATH 10C,B02,084115,Staff,30,0,30,0
1649850878753,MATH 18,A01,084117,Harel; Guershon,28,0,30,2
1649850878753,MATH 18,A02,084119,Harel; Guershon,29,0,30,1
1649850878753,MATH 18,A03,084120,Harel; Guershon,30,0,30,0
1649850878753,MATH 18,A04,084121,Harel; Guershon,30,0,30,0
1649850884785,MATH 20B,A01,084124,Um; Ko Woon,33,0,35,2
1649850884785,MATH 20B,B01,084126,Um; Ko Woon,35,0,35,0
1649850890828,MATH 20C,A01,083446,Hammock; Frances H,26,0,30,4
1649850890828,MATH 20C,A02,083447,Hammock; Frances H,30,0,30,0
1649850890828,MATH 20C,A03,083448,Hammock; Frances H,30,0,30,0
1649850890828,MATH 20C,A04,083449,Hammock; Frances H,30,0,30,0
1649850890828,MATH 20C,B01,083451,Hammock; Frances H,29,0,30,1
1649850890828,MATH 20C,B02,083452,Hammock; Frances H,30,0,30,0
1649850890828,MATH 20C,B03,083453,Hammock; Frances H,30,0,30,0
1649850890828,MATH 20C,B04,083454,Hammock; Frances H,30,0,30,0
1649850896853,MATH 20D,A01,084128,Staff,29,0,30,1
1649850896853,MATH 20D,A02,084129,Staff,30,0,30,0
1649850896853,MATH 20D,A03,084130,Staff,29,0,30,1
1649850896853,MATH 20D,B01,084133,Staff,28,0,30,2
1649850896853,MATH 20D,B02,084134,Staff,30,0,30,0
1649850896853,MATH 20D,B03,084135,Staff,30,0,30,0
1649850902881,MATH 20E,A01,084138,Staff,27,0,30,3
1649850902881,MATH 20E,A02,084139,Staff,29,0,30,1
1649850902881,MATH 20E,A03,084140,Staff,28,0,30,2
1649850902881,MATH 20E,A04,084141,Staff,30,0,30,0
1649850908909,MATH 102,A01,084143,Harel; Guershon,24,0,30,6
1649850908909,MATH 102,A02,084144,Harel; Guershon,25,0,30,5
1649850914936,MATH 103B,A01,083456,Staff,0,0,30,30
1649850914936,MATH 103B,A02,083457,Staff,18,0,30,12
1649850920963,MATH 109,A01,084146,Salehi Golsefidy; Alireza,30,0,30,0
1649850920963,MATH 109,A02,084147,Salehi Golsefidy; Alireza,26,0,30,4
1649850926994,MATH 120A,A01,085445,Eggers; John Dietrich,30,0,35,5
1649850926994,MATH 120A,A02,085446,Eggers; John Dietrich,31,0,35,4
1649850933019,MATH 142B,A01,084149,Verstraete; Jacques Allan,7,0,30,23
1649850933019,MATH 142B,A02,084150,Verstraete; Jacques Allan,25,0,30,5
1649850939051,MATH 170A,A01,083459,Nie; Jiawang,9,0,30,21
1649850939051,MATH 170A,A02,083460,Nie; Jiawang,25,0,30,5
1649850939051,MATH 170A,A03,083461,Nie; Jiawang,26,0,30,4
1649850945081,MATH 193B,A01,083463,Staff,15,0,30,15
1649850945081,MATH 193B,A02,083464,Staff,19,0,30,11
1649850945081,MATH 193B,A03,083465,Staff,27,0,30,3
1649850951155,COGS 2,A01,083966,Boyle; Mary E. T.,27,0,30,3
1649850957185,COGS 9,A01,083968,Staff,56,0,60,4
1649850963222,COGS 14B,A01,083970,Staff,46,0,50,4
1649850969252,COGS 17,A01,092679,Staff,73,0,75,2
1649850975285,COGS 100,A01,083972,Staff,46,0,60,14
1649850987341,COGS 101C,A01,083976,Staff,25,0,30,5
1649850993367,COGS 102A,A01,083978,Johnson; Christine M.,24,0,30,6
1649850999392,COGS 107B,A01,083980,Staff,32,0,50,18
1649851005434,COGS 115,A01,083982,Staff,21,0,30,9
1649851011464,COGS 118B,A01,083367,Staff,5,0,40,35
1649851017499,COGS 172,A01,083984,Provenzano; Emily Kara,20,0,30,10
1649851023529,COGS 177,A00,083368,Staff,3,0,30,27
1649851029555,COGS 186,A01,083986,Staff,25,0,40,15
1649851035584,COGS 187A,A01,083988,Boyle; Mary E. T.,40,0,60,20
1649851041623,CSE 8A,A50,084003,Miranda; Gregory Joseph,9,0,15,6
1649851047653,CSE 11,A01,084005,Miranda; Gregory Joseph,49,0,55,6
1649851053783,CSE 20,A01,084007,Staff,15,0,20,5
1649851059813,CSE 21,A01,084009,Staff,32,0,50,18
1649851065837,CSE 30,A01,083370,Cao; Yingjun,20,0,40,20
1649851071862,CSE 100,A01,083372,Cao; Yingjun,13,0,40,27
1649851077893,CSE 101,A01,084011,Staff,0,16,40,40
1649851083924,CSE 141,A01,083374,Eldon; John,0,14,75,75
1649851089952,CSE 141L,A01,083376,Eldon; John,0,18,75,75
1649851095977,CSE 175,A01,084013,Kumar; Rakesh,24,0,25,1
1649851102006,CSE 190,A00,092508,Staff,15,0,15,0
1649851108040,ECE 5,A01,084049,Morris; Karcher William,17,0,20,3
1649851114068,ECE 100,A01,084051,Baghdadchi; Saharnaz,16,0,20,4
1649851114068,ECE 100,A02,091916,Baghdadchi; Saharnaz,18,0,20,2
1649851120103,ECE 101,A01,084053,Baghdadchi; Saharnaz,25,0,37,12
1649851120103,ECE 101,A02,084054,Baghdadchi; Saharnaz,37,0,37,0
1649851126137,ECE 107,A01,083390,Staff,31,0,40,9
1649851132164,ECE 148,A01,084056,Silberman; Jack,8,0,12,4
1649851138190,ECE 180,A00,083391,Abi Samra; Nicholas Camill,27,0,30,3
1649851138190,ECE 180,B00,083392,Abi Samra; Nicholas Camill,26,0,30,4
1649851144215,MATH 10B,A01,084110,Staff,20,0,30,10
1649851144215,MATH 10B,A02,084111,Staff,29,0,30,1
1649851144215,MATH 10B,A03,084112,Staff,29,0,30,1
1649851150241,MATH 10C,A01,083443,Staff,19,0,30,11
1649851150241,MATH 10C,A02,083444,Staff,24,0,30,6
1649851150241,MATH 10C,B01,084114,Staff,26,0,30,4
1649851150241,MATH 10C,B02,084115,Staff,30,0,30,0
1649851156269,MATH 18,A01,084117,Harel; Guershon,28,0,30,2
1649851156269,MATH 18,A02,084119,Harel; Guershon,29,0,30,1
1649851156269,MATH 18,A03,084120,Harel; Guershon,30,0,30,0
1649851156269,MATH 18,A04,084121,Harel; Guershon,30,0,30,0
1649851162304,MATH 20B,A01,084124,Um; Ko Woon,33,0,35,2
1649851162304,MATH 20B,B01,084126,Um; Ko Woon,35,0,35,0
1649851168331,MATH 20C,A01,083446,Hammock; Frances H,26,0,30,4
1649851168331,MATH 20C,A02,083447,Hammock; Frances H,30,0,30,0
1649851168331,MATH 20C,A03,083448,Hammock; Frances H,30,0,30,0
1649851168331,MATH 20C,A04,083449,Hammock; Frances H,30,0,30,0
1649851168331,MATH 20C,B01,083451,Hammock; Frances H,29,0,30,1
1649851168331,MATH 20C,B02,083452,Hammock; Frances H,30,0,30,0
1649851168331,MATH 20C,B03,083453,Hammock; Frances H,30,0,30,0
1649851168331,MATH 20C,B04,083454,Hammock; Frances H,30,0,30,0
1649851174361,MATH 20D,A01,084128,Staff,29,0,30,1
1649851174361,MATH 20D,A02,084129,Staff,30,0,30,0
1649851174361,MATH 20D,A03,084130,Staff,29,0,30,1
1649851174361,MATH 20D,B01,084133,Staff,28,0,30,2
1649851174361,MATH 20D,B02,084134,Staff,30,0,30,0
1649851174361,MATH 20D,B03,084135,Staff,30,0,30,0
1649851180419,MATH 20E,A01,084138,Staff,27,0,30,3
1649851180419,MATH 20E,A02,084139,Staff,29,0,30,1
1649851180419,MATH 20E,A03,084140,Staff,28,0,30,2
1649851180419,MATH 20E,A04,084141,Staff,30,0,30,0
1649851186453,MATH 102,A01,084143,Harel; Guershon,24,0,30,6
1649851186453,MATH 102,A02,084144,Harel; Guershon,25,0,30,5
1649851192478,MATH 103B,A01,083456,Staff,0,0,30,30
1649851192478,MATH 103B,A02,083457,Staff,18,0,30,12
1649851198512,MATH 109,A01,084146,Salehi Golsefidy; Alireza,30,0,30,0
1649851198512,MATH 109,A02,084147,Salehi Golsefidy; Alireza,26,0,30,4
1649851204538,MATH 120A,A01,085445,Eggers; John Dietrich,30,0,35,5
1649851204538,MATH 120A,A02,085446,Eggers; John Dietrich,31,0,35,4
1649851210562,MATH 142B,A01,084149,Verstraete; Jacques Allan,7,0,30,23
1649851210562,MATH 142B,A02,084150,Verstraete; Jacques Allan,25,0,30,5
1649851216589,MATH 170A,A01,083459,Nie; Jiawang,9,0,30,21
1649851216589,MATH 170A,A02,083460,Nie; Jiawang,25,0,30,5
1649851216589,MATH 170A,A03,083461,Nie; Jiawang,26,0,30,4
1649851222622,MATH 193B,A01,083463,Staff,15,0,30,15
1649851222622,MATH 193B,A02,083464,Staff,19,0,30,11
1649851222622,MATH 193B,A03,083465,Staff,27,0,30,3
1649851228704,COGS 2,A01,083966,Boyle; Mary E. T.,27,0,30,3
1649851234730,COGS 9,A01,083968,Staff,56,0,60,4
1649851240779,COGS 14B,A01,083970,Staff,46,0,50,4
1649851246809,COGS 17,A01,092679,Staff,73,0,75,2
1649851252842,COGS 100,A01,083972,Staff,46,0,60,14
1649851264905,COGS 101C,A01,083976,Staff,25,0,30,5
1649851270945,COGS 102A,A01,083978,Johnson; Christine M.,24,0,30,6
1649851276980,COGS 107B,A01,083980,Staff,32,0,50,18
1649851283006,COGS 115,A01,083982,Staff,21,0,30,9
1649851289031,COGS 118B,A01,083367,Staff,5,0,40,35
1649851295056,COGS 172,A01,083984,Provenzano; Emily Kara,20,0,30,10
1649851301083,COGS 177,A00,083368,Staff,3,0,30,27
1649851307110,COGS 186,A01,083986,Staff,25,0,40,15
1649851313134,COGS 187A,A01,083988,Boyle; Mary E. T.,40,0,60,20
1649851319159,CSE 8A,A50,084003,Miranda; Gregory Joseph,9,0,15,6
1649851325184,CSE 11,A01,084005,Miranda; Gregory Joseph,49,0,55,6
1649851331209,CSE 20,A01,084007,Staff,15,0,20,5
1649851337233,CSE 21,A01,084009,Staff,32,0,50,18
1649851343276,CSE 30,A01,083370,Cao; Yingjun,20,0,40,20
1649851349303,CSE 100,A01,083372,Cao; Yingjun,13,0,40,27
1649851355332,CSE 101,A01,084011,Staff,0,16,40,40
1649851361358,CSE 141,A01,083374,Eldon; John,0,14,75,75
1649851367383,CSE 141L,A01,083376,Eldon; John,0,18,75,75
1649851373419,CSE 175,A01,084013,Kumar; Rakesh,24,0,25,1
1649851379449,CSE 190,A00,092508,Staff,15,0,15,0
1649851385475,ECE 5,A01,084049,Morris; Karcher William,17,0,20,3
1649851391512,ECE 100,A01,084051,Baghdadchi; Saharnaz,16,0,20,4
1649851391512,ECE 100,A02,091916,Baghdadchi; Saharnaz,18,0,20,2
1649851397537,ECE 101,A01,084053,Baghdadchi; Saharnaz,25,0,37,12
1649851397537,ECE 101,A02,084054,Baghdadchi; Saharnaz,37,0,37,0
1649851403565,ECE 107,A01,083390,Staff,31,0,40,9
1649851409591,ECE 148,A01,084056,Silberman; Jack,8,0,12,4
1649851415617,ECE 180,A00,083391,Abi Samra; Nicholas Camill,27,0,30,3
1649851415617,ECE 180,B00,083392,Abi Samra; Nicholas Camill,26,0,30,4
1649851421648,MATH 10B,A01,084110,Staff,20,0,30,10
1649851421648,MATH 10B,A02,084111,Staff,29,0,30,1
1649851421648,MATH 10B,A03,084112,Staff,29,0,30,1
1649851427694,MATH 10C,A01,083443,Staff,19,0,30,11
1649851427694,MATH 10C,A02,083444,Staff,24,0,30,6
1649851427694,MATH 10C,B01,084114,Staff,26,0,30,4
1649851427694,MATH 10C,B02,084115,Staff,30,0,30,0
1649851433719,MATH 18,A01,084117,Harel; Guershon,28,0,30,2
1649851433719,MATH 18,A02,084119,Harel; Guershon,29,0,30,1
1649851433719,MATH 18,A03,084120,Harel; Guershon,30,0,30,0
1649851433719,MATH 18,A04,084121,Harel; Guershon,30,0,30,0
1649851439745,MATH 20B,A01,084124,Um; Ko Woon,33,0,35,2
1649851439745,MATH 20B,B01,084126,Um; Ko Woon,35,0,35,0
1649851445772,MATH 20C,A01,083446,Hammock; Frances H,26,0,30,4
1649851445772,MATH 20C,A02,083447,Hammock; Frances H,30,0,30,0
1649851445772,MATH 20C,A03,083448,Hammock; Frances H,30,0,30,0
1649851445772,MATH 20C,A04,083449,Hammock; Frances H,30,0,30,0
1649851445772,MATH 20C,B01,083451,Hammock; Frances H,29,0,30,1
1649851445772,MATH 20C,B02,083452,Hammock; Frances H,30,0,30,0
1649851445772,MATH 20C,B03,083453,Hammock; Frances H,30,0,30,0
1649851445772,MATH 20C,B04,083454,Hammock; Frances H,30,0,30,0
1649851451798,MATH 20D,A01,084128,Staff,29,0,30,1
1649851451798,MATH 20D,A02,084129,Staff,30,0,30,0
1649851451798,MATH 20D,A03,084130,Staff,29,0,30,1
1649851451798,MATH 20D,B01,084133,Staff,28,0,30,2
1649851451798,MATH 20D,B02,084134,Staff,30,0,30,0
1649851451798,MATH 20D,B03,084135,Staff,30,0,30,0
1649851457828,MATH 20E,A01,084138,Staff,27,0,30,3
1649851457828,MATH 20E,A02,084139,Staff,29,0,30,1
1649851457828,MATH 20E,A03,084140,Staff,28,0,30,2
1649851457828,MATH 20E,A04,084141,Staff,30,0,30,0
1649851463855,MATH 102,A01,084143,Harel; Guershon,24,0,30,6
1649851463855,MATH 102,A02,084144,Harel; Guershon,25,0,30,5
1649851469879,MATH 103B,A01,083456,Staff,0,0,30,30
1649851469879,MATH 103B,A02,083457,Staff,18,0,30,12
1649851475904,MATH 109,A01,084146,Salehi Golsefidy; Alireza,30,0,30,0
1649851475904,MATH 109,A02,084147,Salehi Golsefidy; Alireza,26,0,30,4
1649851481949,MATH 120A,A01,085445,Eggers; John Dietrich,30,0,35,5
1649851481949,MATH 120A,A02,085446,Eggers; John Dietrich,31,0,35,4
1649851487978,MATH 142B,A01,084149,Verstraete; Jacques Allan,7,0,30,23
1649851487978,MATH 142B,A02,084150,Verstraete; Jacques Allan,25,0,30,5
1649851494006,MATH 170A,A01,083459,Nie; Jiawang,9,0,30,21
1649851494006,MATH 170A,A02,083460,Nie; Jiawang,25,0,30,5
1649851494006,MATH 170A,A03,083461,Nie; Jiawang,26,0,30,4
1649851500039,MATH 193B,A01,083463,Staff,15,0,30,15
1649851500039,MATH 193B,A02,083464,Staff,19,0,30,11
1649851500039,MATH 193B,A03,083465,Staff,27,0,30,3
1649851506113,COGS 2,A01,083966,Boyle; Mary E. T.,27,0,30,3
1649851512139,COGS 9,A01,083968,Staff,56,0,60,4
1649851518172,COGS 14B,A01,083970,Staff,46,0,50,4
1649851524199,COGS 17,A01,092679,Staff,73,0,75,2
1649851530228,COGS 100,A01,083972,Staff,46,0,60,14
1649851542280,COGS 101C,A01,083976,Staff,25,0,30,5
1649851548307,COGS 102A,A01,083978,Johnson; Christine M.,24,0,30,6
1649851554339,COGS 107B,A01,083980,Staff,32,0,50,18
1649851560367,COGS 115,A01,083982,Staff,21,0,30,9
1649851566392,COGS 118B,A01,083367,Staff,5,0,40,35
1649851572421,COGS 172,A01,083984,Provenzano; Emily Kara,20,0,30,10
1649851578447,COGS 177,A00,083368,Staff,3,0,30,27
1649851584475,COGS 186,A01,083986,Staff,25,0,40,15
1649851590501,COGS 187A,A01,083988,Boyle; Mary E. T.,40,0,60,20
1649851596528,CSE 8A,A50,084003,Miranda; Gregory Joseph,9,0,15,6
1649851602558,CSE 11,A01,084005,Miranda; Gregory Joseph,49,0,55,6
1649851608587,CSE 20,A01,084007,Staff,15,0,20,5
1649851614619,CSE 21,A01,084009,Staff,32,0,50,18
1649851620648,CSE 30,A01,083370,Cao; Yingjun,20,0,40,20
1649851626683,CSE 100,A01,083372,Cao; Yingjun,13,0,40,27
1649851632708,CSE 101,A01,084011,Staff,0,16,40,40
1649851638735,CSE 141,A01,083374,Eldon; John,0,14,75,75
1649851644767,CSE 141L,A01,083376,Eldon; John,0,18,75,75
1649851650893,CSE 175,A01,084013,Kumar; Rakesh,24,0,25,1
1649851656919,CSE 190,A00,092508,Staff,15,0,15,0
1649851662949,ECE 5,A01,084049,Morris; Karcher William,17,0,20,3
1649851668978,ECE 100,A01,084051,Baghdadchi; Saharnaz,16,0,20,4
1649851668978,ECE 100,A02,091916,Baghdadchi; Saharnaz,18,0,20,2
1649851675007,ECE 101,A01,084053,Baghdadchi; Saharnaz,25,0,37,12
1649851675007,ECE 101,A02,084054,Baghdadchi; Saharnaz,37,0,37,0
1649851681034,ECE 107,A01,083390,Staff,31,0,40,9
1649851687061,ECE 148,A01,084056,Silberman; Jack,8,0,12,4
1649851693087,ECE 180,A00,083391,Abi Samra; Nicholas Camill,27,0,30,3
1649851693087,ECE 180,B00,083392,Abi Samra; Nicholas Camill,26,0,30,4
1649851699119,MATH 10B,A01,084110,Staff,20,0,30,10
1649851699119,MATH 10B,A02,084111,Staff,29,0,30,1
1649851699119,MATH 10B,A03,084112,Staff,29,0,30,1
1649851705145,MATH 10C,A01,083443,Staff,19,0,30,11
1649851705145,MATH 10C,A02,083444,Staff,24,0,30,6
1649851705145,MATH 10C,B01,084114,Staff,26,0,30,4
1649851705145,MATH 10C,B02,084115,Staff,30,0,30,0
1649851711176,MATH 18,A01,084117,Harel; Guershon,28,0,30,2
1649851711176,MATH 18,A02,084119,Harel; Guershon,29,0,30,1
1649851711176,MATH 18,A03,084120,Harel; Guershon,30,0,30,0
1649851711176,MATH 18,A04,084121,Harel; Guershon,30,0,30,0
1649851717204,MATH 20B,A01,084124,Um; Ko Woon,33,0,35,2
1649851717204,MATH 20B,B01,084126,Um; Ko Woon,35,0,35,0
1649851723237,MATH 20C,A01,083446,Hammock; Frances H,26,0,30,4
1649851723237,MATH 20C,A02,083447,Hammock; Frances H,30,0,30,0
1649851723237,MATH 20C,A03,083448,Hammock; Frances H,30,0,30,0
1649851723237,MATH 20C,A04,083449,Hammock; Frances H,30,0,30,0
1649851723237,MATH 20C,B01,083451,Hammock; Frances H,29,0,30,1
1649851723237,MATH 20C,B02,083452,Hammock; Frances H,30,0,30,0
1649851723237,MATH 20C,B03,083453,Hammock; Frances H,30,0,30,0
1649851723237,MATH 20C,B04,083454,Hammock; Frances H,30,0,30,0
1649851729265,MATH 20D,A01,084128,Staff,29,0,30,1
1649851729265,MATH 20D,A02,084129,Staff,30,0,30,0
1649851729265,MATH 20D,A03,084130,Staff,29,0,30,1
1649851729265,MATH 20D,B01,084133,Staff,28,0,30,2
1649851729265,MATH 20D,B02,084134,Staff,30,0,30,0
1649851729265,MATH 20D,B03,084135,Staff,30,0,30,0
1649851735290,MATH 20E,A01,084138,Staff,27,0,30,3
1649851735290,MATH 20E,A02,084139,Staff,29,0,30,1
1649851735290,MATH 20E,A03,084140,Staff,28,0,30,2
1649851735290,MATH 20E,A04,084141,Staff,30,0,30,0
1649851741315,MATH 102,A01,084143,Harel; Guershon,24,0,30,6
1649851741315,MATH 102,A02,084144,Harel; Guershon,25,0,30,5
1649851747340,MATH 103B,A01,083456,Staff,0,0,30,30
1649851747340,MATH 103B,A02,083457,Staff,18,0,30,12
1649851753366,MATH 109,A01,084146,Salehi Golsefidy; Alireza,30,0,30,0
1649851753366,MATH 109,A02,084147,Salehi Golsefidy; Alireza,26,0,30,4
1649851759403,MATH 120A,A01,085445,Eggers; John Dietrich,30,0,35,5
1649851759403,MATH 120A,A02,085446,Eggers; John Dietrich,31,0,35,4
1649851765429,MATH 142B,A01,084149,Verstraete; Jacques Allan,7,0,30,23
1649851765429,MATH 142B,A02,084150,Verstraete; Jacques Allan,25,0,30,5
1649851771453,MATH 170A,A01,083459,Nie; Jiawang,9,0,30,21
1649851771453,MATH 170A,A02,083460,Nie; Jiawang,25,0,30,5
1649851771453,MATH 170A,A03,083461,Nie; Jiawang,26,0,30,4
1649851777485,MATH 193B,A01,083463,Staff,15,0,30,15
1649851777485,MATH 193B,A02,083464,Staff,19,0,30,11
1649851777485,MATH 193B,A03,083465,Staff,27,0,30,3
1649851783559,COGS 2,A01,083966,Boyle; Mary E. T.,27,0,30,3
1649851789589,COGS 9,A01,083968,Staff,56,0,60,4
1649851795612,COGS 14B,A01,083970,Staff,46,0,50,4
1649851801637,COGS 17,A01,092679,Staff,73,0,75,2
1649851807665,COGS 100,A01,083972,Staff,46,0,60,14
1649851819736,COGS 101C,A01,083976,Staff,25,0,30,5
1649851825766,COGS 102A,A01,083978,Johnson; Christine M.,24,0,30,6
1649851831792,COGS 107B,A01,083980,Staff,32,0,50,18
1649851837821,COGS 115,A01,083982,Staff,21,0,30,9
1649851843845,COGS 118B,A01,083367,Staff,5,0,40,35
1649851849876,COGS 172,A01,083984,Provenzano; Emily Kara,20,0,30,10
1649851855905,COGS 177,A00,083368,Staff,3,0,30,27
1649851861935,COGS 186,A01,083986,Staff,25,0,40,15
1649851867963,COGS 187A,A01,083988,Boyle; Mary E. T.,40,0,60,20
1649851874001,CSE 8A,A50,084003,Miranda; Gregory Joseph,9,0,15,6
1649851880032,CSE 11,A01,084005,Miranda; Gregory Joseph,49,0,55,6
1649851886063,CSE 20,A01,084007,Staff,15,0,20,5
1649851892093,CSE 21,A01,084009,Staff,32,0,50,18
1649851898117,CSE 30,A01,083370,Cao; Yingjun,20,0,40,20
1649851904143,CSE 100,A01,083372,Cao; Yingjun,13,0,40,27
1649851910174,CSE 101,A01,084011,Staff,0,16,40,40
1649851916205,CSE 141,A01,083374,Eldon; John,0,14,75,75
1649851922234,CSE 141L,A01,083376,Eldon; John,0,18,75,75
1649851928263,CSE 175,A01,084013,Kumar; Rakesh,24,0,25,1
1649851934289,CSE 190,A00,092508,Staff,15,0,15,0
1649851940329,ECE 5,A01,084049,Morris; Karcher William,17,0,20,3
1649851946354,ECE 100,A01,084051,Baghdadchi; Saharnaz,16,0,20,4
1649851946354,ECE 100,A02,091916,Baghdadchi; Saharnaz,18,0,20,2
1649851952378,ECE 101,A01,084053,Baghdadchi; Saharnaz,25,0,37,12
1649851952378,ECE 101,A02,084054,Baghdadchi; Saharnaz,37,0,37,0
1649851958411,ECE 107,A01,083390,Staff,31,0,40,9
1649851964452,ECE 148,A01,084056,Silberman; Jack,8,0,12,4
1649851970482,ECE 180,A00,083391,Abi Samra; Nicholas Camill,27,0,30,3
1649851970482,ECE 180,B00,083392,Abi Samra; Nicholas Camill,26,0,30,4
1649851976514,MATH 10B,A01,084110,Staff,20,0,30,10
1649851976514,MATH 10B,A02,084111,Staff,29,0,30,1
1649851976514,MATH 10B,A03,084112,Staff,29,0,30,1
1649851982547,MATH 10C,A01,083443,Staff,19,0,30,11
1649851982547,MATH 10C,A02,083444,Staff,24,0,30,6
1649851982547,MATH 10C,B01,084114,Staff,26,0,30,4
1649851982547,MATH 10C,B02,084115,Staff,30,0,30,0
1649851988573,MATH 18,A01,084117,Harel; Guershon,28,0,30,2
1649851988573,MATH 18,A02,084119,Harel; Guershon,29,0,30,1
1649851988573,MATH 18,A03,084120,Harel; Guershon,30,0,30,0
1649851988573,MATH 18,A04,084121,Harel; Guershon,30,0,30,0
1649851994599,MATH 20B,A01,084124,Um; Ko Woon,33,0,35,2
1649851994599,MATH 20B,B01,084126,Um; Ko Woon,35,0,35,0
1649852000626,MATH 20C,A01,083446,Hammock; Frances H,26,0,30,4
1649852000626,MATH 20C,A02,083447,Hammock; Frances H,30,0,30,0
1649852000626,MATH 20C,A03,083448,Hammock; Frances H,30,0,30,0
1649852000626,MATH 20C,A04,083449,Hammock; Frances H,30,0,30,0
1649852000626,MATH 20C,B01,083451,Hammock; Frances H,29,0,30,1
1649852000626,MATH 20C,B02,083452,Hammock; Frances H,30,0,30,0
1649852000626,MATH 20C,B03,083453,Hammock; Frances H,30,0,30,0
1649852000626,MATH 20C,B04,083454,Hammock; Frances H,30,0,30,0
1649852006657,MATH 20D,A01,084128,Staff,29,0,30,1
1649852006657,MATH 20D,A02,084129,Staff,30,0,30,0
1649852006657,MATH 20D,A03,084130,Staff,29,0,30,1
1649852006657,MATH 20D,B01,084133,Staff,28,0,30,2
1649852006657,MATH 20D,B02,084134,Staff,30,0,30,0
1649852006657,MATH 20D,B03,084135,Staff,30,0,30,0
1649852012682,MATH 20E,A01,084138,Staff,27,0,30,3
1649852012682,MATH 20E,A02,084139,Staff,29,0,30,1
1649852012682,MATH 20E,A03,084140,Staff,28,0,30,2
1649852012682,MATH 20E,A04,084141,Staff,30,0,30,0
1649852018714,MATH 102,A01,084143,Harel; Guershon,24,0,30,6
1649852018714,MATH 102,A02,084144,Harel; Guershon,25,0,30,5
1649852024750,MATH 103B,A01,083456,Staff,0,0,30,30
1649852024750,MATH 103B,A02,083457,Staff,18,0,30,12
1649852030782,MATH 109,A01,084146,Salehi Golsefidy; Alireza,30,0,30,0
1649852030782,MATH 109,A02,084147,Salehi Golsefidy; Alireza,26,0,30,4
1649852036805,MATH 120A,A01,085445,Eggers; John Dietrich,30,0,35,5
1649852036805,MATH 120A,A02,085446,Eggers; John Dietrich,31,0,35,4
1649852042835,MATH 142B,A01,084149,Verstraete; Jacques Allan,7,0,30,23
1649852042835,MATH 142B,A02,084150,Verstraete; Jacques Allan,25,0,30,5
1649852048863,MATH 170A,A01,083459,Nie; Jiawang,9,0,30,21
1649852048863,MATH 170A,A02,083460,Nie; Jiawang,25,0,30,5
1649852048863,MATH 170A,A03,083461,Nie; Jiawang,26,0,30,4
1649852054888,MATH 193B,A01,083463,Staff,15,0,30,15
1649852054888,MATH 193B,A02,083464,Staff,19,0,30,11
1649852054888,MATH 193B,A03,083465,Staff,27,0,30,3
1649852060948,COGS 2,A01,083966,Boyle; Mary E. T.,27,0,30,3
1649852066972,COGS 9,A01,083968,Staff,56,0,60,4
1649852072999,COGS 14B,A01,083970,Staff,46,0,50,4
1649852079026,COGS 17,A01,092679,Staff,73,0,75,2
1649852085061,COGS 100,A01,083972,Staff,46,0,60,14
1649852097116,COGS 101C,A01,083976,Staff,25,0,30,5
1649852103141,COGS 102A,A01,083978,Johnson; Christine M.,24,0,30,6
1649852109167,COGS 107B,A01,083980,Staff,32,0,50,18
1649852115193,COGS 115,A01,083982,Staff,21,0,30,9
1649852121221,COGS 118B,A01,083367,Staff,5,0,40,35
1649852127257,COGS 172,A01,083984,Provenzano; Emily Kara,20,0,30,10
1649852133281,COGS 177,A00,083368,Staff,3,0,30,27
1649852139308,COGS 186,A01,083986,Staff,25,0,40,15
1649852145334,COGS 187A,A01,083988,Boyle; Mary E. T.,40,0,60,20
1649852151369,CSE 8A,A50,084003,Miranda; Gregory Joseph,9,0,15,6
1649852157395,CSE 11,A01,084005,Miranda; Gregory Joseph,49,0,55,6
1649852163424,CSE 20,A01,084007,Staff,15,0,20,5
1649852169457,CSE 21,A01,084009,Staff,32,0,50,18
1649852175482,CSE 30,A01,083370,Cao; Yingjun,20,0,40,20
1649852181514,CSE 100,A01,083372,Cao; Yingjun,13,0,40,27
1649852187540,CSE 101,A01,084011,Staff,0,16,40,40
1649852193567,CSE 141,A01,083374,Eldon; John,0,14,75,75
1649852199598,CSE 141L,A01,083376,Eldon; John,0,18,75,75
1649852205625,CSE 175,A01,084013,Kumar; Rakesh,24,0,25,1
1649852211653,CSE 190,A00,092508,Staff,15,0,15,0
1649852217687,ECE 5,A01,084049,Morris; Karcher William,17,0,20,3
1649852223723,ECE 100,A01,084051,Baghdadchi; Saharnaz,16,0,20,4
1649852223723,ECE 100,A02,091916,Baghdadchi; Saharnaz,18,0,20,2
1649852229753,ECE 101,A01,084053,Baghdadchi; Saharnaz,25,0,37,12
1649852229753,ECE 101,A02,084054,Baghdadchi; Saharnaz,37,0,37,0
1649852235782,ECE 107,A01,083390,Staff,31,0,40,9
1649852241810,ECE 148,A01,084056,Silberman; Jack,8,0,12,4
1649852247906,ECE 180,A00,083391,Abi Samra; Nicholas Camill,27,0,30,3
1649852247906,ECE 180,B00,083392,Abi Samra; Nicholas Camill,26,0,30,4
1649852253938,MATH 10B,A01,084110,Staff,20,0,30,10
1649852253938,MATH 10B,A02,084111,Staff,29,0,30,1
1649852253938,MATH 10B,A03,084112,Staff,29,0,30,1
1649852259970,MATH 10C,A01,083443,Staff,19,0,30,11
1649852259970,MATH 10C,A02,083444,Staff,24,0,30,6
1649852259970,MATH 10C,B01,084114,Staff,26,0,30,4
1649852259970,MATH 10C,B02,084115,Staff,30,0,30,0
1649852266009,MATH 18,A01,084117,Harel; Guershon,28,0,30,2
1649852266009,MATH 18,A02,084119,Harel; Guershon,29,0,30,1
1649852266009,MATH 18,A03,084120,Harel; Guershon,30,0,30,0
1649852266009,MATH 18,A04,084121,Harel; Guershon,30,0,30,0
1649852272036,MATH 20B,A01,084124,Um; Ko Woon,33,0,35,2
1649852272036,MATH 20B,B01,084126,Um; Ko Woon,35,0,35,0
1649852278062,MATH 20C,A01,083446,Hammock; Frances H,26,0,30,4
1649852278062,MATH 20C,A02,083447,Hammock; Frances H,30,0,30,0
1649852278062,MATH 20C,A03,083448,Hammock; Frances H,30,0,30,0
1649852278062,MATH 20C,A04,083449,Hammock; Frances H,30,0,30,0
1649852278062,MATH 20C,B01,083451,Hammock; Frances H,29,0,30,1
1649852278062,MATH 20C,B02,083452,Hammock; Frances H,30,0,30,0
1649852278062,MATH 20C,B03,083453,Hammock; Frances H,30,0,30,0
1649852278062,MATH 20C,B04,083454,Hammock; Frances H,30,0,30,0
1649852284088,MATH 20D,A01,084128,Staff,29,0,30,1
1649852284088,MATH 20D,A02,084129,Staff,30,0,30,0
1649852284088,MATH 20D,A03,084130,Staff,29,0,30,1
1649852284088,MATH 20D,B01,084133,Staff,28,0,30,2
1649852284088,MATH 20D,B02,084134,Staff,30,0,30,0
1649852284088,MATH 20D,B03,084135,Staff,30,0,30,0
1649852290111,MATH 20E,A01,084138,Staff,27,0,30,3
1649852290111,MATH 20E,A02,084139,Staff,29,0,30,1
1649852290111,MATH 20E,A03,084140,Staff,28,0,30,2
1649852290111,MATH 20E,A04,084141,Staff,30,0,30,0
1649852296141,MATH 102,A01,084143,Harel; Guershon,24,0,30,6
1649852296141,MATH 102,A02,084144,Harel; Guershon,25,0,30,5
1649852302165,MATH 103B,A01,083456,Staff,0,0,30,30
1649852302165,MATH 103B,A02,083457,Staff,18,0,30,12
1649852308191,MATH 109,A01,084146,Salehi Golsefidy; Alireza,30,0,30,0
1649852308191,MATH 109,A02,084147,Salehi Golsefidy; Alireza,26,0,30,4
1649852314226,MATH 120A,A01,085445,Eggers; John Dietrich,30,0,35,5
1649852314226,MATH 120A,A02,085446,Eggers; John Dietrich,31,0,35,4
1649852320265,MATH 142B,A01,084149,Verstraete; Jacques Allan,7,0,30,23
1649852320265,MATH 142B,A02,084150,Verstraete; Jacques Allan,25,0,30,5
1649852326297,MATH 170A,A01,083459,Nie; Jiawang,9,0,30,21
1649852326297,MATH 170A,A02,083460,Nie; Jiawang,25,0,30,5
1649852326297,MATH 170A,A03,083461,Nie; Jiawang,26,0,30,4
1649852332326,MATH 193B,A01,083463,Staff,15,0,30,15
1649852332326,MATH 193B,A02,083464,Staff,19,0,30,11
1649852332326,MATH 193B,A03,083465,Staff,27,0,30,3
1649852338402,COGS 2,A01,083966,Boyle; Mary E. T.,27,0,30,3
1649852344433,COGS 9,A01,083968,Staff,56,0,60,4
1649852350462,COGS 14B,A01,083970,Staff,46,0,50,4
1649852356488,COGS 17,A01,092679,Staff,73,0,75,2
1649852362514,COGS 100,A01,083972,Staff,46,0,60,14
1649852374574,COGS 101C,A01,083976,Staff,25,0,30,5
1649852380609,COGS 102A,A01,083978,Johnson; Christine M.,24,0,30,6
1649852386634,COGS 107B,A01,083980,Staff,32,0,50,18
1649852392658,COGS 115,A01,083982,Staff,21,0,30,9
1649852398692,COGS 118B,A01,083367,Staff,5,0,40,35
1649852404727,COGS 172,A01,083984,Provenzano; Emily Kara,20,0,30,10
1649852410756,COGS 177,A00,083368,Staff,3,0,30,27
1649852416781,COGS 186,A01,083986,Staff,25,0,40,15
1649852422806,COGS 187A,A01,083988,Boyle; Mary E. T.,40,0,60,20
1649852428834,CSE 8A,A50,084003,Miranda; Gregory Joseph,9,0,15,6
1649852434860,CSE 11,A01,084005,Miranda; Gregory Joseph,49,0,55,6
1649852440886,CSE 20,A01,084007,Staff,15,0,20,5
1649852446913,CSE 21,A01,084009,Staff,32,0,50,18
1649852452939,CSE 30,A01,083370,Cao; Yingjun,20,0,40,20
1649852458964,CSE 100,A01,083372,Cao; Yingjun,13,0,40,27
1649852464990,CSE 101,A01,084011,Staff,0,16,40,40
1649852471014,CSE 141,A01,083374,Eldon; John,0,14,75,75
1649852477044,CSE 141L,A01,083376,Eldon; John,0,18,75,75
1649852483076,CSE 175,A01,084013,Kumar; Rakesh,24,0,25,1
1649852489102,CSE 190,A00,092508,Staff,15,0,15,0
1649852495127,ECE 5,A01,084049,Morris; Karcher William,17,0,20,3
1649852501155,ECE 100,A01,084051,Baghdadchi; Saharnaz,16,0,20,4
1649852501155,ECE 100,A02,091916,Baghdadchi; Saharnaz,18,0,20,2
1649852507185,ECE 101,A01,084053,Baghdadchi; Saharnaz,25,0,37,12
1649852507185,ECE 101,A02,084054,Baghdadchi; Saharnaz,37,0,37,0
1649852513216,ECE 107,A01,083390,Staff,31,0,40,9
1649852519248,ECE 148,A01,084056,Silberman; Jack,8,0,12,4
1649852525275,ECE 180,A00,083391,Abi Samra; Nicholas Camill,27,0,30,3
1649852525275,ECE 180,B00,083392,Abi Samra; Nicholas Camill,26,0,30,4
1649852531316,MATH 10B,A01,084110,Staff,20,0,30,10
1649852531316,MATH 10B,A02,084111,Staff,29,0,30,1
1649852531316,MATH 10B,A03,084112,Staff,29,0,30,1
1649852537341,MATH 10C,A01,083443,Staff,19,0,30,11
1649852537341,MATH 10C,A02,083444,Staff,24,0,30,6
1649852537341,MATH 10C,B01,084114,Staff,26,0,30,4
1649852537341,MATH 10C,B02,084115,Staff,30,0,30,0
1649852543375,MATH 18,A01,084117,Harel; Guershon,28,0,30,2
1649852543375,MATH 18,A02,084119,Harel; Guershon,29,0,30,1
1649852543375,MATH 18,A03,084120,Harel; Guershon,30,0,30,0
1649852543375,MATH 18,A04,084121,Harel; Guershon,30,0,30,0
1649852549410,MATH 20B,A01,084124,Um; Ko Woon,33,0,35,2
1649852549410,MATH 20B,B01,084126,Um; Ko Woon,35,0,35,0
1649852555438,MATH 20C,A01,083446,Hammock; Frances H,26,0,30,4
1649852555438,MATH 20C,A02,083447,Hammock; Frances H,30,0,30,0
1649852555438,MATH 20C,A03,083448,Hammock; Frances H,30,0,30,0
1649852555438,MATH 20C,A04,083449,Hammock; Frances H,30,0,30,0
1649852555438,MATH 20C,B01,083451,Hammock; Frances H,29,0,30,1
1649852555438,MATH 20C,B02,083452,Hammock; Frances H,30,0,30,0
1649852555438,MATH 20C,B03,083453,Hammock; Frances H,30,0,30,0
1649852555438,MATH 20C,B04,083454,Hammock; Frances H,30,0,30,0
1649852561469,MATH 20D,A01,084128,Staff,29,0,30,1
1649852561469,MATH 20D,A02,084129,Staff,30,0,30,0
1649852561469,MATH 20D,A03,084130,Staff,29,0,30,1
1649852561469,MATH 20D,B01,084133,Staff,28,0,30,2
1649852561469,MATH 20D,B02,084134,Staff,30,0,30,0
1649852561469,MATH 20D,B03,084135,Staff,30,0,30,0
1649852567499,MATH 20E,A01,084138,Staff,27,0,30,3
1649852567499,MATH 20E,A02,084139,Staff,29,0,30,1
1649852567499,MATH 20E,A03,084140,Staff,28,0,30,2
1649852567499,MATH 20E,A04,084141,Staff,30,0,30,0
1649852573525,MATH 102,A01,084143,Harel; Guershon,24,0,30,6
1649852573525,MATH 102,A02,084144,Harel; Guershon,25,0,30,5
1649852579555,MATH 103B,A01,083456,Staff,0,0,30,30
1649852579555,MATH 103B,A02,083457,Staff,18,0,30,12
1649852585588,MATH 109,A01,084146,Salehi Golsefidy; Alireza,30,0,30,0
1649852585588,MATH 109,A02,084147,Salehi Golsefidy; Alireza,26,0,30,4
1649852591620,MATH 120A,A01,085445,Eggers; John Dietrich,30,0,35,5
1649852591620,MATH 120A,A02,085446,Eggers; John Dietrich,31,0,35,4
1649852597653,MATH 142B,A01,084149,Verstraete; Jacques Allan,7,0,30,23
1649852597653,MATH 142B,A02,084150,Verstraete; Jacques Allan,25,0,30,5
1649852603687,MATH 170A,A01,083459,Nie; Jiawang,9,0,30,21
1649852603687,MATH 170A,A02,083460,Nie; Jiawang,25,0,30,5
1649852603687,MATH 170A,A03,083461,Nie; Jiawang,26,0,30,4
1649852609711,MATH 193B,A01,083463,Staff,15,0,30,15
1649852609711,MATH 193B,A02,083464,Staff,19,0,30,11
1649852609711,MATH 193B,A03,083465,Staff,27,0,30,3
1649852615804,COGS 2,A01,083966,Boyle; Mary E. T.,27,0,30,3
1649852621838,COGS 9,A01,083968,Staff,56,0,60,4
1649852627868,COGS 14B,A01,083970,Staff,46,0,50,4
1649852633897,COGS 17,A01,092679,Staff,73,0,75,2
1649852639924,COGS 100,A01,083972,Staff,46,0,60,14
1649852651994,COGS 101C,A01,083976,Staff,25,0,30,5
1649852658022,COGS 102A,A01,083978,Johnson; Christine M.,24,0,30,6
1649852664049,COGS 107B,A01,083980,Staff,32,0,50,18
1649852670077,COGS 115,A01,083982,Staff,21,0,30,9
1649852676103,COGS 118B,A01,083367,Staff,5,0,40,35
1649852682164,COGS 172,A01,083984,Provenzano; Emily Kara,20,0,30,10
1649852688190,COGS 177,A00,083368,Staff,3,0,30,27
1649852694218,COGS 186,A01,083986,Staff,25,0,40,15
1649852700242,COGS 187A,A01,083988,Boyle; Mary E. T.,40,0,60,20
1649852706276,CSE 8A,A50,084003,Miranda; Gregory Joseph,9,0,15,6
1649852712303,CSE 11,A01,084005,Miranda; Gregory Joseph,49,0,55,6
1649852718335,CSE 20,A01,084007,Staff,15,0,20,5
1649852724362,CSE 21,A01,084009,Staff,32,0,50,18
1649852730391,CSE 30,A01,083370,Cao; Yingjun,20,0,40,20
1649852736419,CSE 100,A01,083372,Cao; Yingjun,13,0,40,27
1649852742456,CSE 101,A01,084011,Staff,0,16,40,40
1649852748483,CSE 141,A01,083374,Eldon; John,0,14,75,75
1649852754507,CSE 141L,A01,083376,Eldon; John,0,18,75,75
1649852760549,CSE 175,A01,084013,Kumar; Rakesh,24,0,25,1
1649852766575,CSE 190,A00,092508,Staff,15,0,15,0
1649852772607,ECE 5,A01,084049,Morris; Karcher William,17,0,20,3
1649852778633,ECE 100,A01,084051,Baghdadchi; Saharnaz,16,0,20,4
1649852778633,ECE 100,A02,091916,Baghdadchi; Saharnaz,18,0,20,2
1649852784661,ECE 101,A01,084053,Baghdadchi; Saharnaz,25,0,37,12
1649852784661,ECE 101,A02,084054,Baghdadchi; Saharnaz,37,0,37,0
1649852790690,ECE 107,A01,083390,Staff,31,0,40,9
1649852796722,ECE 148,A01,084056,Silberman; Jack,8,0,12,4
1649852802749,ECE 180,A00,083391,Abi Samra; Nicholas Camill,27,0,30,3
1649852802749,ECE 180,B00,083392,Abi Samra; Nicholas Camill,26,0,30,4
1649852808776,MATH 10B,A01,084110,Staff,20,0,30,10
1649852808776,MATH 10B,A02,084111,Staff,29,0,30,1
1649852808776,MATH 10B,A03,084112,Staff,29,0,30,1
1649852814803,MATH 10C,A01,083443,Staff,19,0,30,11
1649852814803,MATH 10C,A02,083444,Staff,24,0,30,6
1649852814803,MATH 10C,B01,084114,Staff,26,0,30,4
1649852814803,MATH 10C,B02,084115,Staff,30,0,30,0
1649852820829,MATH 18,A01,084117,Harel; Guershon,28,0,30,2
1649852820829,MATH 18,A02,084119,Harel; Guershon,29,0,30,1
1649852820829,MATH 18,A03,084120,Harel; Guershon,30,0,30,0
1649852820829,MATH 18,A04,084121,Harel; Guershon,30,0,30,0
1649852826860,MATH 20B,A01,084124,Um; Ko Woon,33,0,35,2
1649852826860,MATH 20B,B01,084126,Um; Ko Woon,35,0,35,0
1649852832902,MATH 20C,A01,083446,Hammock; Frances H,26,0,30,4
1649852832902,MATH 20C,A02,083447,Hammock; Frances H,30,0,30,0
1649852832902,MATH 20C,A03,083448,Hammock; Frances H,30,0,30,0
1649852832902,MATH 20C,A04,083449,Hammock; Frances H,30,0,30,0
1649852832902,MATH 20C,B01,083451,Hammock; Frances H,29,0,30,1
1649852832902,MATH 20C,B02,083452,Hammock; Frances H,30,0,30,0
1649852832902,MATH 20C,B03,083453,Hammock; Frances H,30,0,30,0
1649852832902,MATH 20C,B04,083454,Hammock; Frances H,30,0,30,0
1649852838928,MATH 20D,A01,084128,Staff,29,0,30,1
1649852838928,MATH 20D,A02,084129,Staff,30,0,30,0
1649852838928,MATH 20D,A03,084130,Staff,29,0,30,1
1649852838928,MATH 20D,B01,084133,Staff,28,0,30,2
1649852838928,MATH 20D,B02,084134,Staff,30,0,30,0
1649852838928,MATH 20D,B03,084135,Staff,30,0,30,0
1649852845032,MATH 20E,A01,084138,Staff,27,0,30,3
1649852845032,MATH 20E,A02,084139,Staff,29,0,30,1
1649852845032,MATH 20E,A03,084140,Staff,28,0,30,2
1649852845032,MATH 20E,A04,084141,Staff,30,0,30,0
1649852851059,MATH 102,A01,084143,Harel; Guershon,24,0,30,6
1649852851059,MATH 102,A02,084144,Harel; Guershon,25,0,30,5
1649852857084,MATH 103B,A01,083456,Staff,0,0,30,30
1649852857084,MATH 103B,A02,083457,Staff,18,0,30,12
1649852863116,MATH 109,A01,084146,Salehi Golsefidy; Alireza,30,0,30,0
1649852863116,MATH 109,A02,084147,Salehi Golsefidy; Alireza,26,0,30,4
1649852869144,MATH 120A,A01,085445,Eggers; John Dietrich,30,0,35,5
1649852869144,MATH 120A,A02,085446,Eggers; John Dietrich,31,0,35,4
1649852875182,MATH 142B,A01,084149,Verstraete; Jacques Allan,7,0,30,23
1649852875182,MATH 142B,A02,084150,Verstraete; Jacques Allan,25,0,30,5
1649852881208,MATH 170A,A01,083459,Nie; Jiawang,9,0,30,21
1649852881208,MATH 170A,A02,083460,Nie; Jiawang,25,0,30,5
1649852881208,MATH 170A,A03,083461,Nie; Jiawang,26,0,30,4
1649852887235,MATH 193B,A01,083463,Staff,15,0,30,15
1649852887235,MATH 193B,A02,083464,Staff,19,0,30,11
1649852887235,MATH 193B,A03,083465,Staff,27,0,30,3
1649852893299,COGS 2,A01,083966,Boyle; Mary E. T.,27,0,30,3
1649852899328,COGS 9,A01,083968,Staff,56,0,60,4
1649852905355,COGS 14B,A01,083970,Staff,46,0,50,4
1649852911383,COGS 17,A01,092679,Staff,73,0,75,2
1649852917412,COGS 100,A01,083972,Staff,46,0,60,14
1649852929469,COGS 101C,A01,083976,Staff,25,0,30,5
1649852935495,COGS 102A,A01,083978,Johnson; Christine M.,24,0,30,6
1649852941528,COGS 107B,A01,083980,Staff,32,0,50,18
1649852947555,COGS 115,A01,083982,Staff,21,0,30,9
1649852953580,COGS 118B,A01,083367,Staff,5,0,40,35
1649852959606,COGS 172,A01,083984,Provenzano; Emily Kara,20,0,30,10
1649852965633,COGS 177,A00,083368,Staff,3,0,30,27
1649852971656,COGS 186,A01,083986,Staff,25,0,40,15
1649852977686,COGS 187A,A01,083988,Boyle; Mary E. T.,40,0,60,20
1649852983715,CSE 8A,A50,084003,Miranda; Gregory Joseph,9,0,15,6
1649852989745,CSE 11,A01,084005,Miranda; Gregory Joseph,49,0,55,6
1649852995778,CSE 20,A01,084007,Staff,15,0,20,5
1649853001802,CSE 21,A01,084009,Staff,32,0,50,18
1649853007826,CSE 30,A01,083370,Cao; Yingjun,20,0,40,20
1649853013856,CSE 100,A01,083372,Cao; Yingjun,13,0,40,27
1649853019882,CSE 101,A01,084011,Staff,0,16,40,40
1649853025908,CSE 141,A01,083374,Eldon; John,0,14,75,75
1649853031942,CSE 141L,A01,083376,Eldon; John,0,18,75,75
1649853037973,CSE 175,A01,084013,Kumar; Rakesh,24,0,25,1
1649853044003,CSE 190,A00,092508,Staff,15,0,15,0
1649853050033,ECE 5,A01,084049,Morris; Karcher William,17,0,20,3
1649853056065,ECE 100,A01,084051,Baghdadchi; Saharnaz,16,0,20,4
1649853056065,ECE 100,A02,091916,Baghdadchi; Saharnaz,18,0,20,2
1649853062090,ECE 101,A01,084053,Baghdadchi; Saharnaz,25,0,37,12
1649853062090,ECE 101,A02,084054,Baghdadchi; Saharnaz,37,0,37,0
1649853068121,ECE 107,A01,083390,Staff,31,0,40,9
1649853074149,ECE 148,A01,084056,Silberman; Jack,8,0,12,4
1649853080174,ECE 180,A00,083391,Abi Samra; Nicholas Camill,27,0,30,3
1649853080174,ECE 180,B00,083392,Abi Samra; Nicholas Camill,26,0,30,4
1649853086206,MATH 10B,A01,084110,Staff,20,0,30,10
1649853086206,MATH 10B,A02,084111,Staff,29,0,30,1
1649853086206,MATH 10B,A03,084112,Staff,29,0,30,1
1649853092242,MATH 10C,A01,083443,Staff,19,0,30,11
1649853092242,MATH 10C,A02,083444,Staff,24,0,30,6
1649853092242,MATH 10C,B01,084114,Staff,26,0,30,4
1649853092242,MATH 10C,B02,084115,Staff,30,0,30,0
1649853098281,MATH 18,A01,084117,Harel; Guershon,28,0,30,2
1649853098281,MATH 18,A02,084119,Harel; Guershon,29,0,30,1
1649853098281,MATH 18,A03,084120,Harel; Guershon,30,0,30,0
1649853098281,MATH 18,A04,084121,Harel; Guershon,30,0,30,0
1649853104307,MATH 20B,A01,084124,Um; Ko Woon,33,0,35,2
1649853104307,MATH 20B,B01,084126,Um; Ko Woon,35,0,35,0
1649853110341,MATH 20C,A01,083446,Hammock; Frances H,26,0,30,4
1649853110341,MATH 20C,A02,083447,Hammock; Frances H,30,0,30,0
1649853110341,MATH 20C,A03,083448,Hammock; Frances H,30,0,30,0
1649853110341,MATH 20C,A04,083449,Hammock; Frances H,30,0,30,0
1649853110341,MATH 20C,B01,083451,Hammock; Frances H,29,0,30,1
1649853110341,MATH 20C,B02,083452,Hammock; Frances H,30,0,30,0
1649853110341,MATH 20C,B03,083453,Hammock; Frances H,30,0,30,0
1649853110341,MATH 20C,B04,083454,Hammock; Frances H,30,0,30,0
1649853116372,MATH 20D,A01,084128,Staff,29,0,30,1
1649853116372,MATH 20D,A02,084129,Staff,30,0,30,0
1649853116372,MATH 20D,A03,084130,Staff,29,0,30,1
1649853116372,MATH 20D,B01,084133,Staff,28,0,30,2
1649853116372,MATH 20D,B02,084134,Staff,30,0,30,0
1649853116372,MATH 20D,B03,084135,Staff,30,0,30,0
1649853122397,MATH 20E,A01,084138,Staff,27,0,30,3
1649853122397,MATH 20E,A02,084139,Staff,29,0,30,1
1649853122397,MATH 20E,A03,084140,Staff,28,0,30,2
1649853122397,MATH 20E,A04,084141,Staff,30,0,30,0
1649853128427,MATH 102,A01,084143,Harel; Guershon,24,0,30,6
1649853128427,MATH 102,A02,084144,Harel; Guershon,25,0,30,5
1649853134461,MATH 103B,A01,083456,Staff,0,0,30,30
1649853134461,MATH 103B,A02,083457,Staff,18,0,30,12
1649853140493,MATH 109,A01,084146,Salehi Golsefidy; Alireza,30,0,30,0
1649853140493,MATH 109,A02,084147,Salehi Golsefidy; Alireza,26,0,30,4
1649853146518,MATH 120A,A01,085445,Eggers; John Dietrich,30,0,35,5
1649853146518,MATH 120A,A02,085446,Eggers; John Dietrich,31,0,35,4
1649853152547,MATH 142B,A01,084149,Verstraete; Jacques Allan,7,0,30,23
1649853152547,MATH 142B,A02,084150,Verstraete; Jacques Allan,25,0,30,5
1649853158577,MATH 170A,A01,083459,Nie; Jiawang,9,0,30,21
1649853158577,MATH 170A,A02,083460,Nie; Jiawang,25,0,30,5
1649853158577,MATH 170A,A03,083461,Nie; Jiawang,26,0,30,4
1649853164601,MATH 193B,A01,083463,Staff,15,0,30,15
1649853164601,MATH 193B,A02,083464,Staff,19,0,30,11
1649853164601,MATH 193B,A03,083465,Staff,27,0,30,3
1649853170677,COGS 2,A01,083966,Boyle; Mary E. T.,27,0,30,3
1649853176710,COGS 9,A01,083968,Staff,56,0,60,4
1649853182738,COGS 14B,A01,083970,Staff,46,0,50,4
1649853188770,COGS 17,A01,092679,Staff,73,0,75,2
1649853194799,COGS 100,A01,083972,Staff,46,0,60,14
1649853206849,COGS 101C,A01,083976,Staff,25,0,30,5
1649853212884,COGS 102A,A01,083978,Johnson; Christine M.,24,0,30,6
1649853218917,COGS 107B,A01,083980,Staff,32,0,50,18
1649853224943,COGS 115,A01,083982,Staff,21,0,30,9
1649853230966,COGS 118B,A01,083367,Staff,5,0,40,35
1649853236998,COGS 172,A01,083984,Provenzano; Emily Kara,20,0,30,10
1649853243030,COGS 177,A00,083368,Staff,3,0,30,27
1649853249054,COGS 186,A01,083986,Staff,25,0,40,15
1649853255090,COGS 187A,A01,083988,Boyle; Mary E. T.,40,0,60,20
1649853261115,CSE 8A,A50,084003,Miranda; Gregory Joseph,9,0,15,6
1649853267141,CSE 11,A01,084005,Miranda; Gregory Joseph,49,0,55,6
1649853273166,CSE 20,A01,084007,Staff,15,0,20,5
1649853279205,CSE 21,A01,084009,Staff,32,0,50,18
1649853285230,CSE 30,A01,083370,Cao; Yingjun,20,0,40,20
1649853291256,CSE 100,A01,083372,Cao; Yingjun,13,0,40,27
1649853297282,CSE 101,A01,084011,Staff,0,16,40,40
1649853303311,CSE 141,A01,083374,Eldon; John,0,14,75,75
1649853309335,CSE 141L,A01,083376,Eldon; John,0,18,75,75
1649853315360,CSE 175,A01,084013,Kumar; Rakesh,24,0,25,1
1649853321389,CSE 190,A00,092508,Staff,15,0,15,0
1649853327416,ECE 5,A01,084049,Morris; Karcher William,17,0,20,3
1649853333441,ECE 100,A01,084051,Baghdadchi; Saharnaz,16,0,20,4
1649853333441,ECE 100,A02,091916,Baghdadchi; Saharnaz,18,0,20,2
1649853339467,ECE 101,A01,084053,Baghdadchi; Saharnaz,25,0,37,12
1649853339467,ECE 101,A02,084054,Baghdadchi; Saharnaz,37,0,37,0
1649853345501,ECE 107,A01,083390,Staff,31,0,40,9
1649853351533,ECE 148,A01,084056,Silberman; Jack,8,0,12,4
1649853357562,ECE 180,A00,083391,Abi Samra; Nicholas Camill,27,0,30,3
1649853357562,ECE 180,B00,083392,Abi Samra; Nicholas Camill,26,0,30,4
1649853363587,MATH 10B,A01,084110,Staff,20,0,30,10
1649853363587,MATH 10B,A02,084111,Staff,29,0,30,1
1649853363587,MATH 10B,A03,084112,Staff,29,0,30,1
1649853369616,MATH 10C,A01,083443,Staff,19,0,30,11
1649853369616,MATH 10C,A02,083444,Staff,24,0,30,6
1649853369616,MATH 10C,B01,084114,Staff,26,0,30,4
1649853369616,MATH 10C,B02,084115,Staff,30,0,30,0
1649853375647,MATH 18,A01,084117,Harel; Guershon,28,0,30,2
1649853375647,MATH 18,A02,084119,Harel; Guershon,29,0,30,1
1649853375647,MATH 18,A03,084120,Harel; Guershon,30,0,30,0
1649853375647,MATH 18,A04,084121,Harel; Guershon,30,0,30,0
1649853381672,MATH 20B,A01,084124,Um; Ko Woon,33,0,35,2
1649853381672,MATH 20B,B01,084126,Um; Ko Woon,35,0,35,0
1649853387700,MATH 20C,A01,083446,Hammock; Frances H,26,0,30,4
1649853387700,MATH 20C,A02,083447,Hammock; Frances H,30,0,30,0
1649853387700,MATH 20C,A03,083448,Hammock; Frances H,30,0,30,0
1649853387700,MATH 20C,A04,083449,Hammock; Frances H,30,0,30,0
1649853387700,MATH 20C,B01,083451,Hammock; Frances H,29,0,30,1
1649853387700,MATH 20C,B02,083452,Hammock; Frances H,30,0,30,0
1649853387700,MATH 20C,B03,083453,Hammock; Frances H,30,0,30,0
1649853387700,MATH 20C,B04,083454,Hammock; Frances H,30,0,30,0
1649853393725,MATH 20D,A01,084128,Staff,29,0,30,1
1649853393725,MATH 20D,A02,084129,Staff,30,0,30,0
1649853393725,MATH 20D,A03,084130,Staff,29,0,30,1
1649853393725,MATH 20D,B01,084133,Staff,28,0,30,2
1649853393725,MATH 20D,B02,084134,Staff,30,0,30,0
1649853393725,MATH 20D,B03,084135,Staff,30,0,30,0
1649853399750,MATH 20E,A01,084138,Staff,27,0,30,3
1649853399750,MATH 20E,A02,084139,Staff,29,0,30,1
1649853399750,MATH 20E,A03,084140,Staff,28,0,30,2
1649853399750,MATH 20E,A04,084141,Staff,30,0,30,0
1649853405779,MATH 102,A01,084143,Harel; Guershon,24,0,30,6
1649853405779,MATH 102,A02,084144,Harel; Guershon,25,0,30,5
1649853411804,MATH 103B,A01,083456,Staff,0,0,30,30
1649853411804,MATH 103B,A02,083457,Staff,18,0,30,12
1649853417836,MATH 109,A01,084146,Salehi Golsefidy; Alireza,30,0,30,0
1649853417836,MATH 109,A02,084147,Salehi Golsefidy; Alireza,26,0,30,4
1649853423862,MATH 120A,A01,085445,Eggers; John Dietrich,30,0,35,5
1649853423862,MATH 120A,A02,085446,Eggers; John Dietrich,31,0,35,4
1649853429888,MATH 142B,A01,084149,Verstraete; Jacques Allan,7,0,30,23
1649853429888,MATH 142B,A02,084150,Verstraete; Jacques Allan,25,0,30,5
1649853435919,MATH 170A,A01,083459,Nie; Jiawang,9,0,30,21
1649853435919,MATH 170A,A02,083460,Nie; Jiawang,25,0,30,5
1649853435919,MATH 170A,A03,083461,Nie; Jiawang,26,0,30,4
1649853442033,MATH 193B,A01,083463,Staff,15,0,30,15
1649853442033,MATH 193B,A02,083464,Staff,19,0,30,11
1649853442033,MATH 193B,A03,083465,Staff,27,0,30,3
1649853448108,COGS 2,A01,083966,Boyle; Mary E. T.,27,0,30,3
1649853454132,COGS 9,A01,083968,Staff,56,0,60,4
1649853460161,COGS 14B,A01,083970,Staff,46,0,50,4
1649853466191,COGS 17,A01,092679,Staff,73,0,75,2
1649853472219,COGS 100,A01,083972,Staff,46,0,60,14
1649853484271,COGS 101C,A01,083976,Staff,25,0,30,5
1649853490296,COGS 102A,A01,083978,Johnson; Christine M.,24,0,30,6
1649853496321,COGS 107B,A01,083980,Staff,32,0,50,18
1649853502345,COGS 115,A01,083982,Staff,21,0,30,9
1649853508371,COGS 118B,A01,083367,Staff,5,0,40,35
1649853514401,COGS 172,A01,083984,Provenzano; Emily Kara,20,0,30,10
1649853520426,COGS 177,A00,083368,Staff,3,0,30,27
1649853526450,COGS 186,A01,083986,Staff,25,0,40,15
1649853532479,COGS 187A,A01,083988,Boyle; Mary E. T.,40,0,60,20
1649853538504,CSE 8A,A50,084003,Miranda; Gregory Joseph,9,0,15,6
1649853544529,CSE 11,A01,084005,Miranda; Gregory Joseph,49,0,55,6
1649853550555,CSE 20,A01,084007,Staff,15,0,20,5
1649853556580,CSE 21,A01,084009,Staff,32,0,50,18
1649853562605,CSE 30,A01,083370,Cao; Yingjun,20,0,40,20
1649853568633,CSE 100,A01,083372,Cao; Yingjun,13,0,40,27
1649853574657,CSE 101,A01,084011,Staff,0,16,40,40
1649853580690,CSE 141,A01,083374,Eldon; John,0,14,75,75
1649853586725,CSE 141L,A01,083376,Eldon; John,0,18,75,75
1649853592752,CSE 175,A01,084013,Kumar; Rakesh,24,0,25,1
1649853598780,CSE 190,A00,092508,Staff,15,0,15,0
1649853604808,ECE 5,A01,084049,Morris; Karcher William,17,0,20,3
1649853610835,ECE 100,A01,084051,Baghdadchi; Saharnaz,16,0,20,4
1649853610835,ECE 100,A02,091916,Baghdadchi; Saharnaz,18,0,20,2
1649853616866,ECE 101,A01,084053,Baghdadchi; Saharnaz,25,0,37,12
1649853616866,ECE 101,A02,084054,Baghdadchi; Saharnaz,37,0,37,0
1649853622890,ECE 107,A01,083390,Staff,31,0,40,9
1649853628917,ECE 148,A01,084056,Silberman; Jack,8,0,12,4
1649853634947,ECE 180,A00,083391,Abi Samra; Nicholas Camill,27,0,30,3
1649853634947,ECE 180,B00,083392,Abi Samra; Nicholas Camill,26,0,30,4
1649853640977,MATH 10B,A01,084110,Staff,20,0,30,10
1649853640977,MATH 10B,A02,084111,Staff,29,0,30,1
1649853640977,MATH 10B,A03,084112,Staff,29,0,30,1
1649853647001,MATH 10C,A01,083443,Staff,19,0,30,11
1649853647001,MATH 10C,A02,083444,Staff,24,0,30,6
1649853647001,MATH 10C,B01,084114,Staff,26,0,30,4
1649853647001,MATH 10C,B02,084115,Staff,30,0,30,0
1649853653032,MATH 18,A01,084117,Harel; Guershon,28,0,30,2
1649853653032,MATH 18,A02,084119,Harel; Guershon,29,0,30,1
1649853653032,MATH 18,A03,084120,Harel; Guershon,30,0,30,0
1649853653032,MATH 18,A04,084121,Harel; Guershon,30,0,30,0
1649853659058,MATH 20B,A01,084124,Um; Ko Woon,33,0,35,2
1649853659058,MATH 20B,B01,084126,Um; Ko Woon,35,0,35,0
1649853665084,MATH 20C,A01,083446,Hammock; Frances H,26,0,30,4
1649853665084,MATH 20C,A02,083447,Hammock; Frances H,30,0,30,0
1649853665084,MATH 20C,A03,083448,Hammock; Frances H,30,0,30,0
1649853665084,MATH 20C,A04,083449,Hammock; Frances H,30,0,30,0
1649853665084,MATH 20C,B01,083451,Hammock; Frances H,29,0,30,1
1649853665084,MATH 20C,B02,083452,Hammock; Frances H,30,0,30,0
1649853665084,MATH 20C,B03,083453,Hammock; Frances H,30,0,30,0
1649853665084,MATH 20C,B04,083454,Hammock; Frances H,30,0,30,0
1649853671115,MATH 20D,A01,084128,Staff,29,0,30,1
1649853671115,MATH 20D,A02,084129,Staff,30,0,30,0
1649853671115,MATH 20D,A03,084130,Staff,29,0,30,1
1649853671115,MATH 20D,B01,084133,Staff,28,0,30,2
1649853671115,MATH 20D,B02,084134,Staff,30,0,30,0
1649853671115,MATH 20D,B03,084135,Staff,30,0,30,0
1649853677140,MATH 20E,A01,084138,Staff,27,0,30,3
1649853677140,MATH 20E,A02,084139,Staff,29,0,30,1
1649853677140,MATH 20E,A03,084140,Staff,28,0,30,2
1649853677140,MATH 20E,A04,084141,Staff,30,0,30,0
1649853683164,MATH 102,A01,084143,Harel; Guershon,24,0,30,6
1649853683164,MATH 102,A02,084144,Harel; Guershon,25,0,30,5
1649853689193,MATH 103B,A01,083456,Staff,0,0,30,30
1649853689193,MATH 103B,A02,083457,Staff,18,0,30,12
1649853695223,MATH 109,A01,084146,Salehi Golsefidy; Alireza,30,0,30,0
1649853695223,MATH 109,A02,084147,Salehi Golsefidy; Alireza,26,0,30,4
1649853701258,MATH 120A,A01,085445,Eggers; John Dietrich,30,0,35,5
1649853701258,MATH 120A,A02,085446,Eggers; John Dietrich,31,0,35,4
1649853707289,MATH 142B,A01,084149,Verstraete; Jacques Allan,7,0,30,23
1649853707289,MATH 142B,A02,084150,Verstraete; Jacques Allan,25,0,30,5
1649853713315,MATH 170A,A01,083459,Nie; Jiawang,9,0,30,21
1649853713315,MATH 170A,A02,083460,Nie; Jiawang,25,0,30,5
1649853713315,MATH 170A,A03,083461,Nie; Jiawang,26,0,30,4
1649853719349,MATH 193B,A01,083463,Staff,15,0,30,15
1649853719349,MATH 193B,A02,083464,Staff,19,0,30,11
1649853719349,MATH 193B,A03,083465,Staff,27,0,30,3
1649853725410,COGS 2,A01,083966,Boyle; Mary E. T.,27,0,30,3
1649853731442,COGS 9,A01,083968,Staff,56,0,60,4
1649853737466,COGS 14B,A01,083970,Staff,46,0,50,4
1649853743494,COGS 17,A01,092679,Staff,73,0,75,2
1649853749520,COGS 100,A01,083972,Staff,46,0,60,14
1649853761573,COGS 101C,A01,083976,Staff,25,0,30,5
1649853767598,COGS 102A,A01,083978,Johnson; Christine M.,24,0,30,6
1649853773624,COGS 107B,A01,083980,Staff,32,0,50,18
1649853779655,COGS 115,A01,083982,Staff,21,0,30,9
1649853785681,COGS 118B,A01,083367,Staff,5,0,40,35
1649853791713,COGS 172,A01,083984,Provenzano; Emily Kara,20,0,30,10
1649853797740,COGS 177,A00,083368,Staff,2,0,30,28
1649853803765,COGS 186,A01,083986,Staff,25,0,40,15
1649853809793,COGS 187A,A01,083988,Boyle; Mary E. T.,40,0,60,20
1649853815817,CSE 8A,A50,084003,Miranda; Gregory Joseph,9,0,15,6
1649853821846,CSE 11,A01,084005,Miranda; Gregory Joseph,49,0,55,6
1649853827869,CSE 20,A01,084007,Staff,15,0,20,5
1649853833899,CSE 21,A01,084009,Staff,32,0,50,18
1649853839926,CSE 30,A01,083370,Cao; Yingjun,20,0,40,20
1649853845954,CSE 100,A01,083372,Cao; Yingjun,13,0,40,27
1649853851981,CSE 101,A01,084011,Staff,0,16,40,40
1649853858009,CSE 141,A01,083374,Eldon; John,0,14,75,75
1649853864037,CSE 141L,A01,083376,Eldon; John,0,18,75,75
1649853870071,CSE 175,A01,084013,Kumar; Rakesh,24,0,25,1
1649853876099,CSE 190,A00,092508,Staff,15,0,15,0
1649853882127,ECE 5,A01,084049,Morris; Karcher William,17,0,20,3
1649853888152,ECE 100,A01,084051,Baghdadchi; Saharnaz,16,0,20,4
1649853888152,ECE 100,A02,091916,Baghdadchi; Saharnaz,18,0,20,2
1649853894178,ECE 101,A01,084053,Baghdadchi; Saharnaz,25,0,37,12
1649853894178,ECE 101,A02,084054,Baghdadchi; Saharnaz,37,0,37,0
1649853900208,ECE 107,A01,083390,Staff,31,0,40,9
1649853906235,ECE 148,A01,084056,Silberman; Jack,8,0,12,4
1649853912261,ECE 180,A00,083391,Abi Samra; Nicholas Camill,27,0,30,3
1649853912261,ECE 180,B00,083392,Abi Samra; Nicholas Camill,26,0,30,4
1649853918289,MATH 10B,A01,084110,Staff,20,0,30,10
1649853918289,MATH 10B,A02,084111,Staff,29,0,30,1
1649853918289,MATH 10B,A03,084112,Staff,29,0,30,1
1649853924315,MATH 10C,A01,083443,Staff,19,0,30,11
1649853924315,MATH 10C,A02,083444,Staff,24,0,30,6
1649853924315,MATH 10C,B01,084114,Staff,26,0,30,4
1649853924315,MATH 10C,B02,084115,Staff,30,0,30,0
1649853930344,MATH 18,A01,084117,Harel; Guershon,28,0,30,2
1649853930344,MATH 18,A02,084119,Harel; Guershon,29,0,30,1
1649853930344,MATH 18,A03,084120,Harel; Guershon,30,0,30,0
1649853930344,MATH 18,A04,084121,Harel; Guershon,30,0,30,0
1649853936374,MATH 20B,A01,084124,Um; Ko Woon,33,0,35,2
1649853936374,MATH 20B,B01,084126,Um; Ko Woon,35,0,35,0
1649853942404,MATH 20C,A01,083446,Hammock; Frances H,26,0,30,4
1649853942404,MATH 20C,A02,083447,Hammock; Frances H,30,0,30,0
1649853942404,MATH 20C,A03,083448,Hammock; Frances H,30,0,30,0
1649853942404,MATH 20C,A04,083449,Hammock; Frances H,30,0,30,0
1649853942404,MATH 20C,B01,083451,Hammock; Frances H,29,0,30,1
1649853942404,MATH 20C,B02,083452,Hammock; Frances H,30,0,30,0
1649853942404,MATH 20C,B03,083453,Hammock; Frances H,30,0,30,0
1649853942404,MATH 20C,B04,083454,Hammock; Frances H,30,0,30,0
1649853948428,MATH 20D,A01,084128,Staff,29,0,30,1
1649853948428,MATH 20D,A02,084129,Staff,30,0,30,0
1649853948428,MATH 20D,A03,084130,Staff,29,0,30,1
1649853948428,MATH 20D,B01,084133,Staff,28,0,30,2
1649853948428,MATH 20D,B02,084134,Staff,30,0,30,0
1649853948428,MATH 20D,B03,084135,Staff,30,0,30,0
1649853954454,MATH 20E,A01,084138,Staff,27,0,30,3
1649853954454,MATH 20E,A02,084139,Staff,29,0,30,1
1649853954454,MATH 20E,A03,084140,Staff,28,0,30,2
1649853954454,MATH 20E,A04,084141,Staff,30,0,30,0
1649853960483,MATH 102,A01,084143,Harel; Guershon,24,0,30,6
1649853960483,MATH 102,A02,084144,Harel; Guershon,25,0,30,5
1649853966512,MATH 103B,A01,083456,Staff,0,0,30,30
1649853966512,MATH 103B,A02,083457,Staff,18,0,30,12
1649853972541,MATH 109,A01,084146,Salehi Golsefidy; Alireza,30,0,30,0
1649853972541,MATH 109,A02,084147,Salehi Golsefidy; Alireza,26,0,30,4
1649853978569,MATH 120A,A01,085445,Eggers; John Dietrich,30,0,35,5
1649853978569,MATH 120A,A02,085446,Eggers; John Dietrich,31,0,35,4
1649853984594,MATH 142B,A01,084149,Verstraete; Jacques Allan,7,0,30,23
1649853984594,MATH 142B,A02,084150,Verstraete; Jacques Allan,25,0,30,5
1649853990620,MATH 170A,A01,083459,Nie; Jiawang,9,0,30,21
1649853990620,MATH 170A,A02,083460,Nie; Jiawang,25,0,30,5
1649853990620,MATH 170A,A03,083461,Nie; Jiawang,26,0,30,4
1649853996646,MATH 193B,A01,083463,Staff,15,0,30,15
1649853996646,MATH 193B,A02,083464,Staff,19,0,30,11
1649853996646,MATH 193B,A03,083465,Staff,27,0,30,3
1649854002709,COGS 2,A01,083966,Boyle; Mary E. T.,27,0,30,3
1649854008740,COGS 9,A01,083968,Staff,56,0,60,4
1649854014765,COGS 14B,A01,083970,Staff,46,0,50,4
1649854020790,COGS 17,A01,092679,Staff,73,0,75,2
1649854026825,COGS 100,A01,083972,Staff,46,0,60,14
1649854038955,COGS 101C,A01,083976,Staff,25,0,30,5
1649854044986,COGS 102A,A01,083978,Johnson; Christine M.,24,0,30,6
1649854051011,COGS 107B,A01,083980,Staff,32,0,50,18
1649854057038,COGS 115,A01,083982,Staff,21,0,30,9
1649854063078,COGS 118B,A01,083367,Staff,5,0,40,35
1649854069106,COGS 172,A01,083984,Provenzano; Emily Kara,20,0,30,10
1649854075137,COGS 177,A00,083368,Staff,2,0,30,28
1649854081165,COGS 186,A01,083986,Staff,25,0,40,15
1649854087197,COGS 187A,A01,083988,Boyle; Mary E. T.,40,0,60,20
1649854093223,CSE 8A,A50,084003,Miranda; Gregory Joseph,9,0,15,6
1649854099249,CSE 11,A01,084005,Miranda; Gregory Joseph,49,0,55,6
1649854105277,CSE 20,A01,084007,Staff,15,0,20,5
1649854111302,CSE 21,A01,084009,Staff,32,0,50,18
1649854117339,CSE 30,A01,083370,Cao; Yingjun,20,0,40,20
1649854123365,CSE 100,A01,083372,Cao; Yingjun,13,0,40,27
1649854129389,CSE 101,A01,084011,Staff,0,16,40,40
1649854135415,CSE 141,A01,083374,Eldon; John,0,14,75,75
1649854141441,CSE 141L,A01,083376,Eldon; John,0,18,75,75
1649854147467,CSE 175,A01,084013,Kumar; Rakesh,24,0,25,1
1649854153501,CSE 190,A00,092508,Staff,15,0,15,0
1649854159529,ECE 5,A01,084049,Morris; Karcher William,17,0,20,3
1649854165559,ECE 100,A01,084051,Baghdadchi; Saharnaz,16,0,20,4
1649854165559,ECE 100,A02,091916,Baghdadchi; Saharnaz,18,0,20,2
1649854171584,ECE 101,A01,084053,Baghdadchi; Saharnaz,25,0,37,12
1649854171584,ECE 101,A02,084054,Baghdadchi; Saharnaz,37,0,37,0
1649854177614,ECE 107,A01,083390,Staff,31,0,40,9
1649854183642,ECE 148,A01,084056,Silberman; Jack,8,0,12,4
1649854189668,ECE 180,A00,083391,Abi Samra; Nicholas Camill,27,0,30,3
1649854189668,ECE 180,B00,083392,Abi Samra; Nicholas Camill,26,0,30,4
1649854195696,MATH 10B,A01,084110,Staff,20,0,30,10
1649854195696,MATH 10B,A02,084111,Staff,29,0,30,1
1649854195696,MATH 10B,A03,084112,Staff,29,0,30,1
1649854201729,MATH 10C,A01,083443,Staff,19,0,30,11
1649854201729,MATH 10C,A02,083444,Staff,24,0,30,6
1649854201729,MATH 10C,B01,084114,Staff,26,0,30,4
1649854201729,MATH 10C,B02,084115,Staff,30,0,30,0
1649854207758,MATH 18,A01,084117,Harel; Guershon,28,0,30,2
1649854207758,MATH 18,A02,084119,Harel; Guershon,29,0,30,1
1649854207758,MATH 18,A03,084120,Harel; Guershon,30,0,30,0
1649854207758,MATH 18,A04,084121,Harel; Guershon,30,0,30,0
1649854213785,MATH 20B,A01,084124,Um; Ko Woon,33,0,35,2
1649854213785,MATH 20B,B01,084126,Um; Ko Woon,35,0,35,0
1649854219814,MATH 20C,A01,083446,Hammock; Frances H,26,0,30,4
1649854219814,MATH 20C,A02,083447,Hammock; Frances H,30,0,30,0
1649854219814,MATH 20C,A03,083448,Hammock; Frances H,30,0,30,0
1649854219814,MATH 20C,A04,083449,Hammock; Frances H,30,0,30,0
1649854219814,MATH 20C,B01,083451,Hammock; Frances H,29,0,30,1
1649854219814,MATH 20C,B02,083452,Hammock; Frances H,30,0,30,0
1649854219814,MATH 20C,B03,083453,Hammock; Frances H,30,0,30,0
1649854219814,MATH 20C,B04,083454,Hammock; Frances H,30,0,30,0
1649854225850,MATH 20D,A01,084128,Staff,29,0,30,1
1649854225850,MATH 20D,A02,084129,Staff,30,0,30,0
1649854225850,MATH 20D,A03,084130,Staff,29,0,30,1
1649854225850,MATH 20D,B01,084133,Staff,28,0,30,2
1649854225850,MATH 20D,B02,084134,Staff,30,0,30,0
1649854225850,MATH 20D,B03,084135,Staff,30,0,30,0
1649854231874,MATH 20E,A01,084138,Staff,27,0,30,3
1649854231874,MATH 20E,A02,084139,Staff,29,0,30,1
1649854231874,MATH 20E,A03,084140,Staff,28,0,30,2
1649854231874,MATH 20E,A04,084141,Staff,30,0,30,0
1649854237900,MATH 102,A01,084143,Harel; Guershon,24,0,30,6
1649854237900,MATH 102,A02,084144,Harel; Guershon,25,0,30,5
1649854243926,MATH 103B,A01,083456,Staff,0,0,30,30
1649854243926,MATH 103B,A02,083457,Staff,18,0,30,12
1649854249951,MATH 109,A01,084146,Salehi Golsefidy; Alireza,30,0,30,0
1649854249951,MATH 109,A02,084147,Salehi Golsefidy; Alireza,26,0,30,4
1649854255981,MATH 120A,A01,085445,Eggers; John Dietrich,30,0,35,5
1649854255981,MATH 120A,A02,085446,Eggers; John Dietrich,31,0,35,4
1649854262007,MATH 142B,A01,084149,Verstraete; Jacques Allan,7,0,30,23
1649854262007,MATH 142B,A02,084150,Verstraete; Jacques Allan,25,0,30,5
1649854268041,MATH 170A,A01,083459,Nie; Jiawang,9,0,30,21
1649854268041,MATH 170A,A02,083460,Nie; Jiawang,25,0,30,5
1649854268041,MATH 170A,A03,083461,Nie; Jiawang,26,0,30,4
1649854274066,MATH 193B,A01,083463,Staff,15,0,30,15
1649854274066,MATH 193B,A02,083464,Staff,19,0,30,11
1649854274066,MATH 193B,A03,083465,Staff,27,0,30,3
1649854280161,COGS 2,A01,083966,Boyle; Mary E. T.,27,0,30,3
1649854286188,COGS 9,A01,083968,Staff,56,0,60,4
1649854292221,COGS 14B,A01,083970,Staff,46,0,50,4
1649854298250,COGS 17,A01,092679,Staff,73,0,75,2
1649854304277,COGS 100,A01,083972,Staff,46,0,60,14
1649854316330,COGS 101C,A01,083976,Staff,25,0,30,5
1649854322356,COGS 102A,A01,083978,Johnson; Christine M.,24,0,30,6
1649854328386,COGS 107B,A01,083980,Staff,32,0,50,18
1649854334415,COGS 115,A01,083982,Staff,21,0,30,9
1649854340460,COGS 118B,A01,083367,Staff,5,0,40,35
1649854346492,COGS 172,A01,083984,Provenzano; Emily Kara,20,0,30,10
1649854352518,COGS 177,A00,083368,Staff,2,0,30,28
1649854358547,COGS 186,A01,083986,Staff,25,0,40,15
1649854364572,COGS 187A,A01,083988,Boyle; Mary E. T.,40,0,60,20
1649854370599,CSE 8A,A50,084003,Miranda; Gregory Joseph,9,0,15,6
1649854376631,CSE 11,A01,084005,Miranda; Gregory Joseph,49,0,55,6
1649854382667,CSE 20,A01,084007,Staff,15,0,20,5
1649854388691,CSE 21,A01,084009,Staff,32,0,50,18
1649854394726,CSE 30,A01,083370,Cao; Yingjun,20,0,40,20
1649854400756,CSE 100,A01,083372,Cao; Yingjun,13,0,40,27
1649854406781,CSE 101,A01,084011,Staff,0,16,40,40
1649854412807,CSE 141,A01,083374,Eldon; John,0,14,75,75
1649854418834,CSE 141L,A01,083376,Eldon; John,0,18,75,75
1649854424859,CSE 175,A01,084013,Kumar; Rakesh,24,0,25,1
1649854430885,CSE 190,A00,092508,Staff,15,0,15,0
1649854436915,ECE 5,A01,084049,Morris; Karcher William,17,0,20,3
1649854442941,ECE 100,A01,084051,Baghdadchi; Saharnaz,16,0,20,4
1649854442941,ECE 100,A02,091916,Baghdadchi; Saharnaz,18,0,20,2
1649854448971,ECE 101,A01,084053,Baghdadchi; Saharnaz,25,0,37,12
1649854448971,ECE 101,A02,084054,Baghdadchi; Saharnaz,37,0,37,0
1649854454997,ECE 107,A01,083390,Staff,31,0,40,9
1649854461022,ECE 148,A01,084056,Silberman; Jack,8,0,12,4
1649854467049,ECE 180,A00,083391,Abi Samra; Nicholas Camill,27,0,30,3
1649854467049,ECE 180,B00,083392,Abi Samra; Nicholas Camill,26,0,30,4
1649854473079,MATH 10B,A01,084110,Staff,20,0,30,10
1649854473079,MATH 10B,A02,084111,Staff,29,0,30,1
1649854473079,MATH 10B,A03,084112,Staff,29,0,30,1
1649854479111,MATH 10C,A01,083443,Staff,19,0,30,11
1649854479111,MATH 10C,A02,083444,Staff,24,0,30,6
1649854479111,MATH 10C,B01,084114,Staff,26,0,30,4
1649854479111,MATH 10C,B02,084115,Staff,30,0,30,0
1649854485137,MATH 18,A01,084117,Harel; Guershon,28,0,30,2
1649854485137,MATH 18,A02,084119,Harel; Guershon,29,0,30,1
1649854485137,MATH 18,A03,084120,Harel; Guershon,30,0,30,0
1649854485137,MATH 18,A04,084121,Harel; Guershon,30,0,30,0
1649854491168,MATH 20B,A01,084124,Um; Ko Woon,33,0,35,2
1649854491168,MATH 20B,B01,084126,Um; Ko Woon,35,0,35,0
1649854497195,MATH 20C,A01,083446,Hammock; Frances H,26,0,30,4
1649854497195,MATH 20C,A02,083447,Hammock; Frances H,30,0,30,0
1649854497195,MATH 20C,A03,083448,Hammock; Frances H,30,0,30,0
1649854497195,MATH 20C,A04,083449,Hammock; Frances H,30,0,30,0
1649854497195,MATH 20C,B01,083451,Hammock; Frances H,29,0,30,1
1649854497195,MATH 20C,B02,083452,Hammock; Frances H,30,0,30,0
1649854497195,MATH 20C,B03,083453,Hammock; Frances H,30,0,30,0
1649854497195,MATH 20C,B04,083454,Hammock; Frances H,30,0,30,0
1649854503224,MATH 20D,A01,084128,Staff,29,0,30,1
1649854503224,MATH 20D,A02,084129,Staff,30,0,30,0
1649854503224,MATH 20D,A03,084130,Staff,29,0,30,1
1649854503224,MATH 20D,B01,084133,Staff,28,0,30,2
1649854503224,MATH 20D,B02,084134,Staff,30,0,30,0
1649854503224,MATH 20D,B03,084135,Staff,30,0,30,0
1649854509254,MATH 20E,A01,084138,Staff,27,0,30,3
1649854509254,MATH 20E,A02,084139,Staff,29,0,30,1
1649854509254,MATH 20E,A03,084140,Staff,28,0,30,2
1649854509254,MATH 20E,A04,084141,Staff,30,0,30,0
1649854515280,MATH 102,A01,084143,Harel; Guershon,24,0,30,6
1649854515280,MATH 102,A02,084144,Harel; Guershon,25,0,30,5
1649854521304,MATH 103B,A01,083456,Staff,0,0,30,30
1649854521304,MATH 103B,A02,083457,Staff,18,0,30,12
1649854527331,MATH 109,A01,084146,Salehi Golsefidy; Alireza,30,0,30,0
1649854527331,MATH 109,A02,084147,Salehi Golsefidy; Alireza,26,0,30,4
1649854533355,MATH 120A,A01,085445,Eggers; John Dietrich,30,0,35,5
1649854533355,MATH 120A,A02,085446,Eggers; John Dietrich,31,0,35,4
1649854539402,MATH 142B,A01,084149,Verstraete; Jacques Allan,7,0,30,23
1649854539402,MATH 142B,A02,084150,Verstraete; Jacques Allan,25,0,30,5
1649854545436,MATH 170A,A01,083459,Nie; Jiawang,9,0,30,21
1649854545436,MATH 170A,A02,083460,Nie; Jiawang,25,0,30,5
1649854545436,MATH 170A,A03,083461,Nie; Jiawang,26,0,30,4
1649854551461,MATH 193B,A01,083463,Staff,15,0,30,15
1649854551461,MATH 193B,A02,083464,Staff,19,0,30,11
1649854551461,MATH 193B,A03,083465,Staff,27,0,30,3
1649854557546,COGS 2,A01,083966,Boyle; Mary E. T.,27,0,30,3
1649854563573,COGS 9,A01,083968,Staff,56,0,60,4
1649854569598,COGS 14B,A01,083970,Staff,46,0,50,4
1649854575622,COGS 17,A01,092679,Staff,73,0,75,2
1649854581647,COGS 100,A01,083972,Staff,46,0,60,14
1649854593709,COGS 101C,A01,083976,Staff,25,0,30,5
1649854599737,COGS 102A,A01,083978,Johnson; Christine M.,24,0,30,6
1649854605762,COGS 107B,A01,083980,Staff,32,0,50,18
1649854611785,COGS 115,A01,083982,Staff,21,0,30,9
1649854617814,COGS 118B,A01,083367,Staff,5,0,40,35
1649854623839,COGS 172,A01,083984,Provenzano; Emily Kara,20,0,30,10
1649854629938,COGS 177,A00,083368,Staff,2,0,30,28
1649854635962,COGS 186,A01,083986,Staff,25,0,40,15
1649854641987,COGS 187A,A01,083988,Boyle; Mary E. T.,40,0,60,20
1649854648016,CSE 8A,A50,084003,Miranda; Gregory Joseph,9,0,15,6
1649854654048,CSE 11,A01,084005,Miranda; Gregory Joseph,49,0,55,6
1649854660071,CSE 20,A01,084007,Staff,15,0,20,5
1649854666097,CSE 21,A01,084009,Staff,32,0,50,18
1649854672126,CSE 30,A01,083370,Cao; Yingjun,20,0,40,20
1649854678151,CSE 100,A01,083372,Cao; Yingjun,13,0,40,27
1649854684181,CSE 101,A01,084011,Staff,0,16,40,40
1649854690224,CSE 141,A01,083374,Eldon; John,0,14,75,75
1649854696249,CSE 141L,A01,083376,Eldon; John,0,18,75,75
1649854702278,CSE 175,A01,084013,Kumar; Rakesh,24,0,25,1
1649854708301,CSE 190,A00,092508,Staff,15,0,15,0
1649854714332,ECE 5,A01,084049,Morris; Karcher William,17,0,20,3
1649854720355,ECE 100,A01,084051,Baghdadchi; Saharnaz,16,0,20,4
1649854720355,ECE 100,A02,091916,Baghdadchi; Saharnaz,18,0,20,2
1649854726380,ECE 101,A01,084053,Baghdadchi; Saharnaz,25,0,37,12
1649854726380,ECE 101,A02,084054,Baghdadchi; Saharnaz,37,0,37,0
1649854732411,ECE 107,A01,083390,Staff,31,0,40,9
1649854738435,ECE 148,A01,084056,Silberman; Jack,8,0,12,4
1649854744465,ECE 180,A00,083391,Abi Samra; Nicholas Camill,27,0,30,3
1649854744465,ECE 180,B00,083392,Abi Samra; Nicholas Camill,26,0,30,4
1649854750495,MATH 10B,A01,084110,Staff,20,0,30,10
1649854750495,MATH 10B,A02,084111,Staff,29,0,30,1
1649854750495,MATH 10B,A03,084112,Staff,29,0,30,1
1649854756520,MATH 10C,A01,083443,Staff,19,0,30,11
1649854756520,MATH 10C,A02,083444,Staff,24,0,30,6
1649854756520,MATH 10C,B01,084114,Staff,26,0,30,4
1649854756520,MATH 10C,B02,084115,Staff,30,0,30,0
1649854762549,MATH 18,A01,084117,Harel; Guershon,28,0,30,2
1649854762549,MATH 18,A02,084119,Harel; Guershon,29,0,30,1
1649854762549,MATH 18,A03,084120,Harel; Guershon,30,0,30,0
1649854762549,MATH 18,A04,084121,Harel; Guershon,30,0,30,0
1649854768578,MATH 20B,A01,084124,Um; Ko Woon,33,0,35,2
1649854768578,MATH 20B,B01,084126,Um; Ko Woon,35,0,35,0
1649854774604,MATH 20C,A01,083446,Hammock; Frances H,26,0,30,4
1649854774604,MATH 20C,A02,083447,Hammock; Frances H,30,0,30,0
1649854774604,MATH 20C,A03,083448,Hammock; Frances H,30,0,30,0
1649854774604,MATH 20C,A04,083449,Hammock; Frances H,30,0,30,0
1649854774604,MATH 20C,B01,083451,Hammock; Frances H,29,0,30,1
1649854774604,MATH 20C,B02,083452,Hammock; Frances H,30,0,30,0
1649854774604,MATH 20C,B03,083453,Hammock; Frances H,30,0,30,0
1649854774604,MATH 20C,B04,083454,Hammock; Frances H,30,0,30,0
1649854780630,MATH 20D,A01,084128,Staff,29,0,30,1
1649854780630,MATH 20D,A02,084129,Staff,30,0,30,0
1649854780630,MATH 20D,A03,084130,Staff,29,0,30,1
1649854780630,MATH 20D,B01,084133,Staff,28,0,30,2
1649854780630,MATH 20D,B02,084134,Staff,30,0,30,0
1649854780630,MATH 20D,B03,084135,Staff,30,0,30,0
1649854786656,MATH 20E,A01,084138,Staff,27,0,30,3
1649854786656,MATH 20E,A02,084139,Staff,29,0,30,1
1649854786656,MATH 20E,A03,084140,Staff,28,0,30,2
1649854786656,MATH 20E,A04,084141,Staff,30,0,30,0
1649854792686,MATH 102,A01,084143,Harel; Guershon,24,0,30,6
1649854792686,MATH 102,A02,084144,Harel; Guershon,25,0,30,5
1649854798709,MATH 103B,A01,083456,Staff,0,0,30,30
1649854798709,MATH 103B,A02,083457,Staff,18,0,30,12
1649854804733,MATH 109,A01,084146,Salehi Golsefidy; Alireza,30,0,30,0
1649854804733,MATH 109,A02,084147,Salehi Golsefidy; Alireza,26,0,30,4
1649854810786,MATH 120A,A01,085445,Eggers; John Dietrich,30,0,35,5
1649854810786,MATH 120A,A02,085446,Eggers; John Dietrich,31,0,35,4
1649854816814,MATH 142B,A01,084149,Verstraete; Jacques Allan,7,0,30,23
1649854816814,MATH 142B,A02,084150,Verstraete; Jacques Allan,25,0,30,5
1649854822840,MATH 170A,A01,083459,Nie; Jiawang,9,0,30,21
1649854822840,MATH 170A,A02,083460,Nie; Jiawang,25,0,30,5
1649854822840,MATH 170A,A03,083461,Nie; Jiawang,26,0,30,4
1649854828876,MATH 193B,A01,083463,Staff,15,0,30,15
1649854828876,MATH 193B,A02,083464,Staff,19,0,30,11
1649854828876,MATH 193B,A03,083465,Staff,27,0,30,3
1649854834961,COGS 2,A01,083966,Boyle; Mary E. T.,27,0,30,3
1649854840985,COGS 9,A01,083968,Staff,56,0,60,4
1649854847015,COGS 14B,A01,083970,Staff,46,0,50,4
1649854853041,COGS 17,A01,092679,Staff,73,0,75,2
1649854859069,COGS 100,A01,083972,Staff,46,0,60,14
1649854871128,COGS 101C,A01,083976,Staff,25,0,30,5
1649854877155,COGS 102A,A01,083978,Johnson; Christine M.,24,0,30,6
1649854883180,COGS 107B,A01,083980,Staff,32,0,50,18
1649854889204,COGS 115,A01,083982,Staff,21,0,30,9
1649854895234,COGS 118B,A01,083367,Staff,5,0,40,35
1649854901260,COGS 172,A01,083984,Provenzano; Emily Kara,20,0,30,10
1649854907285,COGS 177,A00,083368,Staff,2,0,30,28
1649854913316,COGS 186,A01,083986,Staff,25,0,40,15
1649854919341,COGS 187A,A01,083988,Boyle; Mary E. T.,40,0,60,20
1649854925374,CSE 8A,A50,084003,Miranda; Gregory Joseph,9,0,15,6
1649854931403,CSE 11,A01,084005,Miranda; Gregory Joseph,49,0,55,6
1649854937429,CSE 20,A01,084007,Staff,15,0,20,5
1649854943453,CSE 21,A01,084009,Staff,32,0,50,18
1649854949483,CSE 30,A01,083370,Cao; Yingjun,20,0,40,20
1649854955509,CSE 100,A01,083372,Cao; Yingjun,13,0,40,27
1649854961533,CSE 101,A01,084011,Staff,0,16,40,40
1649854967561,CSE 141,A01,083374,Eldon; John,0,14,75,75
1649854973589,CSE 141L,A01,083376,Eldon; John,0,18,75,75
1649854979620,CSE 175,A01,084013,Kumar; Rakesh,24,0,25,1
1649854985647,CSE 190,A00,092508,Staff,15,0,15,0
1649854991674,ECE 5,A01,084049,Morris; Karcher William,17,0,20,3
1649854997701,ECE 100,A01,084051,Baghdadchi; Saharnaz,16,0,20,4
1649854997701,ECE 100,A02,091916,Baghdadchi; Saharnaz,18,0,20,2
1649855003731,ECE 101,A01,084053,Baghdadchi; Saharnaz,25,0,37,12
1649855003731,ECE 101,A02,084054,Baghdadchi; Saharnaz,37,0,37,0
1649855009756,ECE 107,A01,083390,Staff,31,0,40,9
1649855015786,ECE 148,A01,084056,Silberman; Jack,8,0,12,4
1649855021816,ECE 180,A00,083391,Abi Samra; Nicholas Camill,27,0,30,3
1649855021816,ECE 180,B00,083392,Abi Samra; Nicholas Camill,26,0,30,4
1649855027848,MATH 10B,A01,084110,Staff,20,0,30,10
1649855027848,MATH 10B,A02,084111,Staff,29,0,30,1
1649855027848,MATH 10B,A03,084112,Staff,29,0,30,1
1649855033880,MATH 10C,A01,083443,Staff,19,0,30,11
1649855033880,MATH 10C,A02,083444,Staff,24,0,30,6
1649855033880,MATH 10C,B01,084114,Staff,26,0,30,4
1649855033880,MATH 10C,B02,084115,Staff,30,0,30,0
1649855039904,MATH 18,A01,084117,Harel; Guershon,28,0,30,2
1649855039904,MATH 18,A02,084119,Harel; Guershon,29,0,30,1
1649855039904,MATH 18,A03,084120,Harel; Guershon,30,0,30,0
1649855039904,MATH 18,A04,084121,Harel; Guershon,30,0,30,0
1649855045935,MATH 20B,A01,084124,Um; Ko Woon,33,0,35,2
1649855045935,MATH 20B,B01,084126,Um; Ko Woon,35,0,35,0
1649855051966,MATH 20C,A01,083446,Hammock; Frances H,26,0,30,4
1649855051966,MATH 20C,A02,083447,Hammock; Frances H,30,0,30,0
1649855051966,MATH 20C,A03,083448,Hammock; Frances H,30,0,30,0
1649855051966,MATH 20C,A04,083449,Hammock; Frances H,30,0,30,0
1649855051966,MATH 20C,B01,083451,Hammock; Frances H,29,0,30,1
1649855051966,MATH 20C,B02,083452,Hammock; Frances H,30,0,30,0
1649855051966,MATH 20C,B03,083453,Hammock; Frances H,30,0,30,0
1649855051966,MATH 20C,B04,083454,Hammock; Frances H,30,0,30,0
1649855057994,MATH 20D,A01,084128,Staff,29,0,30,1
1649855057994,MATH 20D,A02,084129,Staff,30,0,30,0
1649855057994,MATH 20D,A03,084130,Staff,29,0,30,1
1649855057994,MATH 20D,B01,084133,Staff,28,0,30,2
1649855057994,MATH 20D,B02,084134,Staff,30,0,30,0
1649855057994,MATH 20D,B03,084135,Staff,30,0,30,0
1649855064024,MATH 20E,A01,084138,Staff,27,0,30,3
1649855064024,MATH 20E,A02,084139,Staff,29,0,30,1
1649855064024,MATH 20E,A03,084140,Staff,28,0,30,2
1649855064024,MATH 20E,A04,084141,Staff,30,0,30,0
1649855070050,MATH 102,A01,084143,Harel; Guershon,24,0,30,6
1649855070050,MATH 102,A02,084144,Harel; Guershon,25,0,30,5
1649855076072,MATH 103B,A01,083456,Staff,0,0,30,30
1649855076072,MATH 103B,A02,083457,Staff,18,0,30,12
1649855082097,MATH 109,A01,084146,Salehi Golsefidy; Alireza,30,0,30,0
1649855082097,MATH 109,A02,084147,Salehi Golsefidy; Alireza,26,0,30,4
1649855088127,MATH 120A,A01,085445,Eggers; John Dietrich,30,0,35,5
1649855088127,MATH 120A,A02,085446,Eggers; John Dietrich,31,0,35,4
1649855094151,MATH 142B,A01,084149,Verstraete; Jacques Allan,7,0,30,23
1649855094151,MATH 142B,A02,084150,Verstraete; Jacques Allan,25,0,30,5
1649855100176,MATH 170A,A01,083459,Nie; Jiawang,9,0,30,21
1649855100176,MATH 170A,A02,083460,Nie; Jiawang,25,0,30,5
1649855100176,MATH 170A,A03,083461,Nie; Jiawang,26,0,30,4
1649855106205,MATH 193B,A01,083463,Staff,15,0,30,15
1649855106205,MATH 193B,A02,083464,Staff,19,0,30,11
1649855106205,MATH 193B,A03,083465,Staff,27,0,30,3
1649855112269,COGS 2,A01,083966,Boyle; Mary E. T.,27,0,30,3
1649855118295,COGS 9,A01,083968,Staff,56,0,60,4
1649855124325,COGS 14B,A01,083970,Staff,46,0,50,4
1649855130349,COGS 17,A01,092679,Staff,73,0,75,2
1649855136376,COGS 100,A01,083972,Staff,46,0,60,14
1649855148425,COGS 101C,A01,083976,Staff,25,0,30,5
1649855154451,COGS 102A,A01,083978,Johnson; Christine M.,24,0,30,6
1649855160474,COGS 107B,A01,083980,Staff,32,0,50,18
1649855166508,COGS 115,A01,083982,Staff,21,0,30,9
1649855172534,COGS 118B,A01,083367,Staff,5,0,40,35
1649855178558,COGS 172,A01,083984,Provenzano; Emily Kara,20,0,30,10
1649855184594,COGS 177,A00,083368,Staff,2,0,30,28
1649855190621,COGS 186,A01,083986,Staff,25,0,40,15
1649855196648,COGS 187A,A01,083988,Boyle; Mary E. T.,40,0,60,20
1649855202674,CSE 8A,A50,084003,Miranda; Gregory Joseph,9,0,15,6
1649855208698,CSE 11,A01,084005,Miranda; Gregory Joseph,49,0,55,6
1649855214725,CSE 20,A01,084007,Staff,15,0,20,5
1649855220752,CSE 21,A01,084009,Staff,32,0,50,18
1649855226851,CSE 30,A01,083370,Cao; Yingjun,20,0,40,20
1649855232882,CSE 100,A01,083372,Cao; Yingjun,13,0,40,27
1649855238913,CSE 101,A01,084011,Staff,0,16,40,40
1649855244945,CSE 141,A01,083374,Eldon; John,0,14,75,75
1649855250974,CSE 141L,A01,083376,Eldon; John,0,18,75,75
1649855257005,CSE 175,A01,084013,Kumar; Rakesh,24,0,25,1
1649855263029,CSE 190,A00,092508,Staff,15,0,15,0
1649855269058,ECE 5,A01,084049,Morris; Karcher William,17,0,20,3
1649855275085,ECE 100,A01,084051,Baghdadchi; Saharnaz,16,0,20,4
1649855275085,ECE 100,A02,091916,Baghdadchi; Saharnaz,18,0,20,2
1649855281116,ECE 101,A01,084053,Baghdadchi; Saharnaz,25,0,37,12
1649855281116,ECE 101,A02,084054,Baghdadchi; Saharnaz,37,0,37,0
1649855287140,ECE 107,A01,083390,Staff,31,0,40,9
1649855293171,ECE 148,A01,084056,Silberman; Jack,8,0,12,4
1649855299194,ECE 180,A00,083391,Abi Samra; Nicholas Camill,27,0,30,3
1649855299194,ECE 180,B00,083392,Abi Samra; Nicholas Camill,26,0,30,4
1649855305225,MATH 10B,A01,084110,Staff,20,0,30,10
1649855305225,MATH 10B,A02,084111,Staff,29,0,30,1
1649855305225,MATH 10B,A03,084112,Staff,29,0,30,1
1649855311249,MATH 10C,A01,083443,Staff,19,0,30,11
1649855311249,MATH 10C,A02,083444,Staff,24,0,30,6
1649855311249,MATH 10C,B01,084114,Staff,26,0,30,4
1649855311249,MATH 10C,B02,084115,Staff,30,0,30,0
1649855317284,MATH 18,A01,084117,Harel; Guershon,28,0,30,2
1649855317284,MATH 18,A02,084119,Harel; Guershon,29,0,30,1
1649855317284,MATH 18,A03,084120,Harel; Guershon,30,0,30,0
1649855317284,MATH 18,A04,084121,Harel; Guershon,30,0,30,0
1649855323312,MATH 20B,A01,084124,Um; Ko Woon,33,0,35,2
1649855323312,MATH 20B,B01,084126,Um; Ko Woon,35,0,35,0
1649855329344,MATH 20C,A01,083446,Hammock; Frances H,26,0,30,4
1649855329344,MATH 20C,A02,083447,Hammock; Frances H,30,0,30,0
1649855329344,MATH 20C,A03,083448,Hammock; Frances H,30,0,30,0
1649855329344,MATH 20C,A04,083449,Hammock; Frances H,30,0,30,0
1649855329344,MATH 20C,B01,083451,Hammock; Frances H,29,0,30,1
1649855329344,MATH 20C,B02,083452,Hammock; Frances H,30,0,30,0
1649855329344,MATH 20C,B03,083453,Hammock; Frances H,30,0,30,0
1649855329344,MATH 20C,B04,083454,Hammock; Frances H,30,0,30,0
1649855335373,MATH 20D,A01,084128,Staff,29,0,30,1
1649855335373,MATH 20D,A02,084129,Staff,30,0,30,0
1649855335373,MATH 20D,A03,084130,Staff,29,0,30,1
1649855335373,MATH 20D,B01,084133,Staff,28,0,30,2
1649855335373,MATH 20D,B02,084134,Staff,30,0,30,0
1649855335373,MATH 20D,B03,084135,Staff,30,0,30,0
1649855341399,MATH 20E,A01,084138,Staff,27,0,30,3
1649855341399,MATH 20E,A02,084139,Staff,29,0,30,1
1649855341399,MATH 20E,A03,084140,Staff,28,0,30,2
1649855341399,MATH 20E,A04,084141,Staff,30,0,30,0
1649855347425,MATH 102,A01,084143,Harel; Guershon,24,0,30,6
1649855347425,MATH 102,A02,084144,Harel; Guershon,25,0,30,5
1649855353448,MATH 103B,A01,083456,Staff,0,0,30,30
1649855353448,MATH 103B,A02,083457,Staff,18,0,30,12
1649855359475,MATH 109,A01,084146,Salehi Golsefidy; Alireza,30,0,30,0
1649855359475,MATH 109,A02,084147,Salehi Golsefidy; Alireza,26,0,30,4
1649855365515,MATH 120A,A01,085445,Eggers; John Dietrich,30,0,35,5
1649855365515,MATH 120A,A02,085446,Eggers; John Dietrich,31,0,35,4
1649855371539,MATH 142B,A01,084149,Verstraete; Jacques Allan,7,0,30,23
1649855371539,MATH 142B,A02,084150,Verstraete; Jacques Allan,25,0,30,5
1649855377565,MATH 170A,A01,083459,Nie; Jiawang,9,0,30,21
1649855377565,MATH 170A,A02,083460,Nie; Jiawang,25,0,30,5
1649855377565,MATH 170A,A03,083461,Nie; Jiawang,26,0,30,4
1649855383596,MATH 193B,A01,083463,Staff,15,0,30,15
1649855383596,MATH 193B,A02,083464,Staff,19,0,30,11
1649855383596,MATH 193B,A03,083465,Staff,27,0,30,3
1649855389653,COGS 2,A01,083966,Boyle; Mary E. T.,27,0,30,3
1649855395677,COGS 9,A01,083968,Staff,56,0,60,4
1649855401706,COGS 14B,A01,083970,Staff,46,0,50,4
1649855407729,COGS 17,A01,092679,Staff,73,0,75,2
1649855413754,COGS 100,A01,083972,Staff,46,0,60,14
1649855425807,COGS 101C,A01,083976,Staff,25,0,30,5
1649855431839,COGS 102A,A01,083978,Johnson; Christine M.,24,0,30,6
1649855437868,COGS 107B,A01,083980,Staff,32,0,50,18
1649855443894,COGS 115,A01,083982,Staff,21,0,30,9
1649855449921,COGS 118B,A01,083367,Staff,5,0,40,35
1649855455947,COGS 172,A01,083984,Provenzano; Emily Kara,20,0,30,10
1649855461972,COGS 177,A00,083368,Staff,2,0,30,28
1649855468000,COGS 186,A01,083986,Staff,25,0,40,15
1649855474024,COGS 187A,A01,083988,Boyle; Mary E. T.,40,0,60,20
1649855480056,CSE 8A,A50,084003,Miranda; Gregory Joseph,9,0,15,6
1649855486088,CSE 11,A01,084005,Miranda; Gregory Joseph,49,0,55,6
1649855492115,CSE 20,A01,084007,Staff,15,0,20,5
1649855498149,CSE 21,A01,084009,Staff,32,0,50,18
1649855504178,CSE 30,A01,083370,Cao; Yingjun,20,0,40,20
1649855510207,CSE 100,A01,083372,Cao; Yingjun,13,0,40,27
1649855516231,CSE 101,A01,084011,Staff,0,16,40,40
1649855522257,CSE 141,A01,083374,Eldon; John,0,14,75,75
1649855528287,CSE 141L,A01,083376,Eldon; John,0,18,75,75
1649855534313,CSE 175,A01,084013,Kumar; Rakesh,24,0,25,1
1649855540337,CSE 190,A00,092508,Staff,15,0,15,0
1649855546363,ECE 5,A01,084049,Morris; Karcher William,17,0,20,3
1649855552397,ECE 100,A01,084051,Baghdadchi; Saharnaz,16,0,20,4
1649855552397,ECE 100,A02,091916,Baghdadchi; Saharnaz,18,0,20,2
1649855558429,ECE 101,A01,084053,Baghdadchi; Saharnaz,25,0,37,12
1649855558429,ECE 101,A02,084054,Baghdadchi; Saharnaz,37,0,37,0
1649855564454,ECE 107,A01,083390,Staff,31,0,40,9
1649855570481,ECE 148,A01,084056,Silberman; Jack,8,0,12,4
1649855576506,ECE 180,A00,083391,Abi Samra; Nicholas Camill,27,0,30,3
1649855576506,ECE 180,B00,083392,Abi Samra; Nicholas Camill,26,0,30,4
1649855582537,MATH 10B,A01,084110,Staff,20,0,30,10
1649855582537,MATH 10B,A02,084111,Staff,29,0,30,1
1649855582537,MATH 10B,A03,084112,Staff,29,0,30,1
1649855588564,MATH 10C,A01,083443,Staff,19,0,30,11
1649855588564,MATH 10C,A02,083444,Staff,24,0,30,6
1649855588564,MATH 10C,B01,084114,Staff,26,0,30,4
1649855588564,MATH 10C,B02,084115,Staff,30,0,30,0
1649855594594,MATH 18,A01,084117,Harel; Guershon,28,0,30,2
1649855594594,MATH 18,A02,084119,Harel; Guershon,29,0,30,1
1649855594594,MATH 18,A03,084120,Harel; Guershon,30,0,30,0
1649855594594,MATH 18,A04,084121,Harel; Guershon,30,0,30,0
1649855600616,MATH 20B,A01,084124,Um; Ko Woon,33,0,35,2
1649855600616,MATH 20B,B01,084126,Um; Ko Woon,35,0,35,0
1649855606642,MATH 20C,A01,083446,Hammock; Frances H,26,0,30,4
1649855606642,MATH 20C,A02,083447,Hammock; Frances H,30,0,30,0
1649855606642,MATH 20C,A03,083448,Hammock; Frances H,30,0,30,0
1649855606642,MATH 20C,A04,083449,Hammock; Frances H,30,0,30,0
1649855606642,MATH 20C,B01,083451,Hammock; Frances H,29,0,30,1
1649855606642,MATH 20C,B02,083452,Hammock; Frances H,30,0,30,0
1649855606642,MATH 20C,B03,083453,Hammock; Frances H,30,0,30,0
1649855606642,MATH 20C,B04,083454,Hammock; Frances H,30,0,30,0
1649855612674,MATH 20D,A01,084128,Staff,29,0,30,1
1649855612674,MATH 20D,A02,084129,Staff,30,0,30,0
1649855612674,MATH 20D,A03,084130,Staff,29,0,30,1
1649855612674,MATH 20D,B01,084133,Staff,28,0,30,2
1649855612674,MATH 20D,B02,084134,Staff,30,0,30,0
1649855612674,MATH 20D,B03,084135,Staff,30,0,30,0
1649855618698,MATH 20E,A01,084138,Staff,27,0,30,3
1649855618698,MATH 20E,A02,084139,Staff,29,0,30,1
1649855618698,MATH 20E,A03,084140,Staff,28,0,30,2
1649855618698,MATH 20E,A04,084141,Staff,30,0,30,0
1649855624722,MATH 102,A01,084143,Harel; Guershon,24,0,30,6
1649855624722,MATH 102,A02,084144,Harel; Guershon,25,0,30,5
1649855630747,MATH 103B,A01,083456,Staff,0,0,30,30
1649855630747,MATH 103B,A02,083457,Staff,18,0,30,12
1649855636775,MATH 109,A01,084146,Salehi Golsefidy; Alireza,30,0,30,0
1649855636775,MATH 109,A02,084147,Salehi Golsefidy; Alireza,26,0,30,4
1649855642816,MATH 120A,A01,085445,Eggers; John Dietrich,30,0,35,5
1649855642816,MATH 120A,A02,085446,Eggers; John Dietrich,31,0,35,4
1649855648844,MATH 142B,A01,084149,Verstraete; Jacques Allan,7,0,30,23
1649855648844,MATH 142B,A02,084150,Verstraete; Jacques Allan,25,0,30,5
1649855654874,MATH 170A,A01,083459,Nie; Jiawang,9,0,30,21
1649855654874,MATH 170A,A02,083460,Nie; Jiawang,25,0,30,5
1649855654874,MATH 170A,A03,083461,Nie; Jiawang,26,0,30,4
1649855660906,MATH 193B,A01,083463,Staff,15,0,30,15
1649855660906,MATH 193B,A02,083464,Staff,19,0,30,11
1649855660906,MATH 193B,A03,083465,Staff,27,0,30,3
1649855666973,COGS 2,A01,083966,Boyle; Mary E. T.,27,0,30,3
1649855672997,COGS 9,A01,083968,Staff,56,0,60,4
1649855679020,COGS 14B,A01,083970,Staff,46,0,50,4
1649855685047,COGS 17,A01,092679,Staff,73,0,75,2
1649855691072,COGS 100,A01,083972,Staff,46,0,60,14
1649855703124,COGS 101C,A01,083976,Staff,25,0,30,5
1649855709148,COGS 102A,A01,083978,Johnson; Christine M.,24,0,30,6
1649855715177,COGS 107B,A01,083980,Staff,32,0,50,18
1649855721201,COGS 115,A01,083982,Staff,21,0,30,9
1649855727238,COGS 118B,A01,083367,Staff,5,0,40,35
1649855733263,COGS 172,A01,083984,Provenzano; Emily Kara,20,0,30,10
1649855739287,COGS 177,A00,083368,Staff,2,0,30,28
1649855745327,COGS 186,A01,083986,Staff,25,0,40,15
1649855751351,COGS 187A,A01,083988,Boyle; Mary E. T.,40,0,60,20
1649855757376,CSE 8A,A50,084003,Miranda; Gregory Joseph,9,0,15,6
1649855763406,CSE 11,A01,084005,Miranda; Gregory Joseph,49,0,55,6
1649855769435,CSE 20,A01,084007,Staff,15,0,20,5
1649855775459,CSE 21,A01,084009,Staff,32,0,50,18
1649855781485,CSE 30,A01,083370,Cao; Yingjun,20,0,40,20
1649855787509,CSE 100,A01,083372,Cao; Yingjun,13,0,40,27
1649855793536,CSE 101,A01,084011,Staff,0,16,40,40
1649855799564,CSE 141,A01,083374,Eldon; John,0,14,75,75
1649855805593,CSE 141L,A01,083376,Eldon; John,0,18,75,75
1649855811623,CSE 175,A01,084013,Kumar; Rakesh,24,0,25,1
1649855817651,CSE 190,A00,092508,Staff,15,0,15,0
1649855823771,ECE 5,A01,084049,Morris; Karcher William,17,0,20,3
1649855829809,ECE 100,A01,084051,Baghdadchi; Saharnaz,16,0,20,4
1649855829809,ECE 100,A02,091916,Baghdadchi; Saharnaz,18,0,20,2
1649855835833,ECE 101,A01,084053,Baghdadchi; Saharnaz,25,0,37,12
1649855835833,ECE 101,A02,084054,Baghdadchi; Saharnaz,37,0,37,0
1649855841861,ECE 107,A01,083390,Staff,31,0,40,9
1649855847885,ECE 148,A01,084056,Silberman; Jack,8,0,12,4
1649855853908,ECE 180,A00,083391,Abi Samra; Nicholas Camill,27,0,30,3
1649855853908,ECE 180,B00,083392,Abi Samra; Nicholas Camill,26,0,30,4
1649855859934,MATH 10B,A01,084110,Staff,20,0,30,10
1649855859934,MATH 10B,A02,084111,Staff,29,0,30,1
1649855859934,MATH 10B,A03,084112,Staff,29,0,30,1
1649855865965,MATH 10C,A01,083443,Staff,19,0,30,11
1649855865965,MATH 10C,A02,083444,Staff,24,0,30,6
1649855865965,MATH 10C,B01,084114,Staff,26,0,30,4
1649855865965,MATH 10C,B02,084115,Staff,30,0,30,0
1649855871996,MATH 18,A01,084117,Harel; Guershon,28,0,30,2
1649855871996,MATH 18,A02,084119,Harel; Guershon,29,0,30,1
1649855871996,MATH 18,A03,084120,Harel; Guershon,30,0,30,0
1649855871996,MATH 18,A04,084121,Harel; Guershon,30,0,30,0
1649855878026,MATH 20B,A01,084124,Um; Ko Woon,33,0,35,2
1649855878026,MATH 20B,B01,084126,Um; Ko Woon,35,0,35,0
1649855884059,MATH 20C,A01,083446,Hammock; Frances H,26,0,30,4
1649855884059,MATH 20C,A02,083447,Hammock; Frances H,30,0,30,0
1649855884059,MATH 20C,A03,083448,Hammock; Frances H,30,0,30,0
1649855884059,MATH 20C,A04,083449,Hammock; Frances H,30,0,30,0
1649855884059,MATH 20C,B01,083451,Hammock; Frances H,29,0,30,1
1649855884059,MATH 20C,B02,083452,Hammock; Frances H,30,0,30,0
1649855884059,MATH 20C,B03,083453,Hammock; Frances H,30,0,30,0
1649855884059,MATH 20C,B04,083454,Hammock; Frances H,30,0,30,0
1649855890088,MATH 20D,A01,084128,Staff,29,0,30,1
1649855890088,MATH 20D,A02,084129,Staff,30,0,30,0
1649855890088,MATH 20D,A03,084130,Staff,29,0,30,1
1649855890088,MATH 20D,B01,084133,Staff,28,0,30,2
1649855890088,MATH 20D,B02,084134,Staff,30,0,30,0
1649855890088,MATH 20D,B03,084135,Staff,30,0,30,0
1649855896113,MATH 20E,A01,084138,Staff,27,0,30,3
1649855896113,MATH 20E,A02,084139,Staff,29,0,30,1
1649855896113,MATH 20E,A03,084140,Staff,28,0,30,2
1649855896113,MATH 20E,A04,084141,Staff,30,0,30,0
1649855902138,MATH 102,A01,084143,Harel; Guershon,24,0,30,6
1649855902138,MATH 102,A02,084144,Harel; Guershon,25,0,30,5
1649855908163,MATH 103B,A01,083456,Staff,0,0,30,30
1649855908163,MATH 103B,A02,083457,Staff,18,0,30,12
1649855914192,MATH 109,A01,084146,Salehi Golsefidy; Alireza,30,0,30,0
1649855914192,MATH 109,A02,084147,Salehi Golsefidy; Alireza,26,0,30,4
1649855920217,MATH 120A,A01,085445,Eggers; John Dietrich,30,0,35,5
1649855920217,MATH 120A,A02,085446,Eggers; John Dietrich,31,0,35,4
1649855926244,MATH 142B,A01,084149,Verstraete; Jacques Allan,7,0,30,23
1649855926244,MATH 142B,A02,084150,Verstraete; Jacques Allan,25,0,30,5
1649855932275,MATH 170A,A01,083459,Nie; Jiawang,9,0,30,21
1649855932275,MATH 170A,A02,083460,Nie; Jiawang,25,0,30,5
1649855932275,MATH 170A,A03,083461,Nie; Jiawang,26,0,30,4
1649855938300,MATH 193B,A01,083463,Staff,15,0,30,15
1649855938300,MATH 193B,A02,083464,Staff,19,0,30,11
1649855938300,MATH 193B,A03,083465,Staff,27,0,30,3
1649855944379,COGS 2,A01,083966,Boyle; Mary E. T.,27,0,30,3
1649855950404,COGS 9,A01,083968,Staff,56,0,60,4
1649855956431,COGS 14B,A01,083970,Staff,46,0,50,4
1649855962455,COGS 17,A01,092679,Staff,73,0,75,2
1649855968483,COGS 100,A01,083972,Staff,46,0,60,14
1649855980543,COGS 101C,A01,083976,Staff,25,0,30,5
1649855986568,COGS 102A,A01,083978,Johnson; Christine M.,24,0,30,6
1649855992593,COGS 107B,A01,083980,Staff,32,0,50,18
1649855998616,COGS 115,A01,083982,Staff,21,0,30,9
1649856004642,COGS 118B,A01,083367,Staff,5,0,40,35
1649856010666,COGS 172,A01,083984,Provenzano; Emily Kara,20,0,30,10
1649856016694,COGS 177,A00,083368,Staff,2,0,30,28
1649856022719,COGS 186,A01,083986,Staff,25,0,40,15
1649856028746,COGS 187A,A01,083988,Boyle; Mary E. T.,40,0,60,20
1649856034772,CSE 8A,A50,084003,Miranda; Gregory Joseph,9,0,15,6
1649856040798,CSE 11,A01,084005,Miranda; Gregory Joseph,49,0,55,6
1649856046823,CSE 20,A01,084007,Staff,15,0,20,5
1649856052847,CSE 21,A01,084009,Staff,32,0,50,18
1649856058878,CSE 30,A01,083370,Cao; Yingjun,20,0,40,20
1649856064903,CSE 100,A01,083372,Cao; Yingjun,13,0,40,27
1649856070931,CSE 101,A01,084011,Staff,0,16,40,40
1649856076955,CSE 141,A01,083374,Eldon; John,0,14,75,75
1649856082977,CSE 141L,A01,083376,Eldon; John,0,18,75,75
1649856089002,CSE 175,A01,084013,Kumar; Rakesh,24,0,25,1
1649856095029,CSE 190,A00,092508,Staff,15,0,15,0
1649856101058,ECE 5,A01,084049,Morris; Karcher William,17,0,20,3
1649856107092,ECE 100,A01,084051,Baghdadchi; Saharnaz,16,0,20,4
1649856107092,ECE 100,A02,091916,Baghdadchi; Saharnaz,18,0,20,2
1649856113123,ECE 101,A01,084053,Baghdadchi; Saharnaz,25,0,37,12
1649856113123,ECE 101,A02,084054,Baghdadchi; Saharnaz,37,0,37,0
1649856119155,ECE 107,A01,083390,Staff,31,0,40,9
1649856125188,ECE 148,A01,084056,Silberman; Jack,8,0,12,4
1649856131219,ECE 180,A00,083391,Abi Samra; Nicholas Camill,27,0,30,3
1649856131219,ECE 180,B00,083392,Abi Samra; Nicholas Camill,26,0,30,4
1649856137243,MATH 10B,A01,084110,Staff,20,0,30,10
1649856137243,MATH 10B,A02,084111,Staff,29,0,30,1
1649856137243,MATH 10B,A03,084112,Staff,29,0,30,1
1649856143269,MATH 10C,A01,083443,Staff,19,0,30,11
1649856143269,MATH 10C,A02,083444,Staff,24,0,30,6
1649856143269,MATH 10C,B01,084114,Staff,26,0,30,4
1649856143269,MATH 10C,B02,084115,Staff,30,0,30,0
1649856149295,MATH 18,A01,084117,Harel; Guershon,28,0,30,2
1649856149295,MATH 18,A02,084119,Harel; Guershon,29,0,30,1
1649856149295,MATH 18,A03,084120,Harel; Guershon,30,0,30,0
1649856149295,MATH 18,A04,084121,Harel; Guershon,30,0,30,0
1649856155326,MATH 20B,A01,084124,Um; Ko Woon,33,0,35,2
1649856155326,MATH 20B,B01,084126,Um; Ko Woon,35,0,35,0
1649856161352,MATH 20C,A01,083446,Hammock; Frances H,26,0,30,4
1649856161352,MATH 20C,A02,083447,Hammock; Frances H,30,0,30,0
1649856161352,MATH 20C,A03,083448,Hammock; Frances H,30,0,30,0
1649856161352,MATH 20C,A04,083449,Hammock; Frances H,30,0,30,0
1649856161352,MATH 20C,B01,083451,Hammock; Frances H,29,0,30,1
1649856161352,MATH 20C,B02,083452,Hammock; Frances H,30,0,30,0
1649856161352,MATH 20C,B03,083453,Hammock; Frances H,30,0,30,0
1649856161352,MATH 20C,B04,083454,Hammock; Frances H,30,0,30,0
1649856167383,MATH 20D,A01,084128,Staff,29,0,30,1
1649856167383,MATH 20D,A02,084129,Staff,30,0,30,0
1649856167383,MATH 20D,A03,084130,Staff,29,0,30,1
1649856167383,MATH 20D,B01,084133,Staff,28,0,30,2
1649856167383,MATH 20D,B02,084134,Staff,30,0,30,0
1649856167383,MATH 20D,B03,084135,Staff,30,0,30,0
1649856173408,MATH 20E,A01,084138,Staff,27,0,30,3
1649856173408,MATH 20E,A02,084139,Staff,29,0,30,1
1649856173408,MATH 20E,A03,084140,Staff,28,0,30,2
1649856173408,MATH 20E,A04,084141,Staff,30,0,30,0
1649856179437,MATH 102,A01,084143,Harel; Guershon,24,0,30,6
1649856179437,MATH 102,A02,084144,Harel; Guershon,25,0,30,5
1649856185469,MATH 103B,A01,083456,Staff,0,0,30,30
1649856185469,MATH 103B,A02,083457,Staff,18,0,30,12
1649856191493,MATH 109,A01,084146,Salehi Golsefidy; Alireza,30,0,30,0
1649856191493,MATH 109,A02,084147,Salehi Golsefidy; Alireza,26,0,30,4
1649856197523,MATH 120A,A01,085445,Eggers; John Dietrich,30,0,35,5
1649856197523,MATH 120A,A02,085446,Eggers; John Dietrich,31,0,35,4
1649856203546,MATH 142B,A01,084149,Verstraete; Jacques Allan,7,0,30,23
1649856203546,MATH 142B,A02,084150,Verstraete; Jacques Allan,25,0,30,5
1649856209572,MATH 170A,A01,083459,Nie; Jiawang,9,0,30,21
1649856209572,MATH 170A,A02,083460,Nie; Jiawang,25,0,30,5
1649856209572,MATH 170A,A03,083461,Nie; Jiawang,26,0,30,4
1649856215597,MATH 193B,A01,083463,Staff,15,0,30,15
1649856215597,MATH 193B,A02,083464,Staff,19,0,30,11
1649856215597,MATH 193B,A03,083465,Staff,27,0,30,3
1649856221664,COGS 2,A01,083966,Boyle; Mary E. T.,27,0,30,3
1649856227690,COGS 9,A01,083968,Staff,56,0,60,4
1649856233714,COGS 14B,A01,083970,Staff,46,0,50,4
1649856239741,COGS 17,A01,092679,Staff,73,0,75,2
1649856245771,COGS 100,A01,083972,Staff,46,0,60,14
1649856257822,COGS 101C,A01,083976,Staff,25,0,30,5
1649856263858,COGS 102A,A01,083978,Johnson; Christine M.,24,0,30,6
1649856269882,COGS 107B,A01,083980,Staff,32,0,50,18
1649856279061,COGS 115,A01,083982,Staff,21,0,30,9
1649856285090,COGS 118B,A01,083367,Staff,5,0,40,35
1649856291118,COGS 172,A01,083984,Provenzano; Emily Kara,20,0,30,10
1649856297148,COGS 177,A00,083368,Staff,2,0,30,28
1649856303175,COGS 186,A01,083986,Staff,25,0,40,15
1649856309202,COGS 187A,A01,083988,Boyle; Mary E. T.,40,0,60,20
1649856315235,CSE 8A,A50,084003,Miranda; Gregory Joseph,9,0,15,6
1649856321262,CSE 11,A01,084005,Miranda; Gregory Joseph,49,0,55,6
1649856327291,CSE 20,A01,084007,Staff,15,0,20,5
1649856333320,CSE 21,A01,084009,Staff,32,0,50,18
1649856339352,CSE 30,A01,083370,Cao; Yingjun,20,0,40,20
1649856345376,CSE 100,A01,083372,Cao; Yingjun,13,0,40,27
1649856351399,CSE 101,A01,084011,Staff,0,16,40,40
1649856357424,CSE 141,A01,083374,Eldon; John,0,14,75,75
1649856363448,CSE 141L,A01,083376,Eldon; John,0,18,75,75
1649856369473,CSE 175,A01,084013,Kumar; Rakesh,24,0,25,1
1649856375500,CSE 190,A00,092508,Staff,15,0,15,0
1649856381530,ECE 5,A01,084049,Morris; Karcher William,17,0,20,3
1649856387558,ECE 100,A01,084051,Baghdadchi; Saharnaz,16,0,20,4
1649856387558,ECE 100,A02,091916,Baghdadchi; Saharnaz,18,0,20,2
1649856393588,ECE 101,A01,084053,Baghdadchi; Saharnaz,25,0,37,12
1649856393588,ECE 101,A02,084054,Baghdadchi; Saharnaz,37,0,37,0
1649856399616,ECE 107,A01,083390,Staff,31,0,40,9
1649856405647,ECE 148,A01,084056,Silberman; Jack,8,0,12,4
1649856411674,ECE 180,A00,083391,Abi Samra; Nicholas Camill,27,0,30,3
1649856411674,ECE 180,B00,083392,Abi Samra; Nicholas Camill,26,0,30,4
1649856417709,MATH 10B,A01,084110,Staff,20,0,30,10
1649856417709,MATH 10B,A02,084111,Staff,29,0,30,1
1649856417709,MATH 10B,A03,084112,Staff,29,0,30,1
1649856423829,MATH 10C,A01,083443,Staff,19,0,30,11
1649856423829,MATH 10C,A02,083444,Staff,24,0,30,6
1649856423829,MATH 10C,B01,084114,Staff,26,0,30,4
1649856423829,MATH 10C,B02,084115,Staff,30,0,30,0
1649856429858,MATH 18,A01,084117,Harel; Guershon,28,0,30,2
1649856429858,MATH 18,A02,084119,Harel; Guershon,29,0,30,1
1649856429858,MATH 18,A03,084120,Harel; Guershon,30,0,30,0
1649856429858,MATH 18,A04,084121,Harel; Guershon,30,0,30,0
1649856435884,MATH 20B,A01,084124,Um; Ko Woon,33,0,35,2
1649856435884,MATH 20B,B01,084126,Um; Ko Woon,35,0,35,0
1649856441911,MATH 20C,A01,083446,Hammock; Frances H,26,0,30,4
1649856441911,MATH 20C,A02,083447,Hammock; Frances H,30,0,30,0
1649856441911,MATH 20C,A03,083448,Hammock; Frances H,30,0,30,0
1649856441911,MATH 20C,A04,083449,Hammock; Frances H,30,0,30,0
1649856441911,MATH 20C,B01,083451,Hammock; Frances H,29,0,30,1
1649856441911,MATH 20C,B02,083452,Hammock; Frances H,30,0,30,0
1649856441911,MATH 20C,B03,083453,Hammock; Frances H,30,0,30,0
1649856441911,MATH 20C,B04,083454,Hammock; Frances H,30,0,30,0
1649856447939,MATH 20D,A01,084128,Staff,29,0,30,1
1649856447939,MATH 20D,A02,084129,Staff,30,0,30,0
1649856447939,MATH 20D,A03,084130,Staff,29,0,30,1
1649856447939,MATH 20D,B01,084133,Staff,28,0,30,2
1649856447939,MATH 20D,B02,084134,Staff,30,0,30,0
1649856447939,MATH 20D,B03,084135,Staff,30,0,30,0
1649856453963,MATH 20E,A01,084138,Staff,27,0,30,3
1649856453963,MATH 20E,A02,084139,Staff,29,0,30,1
1649856453963,MATH 20E,A03,084140,Staff,28,0,30,2
1649856453963,MATH 20E,A04,084141,Staff,30,0,30,0
1649856459988,MATH 102,A01,084143,Harel; Guershon,24,0,30,6
1649856459988,MATH 102,A02,084144,Harel; Guershon,25,0,30,5
1649856466016,MATH 103B,A01,083456,Staff,0,0,30,30
1649856466016,MATH 103B,A02,083457,Staff,18,0,30,12
1649856472044,MATH 109,A01,084146,Salehi Golsefidy; Alireza,30,0,30,0
1649856472044,MATH 109,A02,084147,Salehi Golsefidy; Alireza,26,0,30,4
1649856478070,MATH 120A,A01,085445,Eggers; John Dietrich,30,0,35,5
1649856478070,MATH 120A,A02,085446,Eggers; John Dietrich,31,0,35,4
1649856484097,MATH 142B,A01,084149,Verstraete; Jacques Allan,7,0,30,23
1649856484097,MATH 142B,A02,084150,Verstraete; Jacques Allan,25,0,30,5
1649856490127,MATH 170A,A01,083459,Nie; Jiawang,9,0,30,21
1649856490127,MATH 170A,A02,083460,Nie; Jiawang,25,0,30,5
1649856490127,MATH 170A,A03,083461,Nie; Jiawang,26,0,30,4
1649856496155,MATH 193B,A01,083463,Staff,15,0,30,15
1649856496155,MATH 193B,A02,083464,Staff,19,0,30,11
1649856496155,MATH 193B,A03,083465,Staff,27,0,30,3
1649856502221,COGS 2,A01,083966,Boyle; Mary E. T.,27,0,30,3
1649856508246,COGS 9,A01,083968,Staff,56,0,60,4
1649856514285,COGS 14B,A01,083970,Staff,46,0,50,4
1649856520311,COGS 17,A01,092679,Staff,73,0,75,2
1649856526339,COGS 100,A01,083972,Staff,46,0,60,14
1649856538391,COGS 101C,A01,083976,Staff,25,0,30,5
1649856544416,COGS 102A,A01,083978,Johnson; Christine M.,24,0,30,6
1649856550441,COGS 107B,A01,083980,Staff,32,0,50,18
1649856556470,COGS 115,A01,083982,Staff,21,0,30,9
1649856562498,COGS 118B,A01,083367,Staff,5,0,40,35
1649856568538,COGS 172,A01,083984,Provenzano; Emily Kara,20,0,30,10
1649856574564,COGS 177,A00,083368,Staff,2,0,30,28
1649856580591,COGS 186,A01,083986,Staff,25,0,40,15
1649856586615,COGS 187A,A01,083988,Boyle; Mary E. T.,40,0,60,20
1649856592656,CSE 8A,A50,084003,Miranda; Gregory Joseph,9,0,15,6
1649856598685,CSE 11,A01,084005,Miranda; Gregory Joseph,49,0,55,6
1649856604713,CSE 20,A01,084007,Staff,15,0,20,5
1649856610738,CSE 21,A01,084009,Staff,32,0,50,18
1649856616762,CSE 30,A01,083370,Cao; Yingjun,20,0,40,20
1649856622787,CSE 100,A01,083372,Cao; Yingjun,13,0,40,27
1649856628811,CSE 101,A01,084011,Staff,0,16,40,40
1649856634840,CSE 141,A01,083374,Eldon; John,0,14,75,75
1649856640863,CSE 141L,A01,083376,Eldon; John,0,18,75,75
1649856646892,CSE 175,A01,084013,Kumar; Rakesh,24,0,25,1
1649856652917,CSE 190,A00,092508,Staff,15,0,15,0
1649856658946,ECE 5,A01,084049,Morris; Karcher William,17,0,20,3
1649856664972,ECE 100,A01,084051,Baghdadchi; Saharnaz,16,0,20,4
1649856664972,ECE 100,A02,091916,Baghdadchi; Saharnaz,18,0,20,2
1649856670995,ECE 101,A01,084053,Baghdadchi; Saharnaz,25,0,37,12
1649856670995,ECE 101,A02,084054,Baghdadchi; Saharnaz,37,0,37,0
1649856677025,ECE 107,A01,083390,Staff,31,0,40,9
1649856683066,ECE 148,A01,084056,Silberman; Jack,8,0,12,4
1649856689107,ECE 180,A00,083391,Abi Samra; Nicholas Camill,27,0,30,3
1649856689107,ECE 180,B00,083392,Abi Samra; Nicholas Camill,26,0,30,4
1649856695133,MATH 10B,A01,084110,Staff,20,0,30,10
1649856695133,MATH 10B,A02,084111,Staff,29,0,30,1
1649856695133,MATH 10B,A03,084112,Staff,29,0,30,1
1649856701164,MATH 10C,A01,083443,Staff,19,0,30,11
1649856701164,MATH 10C,A02,083444,Staff,24,0,30,6
1649856701164,MATH 10C,B01,084114,Staff,26,0,30,4
1649856701164,MATH 10C,B02,084115,Staff,30,0,30,0
1649856707189,MATH 18,A01,084117,Harel; Guershon,28,0,30,2
1649856707189,MATH 18,A02,084119,Harel; Guershon,29,0,30,1
1649856707189,MATH 18,A03,084120,Harel; Guershon,30,0,30,0
1649856707189,MATH 18,A04,084121,Harel; Guershon,30,0,30,0
1649856713213,MATH 20B,A01,084124,Um; Ko Woon,33,0,35,2
1649856713213,MATH 20B,B01,084126,Um; Ko Woon,35,0,35,0
1649856719253,MATH 20C,A01,083446,Hammock; Frances H,26,0,30,4
1649856719253,MATH 20C,A02,083447,Hammock; Frances H,30,0,30,0
1649856719253,MATH 20C,A03,083448,Hammock; Frances H,30,0,30,0
1649856719253,MATH 20C,A04,083449,Hammock; Frances H,30,0,30,0
1649856719253,MATH 20C,B01,083451,Hammock; Frances H,29,0,30,1
1649856719253,MATH 20C,B02,083452,Hammock; Frances H,30,0,30,0
1649856719253,MATH 20C,B03,083453,Hammock; Frances H,30,0,30,0
1649856719253,MATH 20C,B04,083454,Hammock; Frances H,30,0,30,0
1649856725277,MATH 20D,A01,084128,Staff,29,0,30,1
1649856725277,MATH 20D,A02,084129,Staff,30,0,30,0
1649856725277,MATH 20D,A03,084130,Staff,29,0,30,1
1649856725277,MATH 20D,B01,084133,Staff,28,0,30,2
1649856725277,MATH 20D,B02,084134,Staff,30,0,30,0
1649856725277,MATH 20D,B03,084135,Staff,30,0,30,0
1649856731315,MATH 20E,A01,084138,Staff,27,0,30,3
1649856731315,MATH 20E,A02,084139,Staff,29,0,30,1
1649856731315,MATH 20E,A03,084140,Staff,28,0,30,2
1649856731315,MATH 20E,A04,084141,Staff,30,0,30,0
1649856737351,MATH 102,A01,084143,Harel; Guershon,24,0,30,6
1649856737351,MATH 102,A02,084144,Harel; Guershon,25,0,30,5
1649856743382,MATH 103B,A01,083456,Staff,0,0,30,30
1649856743382,MATH 103B,A02,083457,Staff,18,0,30,12
1649856749415,MATH 109,A01,084146,Salehi Golsefidy; Alireza,30,0,30,0
1649856749415,MATH 109,A02,084147,Salehi Golsefidy; Alireza,26,0,30,4
1649856755440,MATH 120A,A01,085445,Eggers; John Dietrich,30,0,35,5
1649856755440,MATH 120A,A02,085446,Eggers; John Dietrich,31,0,35,4
1649856761463,MATH 142B,A01,084149,Verstraete; Jacques Allan,7,0,30,23
1649856761463,MATH 142B,A02,084150,Verstraete; Jacques Allan,25,0,30,5
1649856767489,MATH 170A,A01,083459,Nie; Jiawang,9,0,30,21
1649856767489,MATH 170A,A02,083460,Nie; Jiawang,25,0,30,5
1649856767489,MATH 170A,A03,083461,Nie; Jiawang,26,0,30,4
1649856773516,MATH 193B,A01,083463,Staff,15,0,30,15
1649856773516,MATH 193B,A02,083464,Staff,19,0,30,11
1649856773516,MATH 193B,A03,083465,Staff,27,0,30,3
1649856779573,COGS 2,A01,083966,Boyle; Mary E. T.,27,0,30,3
1649856785599,COGS 9,A01,083968,Staff,56,0,60,4
1649856791622,COGS 14B,A01,083970,Staff,46,0,50,4
1649856797647,COGS 17,A01,092679,Staff,73,0,75,2
1649856803687,COGS 100,A01,083972,Staff,46,0,60,14
1649856815740,COGS 101C,A01,083976,Staff,25,0,30,5
1649856821770,COGS 102A,A01,083978,Johnson; Christine M.,24,0,30,6
1649856827793,COGS 107B,A01,083980,Staff,32,0,50,18
1649856833817,COGS 115,A01,083982,Staff,21,0,30,9
1649856839840,COGS 118B,A01,083367,Staff,5,0,40,35
1649856845863,COGS 172,A01,083984,Provenzano; Emily Kara,20,0,30,10
1649856851887,COGS 177,A00,083368,Staff,2,0,30,28
1649856857910,COGS 186,A01,083986,Staff,25,0,40,15
1649856863935,COGS 187A,A01,083988,Boyle; Mary E. T.,40,0,60,20
1649856869959,CSE 8A,A50,084003,Miranda; Gregory Joseph,9,0,15,6
1649856875983,CSE 11,A01,084005,Miranda; Gregory Joseph,49,0,55,6
1649856882006,CSE 20,A01,084007,Staff,15,0,20,5
1649856888034,CSE 21,A01,084009,Staff,32,0,50,18
1649856894058,CSE 30,A01,083370,Cao; Yingjun,20,0,40,20
1649856900084,CSE 100,A01,083372,Cao; Yingjun,13,0,40,27
1649856906113,CSE 101,A01,084011,Staff,0,16,40,40
1649856912139,CSE 141,A01,083374,Eldon; John,0,14,75,75
1649856918162,CSE 141L,A01,083376,Eldon; John,0,18,75,75
1649856924187,CSE 175,A01,084013,Kumar; Rakesh,24,0,25,1
1649856930209,CSE 190,A00,092508,Staff,15,0,15,0
1649856936238,ECE 5,A01,084049,Morris; Karcher William,17,0,20,3
1649856942261,ECE 100,A01,084051,Baghdadchi; Saharnaz,16,0,20,4
1649856942261,ECE 100,A02,091916,Baghdadchi; Saharnaz,18,0,20,2
1649856948289,ECE 101,A01,084053,Baghdadchi; Saharnaz,25,0,37,12
1649856948289,ECE 101,A02,084054,Baghdadchi; Saharnaz,37,0,37,0
1649856954312,ECE 107,A01,083390,Staff,31,0,40,9
1649856960340,ECE 148,A01,084056,Silberman; Jack,8,0,12,4
1649856966366,ECE 180,A00,083391,Abi Samra; Nicholas Camill,27,0,30,3
1649856966366,ECE 180,B00,083392,Abi Samra; Nicholas Camill,26,0,30,4
1649856972389,MATH 10B,A01,084110,Staff,20,0,30,10
1649856972389,MATH 10B,A02,084111,Staff,29,0,30,1
1649856972389,MATH 10B,A03,084112,Staff,29,0,30,1
1649856978419,MATH 10C,A01,083443,Staff,19,0,30,11
1649856978419,MATH 10C,A02,083444,Staff,24,0,30,6
1649856978419,MATH 10C,B01,084114,Staff,26,0,30,4
1649856978419,MATH 10C,B02,084115,Staff,30,0,30,0
1649856984452,MATH 18,A01,084117,Harel; Guershon,28,0,30,2
1649856984452,MATH 18,A02,084119,Harel; Guershon,29,0,30,1
1649856984452,MATH 18,A03,084120,Harel; Guershon,30,0,30,0
1649856984452,MATH 18,A04,084121,Harel; Guershon,30,0,30,0
1649856990478,MATH 20B,A01,084124,Um; Ko Woon,33,0,35,2
1649856990478,MATH 20B,B01,084126,Um; Ko Woon,35,0,35,0
1649856996554,MATH 20C,A01,083446,Hammock; Frances H,26,0,30,4
1649856996554,MATH 20C,A02,083447,Hammock; Frances H,30,0,30,0
1649856996554,MATH 20C,A03,083448,Hammock; Frances H,30,0,30,0
1649856996554,MATH 20C,A04,083449,Hammock; Frances H,30,0,30,0
1649856996554,MATH 20C,B01,083451,Hammock; Frances H,29,0,30,1
1649856996554,MATH 20C,B02,083452,Hammock; Frances H,30,0,30,0
1649856996554,MATH 20C,B03,083453,Hammock; Frances H,30,0,30,0
1649856996554,MATH 20C,B04,083454,Hammock; Frances H,30,0,30,0
1649857002583,MATH 20D,A01,084128,Staff,29,0,30,1
1649857002583,MATH 20D,A02,084129,Staff,30,0,30,0
1649857002583,MATH 20D,A03,084130,Staff,29,0,30,1
1649857002583,MATH 20D,B01,084133,Staff,28,0,30,2
1649857002583,MATH 20D,B02,084134,Staff,30,0,30,0
1649857002583,MATH 20D,B03,084135,Staff,30,0,30,0
1649857008608,MATH 20E,A01,084138,Staff,27,0,30,3
1649857008608,MATH 20E,A02,084139,Staff,29,0,30,1
1649857008608,MATH 20E,A03,084140,Staff,28,0,30,2
1649857008608,MATH 20E,A04,084141,Staff,30,0,30,0
1649857014636,MATH 102,A01,084143,Harel; Guershon,24,0,30,6
1649857014636,MATH 102,A02,084144,Harel; Guershon,25,0,30,5
1649857020759,MATH 103B,A01,083456,Staff,0,0,30,30
1649857020759,MATH 103B,A02,083457,Staff,18,0,30,12
1649857026787,MATH 109,A01,084146,Salehi Golsefidy; Alireza,30,0,30,0
1649857026787,MATH 109,A02,084147,Salehi Golsefidy; Alireza,26,0,30,4
1649857032814,MATH 120A,A01,085445,Eggers; John Dietrich,30,0,35,5
1649857032814,MATH 120A,A02,085446,Eggers; John Dietrich,31,0,35,4
1649857038838,MATH 142B,A01,084149,Verstraete; Jacques Allan,7,0,30,23
1649857038838,MATH 142B,A02,084150,Verstraete; Jacques Allan,25,0,30,5
1649857044863,MATH 170A,A01,083459,Nie; Jiawang,9,0,30,21
1649857044863,MATH 170A,A02,083460,Nie; Jiawang,25,0,30,5
1649857044863,MATH 170A,A03,083461,Nie; Jiawang,26,0,30,4
1649857050886,MATH 193B,A01,083463,Staff,15,0,30,15
1649857050886,MATH 193B,A02,083464,Staff,19,0,30,11
1649857050886,MATH 193B,A03,083465,Staff,27,0,30,3
1649857056952,COGS 2,A01,083966,Boyle; Mary E. T.,27,0,30,3
1649857062978,COGS 9,A01,083968,Staff,56,0,60,4
1649857069003,COGS 14B,A01,083970,Staff,46,0,50,4
1649857075027,COGS 17,A01,092679,Staff,73,0,75,2
1649857081051,COGS 100,A01,083972,Staff,46,0,60,14
1649857093100,COGS 101C,A01,083976,Staff,25,0,30,5
1649857099126,COGS 102A,A01,083978,Johnson; Christine M.,24,0,30,6
1649857105154,COGS 107B,A01,083980,Staff,32,0,50,18
1649857111177,COGS 115,A01,083982,Staff,21,0,30,9
1649857117202,COGS 118B,A01,083367,Staff,5,0,40,35
1649857123227,COGS 172,A01,083984,Provenzano; Emily Kara,20,0,30,10
1649857129254,COGS 177,A00,083368,Staff,2,0,30,28
1649857135281,COGS 186,A01,083986,Staff,25,0,40,15
1649857141309,COGS 187A,A01,083988,Boyle; Mary E. T.,40,0,60,20
1649857147349,CSE 8A,A50,084003,Miranda; Gregory Joseph,9,0,15,6
1649857153378,CSE 11,A01,084005,Miranda; Gregory Joseph,49,0,55,6
1649857159413,CSE 20,A01,084007,Staff,15,0,20,5
1649857165447,CSE 21,A01,084009,Staff,32,0,50,18
1649857171470,CSE 30,A01,083370,Cao; Yingjun,20,0,40,20
1649857177497,CSE 100,A01,083372,Cao; Yingjun,13,0,40,27
1649857183520,CSE 101,A01,084011,Staff,0,16,40,40
1649857189543,CSE 141,A01,083374,Eldon; John,0,14,75,75
1649857195568,CSE 141L,A01,083376,Eldon; John,0,18,75,75
1649857201592,CSE 175,A01,084013,Kumar; Rakesh,24,0,25,1
1649857207617,CSE 190,A00,092508,Staff,15,0,15,0
1649857213651,ECE 5,A01,084049,Morris; Karcher William,17,0,20,3
1649857219676,ECE 100,A01,084051,Baghdadchi; Saharnaz,16,0,20,4
1649857219676,ECE 100,A02,091916,Baghdadchi; Saharnaz,18,0,20,2
1649857225703,ECE 101,A01,084053,Baghdadchi; Saharnaz,25,0,37,12
1649857225703,ECE 101,A02,084054,Baghdadchi; Saharnaz,37,0,37,0
1649857231731,ECE 107,A01,083390,Staff,31,0,40,9
1649857237755,ECE 148,A01,084056,Silberman; Jack,8,0,12,4
1649857243779,ECE 180,A00,083391,Abi Samra; Nicholas Camill,27,0,30,3
1649857243779,ECE 180,B00,083392,Abi Samra; Nicholas Camill,26,0,30,4
1649857249814,MATH 10B,A01,084110,Staff,20,0,30,10
1649857249814,MATH 10B,A02,084111,Staff,29,0,30,1
1649857249814,MATH 10B,A03,084112,Staff,29,0,30,1
1649857255846,MATH 10C,A01,083443,Staff,19,0,30,11
1649857255846,MATH 10C,A02,083444,Staff,24,0,30,6
1649857255846,MATH 10C,B01,084114,Staff,26,0,30,4
1649857255846,MATH 10C,B02,084115,Staff,30,0,30,0
1649857261873,MATH 18,A01,084117,Harel; Guershon,28,0,30,2
1649857261873,MATH 18,A02,084119,Harel; Guershon,29,0,30,1
1649857261873,MATH 18,A03,084120,Harel; Guershon,30,0,30,0
1649857261873,MATH 18,A04,084121,Harel; Guershon,30,0,30,0
1649857267905,MATH 20B,A01,084124,Um; Ko Woon,33,0,35,2
1649857267905,MATH 20B,B01,084126,Um; Ko Woon,35,0,35,0
1649857273933,MATH 20C,A01,083446,Hammock; Frances H,26,0,30,4
1649857273933,MATH 20C,A02,083447,Hammock; Frances H,30,0,30,0
1649857273933,MATH 20C,A03,083448,Hammock; Frances H,30,0,30,0
1649857273933,MATH 20C,A04,083449,Hammock; Frances H,30,0,30,0
1649857273933,MATH 20C,B01,083451,Hammock; Frances H,29,0,30,1
1649857273933,MATH 20C,B02,083452,Hammock; Frances H,30,0,30,0
1649857273933,MATH 20C,B03,083453,Hammock; Frances H,30,0,30,0
1649857273933,MATH 20C,B04,083454,Hammock; Frances H,30,0,30,0
1649857279957,MATH 20D,A01,084128,Staff,29,0,30,1
1649857279957,MATH 20D,A02,084129,Staff,30,0,30,0
1649857279957,MATH 20D,A03,084130,Staff,29,0,30,1
1649857279957,MATH 20D,B01,084133,Staff,28,0,30,2
1649857279957,MATH 20D,B02,084134,Staff,30,0,30,0
1649857279957,MATH 20D,B03,084135,Staff,30,0,30,0
1649857285984,MATH 20E,A01,084138,Staff,27,0,30,3
1649857285984,MATH 20E,A02,084139,Staff,29,0,30,1
1649857285984,MATH 20E,A03,084140,Staff,28,0,30,2
1649857285984,MATH 20E,A04,084141,Staff,30,0,30,0
1649857292013,MATH 102,A01,084143,Harel; Guershon,24,0,30,6
1649857292013,MATH 102,A02,084144,Harel; Guershon,25,0,30,5
1649857298037,MATH 103B,A01,083456,Staff,0,0,30,30
1649857298037,MATH 103B,A02,083457,Staff,18,0,30,12
1649857304062,MATH 109,A01,084146,Salehi Golsefidy; Alireza,30,0,30,0
1649857304062,MATH 109,A02,084147,Salehi Golsefidy; Alireza,26,0,30,4
1649857310105,MATH 120A,A01,085445,Eggers; John Dietrich,30,0,35,5
1649857310105,MATH 120A,A02,085446,Eggers; John Dietrich,31,0,35,4
1649857316129,MATH 142B,A01,084149,Verstraete; Jacques Allan,7,0,30,23
1649857316129,MATH 142B,A02,084150,Verstraete; Jacques Allan,25,0,30,5
1649857322151,MATH 170A,A01,083459,Nie; Jiawang,9,0,30,21
1649857322151,MATH 170A,A02,083460,Nie; Jiawang,25,0,30,5
1649857322151,MATH 170A,A03,083461,Nie; Jiawang,26,0,30,4
1649857328175,MATH 193B,A01,083463,Staff,15,0,30,15
1649857328175,MATH 193B,A02,083464,Staff,19,0,30,11
1649857328175,MATH 193B,A03,083465,Staff,27,0,30,3
1649857334250,COGS 2,A01,083966,Boyle; Mary E. T.,27,0,30,3
1649857340282,COGS 9,A01,083968,Staff,56,0,60,4
1649857346309,COGS 14B,A01,083970,Staff,46,0,50,4
1649857352334,COGS 17,A01,092679,Staff,73,0,75,2
1649857358358,COGS 100,A01,083972,Staff,46,0,60,14
1649857370420,COGS 101C,A01,083976,Staff,25,0,30,5
1649857376447,COGS 102A,A01,083978,Johnson; Christine M.,24,0,30,6
1649857382473,COGS 107B,A01,083980,Staff,32,0,50,18
1649857388503,COGS 115,A01,083982,Staff,21,0,30,9
1649857394530,COGS 118B,A01,083367,Staff,5,0,40,35
1649857400560,COGS 172,A01,083984,Provenzano; Emily Kara,20,0,30,10
1649857406586,COGS 177,A00,083368,Staff,2,0,30,28
1649857412612,COGS 186,A01,083986,Staff,25,0,40,15
1649857418640,COGS 187A,A01,083988,Boyle; Mary E. T.,40,0,60,20
1649857424664,CSE 8A,A50,084003,Miranda; Gregory Joseph,9,0,15,6
1649857430689,CSE 11,A01,084005,Miranda; Gregory Joseph,49,0,55,6
1649857436712,CSE 20,A01,084007,Staff,15,0,20,5
1649857442737,CSE 21,A01,084009,Staff,32,0,50,18
1649857448760,CSE 30,A01,083370,Cao; Yingjun,20,0,40,20
1649857454800,CSE 100,A01,083372,Cao; Yingjun,13,0,40,27
1649857460830,CSE 101,A01,084011,Staff,0,16,40,40
1649857466853,CSE 141,A01,083374,Eldon; John,0,14,75,75
1649857472876,CSE 141L,A01,083376,Eldon; John,0,18,75,75
1649857478901,CSE 175,A01,084013,Kumar; Rakesh,24,0,25,1
1649857484924,CSE 190,A00,092508,Staff,15,0,15,0
1649857490949,ECE 5,A01,084049,Morris; Karcher William,17,0,20,3
1649857496974,ECE 100,A01,084051,Baghdadchi; Saharnaz,16,0,20,4
1649857496974,ECE 100,A02,091916,Baghdadchi; Saharnaz,18,0,20,2
1649857503009,ECE 101,A01,084053,Baghdadchi; Saharnaz,25,0,37,12
1649857503009,ECE 101,A02,084054,Baghdadchi; Saharnaz,37,0,37,0
1649857509031,ECE 107,A01,083390,Staff,31,0,40,9
1649857515054,ECE 148,A01,084056,Silberman; Jack,8,0,12,4
1649857521077,ECE 180,A00,083391,Abi Samra; Nicholas Camill,27,0,30,3
1649857521077,ECE 180,B00,083392,Abi Samra; Nicholas Camill,26,0,30,4
1649857527105,MATH 10B,A01,084110,Staff,20,0,30,10
1649857527105,MATH 10B,A02,084111,Staff,29,0,30,1
1649857527105,MATH 10B,A03,084112,Staff,29,0,30,1
1649857533131,MATH 10C,A01,083443,Staff,19,0,30,11
1649857533131,MATH 10C,A02,083444,Staff,24,0,30,6
1649857533131,MATH 10C,B01,084114,Staff,26,0,30,4
1649857533131,MATH 10C,B02,084115,Staff,30,0,30,0
1649857539154,MATH 18,A01,084117,Harel; Guershon,28,0,30,2
1649857539154,MATH 18,A02,084119,Harel; Guershon,29,0,30,1
1649857539154,MATH 18,A03,084120,Harel; Guershon,30,0,30,0
1649857539154,MATH 18,A04,084121,Harel; Guershon,30,0,30,0
1649857545176,MATH 20B,A01,084124,Um; Ko Woon,33,0,35,2
1649857545176,MATH 20B,B01,084126,Um; Ko Woon,35,0,35,0
1649857551202,MATH 20C,A01,083446,Hammock; Frances H,26,0,30,4
1649857551202,MATH 20C,A02,083447,Hammock; Frances H,30,0,30,0
1649857551202,MATH 20C,A03,083448,Hammock; Frances H,30,0,30,0
1649857551202,MATH 20C,A04,083449,Hammock; Frances H,30,0,30,0
1649857551202,MATH 20C,B01,083451,Hammock; Frances H,29,0,30,1
1649857551202,MATH 20C,B02,083452,Hammock; Frances H,30,0,30,0
1649857551202,MATH 20C,B03,083453,Hammock; Frances H,30,0,30,0
1649857551202,MATH 20C,B04,083454,Hammock; Frances H,30,0,30,0
1649857557231,MATH 20D,A01,084128,Staff,29,0,30,1
1649857557231,MATH 20D,A02,084129,Staff,30,0,30,0
1649857557231,MATH 20D,A03,084130,Staff,29,0,30,1
1649857557231,MATH 20D,B01,084133,Staff,28,0,30,2
1649857557231,MATH 20D,B02,084134,Staff,30,0,30,0
1649857557231,MATH 20D,B03,084135,Staff,30,0,30,0
1649857563259,MATH 20E,A01,084138,Staff,27,0,30,3
1649857563259,MATH 20E,A02,084139,Staff,29,0,30,1
1649857563259,MATH 20E,A03,084140,Staff,28,0,30,2
1649857563259,MATH 20E,A04,084141,Staff,30,0,30,0
1649857569284,MATH 102,A01,084143,Harel; Guershon,24,0,30,6
1649857569284,MATH 102,A02,084144,Harel; Guershon,25,0,30,5
1649857575312,MATH 103B,A01,083456,Staff,0,0,30,30
1649857575312,MATH 103B,A02,083457,Staff,18,0,30,12
1649857581345,MATH 109,A01,084146,Salehi Golsefidy; Alireza,30,0,30,0
1649857581345,MATH 109,A02,084147,Salehi Golsefidy; Alireza,26,0,30,4
1649857587373,MATH 120A,A01,085445,Eggers; John Dietrich,30,0,35,5
1649857587373,MATH 120A,A02,085446,Eggers; John Dietrich,31,0,35,4
1649857593396,MATH 142B,A01,084149,Verstraete; Jacques Allan,7,0,30,23
1649857593396,MATH 142B,A02,084150,Verstraete; Jacques Allan,25,0,30,5
1649857599419,MATH 170A,A01,083459,Nie; Jiawang,9,0,30,21
1649857599419,MATH 170A,A02,083460,Nie; Jiawang,25,0,30,5
1649857599419,MATH 170A,A03,083461,Nie; Jiawang,26,0,30,4
1649857605454,MATH 193B,A01,083463,Staff,15,0,30,15
1649857605454,MATH 193B,A02,083464,Staff,19,0,30,11
1649857605454,MATH 193B,A03,083465,Staff,27,0,30,3
1649857611603,COGS 2,A01,083966,Boyle; Mary E. T.,27,0,30,3
1649857617630,COGS 9,A01,083968,Staff,56,0,60,4
1649857623654,COGS 14B,A01,083970,Staff,46,0,50,4
1649857629681,COGS 17,A01,092679,Staff,73,0,75,2
1649857635713,COGS 100,A01,083972,Staff,46,0,60,14
1649857647760,COGS 101C,A01,083976,Staff,25,0,30,5
1649857653785,COGS 102A,A01,083978,Johnson; Christine M.,24,0,30,6
1649857659808,COGS 107B,A01,083980,Staff,32,0,50,18
1649857665838,COGS 115,A01,083982,Staff,21,0,30,9
1649857671861,COGS 118B,A01,083367,Staff,5,0,40,35
1649857677910,COGS 172,A01,083984,Provenzano; Emily Kara,20,0,30,10
1649857683932,COGS 177,A00,083368,Staff,2,0,30,28
1649857689978,COGS 186,A01,083986,Staff,25,0,40,15
1649857696006,COGS 187A,A01,083988,Boyle; Mary E. T.,40,0,60,20
1649857702034,CSE 8A,A50,084003,Miranda; Gregory Joseph,9,0,15,6
1649857708057,CSE 11,A01,084005,Miranda; Gregory Joseph,49,0,55,6
1649857714089,CSE 20,A01,084007,Staff,15,0,20,5
1649857720118,CSE 21,A01,084009,Staff,32,0,50,18
1649857726142,CSE 30,A01,083370,Cao; Yingjun,20,0,40,20
1649857732171,CSE 100,A01,083372,Cao; Yingjun,13,0,40,27
1649857738195,CSE 101,A01,084011,Staff,0,16,40,40
1649857744217,CSE 141,A01,083374,Eldon; John,0,14,75,75
1649857750244,CSE 141L,A01,083376,Eldon; John,0,18,75,75
1649857756268,CSE 175,A01,084013,Kumar; Rakesh,24,0,25,1
1649857762289,CSE 190,A00,092508,Staff,15,0,15,0
1649857768312,ECE 5,A01,084049,Morris; Karcher William,17,0,20,3
1649857774336,ECE 100,A01,084051,Baghdadchi; Saharnaz,16,0,20,4
1649857774336,ECE 100,A02,091916,Baghdadchi; Saharnaz,18,0,20,2
1649857780359,ECE 101,A01,084053,Baghdadchi; Saharnaz,25,0,37,12
1649857780359,ECE 101,A02,084054,Baghdadchi; Saharnaz,37,0,37,0
1649857786382,ECE 107,A01,083390,Staff,31,0,40,9
1649857792405,ECE 148,A01,084056,Silberman; Jack,8,0,12,4
1649857798428,ECE 180,A00,083391,Abi Samra; Nicholas Camill,27,0,30,3
1649857798428,ECE 180,B00,083392,Abi Samra; Nicholas Camill,26,0,30,4
1649857804460,MATH 10B,A01,084110,Staff,20,0,30,10
1649857804460,MATH 10B,A02,084111,Staff,29,0,30,1
1649857804460,MATH 10B,A03,084112,Staff,29,0,30,1
1649857810486,MATH 10C,A01,083443,Staff,19,0,30,11
1649857810486,MATH 10C,A02,083444,Staff,24,0,30,6
1649857810486,MATH 10C,B01,084114,Staff,26,0,30,4
1649857810486,MATH 10C,B02,084115,Staff,30,0,30,0
1649857816513,MATH 18,A01,084117,Harel; Guershon,28,0,30,2
1649857816513,MATH 18,A02,084119,Harel; Guershon,29,0,30,1
1649857816513,MATH 18,A03,084120,Harel; Guershon,30,0,30,0
1649857816513,MATH 18,A04,084121,Harel; Guershon,30,0,30,0
1649857822542,MATH 20B,A01,084124,Um; Ko Woon,33,0,35,2
1649857822542,MATH 20B,B01,084126,Um; Ko Woon,35,0,35,0
1649857828571,MATH 20C,A01,083446,Hammock; Frances H,26,0,30,4
1649857828571,MATH 20C,A02,083447,Hammock; Frances H,30,0,30,0
1649857828571,MATH 20C,A03,083448,Hammock; Frances H,30,0,30,0
1649857828571,MATH 20C,A04,083449,Hammock; Frances H,30,0,30,0
1649857828571,MATH 20C,B01,083451,Hammock; Frances H,29,0,30,1
1649857828571,MATH 20C,B02,083452,Hammock; Frances H,30,0,30,0
1649857828571,MATH 20C,B03,083453,Hammock; Frances H,30,0,30,0
1649857828571,MATH 20C,B04,083454,Hammock; Frances H,30,0,30,0
1649857834600,MATH 20D,A01,084128,Staff,29,0,30,1
1649857834600,MATH 20D,A02,084129,Staff,30,0,30,0
1649857834600,MATH 20D,A03,084130,Staff,29,0,30,1
1649857834600,MATH 20D,B01,084133,Staff,28,0,30,2
1649857834600,MATH 20D,B02,084134,Staff,30,0,30,0
1649857834600,MATH 20D,B03,084135,Staff,30,0,30,0
1649857840626,MATH 20E,A01,084138,Staff,27,0,30,3
1649857840626,MATH 20E,A02,084139,Staff,29,0,30,1
1649857840626,MATH 20E,A03,084140,Staff,28,0,30,2
1649857840626,MATH 20E,A04,084141,Staff,30,0,30,0
1649857846650,MATH 102,A01,084143,Harel; Guershon,24,0,30,6
1649857846650,MATH 102,A02,084144,Harel; Guershon,25,0,30,5
1649857852675,MATH 103B,A01,083456,Staff,0,0,30,30
1649857852675,MATH 103B,A02,083457,Staff,18,0,30,12
1649857858704,MATH 109,A01,084146,Salehi Golsefidy; Alireza,30,0,30,0
1649857858704,MATH 109,A02,084147,Salehi Golsefidy; Alireza,26,0,30,4
1649857864736,MATH 120A,A01,085445,Eggers; John Dietrich,30,0,35,5
1649857864736,MATH 120A,A02,085446,Eggers; John Dietrich,31,0,35,4
1649857870767,MATH 142B,A01,084149,Verstraete; Jacques Allan,7,0,30,23
1649857870767,MATH 142B,A02,084150,Verstraete; Jacques Allan,25,0,30,5
1649857876794,MATH 170A,A01,083459,Nie; Jiawang,9,0,30,21
1649857876794,MATH 170A,A02,083460,Nie; Jiawang,25,0,30,5
1649857876794,MATH 170A,A03,083461,Nie; Jiawang,26,0,30,4
1649857882819,MATH 193B,A01,083463,Staff,15,0,30,15
1649857882819,MATH 193B,A02,083464,Staff,19,0,30,11
1649857882819,MATH 193B,A03,083465,Staff,27,0,30,3
1649857888890,COGS 2,A01,083966,Boyle; Mary E. T.,27,0,30,3
1649857894920,COGS 9,A01,083968,Staff,56,0,60,4
1649857900964,COGS 14B,A01,083970,Staff,46,0,50,4
1649857906988,COGS 17,A01,092679,Staff,73,0,75,2
1649857913011,COGS 100,A01,083972,Staff,46,0,60,14
1649857925059,COGS 101C,A01,083976,Staff,25,0,30,5
1649857931086,COGS 102A,A01,083978,Johnson; Christine M.,24,0,30,6
1649857937109,COGS 107B,A01,083980,Staff,32,0,50,18
1649857943134,COGS 115,A01,083982,Staff,21,0,30,9
1649857949159,COGS 118B,A01,083367,Staff,5,0,40,35
1649857955192,COGS 172,A01,083984,Provenzano; Emily Kara,20,0,30,10
1649857961217,COGS 177,A00,083368,Staff,2,0,30,28
1649857967243,COGS 186,A01,083986,Staff,25,0,40,15
1649857973270,COGS 187A,A01,083988,Boyle; Mary E. T.,40,0,60,20
1649857979299,CSE 8A,A50,084003,Miranda; Gregory Joseph,9,0,15,6
1649857985324,CSE 11,A01,084005,Miranda; Gregory Joseph,49,0,55,6
1649857991352,CSE 20,A01,084007,Staff,15,0,20,5
1649857997376,CSE 21,A01,084009,Staff,32,0,50,18
1649858003399,CSE 30,A01,083370,Cao; Yingjun,20,0,40,20
1649858009424,CSE 100,A01,083372,Cao; Yingjun,13,0,40,27
1649858015453,CSE 101,A01,084011,Staff,0,16,40,40
1649858021477,CSE 141,A01,083374,Eldon; John,0,14,75,75
1649858027505,CSE 141L,A01,083376,Eldon; John,0,18,75,75
1649858033529,CSE 175,A01,084013,Kumar; Rakesh,24,0,25,1
1649858039552,CSE 190,A00,092508,Staff,15,0,15,0
1649858045574,ECE 5,A01,084049,Morris; Karcher William,17,0,20,3
1649858051604,ECE 100,A01,084051,Baghdadchi; Saharnaz,16,0,20,4
1649858051604,ECE 100,A02,091916,Baghdadchi; Saharnaz,18,0,20,2
1649858057632,ECE 101,A01,084053,Baghdadchi; Saharnaz,25,0,37,12
1649858057632,ECE 101,A02,084054,Baghdadchi; Saharnaz,37,0,37,0
1649858063657,ECE 107,A01,083390,Staff,31,0,40,9
1649858069685,ECE 148,A01,084056,Silberman; Jack,8,0,12,4
1649858075711,ECE 180,A00,083391,Abi Samra; Nicholas Camill,27,0,30,3
1649858075711,ECE 180,B00,083392,Abi Samra; Nicholas Camill,26,0,30,4
1649858081737,MATH 10B,A01,084110,Staff,20,0,30,10
1649858081737,MATH 10B,A02,084111,Staff,29,0,30,1
1649858081737,MATH 10B,A03,084112,Staff,29,0,30,1
1649858087761,MATH 10C,A01,083443,Staff,19,0,30,11
1649858087761,MATH 10C,A02,083444,Staff,24,0,30,6
1649858087761,MATH 10C,B01,084114,Staff,26,0,30,4
1649858087761,MATH 10C,B02,084115,Staff,30,0,30,0
1649858093786,MATH 18,A01,084117,Harel; Guershon,28,0,30,2
1649858093786,MATH 18,A02,084119,Harel; Guershon,29,0,30,1
1649858093786,MATH 18,A03,084120,Harel; Guershon,30,0,30,0
1649858093786,MATH 18,A04,084121,Harel; Guershon,30,0,30,0
1649858099809,MATH 20B,A01,084124,Um; Ko Woon,33,0,35,2
1649858099809,MATH 20B,B01,084126,Um; Ko Woon,35,0,35,0
1649858105839,MATH 20C,A01,083446,Hammock; Frances H,26,0,30,4
1649858105839,MATH 20C,A02,083447,Hammock; Frances H,30,0,30,0
1649858105839,MATH 20C,A03,083448,Hammock; Frances H,30,0,30,0
1649858105839,MATH 20C,A04,083449,Hammock; Frances H,30,0,30,0
1649858105839,MATH 20C,B01,083451,Hammock; Frances H,29,0,30,1
1649858105839,MATH 20C,B02,083452,Hammock; Frances H,30,0,30,0
1649858105839,MATH 20C,B03,083453,Hammock; Frances H,30,0,30,0
1649858105839,MATH 20C,B04,083454,Hammock; Frances H,30,0,30,0
1649858111866,MATH 20D,A01,084128,Staff,29,0,30,1
1649858111866,MATH 20D,A02,084129,Staff,30,0,30,0
1649858111866,MATH 20D,A03,084130,Staff,29,0,30,1
1649858111866,MATH 20D,B01,084133,Staff,28,0,30,2
1649858111866,MATH 20D,B02,084134,Staff,30,0,30,0
1649858111866,MATH 20D,B03,084135,Staff,30,0,30,0
1649858117893,MATH 20E,A01,084138,Staff,27,0,30,3
1649858117893,MATH 20E,A02,084139,Staff,29,0,30,1
1649858117893,MATH 20E,A03,084140,Staff,28,0,30,2
1649858117893,MATH 20E,A04,084141,Staff,30,0,30,0
1649858123917,MATH 102,A01,084143,Harel; Guershon,24,0,30,6
1649858123917,MATH 102,A02,084144,Harel; Guershon,25,0,30,5
1649858129952,MATH 103B,A01,083456,Staff,0,0,30,30
1649858129952,MATH 103B,A02,083457,Staff,18,0,30,12
1649858135976,MATH 109,A01,084146,Salehi Golsefidy; Alireza,30,0,30,0
1649858135976,MATH 109,A02,084147,Salehi Golsefidy; Alireza,26,0,30,4
1649858142004,MATH 120A,A01,085445,Eggers; John Dietrich,30,0,35,5
1649858142004,MATH 120A,A02,085446,Eggers; John Dietrich,31,0,35,4
1649858148028,MATH 142B,A01,084149,Verstraete; Jacques Allan,7,0,30,23
1649858148028,MATH 142B,A02,084150,Verstraete; Jacques Allan,25,0,30,5
1649858154051,MATH 170A,A01,083459,Nie; Jiawang,9,0,30,21
1649858154051,MATH 170A,A02,083460,Nie; Jiawang,25,0,30,5
1649858154051,MATH 170A,A03,083461,Nie; Jiawang,26,0,30,4
1649858160075,MATH 193B,A01,083463,Staff,15,0,30,15
1649858160075,MATH 193B,A02,083464,Staff,19,0,30,11
1649858160075,MATH 193B,A03,083465,Staff,27,0,30,3
1649858166125,COGS 2,A01,083966,Boyle; Mary E. T.,27,0,30,3
1649858172151,COGS 9,A01,083968,Staff,56,0,60,4
1649858178181,COGS 14B,A01,083970,Staff,46,0,50,4
1649858184206,COGS 17,A01,092679,Staff,73,0,75,2
1649858190240,COGS 100,A01,083972,Staff,46,0,60,14
1649858202287,COGS 101C,A01,083976,Staff,25,0,30,5
1649858208409,COGS 102A,A01,083978,Johnson; Christine M.,24,0,30,6
1649858214439,COGS 107B,A01,083980,Staff,32,0,50,18
1649858220463,COGS 115,A01,083982,Staff,21,0,30,9
1649858226486,COGS 118B,A01,083367,Staff,5,0,40,35
1649858232509,COGS 172,A01,083984,Provenzano; Emily Kara,20,0,30,10
1649858238533,COGS 177,A00,083368,Staff,2,0,30,28
1649858244568,COGS 186,A01,083986,Staff,25,0,40,15
1649858250592,COGS 187A,A01,083988,Boyle; Mary E. T.,40,0,60,20
1649858256617,CSE 8A,A50,084003,Miranda; Gregory Joseph,9,0,15,6
1649858262643,CSE 11,A01,084005,Miranda; Gregory Joseph,49,0,55,6
1649858268670,CSE 20,A01,084007,Staff,15,0,20,5
1649858274695,CSE 21,A01,084009,Staff,32,0,50,18
1649858280722,CSE 30,A01,083370,Cao; Yingjun,20,0,40,20
1649858286745,CSE 100,A01,083372,Cao; Yingjun,13,0,40,27
1649858292770,CSE 101,A01,084011,Staff,0,16,40,40
1649858298793,CSE 141,A01,083374,Eldon; John,0,14,75,75
1649858304818,CSE 141L,A01,083376,Eldon; John,0,18,75,75
1649858310845,CSE 175,A01,084013,Kumar; Rakesh,24,0,25,1
1649858316867,CSE 190,A00,092508,Staff,15,0,15,0
1649858322896,ECE 5,A01,084049,Morris; Karcher William,17,0,20,3
1649858328921,ECE 100,A01,084051,Baghdadchi; Saharnaz,16,0,20,4
1649858328921,ECE 100,A02,091916,Baghdadchi; Saharnaz,18,0,20,2
1649858334944,ECE 101,A01,084053,Baghdadchi; Saharnaz,25,0,37,12
1649858334944,ECE 101,A02,084054,Baghdadchi; Saharnaz,37,0,37,0
1649858340968,ECE 107,A01,083390,Staff,31,0,40,9
1649858346992,ECE 148,A01,084056,Silberman; Jack,8,0,12,4
1649858353017,ECE 180,A00,083391,Abi Samra; Nicholas Camill,27,0,30,3
1649858353017,ECE 180,B00,083392,Abi Samra; Nicholas Camill,26,0,30,4
1649858359040,MATH 10B,A01,084110,Staff,20,0,30,10
1649858359040,MATH 10B,A02,084111,Staff,29,0,30,1
1649858359040,MATH 10B,A03,084112,Staff,29,0,30,1
1649858365064,MATH 10C,A01,083443,Staff,19,0,30,11
1649858365064,MATH 10C,A02,083444,Staff,24,0,30,6
1649858365064,MATH 10C,B01,084114,Staff,26,0,30,4
1649858365064,MATH 10C,B02,084115,Staff,30,0,30,0
1649858371106,MATH 18,A01,084117,Harel; Guershon,28,0,30,2
1649858371106,MATH 18,A02,084119,Harel; Guershon,29,0,30,1
1649858371106,MATH 18,A03,084120,Harel; Guershon,30,0,30,0
1649858371106,MATH 18,A04,084121,Harel; Guershon,30,0,30,0
1649858377132,MATH 20B,A01,084124,Um; Ko Woon,33,0,35,2
1649858377132,MATH 20B,B01,084126,Um; Ko Woon,35,0,35,0
1649858383162,MATH 20C,A01,083446,Hammock; Frances H,26,0,30,4
1649858383162,MATH 20C,A02,083447,Hammock; Frances H,30,0,30,0
1649858383162,MATH 20C,A03,083448,Hammock; Frances H,30,0,30,0
1649858383162,MATH 20C,A04,083449,Hammock; Frances H,30,0,30,0
1649858383162,MATH 20C,B01,083451,Hammock; Frances H,29,0,30,1
1649858383162,MATH 20C,B02,083452,Hammock; Frances H,30,0,30,0
1649858383162,MATH 20C,B03,083453,Hammock; Frances H,30,0,30,0
1649858383162,MATH 20C,B04,083454,Hammock; Frances H,30,0,30,0
1649858389191,MATH 20D,A01,084128,Staff,29,0,30,1
1649858389191,MATH 20D,A02,084129,Staff,30,0,30,0
1649858389191,MATH 20D,A03,084130,Staff,29,0,30,1
1649858389191,MATH 20D,B01,084133,Staff,28,0,30,2
1649858389191,MATH 20D,B02,084134,Staff,30,0,30,0
1649858389191,MATH 20D,B03,084135,Staff,30,0,30,0
1649858395219,MATH 20E,A01,084138,Staff,27,0,30,3
1649858395219,MATH 20E,A02,084139,Staff,29,0,30,1
1649858395219,MATH 20E,A03,084140,Staff,28,0,30,2
1649858395219,MATH 20E,A04,084141,Staff,30,0,30,0
1649858401247,MATH 102,A01,084143,Harel; Guershon,24,0,30,6
1649858401247,MATH 102,A02,084144,Harel; Guershon,25,0,30,5
1649858407270,MATH 103B,A01,083456,Staff,0,0,30,30
1649858407270,MATH 103B,A02,083457,Staff,18,0,30,12
1649858413292,MATH 109,A01,084146,Salehi Golsefidy; Alireza,30,0,30,0
1649858413292,MATH 109,A02,084147,Salehi Golsefidy; Alireza,26,0,30,4
1649858419315,MATH 120A,A01,085445,Eggers; John Dietrich,30,0,35,5
1649858419315,MATH 120A,A02,085446,Eggers; John Dietrich,31,0,35,4
1649858425343,MATH 142B,A01,084149,Verstraete; Jacques Allan,7,0,30,23
1649858425343,MATH 142B,A02,084150,Verstraete; Jacques Allan,25,0,30,5
1649858431370,MATH 170A,A01,083459,Nie; Jiawang,9,0,30,21
1649858431370,MATH 170A,A02,083460,Nie; Jiawang,25,0,30,5
1649858431370,MATH 170A,A03,083461,Nie; Jiawang,26,0,30,4
1649858437396,MATH 193B,A01,083463,Staff,15,0,30,15
1649858437396,MATH 193B,A02,083464,Staff,19,0,30,11
1649858437396,MATH 193B,A03,083465,Staff,27,0,30,3
1649858443451,COGS 2,A01,083966,Boyle; Mary E. T.,27,0,30,3
1649858449475,COGS 9,A01,083968,Staff,56,0,60,4
1649858455499,COGS 14B,A01,083970,Staff,46,0,50,4
1649858461528,COGS 17,A01,092679,Staff,73,0,75,2
1649858467552,COGS 100,A01,083972,Staff,46,0,60,14
1649858479601,COGS 101C,A01,083976,Staff,25,0,30,5
1649858485629,COGS 102A,A01,083978,Johnson; Christine M.,24,0,30,6
1649858491652,COGS 107B,A01,083980,Staff,32,0,50,18
1649858497678,COGS 115,A01,083982,Staff,21,0,30,9
1649858503705,COGS 118B,A01,083367,Staff,5,0,40,35
1649858509732,COGS 172,A01,083984,Provenzano; Emily Kara,20,0,30,10
1649858515759,COGS 177,A00,083368,Staff,2,0,30,28
1649858521787,COGS 186,A01,083986,Staff,25,0,40,15
1649858527814,COGS 187A,A01,083988,Boyle; Mary E. T.,40,0,60,20
1649858533842,CSE 8A,A50,084003,Miranda; Gregory Joseph,9,0,15,6
1649858539867,CSE 11,A01,084005,Miranda; Gregory Joseph,49,0,55,6
1649858545896,CSE 20,A01,084007,Staff,15,0,20,5
1649858551919,CSE 21,A01,084009,Staff,32,0,50,18
1649858557944,CSE 30,A01,083370,Cao; Yingjun,20,0,40,20
1649858563967,CSE 100,A01,083372,Cao; Yingjun,13,0,40,27
1649858569995,CSE 101,A01,084011,Staff,0,16,40,40
1649858576018,CSE 141,A01,083374,Eldon; John,0,14,75,75
1649858582046,CSE 141L,A01,083376,Eldon; John,0,18,75,75
1649858588074,CSE 175,A01,084013,Kumar; Rakesh,24,0,25,1
1649858594100,CSE 190,A00,092508,Staff,15,0,15,0
1649858600124,ECE 5,A01,084049,Morris; Karcher William,17,0,20,3
1649858606152,ECE 100,A01,084051,Baghdadchi; Saharnaz,16,0,20,4
1649858606152,ECE 100,A02,091916,Baghdadchi; Saharnaz,18,0,20,2
1649858612179,ECE 101,A01,084053,Baghdadchi; Saharnaz,25,0,37,12
1649858612179,ECE 101,A02,084054,Baghdadchi; Saharnaz,37,0,37,0
1649858618207,ECE 107,A01,083390,Staff,31,0,40,9
1649858624236,ECE 148,A01,084056,Silberman; Jack,8,0,12,4
1649858630260,ECE 180,A00,083391,Abi Samra; Nicholas Camill,27,0,30,3
1649858630260,ECE 180,B00,083392,Abi Samra; Nicholas Camill,26,0,30,4
1649858636286,MATH 10B,A01,084110,Staff,20,0,30,10
1649858636286,MATH 10B,A02,084111,Staff,29,0,30,1
1649858636286,MATH 10B,A03,084112,Staff,29,0,30,1
1649858642310,MATH 10C,A01,083443,Staff,19,0,30,11
1649858642310,MATH 10C,A02,083444,Staff,24,0,30,6
1649858642310,MATH 10C,B01,084114,Staff,26,0,30,4
1649858642310,MATH 10C,B02,084115,Staff,30,0,30,0
1649858648340,MATH 18,A01,084117,Harel; Guershon,28,0,30,2
1649858648340,MATH 18,A02,084119,Harel; Guershon,29,0,30,1
1649858648340,MATH 18,A03,084120,Harel; Guershon,30,0,30,0
1649858648340,MATH 18,A04,084121,Harel; Guershon,30,0,30,0
1649858654365,MATH 20B,A01,084124,Um; Ko Woon,33,0,35,2
1649858654365,MATH 20B,B01,084126,Um; Ko Woon,35,0,35,0
1649858660394,MATH 20C,A01,083446,Hammock; Frances H,26,0,30,4
1649858660394,MATH 20C,A02,083447,Hammock; Frances H,30,0,30,0
1649858660394,MATH 20C,A03,083448,Hammock; Frances H,30,0,30,0
1649858660394,MATH 20C,A04,083449,Hammock; Frances H,30,0,30,0
1649858660394,MATH 20C,B01,083451,Hammock; Frances H,29,0,30,1
1649858660394,MATH 20C,B02,083452,Hammock; Frances H,30,0,30,0
1649858660394,MATH 20C,B03,083453,Hammock; Frances H,30,0,30,0
1649858660394,MATH 20C,B04,083454,Hammock; Frances H,30,0,30,0
1649858666418,MATH 20D,A01,084128,Staff,29,0,30,1
1649858666418,MATH 20D,A02,084129,Staff,30,0,30,0
1649858666418,MATH 20D,A03,084130,Staff,29,0,30,1
1649858666418,MATH 20D,B01,084133,Staff,28,0,30,2
1649858666418,MATH 20D,B02,084134,Staff,30,0,30,0
1649858666418,MATH 20D,B03,084135,Staff,30,0,30,0
1649858672449,MATH 20E,A01,084138,Staff,27,0,30,3
1649858672449,MATH 20E,A02,084139,Staff,29,0,30,1
1649858672449,MATH 20E,A03,084140,Staff,28,0,30,2
1649858672449,MATH 20E,A04,084141,Staff,30,0,30,0
1649858678472,MATH 102,A01,084143,Harel; Guershon,24,0,30,6
1649858678472,MATH 102,A02,084144,Harel; Guershon,25,0,30,5
1649858684498,MATH 103B,A01,083456,Staff,0,0,30,30
1649858684498,MATH 103B,A02,083457,Staff,18,0,30,12
1649858690526,MATH 109,A01,084146,Salehi Golsefidy; Alireza,30,0,30,0
1649858690526,MATH 109,A02,084147,Salehi Golsefidy; Alireza,26,0,30,4
1649858696558,MATH 120A,A01,085445,Eggers; John Dietrich,30,0,35,5
1649858696558,MATH 120A,A02,085446,Eggers; John Dietrich,31,0,35,4
1649858702581,MATH 142B,A01,084149,Verstraete; Jacques Allan,7,0,30,23
1649858702581,MATH 142B,A02,084150,Verstraete; Jacques Allan,25,0,30,5
1649858708605,MATH 170A,A01,083459,Nie; Jiawang,9,0,30,21
1649858708605,MATH 170A,A02,083460,Nie; Jiawang,25,0,30,5
1649858708605,MATH 170A,A03,083461,Nie; Jiawang,26,0,30,4
1649858714631,MATH 193B,A01,083463,Staff,15,0,30,15
1649858714631,MATH 193B,A02,083464,Staff,19,0,30,11
1649858714631,MATH 193B,A03,083465,Staff,27,0,30,3
1649858720692,COGS 2,A01,083966,Boyle; Mary E. T.,27,0,30,3
1649858726718,COGS 9,A01,083968,Staff,56,0,60,4
1649858732744,COGS 14B,A01,083970,Staff,46,0,50,4
1649858738769,COGS 17,A01,092679,Staff,73,0,75,2
1649858744792,COGS 100,A01,083972,Staff,46,0,60,14
1649858756863,COGS 101C,A01,083976,Staff,25,0,30,5
1649858762885,COGS 102A,A01,083978,Johnson; Christine M.,24,0,30,6
1649858768907,COGS 107B,A01,083980,Staff,32,0,50,18
1649858774933,COGS 115,A01,083982,Staff,21,0,30,9
1649858780959,COGS 118B,A01,083367,Staff,5,0,40,35
1649858786988,COGS 172,A01,083984,Provenzano; Emily Kara,20,0,30,10
1649858793020,COGS 177,A00,083368,Staff,2,0,30,28
1649858799045,COGS 186,A01,083986,Staff,25,0,40,15
1649858805161,COGS 187A,A01,083988,Boyle; Mary E. T.,40,0,60,20
1649858811185,CSE 8A,A50,084003,Miranda; Gregory Joseph,9,0,15,6
1649858817212,CSE 11,A01,084005,Miranda; Gregory Joseph,49,0,55,6
1649858823236,CSE 20,A01,084007,Staff,15,0,20,5
1649858829260,CSE 21,A01,084009,Staff,32,0,50,18
1649858835283,CSE 30,A01,083370,Cao; Yingjun,20,0,40,20
1649858841306,CSE 100,A01,083372,Cao; Yingjun,13,0,40,27
1649858847333,CSE 101,A01,084011,Staff,0,16,40,40
1649858853360,CSE 141,A01,083374,Eldon; John,0,14,75,75
1649858859388,CSE 141L,A01,083376,Eldon; John,0,18,75,75
1649858865413,CSE 175,A01,084013,Kumar; Rakesh,24,0,25,1
1649858871440,CSE 190,A00,092508,Staff,15,0,15,0
1649858877467,ECE 5,A01,084049,Morris; Karcher William,17,0,20,3
1649858883491,ECE 100,A01,084051,Baghdadchi; Saharnaz,16,0,20,4
1649858883491,ECE 100,A02,091916,Baghdadchi; Saharnaz,18,0,20,2
1649858889521,ECE 101,A01,084053,Baghdadchi; Saharnaz,25,0,37,12
1649858889521,ECE 101,A02,084054,Baghdadchi; Saharnaz,37,0,37,0
1649858895546,ECE 107,A01,083390,Staff,31,0,40,9
1649858901579,ECE 148,A01,084056,Silberman; Jack,8,0,12,4
1649858907607,ECE 180,A00,083391,Abi Samra; Nicholas Camill,27,0,30,3
1649858907607,ECE 180,B00,083392,Abi Samra; Nicholas Camill,26,0,30,4
1649858913632,MATH 10B,A01,084110,Staff,20,0,30,10
1649858913632,MATH 10B,A02,084111,Staff,29,0,30,1
1649858913632,MATH 10B,A03,084112,Staff,29,0,30,1
1649858919660,MATH 10C,A01,083443,Staff,19,0,30,11
1649858919660,MATH 10C,A02,083444,Staff,24,0,30,6
1649858919660,MATH 10C,B01,084114,Staff,26,0,30,4
1649858919660,MATH 10C,B02,084115,Staff,30,0,30,0
1649858925692,MATH 18,A01,084117,Harel; Guershon,28,0,30,2
1649858925692,MATH 18,A02,084119,Harel; Guershon,29,0,30,1
1649858925692,MATH 18,A03,084120,Harel; Guershon,30,0,30,0
1649858925692,MATH 18,A04,084121,Harel; Guershon,30,0,30,0
1649858931718,MATH 20B,A01,084124,Um; Ko Woon,33,0,35,2
1649858931718,MATH 20B,B01,084126,Um; Ko Woon,35,0,35,0
1649858937745,MATH 20C,A01,083446,Hammock; Frances H,26,0,30,4
1649858937745,MATH 20C,A02,083447,Hammock; Frances H,30,0,30,0
1649858937745,MATH 20C,A03,083448,Hammock; Frances H,30,0,30,0
1649858937745,MATH 20C,A04,083449,Hammock; Frances H,30,0,30,0
1649858937745,MATH 20C,B01,083451,Hammock; Frances H,29,0,30,1
1649858937745,MATH 20C,B02,083452,Hammock; Frances H,30,0,30,0
1649858937745,MATH 20C,B03,083453,Hammock; Frances H,30,0,30,0
1649858937745,MATH 20C,B04,083454,Hammock; Frances H,30,0,30,0
1649858943773,MATH 20D,A01,084128,Staff,29,0,30,1
1649858943773,MATH 20D,A02,084129,Staff,30,0,30,0
1649858943773,MATH 20D,A03,084130,Staff,29,0,30,1
1649858943773,MATH 20D,B01,084133,Staff,28,0,30,2
1649858943773,MATH 20D,B02,084134,Staff,30,0,30,0
1649858943773,MATH 20D,B03,084135,Staff,30,0,30,0
1649858949798,MATH 20E,A01,084138,Staff,27,0,30,3
1649858949798,MATH 20E,A02,084139,Staff,29,0,30,1
1649858949798,MATH 20E,A03,084140,Staff,28,0,30,2
1649858949798,MATH 20E,A04,084141,Staff,30,0,30,0
1649858955823,MATH 102,A01,084143,Harel; Guershon,24,0,30,6
1649858955823,MATH 102,A02,084144,Harel; Guershon,25,0,30,5
1649858961849,MATH 103B,A01,083456,Staff,0,0,30,30
1649858961849,MATH 103B,A02,083457,Staff,18,0,30,12
1649858967876,MATH 109,A01,084146,Salehi Golsefidy; Alireza,30,0,30,0
1649858967876,MATH 109,A02,084147,Salehi Golsefidy; Alireza,26,0,30,4
1649858973899,MATH 120A,A01,085445,Eggers; John Dietrich,30,0,35,5
1649858973899,MATH 120A,A02,085446,Eggers; John Dietrich,31,0,35,4
1649858979928,MATH 142B,A01,084149,Verstraete; Jacques Allan,7,0,30,23
1649858979928,MATH 142B,A02,084150,Verstraete; Jacques Allan,25,0,30,5
1649858985951,MATH 170A,A01,083459,Nie; Jiawang,9,0,30,21
1649858985951,MATH 170A,A02,083460,Nie; Jiawang,25,0,30,5
1649858985951,MATH 170A,A03,083461,Nie; Jiawang,26,0,30,4
1649858991979,MATH 193B,A01,083463,Staff,15,0,30,15
1649858991979,MATH 193B,A02,083464,Staff,19,0,30,11
1649858991979,MATH 193B,A03,083465,Staff,27,0,30,3
1649858998043,COGS 2,A01,083966,Boyle; Mary E. T.,27,0,30,3
1649859004072,COGS 9,A01,083968,Staff,56,0,60,4
1649859010097,COGS 14B,A01,083970,Staff,46,0,50,4
1649859016124,COGS 17,A01,092679,Staff,73,0,75,2
1649859022154,COGS 100,A01,083972,Staff,46,0,60,14
1649859034200,COGS 101C,A01,083976,Staff,25,0,30,5
1649859040223,COGS 102A,A01,083978,Johnson; Christine M.,24,0,30,6
1649859046250,COGS 107B,A01,083980,Staff,32,0,50,18
1649859052272,COGS 115,A01,083982,Staff,21,0,30,9
1649859058297,COGS 118B,A01,083367,Staff,5,0,40,35
1649859064325,COGS 172,A01,083984,Provenzano; Emily Kara,20,0,30,10
1649859070355,COGS 177,A00,083368,Staff,2,0,30,28
1649859076382,COGS 186,A01,083986,Staff,25,0,40,15
1649859082406,COGS 187A,A01,083988,Boyle; Mary E. T.,40,0,60,20
1649859088435,CSE 8A,A50,084003,Miranda; Gregory Joseph,9,0,15,6
1649859094473,CSE 11,A01,084005,Miranda; Gregory Joseph,49,0,55,6
1649859100500,CSE 20,A01,084007,Staff,15,0,20,5
1649859106526,CSE 21,A01,084009,Staff,32,0,50,18
1649859112553,CSE 30,A01,083370,Cao; Yingjun,20,0,40,20
1649859118577,CSE 100,A01,083372,Cao; Yingjun,13,0,40,27
1649859124602,CSE 101,A01,084011,Staff,0,16,40,40
1649859130624,CSE 141,A01,083374,Eldon; John,0,14,75,75
1649859136649,CSE 141L,A01,083376,Eldon; John,0,18,75,75
1649859142672,CSE 175,A01,084013,Kumar; Rakesh,24,0,25,1
1649859148706,CSE 190,A00,092508,Staff,15,0,15,0
1649859154729,ECE 5,A01,084049,Morris; Karcher William,17,0,20,3
1649859160758,ECE 100,A01,084051,Baghdadchi; Saharnaz,16,0,20,4
1649859160758,ECE 100,A02,091916,Baghdadchi; Saharnaz,18,0,20,2
1649859166793,ECE 101,A01,084053,Baghdadchi; Saharnaz,25,0,37,12
1649859166793,ECE 101,A02,084054,Baghdadchi; Saharnaz,37,0,37,0
1649859172820,ECE 107,A01,083390,Staff,31,0,40,9
1649859178846,ECE 148,A01,084056,Silberman; Jack,8,0,12,4
1649859184869,ECE 180,A00,083391,Abi Samra; Nicholas Camill,27,0,30,3
1649859184869,ECE 180,B00,083392,Abi Samra; Nicholas Camill,26,0,30,4
1649859190891,MATH 10B,A01,084110,Staff,20,0,30,10
1649859190891,MATH 10B,A02,084111,Staff,29,0,30,1
1649859190891,MATH 10B,A03,084112,Staff,29,0,30,1
1649859196917,MATH 10C,A01,083443,Staff,19,0,30,11
1649859196917,MATH 10C,A02,083444,Staff,24,0,30,6
1649859196917,MATH 10C,B01,084114,Staff,26,0,30,4
1649859196917,MATH 10C,B02,084115,Staff,30,0,30,0
1649859202947,MATH 18,A01,084117,Harel; Guershon,28,0,30,2
1649859202947,MATH 18,A02,084119,Harel; Guershon,29,0,30,1
1649859202947,MATH 18,A03,084120,Harel; Guershon,30,0,30,0
1649859202947,MATH 18,A04,084121,Harel; Guershon,30,0,30,0
1649859208972,MATH 20B,A01,084124,Um; Ko Woon,33,0,35,2
1649859208972,MATH 20B,B01,084126,Um; Ko Woon,35,0,35,0
1649859214999,MATH 20C,A01,083446,Hammock; Frances H,26,0,30,4
1649859214999,MATH 20C,A02,083447,Hammock; Frances H,30,0,30,0
1649859214999,MATH 20C,A03,083448,Hammock; Frances H,30,0,30,0
1649859214999,MATH 20C,A04,083449,Hammock; Frances H,30,0,30,0
1649859214999,MATH 20C,B01,083451,Hammock; Frances H,29,0,30,1
1649859214999,MATH 20C,B02,083452,Hammock; Frances H,30,0,30,0
1649859214999,MATH 20C,B03,083453,Hammock; Frances H,30,0,30,0
1649859214999,MATH 20C,B04,083454,Hammock; Frances H,30,0,30,0
1649859221026,MATH 20D,A01,084128,Staff,29,0,30,1
1649859221026,MATH 20D,A02,084129,Staff,30,0,30,0
1649859221026,MATH 20D,A03,084130,Staff,29,0,30,1
1649859221026,MATH 20D,B01,084133,Staff,28,0,30,2
1649859221026,MATH 20D,B02,084134,Staff,30,0,30,0
1649859221026,MATH 20D,B03,084135,Staff,30,0,30,0
1649859227054,MATH 20E,A01,084138,Staff,27,0,30,3
1649859227054,MATH 20E,A02,084139,Staff,29,0,30,1
1649859227054,MATH 20E,A03,084140,Staff,28,0,30,2
1649859227054,MATH 20E,A04,084141,Staff,30,0,30,0
1649859233078,MATH 102,A01,084143,Harel; Guershon,24,0,30,6
1649859233078,MATH 102,A02,084144,Harel; Guershon,25,0,30,5
1649859239101,MATH 103B,A01,083456,Staff,0,0,30,30
1649859239101,MATH 103B,A02,083457,Staff,18,0,30,12
1649859245128,MATH 109,A01,084146,Salehi Golsefidy; Alireza,30,0,30,0
1649859245128,MATH 109,A02,084147,Salehi Golsefidy; Alireza,26,0,30,4
1649859251160,MATH 120A,A01,085445,Eggers; John Dietrich,30,0,35,5
1649859251160,MATH 120A,A02,085446,Eggers; John Dietrich,31,0,35,4
1649859257185,MATH 142B,A01,084149,Verstraete; Jacques Allan,7,0,30,23
1649859257185,MATH 142B,A02,084150,Verstraete; Jacques Allan,25,0,30,5
1649859263210,MATH 170A,A01,083459,Nie; Jiawang,9,0,30,21
1649859263210,MATH 170A,A02,083460,Nie; Jiawang,25,0,30,5
1649859263210,MATH 170A,A03,083461,Nie; Jiawang,26,0,30,4
1649859269232,MATH 193B,A01,083463,Staff,15,0,30,15
1649859269232,MATH 193B,A02,083464,Staff,19,0,30,11
1649859269232,MATH 193B,A03,083465,Staff,27,0,30,3
1649859275289,COGS 2,A01,083966,Boyle; Mary E. T.,27,0,30,3
1649859281313,COGS 9,A01,083968,Staff,56,0,60,4
1649859287339,COGS 14B,A01,083970,Staff,46,0,50,4
1649859293363,COGS 17,A01,092679,Staff,73,0,75,2
1649859299387,COGS 100,A01,083972,Staff,46,0,60,14
1649859311440,COGS 101C,A01,083976,Staff,25,0,30,5
1649859317490,COGS 102A,A01,083978,Johnson; Christine M.,24,0,30,6
1649859323515,COGS 107B,A01,083980,Staff,32,0,50,18
1649859329545,COGS 115,A01,083982,Staff,21,0,30,9
1649859335568,COGS 118B,A01,083367,Staff,5,0,40,35
1649859341594,COGS 172,A01,083984,Provenzano; Emily Kara,20,0,30,10
1649859347616,COGS 177,A00,083368,Staff,2,0,30,28
1649859353645,COGS 186,A01,083986,Staff,25,0,40,15
1649859359670,COGS 187A,A01,083988,Boyle; Mary E. T.,40,0,60,20
1649859365700,CSE 8A,A50,084003,Miranda; Gregory Joseph,9,0,15,6
1649859371726,CSE 11,A01,084005,Miranda; Gregory Joseph,49,0,55,6
1649859377750,CSE 20,A01,084007,Staff,15,0,20,5
1649859383791,CSE 21,A01,084009,Staff,32,0,50,18
1649859389815,CSE 30,A01,083370,Cao; Yingjun,20,0,40,20
1649859395850,CSE 100,A01,083372,Cao; Yingjun,13,0,40,27
1649859401965,CSE 101,A01,084011,Staff,0,16,40,40
1649859407991,CSE 141,A01,083374,Eldon; John,0,14,75,75
1649859414012,CSE 141L,A01,083376,Eldon; John,0,18,75,75
1649859420036,CSE 175,A01,084013,Kumar; Rakesh,24,0,25,1
1649859426060,CSE 190,A00,092508,Staff,15,0,15,0
1649859432086,ECE 5,A01,084049,Morris; Karcher William,17,0,20,3
1649859438109,ECE 100,A01,084051,Baghdadchi; Saharnaz,16,0,20,4
1649859438109,ECE 100,A02,091916,Baghdadchi; Saharnaz,18,0,20,2
1649859444136,ECE 101,A01,084053,Baghdadchi; Saharnaz,25,0,37,12
1649859444136,ECE 101,A02,084054,Baghdadchi; Saharnaz,37,0,37,0
1649859450163,ECE 107,A01,083390,Staff,31,0,40,9
1649859456189,ECE 148,A01,084056,Silberman; Jack,8,0,12,4
1649859462215,ECE 180,A00,083391,Abi Samra; Nicholas Camill,27,0,30,3
1649859462215,ECE 180,B00,083392,Abi Samra; Nicholas Camill,26,0,30,4
1649859468237,MATH 10B,A01,084110,Staff,20,0,30,10
1649859468237,MATH 10B,A02,084111,Staff,29,0,30,1
1649859468237,MATH 10B,A03,084112,Staff,29,0,30,1
1649859474263,MATH 10C,A01,083443,Staff,19,0,30,11
1649859474263,MATH 10C,A02,083444,Staff,24,0,30,6
1649859474263,MATH 10C,B01,084114,Staff,26,0,30,4
1649859474263,MATH 10C,B02,084115,Staff,30,0,30,0
1649859480286,MATH 18,A01,084117,Harel; Guershon,28,0,30,2
1649859480286,MATH 18,A02,084119,Harel; Guershon,29,0,30,1
1649859480286,MATH 18,A03,084120,Harel; Guershon,30,0,30,0
1649859480286,MATH 18,A04,084121,Harel; Guershon,30,0,30,0
1649859486309,MATH 20B,A01,084124,Um; Ko Woon,33,0,35,2
1649859486309,MATH 20B,B01,084126,Um; Ko Woon,35,0,35,0
1649859492333,MATH 20C,A01,083446,Hammock; Frances H,26,0,30,4
1649859492333,MATH 20C,A02,083447,Hammock; Frances H,30,0,30,0
1649859492333,MATH 20C,A03,083448,Hammock; Frances H,30,0,30,0
1649859492333,MATH 20C,A04,083449,Hammock; Frances H,30,0,30,0
1649859492333,MATH 20C,B01,083451,Hammock; Frances H,29,0,30,1
1649859492333,MATH 20C,B02,083452,Hammock; Frances H,30,0,30,0
1649859492333,MATH 20C,B03,083453,Hammock; Frances H,30,0,30,0
1649859492333,MATH 20C,B04,083454,Hammock; Frances H,30,0,30,0
1649859498361,MATH 20D,A01,084128,Staff,29,0,30,1
1649859498361,MATH 20D,A02,084129,Staff,30,0,30,0
1649859498361,MATH 20D,A03,084130,Staff,29,0,30,1
1649859498361,MATH 20D,B01,084133,Staff,28,0,30,2
1649859498361,MATH 20D,B02,084134,Staff,30,0,30,0
1649859498361,MATH 20D,B03,084135,Staff,30,0,30,0
1649859504393,MATH 20E,A01,084138,Staff,27,0,30,3
1649859504393,MATH 20E,A02,084139,Staff,29,0,30,1
1649859504393,MATH 20E,A03,084140,Staff,28,0,30,2
1649859504393,MATH 20E,A04,084141,Staff,30,0,30,0
1649859510417,MATH 102,A01,084143,Harel; Guershon,24,0,30,6
1649859510417,MATH 102,A02,084144,Harel; Guershon,25,0,30,5
1649859516441,MATH 103B,A01,083456,Staff,0,0,30,30
1649859516441,MATH 103B,A02,083457,Staff,18,0,30,12
1649859522466,MATH 109,A01,084146,Salehi Golsefidy; Alireza,30,0,30,0
1649859522466,MATH 109,A02,084147,Salehi Golsefidy; Alireza,26,0,30,4
1649859528491,MATH 120A,A01,085445,Eggers; John Dietrich,30,0,35,5
1649859528491,MATH 120A,A02,085446,Eggers; John Dietrich,31,0,35,4
1649859534516,MATH 142B,A01,084149,Verstraete; Jacques Allan,7,0,30,23
1649859534516,MATH 142B,A02,084150,Verstraete; Jacques Allan,25,0,30,5
1649859540541,MATH 170A,A01,083459,Nie; Jiawang,9,0,30,21
1649859540541,MATH 170A,A02,083460,Nie; Jiawang,25,0,30,5
1649859540541,MATH 170A,A03,083461,Nie; Jiawang,26,0,30,4
1649859546565,MATH 193B,A01,083463,Staff,15,0,30,15
1649859546565,MATH 193B,A02,083464,Staff,19,0,30,11
1649859546565,MATH 193B,A03,083465,Staff,27,0,30,3
1649859552632,COGS 2,A01,083966,Boyle; Mary E. T.,27,0,30,3
1649859558665,COGS 9,A01,083968,Staff,56,0,60,4
1649859564689,COGS 14B,A01,083970,Staff,46,0,50,4
1649859570717,COGS 17,A01,092679,Staff,73,0,75,2
1649859576742,COGS 100,A01,083972,Staff,46,0,60,14
1649859588789,COGS 101C,A01,083976,Staff,25,0,30,5
1649859594817,COGS 102A,A01,083978,Johnson; Christine M.,24,0,30,6
1649859600844,COGS 107B,A01,083980,Staff,32,0,50,18
1649859606899,COGS 115,A01,083982,Staff,21,0,30,9
1649859612926,COGS 118B,A01,083367,Staff,5,0,40,35
1649859618951,COGS 172,A01,083984,Provenzano; Emily Kara,20,0,30,10
1649859624975,COGS 177,A00,083368,Staff,2,0,30,28
1649859631007,COGS 186,A01,083986,Staff,25,0,40,15
1649859637030,COGS 187A,A01,083988,Boyle; Mary E. T.,40,0,60,20
1649859643056,CSE 8A,A50,084003,Miranda; Gregory Joseph,9,0,15,6
1649859649085,CSE 11,A01,084005,Miranda; Gregory Joseph,49,0,55,6
1649859655109,CSE 20,A01,084007,Staff,15,0,20,5
1649859661136,CSE 21,A01,084009,Staff,32,0,50,18
1649859667163,CSE 30,A01,083370,Cao; Yingjun,20,0,40,20
1649859673195,CSE 100,A01,083372,Cao; Yingjun,13,0,40,27
1649859679219,CSE 101,A01,084011,Staff,0,16,40,40
1649859685242,CSE 141,A01,083374,Eldon; John,0,14,75,75
1649859691274,CSE 141L,A01,083376,Eldon; John,0,18,75,75
1649859697297,CSE 175,A01,084013,Kumar; Rakesh,24,0,25,1
1649859703324,CSE 190,A00,092508,Staff,15,0,15,0
1649859709361,ECE 5,A01,084049,Morris; Karcher William,17,0,20,3
1649859715384,ECE 100,A01,084051,Baghdadchi; Saharnaz,16,0,20,4
1649859715384,ECE 100,A02,091916,Baghdadchi; Saharnaz,18,0,20,2
1649859721408,ECE 101,A01,084053,Baghdadchi; Saharnaz,25,0,37,12
1649859721408,ECE 101,A02,084054,Baghdadchi; Saharnaz,37,0,37,0
1649859727436,ECE 107,A01,083390,Staff,31,0,40,9
1649859733460,ECE 148,A01,084056,Silberman; Jack,8,0,12,4
1649859739483,ECE 180,A00,083391,Abi Samra; Nicholas Camill,27,0,30,3
1649859739483,ECE 180,B00,083392,Abi Samra; Nicholas Camill,26,0,30,4
1649859745507,MATH 10B,A01,084110,Staff,20,0,30,10
1649859745507,MATH 10B,A02,084111,Staff,29,0,30,1
1649859745507,MATH 10B,A03,084112,Staff,29,0,30,1
1649859751531,MATH 10C,A01,083443,Staff,19,0,30,11
1649859751531,MATH 10C,A02,083444,Staff,24,0,30,6
1649859751531,MATH 10C,B01,084114,Staff,26,0,30,4
1649859751531,MATH 10C,B02,084115,Staff,30,0,30,0
1649859757560,MATH 18,A01,084117,Harel; Guershon,28,0,30,2
1649859757560,MATH 18,A02,084119,Harel; Guershon,29,0,30,1
1649859757560,MATH 18,A03,084120,Harel; Guershon,30,0,30,0
1649859757560,MATH 18,A04,084121,Harel; Guershon,30,0,30,0
1649859763585,MATH 20B,A01,084124,Um; Ko Woon,33,0,35,2
1649859763585,MATH 20B,B01,084126,Um; Ko Woon,35,0,35,0
1649859769609,MATH 20C,A01,083446,Hammock; Frances H,26,0,30,4
1649859769609,MATH 20C,A02,083447,Hammock; Frances H,30,0,30,0
1649859769609,MATH 20C,A03,083448,Hammock; Frances H,30,0,30,0
1649859769609,MATH 20C,A04,083449,Hammock; Frances H,30,0,30,0
1649859769609,MATH 20C,B01,083451,Hammock; Frances H,29,0,30,1
1649859769609,MATH 20C,B02,083452,Hammock; Frances H,30,0,30,0
1649859769609,MATH 20C,B03,083453,Hammock; Frances H,30,0,30,0
1649859769609,MATH 20C,B04,083454,Hammock; Frances H,30,0,30,0
1649859775634,MATH 20D,A01,084128,Staff,29,0,30,1
1649859775634,MATH 20D,A02,084129,Staff,30,0,30,0
1649859775634,MATH 20D,A03,084130,Staff,29,0,30,1
1649859775634,MATH 20D,B01,084133,Staff,28,0,30,2
1649859775634,MATH 20D,B02,084134,Staff,30,0,30,0
1649859775634,MATH 20D,B03,084135,Staff,30,0,30,0
1649859781659,MATH 20E,A01,084138,Staff,27,0,30,3
1649859781659,MATH 20E,A02,084139,Staff,29,0,30,1
1649859781659,MATH 20E,A03,084140,Staff,28,0,30,2
1649859781659,MATH 20E,A04,084141,Staff,30,0,30,0
1649859787683,MATH 102,A01,084143,Harel; Guershon,24,0,30,6
1649859787683,MATH 102,A02,084144,Harel; Guershon,25,0,30,5
1649859793722,MATH 103B,A01,083456,Staff,0,0,30,30
1649859793722,MATH 103B,A02,083457,Staff,18,0,30,12
1649859799749,MATH 109,A01,084146,Salehi Golsefidy; Alireza,30,0,30,0
1649859799749,MATH 109,A02,084147,Salehi Golsefidy; Alireza,26,0,30,4
1649859805779,MATH 120A,A01,085445,Eggers; John Dietrich,30,0,35,5
1649859805779,MATH 120A,A02,085446,Eggers; John Dietrich,31,0,35,4
1649859811813,MATH 142B,A01,084149,Verstraete; Jacques Allan,7,0,30,23
1649859811813,MATH 142B,A02,084150,Verstraete; Jacques Allan,25,0,30,5
1649859817838,MATH 170A,A01,083459,Nie; Jiawang,9,0,30,21
1649859817838,MATH 170A,A02,083460,Nie; Jiawang,25,0,30,5
1649859817838,MATH 170A,A03,083461,Nie; Jiawang,26,0,30,4
1649859823863,MATH 193B,A01,083463,Staff,15,0,30,15
1649859823863,MATH 193B,A02,083464,Staff,19,0,30,11
1649859823863,MATH 193B,A03,083465,Staff,27,0,30,3
1649859829925,COGS 2,A01,083966,Boyle; Mary E. T.,27,0,30,3
1649859835950,COGS 9,A01,083968,Staff,56,0,60,4
1649859841971,COGS 14B,A01,083970,Staff,46,0,50,4
1649859847998,COGS 17,A01,092679,Staff,73,0,75,2
1649859854025,COGS 100,A01,083972,Staff,46,0,60,14
1649859866072,COGS 101C,A01,083976,Staff,25,0,30,5
1649859872097,COGS 102A,A01,083978,Johnson; Christine M.,24,0,30,6
1649859878121,COGS 107B,A01,083980,Staff,32,0,50,18
1649859884146,COGS 115,A01,083982,Staff,21,0,30,9
1649859890171,COGS 118B,A01,083367,Staff,5,0,40,35
1649859896201,COGS 172,A01,083984,Provenzano; Emily Kara,20,0,30,10
1649859902230,COGS 177,A00,083368,Staff,2,0,30,28
1649859908256,COGS 186,A01,083986,Staff,25,0,40,15
1649859914283,COGS 187A,A01,083988,Boyle; Mary E. T.,40,0,60,20
1649859920314,CSE 8A,A50,084003,Miranda; Gregory Joseph,9,0,15,6
1649859926336,CSE 11,A01,084005,Miranda; Gregory Joseph,49,0,55,6
1649859932366,CSE 20,A01,084007,Staff,15,0,20,5
1649859938393,CSE 21,A01,084009,Staff,32,0,50,18
1649859944416,CSE 30,A01,083370,Cao; Yingjun,20,0,40,20
1649859950444,CSE 100,A01,083372,Cao; Yingjun,13,0,40,27
1649859956472,CSE 101,A01,084011,Staff,0,16,40,40
1649859962495,CSE 141,A01,083374,Eldon; John,0,14,75,75
1649859968533,CSE 141L,A01,083376,Eldon; John,0,18,75,75
1649859974560,CSE 175,A01,084013,Kumar; Rakesh,24,0,25,1
1649859980587,CSE 190,A00,092508,Staff,15,0,15,0
1649859986612,ECE 5,A01,084049,Morris; Karcher William,17,0,20,3
1649859992635,ECE 100,A01,084051,Baghdadchi; Saharnaz,16,0,20,4
1649859992635,ECE 100,A02,091916,Baghdadchi; Saharnaz,18,0,20,2
1649859998754,ECE 101,A01,084053,Baghdadchi; Saharnaz,25,0,37,12
1649859998754,ECE 101,A02,084054,Baghdadchi; Saharnaz,37,0,37,0
1649860004778,ECE 107,A01,083390,Staff,31,0,40,9
1649860010805,ECE 148,A01,084056,Silberman; Jack,8,0,12,4
1649860016832,ECE 180,A00,083391,Abi Samra; Nicholas Camill,27,0,30,3
1649860016832,ECE 180,B00,083392,Abi Samra; Nicholas Camill,26,0,30,4
1649860022858,MATH 10B,A01,084110,Staff,20,0,30,10
1649860022858,MATH 10B,A02,084111,Staff,29,0,30,1
1649860022858,MATH 10B,A03,084112,Staff,29,0,30,1
1649860028884,MATH 10C,A01,083443,Staff,19,0,30,11
1649860028884,MATH 10C,A02,083444,Staff,24,0,30,6
1649860028884,MATH 10C,B01,084114,Staff,26,0,30,4
1649860028884,MATH 10C,B02,084115,Staff,30,0,30,0
1649860034912,MATH 18,A01,084117,Harel; Guershon,28,0,30,2
1649860034912,MATH 18,A02,084119,Harel; Guershon,29,0,30,1
1649860034912,MATH 18,A03,084120,Harel; Guershon,30,0,30,0
1649860034912,MATH 18,A04,084121,Harel; Guershon,30,0,30,0
1649860040936,MATH 20B,A01,084124,Um; Ko Woon,33,0,35,2
1649860040936,MATH 20B,B01,084126,Um; Ko Woon,35,0,35,0
1649860046965,MATH 20C,A01,083446,Hammock; Frances H,26,0,30,4
1649860046965,MATH 20C,A02,083447,Hammock; Frances H,30,0,30,0
1649860046965,MATH 20C,A03,083448,Hammock; Frances H,30,0,30,0
1649860046965,MATH 20C,A04,083449,Hammock; Frances H,30,0,30,0
1649860046965,MATH 20C,B01,083451,Hammock; Frances H,29,0,30,1
1649860046965,MATH 20C,B02,083452,Hammock; Frances H,30,0,30,0
1649860046965,MATH 20C,B03,083453,Hammock; Frances H,30,0,30,0
1649860046965,MATH 20C,B04,083454,Hammock; Frances H,30,0,30,0
1649860052996,MATH 20D,A01,084128,Staff,29,0,30,1
1649860052996,MATH 20D,A02,084129,Staff,30,0,30,0
1649860052996,MATH 20D,A03,084130,Staff,29,0,30,1
1649860052996,MATH 20D,B01,084133,Staff,28,0,30,2
1649860052996,MATH 20D,B02,084134,Staff,30,0,30,0
1649860052996,MATH 20D,B03,084135,Staff,30,0,30,0
1649860059017,MATH 20E,A01,084138,Staff,27,0,30,3
1649860059017,MATH 20E,A02,084139,Staff,29,0,30,1
1649860059017,MATH 20E,A03,084140,Staff,28,0,30,2
1649860059017,MATH 20E,A04,084141,Staff,30,0,30,0
1649860065043,MATH 102,A01,084143,Harel; Guershon,24,0,30,6
1649860065043,MATH 102,A02,084144,Harel; Guershon,25,0,30,5
1649860071066,MATH 103B,A01,083456,Staff,0,0,30,30
1649860071066,MATH 103B,A02,083457,Staff,18,0,30,12
1649860077091,MATH 109,A01,084146,Salehi Golsefidy; Alireza,30,0,30,0
1649860077091,MATH 109,A02,084147,Salehi Golsefidy; Alireza,26,0,30,4
1649860083117,MATH 120A,A01,085445,Eggers; John Dietrich,30,0,35,5
1649860083117,MATH 120A,A02,085446,Eggers; John Dietrich,31,0,35,4
1649860089147,MATH 142B,A01,084149,Verstraete; Jacques Allan,7,0,30,23
1649860089147,MATH 142B,A02,084150,Verstraete; Jacques Allan,25,0,30,5
1649860095183,MATH 170A,A01,083459,Nie; Jiawang,9,0,30,21
1649860095183,MATH 170A,A02,083460,Nie; Jiawang,25,0,30,5
1649860095183,MATH 170A,A03,083461,Nie; Jiawang,26,0,30,4
1649860101208,MATH 193B,A01,083463,Staff,15,0,30,15
1649860101208,MATH 193B,A02,083464,Staff,19,0,30,11
1649860101208,MATH 193B,A03,083465,Staff,27,0,30,3
1649860107257,COGS 2,A01,083966,Boyle; Mary E. T.,27,0,30,3
1649860113284,COGS 9,A01,083968,Staff,56,0,60,4
1649860119311,COGS 14B,A01,083970,Staff,46,0,50,4
1649860125338,COGS 17,A01,092679,Staff,73,0,75,2
1649860131360,COGS 100,A01,083972,Staff,46,0,60,14
1649860143409,COGS 101C,A01,083976,Staff,25,0,30,5
1649860149436,COGS 102A,A01,083978,Johnson; Christine M.,24,0,30,6
1649860155474,COGS 107B,A01,083980,Staff,32,0,50,18
1649860161502,COGS 115,A01,083982,Staff,21,0,30,9
1649860167530,COGS 118B,A01,083367,Staff,5,0,40,35
1649860173557,COGS 172,A01,083984,Provenzano; Emily Kara,20,0,30,10
1649860179589,COGS 177,A00,083368,Staff,2,0,30,28
1649860185611,COGS 186,A01,083986,Staff,25,0,40,15
1649860191635,COGS 187A,A01,083988,Boyle; Mary E. T.,40,0,60,20
1649860197663,CSE 8A,A50,084003,Miranda; Gregory Joseph,9,0,15,6
1649860203691,CSE 11,A01,084005,Miranda; Gregory Joseph,49,0,55,6
1649860209719,CSE 20,A01,084007,Staff,15,0,20,5
1649860215748,CSE 21,A01,084009,Staff,32,0,50,18
1649860221781,CSE 30,A01,083370,Cao; Yingjun,20,0,40,20
1649860227807,CSE 100,A01,083372,Cao; Yingjun,13,0,40,27
1649860233832,CSE 101,A01,084011,Staff,0,16,40,40
1649860239858,CSE 141,A01,083374,Eldon; John,0,14,75,75
1649860245881,CSE 141L,A01,083376,Eldon; John,0,18,75,75
1649860251914,CSE 175,A01,084013,Kumar; Rakesh,24,0,25,1
1649860257937,CSE 190,A00,092508,Staff,15,0,15,0
1649860263963,ECE 5,A01,084049,Morris; Karcher William,17,0,20,3
1649860269991,ECE 100,A01,084051,Baghdadchi; Saharnaz,16,0,20,4
1649860269991,ECE 100,A02,091916,Baghdadchi; Saharnaz,18,0,20,2
1649860276017,ECE 101,A01,084053,Baghdadchi; Saharnaz,25,0,37,12
1649860276017,ECE 101,A02,084054,Baghdadchi; Saharnaz,37,0,37,0
1649860282049,ECE 107,A01,083390,Staff,31,0,40,9
1649860288073,ECE 148,A01,084056,Silberman; Jack,8,0,12,4
1649860294102,ECE 180,A00,083391,Abi Samra; Nicholas Camill,27,0,30,3
1649860294102,ECE 180,B00,083392,Abi Samra; Nicholas Camill,26,0,30,4
1649860300133,MATH 10B,A01,084110,Staff,20,0,30,10
1649860300133,MATH 10B,A02,084111,Staff,29,0,30,1
1649860300133,MATH 10B,A03,084112,Staff,29,0,30,1
1649860306161,MATH 10C,A01,083443,Staff,19,0,30,11
1649860306161,MATH 10C,A02,083444,Staff,24,0,30,6
1649860306161,MATH 10C,B01,084114,Staff,26,0,30,4
1649860306161,MATH 10C,B02,084115,Staff,30,0,30,0
1649860312185,MATH 18,A01,084117,Harel; Guershon,28,0,30,2
1649860312185,MATH 18,A02,084119,Harel; Guershon,29,0,30,1
1649860312185,MATH 18,A03,084120,Harel; Guershon,30,0,30,0
1649860312185,MATH 18,A04,084121,Harel; Guershon,30,0,30,0
1649860318213,MATH 20B,A01,084124,Um; Ko Woon,33,0,35,2
1649860318213,MATH 20B,B01,084126,Um; Ko Woon,35,0,35,0
1649860324240,MATH 20C,A01,083446,Hammock; Frances H,26,0,30,4
1649860324240,MATH 20C,A02,083447,Hammock; Frances H,30,0,30,0
1649860324240,MATH 20C,A03,083448,Hammock; Frances H,30,0,30,0
1649860324240,MATH 20C,A04,083449,Hammock; Frances H,30,0,30,0
1649860324240,MATH 20C,B01,083451,Hammock; Frances H,29,0,30,1
1649860324240,MATH 20C,B02,083452,Hammock; Frances H,30,0,30,0
1649860324240,MATH 20C,B03,083453,Hammock; Frances H,30,0,30,0
1649860324240,MATH 20C,B04,083454,Hammock; Frances H,30,0,30,0
1649860330264,MATH 20D,A01,084128,Staff,29,0,30,1
1649860330264,MATH 20D,A02,084129,Staff,30,0,30,0
1649860330264,MATH 20D,A03,084130,Staff,29,0,30,1
1649860330264,MATH 20D,B01,084133,Staff,28,0,30,2
1649860330264,MATH 20D,B02,084134,Staff,30,0,30,0
1649860330264,MATH 20D,B03,084135,Staff,30,0,30,0
1649860336300,MATH 20E,A01,084138,Staff,27,0,30,3
1649860336300,MATH 20E,A02,084139,Staff,29,0,30,1
1649860336300,MATH 20E,A03,084140,Staff,28,0,30,2
1649860336300,MATH 20E,A04,084141,Staff,30,0,30,0
1649860342329,MATH 102,A01,084143,Harel; Guershon,24,0,30,6
1649860342329,MATH 102,A02,084144,Harel; Guershon,25,0,30,5
1649860348356,MATH 103B,A01,083456,Staff,0,0,30,30
1649860348356,MATH 103B,A02,083457,Staff,18,0,30,12
1649860354389,MATH 109,A01,084146,Salehi Golsefidy; Alireza,30,0,30,0
1649860354389,MATH 109,A02,084147,Salehi Golsefidy; Alireza,26,0,30,4
1649860360417,MATH 120A,A01,085445,Eggers; John Dietrich,30,0,35,5
1649860360417,MATH 120A,A02,085446,Eggers; John Dietrich,31,0,35,4
1649860366451,MATH 142B,A01,084149,Verstraete; Jacques Allan,7,0,30,23
1649860366451,MATH 142B,A02,084150,Verstraete; Jacques Allan,25,0,30,5
1649860372478,MATH 170A,A01,083459,Nie; Jiawang,9,0,30,21
1649860372478,MATH 170A,A02,083460,Nie; Jiawang,25,0,30,5
1649860372478,MATH 170A,A03,083461,Nie; Jiawang,26,0,30,4
1649860378501,MATH 193B,A01,083463,Staff,15,0,30,15
1649860378501,MATH 193B,A02,083464,Staff,19,0,30,11
1649860378501,MATH 193B,A03,083465,Staff,27,0,30,3
1649860384562,COGS 2,A01,083966,Boyle; Mary E. T.,27,0,30,3
1649860390585,COGS 9,A01,083968,Staff,56,0,60,4
1649860396620,COGS 14B,A01,083970,Staff,46,0,50,4
1649860402646,COGS 17,A01,092679,Staff,73,0,75,2
1649860408678,COGS 100,A01,083972,Staff,46,0,60,14
1649860420731,COGS 101C,A01,083976,Staff,25,0,30,5
1649860426754,COGS 102A,A01,083978,Johnson; Christine M.,24,0,30,6
1649860432781,COGS 107B,A01,083980,Staff,32,0,50,18
1649860438816,COGS 115,A01,083982,Staff,21,0,30,9
1649860444842,COGS 118B,A01,083367,Staff,5,0,40,35
1649860450867,COGS 172,A01,083984,Provenzano; Emily Kara,20,0,30,10
1649860456895,COGS 177,A00,083368,Staff,2,0,30,28
1649860462930,COGS 186,A01,083986,Staff,25,0,40,15
1649860468961,COGS 187A,A01,083988,Boyle; Mary E. T.,40,0,60,20
1649860474989,CSE 8A,A50,084003,Miranda; Gregory Joseph,9,0,15,6
1649860481023,CSE 11,A01,084005,Miranda; Gregory Joseph,49,0,55,6
1649860487055,CSE 20,A01,084007,Staff,15,0,20,5
1649860493083,CSE 21,A01,084009,Staff,32,0,50,18
1649860499108,CSE 30,A01,083370,Cao; Yingjun,20,0,40,20
1649860505132,CSE 100,A01,083372,Cao; Yingjun,13,0,40,27
1649860511164,CSE 101,A01,084011,Staff,0,16,40,40
1649860517187,CSE 141,A01,083374,Eldon; John,0,14,75,75
1649860523215,CSE 141L,A01,083376,Eldon; John,0,18,75,75
1649860529239,CSE 175,A01,084013,Kumar; Rakesh,24,0,25,1
1649860535263,CSE 190,A00,092508,Staff,15,0,15,0
1649860541287,ECE 5,A01,084049,Morris; Karcher William,17,0,20,3
1649860547321,ECE 100,A01,084051,Baghdadchi; Saharnaz,16,0,20,4
1649860547321,ECE 100,A02,091916,Baghdadchi; Saharnaz,18,0,20,2
1649860553344,ECE 101,A01,084053,Baghdadchi; Saharnaz,25,0,37,12
1649860553344,ECE 101,A02,084054,Baghdadchi; Saharnaz,37,0,37,0
1649860559370,ECE 107,A01,083390,Staff,31,0,40,9
1649860565399,ECE 148,A01,084056,Silberman; Jack,8,0,12,4
1649860571437,ECE 180,A00,083391,Abi Samra; Nicholas Camill,27,0,30,3
1649860571437,ECE 180,B00,083392,Abi Samra; Nicholas Camill,26,0,30,4
1649860577465,MATH 10B,A01,084110,Staff,20,0,30,10
1649860577465,MATH 10B,A02,084111,Staff,29,0,30,1
1649860577465,MATH 10B,A03,084112,Staff,29,0,30,1
1649860583496,MATH 10C,A01,083443,Staff,19,0,30,11
1649860583496,MATH 10C,A02,083444,Staff,24,0,30,6
1649860583496,MATH 10C,B01,084114,Staff,26,0,30,4
1649860583496,MATH 10C,B02,084115,Staff,30,0,30,0
1649860589522,MATH 18,A01,084117,Harel; Guershon,28,0,30,2
1649860589522,MATH 18,A02,084119,Harel; Guershon,29,0,30,1
1649860589522,MATH 18,A03,084120,Harel; Guershon,30,0,30,0
1649860589522,MATH 18,A04,084121,Harel; Guershon,30,0,30,0
1649860595646,MATH 20B,A01,084124,Um; Ko Woon,33,0,35,2
1649860595646,MATH 20B,B01,084126,Um; Ko Woon,35,0,35,0
1649860601672,MATH 20C,A01,083446,Hammock; Frances H,26,0,30,4
1649860601672,MATH 20C,A02,083447,Hammock; Frances H,30,0,30,0
1649860601672,MATH 20C,A03,083448,Hammock; Frances H,30,0,30,0
1649860601672,MATH 20C,A04,083449,Hammock; Frances H,30,0,30,0
1649860601672,MATH 20C,B01,083451,Hammock; Frances H,29,0,30,1
1649860601672,MATH 20C,B02,083452,Hammock; Frances H,30,0,30,0
1649860601672,MATH 20C,B03,083453,Hammock; Frances H,30,0,30,0
1649860601672,MATH 20C,B04,083454,Hammock; Frances H,30,0,30,0
1649860607699,MATH 20D,A01,084128,Staff,29,0,30,1
1649860607699,MATH 20D,A02,084129,Staff,30,0,30,0
1649860607699,MATH 20D,A03,084130,Staff,29,0,30,1
1649860607699,MATH 20D,B01,084133,Staff,28,0,30,2
1649860607699,MATH 20D,B02,084134,Staff,30,0,30,0
1649860607699,MATH 20D,B03,084135,Staff,30,0,30,0
1649860613720,MATH 20E,A01,084138,Staff,27,0,30,3
1649860613720,MATH 20E,A02,084139,Staff,29,0,30,1
1649860613720,MATH 20E,A03,084140,Staff,28,0,30,2
1649860613720,MATH 20E,A04,084141,Staff,30,0,30,0
1649860619742,MATH 102,A01,084143,Harel; Guershon,24,0,30,6
1649860619742,MATH 102,A02,084144,Harel; Guershon,25,0,30,5
1649860625765,MATH 103B,A01,083456,Staff,0,0,30,30
1649860625765,MATH 103B,A02,083457,Staff,18,0,30,12
1649860631798,MATH 109,A01,084146,Salehi Golsefidy; Alireza,30,0,30,0
1649860631798,MATH 109,A02,084147,Salehi Golsefidy; Alireza,26,0,30,4
1649860637825,MATH 120A,A01,085445,Eggers; John Dietrich,30,0,35,5
1649860637825,MATH 120A,A02,085446,Eggers; John Dietrich,31,0,35,4
1649860643849,MATH 142B,A01,084149,Verstraete; Jacques Allan,7,0,30,23
1649860643849,MATH 142B,A02,084150,Verstraete; Jacques Allan,25,0,30,5
1649860649875,MATH 170A,A01,083459,Nie; Jiawang,9,0,30,21
1649860649875,MATH 170A,A02,083460,Nie; Jiawang,25,0,30,5
1649860649875,MATH 170A,A03,083461,Nie; Jiawang,26,0,30,4
1649860655903,MATH 193B,A01,083463,Staff,15,0,30,15
1649860655903,MATH 193B,A02,083464,Staff,19,0,30,11
1649860655903,MATH 193B,A03,083465,Staff,27,0,30,3
1649860661959,COGS 2,A01,083966,Boyle; Mary E. T.,27,0,30,3
1649860667985,COGS 9,A01,083968,Staff,56,0,60,4
1649860674013,COGS 14B,A01,083970,Staff,46,0,50,4
1649860680036,COGS 17,A01,092679,Staff,73,0,75,2
1649860686060,COGS 100,A01,083972,Staff,46,0,60,14
1649860698109,COGS 101C,A01,083976,Staff,25,0,30,5
1649860704137,COGS 102A,A01,083978,Johnson; Christine M.,24,0,30,6
1649860710170,COGS 107B,A01,083980,Staff,32,0,50,18
1649860716200,COGS 115,A01,083982,Staff,21,0,30,9
1649860722224,COGS 118B,A01,083367,Staff,5,0,40,35
1649860728247,COGS 172,A01,083984,Provenzano; Emily Kara,20,0,30,10
1649860734270,COGS 177,A00,083368,Staff,2,0,30,28
1649860740299,COGS 186,A01,083986,Staff,25,0,40,15
1649860746322,COGS 187A,A01,083988,Boyle; Mary E. T.,40,0,60,20
1649860752347,CSE 8A,A50,084003,Miranda; Gregory Joseph,9,0,15,6
1649860758383,CSE 11,A01,084005,Miranda; Gregory Joseph,49,0,55,6
1649860764406,CSE 20,A01,084007,Staff,15,0,20,5
1649860770431,CSE 21,A01,084009,Staff,32,0,50,18
1649860776458,CSE 30,A01,083370,Cao; Yingjun,20,0,40,20
1649860782485,CSE 100,A01,083372,Cao; Yingjun,13,0,40,27
1649860788511,CSE 101,A01,084011,Staff,0,16,40,40
1649860794535,CSE 141,A01,083374,Eldon; John,0,14,75,75
1649860800563,CSE 141L,A01,083376,Eldon; John,0,18,75,75
1649860806590,CSE 175,A01,084013,Kumar; Rakesh,24,0,25,1
1649860812614,CSE 190,A00,092508,Staff,15,0,15,0
1649860818638,ECE 5,A01,084049,Morris; Karcher William,17,0,20,3
1649860824662,ECE 100,A01,084051,Baghdadchi; Saharnaz,16,0,20,4
1649860824662,ECE 100,A02,091916,Baghdadchi; Saharnaz,18,0,20,2
1649860830689,ECE 101,A01,084053,Baghdadchi; Saharnaz,25,0,37,12
1649860830689,ECE 101,A02,084054,Baghdadchi; Saharnaz,37,0,37,0
1649860836718,ECE 107,A01,083390,Staff,31,0,40,9
1649860842740,ECE 148,A01,084056,Silberman; Jack,8,0,12,4
1649860848766,ECE 180,A00,083391,Abi Samra; Nicholas Camill,27,0,30,3
1649860848766,ECE 180,B00,083392,Abi Samra; Nicholas Camill,26,0,30,4
1649860854789,MATH 10B,A01,084110,Staff,20,0,30,10
1649860854789,MATH 10B,A02,084111,Staff,29,0,30,1
1649860854789,MATH 10B,A03,084112,Staff,29,0,30,1
1649860860820,MATH 10C,A01,083443,Staff,19,0,30,11
1649860860820,MATH 10C,A02,083444,Staff,24,0,30,6
1649860860820,MATH 10C,B01,084114,Staff,26,0,30,4
1649860860820,MATH 10C,B02,084115,Staff,30,0,30,0
1649860866844,MATH 18,A01,084117,Harel; Guershon,28,0,30,2
1649860866844,MATH 18,A02,084119,Harel; Guershon,29,0,30,1
1649860866844,MATH 18,A03,084120,Harel; Guershon,30,0,30,0
1649860866844,MATH 18,A04,084121,Harel; Guershon,30,0,30,0
1649860872868,MATH 20B,A01,084124,Um; Ko Woon,33,0,35,2
1649860872868,MATH 20B,B01,084126,Um; Ko Woon,35,0,35,0
1649860878891,MATH 20C,A01,083446,Hammock; Frances H,26,0,30,4
1649860878891,MATH 20C,A02,083447,Hammock; Frances H,30,0,30,0
1649860878891,MATH 20C,A03,083448,Hammock; Frances H,30,0,30,0
1649860878891,MATH 20C,A04,083449,Hammock; Frances H,30,0,30,0
1649860878891,MATH 20C,B01,083451,Hammock; Frances H,29,0,30,1
1649860878891,MATH 20C,B02,083452,Hammock; Frances H,30,0,30,0
1649860878891,MATH 20C,B03,083453,Hammock; Frances H,30,0,30,0
1649860878891,MATH 20C,B04,083454,Hammock; Frances H,30,0,30,0
1649860884916,MATH 20D,A01,084128,Staff,29,0,30,1
1649860884916,MATH 20D,A02,084129,Staff,30,0,30,0
1649860884916,MATH 20D,A03,084130,Staff,29,0,30,1
1649860884916,MATH 20D,B01,084133,Staff,28,0,30,2
1649860884916,MATH 20D,B02,084134,Staff,30,0,30,0
1649860884916,MATH 20D,B03,084135,Staff,30,0,30,0
1649860890943,MATH 20E,A01,084138,Staff,27,0,30,3
1649860890943,MATH 20E,A02,084139,Staff,29,0,30,1
1649860890943,MATH 20E,A03,084140,Staff,28,0,30,2
1649860890943,MATH 20E,A04,084141,Staff,30,0,30,0
1649860896969,MATH 102,A01,084143,Harel; Guershon,24,0,30,6
1649860896969,MATH 102,A02,084144,Harel; Guershon,25,0,30,5
1649860902992,MATH 103B,A01,083456,Staff,0,0,30,30
1649860902992,MATH 103B,A02,083457,Staff,18,0,30,12
1649860909019,MATH 109,A01,084146,Salehi Golsefidy; Alireza,30,0,30,0
1649860909019,MATH 109,A02,084147,Salehi Golsefidy; Alireza,26,0,30,4
1649860915049,MATH 120A,A01,085445,Eggers; John Dietrich,30,0,35,5
1649860915049,MATH 120A,A02,085446,Eggers; John Dietrich,31,0,35,4
1649860921077,MATH 142B,A01,084149,Verstraete; Jacques Allan,7,0,30,23
1649860921077,MATH 142B,A02,084150,Verstraete; Jacques Allan,25,0,30,5
1649860927103,MATH 170A,A01,083459,Nie; Jiawang,9,0,30,21
1649860927103,MATH 170A,A02,083460,Nie; Jiawang,25,0,30,5
1649860927103,MATH 170A,A03,083461,Nie; Jiawang,26,0,30,4
1649860933128,MATH 193B,A01,083463,Staff,15,0,30,15
1649860933128,MATH 193B,A02,083464,Staff,19,0,30,11
1649860933128,MATH 193B,A03,083465,Staff,27,0,30,3
1649860939201,COGS 2,A01,083966,Boyle; Mary E. T.,27,0,30,3
1649860945225,COGS 9,A01,083968,Staff,56,0,60,4
1649860951251,COGS 14B,A01,083970,Staff,46,0,50,4
1649860957280,COGS 17,A01,092679,Staff,73,0,75,2
1649860963305,COGS 100,A01,083972,Staff,46,0,60,14
1649860975360,COGS 101C,A01,083976,Staff,25,0,30,5
1649860981384,COGS 102A,A01,083978,Johnson; Christine M.,24,0,30,6
1649860987407,COGS 107B,A01,083980,Staff,32,0,50,18
1649860993434,COGS 115,A01,083982,Staff,21,0,30,9
1649860999461,COGS 118B,A01,083367,Staff,5,0,40,35
1649861005487,COGS 172,A01,083984,Provenzano; Emily Kara,20,0,30,10
1649861011516,COGS 177,A00,083368,Staff,2,0,30,28
1649861017542,COGS 186,A01,083986,Staff,25,0,40,15
1649861023568,COGS 187A,A01,083988,Boyle; Mary E. T.,40,0,60,20
1649861042850,CSE 8A,A50,084003,Miranda; Gregory Joseph,9,0,15,6
1649861048876,CSE 11,A01,084005,Miranda; Gregory Joseph,49,0,55,6
1649861054898,CSE 20,A01,084007,Staff,15,0,20,5
1649861060923,CSE 21,A01,084009,Staff,32,0,50,18
1649861066946,CSE 30,A01,083370,Cao; Yingjun,20,0,40,20
1649861072977,CSE 100,A01,083372,Cao; Yingjun,13,0,40,27
1649861079005,CSE 101,A01,084011,Staff,0,16,40,40
1649861085028,CSE 141,A01,083374,Eldon; John,0,14,75,75
1649861091060,CSE 141L,A01,083376,Eldon; John,0,18,75,75
1649861097084,CSE 175,A01,084013,Kumar; Rakesh,24,0,25,1
1649861103107,CSE 190,A00,092508,Staff,15,0,15,0
1649861109136,ECE 5,A01,084049,Morris; Karcher William,17,0,20,3
1649861115164,ECE 100,A01,084051,Baghdadchi; Saharnaz,16,0,20,4
1649861115164,ECE 100,A02,091916,Baghdadchi; Saharnaz,18,0,20,2
1649861121189,ECE 101,A01,084053,Baghdadchi; Saharnaz,25,0,37,12
1649861121189,ECE 101,A02,084054,Baghdadchi; Saharnaz,37,0,37,0
1649861127212,ECE 107,A01,083390,Staff,31,0,40,9
1649861133233,ECE 148,A01,084056,Silberman; Jack,8,0,12,4
1649861139260,ECE 180,A00,083391,Abi Samra; Nicholas Camill,27,0,30,3
1649861139260,ECE 180,B00,083392,Abi Samra; Nicholas Camill,26,0,30,4
1649861145282,MATH 10B,A01,084110,Staff,20,0,30,10
1649861145282,MATH 10B,A02,084111,Staff,29,0,30,1
1649861145282,MATH 10B,A03,084112,Staff,29,0,30,1
1649861151311,MATH 10C,A01,083443,Staff,19,0,30,11
1649861151311,MATH 10C,A02,083444,Staff,24,0,30,6
1649861151311,MATH 10C,B01,084114,Staff,26,0,30,4
1649861151311,MATH 10C,B02,084115,Staff,30,0,30,0
1649861157340,MATH 18,A01,084117,Harel; Guershon,28,0,30,2
1649861157340,MATH 18,A02,084119,Harel; Guershon,29,0,30,1
1649861157340,MATH 18,A03,084120,Harel; Guershon,30,0,30,0
1649861157340,MATH 18,A04,084121,Harel; Guershon,30,0,30,0
1649861163376,MATH 20B,A01,084124,Um; Ko Woon,33,0,35,2
1649861163376,MATH 20B,B01,084126,Um; Ko Woon,35,0,35,0
1649861169401,MATH 20C,A01,083446,Hammock; Frances H,26,0,30,4
1649861169401,MATH 20C,A02,083447,Hammock; Frances H,30,0,30,0
1649861169401,MATH 20C,A03,083448,Hammock; Frances H,30,0,30,0
1649861169401,MATH 20C,A04,083449,Hammock; Frances H,30,0,30,0
1649861169401,MATH 20C,B01,083451,Hammock; Frances H,29,0,30,1
1649861169401,MATH 20C,B02,083452,Hammock; Frances H,30,0,30,0
1649861169401,MATH 20C,B03,083453,Hammock; Frances H,30,0,30,0
1649861169401,MATH 20C,B04,083454,Hammock; Frances H,30,0,30,0
1649861175429,MATH 20D,A01,084128,Staff,29,0,30,1
1649861175429,MATH 20D,A02,084129,Staff,30,0,30,0
1649861175429,MATH 20D,A03,084130,Staff,29,0,30,1
1649861175429,MATH 20D,B01,084133,Staff,28,0,30,2
1649861175429,MATH 20D,B02,084134,Staff,30,0,30,0
1649861175429,MATH 20D,B03,084135,Staff,30,0,30,0
1649861181457,MATH 20E,A01,084138,Staff,27,0,30,3
1649861181457,MATH 20E,A02,084139,Staff,29,0,30,1
1649861181457,MATH 20E,A03,084140,Staff,28,0,30,2
1649861181457,MATH 20E,A04,084141,Staff,30,0,30,0
1649861187484,MATH 102,A01,084143,Harel; Guershon,24,0,30,6
1649861187484,MATH 102,A02,084144,Harel; Guershon,25,0,30,5
1649861193512,MATH 103B,A01,083456,Staff,0,0,30,30
1649861193512,MATH 103B,A02,083457,Staff,18,0,30,12
1649861199538,MATH 109,A01,084146,Salehi Golsefidy; Alireza,30,0,30,0
1649861199538,MATH 109,A02,084147,Salehi Golsefidy; Alireza,26,0,30,4
1649861205649,MATH 120A,A01,085445,Eggers; John Dietrich,30,0,35,5
1649861205649,MATH 120A,A02,085446,Eggers; John Dietrich,31,0,35,4
1649861211671,MATH 142B,A01,084149,Verstraete; Jacques Allan,7,0,30,23
1649861211671,MATH 142B,A02,084150,Verstraete; Jacques Allan,25,0,30,5
1649861217695,MATH 170A,A01,083459,Nie; Jiawang,9,0,30,21
1649861217695,MATH 170A,A02,083460,Nie; Jiawang,25,0,30,5
1649861217695,MATH 170A,A03,083461,Nie; Jiawang,26,0,30,4
1649861223723,MATH 193B,A01,083463,Staff,15,0,30,15
1649861223723,MATH 193B,A02,083464,Staff,19,0,30,11
1649861223723,MATH 193B,A03,083465,Staff,27,0,30,3
1649861229783,COGS 2,A01,083966,Boyle; Mary E. T.,27,0,30,3
1649861235806,COGS 9,A01,083968,Staff,56,0,60,4
1649861241845,COGS 14B,A01,083970,Staff,46,0,50,4
1649861247866,COGS 17,A01,092679,Staff,73,0,75,2
1649861253891,COGS 100,A01,083972,Staff,46,0,60,14
1649861265945,COGS 101C,A01,083976,Staff,25,0,30,5
1649861271970,COGS 102A,A01,083978,Johnson; Christine M.,24,0,30,6
1649861277999,COGS 107B,A01,083980,Staff,32,0,50,18
1649861284030,COGS 115,A01,083982,Staff,21,0,30,9
1649861290053,COGS 118B,A01,083367,Staff,5,0,40,35
1649861296083,COGS 172,A01,083984,Provenzano; Emily Kara,20,0,30,10
1649861302107,COGS 177,A00,083368,Staff,2,0,30,28
1649861308132,COGS 186,A01,083986,Staff,25,0,40,15
1649861314158,COGS 187A,A01,083988,Boyle; Mary E. T.,40,0,60,20
1649861320181,CSE 8A,A50,084003,Miranda; Gregory Joseph,9,0,15,6
1649861326207,CSE 11,A01,084005,Miranda; Gregory Joseph,49,0,55,6
1649861332230,CSE 20,A01,084007,Staff,15,0,20,5
1649861338255,CSE 21,A01,084009,Staff,32,0,50,18
1649861344279,CSE 30,A01,083370,Cao; Yingjun,20,0,40,20
1649861350306,CSE 100,A01,083372,Cao; Yingjun,13,0,40,27
1649861356337,CSE 101,A01,084011,Staff,0,16,40,40
1649861362359,CSE 141,A01,083374,Eldon; John,0,14,75,75
1649861368383,CSE 141L,A01,083376,Eldon; John,0,18,75,75
1649861374406,CSE 175,A01,084013,Kumar; Rakesh,24,0,25,1
1649861380429,CSE 190,A00,092508,Staff,15,0,15,0
1649861386454,ECE 5,A01,084049,Morris; Karcher William,17,0,20,3
1649861392481,ECE 100,A01,084051,Baghdadchi; Saharnaz,16,0,20,4
1649861392481,ECE 100,A02,091916,Baghdadchi; Saharnaz,18,0,20,2
1649861398510,ECE 101,A01,084053,Baghdadchi; Saharnaz,25,0,37,12
1649861398510,ECE 101,A02,084054,Baghdadchi; Saharnaz,37,0,37,0
1649861404540,ECE 107,A01,083390,Staff,31,0,40,9
1649861410567,ECE 148,A01,084056,Silberman; Jack,8,0,12,4
1649861416591,ECE 180,A00,083391,Abi Samra; Nicholas Camill,27,0,30,3
1649861416591,ECE 180,B00,083392,Abi Samra; Nicholas Camill,26,0,30,4
1649861422614,MATH 10B,A01,084110,Staff,20,0,30,10
1649861422614,MATH 10B,A02,084111,Staff,29,0,30,1
1649861422614,MATH 10B,A03,084112,Staff,29,0,30,1
1649861428642,MATH 10C,A01,083443,Staff,19,0,30,11
1649861428642,MATH 10C,A02,083444,Staff,24,0,30,6
1649861428642,MATH 10C,B01,084114,Staff,26,0,30,4
1649861428642,MATH 10C,B02,084115,Staff,30,0,30,0
1649861434677,MATH 18,A01,084117,Harel; Guershon,28,0,30,2
1649861434677,MATH 18,A02,084119,Harel; Guershon,29,0,30,1
1649861434677,MATH 18,A03,084120,Harel; Guershon,30,0,30,0
1649861434677,MATH 18,A04,084121,Harel; Guershon,30,0,30,0
1649861440699,MATH 20B,A01,084124,Um; Ko Woon,33,0,35,2
1649861440699,MATH 20B,B01,084126,Um; Ko Woon,35,0,35,0
1649861446729,MATH 20C,A01,083446,Hammock; Frances H,26,0,30,4
1649861446729,MATH 20C,A02,083447,Hammock; Frances H,30,0,30,0
1649861446729,MATH 20C,A03,083448,Hammock; Frances H,30,0,30,0
1649861446729,MATH 20C,A04,083449,Hammock; Frances H,30,0,30,0
1649861446729,MATH 20C,B01,083451,Hammock; Frances H,29,0,30,1
1649861446729,MATH 20C,B02,083452,Hammock; Frances H,30,0,30,0
1649861446729,MATH 20C,B03,083453,Hammock; Frances H,30,0,30,0
1649861446729,MATH 20C,B04,083454,Hammock; Frances H,30,0,30,0
1649861452753,MATH 20D,A01,084128,Staff,29,0,30,1
1649861452753,MATH 20D,A02,084129,Staff,30,0,30,0
1649861452753,MATH 20D,A03,084130,Staff,29,0,30,1
1649861452753,MATH 20D,B01,084133,Staff,28,0,30,2
1649861452753,MATH 20D,B02,084134,Staff,30,0,30,0
1649861452753,MATH 20D,B03,084135,Staff,30,0,30,0
1649861458780,MATH 20E,A01,084138,Staff,27,0,30,3
1649861458780,MATH 20E,A02,084139,Staff,29,0,30,1
1649861458780,MATH 20E,A03,084140,Staff,28,0,30,2
1649861458780,MATH 20E,A04,084141,Staff,30,0,30,0
1649861464808,MATH 102,A01,084143,Harel; Guershon,24,0,30,6
1649861464808,MATH 102,A02,084144,Harel; Guershon,25,0,30,5
1649861470831,MATH 103B,A01,083456,Staff,0,0,30,30
1649861470831,MATH 103B,A02,083457,Staff,18,0,30,12
1649861476855,MATH 109,A01,084146,Salehi Golsefidy; Alireza,30,0,30,0
1649861476855,MATH 109,A02,084147,Salehi Golsefidy; Alireza,26,0,30,4
1649861482883,MATH 120A,A01,085445,Eggers; John Dietrich,30,0,35,5
1649861482883,MATH 120A,A02,085446,Eggers; John Dietrich,31,0,35,4
1649861488906,MATH 142B,A01,084149,Verstraete; Jacques Allan,7,0,30,23
1649861488906,MATH 142B,A02,084150,Verstraete; Jacques Allan,25,0,30,5
1649861494940,MATH 170A,A01,083459,Nie; Jiawang,9,0,30,21
1649861494940,MATH 170A,A02,083460,Nie; Jiawang,25,0,30,5
1649861494940,MATH 170A,A03,083461,Nie; Jiawang,26,0,30,4
1649861500966,MATH 193B,A01,083463,Staff,15,0,30,15
1649861500966,MATH 193B,A02,083464,Staff,19,0,30,11
1649861500966,MATH 193B,A03,083465,Staff,27,0,30,3
1649861507015,COGS 2,A01,083966,Boyle; Mary E. T.,27,0,30,3
1649861513038,COGS 9,A01,083968,Staff,56,0,60,4
1649861519066,COGS 14B,A01,083970,Staff,46,0,50,4
1649861525092,COGS 17,A01,092679,Staff,73,0,75,2
1649861531130,COGS 100,A01,083972,Staff,46,0,60,14
1649861543189,COGS 101C,A01,083976,Staff,25,0,30,5
1649861549213,COGS 102A,A01,083978,Johnson; Christine M.,24,0,30,6
1649861555251,COGS 107B,A01,083980,Staff,32,0,50,18
1649861561276,COGS 115,A01,083982,Staff,21,0,30,9
1649861567303,COGS 118B,A01,083367,Staff,5,0,40,35
1649861573330,COGS 172,A01,083984,Provenzano; Emily Kara,20,0,30,10
1649861579356,COGS 177,A00,083368,Staff,2,0,30,28
1649861585385,COGS 186,A01,083986,Staff,25,0,40,15
1649861591408,COGS 187A,A01,083988,Boyle; Mary E. T.,40,0,60,20
1649861597435,CSE 8A,A50,084003,Miranda; Gregory Joseph,9,0,15,6
1649861603464,CSE 11,A01,084005,Miranda; Gregory Joseph,49,0,55,6
1649861609488,CSE 20,A01,084007,Staff,15,0,20,5
1649861615516,CSE 21,A01,084009,Staff,32,0,50,18
1649861621541,CSE 30,A01,083370,Cao; Yingjun,20,0,40,20
1649861627572,CSE 100,A01,083372,Cao; Yingjun,13,0,40,27
1649861633597,CSE 101,A01,084011,Staff,0,16,40,40
1649861639625,CSE 141,A01,083374,Eldon; John,0,14,75,75
1649861645657,CSE 141L,A01,083376,Eldon; John,0,18,75,75
1649861651688,CSE 175,A01,084013,Kumar; Rakesh,24,0,25,1
1649861657714,CSE 190,A00,092508,Staff,15,0,15,0
1649861663738,ECE 5,A01,084049,Morris; Karcher William,17,0,20,3
1649861669760,ECE 100,A01,084051,Baghdadchi; Saharnaz,16,0,20,4
1649861669760,ECE 100,A02,091916,Baghdadchi; Saharnaz,18,0,20,2
1649861675783,ECE 101,A01,084053,Baghdadchi; Saharnaz,25,0,37,12
1649861675783,ECE 101,A02,084054,Baghdadchi; Saharnaz,37,0,37,0
1649861681807,ECE 107,A01,083390,Staff,31,0,40,9
1649861687836,ECE 148,A01,084056,Silberman; Jack,8,0,12,4
1649861693870,ECE 180,A00,083391,Abi Samra; Nicholas Camill,27,0,30,3
1649861693870,ECE 180,B00,083392,Abi Samra; Nicholas Camill,26,0,30,4
1649861699897,MATH 10B,A01,084110,Staff,20,0,30,10
1649861699897,MATH 10B,A02,084111,Staff,29,0,30,1
1649861699897,MATH 10B,A03,084112,Staff,29,0,30,1
1649861705921,MATH 10C,A01,083443,Staff,19,0,30,11
1649861705921,MATH 10C,A02,083444,Staff,24,0,30,6
1649861705921,MATH 10C,B01,084114,Staff,26,0,30,4
1649861705921,MATH 10C,B02,084115,Staff,30,0,30,0
1649861711944,MATH 18,A01,084117,Harel; Guershon,28,0,30,2
1649861711944,MATH 18,A02,084119,Harel; Guershon,29,0,30,1
1649861711944,MATH 18,A03,084120,Harel; Guershon,30,0,30,0
1649861711944,MATH 18,A04,084121,Harel; Guershon,30,0,30,0
1649861717969,MATH 20B,A01,084124,Um; Ko Woon,33,0,35,2
1649861717969,MATH 20B,B01,084126,Um; Ko Woon,35,0,35,0
1649861724003,MATH 20C,A01,083446,Hammock; Frances H,26,0,30,4
1649861724003,MATH 20C,A02,083447,Hammock; Frances H,30,0,30,0
1649861724003,MATH 20C,A03,083448,Hammock; Frances H,30,0,30,0
1649861724003,MATH 20C,A04,083449,Hammock; Frances H,30,0,30,0
1649861724003,MATH 20C,B01,083451,Hammock; Frances H,29,0,30,1
1649861724003,MATH 20C,B02,083452,Hammock; Frances H,30,0,30,0
1649861724003,MATH 20C,B03,083453,Hammock; Frances H,30,0,30,0
1649861724003,MATH 20C,B04,083454,Hammock; Frances H,30,0,30,0
1649861730027,MATH 20D,A01,084128,Staff,29,0,30,1
1649861730027,MATH 20D,A02,084129,Staff,30,0,30,0
1649861730027,MATH 20D,A03,084130,Staff,29,0,30,1
1649861730027,MATH 20D,B01,084133,Staff,28,0,30,2
1649861730027,MATH 20D,B02,084134,Staff,30,0,30,0
1649861730027,MATH 20D,B03,084135,Staff,30,0,30,0
1649861736049,MATH 20E,A01,084138,Staff,27,0,30,3
1649861736049,MATH 20E,A02,084139,Staff,29,0,30,1
1649861736049,MATH 20E,A03,084140,Staff,28,0,30,2
1649861736049,MATH 20E,A04,084141,Staff,30,0,30,0
1649861742073,MATH 102,A01,084143,Harel; Guershon,24,0,30,6
1649861742073,MATH 102,A02,084144,Harel; Guershon,25,0,30,5
1649861748104,MATH 103B,A01,083456,Staff,0,0,30,30
1649861748104,MATH 103B,A02,083457,Staff,18,0,30,12
1649861754132,MATH 109,A01,084146,Salehi Golsefidy; Alireza,30,0,30,0
1649861754132,MATH 109,A02,084147,Salehi Golsefidy; Alireza,26,0,30,4
1649861760158,MATH 120A,A01,085445,Eggers; John Dietrich,30,0,35,5
1649861760158,MATH 120A,A02,085446,Eggers; John Dietrich,31,0,35,4
1649861766183,MATH 142B,A01,084149,Verstraete; Jacques Allan,7,0,30,23
1649861766183,MATH 142B,A02,084150,Verstraete; Jacques Allan,25,0,30,5
1649861772205,MATH 170A,A01,083459,Nie; Jiawang,9,0,30,21
1649861772205,MATH 170A,A02,083460,Nie; Jiawang,25,0,30,5
1649861772205,MATH 170A,A03,083461,Nie; Jiawang,26,0,30,4
1649861778226,MATH 193B,A01,083463,Staff,15,0,30,15
1649861778226,MATH 193B,A02,083464,Staff,19,0,30,11
1649861778226,MATH 193B,A03,083465,Staff,27,0,30,3
1649861784286,COGS 2,A01,083966,Boyle; Mary E. T.,27,0,30,3
1649861790312,COGS 9,A01,083968,Staff,56,0,60,4
1649861796427,COGS 14B,A01,083970,Staff,46,0,50,4
1649861802454,COGS 17,A01,092679,Staff,73,0,75,2
1649861808477,COGS 100,A01,083972,Staff,46,0,60,14
1649861820534,COGS 101C,A01,083976,Staff,25,0,30,5
1649861826561,COGS 102A,A01,083978,Johnson; Christine M.,24,0,30,6
1649861832586,COGS 107B,A01,083980,Staff,32,0,50,18
1649861838613,COGS 115,A01,083982,Staff,21,0,30,9
1649861844645,COGS 118B,A01,083367,Staff,5,0,40,35
1649861850677,COGS 172,A01,083984,Provenzano; Emily Kara,20,0,30,10
1649861856699,COGS 177,A00,083368,Staff,2,0,30,28
1649861862725,COGS 186,A01,083986,Staff,25,0,40,15
1649861868755,COGS 187A,A01,083988,Boyle; Mary E. T.,40,0,60,20
1649861874783,CSE 8A,A50,084003,Miranda; Gregory Joseph,9,0,15,6
1649861880807,CSE 11,A01,084005,Miranda; Gregory Joseph,49,0,55,6
1649861886829,CSE 20,A01,084007,Staff,15,0,20,5
1649861892855,CSE 21,A01,084009,Staff,32,0,50,18
1649861898886,CSE 30,A01,083370,Cao; Yingjun,20,0,40,20
1649861904913,CSE 100,A01,083372,Cao; Yingjun,13,0,40,27
1649861910936,CSE 101,A01,084011,Staff,0,16,40,40
1649861916963,CSE 141,A01,083374,Eldon; John,0,14,75,75
1649861922987,CSE 141L,A01,083376,Eldon; John,0,18,75,75
1649861929010,CSE 175,A01,084013,Kumar; Rakesh,24,0,25,1
1649861935038,CSE 190,A00,092508,Staff,15,0,15,0
1649861941069,ECE 5,A01,084049,Morris; Karcher William,17,0,20,3
1649861947096,ECE 100,A01,084051,Baghdadchi; Saharnaz,16,0,20,4
1649861947096,ECE 100,A02,091916,Baghdadchi; Saharnaz,18,0,20,2
1649861953119,ECE 101,A01,084053,Baghdadchi; Saharnaz,25,0,37,12
1649861953119,ECE 101,A02,084054,Baghdadchi; Saharnaz,37,0,37,0
1649861959145,ECE 107,A01,083390,Staff,31,0,40,9
1649861965169,ECE 148,A01,084056,Silberman; Jack,8,0,12,4
1649861971192,ECE 180,A00,083391,Abi Samra; Nicholas Camill,27,0,30,3
1649861971192,ECE 180,B00,083392,Abi Samra; Nicholas Camill,26,0,30,4
1649861977220,MATH 10B,A01,084110,Staff,20,0,30,10
1649861977220,MATH 10B,A02,084111,Staff,29,0,30,1
1649861977220,MATH 10B,A03,084112,Staff,29,0,30,1
1649861983244,MATH 10C,A01,083443,Staff,19,0,30,11
1649861983244,MATH 10C,A02,083444,Staff,24,0,30,6
1649861983244,MATH 10C,B01,084114,Staff,26,0,30,4
1649861983244,MATH 10C,B02,084115,Staff,30,0,30,0
1649861989272,MATH 18,A01,084117,Harel; Guershon,28,0,30,2
1649861989272,MATH 18,A02,084119,Harel; Guershon,29,0,30,1
1649861989272,MATH 18,A03,084120,Harel; Guershon,30,0,30,0
1649861989272,MATH 18,A04,084121,Harel; Guershon,30,0,30,0
1649861995294,MATH 20B,A01,084124,Um; Ko Woon,33,0,35,2
1649861995294,MATH 20B,B01,084126,Um; Ko Woon,35,0,35,0
1649862001316,MATH 20C,A01,083446,Hammock; Frances H,26,0,30,4
1649862001316,MATH 20C,A02,083447,Hammock; Frances H,30,0,30,0
1649862001316,MATH 20C,A03,083448,Hammock; Frances H,30,0,30,0
1649862001316,MATH 20C,A04,083449,Hammock; Frances H,30,0,30,0
1649862001316,MATH 20C,B01,083451,Hammock; Frances H,29,0,30,1
1649862001316,MATH 20C,B02,083452,Hammock; Frances H,30,0,30,0
1649862001316,MATH 20C,B03,083453,Hammock; Frances H,30,0,30,0
1649862001316,MATH 20C,B04,083454,Hammock; Frances H,30,0,30,0
1649862007343,MATH 20D,A01,084128,Staff,29,0,30,1
1649862007343,MATH 20D,A02,084129,Staff,30,0,30,0
1649862007343,MATH 20D,A03,084130,Staff,29,0,30,1
1649862007343,MATH 20D,B01,084133,Staff,28,0,30,2
1649862007343,MATH 20D,B02,084134,Staff,30,0,30,0
1649862007343,MATH 20D,B03,084135,Staff,30,0,30,0
1649862013369,MATH 20E,A01,084138,Staff,27,0,30,3
1649862013369,MATH 20E,A02,084139,Staff,29,0,30,1
1649862013369,MATH 20E,A03,084140,Staff,28,0,30,2
1649862013369,MATH 20E,A04,084141,Staff,30,0,30,0
1649862019392,MATH 102,A01,084143,Harel; Guershon,24,0,30,6
1649862019392,MATH 102,A02,084144,Harel; Guershon,25,0,30,5
1649862025421,MATH 103B,A01,083456,Staff,0,0,30,30
1649862025421,MATH 103B,A02,083457,Staff,18,0,30,12
1649862031443,MATH 109,A01,084146,Salehi Golsefidy; Alireza,30,0,30,0
1649862031443,MATH 109,A02,084147,Salehi Golsefidy; Alireza,26,0,30,4
1649862037465,MATH 120A,A01,085445,Eggers; John Dietrich,30,0,35,5
1649862037465,MATH 120A,A02,085446,Eggers; John Dietrich,31,0,35,4
1649862043498,MATH 142B,A01,084149,Verstraete; Jacques Allan,7,0,30,23
1649862043498,MATH 142B,A02,084150,Verstraete; Jacques Allan,25,0,30,5
1649862049521,MATH 170A,A01,083459,Nie; Jiawang,9,0,30,21
1649862049521,MATH 170A,A02,083460,Nie; Jiawang,25,0,30,5
1649862049521,MATH 170A,A03,083461,Nie; Jiawang,26,0,30,4
1649862055548,MATH 193B,A01,083463,Staff,15,0,30,15
1649862055548,MATH 193B,A02,083464,Staff,19,0,30,11
1649862055548,MATH 193B,A03,083465,Staff,27,0,30,3
1649862061611,COGS 2,A01,083966,Boyle; Mary E. T.,27,0,30,3
1649862067634,COGS 9,A01,083968,Staff,56,0,60,4
1649862073656,COGS 14B,A01,083970,Staff,46,0,50,4
1649862079686,COGS 17,A01,092679,Staff,73,0,75,2
1649862085712,COGS 100,A01,083972,Staff,46,0,60,14
1649862097778,COGS 101C,A01,083976,Staff,25,0,30,5
1649862103806,COGS 102A,A01,083978,Johnson; Christine M.,24,0,30,6
1649862109837,COGS 107B,A01,083980,Staff,32,0,50,18
1649862115859,COGS 115,A01,083982,Staff,21,0,30,9
1649862121886,COGS 118B,A01,083367,Staff,5,0,40,35
1649862127910,COGS 172,A01,083984,Provenzano; Emily Kara,20,0,30,10
1649862133934,COGS 177,A00,083368,Staff,2,0,30,28
1649862139958,COGS 186,A01,083986,Staff,25,0,40,15
1649862145990,COGS 187A,A01,083988,Boyle; Mary E. T.,40,0,60,20
1649862152024,CSE 8A,A50,084003,Miranda; Gregory Joseph,9,0,15,6
1649862158047,CSE 11,A01,084005,Miranda; Gregory Joseph,49,0,55,6
1649862164072,CSE 20,A01,084007,Staff,15,0,20,5
1649862170093,CSE 21,A01,084009,Staff,32,0,50,18
1649862176125,CSE 30,A01,083370,Cao; Yingjun,20,0,40,20
1649862182155,CSE 100,A01,083372,Cao; Yingjun,13,0,40,27
1649862188181,CSE 101,A01,084011,Staff,0,16,40,40
1649862194203,CSE 141,A01,083374,Eldon; John,0,14,75,75
1649862200230,CSE 141L,A01,083376,Eldon; John,0,18,75,75
1649862206264,CSE 175,A01,084013,Kumar; Rakesh,24,0,25,1
1649862212293,CSE 190,A00,092508,Staff,15,0,15,0
1649862218321,ECE 5,A01,084049,Morris; Karcher William,17,0,20,3
1649862224354,ECE 100,A01,084051,Baghdadchi; Saharnaz,16,0,20,4
1649862224354,ECE 100,A02,091916,Baghdadchi; Saharnaz,18,0,20,2
1649862230377,ECE 101,A01,084053,Baghdadchi; Saharnaz,25,0,37,12
1649862230377,ECE 101,A02,084054,Baghdadchi; Saharnaz,37,0,37,0
1649862236402,ECE 107,A01,083390,Staff,31,0,40,9
1649862242438,ECE 148,A01,084056,Silberman; Jack,8,0,12,4
1649862248463,ECE 180,A00,083391,Abi Samra; Nicholas Camill,27,0,30,3
1649862248463,ECE 180,B00,083392,Abi Samra; Nicholas Camill,26,0,30,4
1649862254491,MATH 10B,A01,084110,Staff,20,0,30,10
1649862254491,MATH 10B,A02,084111,Staff,29,0,30,1
1649862254491,MATH 10B,A03,084112,Staff,29,0,30,1
1649862260524,MATH 10C,A01,083443,Staff,19,0,30,11
1649862260524,MATH 10C,A02,083444,Staff,24,0,30,6
1649862260524,MATH 10C,B01,084114,Staff,26,0,30,4
1649862260524,MATH 10C,B02,084115,Staff,30,0,30,0
1649862266554,MATH 18,A01,084117,Harel; Guershon,28,0,30,2
1649862266554,MATH 18,A02,084119,Harel; Guershon,29,0,30,1
1649862266554,MATH 18,A03,084120,Harel; Guershon,30,0,30,0
1649862266554,MATH 18,A04,084121,Harel; Guershon,30,0,30,0
1649862272590,MATH 20B,A01,084124,Um; Ko Woon,33,0,35,2
1649862272590,MATH 20B,B01,084126,Um; Ko Woon,35,0,35,0
1649862278620,MATH 20C,A01,083446,Hammock; Frances H,26,0,30,4
1649862278620,MATH 20C,A02,083447,Hammock; Frances H,30,0,30,0
1649862278620,MATH 20C,A03,083448,Hammock; Frances H,30,0,30,0
1649862278620,MATH 20C,A04,083449,Hammock; Frances H,30,0,30,0
1649862278620,MATH 20C,B01,083451,Hammock; Frances H,29,0,30,1
1649862278620,MATH 20C,B02,083452,Hammock; Frances H,30,0,30,0
1649862278620,MATH 20C,B03,083453,Hammock; Frances H,30,0,30,0
1649862278620,MATH 20C,B04,083454,Hammock; Frances H,30,0,30,0
1649862284655,MATH 20D,A01,084128,Staff,29,0,30,1
1649862284655,MATH 20D,A02,084129,Staff,30,0,30,0
1649862284655,MATH 20D,A03,084130,Staff,29,0,30,1
1649862284655,MATH 20D,B01,084133,Staff,28,0,30,2
1649862284655,MATH 20D,B02,084134,Staff,30,0,30,0
1649862284655,MATH 20D,B03,084135,Staff,30,0,30,0
1649862290689,MATH 20E,A01,084138,Staff,27,0,30,3
1649862290689,MATH 20E,A02,084139,Staff,29,0,30,1
1649862290689,MATH 20E,A03,084140,Staff,28,0,30,2
1649862290689,MATH 20E,A04,084141,Staff,30,0,30,0
1649862296713,MATH 102,A01,084143,Harel; Guershon,24,0,30,6
1649862296713,MATH 102,A02,084144,Harel; Guershon,25,0,30,5
1649862302736,MATH 103B,A01,083456,Staff,0,0,30,30
1649862302736,MATH 103B,A02,083457,Staff,18,0,30,12
1649862308758,MATH 109,A01,084146,Salehi Golsefidy; Alireza,29,0,30,1
1649862308758,MATH 109,A02,084147,Salehi Golsefidy; Alireza,26,0,30,4
1649862314785,MATH 120A,A01,085445,Eggers; John Dietrich,30,0,35,5
1649862314785,MATH 120A,A02,085446,Eggers; John Dietrich,31,0,35,4
1649862320807,MATH 142B,A01,084149,Verstraete; Jacques Allan,7,0,30,23
1649862320807,MATH 142B,A02,084150,Verstraete; Jacques Allan,25,0,30,5
1649862326846,MATH 170A,A01,083459,Nie; Jiawang,9,0,30,21
1649862326846,MATH 170A,A02,083460,Nie; Jiawang,25,0,30,5
1649862326846,MATH 170A,A03,083461,Nie; Jiawang,26,0,30,4
1649862332867,MATH 193B,A01,083463,Staff,15,0,30,15
1649862332867,MATH 193B,A02,083464,Staff,19,0,30,11
1649862332867,MATH 193B,A03,083465,Staff,27,0,30,3
1649862338918,COGS 2,A01,083966,Boyle; Mary E. T.,27,0,30,3
1649862344944,COGS 9,A01,083968,Staff,56,0,60,4
1649862350968,COGS 14B,A01,083970,Staff,46,0,50,4
1649862356993,COGS 17,A01,092679,Staff,73,0,75,2
1649862363016,COGS 100,A01,083972,Staff,46,0,60,14
1649862375060,COGS 101C,A01,083976,Staff,25,0,30,5
1649862381084,COGS 102A,A01,083978,Johnson; Christine M.,24,0,30,6
1649862387108,COGS 107B,A01,083980,Staff,32,0,50,18
1649862393228,COGS 115,A01,083982,Staff,21,0,30,9
1649862399255,COGS 118B,A01,083367,Staff,5,0,40,35
1649862405276,COGS 172,A01,083984,Provenzano; Emily Kara,20,0,30,10
1649862411306,COGS 177,A00,083368,Staff,2,0,30,28
1649862417330,COGS 186,A01,083986,Staff,25,0,40,15
1649862423354,COGS 187A,A01,083988,Boyle; Mary E. T.,40,0,60,20
1649862429383,CSE 8A,A50,084003,Miranda; Gregory Joseph,9,0,15,6
1649862435407,CSE 11,A01,084005,Miranda; Gregory Joseph,49,0,55,6
1649862441448,CSE 20,A01,084007,Staff,15,0,20,5
1649862447471,CSE 21,A01,084009,Staff,32,0,50,18
1649862453498,CSE 30,A01,083370,Cao; Yingjun,20,0,40,20
1649862459521,CSE 100,A01,083372,Cao; Yingjun,13,0,40,27
1649862465546,CSE 101,A01,084011,Staff,0,16,40,40
1649862471568,CSE 141,A01,083374,Eldon; John,0,14,75,75
1649862477604,CSE 141L,A01,083376,Eldon; John,0,18,75,75
1649862483628,CSE 175,A01,084013,Kumar; Rakesh,24,0,25,1
1649862489653,CSE 190,A00,092508,Staff,15,0,15,0
1649862495689,ECE 5,A01,084049,Morris; Karcher William,17,0,20,3
1649862501714,ECE 100,A01,084051,Baghdadchi; Saharnaz,16,0,20,4
1649862501714,ECE 100,A02,091916,Baghdadchi; Saharnaz,18,0,20,2
1649862507741,ECE 101,A01,084053,Baghdadchi; Saharnaz,25,0,37,12
1649862507741,ECE 101,A02,084054,Baghdadchi; Saharnaz,37,0,37,0
1649862513768,ECE 107,A01,083390,Staff,31,0,40,9
1649862519796,ECE 148,A01,084056,Silberman; Jack,8,0,12,4
1649862525821,ECE 180,A00,083391,Abi Samra; Nicholas Camill,27,0,30,3
1649862525821,ECE 180,B00,083392,Abi Samra; Nicholas Camill,26,0,30,4
1649862531848,MATH 10B,A01,084110,Staff,20,0,30,10
1649862531848,MATH 10B,A02,084111,Staff,29,0,30,1
1649862531848,MATH 10B,A03,084112,Staff,29,0,30,1
1649862537872,MATH 10C,A01,083443,Staff,19,0,30,11
1649862537872,MATH 10C,A02,083444,Staff,24,0,30,6
1649862537872,MATH 10C,B01,084114,Staff,26,0,30,4
1649862537872,MATH 10C,B02,084115,Staff,30,0,30,0
1649862543899,MATH 18,A01,084117,Harel; Guershon,28,0,30,2
1649862543899,MATH 18,A02,084119,Harel; Guershon,29,0,30,1
1649862543899,MATH 18,A03,084120,Harel; Guershon,30,0,30,0
1649862543899,MATH 18,A04,084121,Harel; Guershon,30,0,30,0
1649862549927,MATH 20B,A01,084124,Um; Ko Woon,33,0,35,2
1649862549927,MATH 20B,B01,084126,Um; Ko Woon,35,0,35,0
1649862555954,MATH 20C,A01,083446,Hammock; Frances H,26,0,30,4
1649862555954,MATH 20C,A02,083447,Hammock; Frances H,30,0,30,0
1649862555954,MATH 20C,A03,083448,Hammock; Frances H,30,0,30,0
1649862555954,MATH 20C,A04,083449,Hammock; Frances H,30,0,30,0
1649862555954,MATH 20C,B01,083451,Hammock; Frances H,29,0,30,1
1649862555954,MATH 20C,B02,083452,Hammock; Frances H,30,0,30,0
1649862555954,MATH 20C,B03,083453,Hammock; Frances H,30,0,30,0
1649862555954,MATH 20C,B04,083454,Hammock; Frances H,30,0,30,0
1649862561981,MATH 20D,A01,084128,Staff,29,0,30,1
1649862561981,MATH 20D,A02,084129,Staff,30,0,30,0
1649862561981,MATH 20D,A03,084130,Staff,29,0,30,1
1649862561981,MATH 20D,B01,084133,Staff,28,0,30,2
1649862561981,MATH 20D,B02,084134,Staff,30,0,30,0
1649862561981,MATH 20D,B03,084135,Staff,30,0,30,0
1649862568022,MATH 20E,A01,084138,Staff,27,0,30,3
1649862568022,MATH 20E,A02,084139,Staff,29,0,30,1
1649862568022,MATH 20E,A03,084140,Staff,28,0,30,2
1649862568022,MATH 20E,A04,084141,Staff,30,0,30,0
1649862574050,MATH 102,A01,084143,Harel; Guershon,24,0,30,6
1649862574050,MATH 102,A02,084144,Harel; Guershon,25,0,30,5
1649862580077,MATH 103B,A01,083456,Staff,0,0,30,30
1649862580077,MATH 103B,A02,083457,Staff,18,0,30,12
1649862586101,MATH 109,A01,084146,Salehi Golsefidy; Alireza,29,0,30,1
1649862586101,MATH 109,A02,084147,Salehi Golsefidy; Alireza,26,0,30,4
1649862592124,MATH 120A,A01,085445,Eggers; John Dietrich,30,0,35,5
1649862592124,MATH 120A,A02,085446,Eggers; John Dietrich,31,0,35,4
1649862598149,MATH 142B,A01,084149,Verstraete; Jacques Allan,7,0,30,23
1649862598149,MATH 142B,A02,084150,Verstraete; Jacques Allan,25,0,30,5
1649862604187,MATH 170A,A01,083459,Nie; Jiawang,9,0,30,21
1649862604187,MATH 170A,A02,083460,Nie; Jiawang,25,0,30,5
1649862604187,MATH 170A,A03,083461,Nie; Jiawang,26,0,30,4
1649862610210,MATH 193B,A01,083463,Staff,15,0,30,15
1649862610210,MATH 193B,A02,083464,Staff,19,0,30,11
1649862610210,MATH 193B,A03,083465,Staff,27,0,30,3
1649862616282,COGS 2,A01,083966,Boyle; Mary E. T.,27,0,30,3
1649862622309,COGS 9,A01,083968,Staff,56,0,60,4
1649862628334,COGS 14B,A01,083970,Staff,46,0,50,4
1649862634356,COGS 17,A01,092679,Staff,73,0,75,2
1649862640381,COGS 100,A01,083972,Staff,46,0,60,14
1649862652436,COGS 101C,A01,083976,Staff,25,0,30,5
1649862658467,COGS 102A,A01,083978,Johnson; Christine M.,24,0,30,6
1649862664497,COGS 107B,A01,083980,Staff,32,0,50,18
1649862670520,COGS 115,A01,083982,Staff,21,0,30,9
1649862676546,COGS 118B,A01,083367,Staff,5,0,40,35
1649862682570,COGS 172,A01,083984,Provenzano; Emily Kara,20,0,30,10
1649862688607,COGS 177,A00,083368,Staff,2,0,30,28
1649862694653,COGS 186,A01,083986,Staff,25,0,40,15
1649862700681,COGS 187A,A01,083988,Boyle; Mary E. T.,40,0,60,20
1649862706705,CSE 8A,A50,084003,Miranda; Gregory Joseph,9,0,15,6
1649862712733,CSE 11,A01,084005,Miranda; Gregory Joseph,49,0,55,6
1649862718759,CSE 20,A01,084007,Staff,15,0,20,5
1649862724792,CSE 21,A01,084009,Staff,32,0,50,18
1649862730817,CSE 30,A01,083370,Cao; Yingjun,20,0,40,20
1649862736853,CSE 100,A01,083372,Cao; Yingjun,13,0,40,27
1649862742877,CSE 101,A01,084011,Staff,0,16,40,40
1649862748907,CSE 141,A01,083374,Eldon; John,0,14,75,75
1649862754935,CSE 141L,A01,083376,Eldon; John,0,18,75,75
1649862760962,CSE 175,A01,084013,Kumar; Rakesh,24,0,25,1
1649862766986,CSE 190,A00,092508,Staff,15,0,15,0
1649862773011,ECE 5,A01,084049,Morris; Karcher William,17,0,20,3
1649862779047,ECE 100,A01,084051,Baghdadchi; Saharnaz,16,0,20,4
1649862779047,ECE 100,A02,091916,Baghdadchi; Saharnaz,18,0,20,2
1649862785073,ECE 101,A01,084053,Baghdadchi; Saharnaz,25,0,37,12
1649862785073,ECE 101,A02,084054,Baghdadchi; Saharnaz,37,0,37,0
1649862791095,ECE 107,A01,083390,Staff,31,0,40,9
1649862797117,ECE 148,A01,084056,Silberman; Jack,8,0,12,4
1649862803143,ECE 180,A00,083391,Abi Samra; Nicholas Camill,27,0,30,3
1649862803143,ECE 180,B00,083392,Abi Samra; Nicholas Camill,26,0,30,4
1649862809172,MATH 10B,A01,084110,Staff,19,0,30,11
1649862809172,MATH 10B,A02,084111,Staff,29,0,30,1
1649862809172,MATH 10B,A03,084112,Staff,29,0,30,1
1649862815194,MATH 10C,A01,083443,Staff,19,0,30,11
1649862815194,MATH 10C,A02,083444,Staff,24,0,30,6
1649862815194,MATH 10C,B01,084114,Staff,26,0,30,4
1649862815194,MATH 10C,B02,084115,Staff,30,0,30,0
1649862821227,MATH 18,A01,084117,Harel; Guershon,28,0,30,2
1649862821227,MATH 18,A02,084119,Harel; Guershon,29,0,30,1
1649862821227,MATH 18,A03,084120,Harel; Guershon,30,0,30,0
1649862821227,MATH 18,A04,084121,Harel; Guershon,30,0,30,0
1649862827252,MATH 20B,A01,084124,Um; Ko Woon,33,0,35,2
1649862827252,MATH 20B,B01,084126,Um; Ko Woon,35,0,35,0
1649862833282,MATH 20C,A01,083446,Hammock; Frances H,26,0,30,4
1649862833282,MATH 20C,A02,083447,Hammock; Frances H,30,0,30,0
1649862833282,MATH 20C,A03,083448,Hammock; Frances H,30,0,30,0
1649862833282,MATH 20C,A04,083449,Hammock; Frances H,30,0,30,0
1649862833282,MATH 20C,B01,083451,Hammock; Frances H,29,0,30,1
1649862833282,MATH 20C,B02,083452,Hammock; Frances H,30,0,30,0
1649862833282,MATH 20C,B03,083453,Hammock; Frances H,30,0,30,0
1649862833282,MATH 20C,B04,083454,Hammock; Frances H,30,0,30,0
1649862839309,MATH 20D,A01,084128,Staff,29,0,30,1
1649862839309,MATH 20D,A02,084129,Staff,30,0,30,0
1649862839309,MATH 20D,A03,084130,Staff,29,0,30,1
1649862839309,MATH 20D,B01,084133,Staff,28,0,30,2
1649862839309,MATH 20D,B02,084134,Staff,30,0,30,0
1649862839309,MATH 20D,B03,084135,Staff,30,0,30,0
1649862845332,MATH 20E,A01,084138,Staff,27,0,30,3
1649862845332,MATH 20E,A02,084139,Staff,29,0,30,1
1649862845332,MATH 20E,A03,084140,Staff,28,0,30,2
1649862845332,MATH 20E,A04,084141,Staff,30,0,30,0
1649862851397,MATH 102,A01,084143,Harel; Guershon,24,0,30,6
1649862851397,MATH 102,A02,084144,Harel; Guershon,25,0,30,5
1649862857432,MATH 103B,A01,083456,Staff,0,0,30,30
1649862857432,MATH 103B,A02,083457,Staff,17,0,30,13
1649862863454,MATH 109,A01,084146,Salehi Golsefidy; Alireza,29,0,30,1
1649862863454,MATH 109,A02,084147,Salehi Golsefidy; Alireza,26,0,30,4
1649862869478,MATH 120A,A01,085445,Eggers; John Dietrich,29,0,35,6
1649862869478,MATH 120A,A02,085446,Eggers; John Dietrich,31,0,35,4
1649862875505,MATH 142B,A01,084149,Verstraete; Jacques Allan,7,0,30,23
1649862875505,MATH 142B,A02,084150,Verstraete; Jacques Allan,25,0,30,5
1649862881533,MATH 170A,A01,083459,Nie; Jiawang,9,0,30,21
1649862881533,MATH 170A,A02,083460,Nie; Jiawang,25,0,30,5
1649862881533,MATH 170A,A03,083461,Nie; Jiawang,26,0,30,4
1649862887560,MATH 193B,A01,083463,Staff,15,0,30,15
1649862887560,MATH 193B,A02,083464,Staff,19,0,30,11
1649862887560,MATH 193B,A03,083465,Staff,27,0,30,3
1649862893614,COGS 2,A01,083966,Boyle; Mary E. T.,27,0,30,3
1649862899636,COGS 9,A01,083968,Staff,56,0,60,4
1649862905662,COGS 14B,A01,083970,Staff,46,0,50,4
1649862911686,COGS 17,A01,092679,Staff,73,0,75,2
1649862917712,COGS 100,A01,083972,Staff,46,0,60,14
1649862929759,COGS 101C,A01,083976,Staff,25,0,30,5
1649862935787,COGS 102A,A01,083978,Johnson; Christine M.,24,0,30,6
1649862941810,COGS 107B,A01,083980,Staff,32,0,50,18
1649862947843,COGS 115,A01,083982,Staff,21,0,30,9
1649862953882,COGS 118B,A01,083367,Staff,4,0,40,36
1649862959908,COGS 172,A01,083984,Provenzano; Emily Kara,20,0,30,10
1649862965936,COGS 177,A00,083368,Staff,2,0,30,28
1649862971961,COGS 186,A01,083986,Staff,25,0,40,15
1649862977991,COGS 187A,A01,083988,Boyle; Mary E. T.,40,0,60,20
1649862984014,CSE 8A,A50,084003,Miranda; Gregory Joseph,9,0,15,6
1649862990144,CSE 11,A01,084005,Miranda; Gregory Joseph,49,0,55,6
1649862996168,CSE 20,A01,084007,Staff,15,0,20,5
1649863002192,CSE 21,A01,084009,Staff,32,0,50,18
1649863008218,CSE 30,A01,083370,Cao; Yingjun,20,0,40,20
1649863014243,CSE 100,A01,083372,Cao; Yingjun,12,0,40,28
1649863020270,CSE 101,A01,084011,Staff,0,16,40,40
1649863026299,CSE 141,A01,083374,Eldon; John,0,14,75,75
1649863032322,CSE 141L,A01,083376,Eldon; John,0,18,75,75
1649863038354,CSE 175,A01,084013,Kumar; Rakesh,24,0,25,1
1649863044386,CSE 190,A00,092508,Staff,15,0,15,0
1649863050411,ECE 5,A01,084049,Morris; Karcher William,17,0,20,3
1649863056433,ECE 100,A01,084051,Baghdadchi; Saharnaz,16,0,20,4
1649863056433,ECE 100,A02,091916,Baghdadchi; Saharnaz,18,0,20,2
1649863062456,ECE 101,A01,084053,Baghdadchi; Saharnaz,25,0,37,12
1649863062456,ECE 101,A02,084054,Baghdadchi; Saharnaz,37,0,37,0
1649863068483,ECE 107,A01,083390,Staff,31,0,40,9
1649863074509,ECE 148,A01,084056,Silberman; Jack,8,0,12,4
1649863080533,ECE 180,A00,083391,Abi Samra; Nicholas Camill,27,0,30,3
1649863080533,ECE 180,B00,083392,Abi Samra; Nicholas Camill,26,0,30,4
1649863086557,MATH 10B,A01,084110,Staff,19,0,30,11
1649863086557,MATH 10B,A02,084111,Staff,29,0,30,1
1649863086557,MATH 10B,A03,084112,Staff,29,0,30,1
1649863092587,MATH 10C,A01,083443,Staff,19,0,30,11
1649863092587,MATH 10C,A02,083444,Staff,24,0,30,6
1649863092587,MATH 10C,B01,084114,Staff,26,0,30,4
1649863092587,MATH 10C,B02,084115,Staff,30,0,30,0
1649863098614,MATH 18,A01,084117,Harel; Guershon,28,0,30,2
1649863098614,MATH 18,A02,084119,Harel; Guershon,29,0,30,1
1649863098614,MATH 18,A03,084120,Harel; Guershon,30,0,30,0
1649863098614,MATH 18,A04,084121,Harel; Guershon,30,0,30,0
1649863104641,MATH 20B,A01,084124,Um; Ko Woon,33,0,35,2
1649863104641,MATH 20B,B01,084126,Um; Ko Woon,35,0,35,0
1649863110669,MATH 20C,A01,083446,Hammock; Frances H,26,0,30,4
1649863110669,MATH 20C,A02,083447,Hammock; Frances H,30,0,30,0
1649863110669,MATH 20C,A03,083448,Hammock; Frances H,30,0,30,0
1649863110669,MATH 20C,A04,083449,Hammock; Frances H,30,0,30,0
1649863110669,MATH 20C,B01,083451,Hammock; Frances H,29,0,30,1
1649863110669,MATH 20C,B02,083452,Hammock; Frances H,30,0,30,0
1649863110669,MATH 20C,B03,083453,Hammock; Frances H,30,0,30,0
1649863110669,MATH 20C,B04,083454,Hammock; Frances H,30,0,30,0
1649863116693,MATH 20D,A01,084128,Staff,29,0,30,1
1649863116693,MATH 20D,A02,084129,Staff,30,0,30,0
1649863116693,MATH 20D,A03,084130,Staff,29,0,30,1
1649863116693,MATH 20D,B01,084133,Staff,28,0,30,2
1649863116693,MATH 20D,B02,084134,Staff,30,0,30,0
1649863116693,MATH 20D,B03,084135,Staff,30,0,30,0
1649863122718,MATH 20E,A01,084138,Staff,27,0,30,3
1649863122718,MATH 20E,A02,084139,Staff,29,0,30,1
1649863122718,MATH 20E,A03,084140,Staff,28,0,30,2
1649863122718,MATH 20E,A04,084141,Staff,30,0,30,0
1649863128743,MATH 102,A01,084143,Harel; Guershon,24,0,30,6
1649863128743,MATH 102,A02,084144,Harel; Guershon,25,0,30,5
1649863134769,MATH 103B,A01,083456,Staff,0,0,30,30
1649863134769,MATH 103B,A02,083457,Staff,17,0,30,13
1649863140794,MATH 109,A01,084146,Salehi Golsefidy; Alireza,29,0,30,1
1649863140794,MATH 109,A02,084147,Salehi Golsefidy; Alireza,26,0,30,4
1649863146819,MATH 120A,A01,085445,Eggers; John Dietrich,29,0,35,6
1649863146819,MATH 120A,A02,085446,Eggers; John Dietrich,31,0,35,4
1649863152844,MATH 142B,A01,084149,Verstraete; Jacques Allan,7,0,30,23
1649863152844,MATH 142B,A02,084150,Verstraete; Jacques Allan,25,0,30,5
1649863158870,MATH 170A,A01,083459,Nie; Jiawang,9,0,30,21
1649863158870,MATH 170A,A02,083460,Nie; Jiawang,25,0,30,5
1649863158870,MATH 170A,A03,083461,Nie; Jiawang,26,0,30,4
1649863164892,MATH 193B,A01,083463,Staff,15,0,30,15
1649863164892,MATH 193B,A02,083464,Staff,19,0,30,11
1649863164892,MATH 193B,A03,083465,Staff,27,0,30,3
1649863170942,COGS 2,A01,083966,Boyle; Mary E. T.,27,0,30,3
1649863176969,COGS 9,A01,083968,Staff,56,0,60,4
1649863182995,COGS 14B,A01,083970,Staff,46,0,50,4
1649863189025,COGS 17,A01,092679,Staff,73,0,75,2
1649863195049,COGS 100,A01,083972,Staff,46,0,60,14
1649863207096,COGS 101C,A01,083976,Staff,25,0,30,5
1649863213119,COGS 102A,A01,083978,Johnson; Christine M.,24,0,30,6
1649863219143,COGS 107B,A01,083980,Staff,32,0,50,18
1649863225169,COGS 115,A01,083982,Staff,21,0,30,9
1649863231194,COGS 118B,A01,083367,Staff,4,0,40,36
1649863237223,COGS 172,A01,083984,Provenzano; Emily Kara,20,0,30,10
1649863243247,COGS 177,A00,083368,Staff,2,0,30,28
1649863249273,COGS 186,A01,083986,Staff,25,0,40,15
1649863255298,COGS 187A,A01,083988,Boyle; Mary E. T.,40,0,60,20
1649863261325,CSE 8A,A50,084003,Miranda; Gregory Joseph,9,0,15,6
1649863267349,CSE 11,A01,084005,Miranda; Gregory Joseph,49,0,55,6
1649863273376,CSE 20,A01,084007,Staff,15,0,20,5
1649863279400,CSE 21,A01,084009,Staff,32,0,50,18
1649863285423,CSE 30,A01,083370,Cao; Yingjun,20,0,40,20
1649863291459,CSE 100,A01,083372,Cao; Yingjun,11,0,40,29
1649863297485,CSE 101,A01,084011,Staff,0,16,40,40
1649863303511,CSE 141,A01,083374,Eldon; John,0,15,75,75
1649863309533,CSE 141L,A01,083376,Eldon; John,0,19,75,75
1649863315560,CSE 175,A01,084013,Kumar; Rakesh,24,0,25,1
1649863321587,CSE 190,A00,092508,Staff,15,0,15,0
1649863327617,ECE 5,A01,084049,Morris; Karcher William,17,0,20,3
1649863333640,ECE 100,A01,084051,Baghdadchi; Saharnaz,16,0,20,4
1649863333640,ECE 100,A02,091916,Baghdadchi; Saharnaz,18,0,20,2
1649863339668,ECE 101,A01,084053,Baghdadchi; Saharnaz,25,0,37,12
1649863339668,ECE 101,A02,084054,Baghdadchi; Saharnaz,37,0,37,0
1649863345696,ECE 107,A01,083390,Staff,31,0,40,9
1649863351724,ECE 148,A01,084056,Silberman; Jack,8,0,12,4
1649863357746,ECE 180,A00,083391,Abi Samra; Nicholas Camill,27,0,30,3
1649863357746,ECE 180,B00,083392,Abi Samra; Nicholas Camill,26,0,30,4
1649863363772,MATH 10B,A01,084110,Staff,19,0,30,11
1649863363772,MATH 10B,A02,084111,Staff,29,0,30,1
1649863363772,MATH 10B,A03,084112,Staff,29,0,30,1
1649863369796,MATH 10C,A01,083443,Staff,19,0,30,11
1649863369796,MATH 10C,A02,083444,Staff,24,0,30,6
1649863369796,MATH 10C,B01,084114,Staff,26,0,30,4
1649863369796,MATH 10C,B02,084115,Staff,30,0,30,0
1649863375821,MATH 18,A01,084117,Harel; Guershon,28,0,30,2
1649863375821,MATH 18,A02,084119,Harel; Guershon,29,0,30,1
1649863375821,MATH 18,A03,084120,Harel; Guershon,30,0,30,0
1649863375821,MATH 18,A04,084121,Harel; Guershon,30,0,30,0
1649863381851,MATH 20B,A01,084124,Um; Ko Woon,33,0,35,2
1649863381851,MATH 20B,B01,084126,Um; Ko Woon,35,0,35,0
1649863387878,MATH 20C,A01,083446,Hammock; Frances H,26,0,30,4
1649863387878,MATH 20C,A02,083447,Hammock; Frances H,30,0,30,0
1649863387878,MATH 20C,A03,083448,Hammock; Frances H,30,0,30,0
1649863387878,MATH 20C,A04,083449,Hammock; Frances H,30,0,30,0
1649863387878,MATH 20C,B01,083451,Hammock; Frances H,29,0,30,1
1649863387878,MATH 20C,B02,083452,Hammock; Frances H,30,0,30,0
1649863387878,MATH 20C,B03,083453,Hammock; Frances H,30,0,30,0
1649863387878,MATH 20C,B04,083454,Hammock; Frances H,30,0,30,0
1649863393904,MATH 20D,A01,084128,Staff,29,0,30,1
1649863393904,MATH 20D,A02,084129,Staff,30,0,30,0
1649863393904,MATH 20D,A03,084130,Staff,29,0,30,1
1649863393904,MATH 20D,B01,084133,Staff,28,0,30,2
1649863393904,MATH 20D,B02,084134,Staff,30,0,30,0
1649863393904,MATH 20D,B03,084135,Staff,30,0,30,0
1649863399926,MATH 20E,A01,084138,Staff,27,0,30,3
1649863399926,MATH 20E,A02,084139,Staff,29,0,30,1
1649863399926,MATH 20E,A03,084140,Staff,28,0,30,2
1649863399926,MATH 20E,A04,084141,Staff,30,0,30,0
1649863405950,MATH 102,A01,084143,Harel; Guershon,24,0,30,6
1649863405950,MATH 102,A02,084144,Harel; Guershon,25,0,30,5
1649863411980,MATH 103B,A01,083456,Staff,0,1,30,30
1649863411980,MATH 103B,A02,083457,Staff,16,0,30,14
1649863418004,MATH 109,A01,084146,Salehi Golsefidy; Alireza,29,0,30,1
1649863418004,MATH 109,A02,084147,Salehi Golsefidy; Alireza,26,0,30,4
1649863424028,MATH 120A,A01,085445,Eggers; John Dietrich,29,0,35,6
1649863424028,MATH 120A,A02,085446,Eggers; John Dietrich,31,0,35,4
1649863430055,MATH 142B,A01,084149,Verstraete; Jacques Allan,7,0,30,23
1649863430055,MATH 142B,A02,084150,Verstraete; Jacques Allan,25,0,30,5
1649863436084,MATH 170A,A01,083459,Nie; Jiawang,8,0,30,22
1649863436084,MATH 170A,A02,083460,Nie; Jiawang,25,0,30,5
1649863436084,MATH 170A,A03,083461,Nie; Jiawang,26,0,30,4
1649863442113,MATH 193B,A01,083463,Staff,15,0,30,15
1649863442113,MATH 193B,A02,083464,Staff,19,0,30,11
1649863442113,MATH 193B,A03,083465,Staff,27,0,30,3
1649863448170,COGS 2,A01,083966,Boyle; Mary E. T.,27,0,30,3
1649863454196,COGS 9,A01,083968,Staff,56,0,60,4
1649863460231,COGS 14B,A01,083970,Staff,46,0,50,4
1649863466256,COGS 17,A01,092679,Staff,73,0,75,2
1649863472284,COGS 100,A01,083972,Staff,45,0,60,15
1649863484329,COGS 101C,A01,083976,Staff,24,0,30,6
1649863490360,COGS 102A,A01,083978,Johnson; Christine M.,24,0,30,6
1649863496384,COGS 107B,A01,083980,Staff,32,0,50,18
1649863502417,COGS 115,A01,083982,Staff,20,0,30,10
1649863508442,COGS 118B,A01,083367,Staff,3,0,40,37
1649863514470,COGS 172,A01,083984,Provenzano; Emily Kara,20,0,30,10
1649863520507,COGS 177,A00,083368,Staff,2,0,30,28
1649863526540,COGS 186,A01,083986,Staff,25,0,40,15
1649863532561,COGS 187A,A01,083988,Boyle; Mary E. T.,40,0,60,20
1649863538586,CSE 8A,A50,084003,Miranda; Gregory Joseph,9,0,15,6
1649863544608,CSE 11,A01,084005,Miranda; Gregory Joseph,49,0,55,6
1649863550634,CSE 20,A01,084007,Staff,15,0,20,5
1649863556657,CSE 21,A01,084009,Staff,32,0,50,18
1649863562682,CSE 30,A01,083370,Cao; Yingjun,19,0,40,21
1649863568706,CSE 100,A01,083372,Cao; Yingjun,10,0,40,30
1649863574729,CSE 101,A01,084011,Staff,0,17,40,40
1649863580755,CSE 141,A01,083374,Eldon; John,0,15,75,75
1649863586868,CSE 141L,A01,083376,Eldon; John,0,19,75,75
1649863592891,CSE 175,A01,084013,Kumar; Rakesh,24,0,25,1
1649863598916,CSE 190,A00,092508,Staff,15,0,15,0
1649863604944,ECE 5,A01,084049,Morris; Karcher William,17,0,20,3
1649863610973,ECE 100,A01,084051,Baghdadchi; Saharnaz,16,0,20,4
1649863610973,ECE 100,A02,091916,Baghdadchi; Saharnaz,18,0,20,2
1649863617005,ECE 101,A01,084053,Baghdadchi; Saharnaz,25,0,37,12
1649863617005,ECE 101,A02,084054,Baghdadchi; Saharnaz,37,0,37,0
1649863623032,ECE 107,A01,083390,Staff,31,0,40,9
1649863629059,ECE 148,A01,084056,Silberman; Jack,8,0,12,4
1649863635084,ECE 180,A00,083391,Abi Samra; Nicholas Camill,27,0,30,3
1649863635084,ECE 180,B00,083392,Abi Samra; Nicholas Camill,26,0,30,4
1649863641115,MATH 10B,A01,084110,Staff,19,0,30,11
1649863641115,MATH 10B,A02,084111,Staff,29,0,30,1
1649863641115,MATH 10B,A03,084112,Staff,29,0,30,1
1649863647138,MATH 10C,A01,083443,Staff,19,0,30,11
1649863647138,MATH 10C,A02,083444,Staff,24,0,30,6
1649863647138,MATH 10C,B01,084114,Staff,26,0,30,4
1649863647138,MATH 10C,B02,084115,Staff,30,0,30,0
1649863653160,MATH 18,A01,084117,Harel; Guershon,28,0,30,2
1649863653160,MATH 18,A02,084119,Harel; Guershon,29,0,30,1
1649863653160,MATH 18,A03,084120,Harel; Guershon,30,0,30,0
1649863653160,MATH 18,A04,084121,Harel; Guershon,30,0,30,0
1649863659188,MATH 20B,A01,084124,Um; Ko Woon,33,0,35,2
1649863659188,MATH 20B,B01,084126,Um; Ko Woon,35,0,35,0
1649863665218,MATH 20C,A01,083446,Hammock; Frances H,26,0,30,4
1649863665218,MATH 20C,A02,083447,Hammock; Frances H,30,0,30,0
1649863665218,MATH 20C,A03,083448,Hammock; Frances H,30,0,30,0
1649863665218,MATH 20C,A04,083449,Hammock; Frances H,30,0,30,0
1649863665218,MATH 20C,B01,083451,Hammock; Frances H,29,0,30,1
1649863665218,MATH 20C,B02,083452,Hammock; Frances H,30,0,30,0
1649863665218,MATH 20C,B03,083453,Hammock; Frances H,30,0,30,0
1649863665218,MATH 20C,B04,083454,Hammock; Frances H,30,0,30,0
1649863671247,MATH 20D,A01,084128,Staff,29,0,30,1
1649863671247,MATH 20D,A02,084129,Staff,30,0,30,0
1649863671247,MATH 20D,A03,084130,Staff,29,0,30,1
1649863671247,MATH 20D,B01,084133,Staff,28,0,30,2
1649863671247,MATH 20D,B02,084134,Staff,30,0,30,0
1649863671247,MATH 20D,B03,084135,Staff,30,0,30,0
1649863677269,MATH 20E,A01,084138,Staff,27,0,30,3
1649863677269,MATH 20E,A02,084139,Staff,29,0,30,1
1649863677269,MATH 20E,A03,084140,Staff,28,0,30,2
1649863677269,MATH 20E,A04,084141,Staff,30,0,30,0
1649863683332,MATH 102,A01,084143,Harel; Guershon,24,0,30,6
1649863683332,MATH 102,A02,084144,Harel; Guershon,25,0,30,5
1649863689363,MATH 103B,A01,083456,Staff,0,1,30,30
1649863689363,MATH 103B,A02,083457,Staff,16,0,30,14
1649863695393,MATH 109,A01,084146,Salehi Golsefidy; Alireza,29,0,30,1
1649863695393,MATH 109,A02,084147,Salehi Golsefidy; Alireza,26,0,30,4
1649863701417,MATH 120A,A01,085445,Eggers; John Dietrich,29,0,35,6
1649863701417,MATH 120A,A02,085446,Eggers; John Dietrich,31,0,35,4
1649863707439,MATH 142B,A01,084149,Verstraete; Jacques Allan,7,0,30,23
1649863707439,MATH 142B,A02,084150,Verstraete; Jacques Allan,25,0,30,5
1649863713469,MATH 170A,A01,083459,Nie; Jiawang,8,0,30,22
1649863713469,MATH 170A,A02,083460,Nie; Jiawang,25,0,30,5
1649863713469,MATH 170A,A03,083461,Nie; Jiawang,26,0,30,4
1649863719495,MATH 193B,A01,083463,Staff,15,0,30,15
1649863719495,MATH 193B,A02,083464,Staff,19,0,30,11
1649863719495,MATH 193B,A03,083465,Staff,27,0,30,3
1649863725544,COGS 2,A01,083966,Boyle; Mary E. T.,27,0,30,3
1649863731569,COGS 9,A01,083968,Staff,56,0,60,4
1649863737592,COGS 14B,A01,083970,Staff,46,0,50,4
1649863743615,COGS 17,A01,092679,Staff,73,0,75,2
1649863749651,COGS 100,A01,083972,Staff,45,0,60,15
1649863761697,COGS 101C,A01,083976,Staff,24,0,30,6
1649863767724,COGS 102A,A01,083978,Johnson; Christine M.,24,0,30,6
1649863773747,COGS 107B,A01,083980,Staff,32,0,50,18
1649863779770,COGS 115,A01,083982,Staff,20,0,30,10
1649863785792,COGS 118B,A01,083367,Staff,2,0,40,38
1649863791821,COGS 172,A01,083984,Provenzano; Emily Kara,20,0,30,10
1649863797844,COGS 177,A00,083368,Staff,2,0,30,28
1649863803873,COGS 186,A01,083986,Staff,25,0,40,15
1649863809902,COGS 187A,A01,083988,Boyle; Mary E. T.,39,0,60,21
1649863815928,CSE 8A,A50,084003,Miranda; Gregory Joseph,9,0,15,6
1649863821952,CSE 11,A01,084005,Miranda; Gregory Joseph,49,0,55,6
1649863827979,CSE 20,A01,084007,Staff,15,0,20,5
1649863834003,CSE 21,A01,084009,Staff,32,0,50,18
1649863840026,CSE 30,A01,083370,Cao; Yingjun,19,0,40,21
1649863846054,CSE 100,A01,083372,Cao; Yingjun,10,0,40,30
1649863852078,CSE 101,A01,084011,Staff,0,17,40,40
1649863858107,CSE 141,A01,083374,Eldon; John,0,15,75,75
1649863864135,CSE 141L,A01,083376,Eldon; John,0,19,75,75
1649863870161,CSE 175,A01,084013,Kumar; Rakesh,24,0,25,1
1649863876184,CSE 190,A00,092508,Staff,15,0,15,0
1649863882206,ECE 5,A01,084049,Morris; Karcher William,17,0,20,3
1649863888242,ECE 100,A01,084051,Baghdadchi; Saharnaz,16,0,20,4
1649863888242,ECE 100,A02,091916,Baghdadchi; Saharnaz,18,0,20,2
1649863894268,ECE 101,A01,084053,Baghdadchi; Saharnaz,25,0,37,12
1649863894268,ECE 101,A02,084054,Baghdadchi; Saharnaz,37,0,37,0
1649863900290,ECE 107,A01,083390,Staff,31,0,40,9
1649863906325,ECE 148,A01,084056,Silberman; Jack,8,0,12,4
1649863912356,ECE 180,A00,083391,Abi Samra; Nicholas Camill,27,0,30,3
1649863912356,ECE 180,B00,083392,Abi Samra; Nicholas Camill,26,0,30,4
1649863918380,MATH 10B,A01,084110,Staff,19,0,30,11
1649863918380,MATH 10B,A02,084111,Staff,29,0,30,1
1649863918380,MATH 10B,A03,084112,Staff,29,0,30,1
1649863924403,MATH 10C,A01,083443,Staff,19,0,30,11
1649863924403,MATH 10C,A02,083444,Staff,24,0,30,6
1649863924403,MATH 10C,B01,084114,Staff,26,0,30,4
1649863924403,MATH 10C,B02,084115,Staff,30,0,30,0
1649863930427,MATH 18,A01,084117,Harel; Guershon,28,0,30,2
1649863930427,MATH 18,A02,084119,Harel; Guershon,29,0,30,1
1649863930427,MATH 18,A03,084120,Harel; Guershon,30,0,30,0
1649863930427,MATH 18,A04,084121,Harel; Guershon,30,0,30,0
1649863936452,MATH 20B,A01,084124,Um; Ko Woon,33,0,35,2
1649863936452,MATH 20B,B01,084126,Um; Ko Woon,35,0,35,0
1649863942477,MATH 20C,A01,083446,Hammock; Frances H,26,0,30,4
1649863942477,MATH 20C,A02,083447,Hammock; Frances H,30,0,30,0
1649863942477,MATH 20C,A03,083448,Hammock; Frances H,30,0,30,0
1649863942477,MATH 20C,A04,083449,Hammock; Frances H,30,0,30,0
1649863942477,MATH 20C,B01,083451,Hammock; Frances H,29,0,30,1
1649863942477,MATH 20C,B02,083452,Hammock; Frances H,30,0,30,0
1649863942477,MATH 20C,B03,083453,Hammock; Frances H,30,0,30,0
1649863942477,MATH 20C,B04,083454,Hammock; Frances H,30,0,30,0
1649863948507,MATH 20D,A01,084128,Staff,29,0,30,1
1649863948507,MATH 20D,A02,084129,Staff,30,0,30,0
1649863948507,MATH 20D,A03,084130,Staff,29,0,30,1
1649863948507,MATH 20D,B01,084133,Staff,28,0,30,2
1649863948507,MATH 20D,B02,084134,Staff,30,0,30,0
1649863948507,MATH 20D,B03,084135,Staff,30,0,30,0
1649863954534,MATH 20E,A01,084138,Staff,27,0,30,3
1649863954534,MATH 20E,A02,084139,Staff,29,0,30,1
1649863954534,MATH 20E,A03,084140,Staff,28,0,30,2
1649863954534,MATH 20E,A04,084141,Staff,30,0,30,0
1649863960556,MATH 102,A01,084143,Harel; Guershon,24,0,30,6
1649863960556,MATH 102,A02,084144,Harel; Guershon,25,0,30,5
1649863966600,MATH 103B,A01,083456,Staff,0,1,30,30
1649863966600,MATH 103B,A02,083457,Staff,15,0,30,15
1649863972623,MATH 109,A01,084146,Salehi Golsefidy; Alireza,29,0,30,1
1649863972623,MATH 109,A02,084147,Salehi Golsefidy; Alireza,26,0,30,4
1649863978647,MATH 120A,A01,085445,Eggers; John Dietrich,29,0,35,6
1649863978647,MATH 120A,A02,085446,Eggers; John Dietrich,31,0,35,4
1649863984669,MATH 142B,A01,084149,Verstraete; Jacques Allan,6,0,30,24
1649863984669,MATH 142B,A02,084150,Verstraete; Jacques Allan,25,0,30,5
1649863990697,MATH 170A,A01,083459,Nie; Jiawang,7,0,30,23
1649863990697,MATH 170A,A02,083460,Nie; Jiawang,25,0,30,5
1649863990697,MATH 170A,A03,083461,Nie; Jiawang,26,0,30,4
1649863996724,MATH 193B,A01,083463,Staff,15,0,30,15
1649863996724,MATH 193B,A02,083464,Staff,19,0,30,11
1649863996724,MATH 193B,A03,083465,Staff,26,0,30,4
1649864002803,COGS 2,A01,083966,Boyle; Mary E. T.,27,0,30,3
1649864008843,COGS 9,A01,083968,Staff,56,0,60,4
1649864014870,COGS 14B,A01,083970,Staff,46,0,50,4
1649864020905,COGS 17,A01,092679,Staff,73,0,75,2
1649864026932,COGS 100,A01,083972,Staff,45,0,60,15
1649864038979,COGS 101C,A01,083976,Staff,24,0,30,6
1649864045007,COGS 102A,A01,083978,Johnson; Christine M.,24,0,30,6
1649864051032,COGS 107B,A01,083980,Staff,32,0,50,18
1649864057060,COGS 115,A01,083982,Staff,20,0,30,10
1649864063083,COGS 118B,A01,083367,Staff,2,0,40,38
1649864069109,COGS 172,A01,083984,Provenzano; Emily Kara,20,0,30,10
1649864075133,COGS 177,A00,083368,Staff,2,0,30,28
1649864081166,COGS 186,A01,083986,Staff,25,0,40,15
1649864087189,COGS 187A,A01,083988,Boyle; Mary E. T.,39,0,60,21
1649864093211,CSE 8A,A50,084003,Miranda; Gregory Joseph,9,0,15,6
1649864099235,CSE 11,A01,084005,Miranda; Gregory Joseph,49,0,55,6
1649864105258,CSE 20,A01,084007,Staff,15,0,20,5
1649864111282,CSE 21,A01,084009,Staff,32,0,50,18
1649864117313,CSE 30,A01,083370,Cao; Yingjun,19,0,40,21
1649864123336,CSE 100,A01,083372,Cao; Yingjun,10,0,40,30
1649864129363,CSE 101,A01,084011,Staff,0,18,40,40
1649864135389,CSE 141,A01,083374,Eldon; John,0,16,75,75
1649864141411,CSE 141L,A01,083376,Eldon; John,0,21,75,75
1649864147437,CSE 175,A01,084013,Kumar; Rakesh,24,0,25,1
1649864153464,CSE 190,A00,092508,Staff,15,0,15,0
1649864159490,ECE 5,A01,084049,Morris; Karcher William,17,0,20,3
1649864165514,ECE 100,A01,084051,Baghdadchi; Saharnaz,16,0,20,4
1649864165514,ECE 100,A02,091916,Baghdadchi; Saharnaz,18,0,20,2
1649864171545,ECE 101,A01,084053,Baghdadchi; Saharnaz,25,0,37,12
1649864171545,ECE 101,A02,084054,Baghdadchi; Saharnaz,37,0,37,0
1649864177657,ECE 107,A01,083390,Staff,31,0,40,9
1649864183681,ECE 148,A01,084056,Silberman; Jack,8,0,12,4
1649864189704,ECE 180,A00,083391,Abi Samra; Nicholas Camill,27,0,30,3
1649864189704,ECE 180,B00,083392,Abi Samra; Nicholas Camill,26,0,30,4
1649864195731,MATH 10B,A01,084110,Staff,19,0,30,11
1649864195731,MATH 10B,A02,084111,Staff,29,0,30,1
1649864195731,MATH 10B,A03,084112,Staff,29,0,30,1
1649864201760,MATH 10C,A01,083443,Staff,19,0,30,11
1649864201760,MATH 10C,A02,083444,Staff,24,0,30,6
1649864201760,MATH 10C,B01,084114,Staff,26,0,30,4
1649864201760,MATH 10C,B02,084115,Staff,30,0,30,0
1649864207787,MATH 18,A01,084117,Harel; Guershon,28,0,30,2
1649864207787,MATH 18,A02,084119,Harel; Guershon,29,0,30,1
1649864207787,MATH 18,A03,084120,Harel; Guershon,30,0,30,0
1649864207787,MATH 18,A04,084121,Harel; Guershon,30,0,30,0
1649864213817,MATH 20B,A01,084124,Um; Ko Woon,33,0,35,2
1649864213817,MATH 20B,B01,084126,Um; Ko Woon,35,0,35,0
1649864219841,MATH 20C,A01,083446,Hammock; Frances H,26,0,30,4
1649864219841,MATH 20C,A02,083447,Hammock; Frances H,30,0,30,0
1649864219841,MATH 20C,A03,083448,Hammock; Frances H,30,0,30,0
1649864219841,MATH 20C,A04,083449,Hammock; Frances H,30,0,30,0
1649864219841,MATH 20C,B01,083451,Hammock; Frances H,29,0,30,1
1649864219841,MATH 20C,B02,083452,Hammock; Frances H,30,0,30,0
1649864219841,MATH 20C,B03,083453,Hammock; Frances H,30,0,30,0
1649864219841,MATH 20C,B04,083454,Hammock; Frances H,30,0,30,0
1649864225867,MATH 20D,A01,084128,Staff,29,0,30,1
1649864225867,MATH 20D,A02,084129,Staff,30,0,30,0
1649864225867,MATH 20D,A03,084130,Staff,29,0,30,1
1649864225867,MATH 20D,B01,084133,Staff,28,0,30,2
1649864225867,MATH 20D,B02,084134,Staff,30,0,30,0
1649864225867,MATH 20D,B03,084135,Staff,30,0,30,0
1649864231893,MATH 20E,A01,084138,Staff,27,0,30,3
1649864231893,MATH 20E,A02,084139,Staff,29,0,30,1
1649864231893,MATH 20E,A03,084140,Staff,28,0,30,2
1649864231893,MATH 20E,A04,084141,Staff,30,0,30,0
1649864237916,MATH 102,A01,084143,Harel; Guershon,24,0,30,6
1649864237916,MATH 102,A02,084144,Harel; Guershon,25,0,30,5
1649864243939,MATH 103B,A01,083456,Staff,0,1,30,30
1649864243939,MATH 103B,A02,083457,Staff,15,0,30,15
1649864249978,MATH 109,A01,084146,Salehi Golsefidy; Alireza,29,0,30,1
1649864249978,MATH 109,A02,084147,Salehi Golsefidy; Alireza,26,0,30,4
1649864256002,MATH 120A,A01,085445,Eggers; John Dietrich,29,0,35,6
1649864256002,MATH 120A,A02,085446,Eggers; John Dietrich,31,0,35,4
1649864262025,MATH 142B,A01,084149,Verstraete; Jacques Allan,5,0,30,25
1649864262025,MATH 142B,A02,084150,Verstraete; Jacques Allan,25,0,30,5
1649864268054,MATH 170A,A01,083459,Nie; Jiawang,7,0,30,23
1649864268054,MATH 170A,A02,083460,Nie; Jiawang,25,0,30,5
1649864268054,MATH 170A,A03,083461,Nie; Jiawang,26,0,30,4
1649864274078,MATH 193B,A01,083463,Staff,15,0,30,15
1649864274078,MATH 193B,A02,083464,Staff,19,0,30,11
1649864274078,MATH 193B,A03,083465,Staff,26,0,30,4
1649864280136,COGS 2,A01,083966,Boyle; Mary E. T.,27,0,30,3
1649864286163,COGS 9,A01,083968,Staff,56,0,60,4
1649864292189,COGS 14B,A01,083970,Staff,46,0,50,4
1649864298212,COGS 17,A01,092679,Staff,73,0,75,2
1649864304237,COGS 100,A01,083972,Staff,45,0,60,15
1649864316284,COGS 101C,A01,083976,Staff,24,0,30,6
1649864322310,COGS 102A,A01,083978,Johnson; Christine M.,24,0,30,6
1649864328333,COGS 107B,A01,083980,Staff,32,0,50,18
1649864334359,COGS 115,A01,083982,Staff,20,0,30,10
1649864340381,COGS 118B,A01,083367,Staff,2,0,40,38
1649864346409,COGS 172,A01,083984,Provenzano; Emily Kara,20,0,30,10
1649864352433,COGS 177,A00,083368,Staff,2,0,30,28
1649864358455,COGS 186,A01,083986,Staff,25,0,40,15
1649864364489,COGS 187A,A01,083988,Boyle; Mary E. T.,39,0,60,21
1649864370522,CSE 8A,A50,084003,Miranda; Gregory Joseph,9,0,15,6
1649864376550,CSE 11,A01,084005,Miranda; Gregory Joseph,49,0,55,6
1649864382576,CSE 20,A01,084007,Staff,15,0,20,5
1649864388598,CSE 21,A01,084009,Staff,32,0,50,18
1649864394621,CSE 30,A01,083370,Cao; Yingjun,19,0,40,21
1649864400656,CSE 100,A01,083372,Cao; Yingjun,10,0,40,30
1649864406678,CSE 101,A01,084011,Staff,0,18,40,40
1649864412708,CSE 141,A01,083374,Eldon; John,0,16,75,75
1649864418730,CSE 141L,A01,083376,Eldon; John,0,21,75,75
1649864424757,CSE 175,A01,084013,Kumar; Rakesh,24,0,25,1
1649864430784,CSE 190,A00,092508,Staff,15,0,15,0
1649864436806,ECE 5,A01,084049,Morris; Karcher William,17,0,20,3
1649864442846,ECE 100,A01,084051,Baghdadchi; Saharnaz,16,0,20,4
1649864442846,ECE 100,A02,091916,Baghdadchi; Saharnaz,18,0,20,2
1649864448868,ECE 101,A01,084053,Baghdadchi; Saharnaz,25,0,37,12
1649864448868,ECE 101,A02,084054,Baghdadchi; Saharnaz,37,0,37,0
1649864454893,ECE 107,A01,083390,Staff,31,0,40,9
1649864460919,ECE 148,A01,084056,Silberman; Jack,8,0,12,4
1649864466953,ECE 180,A00,083391,Abi Samra; Nicholas Camill,27,0,30,3
1649864466953,ECE 180,B00,083392,Abi Samra; Nicholas Camill,26,0,30,4
1649864472979,MATH 10B,A01,084110,Staff,19,0,30,11
1649864472979,MATH 10B,A02,084111,Staff,29,0,30,1
1649864472979,MATH 10B,A03,084112,Staff,29,0,30,1
1649864479007,MATH 10C,A01,083443,Staff,19,0,30,11
1649864479007,MATH 10C,A02,083444,Staff,24,0,30,6
1649864479007,MATH 10C,B01,084114,Staff,26,0,30,4
1649864479007,MATH 10C,B02,084115,Staff,30,0,30,0
1649864485030,MATH 18,A01,084117,Harel; Guershon,28,0,30,2
1649864485030,MATH 18,A02,084119,Harel; Guershon,29,0,30,1
1649864485030,MATH 18,A03,084120,Harel; Guershon,30,0,30,0
1649864485030,MATH 18,A04,084121,Harel; Guershon,30,0,30,0
1649864491067,MATH 20B,A01,084124,Um; Ko Woon,33,0,35,2
1649864491067,MATH 20B,B01,084126,Um; Ko Woon,35,0,35,0
1649864497091,MATH 20C,A01,083446,Hammock; Frances H,26,0,30,4
1649864497091,MATH 20C,A02,083447,Hammock; Frances H,30,0,30,0
1649864497091,MATH 20C,A03,083448,Hammock; Frances H,30,0,30,0
1649864497091,MATH 20C,A04,083449,Hammock; Frances H,30,0,30,0
1649864497091,MATH 20C,B01,083451,Hammock; Frances H,29,0,30,1
1649864497091,MATH 20C,B02,083452,Hammock; Frances H,30,0,30,0
1649864497091,MATH 20C,B03,083453,Hammock; Frances H,30,0,30,0
1649864497091,MATH 20C,B04,083454,Hammock; Frances H,30,0,30,0
1649864503114,MATH 20D,A01,084128,Staff,29,0,30,1
1649864503114,MATH 20D,A02,084129,Staff,30,0,30,0
1649864503114,MATH 20D,A03,084130,Staff,29,0,30,1
1649864503114,MATH 20D,B01,084133,Staff,28,0,30,2
1649864503114,MATH 20D,B02,084134,Staff,30,0,30,0
1649864503114,MATH 20D,B03,084135,Staff,30,0,30,0
1649864509141,MATH 20E,A01,084138,Staff,27,0,30,3
1649864509141,MATH 20E,A02,084139,Staff,29,0,30,1
1649864509141,MATH 20E,A03,084140,Staff,28,0,30,2
1649864509141,MATH 20E,A04,084141,Staff,30,0,30,0
1649864515165,MATH 102,A01,084143,Harel; Guershon,24,0,30,6
1649864515165,MATH 102,A02,084144,Harel; Guershon,25,0,30,5
1649864521189,MATH 103B,A01,083456,Staff,0,1,30,30
1649864521189,MATH 103B,A02,083457,Staff,15,0,30,15
1649864527221,MATH 109,A01,084146,Salehi Golsefidy; Alireza,29,0,30,1
1649864527221,MATH 109,A02,084147,Salehi Golsefidy; Alireza,26,0,30,4
1649864533246,MATH 120A,A01,085445,Eggers; John Dietrich,28,0,35,7
1649864533246,MATH 120A,A02,085446,Eggers; John Dietrich,31,0,35,4
1649864539269,MATH 142B,A01,084149,Verstraete; Jacques Allan,5,0,30,25
1649864539269,MATH 142B,A02,084150,Verstraete; Jacques Allan,24,0,30,6
1649864545296,MATH 170A,A01,083459,Nie; Jiawang,7,0,30,23
1649864545296,MATH 170A,A02,083460,Nie; Jiawang,25,0,30,5
1649864545296,MATH 170A,A03,083461,Nie; Jiawang,25,0,30,5
1649864551319,MATH 193B,A01,083463,Staff,15,0,30,15
1649864551319,MATH 193B,A02,083464,Staff,19,0,30,11
1649864551319,MATH 193B,A03,083465,Staff,26,0,30,4
1649864557382,COGS 2,A01,083966,Boyle; Mary E. T.,27,0,30,3
1649864563405,COGS 9,A01,083968,Staff,56,0,60,4
1649864569432,COGS 14B,A01,083970,Staff,46,0,50,4
1649864575469,COGS 17,A01,092679,Staff,73,0,75,2
1649864581500,COGS 100,A01,083972,Staff,45,0,60,15
1649864593546,COGS 101C,A01,083976,Staff,24,0,30,6
1649864599581,COGS 102A,A01,083978,Johnson; Christine M.,24,0,30,6
1649864605604,COGS 107B,A01,083980,Staff,32,0,50,18
1649864611630,COGS 115,A01,083982,Staff,20,0,30,10
1649864617656,COGS 118B,A01,083367,Staff,2,0,40,38
1649864623678,COGS 172,A01,083984,Provenzano; Emily Kara,20,0,30,10
1649864629702,COGS 177,A00,083368,Staff,2,0,30,28
1649864635727,COGS 186,A01,083986,Staff,25,0,40,15
1649864641767,COGS 187A,A01,083988,Boyle; Mary E. T.,39,0,60,21
1649864647789,CSE 8A,A50,084003,Miranda; Gregory Joseph,9,0,15,6
1649864653818,CSE 11,A01,084005,Miranda; Gregory Joseph,49,0,55,6
1649864659840,CSE 20,A01,084007,Staff,15,0,20,5
1649864665869,CSE 21,A01,084009,Staff,32,0,50,18
1649864671891,CSE 30,A01,083370,Cao; Yingjun,19,0,40,21
1649864677922,CSE 100,A01,083372,Cao; Yingjun,10,0,40,30
1649864683945,CSE 101,A01,084011,Staff,0,19,40,40
1649864689967,CSE 141,A01,083374,Eldon; John,0,17,75,75
1649864696006,CSE 141L,A01,083376,Eldon; John,0,22,75,75
1649864702032,CSE 175,A01,084013,Kumar; Rakesh,24,0,25,1
1649864708056,CSE 190,A00,092508,Staff,15,0,15,0
1649864714085,ECE 5,A01,084049,Morris; Karcher William,17,0,20,3
1649864720107,ECE 100,A01,084051,Baghdadchi; Saharnaz,16,0,20,4
1649864720107,ECE 100,A02,091916,Baghdadchi; Saharnaz,18,0,20,2
1649864726130,ECE 101,A01,084053,Baghdadchi; Saharnaz,25,0,37,12
1649864726130,ECE 101,A02,084054,Baghdadchi; Saharnaz,37,0,37,0
1649864732177,ECE 107,A01,083390,Staff,31,0,40,9
1649864738199,ECE 148,A01,084056,Silberman; Jack,8,0,12,4
1649864744226,ECE 180,A00,083391,Abi Samra; Nicholas Camill,27,0,30,3
1649864744226,ECE 180,B00,083392,Abi Samra; Nicholas Camill,26,0,30,4
1649864750257,MATH 10B,A01,084110,Staff,19,0,30,11
1649864750257,MATH 10B,A02,084111,Staff,29,0,30,1
1649864750257,MATH 10B,A03,084112,Staff,29,0,30,1
1649864756288,MATH 10C,A01,083443,Staff,19,0,30,11
1649864756288,MATH 10C,A02,083444,Staff,24,0,30,6
1649864756288,MATH 10C,B01,084114,Staff,26,0,30,4
1649864756288,MATH 10C,B02,084115,Staff,30,0,30,0
1649864762318,MATH 18,A01,084117,Harel; Guershon,28,0,30,2
1649864762318,MATH 18,A02,084119,Harel; Guershon,29,0,30,1
1649864762318,MATH 18,A03,084120,Harel; Guershon,30,0,30,0
1649864762318,MATH 18,A04,084121,Harel; Guershon,30,0,30,0
1649864768353,MATH 20B,A01,084124,Um; Ko Woon,33,0,35,2
1649864768353,MATH 20B,B01,084126,Um; Ko Woon,35,0,35,0
1649864774469,MATH 20C,A01,083446,Hammock; Frances H,26,0,30,4
1649864774469,MATH 20C,A02,083447,Hammock; Frances H,30,0,30,0
1649864774469,MATH 20C,A03,083448,Hammock; Frances H,30,0,30,0
1649864774469,MATH 20C,A04,083449,Hammock; Frances H,30,0,30,0
1649864774469,MATH 20C,B01,083451,Hammock; Frances H,29,0,30,1
1649864774469,MATH 20C,B02,083452,Hammock; Frances H,30,0,30,0
1649864774469,MATH 20C,B03,083453,Hammock; Frances H,30,0,30,0
1649864774469,MATH 20C,B04,083454,Hammock; Frances H,30,0,30,0
1649864780500,MATH 20D,A01,084128,Staff,29,0,30,1
1649864780500,MATH 20D,A02,084129,Staff,30,0,30,0
1649864780500,MATH 20D,A03,084130,Staff,29,0,30,1
1649864780500,MATH 20D,B01,084133,Staff,28,0,30,2
1649864780500,MATH 20D,B02,084134,Staff,30,0,30,0
1649864780500,MATH 20D,B03,084135,Staff,30,0,30,0
1649864786525,MATH 20E,A01,084138,Staff,27,0,30,3
1649864786525,MATH 20E,A02,084139,Staff,29,0,30,1
1649864786525,MATH 20E,A03,084140,Staff,28,0,30,2
1649864786525,MATH 20E,A04,084141,Staff,30,0,30,0
1649864792548,MATH 102,A01,084143,Harel; Guershon,24,0,30,6
1649864792548,MATH 102,A02,084144,Harel; Guershon,25,0,30,5
1649864798571,MATH 103B,A01,083456,Staff,0,2,30,30
1649864798571,MATH 103B,A02,083457,Staff,15,0,30,15
1649864804598,MATH 109,A01,084146,Salehi Golsefidy; Alireza,29,0,30,1
1649864804598,MATH 109,A02,084147,Salehi Golsefidy; Alireza,26,0,30,4
1649864810620,MATH 120A,A01,085445,Eggers; John Dietrich,28,0,35,7
1649864810620,MATH 120A,A02,085446,Eggers; John Dietrich,31,0,35,4
1649864816648,MATH 142B,A01,084149,Verstraete; Jacques Allan,5,0,30,25
1649864816648,MATH 142B,A02,084150,Verstraete; Jacques Allan,23,0,30,7
1649864822671,MATH 170A,A01,083459,Nie; Jiawang,7,0,30,23
1649864822671,MATH 170A,A02,083460,Nie; Jiawang,25,0,30,5
1649864822671,MATH 170A,A03,083461,Nie; Jiawang,25,0,30,5
1649864828697,MATH 193B,A01,083463,Staff,14,0,30,16
1649864828697,MATH 193B,A02,083464,Staff,19,0,30,11
1649864828697,MATH 193B,A03,083465,Staff,26,0,30,4
1649864834753,COGS 2,A01,083966,Boyle; Mary E. T.,27,0,30,3
1649864840774,COGS 9,A01,083968,Staff,56,0,60,4
1649864846797,COGS 14B,A01,083970,Staff,46,0,50,4
1649864852820,COGS 17,A01,092679,Staff,73,0,75,2
1649864858845,COGS 100,A01,083972,Staff,45,0,60,15
1649864870898,COGS 101C,A01,083976,Staff,24,0,30,6
1649864876919,COGS 102A,A01,083978,Johnson; Christine M.,24,0,30,6
1649864882944,COGS 107B,A01,083980,Staff,32,0,50,18
1649864888965,COGS 115,A01,083982,Staff,20,0,30,10
1649864894997,COGS 118B,A01,083367,Staff,2,0,40,38
1649864901023,COGS 172,A01,083984,Provenzano; Emily Kara,20,0,30,10
1649864907049,COGS 177,A00,083368,Staff,2,0,30,28
1649864913088,COGS 186,A01,083986,Staff,25,0,40,15
1649864919115,COGS 187A,A01,083988,Boyle; Mary E. T.,39,0,60,21
1649864925139,CSE 8A,A50,084003,Miranda; Gregory Joseph,9,0,15,6
1649864931164,CSE 11,A01,084005,Miranda; Gregory Joseph,49,0,55,6
1649864937238,CSE 20,A01,084007,Staff,15,0,20,5
1649864943263,CSE 21,A01,084009,Staff,32,0,50,18
1649864949285,CSE 30,A01,083370,Cao; Yingjun,19,0,40,21
1649864955308,CSE 100,A01,083372,Cao; Yingjun,10,0,40,30
1649864961332,CSE 101,A01,084011,Staff,0,19,40,40
1649864967361,CSE 141,A01,083374,Eldon; John,0,17,75,75
1649864973382,CSE 141L,A01,083376,Eldon; John,0,22,75,75
1649864979415,CSE 175,A01,084013,Kumar; Rakesh,24,0,25,1
1649864985451,CSE 190,A00,092508,Staff,15,0,15,0
1649864991476,ECE 5,A01,084049,Morris; Karcher William,17,0,20,3
1649864997522,ECE 100,A01,084051,Baghdadchi; Saharnaz,16,0,20,4
1649864997522,ECE 100,A02,091916,Baghdadchi; Saharnaz,18,0,20,2
1649865003552,ECE 101,A01,084053,Baghdadchi; Saharnaz,25,0,37,12
1649865003552,ECE 101,A02,084054,Baghdadchi; Saharnaz,37,0,37,0
1649865009582,ECE 107,A01,083390,Staff,31,0,40,9
1649865015605,ECE 148,A01,084056,Silberman; Jack,8,0,12,4
1649865021633,ECE 180,A00,083391,Abi Samra; Nicholas Camill,27,0,30,3
1649865021633,ECE 180,B00,083392,Abi Samra; Nicholas Camill,26,0,30,4
1649865027656,MATH 10B,A01,084110,Staff,19,0,30,11
1649865027656,MATH 10B,A02,084111,Staff,29,0,30,1
1649865027656,MATH 10B,A03,084112,Staff,29,0,30,1
1649865033694,MATH 10C,A01,083443,Staff,19,0,30,11
1649865033694,MATH 10C,A02,083444,Staff,24,0,30,6
1649865033694,MATH 10C,B01,084114,Staff,26,0,30,4
1649865033694,MATH 10C,B02,084115,Staff,30,0,30,0
1649865039722,MATH 18,A01,084117,Harel; Guershon,28,0,30,2
1649865039722,MATH 18,A02,084119,Harel; Guershon,29,0,30,1
1649865039722,MATH 18,A03,084120,Harel; Guershon,30,0,30,0
1649865039722,MATH 18,A04,084121,Harel; Guershon,30,0,30,0
1649865045746,MATH 20B,A01,084124,Um; Ko Woon,33,0,35,2
1649865045746,MATH 20B,B01,084126,Um; Ko Woon,35,0,35,0
1649865051780,MATH 20C,A01,083446,Hammock; Frances H,26,0,30,4
1649865051780,MATH 20C,A02,083447,Hammock; Frances H,30,0,30,0
1649865051780,MATH 20C,A03,083448,Hammock; Frances H,30,0,30,0
1649865051780,MATH 20C,A04,083449,Hammock; Frances H,30,0,30,0
1649865051780,MATH 20C,B01,083451,Hammock; Frances H,29,0,30,1
1649865051780,MATH 20C,B02,083452,Hammock; Frances H,30,0,30,0
1649865051780,MATH 20C,B03,083453,Hammock; Frances H,30,0,30,0
1649865051780,MATH 20C,B04,083454,Hammock; Frances H,30,0,30,0
1649865057804,MATH 20D,A01,084128,Staff,29,0,30,1
1649865057804,MATH 20D,A02,084129,Staff,30,0,30,0
1649865057804,MATH 20D,A03,084130,Staff,29,0,30,1
1649865057804,MATH 20D,B01,084133,Staff,28,0,30,2
1649865057804,MATH 20D,B02,084134,Staff,30,0,30,0
1649865057804,MATH 20D,B03,084135,Staff,30,0,30,0
1649865063827,MATH 20E,A01,084138,Staff,27,0,30,3
1649865063827,MATH 20E,A02,084139,Staff,29,0,30,1
1649865063827,MATH 20E,A03,084140,Staff,28,0,30,2
1649865063827,MATH 20E,A04,084141,Staff,30,0,30,0
1649865069852,MATH 102,A01,084143,Harel; Guershon,24,0,30,6
1649865069852,MATH 102,A02,084144,Harel; Guershon,25,0,30,5
1649865075880,MATH 103B,A01,083456,Staff,0,2,30,30
1649865075880,MATH 103B,A02,083457,Staff,15,0,30,15
1649865081918,MATH 109,A01,084146,Salehi Golsefidy; Alireza,29,0,30,1
1649865081918,MATH 109,A02,084147,Salehi Golsefidy; Alireza,26,0,30,4
1649865087941,MATH 120A,A01,085445,Eggers; John Dietrich,28,0,35,7
1649865087941,MATH 120A,A02,085446,Eggers; John Dietrich,31,0,35,4
1649865093983,MATH 142B,A01,084149,Verstraete; Jacques Allan,5,0,30,25
1649865093983,MATH 142B,A02,084150,Verstraete; Jacques Allan,23,0,30,7
1649865100017,MATH 170A,A01,083459,Nie; Jiawang,7,0,30,23
1649865100017,MATH 170A,A02,083460,Nie; Jiawang,25,0,30,5
1649865100017,MATH 170A,A03,083461,Nie; Jiawang,25,0,30,5
1649865106043,MATH 193B,A01,083463,Staff,14,0,30,16
1649865106043,MATH 193B,A02,083464,Staff,19,0,30,11
1649865106043,MATH 193B,A03,083465,Staff,26,0,30,4
1649865112111,COGS 2,A01,083966,Boyle; Mary E. T.,27,0,30,3
1649865118138,COGS 9,A01,083968,Staff,56,0,60,4
1649865124170,COGS 14B,A01,083970,Staff,46,0,50,4
1649865130196,COGS 17,A01,092679,Staff,73,0,75,2
1649865136223,COGS 100,A01,083972,Staff,45,0,60,15
1649865148284,COGS 101C,A01,083976,Staff,24,0,30,6
1649865154306,COGS 102A,A01,083978,Johnson; Christine M.,24,0,30,6
1649865160332,COGS 107B,A01,083980,Staff,32,0,50,18
1649865166377,COGS 115,A01,083982,Staff,20,0,30,10
1649865172400,COGS 118B,A01,083367,Staff,2,0,40,38
1649865178423,COGS 172,A01,083984,Provenzano; Emily Kara,20,0,30,10
1649865184450,COGS 177,A00,083368,Staff,2,0,30,28
1649865190484,COGS 186,A01,083986,Staff,25,0,40,15
1649865196514,COGS 187A,A01,083988,Boyle; Mary E. T.,39,0,60,21
1649865202539,CSE 8A,A50,084003,Miranda; Gregory Joseph,9,0,15,6
1649865208571,CSE 11,A01,084005,Miranda; Gregory Joseph,49,0,55,6
1649865214604,CSE 20,A01,084007,Staff,15,0,20,5
1649865220630,CSE 21,A01,084009,Staff,32,0,50,18
1649865226654,CSE 30,A01,083370,Cao; Yingjun,19,0,40,21
1649865232680,CSE 100,A01,083372,Cao; Yingjun,10,0,40,30
1649865238703,CSE 101,A01,084011,Staff,0,19,40,40
1649865244727,CSE 141,A01,083374,Eldon; John,0,18,75,75
1649865250768,CSE 141L,A01,083376,Eldon; John,0,23,75,75
1649865256796,CSE 175,A01,084013,Kumar; Rakesh,23,0,25,2
1649865262819,CSE 190,A00,092508,Staff,15,0,15,0
1649865268863,ECE 5,A01,084049,Morris; Karcher William,17,0,20,3
1649865274888,ECE 100,A01,084051,Baghdadchi; Saharnaz,16,0,20,4
1649865274888,ECE 100,A02,091916,Baghdadchi; Saharnaz,18,0,20,2
1649865280915,ECE 101,A01,084053,Baghdadchi; Saharnaz,25,0,37,12
1649865280915,ECE 101,A02,084054,Baghdadchi; Saharnaz,37,0,37,0
1649865286938,ECE 107,A01,083390,Staff,31,0,40,9
1649865292960,ECE 148,A01,084056,Silberman; Jack,8,0,12,4
1649865298983,ECE 180,A00,083391,Abi Samra; Nicholas Camill,27,0,30,3
1649865298983,ECE 180,B00,083392,Abi Samra; Nicholas Camill,26,0,30,4
1649865305011,MATH 10B,A01,084110,Staff,19,0,30,11
1649865305011,MATH 10B,A02,084111,Staff,29,0,30,1
1649865305011,MATH 10B,A03,084112,Staff,29,0,30,1
1649865311036,MATH 10C,A01,083443,Staff,19,0,30,11
1649865311036,MATH 10C,A02,083444,Staff,24,0,30,6
1649865311036,MATH 10C,B01,084114,Staff,26,0,30,4
1649865311036,MATH 10C,B02,084115,Staff,30,0,30,0
1649865317064,MATH 18,A01,084117,Harel; Guershon,28,0,30,2
1649865317064,MATH 18,A02,084119,Harel; Guershon,29,0,30,1
1649865317064,MATH 18,A03,084120,Harel; Guershon,30,0,30,0
1649865317064,MATH 18,A04,084121,Harel; Guershon,30,0,30,0
1649865323091,MATH 20B,A01,084124,Um; Ko Woon,33,0,35,2
1649865323091,MATH 20B,B01,084126,Um; Ko Woon,35,0,35,0
1649865329116,MATH 20C,A01,083446,Hammock; Frances H,26,0,30,4
1649865329116,MATH 20C,A02,083447,Hammock; Frances H,30,0,30,0
1649865329116,MATH 20C,A03,083448,Hammock; Frances H,30,0,30,0
1649865329116,MATH 20C,A04,083449,Hammock; Frances H,30,0,30,0
1649865329116,MATH 20C,B01,083451,Hammock; Frances H,29,0,30,1
1649865329116,MATH 20C,B02,083452,Hammock; Frances H,30,0,30,0
1649865329116,MATH 20C,B03,083453,Hammock; Frances H,30,0,30,0
1649865329116,MATH 20C,B04,083454,Hammock; Frances H,30,0,30,0
1649865335141,MATH 20D,A01,084128,Staff,29,0,30,1
1649865335141,MATH 20D,A02,084129,Staff,30,0,30,0
1649865335141,MATH 20D,A03,084130,Staff,29,0,30,1
1649865335141,MATH 20D,B01,084133,Staff,28,0,30,2
1649865335141,MATH 20D,B02,084134,Staff,30,0,30,0
1649865335141,MATH 20D,B03,084135,Staff,30,0,30,0
1649865341169,MATH 20E,A01,084138,Staff,27,0,30,3
1649865341169,MATH 20E,A02,084139,Staff,28,0,30,2
1649865341169,MATH 20E,A03,084140,Staff,28,0,30,2
1649865341169,MATH 20E,A04,084141,Staff,30,0,30,0
1649865347196,MATH 102,A01,084143,Harel; Guershon,24,0,30,6
1649865347196,MATH 102,A02,084144,Harel; Guershon,25,0,30,5
1649865353218,MATH 103B,A01,083456,Staff,0,2,30,30
1649865353218,MATH 103B,A02,083457,Staff,14,0,30,16
1649865359242,MATH 109,A01,084146,Salehi Golsefidy; Alireza,29,0,30,1
1649865359242,MATH 109,A02,084147,Salehi Golsefidy; Alireza,26,0,30,4
1649865365279,MATH 120A,A01,085445,Eggers; John Dietrich,27,0,35,8
1649865365279,MATH 120A,A02,085446,Eggers; John Dietrich,30,0,35,5
1649865371409,MATH 142B,A01,084149,Verstraete; Jacques Allan,5,0,30,25
1649865371409,MATH 142B,A02,084150,Verstraete; Jacques Allan,23,0,30,7
1649865377438,MATH 170A,A01,083459,Nie; Jiawang,7,0,30,23
1649865377438,MATH 170A,A02,083460,Nie; Jiawang,25,0,30,5
1649865377438,MATH 170A,A03,083461,Nie; Jiawang,24,0,30,6
1649865383468,MATH 193B,A01,083463,Staff,14,0,30,16
1649865383468,MATH 193B,A02,083464,Staff,19,0,30,11
1649865383468,MATH 193B,A03,083465,Staff,26,0,30,4
1649865389520,COGS 2,A01,083966,Boyle; Mary E. T.,27,0,30,3
1649865395546,COGS 9,A01,083968,Staff,56,0,60,4
1649865401572,COGS 14B,A01,083970,Staff,46,0,50,4
1649865407595,COGS 17,A01,092679,Staff,73,0,75,2
1649865413625,COGS 100,A01,083972,Staff,45,0,60,15
1649865425684,COGS 101C,A01,083976,Staff,24,0,30,6
1649865431706,COGS 102A,A01,083978,Johnson; Christine M.,24,0,30,6
1649865437736,COGS 107B,A01,083980,Staff,32,0,50,18
1649865443772,COGS 115,A01,083982,Staff,20,0,30,10
1649865449809,COGS 118B,A01,083367,Staff,2,0,40,38
1649865455834,COGS 172,A01,083984,Provenzano; Emily Kara,20,0,30,10
1649865461866,COGS 177,A00,083368,Staff,2,0,30,28
1649865467891,COGS 186,A01,083986,Staff,25,0,40,15
1649865473927,COGS 187A,A01,083988,Boyle; Mary E. T.,39,0,60,21
1649865479950,CSE 8A,A50,084003,Miranda; Gregory Joseph,9,0,15,6
1649865485985,CSE 11,A01,084005,Miranda; Gregory Joseph,49,0,55,6
1649865492012,CSE 20,A01,084007,Staff,15,0,20,5
1649865498034,CSE 21,A01,084009,Staff,32,0,50,18
1649865504056,CSE 30,A01,083370,Cao; Yingjun,19,0,40,21
1649865510079,CSE 100,A01,083372,Cao; Yingjun,10,0,40,30
1649865516102,CSE 101,A01,084011,Staff,0,19,40,40
1649865522138,CSE 141,A01,083374,Eldon; John,0,18,75,75
1649865528170,CSE 141L,A01,083376,Eldon; John,0,23,75,75
1649865534201,CSE 175,A01,084013,Kumar; Rakesh,23,0,25,2
1649865540224,CSE 190,A00,092508,Staff,15,0,15,0
1649865546248,ECE 5,A01,084049,Morris; Karcher William,17,0,20,3
1649865552272,ECE 100,A01,084051,Baghdadchi; Saharnaz,16,0,20,4
1649865552272,ECE 100,A02,091916,Baghdadchi; Saharnaz,18,0,20,2
1649865558305,ECE 101,A01,084053,Baghdadchi; Saharnaz,25,0,37,12
1649865558305,ECE 101,A02,084054,Baghdadchi; Saharnaz,37,0,37,0
1649865564328,ECE 107,A01,083390,Staff,31,0,40,9
1649865570352,ECE 148,A01,084056,Silberman; Jack,8,0,12,4
1649865576381,ECE 180,A00,083391,Abi Samra; Nicholas Camill,27,0,30,3
1649865576381,ECE 180,B00,083392,Abi Samra; Nicholas Camill,26,0,30,4
1649865582407,MATH 10B,A01,084110,Staff,19,0,30,11
1649865582407,MATH 10B,A02,084111,Staff,29,0,30,1
1649865582407,MATH 10B,A03,084112,Staff,29,0,30,1
1649865588433,MATH 10C,A01,083443,Staff,19,0,30,11
1649865588433,MATH 10C,A02,083444,Staff,24,0,30,6
1649865588433,MATH 10C,B01,084114,Staff,26,0,30,4
1649865588433,MATH 10C,B02,084115,Staff,30,0,30,0
1649865594456,MATH 18,A01,084117,Harel; Guershon,28,0,30,2
1649865594456,MATH 18,A02,084119,Harel; Guershon,29,0,30,1
1649865594456,MATH 18,A03,084120,Harel; Guershon,30,0,30,0
1649865594456,MATH 18,A04,084121,Harel; Guershon,30,0,30,0
1649865600483,MATH 20B,A01,084124,Um; Ko Woon,33,0,35,2
1649865600483,MATH 20B,B01,084126,Um; Ko Woon,35,0,35,0
1649865606510,MATH 20C,A01,083446,Hammock; Frances H,26,0,30,4
1649865606510,MATH 20C,A02,083447,Hammock; Frances H,30,0,30,0
1649865606510,MATH 20C,A03,083448,Hammock; Frances H,30,0,30,0
1649865606510,MATH 20C,A04,083449,Hammock; Frances H,30,0,30,0
1649865606510,MATH 20C,B01,083451,Hammock; Frances H,29,0,30,1
1649865606510,MATH 20C,B02,083452,Hammock; Frances H,30,0,30,0
1649865606510,MATH 20C,B03,083453,Hammock; Frances H,30,0,30,0
1649865606510,MATH 20C,B04,083454,Hammock; Frances H,30,0,30,0
1649865612537,MATH 20D,A01,084128,Staff,29,0,30,1
1649865612537,MATH 20D,A02,084129,Staff,30,0,30,0
1649865612537,MATH 20D,A03,084130,Staff,29,0,30,1
1649865612537,MATH 20D,B01,084133,Staff,28,0,30,2
1649865612537,MATH 20D,B02,084134,Staff,30,0,30,0
1649865612537,MATH 20D,B03,084135,Staff,30,0,30,0
1649865618562,MATH 20E,A01,084138,Staff,27,0,30,3
1649865618562,MATH 20E,A02,084139,Staff,28,0,30,2
1649865618562,MATH 20E,A03,084140,Staff,28,0,30,2
1649865618562,MATH 20E,A04,084141,Staff,30,0,30,0
1649865624594,MATH 102,A01,084143,Harel; Guershon,24,0,30,6
1649865624594,MATH 102,A02,084144,Harel; Guershon,25,0,30,5
1649865630619,MATH 103B,A01,083456,Staff,0,2,30,30
1649865630619,MATH 103B,A02,083457,Staff,14,0,30,16
1649865636649,MATH 109,A01,084146,Salehi Golsefidy; Alireza,29,0,30,1
1649865636649,MATH 109,A02,084147,Salehi Golsefidy; Alireza,26,0,30,4
1649865642674,MATH 120A,A01,085445,Eggers; John Dietrich,27,0,35,8
1649865642674,MATH 120A,A02,085446,Eggers; John Dietrich,30,0,35,5
1649865648697,MATH 142B,A01,084149,Verstraete; Jacques Allan,5,0,30,25
1649865648697,MATH 142B,A02,084150,Verstraete; Jacques Allan,23,0,30,7
1649865654724,MATH 170A,A01,083459,Nie; Jiawang,7,0,30,23
1649865654724,MATH 170A,A02,083460,Nie; Jiawang,25,0,30,5
1649865654724,MATH 170A,A03,083461,Nie; Jiawang,24,0,30,6
1649865660750,MATH 193B,A01,083463,Staff,14,0,30,16
1649865660750,MATH 193B,A02,083464,Staff,19,0,30,11
1649865660750,MATH 193B,A03,083465,Staff,26,0,30,4
1649865666826,COGS 2,A01,083966,Boyle; Mary E. T.,27,0,30,3
1649865672848,COGS 9,A01,083968,Staff,56,0,60,4
1649865678875,COGS 14B,A01,083970,Staff,46,0,50,4
1649865684899,COGS 17,A01,092679,Staff,73,0,75,2
1649865690927,COGS 100,A01,083972,Staff,45,0,60,15
1649865703034,COGS 101C,A01,083976,Staff,24,0,30,6
1649865709058,COGS 102A,A01,083978,Johnson; Christine M.,24,0,30,6
1649865715082,COGS 107B,A01,083980,Staff,32,0,50,18
1649865721112,COGS 115,A01,083982,Staff,20,0,30,10
1649865727137,COGS 118B,A01,083367,Staff,2,0,40,38
1649865733163,COGS 172,A01,083984,Provenzano; Emily Kara,20,0,30,10
1649865739188,COGS 177,A00,083368,Staff,2,0,30,28
1649865745212,COGS 186,A01,083986,Staff,25,0,40,15
1649865751238,COGS 187A,A01,083988,Boyle; Mary E. T.,38,0,60,22
1649865757261,CSE 8A,A50,084003,Miranda; Gregory Joseph,9,0,15,6
1649865763287,CSE 11,A01,084005,Miranda; Gregory Joseph,49,0,55,6
1649865769312,CSE 20,A01,084007,Staff,15,0,20,5
1649865775336,CSE 21,A01,084009,Staff,32,0,50,18
1649865781365,CSE 30,A01,083370,Cao; Yingjun,17,0,40,23
1649865787388,CSE 100,A01,083372,Cao; Yingjun,10,0,40,30
1649865793417,CSE 101,A01,084011,Staff,0,19,40,40
1649865799444,CSE 141,A01,083374,Eldon; John,0,18,75,75
1649865805469,CSE 141L,A01,083376,Eldon; John,0,23,75,75
1649865811491,CSE 175,A01,084013,Kumar; Rakesh,23,0,25,2
1649865817517,CSE 190,A00,092508,Staff,15,0,15,0
1649865823550,ECE 5,A01,084049,Morris; Karcher William,17,0,20,3
1649865829586,ECE 100,A01,084051,Baghdadchi; Saharnaz,16,0,20,4
1649865829586,ECE 100,A02,091916,Baghdadchi; Saharnaz,18,0,20,2
1649865835622,ECE 101,A01,084053,Baghdadchi; Saharnaz,25,0,37,12
1649865835622,ECE 101,A02,084054,Baghdadchi; Saharnaz,37,0,37,0
1649865841649,ECE 107,A01,083390,Staff,31,0,40,9
1649865847675,ECE 148,A01,084056,Silberman; Jack,8,0,12,4
1649865853703,ECE 180,A00,083391,Abi Samra; Nicholas Camill,27,0,30,3
1649865853703,ECE 180,B00,083392,Abi Samra; Nicholas Camill,26,0,30,4
1649865859728,MATH 10B,A01,084110,Staff,19,0,30,11
1649865859728,MATH 10B,A02,084111,Staff,29,0,30,1
1649865859728,MATH 10B,A03,084112,Staff,29,0,30,1
1649865865755,MATH 10C,A01,083443,Staff,19,0,30,11
1649865865755,MATH 10C,A02,083444,Staff,24,0,30,6
1649865865755,MATH 10C,B01,084114,Staff,26,0,30,4
1649865865755,MATH 10C,B02,084115,Staff,30,0,30,0
1649865871779,MATH 18,A01,084117,Harel; Guershon,28,0,30,2
1649865871779,MATH 18,A02,084119,Harel; Guershon,29,0,30,1
1649865871779,MATH 18,A03,084120,Harel; Guershon,30,0,30,0
1649865871779,MATH 18,A04,084121,Harel; Guershon,30,0,30,0
1649865877814,MATH 20B,A01,084124,Um; Ko Woon,33,0,35,2
1649865877814,MATH 20B,B01,084126,Um; Ko Woon,35,0,35,0
1649865883843,MATH 20C,A01,083446,Hammock; Frances H,26,0,30,4
1649865883843,MATH 20C,A02,083447,Hammock; Frances H,30,0,30,0
1649865883843,MATH 20C,A03,083448,Hammock; Frances H,30,0,30,0
1649865883843,MATH 20C,A04,083449,Hammock; Frances H,30,0,30,0
1649865883843,MATH 20C,B01,083451,Hammock; Frances H,29,0,30,1
1649865883843,MATH 20C,B02,083452,Hammock; Frances H,30,0,30,0
1649865883843,MATH 20C,B03,083453,Hammock; Frances H,30,0,30,0
1649865883843,MATH 20C,B04,083454,Hammock; Frances H,30,0,30,0
1649865889865,MATH 20D,A01,084128,Staff,29,0,30,1
1649865889865,MATH 20D,A02,084129,Staff,30,0,30,0
1649865889865,MATH 20D,A03,084130,Staff,29,0,30,1
1649865889865,MATH 20D,B01,084133,Staff,28,0,30,2
1649865889865,MATH 20D,B02,084134,Staff,30,0,30,0
1649865889865,MATH 20D,B03,084135,Staff,30,0,30,0
1649865895890,MATH 20E,A01,084138,Staff,27,0,30,3
1649865895890,MATH 20E,A02,084139,Staff,28,0,30,2
1649865895890,MATH 20E,A03,084140,Staff,28,0,30,2
1649865895890,MATH 20E,A04,084141,Staff,30,0,30,0
1649865901916,MATH 102,A01,084143,Harel; Guershon,24,0,30,6
1649865901916,MATH 102,A02,084144,Harel; Guershon,25,0,30,5
1649865907938,MATH 103B,A01,083456,Staff,0,2,30,30
1649865907938,MATH 103B,A02,083457,Staff,14,0,30,16
1649865913964,MATH 109,A01,084146,Salehi Golsefidy; Alireza,29,0,30,1
1649865913964,MATH 109,A02,084147,Salehi Golsefidy; Alireza,26,0,30,4
1649865919988,MATH 120A,A01,085445,Eggers; John Dietrich,27,0,35,8
1649865919988,MATH 120A,A02,085446,Eggers; John Dietrich,30,0,35,5
1649865926013,MATH 142B,A01,084149,Verstraete; Jacques Allan,5,0,30,25
1649865926013,MATH 142B,A02,084150,Verstraete; Jacques Allan,23,0,30,7
1649865932039,MATH 170A,A01,083459,Nie; Jiawang,7,0,30,23
1649865932039,MATH 170A,A02,083460,Nie; Jiawang,25,0,30,5
1649865932039,MATH 170A,A03,083461,Nie; Jiawang,24,0,30,6
1649865938063,MATH 193B,A01,083463,Staff,13,0,30,17
1649865938063,MATH 193B,A02,083464,Staff,19,0,30,11
1649865938063,MATH 193B,A03,083465,Staff,26,0,30,4
1649865944111,COGS 2,A01,083966,Boyle; Mary E. T.,27,0,30,3
1649865950148,COGS 9,A01,083968,Staff,56,0,60,4
1649865956177,COGS 14B,A01,083970,Staff,46,0,50,4
1649865962318,COGS 17,A01,092679,Staff,73,0,75,2
1649865968345,COGS 100,A01,083972,Staff,45,0,60,15
1649865980405,COGS 101C,A01,083976,Staff,24,0,30,6
1649865986431,COGS 102A,A01,083978,Johnson; Christine M.,23,0,30,7
1649865992461,COGS 107B,A01,083980,Staff,31,0,50,19
1649865998486,COGS 115,A01,083982,Staff,20,0,30,10
1649866004509,COGS 118B,A01,083367,Staff,2,0,40,38
1649866010536,COGS 172,A01,083984,Provenzano; Emily Kara,20,0,30,10
1649866016561,COGS 177,A00,083368,Staff,2,0,30,28
1649866022587,COGS 186,A01,083986,Staff,25,0,40,15
1649866028611,COGS 187A,A01,083988,Boyle; Mary E. T.,38,0,60,22
1649866034636,CSE 8A,A50,084003,Miranda; Gregory Joseph,9,0,15,6
1649866040665,CSE 11,A01,084005,Miranda; Gregory Joseph,49,0,55,6
1649866046695,CSE 20,A01,084007,Staff,15,0,20,5
1649866052719,CSE 21,A01,084009,Staff,32,0,50,18
1649866058743,CSE 30,A01,083370,Cao; Yingjun,17,0,40,23
1649866064765,CSE 100,A01,083372,Cao; Yingjun,10,0,40,30
1649866070787,CSE 101,A01,084011,Staff,0,20,40,40
1649866076816,CSE 141,A01,083374,Eldon; John,0,18,75,75
1649866082840,CSE 141L,A01,083376,Eldon; John,0,23,75,75
1649866088866,CSE 175,A01,084013,Kumar; Rakesh,23,0,25,2
1649866094896,CSE 190,A00,092508,Staff,15,0,15,0
1649866100919,ECE 5,A01,084049,Morris; Karcher William,17,0,20,3
1649866106944,ECE 100,A01,084051,Baghdadchi; Saharnaz,16,0,20,4
1649866106944,ECE 100,A02,091916,Baghdadchi; Saharnaz,18,0,20,2
1649866112981,ECE 101,A01,084053,Baghdadchi; Saharnaz,25,0,37,12
1649866112981,ECE 101,A02,084054,Baghdadchi; Saharnaz,37,0,37,0
1649866119006,ECE 107,A01,083390,Staff,31,0,40,9
1649866125039,ECE 148,A01,084056,Silberman; Jack,8,0,12,4
1649866131071,ECE 180,A00,083391,Abi Samra; Nicholas Camill,27,0,30,3
1649866131071,ECE 180,B00,083392,Abi Samra; Nicholas Camill,26,0,30,4
1649866137106,MATH 10B,A01,084110,Staff,19,0,30,11
1649866137106,MATH 10B,A02,084111,Staff,29,0,30,1
1649866137106,MATH 10B,A03,084112,Staff,29,0,30,1
1649866143130,MATH 10C,A01,083443,Staff,19,0,30,11
1649866143130,MATH 10C,A02,083444,Staff,24,0,30,6
1649866143130,MATH 10C,B01,084114,Staff,26,0,30,4
1649866143130,MATH 10C,B02,084115,Staff,30,0,30,0
1649866149155,MATH 18,A01,084117,Harel; Guershon,28,0,30,2
1649866149155,MATH 18,A02,084119,Harel; Guershon,29,0,30,1
1649866149155,MATH 18,A03,084120,Harel; Guershon,30,0,30,0
1649866149155,MATH 18,A04,084121,Harel; Guershon,30,0,30,0
1649866155179,MATH 20B,A01,084124,Um; Ko Woon,33,0,35,2
1649866155179,MATH 20B,B01,084126,Um; Ko Woon,35,0,35,0
1649866161227,MATH 20C,A01,083446,Hammock; Frances H,26,0,30,4
1649866161227,MATH 20C,A02,083447,Hammock; Frances H,30,0,30,0
1649866161227,MATH 20C,A03,083448,Hammock; Frances H,30,0,30,0
1649866161227,MATH 20C,A04,083449,Hammock; Frances H,30,0,30,0
1649866161227,MATH 20C,B01,083451,Hammock; Frances H,29,0,30,1
1649866161227,MATH 20C,B02,083452,Hammock; Frances H,30,0,30,0
1649866161227,MATH 20C,B03,083453,Hammock; Frances H,30,0,30,0
1649866161227,MATH 20C,B04,083454,Hammock; Frances H,30,0,30,0
1649866167254,MATH 20D,A01,084128,Staff,29,0,30,1
1649866167254,MATH 20D,A02,084129,Staff,30,0,30,0
1649866167254,MATH 20D,A03,084130,Staff,29,0,30,1
1649866167254,MATH 20D,B01,084133,Staff,28,0,30,2
1649866167254,MATH 20D,B02,084134,Staff,30,0,30,0
1649866167254,MATH 20D,B03,084135,Staff,30,0,30,0
1649866173277,MATH 20E,A01,084138,Staff,27,0,30,3
1649866173277,MATH 20E,A02,084139,Staff,28,0,30,2
1649866173277,MATH 20E,A03,084140,Staff,28,0,30,2
1649866173277,MATH 20E,A04,084141,Staff,30,0,30,0
1649866179307,MATH 102,A01,084143,Harel; Guershon,24,0,30,6
1649866179307,MATH 102,A02,084144,Harel; Guershon,25,0,30,5
1649866185330,MATH 103B,A01,083456,Staff,0,2,30,30
1649866185330,MATH 103B,A02,083457,Staff,14,0,30,16
1649866191363,MATH 109,A01,084146,Salehi Golsefidy; Alireza,29,0,30,1
1649866191363,MATH 109,A02,084147,Salehi Golsefidy; Alireza,26,0,30,4
1649866197400,MATH 120A,A01,085445,Eggers; John Dietrich,27,0,35,8
1649866197400,MATH 120A,A02,085446,Eggers; John Dietrich,30,0,35,5
1649866203423,MATH 142B,A01,084149,Verstraete; Jacques Allan,4,0,30,26
1649866203423,MATH 142B,A02,084150,Verstraete; Jacques Allan,23,0,30,7
1649866209451,MATH 170A,A01,083459,Nie; Jiawang,7,0,30,23
1649866209451,MATH 170A,A02,083460,Nie; Jiawang,24,0,30,6
1649866209451,MATH 170A,A03,083461,Nie; Jiawang,24,0,30,6
1649866215494,MATH 193B,A01,083463,Staff,13,0,30,17
1649866215494,MATH 193B,A02,083464,Staff,19,0,30,11
1649866215494,MATH 193B,A03,083465,Staff,26,0,30,4
1649866221565,COGS 2,A01,083966,Boyle; Mary E. T.,27,0,30,3
1649866227599,COGS 9,A01,083968,Staff,56,0,60,4
1649866233625,COGS 14B,A01,083970,Staff,46,0,50,4
1649866239650,COGS 17,A01,092679,Staff,73,0,75,2
1649866245673,COGS 100,A01,083972,Staff,45,0,60,15
1649866257734,COGS 101C,A01,083976,Staff,24,0,30,6
1649866263765,COGS 102A,A01,083978,Johnson; Christine M.,23,0,30,7
1649866269788,COGS 107B,A01,083980,Staff,30,0,50,20
1649866275811,COGS 115,A01,083982,Staff,20,0,30,10
1649866281841,COGS 118B,A01,083367,Staff,2,0,40,38
1649866287864,COGS 172,A01,083984,Provenzano; Emily Kara,20,0,30,10
1649866293890,COGS 177,A00,083368,Staff,2,0,30,28
1649866299914,COGS 186,A01,083986,Staff,25,0,40,15
1649866305947,COGS 187A,A01,083988,Boyle; Mary E. T.,38,0,60,22
1649866311970,CSE 8A,A50,084003,Miranda; Gregory Joseph,8,0,15,7
1649866317996,CSE 11,A01,084005,Miranda; Gregory Joseph,49,0,55,6
1649866324034,CSE 20,A01,084007,Staff,15,0,20,5
1649866330058,CSE 21,A01,084009,Staff,32,0,50,18
1649866336091,CSE 30,A01,083370,Cao; Yingjun,17,0,40,23
1649866342114,CSE 100,A01,083372,Cao; Yingjun,10,0,40,30
1649866348144,CSE 101,A01,084011,Staff,0,20,40,40
1649866354168,CSE 141,A01,083374,Eldon; John,0,19,75,75
1649866360190,CSE 141L,A01,083376,Eldon; John,0,24,75,75
1649866366214,CSE 175,A01,084013,Kumar; Rakesh,23,0,25,2
1649866372237,CSE 190,A00,092508,Staff,15,0,15,0
1649866378261,ECE 5,A01,084049,Morris; Karcher William,17,0,20,3
1649866384286,ECE 100,A01,084051,Baghdadchi; Saharnaz,16,0,20,4
1649866384286,ECE 100,A02,091916,Baghdadchi; Saharnaz,18,0,20,2
1649866390309,ECE 101,A01,084053,Baghdadchi; Saharnaz,25,0,37,12
1649866390309,ECE 101,A02,084054,Baghdadchi; Saharnaz,37,0,37,0
1649866396332,ECE 107,A01,083390,Staff,31,0,40,9
1649866402354,ECE 148,A01,084056,Silberman; Jack,8,0,12,4
1649866408386,ECE 180,A00,083391,Abi Samra; Nicholas Camill,27,0,30,3
1649866408386,ECE 180,B00,083392,Abi Samra; Nicholas Camill,26,0,30,4
1649866414421,MATH 10B,A01,084110,Staff,19,0,30,11
1649866414421,MATH 10B,A02,084111,Staff,29,0,30,1
1649866414421,MATH 10B,A03,084112,Staff,29,0,30,1
1649866420463,MATH 10C,A01,083443,Staff,19,0,30,11
1649866420463,MATH 10C,A02,083444,Staff,24,0,30,6
1649866420463,MATH 10C,B01,084114,Staff,26,0,30,4
1649866420463,MATH 10C,B02,084115,Staff,30,0,30,0
1649866426491,MATH 18,A01,084117,Harel; Guershon,28,0,30,2
1649866426491,MATH 18,A02,084119,Harel; Guershon,29,0,30,1
1649866426491,MATH 18,A03,084120,Harel; Guershon,30,0,30,0
1649866426491,MATH 18,A04,084121,Harel; Guershon,30,0,30,0
1649866432515,MATH 20B,A01,084124,Um; Ko Woon,33,0,35,2
1649866432515,MATH 20B,B01,084126,Um; Ko Woon,35,0,35,0
1649866438542,MATH 20C,A01,083446,Hammock; Frances H,26,0,30,4
1649866438542,MATH 20C,A02,083447,Hammock; Frances H,30,0,30,0
1649866438542,MATH 20C,A03,083448,Hammock; Frances H,30,0,30,0
1649866438542,MATH 20C,A04,083449,Hammock; Frances H,30,0,30,0
1649866438542,MATH 20C,B01,083451,Hammock; Frances H,29,0,30,1
1649866438542,MATH 20C,B02,083452,Hammock; Frances H,30,0,30,0
1649866438542,MATH 20C,B03,083453,Hammock; Frances H,30,0,30,0
1649866438542,MATH 20C,B04,083454,Hammock; Frances H,30,0,30,0
1649866444568,MATH 20D,A01,084128,Staff,29,0,30,1
1649866444568,MATH 20D,A02,084129,Staff,30,0,30,0
1649866444568,MATH 20D,A03,084130,Staff,29,0,30,1
1649866444568,MATH 20D,B01,084133,Staff,28,0,30,2
1649866444568,MATH 20D,B02,084134,Staff,30,0,30,0
1649866444568,MATH 20D,B03,084135,Staff,30,0,30,0
1649866450601,MATH 20E,A01,084138,Staff,27,0,30,3
1649866450601,MATH 20E,A02,084139,Staff,28,0,30,2
1649866450601,MATH 20E,A03,084140,Staff,28,0,30,2
1649866450601,MATH 20E,A04,084141,Staff,30,0,30,0
1649866456630,MATH 102,A01,084143,Harel; Guershon,24,0,30,6
1649866456630,MATH 102,A02,084144,Harel; Guershon,25,0,30,5
1649866462657,MATH 103B,A01,083456,Staff,0,2,30,30
1649866462657,MATH 103B,A02,083457,Staff,14,0,30,16
1649866468680,MATH 109,A01,084146,Salehi Golsefidy; Alireza,29,0,30,1
1649866468680,MATH 109,A02,084147,Salehi Golsefidy; Alireza,26,0,30,4
1649866474718,MATH 120A,A01,085445,Eggers; John Dietrich,27,0,35,8
1649866474718,MATH 120A,A02,085446,Eggers; John Dietrich,30,0,35,5
1649866480752,MATH 142B,A01,084149,Verstraete; Jacques Allan,4,0,30,26
1649866480752,MATH 142B,A02,084150,Verstraete; Jacques Allan,23,0,30,7
1649866486775,MATH 170A,A01,083459,Nie; Jiawang,7,0,30,23
1649866486775,MATH 170A,A02,083460,Nie; Jiawang,24,0,30,6
1649866486775,MATH 170A,A03,083461,Nie; Jiawang,24,0,30,6
1649866492798,MATH 193B,A01,083463,Staff,13,0,30,17
1649866492798,MATH 193B,A02,083464,Staff,19,0,30,11
1649866492798,MATH 193B,A03,083465,Staff,26,0,30,4
1649866498846,COGS 2,A01,083966,Boyle; Mary E. T.,27,0,30,3
1649866504913,COGS 9,A01,083968,Staff,56,0,60,4
1649866510944,COGS 14B,A01,083970,Staff,46,0,50,4
1649866516971,COGS 17,A01,092679,Staff,73,0,75,2
1649866522998,COGS 100,A01,083972,Staff,45,0,60,15
1649866535046,COGS 101C,A01,083976,Staff,24,0,30,6
1649866541072,COGS 102A,A01,083978,Johnson; Christine M.,23,0,30,7
1649866547101,COGS 107B,A01,083980,Staff,30,0,50,20
1649866553134,COGS 115,A01,083982,Staff,20,0,30,10
1649866559278,COGS 118B,A01,083367,Staff,2,0,40,38
1649866565308,COGS 172,A01,083984,Provenzano; Emily Kara,19,0,30,11
1649866571341,COGS 177,A00,083368,Staff,2,0,30,28
1649866577372,COGS 186,A01,083986,Staff,25,0,40,15
1649866583396,COGS 187A,A01,083988,Boyle; Mary E. T.,38,0,60,22
1649866589419,CSE 8A,A50,084003,Miranda; Gregory Joseph,8,0,15,7
1649866595446,CSE 11,A01,084005,Miranda; Gregory Joseph,49,0,55,6
1649866601472,CSE 20,A01,084007,Staff,15,0,20,5
1649866607504,CSE 21,A01,084009,Staff,32,0,50,18
1649866613528,CSE 30,A01,083370,Cao; Yingjun,17,0,40,23
1649866619555,CSE 100,A01,083372,Cao; Yingjun,10,0,40,30
1649866625583,CSE 101,A01,084011,Staff,0,20,40,40
1649866631611,CSE 141,A01,083374,Eldon; John,0,19,75,75
1649866637636,CSE 141L,A01,083376,Eldon; John,0,24,75,75
1649866643689,CSE 175,A01,084013,Kumar; Rakesh,23,0,25,2
1649866649712,CSE 190,A00,092508,Staff,15,0,15,0
1649866655734,ECE 5,A01,084049,Morris; Karcher William,17,0,20,3
1649866661776,ECE 100,A01,084051,Baghdadchi; Saharnaz,16,0,20,4
1649866661776,ECE 100,A02,091916,Baghdadchi; Saharnaz,18,0,20,2
1649866667798,ECE 101,A01,084053,Baghdadchi; Saharnaz,25,0,37,12
1649866667798,ECE 101,A02,084054,Baghdadchi; Saharnaz,37,0,37,0
1649866673826,ECE 107,A01,083390,Staff,31,0,40,9
1649866679858,ECE 148,A01,084056,Silberman; Jack,8,0,12,4
1649866685887,ECE 180,A00,083391,Abi Samra; Nicholas Camill,27,0,30,3
1649866685887,ECE 180,B00,083392,Abi Samra; Nicholas Camill,26,0,30,4
1649866691914,MATH 10B,A01,084110,Staff,19,0,30,11
1649866691914,MATH 10B,A02,084111,Staff,29,0,30,1
1649866691914,MATH 10B,A03,084112,Staff,29,0,30,1
1649866697944,MATH 10C,A01,083443,Staff,19,0,30,11
1649866697944,MATH 10C,A02,083444,Staff,24,0,30,6
1649866697944,MATH 10C,B01,084114,Staff,26,0,30,4
1649866697944,MATH 10C,B02,084115,Staff,30,0,30,0
1649866703974,MATH 18,A01,084117,Harel; Guershon,28,0,30,2
1649866703974,MATH 18,A02,084119,Harel; Guershon,29,0,30,1
1649866703974,MATH 18,A03,084120,Harel; Guershon,30,0,30,0
1649866703974,MATH 18,A04,084121,Harel; Guershon,30,0,30,0
1649866709999,MATH 20B,A01,084124,Um; Ko Woon,33,0,35,2
1649866709999,MATH 20B,B01,084126,Um; Ko Woon,35,0,35,0
1649866716028,MATH 20C,A01,083446,Hammock; Frances H,26,0,30,4
1649866716028,MATH 20C,A02,083447,Hammock; Frances H,30,0,30,0
1649866716028,MATH 20C,A03,083448,Hammock; Frances H,30,0,30,0
1649866716028,MATH 20C,A04,083449,Hammock; Frances H,30,0,30,0
1649866716028,MATH 20C,B01,083451,Hammock; Frances H,29,0,30,1
1649866716028,MATH 20C,B02,083452,Hammock; Frances H,30,0,30,0
1649866716028,MATH 20C,B03,083453,Hammock; Frances H,30,0,30,0
1649866716028,MATH 20C,B04,083454,Hammock; Frances H,30,0,30,0
1649866722061,MATH 20D,A01,084128,Staff,29,0,30,1
1649866722061,MATH 20D,A02,084129,Staff,30,0,30,0
1649866722061,MATH 20D,A03,084130,Staff,29,0,30,1
1649866722061,MATH 20D,B01,084133,Staff,28,0,30,2
1649866722061,MATH 20D,B02,084134,Staff,30,0,30,0
1649866722061,MATH 20D,B03,084135,Staff,30,0,30,0
1649866728090,MATH 20E,A01,084138,Staff,27,0,30,3
1649866728090,MATH 20E,A02,084139,Staff,28,0,30,2
1649866728090,MATH 20E,A03,084140,Staff,28,0,30,2
1649866728090,MATH 20E,A04,084141,Staff,30,0,30,0
1649866734114,MATH 102,A01,084143,Harel; Guershon,24,0,30,6
1649866734114,MATH 102,A02,084144,Harel; Guershon,25,0,30,5
1649866740141,MATH 103B,A01,083456,Staff,0,2,30,30
1649866740141,MATH 103B,A02,083457,Staff,14,0,30,16
1649866746164,MATH 109,A01,084146,Salehi Golsefidy; Alireza,29,0,30,1
1649866746164,MATH 109,A02,084147,Salehi Golsefidy; Alireza,26,0,30,4
1649866752188,MATH 120A,A01,085445,Eggers; John Dietrich,27,0,35,8
1649866752188,MATH 120A,A02,085446,Eggers; John Dietrich,30,0,35,5
1649866758212,MATH 142B,A01,084149,Verstraete; Jacques Allan,4,0,30,26
1649866758212,MATH 142B,A02,084150,Verstraete; Jacques Allan,23,0,30,7
1649866764239,MATH 170A,A01,083459,Nie; Jiawang,7,0,30,23
1649866764239,MATH 170A,A02,083460,Nie; Jiawang,24,0,30,6
1649866764239,MATH 170A,A03,083461,Nie; Jiawang,24,0,30,6
1649866770265,MATH 193B,A01,083463,Staff,13,0,30,17
1649866770265,MATH 193B,A02,083464,Staff,19,0,30,11
1649866770265,MATH 193B,A03,083465,Staff,26,0,30,4
1649866776323,COGS 2,A01,083966,Boyle; Mary E. T.,27,0,30,3
1649866782345,COGS 9,A01,083968,Staff,56,0,60,4
1649866788383,COGS 14B,A01,083970,Staff,46,0,50,4
1649866794407,COGS 17,A01,092679,Staff,73,0,75,2
1649866800441,COGS 100,A01,083972,Staff,45,0,60,15
1649866812494,COGS 101C,A01,083976,Staff,24,0,30,6
1649866818529,COGS 102A,A01,083978,Johnson; Christine M.,23,0,30,7
1649866824559,COGS 107B,A01,083980,Staff,30,0,50,20
1649866830585,COGS 115,A01,083982,Staff,20,0,30,10
1649866836609,COGS 118B,A01,083367,Staff,2,0,40,38
1649866842649,COGS 172,A01,083984,Provenzano; Emily Kara,19,0,30,11
1649866848676,COGS 177,A00,083368,Staff,2,0,30,28
1649866854700,COGS 186,A01,083986,Staff,25,0,40,15
1649866860737,COGS 187A,A01,083988,Boyle; Mary E. T.,38,0,60,22
1649866866763,CSE 8A,A50,084003,Miranda; Gregory Joseph,8,0,15,7
1649866872786,CSE 11,A01,084005,Miranda; Gregory Joseph,49,0,55,6
1649866878816,CSE 20,A01,084007,Staff,15,0,20,5
1649866884841,CSE 21,A01,084009,Staff,32,0,50,18
1649866890866,CSE 30,A01,083370,Cao; Yingjun,17,0,40,23
1649866896890,CSE 100,A01,083372,Cao; Yingjun,10,0,40,30
1649866902913,CSE 101,A01,084011,Staff,0,21,40,40
1649866908936,CSE 141,A01,083374,Eldon; John,0,24,75,75
1649866914964,CSE 141L,A01,083376,Eldon; John,0,29,75,75
1649866920991,CSE 175,A01,084013,Kumar; Rakesh,23,0,25,2
1649866927032,CSE 190,A00,092508,Staff,15,0,15,0
1649866933061,ECE 5,A01,084049,Morris; Karcher William,17,0,20,3
1649866939086,ECE 100,A01,084051,Baghdadchi; Saharnaz,16,0,20,4
1649866939086,ECE 100,A02,091916,Baghdadchi; Saharnaz,18,0,20,2
1649866945115,ECE 101,A01,084053,Baghdadchi; Saharnaz,24,0,37,13
1649866945115,ECE 101,A02,084054,Baghdadchi; Saharnaz,37,0,37,0
1649866951143,ECE 107,A01,083390,Staff,31,0,40,9
1649866957175,ECE 148,A01,084056,Silberman; Jack,8,0,12,4
1649866963199,ECE 180,A00,083391,Abi Samra; Nicholas Camill,27,0,30,3
1649866963199,ECE 180,B00,083392,Abi Samra; Nicholas Camill,26,0,30,4
1649866969227,MATH 10B,A01,084110,Staff,19,0,30,11
1649866969227,MATH 10B,A02,084111,Staff,29,0,30,1
1649866969227,MATH 10B,A03,084112,Staff,29,0,30,1
1649866975259,MATH 10C,A01,083443,Staff,19,0,30,11
1649866975259,MATH 10C,A02,083444,Staff,24,0,30,6
1649866975259,MATH 10C,B01,084114,Staff,26,0,30,4
1649866975259,MATH 10C,B02,084115,Staff,30,0,30,0
1649866981287,MATH 18,A01,084117,Harel; Guershon,28,0,30,2
1649866981287,MATH 18,A02,084119,Harel; Guershon,29,0,30,1
1649866981287,MATH 18,A03,084120,Harel; Guershon,30,0,30,0
1649866981287,MATH 18,A04,084121,Harel; Guershon,30,0,30,0
1649866987315,MATH 20B,A01,084124,Um; Ko Woon,33,0,35,2
1649866987315,MATH 20B,B01,084126,Um; Ko Woon,35,0,35,0
1649866993350,MATH 20C,A01,083446,Hammock; Frances H,26,0,30,4
1649866993350,MATH 20C,A02,083447,Hammock; Frances H,30,0,30,0
1649866993350,MATH 20C,A03,083448,Hammock; Frances H,30,0,30,0
1649866993350,MATH 20C,A04,083449,Hammock; Frances H,30,0,30,0
1649866993350,MATH 20C,B01,083451,Hammock; Frances H,29,0,30,1
1649866993350,MATH 20C,B02,083452,Hammock; Frances H,30,0,30,0
1649866993350,MATH 20C,B03,083453,Hammock; Frances H,30,0,30,0
1649866993350,MATH 20C,B04,083454,Hammock; Frances H,30,0,30,0
1649866999377,MATH 20D,A01,084128,Staff,29,0,30,1
1649866999377,MATH 20D,A02,084129,Staff,30,0,30,0
1649866999377,MATH 20D,A03,084130,Staff,29,0,30,1
1649866999377,MATH 20D,B01,084133,Staff,28,0,30,2
1649866999377,MATH 20D,B02,084134,Staff,30,0,30,0
1649866999377,MATH 20D,B03,084135,Staff,30,0,30,0
1649867005412,MATH 20E,A01,084138,Staff,27,0,30,3
1649867005412,MATH 20E,A02,084139,Staff,28,0,30,2
1649867005412,MATH 20E,A03,084140,Staff,28,0,30,2
1649867005412,MATH 20E,A04,084141,Staff,30,0,30,0
1649867011435,MATH 102,A01,084143,Harel; Guershon,24,0,30,6
1649867011435,MATH 102,A02,084144,Harel; Guershon,25,0,30,5
1649867017459,MATH 103B,A01,083456,Staff,0,2,30,30
1649867017459,MATH 103B,A02,083457,Staff,14,0,30,16
1649867023493,MATH 109,A01,084146,Salehi Golsefidy; Alireza,29,0,30,1
1649867023493,MATH 109,A02,084147,Salehi Golsefidy; Alireza,26,0,30,4
1649867029523,MATH 120A,A01,085445,Eggers; John Dietrich,27,0,35,8
1649867029523,MATH 120A,A02,085446,Eggers; John Dietrich,30,0,35,5
1649867035546,MATH 142B,A01,084149,Verstraete; Jacques Allan,4,0,30,26
1649867035546,MATH 142B,A02,084150,Verstraete; Jacques Allan,23,0,30,7
1649867041585,MATH 170A,A01,083459,Nie; Jiawang,6,0,30,24
1649867041585,MATH 170A,A02,083460,Nie; Jiawang,24,0,30,6
1649867041585,MATH 170A,A03,083461,Nie; Jiawang,24,0,30,6
1649867047617,MATH 193B,A01,083463,Staff,13,0,30,17
1649867047617,MATH 193B,A02,083464,Staff,19,0,30,11
1649867047617,MATH 193B,A03,083465,Staff,26,0,30,4
1649867053681,COGS 2,A01,083966,Boyle; Mary E. T.,27,0,30,3
1649867059715,COGS 9,A01,083968,Staff,56,0,60,4
1649867065738,COGS 14B,A01,083970,Staff,46,0,50,4
1649867071761,COGS 17,A01,092679,Staff,72,0,75,3
1649867077788,COGS 100,A01,083972,Staff,45,0,60,15
1649867089840,COGS 101C,A01,083976,Staff,24,0,30,6
1649867095877,COGS 102A,A01,083978,Johnson; Christine M.,23,0,30,7
1649867101902,COGS 107B,A01,083980,Staff,30,0,50,20
1649867107926,COGS 115,A01,083982,Staff,20,0,30,10
1649867113953,COGS 118B,A01,083367,Staff,2,0,40,38
1649867119982,COGS 172,A01,083984,Provenzano; Emily Kara,19,0,30,11
1649867126006,COGS 177,A00,083368,Staff,1,0,30,29
1649867132032,COGS 186,A01,083986,Staff,25,0,40,15
1649867138054,COGS 187A,A01,083988,Boyle; Mary E. T.,38,0,60,22
1649867144079,CSE 8A,A50,084003,Miranda; Gregory Joseph,8,0,15,7
1649867150104,CSE 11,A01,084005,Miranda; Gregory Joseph,49,0,55,6
1649867156252,CSE 20,A01,084007,Staff,15,0,20,5
1649867162280,CSE 21,A01,084009,Staff,32,0,50,18
1649867168306,CSE 30,A01,083370,Cao; Yingjun,17,0,40,23
1649867174328,CSE 100,A01,083372,Cao; Yingjun,9,0,40,31
1649867180352,CSE 101,A01,084011,Staff,0,23,40,40
1649867186387,CSE 141,A01,083374,Eldon; John,0,26,75,75
1649867192410,CSE 141L,A01,083376,Eldon; John,0,30,75,75
1649867198437,CSE 175,A01,084013,Kumar; Rakesh,23,0,25,2
1649867204463,CSE 190,A00,092508,Staff,15,0,15,0
1649867210494,ECE 5,A01,084049,Morris; Karcher William,17,0,20,3
1649867216517,ECE 100,A01,084051,Baghdadchi; Saharnaz,16,0,20,4
1649867216517,ECE 100,A02,091916,Baghdadchi; Saharnaz,18,0,20,2
1649867222545,ECE 101,A01,084053,Baghdadchi; Saharnaz,24,0,37,13
1649867222545,ECE 101,A02,084054,Baghdadchi; Saharnaz,37,0,37,0
1649867228568,ECE 107,A01,083390,Staff,31,0,40,9
1649867234593,ECE 148,A01,084056,Silberman; Jack,8,0,12,4
1649867240621,ECE 180,A00,083391,Abi Samra; Nicholas Camill,27,0,30,3
1649867240621,ECE 180,B00,083392,Abi Samra; Nicholas Camill,26,0,30,4
1649867246651,MATH 10B,A01,084110,Staff,19,0,30,11
1649867246651,MATH 10B,A02,084111,Staff,29,0,30,1
1649867246651,MATH 10B,A03,084112,Staff,29,0,30,1
1649867252673,MATH 10C,A01,083443,Staff,19,0,30,11
1649867252673,MATH 10C,A02,083444,Staff,23,0,30,7
1649867252673,MATH 10C,B01,084114,Staff,26,0,30,4
1649867252673,MATH 10C,B02,084115,Staff,30,0,30,0
1649867258695,MATH 18,A01,084117,Harel; Guershon,28,0,30,2
1649867258695,MATH 18,A02,084119,Harel; Guershon,29,0,30,1
1649867258695,MATH 18,A03,084120,Harel; Guershon,30,0,30,0
1649867258695,MATH 18,A04,084121,Harel; Guershon,30,0,30,0
1649867264725,MATH 20B,A01,084124,Um; Ko Woon,33,0,35,2
1649867264725,MATH 20B,B01,084126,Um; Ko Woon,35,0,35,0
1649867270750,MATH 20C,A01,083446,Hammock; Frances H,26,0,30,4
1649867270750,MATH 20C,A02,083447,Hammock; Frances H,30,0,30,0
1649867270750,MATH 20C,A03,083448,Hammock; Frances H,30,0,30,0
1649867270750,MATH 20C,A04,083449,Hammock; Frances H,30,0,30,0
1649867270750,MATH 20C,B01,083451,Hammock; Frances H,29,0,30,1
1649867270750,MATH 20C,B02,083452,Hammock; Frances H,30,0,30,0
1649867270750,MATH 20C,B03,083453,Hammock; Frances H,30,0,30,0
1649867270750,MATH 20C,B04,083454,Hammock; Frances H,30,0,30,0
1649867276774,MATH 20D,A01,084128,Staff,29,0,30,1
1649867276774,MATH 20D,A02,084129,Staff,30,0,30,0
1649867276774,MATH 20D,A03,084130,Staff,29,0,30,1
1649867276774,MATH 20D,B01,084133,Staff,28,0,30,2
1649867276774,MATH 20D,B02,084134,Staff,30,0,30,0
1649867276774,MATH 20D,B03,084135,Staff,30,0,30,0
1649867282798,MATH 20E,A01,084138,Staff,27,0,30,3
1649867282798,MATH 20E,A02,084139,Staff,28,0,30,2
1649867282798,MATH 20E,A03,084140,Staff,28,0,30,2
1649867282798,MATH 20E,A04,084141,Staff,30,0,30,0
1649867288821,MATH 102,A01,084143,Harel; Guershon,24,0,30,6
1649867288821,MATH 102,A02,084144,Harel; Guershon,25,0,30,5
1649867294843,MATH 103B,A01,083456,Staff,0,2,30,30
1649867294843,MATH 103B,A02,083457,Staff,14,0,30,16
1649867300866,MATH 109,A01,084146,Salehi Golsefidy; Alireza,29,0,30,1
1649867300866,MATH 109,A02,084147,Salehi Golsefidy; Alireza,26,0,30,4
1649867306895,MATH 120A,A01,085445,Eggers; John Dietrich,27,0,35,8
1649867306895,MATH 120A,A02,085446,Eggers; John Dietrich,30,0,35,5
1649867312924,MATH 142B,A01,084149,Verstraete; Jacques Allan,4,0,30,26
1649867312924,MATH 142B,A02,084150,Verstraete; Jacques Allan,23,0,30,7
1649867318945,MATH 170A,A01,083459,Nie; Jiawang,6,0,30,24
1649867318945,MATH 170A,A02,083460,Nie; Jiawang,24,0,30,6
1649867318945,MATH 170A,A03,083461,Nie; Jiawang,24,0,30,6
1649867324970,MATH 193B,A01,083463,Staff,13,0,30,17
1649867324970,MATH 193B,A02,083464,Staff,19,0,30,11
1649867324970,MATH 193B,A03,083465,Staff,27,0,30,3
1649867331034,COGS 2,A01,083966,Boyle; Mary E. T.,27,0,30,3
1649867337064,COGS 9,A01,083968,Staff,56,0,60,4
1649867343087,COGS 14B,A01,083970,Staff,46,0,50,4
1649867349116,COGS 17,A01,092679,Staff,72,0,75,3
1649867355139,COGS 100,A01,083972,Staff,45,0,60,15
1649867367186,COGS 101C,A01,083976,Staff,24,0,30,6
1649867373210,COGS 102A,A01,083978,Johnson; Christine M.,23,0,30,7
1649867379241,COGS 107B,A01,083980,Staff,30,0,50,20
1649867385281,COGS 115,A01,083982,Staff,20,0,30,10
1649867391316,COGS 118B,A01,083367,Staff,2,0,40,38
1649867397350,COGS 172,A01,083984,Provenzano; Emily Kara,19,0,30,11
1649867403374,COGS 177,A00,083368,Staff,1,0,30,29
1649867409405,COGS 186,A01,083986,Staff,25,0,40,15
1649867415432,COGS 187A,A01,083988,Boyle; Mary E. T.,38,0,60,22
1649867421460,CSE 8A,A50,084003,Miranda; Gregory Joseph,8,0,15,7
1649867427490,CSE 11,A01,084005,Miranda; Gregory Joseph,49,0,55,6
1649867433522,CSE 20,A01,084007,Staff,15,0,20,5
1649867439551,CSE 21,A01,084009,Staff,32,0,50,18
1649867445578,CSE 30,A01,083370,Cao; Yingjun,17,0,40,23
1649867451603,CSE 100,A01,083372,Cao; Yingjun,9,0,40,31
1649867457628,CSE 101,A01,084011,Staff,0,23,40,40
1649867463656,CSE 141,A01,083374,Eldon; John,0,26,75,75
1649867469682,CSE 141L,A01,083376,Eldon; John,0,30,75,75
1649867475704,CSE 175,A01,084013,Kumar; Rakesh,23,0,25,2
1649867481728,CSE 190,A00,092508,Staff,15,0,15,0
1649867487755,ECE 5,A01,084049,Morris; Karcher William,17,0,20,3
1649867493795,ECE 100,A01,084051,Baghdadchi; Saharnaz,16,0,20,4
1649867493795,ECE 100,A02,091916,Baghdadchi; Saharnaz,18,0,20,2
1649867499820,ECE 101,A01,084053,Baghdadchi; Saharnaz,24,0,37,13
1649867499820,ECE 101,A02,084054,Baghdadchi; Saharnaz,37,0,37,0
1649867505853,ECE 107,A01,083390,Staff,31,0,40,9
1649867511876,ECE 148,A01,084056,Silberman; Jack,8,0,12,4
1649867517902,ECE 180,A00,083391,Abi Samra; Nicholas Camill,27,0,30,3
1649867517902,ECE 180,B00,083392,Abi Samra; Nicholas Camill,26,0,30,4
1649867523925,MATH 10B,A01,084110,Staff,19,0,30,11
1649867523925,MATH 10B,A02,084111,Staff,29,0,30,1
1649867523925,MATH 10B,A03,084112,Staff,29,0,30,1
1649867529955,MATH 10C,A01,083443,Staff,19,0,30,11
1649867529955,MATH 10C,A02,083444,Staff,23,0,30,7
1649867529955,MATH 10C,B01,084114,Staff,26,0,30,4
1649867529955,MATH 10C,B02,084115,Staff,30,0,30,0
1649867536008,MATH 18,A01,084117,Harel; Guershon,28,0,30,2
1649867536008,MATH 18,A02,084119,Harel; Guershon,29,0,30,1
1649867536008,MATH 18,A03,084120,Harel; Guershon,30,0,30,0
1649867536008,MATH 18,A04,084121,Harel; Guershon,30,0,30,0
1649867542035,MATH 20B,A01,084124,Um; Ko Woon,33,0,35,2
1649867542035,MATH 20B,B01,084126,Um; Ko Woon,35,0,35,0
1649867548060,MATH 20C,A01,083446,Hammock; Frances H,26,0,30,4
1649867548060,MATH 20C,A02,083447,Hammock; Frances H,30,0,30,0
1649867548060,MATH 20C,A03,083448,Hammock; Frances H,30,0,30,0
1649867548060,MATH 20C,A04,083449,Hammock; Frances H,30,0,30,0
1649867548060,MATH 20C,B01,083451,Hammock; Frances H,29,0,30,1
1649867548060,MATH 20C,B02,083452,Hammock; Frances H,30,0,30,0
1649867548060,MATH 20C,B03,083453,Hammock; Frances H,30,0,30,0
1649867548060,MATH 20C,B04,083454,Hammock; Frances H,30,0,30,0
1649867554089,MATH 20D,A01,084128,Staff,29,0,30,1
1649867554089,MATH 20D,A02,084129,Staff,30,0,30,0
1649867554089,MATH 20D,A03,084130,Staff,29,0,30,1
1649867554089,MATH 20D,B01,084133,Staff,28,0,30,2
1649867554089,MATH 20D,B02,084134,Staff,30,0,30,0
1649867554089,MATH 20D,B03,084135,Staff,30,0,30,0
1649867560114,MATH 20E,A01,084138,Staff,27,0,30,3
1649867560114,MATH 20E,A02,084139,Staff,28,0,30,2
1649867560114,MATH 20E,A03,084140,Staff,28,0,30,2
1649867560114,MATH 20E,A04,084141,Staff,30,0,30,0
1649867566142,MATH 102,A01,084143,Harel; Guershon,24,0,30,6
1649867566142,MATH 102,A02,084144,Harel; Guershon,25,0,30,5
1649867572172,MATH 103B,A01,083456,Staff,0,2,30,30
1649867572172,MATH 103B,A02,083457,Staff,14,0,30,16
1649867578198,MATH 109,A01,084146,Salehi Golsefidy; Alireza,29,0,30,1
1649867578198,MATH 109,A02,084147,Salehi Golsefidy; Alireza,26,0,30,4
1649867584223,MATH 120A,A01,085445,Eggers; John Dietrich,27,0,35,8
1649867584223,MATH 120A,A02,085446,Eggers; John Dietrich,30,0,35,5
1649867590247,MATH 142B,A01,084149,Verstraete; Jacques Allan,4,0,30,26
1649867590247,MATH 142B,A02,084150,Verstraete; Jacques Allan,23,0,30,7
1649867596281,MATH 170A,A01,083459,Nie; Jiawang,6,0,30,24
1649867596281,MATH 170A,A02,083460,Nie; Jiawang,24,0,30,6
1649867596281,MATH 170A,A03,083461,Nie; Jiawang,24,0,30,6
1649867602329,MATH 193B,A01,083463,Staff,13,0,30,17
1649867602329,MATH 193B,A02,083464,Staff,19,0,30,11
1649867602329,MATH 193B,A03,083465,Staff,27,0,30,3
1649867608382,COGS 2,A01,083966,Boyle; Mary E. T.,27,0,30,3
1649867614407,COGS 9,A01,083968,Staff,56,0,60,4
1649867620430,COGS 14B,A01,083970,Staff,46,0,50,4
1649867626454,COGS 17,A01,092679,Staff,72,0,75,3
1649867632478,COGS 100,A01,083972,Staff,45,0,60,15
1649867644527,COGS 101C,A01,083976,Staff,24,0,30,6
1649867650548,COGS 102A,A01,083978,Johnson; Christine M.,23,0,30,7
1649867656572,COGS 107B,A01,083980,Staff,30,0,50,20
1649867662602,COGS 115,A01,083982,Staff,20,0,30,10
1649867668628,COGS 118B,A01,083367,Staff,2,0,40,38
1649867674654,COGS 172,A01,083984,Provenzano; Emily Kara,18,0,30,12
1649867680688,COGS 177,A00,083368,Staff,1,0,30,29
1649867686711,COGS 186,A01,083986,Staff,25,0,40,15
1649867692735,COGS 187A,A01,083988,Boyle; Mary E. T.,38,0,60,22
1649867698760,CSE 8A,A50,084003,Miranda; Gregory Joseph,8,0,15,7
1649867704788,CSE 11,A01,084005,Miranda; Gregory Joseph,49,0,55,6
1649867710810,CSE 20,A01,084007,Staff,15,0,20,5
1649867716834,CSE 21,A01,084009,Staff,32,0,50,18
1649867722860,CSE 30,A01,083370,Cao; Yingjun,17,0,40,23
1649867728883,CSE 100,A01,083372,Cao; Yingjun,9,0,40,31
1649867734906,CSE 101,A01,084011,Staff,0,23,40,40
1649867740934,CSE 141,A01,083374,Eldon; John,0,27,75,75
1649867746966,CSE 141L,A01,083376,Eldon; John,0,31,75,75
1649867753078,CSE 175,A01,084013,Kumar; Rakesh,23,0,25,2
1649867759105,CSE 190,A00,092508,Staff,15,0,15,0
1649867765130,ECE 5,A01,084049,Morris; Karcher William,17,0,20,3
1649867771156,ECE 100,A01,084051,Baghdadchi; Saharnaz,16,0,20,4
1649867771156,ECE 100,A02,091916,Baghdadchi; Saharnaz,18,0,20,2
1649867777191,ECE 101,A01,084053,Baghdadchi; Saharnaz,24,0,37,13
1649867777191,ECE 101,A02,084054,Baghdadchi; Saharnaz,37,0,37,0
1649867783216,ECE 107,A01,083390,Staff,31,0,40,9
1649867789243,ECE 148,A01,084056,Silberman; Jack,8,0,12,4
1649867795267,ECE 180,A00,083391,Abi Samra; Nicholas Camill,27,0,30,3
1649867795267,ECE 180,B00,083392,Abi Samra; Nicholas Camill,26,0,30,4
1649867801292,MATH 10B,A01,084110,Staff,19,0,30,11
1649867801292,MATH 10B,A02,084111,Staff,29,0,30,1
1649867801292,MATH 10B,A03,084112,Staff,29,0,30,1
1649867807315,MATH 10C,A01,083443,Staff,19,0,30,11
1649867807315,MATH 10C,A02,083444,Staff,22,0,30,8
1649867807315,MATH 10C,B01,084114,Staff,26,0,30,4
1649867807315,MATH 10C,B02,084115,Staff,30,0,30,0
1649867813344,MATH 18,A01,084117,Harel; Guershon,28,0,30,2
1649867813344,MATH 18,A02,084119,Harel; Guershon,29,0,30,1
1649867813344,MATH 18,A03,084120,Harel; Guershon,30,0,30,0
1649867813344,MATH 18,A04,084121,Harel; Guershon,30,0,30,0
1649867819366,MATH 20B,A01,084124,Um; Ko Woon,33,0,35,2
1649867819366,MATH 20B,B01,084126,Um; Ko Woon,35,0,35,0
1649867825395,MATH 20C,A01,083446,Hammock; Frances H,26,0,30,4
1649867825395,MATH 20C,A02,083447,Hammock; Frances H,30,0,30,0
1649867825395,MATH 20C,A03,083448,Hammock; Frances H,30,0,30,0
1649867825395,MATH 20C,A04,083449,Hammock; Frances H,30,0,30,0
1649867825395,MATH 20C,B01,083451,Hammock; Frances H,29,0,30,1
1649867825395,MATH 20C,B02,083452,Hammock; Frances H,30,0,30,0
1649867825395,MATH 20C,B03,083453,Hammock; Frances H,30,0,30,0
1649867825395,MATH 20C,B04,083454,Hammock; Frances H,30,0,30,0
1649867831416,MATH 20D,A01,084128,Staff,29,0,30,1
1649867831416,MATH 20D,A02,084129,Staff,30,0,30,0
1649867831416,MATH 20D,A03,084130,Staff,29,0,30,1
1649867831416,MATH 20D,B01,084133,Staff,28,0,30,2
1649867831416,MATH 20D,B02,084134,Staff,30,0,30,0
1649867831416,MATH 20D,B03,084135,Staff,30,0,30,0
1649867837440,MATH 20E,A01,084138,Staff,27,0,30,3
1649867837440,MATH 20E,A02,084139,Staff,28,0,30,2
1649867837440,MATH 20E,A03,084140,Staff,28,0,30,2
1649867837440,MATH 20E,A04,084141,Staff,29,0,30,1
1649867843466,MATH 102,A01,084143,Harel; Guershon,24,0,30,6
1649867843466,MATH 102,A02,084144,Harel; Guershon,25,0,30,5
1649867849493,MATH 103B,A01,083456,Staff,0,2,30,30
1649867849493,MATH 103B,A02,083457,Staff,14,0,30,16
1649867855516,MATH 109,A01,084146,Salehi Golsefidy; Alireza,29,0,30,1
1649867855516,MATH 109,A02,084147,Salehi Golsefidy; Alireza,26,0,30,4
1649867861542,MATH 120A,A01,085445,Eggers; John Dietrich,27,0,35,8
1649867861542,MATH 120A,A02,085446,Eggers; John Dietrich,30,0,35,5
1649867867566,MATH 142B,A01,084149,Verstraete; Jacques Allan,3,0,30,27
1649867867566,MATH 142B,A02,084150,Verstraete; Jacques Allan,23,0,30,7
1649867873596,MATH 170A,A01,083459,Nie; Jiawang,5,0,30,25
1649867873596,MATH 170A,A02,083460,Nie; Jiawang,24,0,30,6
1649867873596,MATH 170A,A03,083461,Nie; Jiawang,24,0,30,6
1649867879619,MATH 193B,A01,083463,Staff,13,0,30,17
1649867879619,MATH 193B,A02,083464,Staff,19,0,30,11
1649867879619,MATH 193B,A03,083465,Staff,27,0,30,3
1649867885686,COGS 2,A01,083966,Boyle; Mary E. T.,27,0,30,3
1649867891725,COGS 9,A01,083968,Staff,56,0,60,4
1649867897749,COGS 14B,A01,083970,Staff,46,0,50,4
1649867903775,COGS 17,A01,092679,Staff,72,0,75,3
1649867909803,COGS 100,A01,083972,Staff,45,0,60,15
1649867921864,COGS 101C,A01,083976,Staff,24,0,30,6
1649867927885,COGS 102A,A01,083978,Johnson; Christine M.,23,0,30,7
1649867933910,COGS 107B,A01,083980,Staff,30,0,50,20
1649867939939,COGS 115,A01,083982,Staff,20,0,30,10
1649867945969,COGS 118B,A01,083367,Staff,2,0,40,38
1649867951992,COGS 172,A01,083984,Provenzano; Emily Kara,18,0,30,12
1649867958020,COGS 177,A00,083368,Staff,1,0,30,29
1649867964042,COGS 186,A01,083986,Staff,25,0,40,15
1649867970071,COGS 187A,A01,083988,Boyle; Mary E. T.,38,0,60,22
1649867976095,CSE 8A,A50,084003,Miranda; Gregory Joseph,8,0,15,7
1649867982125,CSE 11,A01,084005,Miranda; Gregory Joseph,49,0,55,6
1649867988149,CSE 20,A01,084007,Staff,15,0,20,5
1649867994184,CSE 21,A01,084009,Staff,32,0,50,18
1649868000217,CSE 30,A01,083370,Cao; Yingjun,17,0,40,23
1649868006239,CSE 100,A01,083372,Cao; Yingjun,9,0,40,31
1649868012270,CSE 101,A01,084011,Staff,0,23,40,40
1649868018294,CSE 141,A01,083374,Eldon; John,0,27,75,75
1649868024431,CSE 141L,A01,083376,Eldon; John,0,31,75,75
1649868030457,CSE 175,A01,084013,Kumar; Rakesh,23,0,25,2
1649868036480,CSE 190,A00,092508,Staff,15,0,15,0
1649868042506,ECE 5,A01,084049,Morris; Karcher William,17,0,20,3
1649868048534,ECE 100,A01,084051,Baghdadchi; Saharnaz,16,0,20,4
1649868048534,ECE 100,A02,091916,Baghdadchi; Saharnaz,18,0,20,2
1649868054558,ECE 101,A01,084053,Baghdadchi; Saharnaz,24,0,37,13
1649868054558,ECE 101,A02,084054,Baghdadchi; Saharnaz,37,0,37,0
1649868060580,ECE 107,A01,083390,Staff,31,0,40,9
1649868066602,ECE 148,A01,084056,Silberman; Jack,8,0,12,4
1649868072644,ECE 180,A00,083391,Abi Samra; Nicholas Camill,27,0,30,3
1649868072644,ECE 180,B00,083392,Abi Samra; Nicholas Camill,26,0,30,4
1649868078676,MATH 10B,A01,084110,Staff,19,0,30,11
1649868078676,MATH 10B,A02,084111,Staff,29,0,30,1
1649868078676,MATH 10B,A03,084112,Staff,29,0,30,1
1649868084699,MATH 10C,A01,083443,Staff,19,0,30,11
1649868084699,MATH 10C,A02,083444,Staff,22,0,30,8
1649868084699,MATH 10C,B01,084114,Staff,26,0,30,4
1649868084699,MATH 10C,B02,084115,Staff,30,0,30,0
1649868090733,MATH 18,A01,084117,Harel; Guershon,28,0,30,2
1649868090733,MATH 18,A02,084119,Harel; Guershon,29,0,30,1
1649868090733,MATH 18,A03,084120,Harel; Guershon,30,0,30,0
1649868090733,MATH 18,A04,084121,Harel; Guershon,30,0,30,0
1649868096762,MATH 20B,A01,084124,Um; Ko Woon,33,0,35,2
1649868096762,MATH 20B,B01,084126,Um; Ko Woon,35,0,35,0
1649868102789,MATH 20C,A01,083446,Hammock; Frances H,26,0,30,4
1649868102789,MATH 20C,A02,083447,Hammock; Frances H,30,0,30,0
1649868102789,MATH 20C,A03,083448,Hammock; Frances H,30,0,30,0
1649868102789,MATH 20C,A04,083449,Hammock; Frances H,30,0,30,0
1649868102789,MATH 20C,B01,083451,Hammock; Frances H,29,0,30,1
1649868102789,MATH 20C,B02,083452,Hammock; Frances H,30,0,30,0
1649868102789,MATH 20C,B03,083453,Hammock; Frances H,30,0,30,0
1649868102789,MATH 20C,B04,083454,Hammock; Frances H,30,0,30,0
1649868108815,MATH 20D,A01,084128,Staff,29,0,30,1
1649868108815,MATH 20D,A02,084129,Staff,30,0,30,0
1649868108815,MATH 20D,A03,084130,Staff,29,0,30,1
1649868108815,MATH 20D,B01,084133,Staff,28,0,30,2
1649868108815,MATH 20D,B02,084134,Staff,30,0,30,0
1649868108815,MATH 20D,B03,084135,Staff,30,0,30,0
1649868114841,MATH 20E,A01,084138,Staff,26,0,30,4
1649868114841,MATH 20E,A02,084139,Staff,28,0,30,2
1649868114841,MATH 20E,A03,084140,Staff,28,0,30,2
1649868114841,MATH 20E,A04,084141,Staff,29,0,30,1
1649868120872,MATH 102,A01,084143,Harel; Guershon,24,0,30,6
1649868120872,MATH 102,A02,084144,Harel; Guershon,25,0,30,5
1649868126894,MATH 103B,A01,083456,Staff,0,2,30,30
1649868126894,MATH 103B,A02,083457,Staff,14,0,30,16
1649868132928,MATH 109,A01,084146,Salehi Golsefidy; Alireza,29,0,30,1
1649868132928,MATH 109,A02,084147,Salehi Golsefidy; Alireza,26,0,30,4
1649868138961,MATH 120A,A01,085445,Eggers; John Dietrich,27,0,35,8
1649868138961,MATH 120A,A02,085446,Eggers; John Dietrich,30,0,35,5
1649868144983,MATH 142B,A01,084149,Verstraete; Jacques Allan,3,0,30,27
1649868144983,MATH 142B,A02,084150,Verstraete; Jacques Allan,23,0,30,7
1649868151014,MATH 170A,A01,083459,Nie; Jiawang,5,0,30,25
1649868151014,MATH 170A,A02,083460,Nie; Jiawang,24,0,30,6
1649868151014,MATH 170A,A03,083461,Nie; Jiawang,24,0,30,6
1649868157043,MATH 193B,A01,083463,Staff,12,0,30,18
1649868157043,MATH 193B,A02,083464,Staff,19,0,30,11
1649868157043,MATH 193B,A03,083465,Staff,27,0,30,3
1649868163122,COGS 2,A01,083966,Boyle; Mary E. T.,27,0,30,3
1649868169145,COGS 9,A01,083968,Staff,56,0,60,4
1649868175171,COGS 14B,A01,083970,Staff,46,0,50,4
1649868181204,COGS 17,A01,092679,Staff,72,0,75,3
1649868187226,COGS 100,A01,083972,Staff,45,0,60,15
1649868199283,COGS 101C,A01,083976,Staff,24,0,30,6
1649868205319,COGS 102A,A01,083978,Johnson; Christine M.,23,0,30,7
1649868211342,COGS 107B,A01,083980,Staff,29,0,50,21
1649868217370,COGS 115,A01,083982,Staff,20,0,30,10
1649868223398,COGS 118B,A01,083367,Staff,2,0,40,38
1649868229427,COGS 172,A01,083984,Provenzano; Emily Kara,18,0,30,12
1649868235451,COGS 177,A00,083368,Staff,1,0,30,29
1649868241474,COGS 186,A01,083986,Staff,25,0,40,15
1649868247497,COGS 187A,A01,083988,Boyle; Mary E. T.,38,0,60,22
1649868253525,CSE 8A,A50,084003,Miranda; Gregory Joseph,8,0,15,7
1649868259554,CSE 11,A01,084005,Miranda; Gregory Joseph,49,0,55,6
1649868265599,CSE 20,A01,084007,Staff,15,0,20,5
1649868271625,CSE 21,A01,084009,Staff,32,0,50,18
1649868277649,CSE 30,A01,083370,Cao; Yingjun,17,0,40,23
1649868283675,CSE 100,A01,083372,Cao; Yingjun,9,0,40,31
1649868289714,CSE 101,A01,084011,Staff,0,23,40,40
1649868295743,CSE 141,A01,083374,Eldon; John,0,27,75,75
1649868301773,CSE 141L,A01,083376,Eldon; John,0,31,75,75
1649868307799,CSE 175,A01,084013,Kumar; Rakesh,23,0,25,2
1649868313823,CSE 190,A00,092508,Staff,15,0,15,0
1649868319845,ECE 5,A01,084049,Morris; Karcher William,17,0,20,3
1649868325869,ECE 100,A01,084051,Baghdadchi; Saharnaz,16,0,20,4
1649868325869,ECE 100,A02,091916,Baghdadchi; Saharnaz,18,0,20,2
1649868331892,ECE 101,A01,084053,Baghdadchi; Saharnaz,24,0,37,13
1649868331892,ECE 101,A02,084054,Baghdadchi; Saharnaz,37,0,37,0
1649868337920,ECE 107,A01,083390,Staff,31,0,40,9
1649868343951,ECE 148,A01,084056,Silberman; Jack,8,0,12,4
1649868350073,ECE 180,A00,083391,Abi Samra; Nicholas Camill,27,0,30,3
1649868350073,ECE 180,B00,083392,Abi Samra; Nicholas Camill,26,0,30,4
1649868356098,MATH 10B,A01,084110,Staff,19,0,30,11
1649868356098,MATH 10B,A02,084111,Staff,29,0,30,1
1649868356098,MATH 10B,A03,084112,Staff,29,0,30,1
1649868362120,MATH 10C,A01,083443,Staff,18,0,30,12
1649868362120,MATH 10C,A02,083444,Staff,22,0,30,8
1649868362120,MATH 10C,B01,084114,Staff,26,0,30,4
1649868362120,MATH 10C,B02,084115,Staff,30,0,30,0
1649868368145,MATH 18,A01,084117,Harel; Guershon,28,0,30,2
1649868368145,MATH 18,A02,084119,Harel; Guershon,29,0,30,1
1649868368145,MATH 18,A03,084120,Harel; Guershon,30,0,30,0
1649868368145,MATH 18,A04,084121,Harel; Guershon,30,0,30,0
1649868374172,MATH 20B,A01,084124,Um; Ko Woon,33,0,35,2
1649868374172,MATH 20B,B01,084126,Um; Ko Woon,35,0,35,0
1649868380203,MATH 20C,A01,083446,Hammock; Frances H,26,0,30,4
1649868380203,MATH 20C,A02,083447,Hammock; Frances H,30,0,30,0
1649868380203,MATH 20C,A03,083448,Hammock; Frances H,30,0,30,0
1649868380203,MATH 20C,A04,083449,Hammock; Frances H,30,0,30,0
1649868380203,MATH 20C,B01,083451,Hammock; Frances H,29,0,30,1
1649868380203,MATH 20C,B02,083452,Hammock; Frances H,30,0,30,0
1649868380203,MATH 20C,B03,083453,Hammock; Frances H,30,0,30,0
1649868380203,MATH 20C,B04,083454,Hammock; Frances H,30,0,30,0
1649868386229,MATH 20D,A01,084128,Staff,29,0,30,1
1649868386229,MATH 20D,A02,084129,Staff,30,0,30,0
1649868386229,MATH 20D,A03,084130,Staff,29,0,30,1
1649868386229,MATH 20D,B01,084133,Staff,28,0,30,2
1649868386229,MATH 20D,B02,084134,Staff,30,0,30,0
1649868386229,MATH 20D,B03,084135,Staff,30,0,30,0
1649868392264,MATH 20E,A01,084138,Staff,26,0,30,4
1649868392264,MATH 20E,A02,084139,Staff,28,0,30,2
1649868392264,MATH 20E,A03,084140,Staff,28,0,30,2
1649868392264,MATH 20E,A04,084141,Staff,29,0,30,1
1649868398290,MATH 102,A01,084143,Harel; Guershon,24,0,30,6
1649868398290,MATH 102,A02,084144,Harel; Guershon,24,0,30,6
1649868404314,MATH 103B,A01,083456,Staff,0,2,30,30
1649868404314,MATH 103B,A02,083457,Staff,14,0,30,16
1649868410348,MATH 109,A01,084146,Salehi Golsefidy; Alireza,29,0,30,1
1649868410348,MATH 109,A02,084147,Salehi Golsefidy; Alireza,26,0,30,4
1649868416373,MATH 120A,A01,085445,Eggers; John Dietrich,27,0,35,8
1649868416373,MATH 120A,A02,085446,Eggers; John Dietrich,30,0,35,5
1649868422394,MATH 142B,A01,084149,Verstraete; Jacques Allan,3,0,30,27
1649868422394,MATH 142B,A02,084150,Verstraete; Jacques Allan,23,0,30,7
1649868428428,MATH 170A,A01,083459,Nie; Jiawang,5,0,30,25
1649868428428,MATH 170A,A02,083460,Nie; Jiawang,23,0,30,7
1649868428428,MATH 170A,A03,083461,Nie; Jiawang,23,0,30,7
1649868434460,MATH 193B,A01,083463,Staff,12,0,30,18
1649868434460,MATH 193B,A02,083464,Staff,19,0,30,11
1649868434460,MATH 193B,A03,083465,Staff,27,0,30,3
1649868440524,COGS 2,A01,083966,Boyle; Mary E. T.,27,0,30,3
1649868446550,COGS 9,A01,083968,Staff,56,0,60,4
1649868452578,COGS 14B,A01,083970,Staff,46,0,50,4
1649868458600,COGS 17,A01,092679,Staff,72,0,75,3
1649868464623,COGS 100,A01,083972,Staff,45,0,60,15
1649868476675,COGS 101C,A01,083976,Staff,24,0,30,6
1649868482698,COGS 102A,A01,083978,Johnson; Christine M.,23,0,30,7
1649868488726,COGS 107B,A01,083980,Staff,29,0,50,21
1649868494754,COGS 115,A01,083982,Staff,20,0,30,10
1649868500778,COGS 118B,A01,083367,Staff,2,0,40,38
1649868506801,COGS 172,A01,083984,Provenzano; Emily Kara,18,0,30,12
1649868512832,COGS 177,A00,083368,Staff,1,0,30,29
1649868518858,COGS 186,A01,083986,Staff,25,0,40,15
1649868524880,COGS 187A,A01,083988,Boyle; Mary E. T.,38,0,60,22
1649868530904,CSE 8A,A50,084003,Miranda; Gregory Joseph,8,0,15,7
1649868548820,CSE 11,A01,084005,Miranda; Gregory Joseph,49,0,55,6
1649868554868,CSE 20,A01,084007,Staff,15,0,20,5
1649868560892,CSE 21,A01,084009,Staff,32,0,50,18
1649868566919,CSE 30,A01,083370,Cao; Yingjun,16,0,40,24
1649868572963,CSE 100,A01,083372,Cao; Yingjun,9,0,40,31
1649868578985,CSE 101,A01,084011,Staff,0,23,40,40
1649868585012,CSE 141,A01,083374,Eldon; John,0,27,75,75
1649868591043,CSE 141L,A01,083376,Eldon; John,0,31,75,75
1649868597065,CSE 175,A01,084013,Kumar; Rakesh,23,0,25,2
1649868603089,CSE 190,A00,092508,Staff,15,0,15,0
1649868609123,ECE 5,A01,084049,Morris; Karcher William,17,0,20,3
1649868615147,ECE 100,A01,084051,Baghdadchi; Saharnaz,16,0,20,4
1649868615147,ECE 100,A02,091916,Baghdadchi; Saharnaz,18,0,20,2
1649868621182,ECE 101,A01,084053,Baghdadchi; Saharnaz,24,0,37,13
1649868621182,ECE 101,A02,084054,Baghdadchi; Saharnaz,37,0,37,0
1649868627210,ECE 107,A01,083390,Staff,31,0,40,9
1649868633235,ECE 148,A01,084056,Silberman; Jack,8,0,12,4
1649868639258,ECE 180,A00,083391,Abi Samra; Nicholas Camill,27,0,30,3
1649868639258,ECE 180,B00,083392,Abi Samra; Nicholas Camill,26,0,30,4
1649868645281,MATH 10B,A01,084110,Staff,19,0,30,11
1649868645281,MATH 10B,A02,084111,Staff,29,0,30,1
1649868645281,MATH 10B,A03,084112,Staff,29,0,30,1
1649868651306,MATH 10C,A01,083443,Staff,18,0,30,12
1649868651306,MATH 10C,A02,083444,Staff,22,0,30,8
1649868651306,MATH 10C,B01,084114,Staff,26,0,30,4
1649868651306,MATH 10C,B02,084115,Staff,30,0,30,0
1649868657333,MATH 18,A01,084117,Harel; Guershon,28,0,30,2
1649868657333,MATH 18,A02,084119,Harel; Guershon,29,0,30,1
1649868657333,MATH 18,A03,084120,Harel; Guershon,30,0,30,0
1649868657333,MATH 18,A04,084121,Harel; Guershon,30,0,30,0
1649868663355,MATH 20B,A01,084124,Um; Ko Woon,33,0,35,2
1649868663355,MATH 20B,B01,084126,Um; Ko Woon,35,0,35,0
1649868669403,MATH 20C,A01,083446,Hammock; Frances H,26,0,30,4
1649868669403,MATH 20C,A02,083447,Hammock; Frances H,30,0,30,0
1649868669403,MATH 20C,A03,083448,Hammock; Frances H,30,0,30,0
1649868669403,MATH 20C,A04,083449,Hammock; Frances H,30,0,30,0
1649868669403,MATH 20C,B01,083451,Hammock; Frances H,29,0,30,1
1649868669403,MATH 20C,B02,083452,Hammock; Frances H,29,0,30,1
1649868669403,MATH 20C,B03,083453,Hammock; Frances H,30,0,30,0
1649868669403,MATH 20C,B04,083454,Hammock; Frances H,30,0,30,0
1649868675429,MATH 20D,A01,084128,Staff,29,0,30,1
1649868675429,MATH 20D,A02,084129,Staff,30,0,30,0
1649868675429,MATH 20D,A03,084130,Staff,29,0,30,1
1649868675429,MATH 20D,B01,084133,Staff,28,0,30,2
1649868675429,MATH 20D,B02,084134,Staff,30,0,30,0
1649868675429,MATH 20D,B03,084135,Staff,30,0,30,0
1649868681454,MATH 20E,A01,084138,Staff,26,0,30,4
1649868681454,MATH 20E,A02,084139,Staff,28,0,30,2
1649868681454,MATH 20E,A03,084140,Staff,28,0,30,2
1649868681454,MATH 20E,A04,084141,Staff,29,0,30,1
1649868687479,MATH 102,A01,084143,Harel; Guershon,24,0,30,6
1649868687479,MATH 102,A02,084144,Harel; Guershon,24,0,30,6
1649868693503,MATH 103B,A01,083456,Staff,0,2,30,30
1649868693503,MATH 103B,A02,083457,Staff,14,0,30,16
1649868699527,MATH 109,A01,084146,Salehi Golsefidy; Alireza,29,0,30,1
1649868699527,MATH 109,A02,084147,Salehi Golsefidy; Alireza,26,0,30,4
1649868705556,MATH 120A,A01,085445,Eggers; John Dietrich,27,0,35,8
1649868705556,MATH 120A,A02,085446,Eggers; John Dietrich,30,0,35,5
1649868711580,MATH 142B,A01,084149,Verstraete; Jacques Allan,3,0,30,27
1649868711580,MATH 142B,A02,084150,Verstraete; Jacques Allan,23,0,30,7
1649868717609,MATH 170A,A01,083459,Nie; Jiawang,5,0,30,25
1649868717609,MATH 170A,A02,083460,Nie; Jiawang,23,0,30,7
1649868717609,MATH 170A,A03,083461,Nie; Jiawang,23,0,30,7
1649868723634,MATH 193B,A01,083463,Staff,12,0,30,18
1649868723634,MATH 193B,A02,083464,Staff,19,0,30,11
1649868723634,MATH 193B,A03,083465,Staff,27,0,30,3
1649868729686,COGS 2,A01,083966,Boyle; Mary E. T.,27,0,30,3
1649868735721,COGS 9,A01,083968,Staff,56,0,60,4
1649868741745,COGS 14B,A01,083970,Staff,46,0,50,4
1649868747768,COGS 17,A01,092679,Staff,72,0,75,3
1649868753813,COGS 100,A01,083972,Staff,45,0,60,15
1649868765864,COGS 101C,A01,083976,Staff,24,0,30,6
1649868771893,COGS 102A,A01,083978,Johnson; Christine M.,22,0,30,8
1649868777915,COGS 107B,A01,083980,Staff,28,0,50,22
1649868783937,COGS 115,A01,083982,Staff,20,0,30,10
1649868789973,COGS 118B,A01,083367,Staff,1,0,40,39
1649868796001,COGS 172,A01,083984,Provenzano; Emily Kara,18,0,30,12
1649868802025,COGS 177,A00,083368,Staff,1,0,30,29
1649868808050,COGS 186,A01,083986,Staff,25,0,40,15
1649868814073,COGS 187A,A01,083988,Boyle; Mary E. T.,38,0,60,22
1649868820104,CSE 8A,A50,084003,Miranda; Gregory Joseph,8,0,15,7
1649868826137,CSE 11,A01,084005,Miranda; Gregory Joseph,49,0,55,6
1649868832164,CSE 20,A01,084007,Staff,15,0,20,5
1649868838203,CSE 21,A01,084009,Staff,32,0,50,18
1649868844239,CSE 30,A01,083370,Cao; Yingjun,16,0,40,24
1649868850267,CSE 100,A01,083372,Cao; Yingjun,9,0,40,31
1649868856302,CSE 101,A01,084011,Staff,0,23,40,40
1649868862327,CSE 141,A01,083374,Eldon; John,0,28,75,75
1649868868356,CSE 141L,A01,083376,Eldon; John,0,32,75,75
1649868874380,CSE 175,A01,084013,Kumar; Rakesh,23,0,25,2
1649868880401,CSE 190,A00,092508,Staff,15,0,15,0
1649868886426,ECE 5,A01,084049,Morris; Karcher William,17,0,20,3
1649868892453,ECE 100,A01,084051,Baghdadchi; Saharnaz,16,0,20,4
1649868892453,ECE 100,A02,091916,Baghdadchi; Saharnaz,18,0,20,2
1649868898476,ECE 101,A01,084053,Baghdadchi; Saharnaz,24,0,37,13
1649868898476,ECE 101,A02,084054,Baghdadchi; Saharnaz,37,0,37,0
1649868904504,ECE 107,A01,083390,Staff,31,0,40,9
1649868910534,ECE 148,A01,084056,Silberman; Jack,8,0,12,4
1649868916561,ECE 180,A00,083391,Abi Samra; Nicholas Camill,27,0,30,3
1649868916561,ECE 180,B00,083392,Abi Samra; Nicholas Camill,26,0,30,4
1649868922589,MATH 10B,A01,084110,Staff,19,0,30,11
1649868922589,MATH 10B,A02,084111,Staff,29,0,30,1
1649868922589,MATH 10B,A03,084112,Staff,29,0,30,1
1649868928620,MATH 10C,A01,083443,Staff,18,0,30,12
1649868928620,MATH 10C,A02,083444,Staff,22,0,30,8
1649868928620,MATH 10C,B01,084114,Staff,26,0,30,4
1649868928620,MATH 10C,B02,084115,Staff,30,0,30,0
1649868934648,MATH 18,A01,084117,Harel; Guershon,28,0,30,2
1649868934648,MATH 18,A02,084119,Harel; Guershon,29,0,30,1
1649868934648,MATH 18,A03,084120,Harel; Guershon,30,0,30,0
1649868934648,MATH 18,A04,084121,Harel; Guershon,30,0,30,0
1649868940686,MATH 20B,A01,084124,Um; Ko Woon,33,0,35,2
1649868940686,MATH 20B,B01,084126,Um; Ko Woon,35,0,35,0
1649868946714,MATH 20C,A01,083446,Hammock; Frances H,26,0,30,4
1649868946714,MATH 20C,A02,083447,Hammock; Frances H,30,0,30,0
1649868946714,MATH 20C,A03,083448,Hammock; Frances H,30,0,30,0
1649868946714,MATH 20C,A04,083449,Hammock; Frances H,30,0,30,0
1649868946714,MATH 20C,B01,083451,Hammock; Frances H,29,0,30,1
1649868946714,MATH 20C,B02,083452,Hammock; Frances H,29,0,30,1
1649868946714,MATH 20C,B03,083453,Hammock; Frances H,30,0,30,0
1649868946714,MATH 20C,B04,083454,Hammock; Frances H,30,0,30,0
1649868952737,MATH 20D,A01,084128,Staff,29,0,30,1
1649868952737,MATH 20D,A02,084129,Staff,30,0,30,0
1649868952737,MATH 20D,A03,084130,Staff,29,0,30,1
1649868952737,MATH 20D,B01,084133,Staff,28,0,30,2
1649868952737,MATH 20D,B02,084134,Staff,30,0,30,0
1649868952737,MATH 20D,B03,084135,Staff,30,0,30,0
1649868958879,MATH 20E,A01,084138,Staff,25,0,30,5
1649868958879,MATH 20E,A02,084139,Staff,28,0,30,2
1649868958879,MATH 20E,A03,084140,Staff,28,0,30,2
1649868958879,MATH 20E,A04,084141,Staff,29,0,30,1
1649868964903,MATH 102,A01,084143,Harel; Guershon,24,0,30,6
1649868964903,MATH 102,A02,084144,Harel; Guershon,24,0,30,6
1649868970933,MATH 103B,A01,083456,Staff,0,2,30,30
1649868970933,MATH 103B,A02,083457,Staff,14,0,30,16
1649868976956,MATH 109,A01,084146,Salehi Golsefidy; Alireza,29,0,30,1
1649868976956,MATH 109,A02,084147,Salehi Golsefidy; Alireza,26,0,30,4
1649868982979,MATH 120A,A01,085445,Eggers; John Dietrich,27,0,35,8
1649868982979,MATH 120A,A02,085446,Eggers; John Dietrich,30,0,35,5
1649868989011,MATH 142B,A01,084149,Verstraete; Jacques Allan,3,0,30,27
1649868989011,MATH 142B,A02,084150,Verstraete; Jacques Allan,23,0,30,7
1649868995038,MATH 170A,A01,083459,Nie; Jiawang,5,0,30,25
1649868995038,MATH 170A,A02,083460,Nie; Jiawang,23,0,30,7
1649868995038,MATH 170A,A03,083461,Nie; Jiawang,23,0,30,7
1649869001081,MATH 193B,A01,083463,Staff,12,0,30,18
1649869001081,MATH 193B,A02,083464,Staff,19,0,30,11
1649869001081,MATH 193B,A03,083465,Staff,27,0,30,3
1649869007145,COGS 2,A01,083966,Boyle; Mary E. T.,27,0,30,3
1649869013173,COGS 9,A01,083968,Staff,56,0,60,4
1649869019211,COGS 14B,A01,083970,Staff,46,0,50,4
1649869025242,COGS 17,A01,092679,Staff,72,0,75,3
1649869031267,COGS 100,A01,083972,Staff,45,0,60,15
1649869043323,COGS 101C,A01,083976,Staff,24,0,30,6
1649869049349,COGS 102A,A01,083978,Johnson; Christine M.,22,0,30,8
1649869055374,COGS 107B,A01,083980,Staff,28,0,50,22
1649869061399,COGS 115,A01,083982,Staff,20,0,30,10
1649869067425,COGS 118B,A01,083367,Staff,1,0,40,39
1649869073451,COGS 172,A01,083984,Provenzano; Emily Kara,18,0,30,12
1649869079484,COGS 177,A00,083368,Staff,1,0,30,29
1649869085522,COGS 186,A01,083986,Staff,25,0,40,15
1649869091550,COGS 187A,A01,083988,Boyle; Mary E. T.,38,0,60,22
1649869097580,CSE 8A,A50,084003,Miranda; Gregory Joseph,8,0,15,7
1649869103602,CSE 11,A01,084005,Miranda; Gregory Joseph,49,0,55,6
1649869109630,CSE 20,A01,084007,Staff,15,0,20,5
1649869115657,CSE 21,A01,084009,Staff,32,0,50,18
1649869121680,CSE 30,A01,083370,Cao; Yingjun,16,0,40,24
1649869127718,CSE 100,A01,083372,Cao; Yingjun,9,0,40,31
1649869133739,CSE 101,A01,084011,Staff,0,24,40,40
1649869139766,CSE 141,A01,083374,Eldon; John,0,29,75,75
1649869145804,CSE 141L,A01,083376,Eldon; John,0,33,75,75
1649869151830,CSE 175,A01,084013,Kumar; Rakesh,23,0,25,2
1649869157862,CSE 190,A00,092508,Staff,15,0,15,0
1649869163887,ECE 5,A01,084049,Morris; Karcher William,17,0,20,3
1649869169910,ECE 100,A01,084051,Baghdadchi; Saharnaz,16,0,20,4
1649869169910,ECE 100,A02,091916,Baghdadchi; Saharnaz,18,0,20,2
1649869175953,ECE 101,A01,084053,Baghdadchi; Saharnaz,24,0,37,13
1649869175953,ECE 101,A02,084054,Baghdadchi; Saharnaz,37,0,37,0
1649869181974,ECE 107,A01,083390,Staff,31,0,40,9
1649869187997,ECE 148,A01,084056,Silberman; Jack,8,0,12,4
1649869194021,ECE 180,A00,083391,Abi Samra; Nicholas Camill,27,0,30,3
1649869194021,ECE 180,B00,083392,Abi Samra; Nicholas Camill,26,0,30,4
1649869200057,MATH 10B,A01,084110,Staff,19,0,30,11
1649869200057,MATH 10B,A02,084111,Staff,29,0,30,1
1649869200057,MATH 10B,A03,084112,Staff,29,0,30,1
1649869206085,MATH 10C,A01,083443,Staff,18,0,30,12
1649869206085,MATH 10C,A02,083444,Staff,22,0,30,8
1649869206085,MATH 10C,B01,084114,Staff,26,0,30,4
1649869206085,MATH 10C,B02,084115,Staff,30,0,30,0
1649869212108,MATH 18,A01,084117,Harel; Guershon,28,0,30,2
1649869212108,MATH 18,A02,084119,Harel; Guershon,29,0,30,1
1649869212108,MATH 18,A03,084120,Harel; Guershon,30,0,30,0
1649869212108,MATH 18,A04,084121,Harel; Guershon,30,0,30,0
1649869218135,MATH 20B,A01,084124,Um; Ko Woon,33,0,35,2
1649869218135,MATH 20B,B01,084126,Um; Ko Woon,35,0,35,0
1649869224170,MATH 20C,A01,083446,Hammock; Frances H,26,0,30,4
1649869224170,MATH 20C,A02,083447,Hammock; Frances H,29,0,30,1
1649869224170,MATH 20C,A03,083448,Hammock; Frances H,30,0,30,0
1649869224170,MATH 20C,A04,083449,Hammock; Frances H,30,0,30,0
1649869224170,MATH 20C,B01,083451,Hammock; Frances H,29,0,30,1
1649869224170,MATH 20C,B02,083452,Hammock; Frances H,29,0,30,1
1649869224170,MATH 20C,B03,083453,Hammock; Frances H,30,0,30,0
1649869224170,MATH 20C,B04,083454,Hammock; Frances H,30,0,30,0
1649869230201,MATH 20D,A01,084128,Staff,29,0,30,1
1649869230201,MATH 20D,A02,084129,Staff,30,0,30,0
1649869230201,MATH 20D,A03,084130,Staff,29,0,30,1
1649869230201,MATH 20D,B01,084133,Staff,28,0,30,2
1649869230201,MATH 20D,B02,084134,Staff,30,0,30,0
1649869230201,MATH 20D,B03,084135,Staff,30,0,30,0
1649869236228,MATH 20E,A01,084138,Staff,25,0,30,5
1649869236228,MATH 20E,A02,084139,Staff,28,0,30,2
1649869236228,MATH 20E,A03,084140,Staff,28,0,30,2
1649869236228,MATH 20E,A04,084141,Staff,29,0,30,1
1649869242255,MATH 102,A01,084143,Harel; Guershon,24,0,30,6
1649869242255,MATH 102,A02,084144,Harel; Guershon,24,0,30,6
1649869248284,MATH 103B,A01,083456,Staff,0,2,30,30
1649869248284,MATH 103B,A02,083457,Staff,14,0,30,16
1649869254315,MATH 109,A01,084146,Salehi Golsefidy; Alireza,29,0,30,1
1649869254315,MATH 109,A02,084147,Salehi Golsefidy; Alireza,26,0,30,4
1649869260350,MATH 120A,A01,085445,Eggers; John Dietrich,27,0,35,8
1649869260350,MATH 120A,A02,085446,Eggers; John Dietrich,30,0,35,5
1649869266376,MATH 142B,A01,084149,Verstraete; Jacques Allan,3,0,30,27
1649869266376,MATH 142B,A02,084150,Verstraete; Jacques Allan,23,0,30,7
1649869272403,MATH 170A,A01,083459,Nie; Jiawang,5,0,30,25
1649869272403,MATH 170A,A02,083460,Nie; Jiawang,23,0,30,7
1649869272403,MATH 170A,A03,083461,Nie; Jiawang,23,0,30,7
1649869278435,MATH 193B,A01,083463,Staff,12,0,30,18
1649869278435,MATH 193B,A02,083464,Staff,19,0,30,11
1649869278435,MATH 193B,A03,083465,Staff,27,0,30,3
1649869284498,COGS 2,A01,083966,Boyle; Mary E. T.,27,0,30,3
1649869290524,COGS 9,A01,083968,Staff,56,0,60,4
1649869296557,COGS 14B,A01,083970,Staff,46,0,50,4
1649869302591,COGS 17,A01,092679,Staff,72,0,75,3
1649869308616,COGS 100,A01,083972,Staff,45,0,60,15
1649869320660,COGS 101C,A01,083976,Staff,24,0,30,6
1649869326686,COGS 102A,A01,083978,Johnson; Christine M.,22,0,30,8
1649869332728,COGS 107B,A01,083980,Staff,28,0,50,22
1649869338754,COGS 115,A01,083982,Staff,20,0,30,10
1649869344781,COGS 118B,A01,083367,Staff,0,0,40,40
1649869350803,COGS 172,A01,083984,Provenzano; Emily Kara,18,0,30,12
1649869356826,COGS 177,A00,083368,Staff,1,0,30,29
1649869362859,COGS 186,A01,083986,Staff,25,0,40,15
1649869368882,COGS 187A,A01,083988,Boyle; Mary E. T.,38,0,60,22
1649869374917,CSE 8A,A50,084003,Miranda; Gregory Joseph,8,0,15,7
1649869380945,CSE 11,A01,084005,Miranda; Gregory Joseph,48,0,55,7
1649869386980,CSE 20,A01,084007,Staff,15,0,20,5
1649869393003,CSE 21,A01,084009,Staff,32,0,50,18
1649869399029,CSE 30,A01,083370,Cao; Yingjun,16,0,40,24
1649869405053,CSE 100,A01,083372,Cao; Yingjun,8,0,40,32
1649869411077,CSE 101,A01,084011,Staff,0,25,40,40
1649869417107,CSE 141,A01,083374,Eldon; John,0,29,75,75
1649869423130,CSE 141L,A01,083376,Eldon; John,0,33,75,75
1649869429151,CSE 175,A01,084013,Kumar; Rakesh,23,0,25,2
1649869435189,CSE 190,A00,092508,Staff,15,0,15,0
1649869441236,ECE 5,A01,084049,Morris; Karcher William,17,0,20,3
1649869447264,ECE 100,A01,084051,Baghdadchi; Saharnaz,15,0,20,5
1649869447264,ECE 100,A02,091916,Baghdadchi; Saharnaz,18,0,20,2
1649869453286,ECE 101,A01,084053,Baghdadchi; Saharnaz,24,0,37,13
1649869453286,ECE 101,A02,084054,Baghdadchi; Saharnaz,37,0,37,0
1649869459309,ECE 107,A01,083390,Staff,31,0,40,9
1649869465344,ECE 148,A01,084056,Silberman; Jack,8,0,12,4
1649869471367,ECE 180,A00,083391,Abi Samra; Nicholas Camill,27,0,30,3
1649869471367,ECE 180,B00,083392,Abi Samra; Nicholas Camill,26,0,30,4
1649869477414,MATH 10B,A01,084110,Staff,19,0,30,11
1649869477414,MATH 10B,A02,084111,Staff,29,0,30,1
1649869477414,MATH 10B,A03,084112,Staff,29,0,30,1
1649869483436,MATH 10C,A01,083443,Staff,18,0,30,12
1649869483436,MATH 10C,A02,083444,Staff,22,0,30,8
1649869483436,MATH 10C,B01,084114,Staff,26,0,30,4
1649869483436,MATH 10C,B02,084115,Staff,30,0,30,0
1649869489484,MATH 18,A01,084117,Harel; Guershon,28,0,30,2
1649869489484,MATH 18,A02,084119,Harel; Guershon,29,0,30,1
1649869489484,MATH 18,A03,084120,Harel; Guershon,30,0,30,0
1649869489484,MATH 18,A04,084121,Harel; Guershon,30,0,30,0
1649869495508,MATH 20B,A01,084124,Um; Ko Woon,33,0,35,2
1649869495508,MATH 20B,B01,084126,Um; Ko Woon,35,0,35,0
1649869501533,MATH 20C,A01,083446,Hammock; Frances H,26,0,30,4
1649869501533,MATH 20C,A02,083447,Hammock; Frances H,29,0,30,1
1649869501533,MATH 20C,A03,083448,Hammock; Frances H,30,0,30,0
1649869501533,MATH 20C,A04,083449,Hammock; Frances H,30,0,30,0
1649869501533,MATH 20C,B01,083451,Hammock; Frances H,29,0,30,1
1649869501533,MATH 20C,B02,083452,Hammock; Frances H,29,0,30,1
1649869501533,MATH 20C,B03,083453,Hammock; Frances H,30,0,30,0
1649869501533,MATH 20C,B04,083454,Hammock; Frances H,30,0,30,0
1649869507557,MATH 20D,A01,084128,Staff,29,0,30,1
1649869507557,MATH 20D,A02,084129,Staff,30,0,30,0
1649869507557,MATH 20D,A03,084130,Staff,29,0,30,1
1649869507557,MATH 20D,B01,084133,Staff,28,0,30,2
1649869507557,MATH 20D,B02,084134,Staff,30,0,30,0
1649869507557,MATH 20D,B03,084135,Staff,30,0,30,0
1649869513588,MATH 20E,A01,084138,Staff,25,0,30,5
1649869513588,MATH 20E,A02,084139,Staff,28,0,30,2
1649869513588,MATH 20E,A03,084140,Staff,27,0,30,3
1649869513588,MATH 20E,A04,084141,Staff,29,0,30,1
1649869519616,MATH 102,A01,084143,Harel; Guershon,24,0,30,6
1649869519616,MATH 102,A02,084144,Harel; Guershon,24,0,30,6
1649869525640,MATH 103B,A01,083456,Staff,0,2,30,30
1649869525640,MATH 103B,A02,083457,Staff,13,0,30,17
1649869531669,MATH 109,A01,084146,Salehi Golsefidy; Alireza,29,0,30,1
1649869531669,MATH 109,A02,084147,Salehi Golsefidy; Alireza,25,0,30,5
1649869537721,MATH 120A,A01,085445,Eggers; John Dietrich,27,0,35,8
1649869537721,MATH 120A,A02,085446,Eggers; John Dietrich,30,0,35,5
1649869543744,MATH 142B,A01,084149,Verstraete; Jacques Allan,3,0,30,27
1649869543744,MATH 142B,A02,084150,Verstraete; Jacques Allan,23,0,30,7
1649869549771,MATH 170A,A01,083459,Nie; Jiawang,5,0,30,25
1649869549771,MATH 170A,A02,083460,Nie; Jiawang,23,0,30,7
1649869549771,MATH 170A,A03,083461,Nie; Jiawang,23,0,30,7
1649869555906,MATH 193B,A01,083463,Staff,12,0,30,18
1649869555906,MATH 193B,A02,083464,Staff,19,0,30,11
1649869555906,MATH 193B,A03,083465,Staff,26,0,30,4
1649869561954,COGS 2,A01,083966,Boyle; Mary E. T.,27,0,30,3
1649869567979,COGS 9,A01,083968,Staff,56,0,60,4
1649869574009,COGS 14B,A01,083970,Staff,46,0,50,4
1649869580034,COGS 17,A01,092679,Staff,72,0,75,3
1649869586069,COGS 100,A01,083972,Staff,44,0,60,16
1649869598125,COGS 101C,A01,083976,Staff,24,0,30,6
1649869604147,COGS 102A,A01,083978,Johnson; Christine M.,22,0,30,8
1649869610170,COGS 107B,A01,083980,Staff,28,0,50,22
1649869616209,COGS 115,A01,083982,Staff,20,0,30,10
1649869622243,COGS 118B,A01,083367,Staff,0,0,40,40
1649869628265,COGS 172,A01,083984,Provenzano; Emily Kara,18,0,30,12
1649869634305,COGS 177,A00,083368,Staff,1,0,30,29
1649869640331,COGS 186,A01,083986,Staff,25,0,40,15
1649869646362,COGS 187A,A01,083988,Boyle; Mary E. T.,38,0,60,22
1649869652386,CSE 8A,A50,084003,Miranda; Gregory Joseph,8,0,15,7
1649869658416,CSE 11,A01,084005,Miranda; Gregory Joseph,48,0,55,7
1649869664443,CSE 20,A01,084007,Staff,15,0,20,5
1649869670469,CSE 21,A01,084009,Staff,32,0,50,18
1649869676502,CSE 30,A01,083370,Cao; Yingjun,16,0,40,24
1649869682538,CSE 100,A01,083372,Cao; Yingjun,8,0,40,32
1649869688566,CSE 101,A01,084011,Staff,0,25,40,40
1649869694590,CSE 141,A01,083374,Eldon; John,0,29,75,75
1649869700628,CSE 141L,A01,083376,Eldon; John,0,33,75,75
1649869706654,CSE 175,A01,084013,Kumar; Rakesh,23,0,25,2
1649869712677,CSE 190,A00,092508,Staff,15,0,15,0
1649869718702,ECE 5,A01,084049,Morris; Karcher William,17,0,20,3
1649869724727,ECE 100,A01,084051,Baghdadchi; Saharnaz,15,0,20,5
1649869724727,ECE 100,A02,091916,Baghdadchi; Saharnaz,18,0,20,2
1649869730767,ECE 101,A01,084053,Baghdadchi; Saharnaz,24,0,37,13
1649869730767,ECE 101,A02,084054,Baghdadchi; Saharnaz,37,0,37,0
1649869736789,ECE 107,A01,083390,Staff,31,0,40,9
1649869742811,ECE 148,A01,084056,Silberman; Jack,8,0,12,4
1649869748832,ECE 180,A00,083391,Abi Samra; Nicholas Camill,27,0,30,3
1649869748832,ECE 180,B00,083392,Abi Samra; Nicholas Camill,26,0,30,4
1649869754855,MATH 10B,A01,084110,Staff,19,0,30,11
1649869754855,MATH 10B,A02,084111,Staff,29,0,30,1
1649869754855,MATH 10B,A03,084112,Staff,29,0,30,1
1649869760883,MATH 10C,A01,083443,Staff,18,0,30,12
1649869760883,MATH 10C,A02,083444,Staff,22,0,30,8
1649869760883,MATH 10C,B01,084114,Staff,26,0,30,4
1649869760883,MATH 10C,B02,084115,Staff,30,0,30,0
1649869766913,MATH 18,A01,084117,Harel; Guershon,28,0,30,2
1649869766913,MATH 18,A02,084119,Harel; Guershon,29,0,30,1
1649869766913,MATH 18,A03,084120,Harel; Guershon,30,0,30,0
1649869766913,MATH 18,A04,084121,Harel; Guershon,30,0,30,0
1649869772938,MATH 20B,A01,084124,Um; Ko Woon,33,0,35,2
1649869772938,MATH 20B,B01,084126,Um; Ko Woon,35,0,35,0
1649869778963,MATH 20C,A01,083446,Hammock; Frances H,26,0,30,4
1649869778963,MATH 20C,A02,083447,Hammock; Frances H,29,0,30,1
1649869778963,MATH 20C,A03,083448,Hammock; Frances H,30,0,30,0
1649869778963,MATH 20C,A04,083449,Hammock; Frances H,30,0,30,0
1649869778963,MATH 20C,B01,083451,Hammock; Frances H,29,0,30,1
1649869778963,MATH 20C,B02,083452,Hammock; Frances H,29,0,30,1
1649869778963,MATH 20C,B03,083453,Hammock; Frances H,30,0,30,0
1649869778963,MATH 20C,B04,083454,Hammock; Frances H,30,0,30,0
1649869784986,MATH 20D,A01,084128,Staff,29,0,30,1
1649869784986,MATH 20D,A02,084129,Staff,30,0,30,0
1649869784986,MATH 20D,A03,084130,Staff,29,0,30,1
1649869784986,MATH 20D,B01,084133,Staff,28,0,30,2
1649869784986,MATH 20D,B02,084134,Staff,30,0,30,0
1649869784986,MATH 20D,B03,084135,Staff,30,0,30,0
1649869791015,MATH 20E,A01,084138,Staff,25,0,30,5
1649869791015,MATH 20E,A02,084139,Staff,28,0,30,2
1649869791015,MATH 20E,A03,084140,Staff,27,0,30,3
1649869791015,MATH 20E,A04,084141,Staff,29,0,30,1
1649869797037,MATH 102,A01,084143,Harel; Guershon,24,0,30,6
1649869797037,MATH 102,A02,084144,Harel; Guershon,24,0,30,6
1649869803075,MATH 103B,A01,083456,Staff,0,2,30,30
1649869803075,MATH 103B,A02,083457,Staff,13,0,30,17
1649869809100,MATH 109,A01,084146,Salehi Golsefidy; Alireza,29,0,30,1
1649869809100,MATH 109,A02,084147,Salehi Golsefidy; Alireza,25,0,30,5
1649869815122,MATH 120A,A01,085445,Eggers; John Dietrich,27,0,35,8
1649869815122,MATH 120A,A02,085446,Eggers; John Dietrich,30,0,35,5
1649869821152,MATH 142B,A01,084149,Verstraete; Jacques Allan,3,0,30,27
1649869821152,MATH 142B,A02,084150,Verstraete; Jacques Allan,23,0,30,7
1649869827175,MATH 170A,A01,083459,Nie; Jiawang,5,0,30,25
1649869827175,MATH 170A,A02,083460,Nie; Jiawang,23,0,30,7
1649869827175,MATH 170A,A03,083461,Nie; Jiawang,23,0,30,7
1649869833202,MATH 193B,A01,083463,Staff,12,0,30,18
1649869833202,MATH 193B,A02,083464,Staff,19,0,30,11
1649869833202,MATH 193B,A03,083465,Staff,26,0,30,4
1649869839286,COGS 2,A01,083966,Boyle; Mary E. T.,27,0,30,3
1649869845315,COGS 9,A01,083968,Staff,56,0,60,4
1649869851340,COGS 14B,A01,083970,Staff,46,0,50,4
1649869857364,COGS 17,A01,092679,Staff,72,0,75,3
1649869863386,COGS 100,A01,083972,Staff,44,0,60,16
1649869875442,COGS 101C,A01,083976,Staff,24,0,30,6
1649869881469,COGS 102A,A01,083978,Johnson; Christine M.,22,0,30,8
1649869887506,COGS 107B,A01,083980,Staff,28,0,50,22
1649869893532,COGS 115,A01,083982,Staff,19,0,30,11
1649869899566,COGS 118B,A01,083367,Staff,0,0,40,40
1649869905590,COGS 172,A01,083984,Provenzano; Emily Kara,18,0,30,12
1649869911636,COGS 177,A00,083368,Staff,1,0,30,29
1649869917665,COGS 186,A01,083986,Staff,25,0,40,15
1649869923701,COGS 187A,A01,083988,Boyle; Mary E. T.,38,0,60,22
1649869929726,CSE 8A,A50,084003,Miranda; Gregory Joseph,8,0,15,7
1649869935751,CSE 11,A01,084005,Miranda; Gregory Joseph,48,0,55,7
1649869941776,CSE 20,A01,084007,Staff,15,0,20,5
1649869947798,CSE 21,A01,084009,Staff,32,0,50,18
1649869953831,CSE 30,A01,083370,Cao; Yingjun,15,0,40,25
1649869959854,CSE 100,A01,083372,Cao; Yingjun,8,0,40,32
1649869965884,CSE 101,A01,084011,Staff,0,25,40,40
1649869971928,CSE 141,A01,083374,Eldon; John,0,30,75,75
1649869977966,CSE 141L,A01,083376,Eldon; John,0,34,75,75
1649869983995,CSE 175,A01,084013,Kumar; Rakesh,23,0,25,2
1649869990037,CSE 190,A00,092508,Staff,15,0,15,0
1649869996060,ECE 5,A01,084049,Morris; Karcher William,17,0,20,3
1649870002099,ECE 100,A01,084051,Baghdadchi; Saharnaz,15,0,20,5
1649870002099,ECE 100,A02,091916,Baghdadchi; Saharnaz,18,0,20,2
1649870008123,ECE 101,A01,084053,Baghdadchi; Saharnaz,24,0,37,13
1649870008123,ECE 101,A02,084054,Baghdadchi; Saharnaz,37,0,37,0
1649870014146,ECE 107,A01,083390,Staff,31,0,40,9
1649870020187,ECE 148,A01,084056,Silberman; Jack,8,0,12,4
1649870026227,ECE 180,A00,083391,Abi Samra; Nicholas Camill,27,0,30,3
1649870026227,ECE 180,B00,083392,Abi Samra; Nicholas Camill,26,0,30,4
1649870032251,MATH 10B,A01,084110,Staff,19,0,30,11
1649870032251,MATH 10B,A02,084111,Staff,29,0,30,1
1649870032251,MATH 10B,A03,084112,Staff,29,0,30,1
1649870038280,MATH 10C,A01,083443,Staff,18,0,30,12
1649870038280,MATH 10C,A02,083444,Staff,22,0,30,8
1649870038280,MATH 10C,B01,084114,Staff,26,0,30,4
1649870038280,MATH 10C,B02,084115,Staff,30,0,30,0
1649870044302,MATH 18,A01,084117,Harel; Guershon,28,0,30,2
1649870044302,MATH 18,A02,084119,Harel; Guershon,29,0,30,1
1649870044302,MATH 18,A03,084120,Harel; Guershon,30,0,30,0
1649870044302,MATH 18,A04,084121,Harel; Guershon,30,0,30,0
1649870050326,MATH 20B,A01,084124,Um; Ko Woon,33,0,35,2
1649870050326,MATH 20B,B01,084126,Um; Ko Woon,35,0,35,0
1649870056352,MATH 20C,A01,083446,Hammock; Frances H,26,0,30,4
1649870056352,MATH 20C,A02,083447,Hammock; Frances H,29,0,30,1
1649870056352,MATH 20C,A03,083448,Hammock; Frances H,30,0,30,0
1649870056352,MATH 20C,A04,083449,Hammock; Frances H,30,0,30,0
1649870056352,MATH 20C,B01,083451,Hammock; Frances H,29,0,30,1
1649870056352,MATH 20C,B02,083452,Hammock; Frances H,29,0,30,1
1649870056352,MATH 20C,B03,083453,Hammock; Frances H,30,0,30,0
1649870056352,MATH 20C,B04,083454,Hammock; Frances H,30,0,30,0
1649870062417,MATH 20D,A01,084128,Staff,29,0,30,1
1649870062417,MATH 20D,A02,084129,Staff,30,0,30,0
1649870062417,MATH 20D,A03,084130,Staff,29,0,30,1
1649870062417,MATH 20D,B01,084133,Staff,28,0,30,2
1649870062417,MATH 20D,B02,084134,Staff,30,0,30,0
1649870062417,MATH 20D,B03,084135,Staff,30,0,30,0
1649870068446,MATH 20E,A01,084138,Staff,25,0,30,5
1649870068446,MATH 20E,A02,084139,Staff,28,0,30,2
1649870068446,MATH 20E,A03,084140,Staff,27,0,30,3
1649870068446,MATH 20E,A04,084141,Staff,29,0,30,1
1649870074477,MATH 102,A01,084143,Harel; Guershon,24,0,30,6
1649870074477,MATH 102,A02,084144,Harel; Guershon,24,0,30,6
1649870080513,MATH 103B,A01,083456,Staff,0,2,30,30
1649870080513,MATH 103B,A02,083457,Staff,13,0,30,17
1649870086548,MATH 109,A01,084146,Salehi Golsefidy; Alireza,29,0,30,1
1649870086548,MATH 109,A02,084147,Salehi Golsefidy; Alireza,25,0,30,5
1649870092572,MATH 120A,A01,085445,Eggers; John Dietrich,27,0,35,8
1649870092572,MATH 120A,A02,085446,Eggers; John Dietrich,30,0,35,5
1649870098599,MATH 142B,A01,084149,Verstraete; Jacques Allan,3,0,30,27
1649870098599,MATH 142B,A02,084150,Verstraete; Jacques Allan,23,0,30,7
1649870104634,MATH 170A,A01,083459,Nie; Jiawang,5,0,30,25
1649870104634,MATH 170A,A02,083460,Nie; Jiawang,23,0,30,7
1649870104634,MATH 170A,A03,083461,Nie; Jiawang,23,0,30,7
1649870110674,MATH 193B,A01,083463,Staff,12,0,30,18
1649870110674,MATH 193B,A02,083464,Staff,19,0,30,11
1649870110674,MATH 193B,A03,083465,Staff,26,0,30,4
1649870116749,COGS 2,A01,083966,Boyle; Mary E. T.,26,0,30,4
1649870122787,COGS 9,A01,083968,Staff,56,0,60,4
1649870128816,COGS 14B,A01,083970,Staff,46,0,50,4
1649870134843,COGS 17,A01,092679,Staff,72,0,75,3
1649870140869,COGS 100,A01,083972,Staff,44,0,60,16
1649870153023,COGS 101C,A01,083976,Staff,24,0,30,6
1649870159059,COGS 102A,A01,083978,Johnson; Christine M.,22,0,30,8
1649870165082,COGS 107B,A01,083980,Staff,28,0,50,22
1649870171118,COGS 115,A01,083982,Staff,19,0,30,11
1649870177142,COGS 118B,A01,083367,Staff,0,0,40,40
1649870183169,COGS 172,A01,083984,Provenzano; Emily Kara,18,0,30,12
1649870189195,COGS 177,A00,083368,Staff,0,0,30,30
1649870195220,COGS 186,A01,083986,Staff,25,0,40,15
1649870201244,COGS 187A,A01,083988,Boyle; Mary E. T.,38,0,60,22
1649870207271,CSE 8A,A50,084003,Miranda; Gregory Joseph,8,0,15,7
1649870213298,CSE 11,A01,084005,Miranda; Gregory Joseph,48,0,55,7
1649870219324,CSE 20,A01,084007,Staff,15,0,20,5
1649870225346,CSE 21,A01,084009,Staff,32,0,50,18
1649870231376,CSE 30,A01,083370,Cao; Yingjun,15,0,40,25
1649870237402,CSE 100,A01,083372,Cao; Yingjun,8,0,40,32
1649870243428,CSE 101,A01,084011,Staff,0,25,40,40
1649870249454,CSE 141,A01,083374,Eldon; John,0,30,75,75
1649870255487,CSE 141L,A01,083376,Eldon; John,0,34,75,75
1649870261520,CSE 175,A01,084013,Kumar; Rakesh,23,0,25,2
1649870267544,CSE 190,A00,092508,Staff,15,0,15,0
1649870273577,ECE 5,A01,084049,Morris; Karcher William,17,0,20,3
1649870279603,ECE 100,A01,084051,Baghdadchi; Saharnaz,15,0,20,5
1649870279603,ECE 100,A02,091916,Baghdadchi; Saharnaz,18,0,20,2
1649870285628,ECE 101,A01,084053,Baghdadchi; Saharnaz,24,0,37,13
1649870285628,ECE 101,A02,084054,Baghdadchi; Saharnaz,37,0,37,0
1649870291651,ECE 107,A01,083390,Staff,31,0,40,9
1649870297676,ECE 148,A01,084056,Silberman; Jack,8,0,12,4
1649870303704,ECE 180,A00,083391,Abi Samra; Nicholas Camill,27,0,30,3
1649870303704,ECE 180,B00,083392,Abi Samra; Nicholas Camill,26,0,30,4
1649870309732,MATH 10B,A01,084110,Staff,19,0,30,11
1649870309732,MATH 10B,A02,084111,Staff,29,0,30,1
1649870309732,MATH 10B,A03,084112,Staff,29,0,30,1
1649870315760,MATH 10C,A01,083443,Staff,18,0,30,12
1649870315760,MATH 10C,A02,083444,Staff,22,0,30,8
1649870315760,MATH 10C,B01,084114,Staff,26,0,30,4
1649870315760,MATH 10C,B02,084115,Staff,30,0,30,0
1649870321783,MATH 18,A01,084117,Harel; Guershon,28,0,30,2
1649870321783,MATH 18,A02,084119,Harel; Guershon,29,0,30,1
1649870321783,MATH 18,A03,084120,Harel; Guershon,30,0,30,0
1649870321783,MATH 18,A04,084121,Harel; Guershon,30,0,30,0
1649870327815,MATH 20B,A01,084124,Um; Ko Woon,33,0,35,2
1649870327815,MATH 20B,B01,084126,Um; Ko Woon,35,0,35,0
1649870333837,MATH 20C,A01,083446,Hammock; Frances H,26,0,30,4
1649870333837,MATH 20C,A02,083447,Hammock; Frances H,29,0,30,1
1649870333837,MATH 20C,A03,083448,Hammock; Frances H,30,0,30,0
1649870333837,MATH 20C,A04,083449,Hammock; Frances H,30,0,30,0
1649870333837,MATH 20C,B01,083451,Hammock; Frances H,29,0,30,1
1649870333837,MATH 20C,B02,083452,Hammock; Frances H,29,0,30,1
1649870333837,MATH 20C,B03,083453,Hammock; Frances H,30,0,30,0
1649870333837,MATH 20C,B04,083454,Hammock; Frances H,30,0,30,0
1649870339860,MATH 20D,A01,084128,Staff,29,0,30,1
1649870339860,MATH 20D,A02,084129,Staff,30,0,30,0
1649870339860,MATH 20D,A03,084130,Staff,29,0,30,1
1649870339860,MATH 20D,B01,084133,Staff,28,0,30,2
1649870339860,MATH 20D,B02,084134,Staff,30,0,30,0
1649870339860,MATH 20D,B03,084135,Staff,30,0,30,0
1649870345889,MATH 20E,A01,084138,Staff,25,0,30,5
1649870345889,MATH 20E,A02,084139,Staff,28,0,30,2
1649870345889,MATH 20E,A03,084140,Staff,27,0,30,3
1649870345889,MATH 20E,A04,084141,Staff,29,0,30,1
1649870351916,MATH 102,A01,084143,Harel; Guershon,24,0,30,6
1649870351916,MATH 102,A02,084144,Harel; Guershon,24,0,30,6
1649870357947,MATH 103B,A01,083456,Staff,0,2,30,30
1649870357947,MATH 103B,A02,083457,Staff,13,0,30,17
1649870363973,MATH 109,A01,084146,Salehi Golsefidy; Alireza,29,0,30,1
1649870363973,MATH 109,A02,084147,Salehi Golsefidy; Alireza,25,0,30,5
1649870369997,MATH 120A,A01,085445,Eggers; John Dietrich,27,0,35,8
1649870369997,MATH 120A,A02,085446,Eggers; John Dietrich,30,0,35,5
1649870376024,MATH 142B,A01,084149,Verstraete; Jacques Allan,3,0,30,27
1649870376024,MATH 142B,A02,084150,Verstraete; Jacques Allan,23,0,30,7
1649870382055,MATH 170A,A01,083459,Nie; Jiawang,5,0,30,25
1649870382055,MATH 170A,A02,083460,Nie; Jiawang,23,0,30,7
1649870382055,MATH 170A,A03,083461,Nie; Jiawang,23,0,30,7
1649870388079,MATH 193B,A01,083463,Staff,12,0,30,18
1649870388079,MATH 193B,A02,083464,Staff,19,0,30,11
1649870388079,MATH 193B,A03,083465,Staff,26,0,30,4
1649870394128,COGS 2,A01,083966,Boyle; Mary E. T.,26,0,30,4
1649870400161,COGS 9,A01,083968,Staff,56,0,60,4
1649870406184,COGS 14B,A01,083970,Staff,46,0,50,4
1649870412211,COGS 17,A01,092679,Staff,72,0,75,3
1649870418238,COGS 100,A01,083972,Staff,44,0,60,16
1649870430283,COGS 101C,A01,083976,Staff,24,0,30,6
1649870436305,COGS 102A,A01,083978,Johnson; Christine M.,22,0,30,8
1649870442332,COGS 107B,A01,083980,Staff,27,0,50,23
1649870448355,COGS 115,A01,083982,Staff,19,0,30,11
1649870454381,COGS 118B,A01,083367,Staff,0,0,40,40
1649870460407,COGS 172,A01,083984,Provenzano; Emily Kara,18,0,30,12
1649870466431,COGS 177,A00,083368,Staff,0,0,30,30
1649870472459,COGS 186,A01,083986,Staff,25,0,40,15
1649870478490,COGS 187A,A01,083988,Boyle; Mary E. T.,38,0,60,22
1649870484528,CSE 8A,A50,084003,Miranda; Gregory Joseph,8,0,15,7
1649870490622,CSE 11,A01,084005,Miranda; Gregory Joseph,48,0,55,7
1649870496652,CSE 20,A01,084007,Staff,15,0,20,5
1649870502679,CSE 21,A01,084009,Staff,32,0,50,18
1649870508704,CSE 30,A01,083370,Cao; Yingjun,15,0,40,25
1649870514735,CSE 100,A01,083372,Cao; Yingjun,8,0,40,32
1649870520771,CSE 101,A01,084011,Staff,0,25,40,40
1649870526802,CSE 141,A01,083374,Eldon; John,0,30,75,75
1649870532838,CSE 141L,A01,083376,Eldon; John,0,34,75,75
1649870538862,CSE 175,A01,084013,Kumar; Rakesh,23,0,25,2
1649870544898,CSE 190,A00,092508,Staff,15,0,15,0
1649870550923,ECE 5,A01,084049,Morris; Karcher William,17,0,20,3
1649870556947,ECE 100,A01,084051,Baghdadchi; Saharnaz,14,0,20,6
1649870556947,ECE 100,A02,091916,Baghdadchi; Saharnaz,18,0,20,2
1649870562974,ECE 101,A01,084053,Baghdadchi; Saharnaz,23,0,37,14
1649870562974,ECE 101,A02,084054,Baghdadchi; Saharnaz,37,0,37,0
1649870569020,ECE 107,A01,083390,Staff,31,0,40,9
1649870575041,ECE 148,A01,084056,Silberman; Jack,7,0,12,5
1649870581073,ECE 180,A00,083391,Abi Samra; Nicholas Camill,27,0,30,3
1649870581073,ECE 180,B00,083392,Abi Samra; Nicholas Camill,26,0,30,4
1649870587101,MATH 10B,A01,084110,Staff,18,0,30,12
1649870587101,MATH 10B,A02,084111,Staff,29,0,30,1
1649870587101,MATH 10B,A03,084112,Staff,29,0,30,1
1649870593129,MATH 10C,A01,083443,Staff,18,0,30,12
1649870593129,MATH 10C,A02,083444,Staff,22,0,30,8
1649870593129,MATH 10C,B01,084114,Staff,26,0,30,4
1649870593129,MATH 10C,B02,084115,Staff,30,0,30,0
1649870599160,MATH 18,A01,084117,Harel; Guershon,28,0,30,2
1649870599160,MATH 18,A02,084119,Harel; Guershon,29,0,30,1
1649870599160,MATH 18,A03,084120,Harel; Guershon,30,0,30,0
1649870599160,MATH 18,A04,084121,Harel; Guershon,30,0,30,0
1649870605189,MATH 20B,A01,084124,Um; Ko Woon,33,0,35,2
1649870605189,MATH 20B,B01,084126,Um; Ko Woon,35,0,35,0
1649870611241,MATH 20C,A01,083446,Hammock; Frances H,26,0,30,4
1649870611241,MATH 20C,A02,083447,Hammock; Frances H,29,0,30,1
1649870611241,MATH 20C,A03,083448,Hammock; Frances H,30,0,30,0
1649870611241,MATH 20C,A04,083449,Hammock; Frances H,30,0,30,0
1649870611241,MATH 20C,B01,083451,Hammock; Frances H,29,0,30,1
1649870611241,MATH 20C,B02,083452,Hammock; Frances H,29,0,30,1
1649870611241,MATH 20C,B03,083453,Hammock; Frances H,30,0,30,0
1649870611241,MATH 20C,B04,083454,Hammock; Frances H,30,0,30,0
1649870617279,MATH 20D,A01,084128,Staff,29,0,30,1
1649870617279,MATH 20D,A02,084129,Staff,30,0,30,0
1649870617279,MATH 20D,A03,084130,Staff,29,0,30,1
1649870617279,MATH 20D,B01,084133,Staff,28,0,30,2
1649870617279,MATH 20D,B02,084134,Staff,30,0,30,0
1649870617279,MATH 20D,B03,084135,Staff,30,0,30,0
1649870623318,MATH 20E,A01,084138,Staff,25,0,30,5
1649870623318,MATH 20E,A02,084139,Staff,28,0,30,2
1649870623318,MATH 20E,A03,084140,Staff,27,0,30,3
1649870623318,MATH 20E,A04,084141,Staff,29,0,30,1
1649870629342,MATH 102,A01,084143,Harel; Guershon,24,0,30,6
1649870629342,MATH 102,A02,084144,Harel; Guershon,24,0,30,6
1649870635372,MATH 103B,A01,083456,Staff,0,2,30,30
1649870635372,MATH 103B,A02,083457,Staff,13,0,30,17
1649870641400,MATH 109,A01,084146,Salehi Golsefidy; Alireza,29,0,30,1
1649870641400,MATH 109,A02,084147,Salehi Golsefidy; Alireza,25,0,30,5
1649870647430,MATH 120A,A01,085445,Eggers; John Dietrich,27,0,35,8
1649870647430,MATH 120A,A02,085446,Eggers; John Dietrich,30,0,35,5
1649870653458,MATH 142B,A01,084149,Verstraete; Jacques Allan,3,0,30,27
1649870653458,MATH 142B,A02,084150,Verstraete; Jacques Allan,23,0,30,7
1649870659484,MATH 170A,A01,083459,Nie; Jiawang,5,0,30,25
1649870659484,MATH 170A,A02,083460,Nie; Jiawang,23,0,30,7
1649870659484,MATH 170A,A03,083461,Nie; Jiawang,23,0,30,7
1649870665506,MATH 193B,A01,083463,Staff,12,0,30,18
1649870665506,MATH 193B,A02,083464,Staff,19,0,30,11
1649870665506,MATH 193B,A03,083465,Staff,26,0,30,4
1649870671598,COGS 2,A01,083966,Boyle; Mary E. T.,24,0,30,6
1649870677623,COGS 9,A01,083968,Staff,55,0,60,5
1649870683645,COGS 14B,A01,083970,Staff,46,0,50,4
1649870689679,COGS 17,A01,092679,Staff,72,0,75,3
1649870695707,COGS 100,A01,083972,Staff,44,0,60,16
1649870707765,COGS 101C,A01,083976,Staff,24,0,30,6
1649870713793,COGS 102A,A01,083978,Johnson; Christine M.,22,0,30,8
1649870719816,COGS 107B,A01,083980,Staff,27,0,50,23
1649870725852,COGS 115,A01,083982,Staff,19,0,30,11
1649870731879,COGS 118B,A01,083367,Staff,0,0,40,40
1649870737903,COGS 172,A01,083984,Provenzano; Emily Kara,18,0,30,12
1649870744029,COGS 177,A00,083368,Staff,0,2,30,30
1649870750061,COGS 186,A01,083986,Staff,25,0,40,15
1649870756086,COGS 187A,A01,083988,Boyle; Mary E. T.,38,0,60,22
1649870762113,CSE 8A,A50,084003,Miranda; Gregory Joseph,8,0,15,7
1649870768139,CSE 11,A01,084005,Miranda; Gregory Joseph,48,0,55,7
1649870774171,CSE 20,A01,084007,Staff,15,0,20,5
1649870780210,CSE 21,A01,084009,Staff,31,0,50,19
1649870786233,CSE 30,A01,083370,Cao; Yingjun,15,0,40,25
1649870792257,CSE 100,A01,083372,Cao; Yingjun,8,0,40,32
1649870798280,CSE 101,A01,084011,Staff,0,25,40,40
1649870804316,CSE 141,A01,083374,Eldon; John,0,30,75,75
1649870810345,CSE 141L,A01,083376,Eldon; John,0,34,75,75
1649870816369,CSE 175,A01,084013,Kumar; Rakesh,23,0,25,2
1649870822400,CSE 190,A00,092508,Staff,15,0,15,0
1649870828432,ECE 5,A01,084049,Morris; Karcher William,17,0,20,3
1649870834456,ECE 100,A01,084051,Baghdadchi; Saharnaz,14,0,20,6
1649870834456,ECE 100,A02,091916,Baghdadchi; Saharnaz,18,0,20,2
1649870840482,ECE 101,A01,084053,Baghdadchi; Saharnaz,23,0,37,14
1649870840482,ECE 101,A02,084054,Baghdadchi; Saharnaz,37,0,37,0
1649870846516,ECE 107,A01,083390,Staff,31,0,40,9
1649870852546,ECE 148,A01,084056,Silberman; Jack,7,0,12,5
1649870858570,ECE 180,A00,083391,Abi Samra; Nicholas Camill,27,0,30,3
1649870858570,ECE 180,B00,083392,Abi Samra; Nicholas Camill,26,0,30,4
1649870864599,MATH 10B,A01,084110,Staff,18,0,30,12
1649870864599,MATH 10B,A02,084111,Staff,29,0,30,1
1649870864599,MATH 10B,A03,084112,Staff,29,0,30,1
1649870870628,MATH 10C,A01,083443,Staff,18,0,30,12
1649870870628,MATH 10C,A02,083444,Staff,22,0,30,8
1649870870628,MATH 10C,B01,084114,Staff,26,0,30,4
1649870870628,MATH 10C,B02,084115,Staff,30,0,30,0
1649870876670,MATH 18,A01,084117,Harel; Guershon,27,0,30,3
1649870876670,MATH 18,A02,084119,Harel; Guershon,29,0,30,1
1649870876670,MATH 18,A03,084120,Harel; Guershon,30,0,30,0
1649870876670,MATH 18,A04,084121,Harel; Guershon,30,0,30,0
1649870882693,MATH 20B,A01,084124,Um; Ko Woon,33,0,35,2
1649870882693,MATH 20B,B01,084126,Um; Ko Woon,35,0,35,0
1649870888727,MATH 20C,A01,083446,Hammock; Frances H,26,0,30,4
1649870888727,MATH 20C,A02,083447,Hammock; Frances H,29,0,30,1
1649870888727,MATH 20C,A03,083448,Hammock; Frances H,30,0,30,0
1649870888727,MATH 20C,A04,083449,Hammock; Frances H,30,0,30,0
1649870888727,MATH 20C,B01,083451,Hammock; Frances H,29,0,30,1
1649870888727,MATH 20C,B02,083452,Hammock; Frances H,29,0,30,1
1649870888727,MATH 20C,B03,083453,Hammock; Frances H,30,0,30,0
1649870888727,MATH 20C,B04,083454,Hammock; Frances H,30,0,30,0
1649870894770,MATH 20D,A01,084128,Staff,29,0,30,1
1649870894770,MATH 20D,A02,084129,Staff,30,0,30,0
1649870894770,MATH 20D,A03,084130,Staff,29,0,30,1
1649870894770,MATH 20D,B01,084133,Staff,28,0,30,2
1649870894770,MATH 20D,B02,084134,Staff,30,0,30,0
1649870894770,MATH 20D,B03,084135,Staff,30,0,30,0
1649870900808,MATH 20E,A01,084138,Staff,25,0,30,5
1649870900808,MATH 20E,A02,084139,Staff,28,0,30,2
1649870900808,MATH 20E,A03,084140,Staff,27,0,30,3
1649870900808,MATH 20E,A04,084141,Staff,29,0,30,1
1649870906840,MATH 102,A01,084143,Harel; Guershon,24,0,30,6
1649870906840,MATH 102,A02,084144,Harel; Guershon,24,0,30,6
1649870912861,MATH 103B,A01,083456,Staff,0,2,30,30
1649870912861,MATH 103B,A02,083457,Staff,13,0,30,17
1649870918892,MATH 109,A01,084146,Salehi Golsefidy; Alireza,29,0,30,1
1649870918892,MATH 109,A02,084147,Salehi Golsefidy; Alireza,25,0,30,5
1649870924914,MATH 120A,A01,085445,Eggers; John Dietrich,27,0,35,8
1649870924914,MATH 120A,A02,085446,Eggers; John Dietrich,30,0,35,5
1649870930945,MATH 142B,A01,084149,Verstraete; Jacques Allan,3,0,30,27
1649870930945,MATH 142B,A02,084150,Verstraete; Jacques Allan,23,0,30,7
1649870936968,MATH 170A,A01,083459,Nie; Jiawang,5,0,30,25
1649870936968,MATH 170A,A02,083460,Nie; Jiawang,23,0,30,7
1649870936968,MATH 170A,A03,083461,Nie; Jiawang,23,0,30,7
1649870942992,MATH 193B,A01,083463,Staff,12,0,30,18
1649870942992,MATH 193B,A02,083464,Staff,19,0,30,11
1649870942992,MATH 193B,A03,083465,Staff,26,0,30,4
1649870949042,COGS 2,A01,083966,Boyle; Mary E. T.,24,0,30,6
1649870955067,COGS 9,A01,083968,Staff,55,0,60,5
1649870961095,COGS 14B,A01,083970,Staff,46,0,50,4
1649870967132,COGS 17,A01,092679,Staff,72,0,75,3
1649870973169,COGS 100,A01,083972,Staff,44,0,60,16
1649870985222,COGS 101C,A01,083976,Staff,24,0,30,6
1649870991256,COGS 102A,A01,083978,Johnson; Christine M.,22,0,30,8
1649870997281,COGS 107B,A01,083980,Staff,27,0,50,23
1649871003311,COGS 115,A01,083982,Staff,19,0,30,11
1649871009333,COGS 118B,A01,083367,Staff,0,0,40,40
1649871015362,COGS 172,A01,083984,Provenzano; Emily Kara,18,0,30,12
1649871021386,COGS 177,A00,083368,Staff,0,2,30,30
1649871027408,COGS 186,A01,083986,Staff,25,0,40,15
1649871033430,COGS 187A,A01,083988,Boyle; Mary E. T.,38,0,60,22
1649871039459,CSE 8A,A50,084003,Miranda; Gregory Joseph,8,0,15,7
1649871045483,CSE 11,A01,084005,Miranda; Gregory Joseph,48,0,55,7
1649871051505,CSE 20,A01,084007,Staff,15,0,20,5
1649871057535,CSE 21,A01,084009,Staff,31,0,50,19
1649871063565,CSE 30,A01,083370,Cao; Yingjun,15,0,40,25
1649871069591,CSE 100,A01,083372,Cao; Yingjun,8,0,40,32
1649871075623,CSE 101,A01,084011,Staff,0,25,40,40
1649871081650,CSE 141,A01,083374,Eldon; John,0,31,75,75
1649871087671,CSE 141L,A01,083376,Eldon; John,0,35,75,75
1649871093700,CSE 175,A01,084013,Kumar; Rakesh,23,0,25,2
1649871099726,CSE 190,A00,092508,Staff,15,0,15,0
1649871105755,ECE 5,A01,084049,Morris; Karcher William,17,0,20,3
1649871111782,ECE 100,A01,084051,Baghdadchi; Saharnaz,14,0,20,6
1649871111782,ECE 100,A02,091916,Baghdadchi; Saharnaz,18,0,20,2
1649871117805,ECE 101,A01,084053,Baghdadchi; Saharnaz,23,0,37,14
1649871117805,ECE 101,A02,084054,Baghdadchi; Saharnaz,37,0,37,0
1649871123827,ECE 107,A01,083390,Staff,31,0,40,9
1649871129863,ECE 148,A01,084056,Silberman; Jack,7,0,12,5
1649871135900,ECE 180,A00,083391,Abi Samra; Nicholas Camill,27,0,30,3
1649871135900,ECE 180,B00,083392,Abi Samra; Nicholas Camill,26,0,30,4
1649871141923,MATH 10B,A01,084110,Staff,18,0,30,12
1649871141923,MATH 10B,A02,084111,Staff,29,0,30,1
1649871141923,MATH 10B,A03,084112,Staff,29,0,30,1
1649871147951,MATH 10C,A01,083443,Staff,18,0,30,12
1649871147951,MATH 10C,A02,083444,Staff,22,0,30,8
1649871147951,MATH 10C,B01,084114,Staff,26,0,30,4
1649871147951,MATH 10C,B02,084115,Staff,30,0,30,0
1649871153979,MATH 18,A01,084117,Harel; Guershon,27,0,30,3
1649871153979,MATH 18,A02,084119,Harel; Guershon,29,0,30,1
1649871153979,MATH 18,A03,084120,Harel; Guershon,30,0,30,0
1649871153979,MATH 18,A04,084121,Harel; Guershon,30,0,30,0
1649871160002,MATH 20B,A01,084124,Um; Ko Woon,33,0,35,2
1649871160002,MATH 20B,B01,084126,Um; Ko Woon,35,0,35,0
1649871166033,MATH 20C,A01,083446,Hammock; Frances H,26,0,30,4
1649871166033,MATH 20C,A02,083447,Hammock; Frances H,29,0,30,1
1649871166033,MATH 20C,A03,083448,Hammock; Frances H,30,0,30,0
1649871166033,MATH 20C,A04,083449,Hammock; Frances H,30,0,30,0
1649871166033,MATH 20C,B01,083451,Hammock; Frances H,29,0,30,1
1649871166033,MATH 20C,B02,083452,Hammock; Frances H,29,0,30,1
1649871166033,MATH 20C,B03,083453,Hammock; Frances H,30,0,30,0
1649871166033,MATH 20C,B04,083454,Hammock; Frances H,30,0,30,0
1649871172062,MATH 20D,A01,084128,Staff,29,0,30,1
1649871172062,MATH 20D,A02,084129,Staff,30,0,30,0
1649871172062,MATH 20D,A03,084130,Staff,29,0,30,1
1649871172062,MATH 20D,B01,084133,Staff,28,0,30,2
1649871172062,MATH 20D,B02,084134,Staff,30,0,30,0
1649871172062,MATH 20D,B03,084135,Staff,30,0,30,0
1649871178095,MATH 20E,A01,084138,Staff,25,0,30,5
1649871178095,MATH 20E,A02,084139,Staff,28,0,30,2
1649871178095,MATH 20E,A03,084140,Staff,27,0,30,3
1649871178095,MATH 20E,A04,084141,Staff,29,0,30,1
1649871184133,MATH 102,A01,084143,Harel; Guershon,24,0,30,6
1649871184133,MATH 102,A02,084144,Harel; Guershon,24,0,30,6
1649871190155,MATH 103B,A01,083456,Staff,0,2,30,30
1649871190155,MATH 103B,A02,083457,Staff,13,0,30,17
1649871196183,MATH 109,A01,084146,Salehi Golsefidy; Alireza,29,0,30,1
1649871196183,MATH 109,A02,084147,Salehi Golsefidy; Alireza,25,0,30,5
1649871202211,MATH 120A,A01,085445,Eggers; John Dietrich,27,0,35,8
1649871202211,MATH 120A,A02,085446,Eggers; John Dietrich,30,0,35,5
1649871208234,MATH 142B,A01,084149,Verstraete; Jacques Allan,3,0,30,27
1649871208234,MATH 142B,A02,084150,Verstraete; Jacques Allan,23,0,30,7
1649871214257,MATH 170A,A01,083459,Nie; Jiawang,5,0,30,25
1649871214257,MATH 170A,A02,083460,Nie; Jiawang,23,0,30,7
1649871214257,MATH 170A,A03,083461,Nie; Jiawang,23,0,30,7
1649871220282,MATH 193B,A01,083463,Staff,12,0,30,18
1649871220282,MATH 193B,A02,083464,Staff,19,0,30,11
1649871220282,MATH 193B,A03,083465,Staff,26,0,30,4
1649871226340,COGS 2,A01,083966,Boyle; Mary E. T.,22,0,30,8
1649871232366,COGS 9,A01,083968,Staff,54,0,60,6
1649871238389,COGS 14B,A01,083970,Staff,46,0,50,4
1649871244415,COGS 17,A01,092679,Staff,72,0,75,3
1649871250447,COGS 100,A01,083972,Staff,43,0,60,17
1649871262498,COGS 101C,A01,083976,Staff,24,0,30,6
1649871268524,COGS 102A,A01,083978,Johnson; Christine M.,22,0,30,8
1649871274550,COGS 107B,A01,083980,Staff,27,0,50,23
1649871280581,COGS 115,A01,083982,Staff,19,0,30,11
1649871286608,COGS 118B,A01,083367,Staff,0,0,40,40
1649871292631,COGS 172,A01,083984,Provenzano; Emily Kara,18,0,30,12
1649871298657,COGS 177,A00,083368,Staff,0,2,30,30
1649871304679,COGS 186,A01,083986,Staff,25,0,40,15
1649871310703,COGS 187A,A01,083988,Boyle; Mary E. T.,38,0,60,22
1649871316734,CSE 8A,A50,084003,Miranda; Gregory Joseph,8,0,15,7
1649871322765,CSE 11,A01,084005,Miranda; Gregory Joseph,47,0,55,8
1649871328802,CSE 20,A01,084007,Staff,15,0,20,5
1649871334826,CSE 21,A01,084009,Staff,31,0,50,19
1649871340927,CSE 30,A01,083370,Cao; Yingjun,15,0,40,25
1649871346949,CSE 100,A01,083372,Cao; Yingjun,8,0,40,32
1649871352979,CSE 101,A01,084011,Staff,0,25,40,40
1649871359009,CSE 141,A01,083374,Eldon; John,0,31,75,75
1649871365031,CSE 141L,A01,083376,Eldon; John,0,35,75,75
1649871371054,CSE 175,A01,084013,Kumar; Rakesh,23,0,25,2
1649871377087,CSE 190,A00,092508,Staff,15,0,15,0
1649871383109,ECE 5,A01,084049,Morris; Karcher William,17,0,20,3
1649871389134,ECE 100,A01,084051,Baghdadchi; Saharnaz,14,0,20,6
1649871389134,ECE 100,A02,091916,Baghdadchi; Saharnaz,18,0,20,2
1649871395156,ECE 101,A01,084053,Baghdadchi; Saharnaz,23,0,37,14
1649871395156,ECE 101,A02,084054,Baghdadchi; Saharnaz,37,0,37,0
1649871401190,ECE 107,A01,083390,Staff,31,0,40,9
1649871407216,ECE 148,A01,084056,Silberman; Jack,7,0,12,5
1649871413242,ECE 180,A00,083391,Abi Samra; Nicholas Camill,27,0,30,3
1649871413242,ECE 180,B00,083392,Abi Samra; Nicholas Camill,26,0,30,4
1649871419275,MATH 10B,A01,084110,Staff,18,0,30,12
1649871419275,MATH 10B,A02,084111,Staff,29,0,30,1
1649871419275,MATH 10B,A03,084112,Staff,29,0,30,1
1649871425302,MATH 10C,A01,083443,Staff,18,0,30,12
1649871425302,MATH 10C,A02,083444,Staff,22,0,30,8
1649871425302,MATH 10C,B01,084114,Staff,26,0,30,4
1649871425302,MATH 10C,B02,084115,Staff,30,0,30,0
1649871431339,MATH 18,A01,084117,Harel; Guershon,27,0,30,3
1649871431339,MATH 18,A02,084119,Harel; Guershon,29,0,30,1
1649871431339,MATH 18,A03,084120,Harel; Guershon,30,0,30,0
1649871431339,MATH 18,A04,084121,Harel; Guershon,30,0,30,0
1649871437362,MATH 20B,A01,084124,Um; Ko Woon,33,0,35,2
1649871437362,MATH 20B,B01,084126,Um; Ko Woon,35,0,35,0
1649871443389,MATH 20C,A01,083446,Hammock; Frances H,25,0,30,5
1649871443389,MATH 20C,A02,083447,Hammock; Frances H,29,0,30,1
1649871443389,MATH 20C,A03,083448,Hammock; Frances H,30,0,30,0
1649871443389,MATH 20C,A04,083449,Hammock; Frances H,30,0,30,0
1649871443389,MATH 20C,B01,083451,Hammock; Frances H,29,0,30,1
1649871443389,MATH 20C,B02,083452,Hammock; Frances H,29,0,30,1
1649871443389,MATH 20C,B03,083453,Hammock; Frances H,30,0,30,0
1649871443389,MATH 20C,B04,083454,Hammock; Frances H,30,0,30,0
1649871449414,MATH 20D,A01,084128,Staff,29,0,30,1
1649871449414,MATH 20D,A02,084129,Staff,30,0,30,0
1649871449414,MATH 20D,A03,084130,Staff,29,0,30,1
1649871449414,MATH 20D,B01,084133,Staff,28,0,30,2
1649871449414,MATH 20D,B02,084134,Staff,30,0,30,0
1649871449414,MATH 20D,B03,084135,Staff,30,0,30,0
1649871455438,MATH 20E,A01,084138,Staff,25,0,30,5
1649871455438,MATH 20E,A02,084139,Staff,28,0,30,2
1649871455438,MATH 20E,A03,084140,Staff,26,0,30,4
1649871455438,MATH 20E,A04,084141,Staff,29,0,30,1
1649871461462,MATH 102,A01,084143,Harel; Guershon,24,0,30,6
1649871461462,MATH 102,A02,084144,Harel; Guershon,24,0,30,6
1649871467492,MATH 103B,A01,083456,Staff,0,2,30,30
1649871467492,MATH 103B,A02,083457,Staff,13,0,30,17
1649871473516,MATH 109,A01,084146,Salehi Golsefidy; Alireza,29,0,30,1
1649871473516,MATH 109,A02,084147,Salehi Golsefidy; Alireza,25,0,30,5
1649871479543,MATH 120A,A01,085445,Eggers; John Dietrich,27,0,35,8
1649871479543,MATH 120A,A02,085446,Eggers; John Dietrich,30,0,35,5
1649871485566,MATH 142B,A01,084149,Verstraete; Jacques Allan,3,0,30,27
1649871485566,MATH 142B,A02,084150,Verstraete; Jacques Allan,23,0,30,7
1649871491593,MATH 170A,A01,083459,Nie; Jiawang,5,0,30,25
1649871491593,MATH 170A,A02,083460,Nie; Jiawang,22,0,30,8
1649871491593,MATH 170A,A03,083461,Nie; Jiawang,23,0,30,7
1649871497622,MATH 193B,A01,083463,Staff,12,0,30,18
1649871497622,MATH 193B,A02,083464,Staff,19,0,30,11
1649871497622,MATH 193B,A03,083465,Staff,26,0,30,4
1649871503690,COGS 2,A01,083966,Boyle; Mary E. T.,22,0,30,8
1649871509728,COGS 9,A01,083968,Staff,54,0,60,6
1649871515754,COGS 14B,A01,083970,Staff,46,0,50,4
1649871521782,COGS 17,A01,092679,Staff,72,0,75,3
1649871527810,COGS 100,A01,083972,Staff,43,0,60,17
1649871539855,COGS 101C,A01,083976,Staff,24,0,30,6
1649871545882,COGS 102A,A01,083978,Johnson; Christine M.,22,0,30,8
1649871551907,COGS 107B,A01,083980,Staff,27,0,50,23
1649871557933,COGS 115,A01,083982,Staff,19,0,30,11
1649871563959,COGS 118B,A01,083367,Staff,0,0,40,40
1649871569987,COGS 172,A01,083984,Provenzano; Emily Kara,18,0,30,12
1649871576015,COGS 177,A00,083368,Staff,0,2,30,30
1649871582038,COGS 186,A01,083986,Staff,25,0,40,15
1649871588065,COGS 187A,A01,083988,Boyle; Mary E. T.,38,0,60,22
1649871594087,CSE 8A,A50,084003,Miranda; Gregory Joseph,8,0,15,7
1649871600117,CSE 11,A01,084005,Miranda; Gregory Joseph,47,0,55,8
1649871606145,CSE 20,A01,084007,Staff,15,0,20,5
1649871612170,CSE 21,A01,084009,Staff,31,0,50,19
1649871618197,CSE 30,A01,083370,Cao; Yingjun,15,0,40,25
1649871624225,CSE 100,A01,083372,Cao; Yingjun,8,0,40,32
1649871630259,CSE 101,A01,084011,Staff,0,25,40,40
1649871636283,CSE 141,A01,083374,Eldon; John,0,31,75,75
1649871642306,CSE 141L,A01,083376,Eldon; John,0,35,75,75
1649871648331,CSE 175,A01,084013,Kumar; Rakesh,23,0,25,2
1649871654354,CSE 190,A00,092508,Staff,15,0,15,0
1649871660378,ECE 5,A01,084049,Morris; Karcher William,17,0,20,3
1649871666407,ECE 100,A01,084051,Baghdadchi; Saharnaz,14,0,20,6
1649871666407,ECE 100,A02,091916,Baghdadchi; Saharnaz,18,0,20,2
1649871672431,ECE 101,A01,084053,Baghdadchi; Saharnaz,23,0,37,14
1649871672431,ECE 101,A02,084054,Baghdadchi; Saharnaz,37,0,37,0
1649871678463,ECE 107,A01,083390,Staff,31,0,40,9
1649871684494,ECE 148,A01,084056,Silberman; Jack,7,0,12,5
1649871690518,ECE 180,A00,083391,Abi Samra; Nicholas Camill,27,0,30,3
1649871690518,ECE 180,B00,083392,Abi Samra; Nicholas Camill,26,0,30,4
1649871696543,MATH 10B,A01,084110,Staff,18,0,30,12
1649871696543,MATH 10B,A02,084111,Staff,29,0,30,1
1649871696543,MATH 10B,A03,084112,Staff,29,0,30,1
1649871702579,MATH 10C,A01,083443,Staff,17,0,30,13
1649871702579,MATH 10C,A02,083444,Staff,22,0,30,8
1649871702579,MATH 10C,B01,084114,Staff,26,0,30,4
1649871702579,MATH 10C,B02,084115,Staff,30,0,30,0
1649871708602,MATH 18,A01,084117,Harel; Guershon,27,0,30,3
1649871708602,MATH 18,A02,084119,Harel; Guershon,29,0,30,1
1649871708602,MATH 18,A03,084120,Harel; Guershon,30,0,30,0
1649871708602,MATH 18,A04,084121,Harel; Guershon,30,0,30,0
1649871714632,MATH 20B,A01,084124,Um; Ko Woon,33,0,35,2
1649871714632,MATH 20B,B01,084126,Um; Ko Woon,35,0,35,0
1649871720668,MATH 20C,A01,083446,Hammock; Frances H,25,0,30,5
1649871720668,MATH 20C,A02,083447,Hammock; Frances H,29,0,30,1
1649871720668,MATH 20C,A03,083448,Hammock; Frances H,30,0,30,0
1649871720668,MATH 20C,A04,083449,Hammock; Frances H,30,0,30,0
1649871720668,MATH 20C,B01,083451,Hammock; Frances H,29,0,30,1
1649871720668,MATH 20C,B02,083452,Hammock; Frances H,29,0,30,1
1649871720668,MATH 20C,B03,083453,Hammock; Frances H,30,0,30,0
1649871720668,MATH 20C,B04,083454,Hammock; Frances H,30,0,30,0
1649871726708,MATH 20D,A01,084128,Staff,29,0,30,1
1649871726708,MATH 20D,A02,084129,Staff,30,0,30,0
1649871726708,MATH 20D,A03,084130,Staff,29,0,30,1
1649871726708,MATH 20D,B01,084133,Staff,28,0,30,2
1649871726708,MATH 20D,B02,084134,Staff,30,0,30,0
1649871726708,MATH 20D,B03,084135,Staff,30,0,30,0
1649871732747,MATH 20E,A01,084138,Staff,25,0,30,5
1649871732747,MATH 20E,A02,084139,Staff,28,0,30,2
1649871732747,MATH 20E,A03,084140,Staff,26,0,30,4
1649871732747,MATH 20E,A04,084141,Staff,29,0,30,1
1649871738785,MATH 102,A01,084143,Harel; Guershon,24,0,30,6
1649871738785,MATH 102,A02,084144,Harel; Guershon,24,0,30,6
1649871744808,MATH 103B,A01,083456,Staff,0,2,30,30
1649871744808,MATH 103B,A02,083457,Staff,13,0,30,17
1649871750832,MATH 109,A01,084146,Salehi Golsefidy; Alireza,29,0,30,1
1649871750832,MATH 109,A02,084147,Salehi Golsefidy; Alireza,25,0,30,5
1649871756854,MATH 120A,A01,085445,Eggers; John Dietrich,27,0,35,8
1649871756854,MATH 120A,A02,085446,Eggers; John Dietrich,30,0,35,5
1649871762882,MATH 142B,A01,084149,Verstraete; Jacques Allan,1,0,30,29
1649871762882,MATH 142B,A02,084150,Verstraete; Jacques Allan,23,0,30,7
1649871768916,MATH 170A,A01,083459,Nie; Jiawang,5,0,30,25
1649871768916,MATH 170A,A02,083460,Nie; Jiawang,22,0,30,8
1649871768916,MATH 170A,A03,083461,Nie; Jiawang,23,0,30,7
1649871774938,MATH 193B,A01,083463,Staff,12,0,30,18
1649871774938,MATH 193B,A02,083464,Staff,19,0,30,11
1649871774938,MATH 193B,A03,083465,Staff,26,0,30,4
1649871781016,COGS 2,A01,083966,Boyle; Mary E. T.,22,0,30,8
1649871787046,COGS 9,A01,083968,Staff,54,0,60,6
1649871793071,COGS 14B,A01,083970,Staff,46,0,50,4
1649871799095,COGS 17,A01,092679,Staff,72,0,75,3
1649871805126,COGS 100,A01,083972,Staff,43,0,60,17
1649871817179,COGS 101C,A01,083976,Staff,24,0,30,6
1649871823216,COGS 102A,A01,083978,Johnson; Christine M.,22,0,30,8
1649871829245,COGS 107B,A01,083980,Staff,27,0,50,23
1649871835270,COGS 115,A01,083982,Staff,19,0,30,11
1649871841299,COGS 118B,A01,083367,Staff,0,0,40,40
1649871847329,COGS 172,A01,083984,Provenzano; Emily Kara,18,0,30,12
1649871853353,COGS 177,A00,083368,Staff,0,2,30,30
1649871859387,COGS 186,A01,083986,Staff,25,0,40,15
1649871865411,COGS 187A,A01,083988,Boyle; Mary E. T.,38,0,60,22
1649871871436,CSE 8A,A50,084003,Miranda; Gregory Joseph,8,0,15,7
1649871877463,CSE 11,A01,084005,Miranda; Gregory Joseph,47,0,55,8
1649871883488,CSE 20,A01,084007,Staff,15,0,20,5
1649871889522,CSE 21,A01,084009,Staff,31,0,50,19
1649871895546,CSE 30,A01,083370,Cao; Yingjun,15,0,40,25
1649871901569,CSE 100,A01,083372,Cao; Yingjun,8,0,40,32
1649871907598,CSE 101,A01,084011,Staff,0,25,40,40
1649871913626,CSE 141,A01,083374,Eldon; John,0,31,75,75
1649871919648,CSE 141L,A01,083376,Eldon; John,0,35,75,75
1649871925675,CSE 175,A01,084013,Kumar; Rakesh,23,0,25,2
1649871931700,CSE 190,A00,092508,Staff,15,0,15,0
1649871937856,ECE 5,A01,084049,Morris; Karcher William,17,0,20,3
1649871943885,ECE 100,A01,084051,Baghdadchi; Saharnaz,13,0,20,7
1649871943885,ECE 100,A02,091916,Baghdadchi; Saharnaz,18,0,20,2
1649871949910,ECE 101,A01,084053,Baghdadchi; Saharnaz,21,0,37,16
1649871949910,ECE 101,A02,084054,Baghdadchi; Saharnaz,37,0,37,0
1649871955938,ECE 107,A01,083390,Staff,31,0,40,9
1649871961964,ECE 148,A01,084056,Silberman; Jack,7,0,12,5
1649871967990,ECE 180,A00,083391,Abi Samra; Nicholas Camill,27,0,30,3
1649871967990,ECE 180,B00,083392,Abi Samra; Nicholas Camill,26,0,30,4
1649871974024,MATH 10B,A01,084110,Staff,18,0,30,12
1649871974024,MATH 10B,A02,084111,Staff,29,0,30,1
1649871974024,MATH 10B,A03,084112,Staff,29,0,30,1
1649871980052,MATH 10C,A01,083443,Staff,17,0,30,13
1649871980052,MATH 10C,A02,083444,Staff,22,0,30,8
1649871980052,MATH 10C,B01,084114,Staff,26,0,30,4
1649871980052,MATH 10C,B02,084115,Staff,30,0,30,0
1649871986079,MATH 18,A01,084117,Harel; Guershon,27,0,30,3
1649871986079,MATH 18,A02,084119,Harel; Guershon,29,0,30,1
1649871986079,MATH 18,A03,084120,Harel; Guershon,30,0,30,0
1649871986079,MATH 18,A04,084121,Harel; Guershon,30,0,30,0
1649871992110,MATH 20B,A01,084124,Um; Ko Woon,33,0,35,2
1649871992110,MATH 20B,B01,084126,Um; Ko Woon,35,0,35,0
1649871998135,MATH 20C,A01,083446,Hammock; Frances H,25,0,30,5
1649871998135,MATH 20C,A02,083447,Hammock; Frances H,29,0,30,1
1649871998135,MATH 20C,A03,083448,Hammock; Frances H,30,0,30,0
1649871998135,MATH 20C,A04,083449,Hammock; Frances H,30,0,30,0
1649871998135,MATH 20C,B01,083451,Hammock; Frances H,29,0,30,1
1649871998135,MATH 20C,B02,083452,Hammock; Frances H,29,0,30,1
1649871998135,MATH 20C,B03,083453,Hammock; Frances H,30,0,30,0
1649871998135,MATH 20C,B04,083454,Hammock; Frances H,30,0,30,0
1649872004160,MATH 20D,A01,084128,Staff,29,0,30,1
1649872004160,MATH 20D,A02,084129,Staff,30,0,30,0
1649872004160,MATH 20D,A03,084130,Staff,29,0,30,1
1649872004160,MATH 20D,B01,084133,Staff,28,0,30,2
1649872004160,MATH 20D,B02,084134,Staff,30,0,30,0
1649872004160,MATH 20D,B03,084135,Staff,30,0,30,0
1649872010187,MATH 20E,A01,084138,Staff,25,0,30,5
1649872010187,MATH 20E,A02,084139,Staff,28,0,30,2
1649872010187,MATH 20E,A03,084140,Staff,26,0,30,4
1649872010187,MATH 20E,A04,084141,Staff,29,0,30,1
1649872016214,MATH 102,A01,084143,Harel; Guershon,24,0,30,6
1649872016214,MATH 102,A02,084144,Harel; Guershon,24,0,30,6
1649872022237,MATH 103B,A01,083456,Staff,0,2,30,30
1649872022237,MATH 103B,A02,083457,Staff,12,0,30,18
1649872028269,MATH 109,A01,084146,Salehi Golsefidy; Alireza,29,0,30,1
1649872028269,MATH 109,A02,084147,Salehi Golsefidy; Alireza,25,0,30,5
1649872034290,MATH 120A,A01,085445,Eggers; John Dietrich,27,0,35,8
1649872034290,MATH 120A,A02,085446,Eggers; John Dietrich,30,0,35,5
1649872040315,MATH 142B,A01,084149,Verstraete; Jacques Allan,0,0,30,30
1649872040315,MATH 142B,A02,084150,Verstraete; Jacques Allan,23,0,30,7
1649872046338,MATH 170A,A01,083459,Nie; Jiawang,5,0,30,25
1649872046338,MATH 170A,A02,083460,Nie; Jiawang,22,0,30,8
1649872046338,MATH 170A,A03,083461,Nie; Jiawang,23,0,30,7
1649872052363,MATH 193B,A01,083463,Staff,12,0,30,18
1649872052363,MATH 193B,A02,083464,Staff,19,0,30,11
1649872052363,MATH 193B,A03,083465,Staff,26,0,30,4
1649872058412,COGS 2,A01,083966,Boyle; Mary E. T.,22,0,30,8
1649872064435,COGS 9,A01,083968,Staff,54,0,60,6
1649872070458,COGS 14B,A01,083970,Staff,46,0,50,4
1649872076504,COGS 17,A01,092679,Staff,72,0,75,3
1649872082532,COGS 100,A01,083972,Staff,43,0,60,17
1649872094599,COGS 101C,A01,083976,Staff,24,0,30,6
1649872100621,COGS 102A,A01,083978,Johnson; Christine M.,22,0,30,8
1649872106647,COGS 107B,A01,083980,Staff,27,0,50,23
1649872112681,COGS 115,A01,083982,Staff,19,0,30,11
1649872118705,COGS 118B,A01,083367,Staff,0,0,40,40
1649872124736,COGS 172,A01,083984,Provenzano; Emily Kara,18,0,30,12
1649872130764,COGS 177,A00,083368,Staff,0,2,30,30
1649872136787,COGS 186,A01,083986,Staff,25,0,40,15
1649872142811,COGS 187A,A01,083988,Boyle; Mary E. T.,38,0,60,22
1649872148836,CSE 8A,A50,084003,Miranda; Gregory Joseph,8,0,15,7
1649872154859,CSE 11,A01,084005,Miranda; Gregory Joseph,47,0,55,8
1649872160881,CSE 20,A01,084007,Staff,15,0,20,5
1649872166906,CSE 21,A01,084009,Staff,31,0,50,19
1649872172928,CSE 30,A01,083370,Cao; Yingjun,15,0,40,25
1649872178950,CSE 100,A01,083372,Cao; Yingjun,8,0,40,32
1649872184973,CSE 101,A01,084011,Staff,0,25,40,40
1649872191004,CSE 141,A01,083374,Eldon; John,0,31,75,75
1649872197043,CSE 141L,A01,083376,Eldon; John,0,35,75,75
1649872203066,CSE 175,A01,084013,Kumar; Rakesh,23,0,25,2
1649872209098,CSE 190,A00,092508,Staff,15,0,15,0
1649872215123,ECE 5,A01,084049,Morris; Karcher William,17,0,20,3
1649872221156,ECE 100,A01,084051,Baghdadchi; Saharnaz,13,0,20,7
1649872221156,ECE 100,A02,091916,Baghdadchi; Saharnaz,18,0,20,2
1649872227187,ECE 101,A01,084053,Baghdadchi; Saharnaz,21,0,37,16
1649872227187,ECE 101,A02,084054,Baghdadchi; Saharnaz,37,0,37,0
1649872233214,ECE 107,A01,083390,Staff,31,0,40,9
1649872239248,ECE 148,A01,084056,Silberman; Jack,7,0,12,5
1649872245281,ECE 180,A00,083391,Abi Samra; Nicholas Camill,27,0,30,3
1649872245281,ECE 180,B00,083392,Abi Samra; Nicholas Camill,26,0,30,4
1649872251306,MATH 10B,A01,084110,Staff,18,0,30,12
1649872251306,MATH 10B,A02,084111,Staff,29,0,30,1
1649872251306,MATH 10B,A03,084112,Staff,29,0,30,1
1649872257330,MATH 10C,A01,083443,Staff,17,0,30,13
1649872257330,MATH 10C,A02,083444,Staff,22,0,30,8
1649872257330,MATH 10C,B01,084114,Staff,26,0,30,4
1649872257330,MATH 10C,B02,084115,Staff,30,0,30,0
1649872263353,MATH 18,A01,084117,Harel; Guershon,27,0,30,3
1649872263353,MATH 18,A02,084119,Harel; Guershon,29,0,30,1
1649872263353,MATH 18,A03,084120,Harel; Guershon,30,0,30,0
1649872263353,MATH 18,A04,084121,Harel; Guershon,30,0,30,0
1649872269376,MATH 20B,A01,084124,Um; Ko Woon,33,0,35,2
1649872269376,MATH 20B,B01,084126,Um; Ko Woon,35,0,35,0
1649872275405,MATH 20C,A01,083446,Hammock; Frances H,25,0,30,5
1649872275405,MATH 20C,A02,083447,Hammock; Frances H,29,0,30,1
1649872275405,MATH 20C,A03,083448,Hammock; Frances H,30,0,30,0
1649872275405,MATH 20C,A04,083449,Hammock; Frances H,30,0,30,0
1649872275405,MATH 20C,B01,083451,Hammock; Frances H,29,0,30,1
1649872275405,MATH 20C,B02,083452,Hammock; Frances H,29,0,30,1
1649872275405,MATH 20C,B03,083453,Hammock; Frances H,30,0,30,0
1649872275405,MATH 20C,B04,083454,Hammock; Frances H,30,0,30,0
1649872281441,MATH 20D,A01,084128,Staff,29,0,30,1
1649872281441,MATH 20D,A02,084129,Staff,30,0,30,0
1649872281441,MATH 20D,A03,084130,Staff,29,0,30,1
1649872281441,MATH 20D,B01,084133,Staff,28,0,30,2
1649872281441,MATH 20D,B02,084134,Staff,30,0,30,0
1649872281441,MATH 20D,B03,084135,Staff,30,0,30,0
1649872287470,MATH 20E,A01,084138,Staff,25,0,30,5
1649872287470,MATH 20E,A02,084139,Staff,28,0,30,2
1649872287470,MATH 20E,A03,084140,Staff,26,0,30,4
1649872287470,MATH 20E,A04,084141,Staff,29,0,30,1
1649872293494,MATH 102,A01,084143,Harel; Guershon,23,0,30,7
1649872293494,MATH 102,A02,084144,Harel; Guershon,24,0,30,6
1649872299521,MATH 103B,A01,083456,Staff,0,2,30,30
1649872299521,MATH 103B,A02,083457,Staff,12,0,30,18
1649872305546,MATH 109,A01,084146,Salehi Golsefidy; Alireza,29,0,30,1
1649872305546,MATH 109,A02,084147,Salehi Golsefidy; Alireza,25,0,30,5
1649872311583,MATH 120A,A01,085445,Eggers; John Dietrich,27,0,35,8
1649872311583,MATH 120A,A02,085446,Eggers; John Dietrich,30,0,35,5
1649872317606,MATH 142B,A01,084149,Verstraete; Jacques Allan,0,0,30,30
1649872317606,MATH 142B,A02,084150,Verstraete; Jacques Allan,23,0,30,7
1649872323633,MATH 170A,A01,083459,Nie; Jiawang,5,0,30,25
1649872323633,MATH 170A,A02,083460,Nie; Jiawang,22,0,30,8
1649872323633,MATH 170A,A03,083461,Nie; Jiawang,23,0,30,7
1649872329667,MATH 193B,A01,083463,Staff,12,0,30,18
1649872329667,MATH 193B,A02,083464,Staff,19,0,30,11
1649872329667,MATH 193B,A03,083465,Staff,26,0,30,4
1649872335731,COGS 2,A01,083966,Boyle; Mary E. T.,22,0,30,8
1649872341754,COGS 9,A01,083968,Staff,53,0,60,7
1649872347790,COGS 14B,A01,083970,Staff,46,0,50,4
1649872353823,COGS 17,A01,092679,Staff,71,0,75,4
1649872359853,COGS 100,A01,083972,Staff,43,0,60,17
1649872371904,COGS 101C,A01,083976,Staff,24,0,30,6
1649872377928,COGS 102A,A01,083978,Johnson; Christine M.,22,0,30,8
1649872383954,COGS 107B,A01,083980,Staff,27,0,50,23
1649872389978,COGS 115,A01,083982,Staff,19,0,30,11
1649872396013,COGS 118B,A01,083367,Staff,0,1,40,40
1649872402036,COGS 172,A01,083984,Provenzano; Emily Kara,18,0,30,12
1649872408062,COGS 177,A00,083368,Staff,0,2,30,30
1649872414085,COGS 186,A01,083986,Staff,25,0,40,15
1649872420108,COGS 187A,A01,083988,Boyle; Mary E. T.,37,0,60,23
1649872426135,CSE 8A,A50,084003,Miranda; Gregory Joseph,8,0,15,7
1649872432158,CSE 11,A01,084005,Miranda; Gregory Joseph,47,0,55,8
1649872438185,CSE 20,A01,084007,Staff,15,0,20,5
1649872444211,CSE 21,A01,084009,Staff,31,0,50,19
1649872450246,CSE 30,A01,083370,Cao; Yingjun,15,0,40,25
1649872456281,CSE 100,A01,083372,Cao; Yingjun,8,0,40,32
1649872462320,CSE 101,A01,084011,Staff,0,25,40,40
1649872468349,CSE 141,A01,083374,Eldon; John,1,31,75,74
1649872474376,CSE 141L,A01,083376,Eldon; John,1,35,75,74
1649872480400,CSE 175,A01,084013,Kumar; Rakesh,23,0,25,2
1649872486431,CSE 190,A00,092508,Staff,15,0,15,0
1649872492454,ECE 5,A01,084049,Morris; Karcher William,17,0,20,3
1649872498478,ECE 100,A01,084051,Baghdadchi; Saharnaz,13,0,20,7
1649872498478,ECE 100,A02,091916,Baghdadchi; Saharnaz,18,0,20,2
1649872504501,ECE 101,A01,084053,Baghdadchi; Saharnaz,21,0,37,16
1649872504501,ECE 101,A02,084054,Baghdadchi; Saharnaz,37,0,37,0
1649872510537,ECE 107,A01,083390,Staff,31,0,40,9
1649872516572,ECE 148,A01,084056,Silberman; Jack,7,0,12,5
1649872522600,ECE 180,A00,083391,Abi Samra; Nicholas Camill,27,0,30,3
1649872522600,ECE 180,B00,083392,Abi Samra; Nicholas Camill,26,0,30,4
1649872528633,MATH 10B,A01,084110,Staff,18,0,30,12
1649872528633,MATH 10B,A02,084111,Staff,29,0,30,1
1649872528633,MATH 10B,A03,084112,Staff,29,0,30,1
1649872534751,MATH 10C,A01,083443,Staff,17,0,30,13
1649872534751,MATH 10C,A02,083444,Staff,22,0,30,8
1649872534751,MATH 10C,B01,084114,Staff,26,0,30,4
1649872534751,MATH 10C,B02,084115,Staff,30,0,30,0
1649872540777,MATH 18,A01,084117,Harel; Guershon,27,0,30,3
1649872540777,MATH 18,A02,084119,Harel; Guershon,29,0,30,1
1649872540777,MATH 18,A03,084120,Harel; Guershon,30,0,30,0
1649872540777,MATH 18,A04,084121,Harel; Guershon,30,0,30,0
1649872546800,MATH 20B,A01,084124,Um; Ko Woon,33,0,35,2
1649872546800,MATH 20B,B01,084126,Um; Ko Woon,35,0,35,0
1649872552848,MATH 20C,A01,083446,Hammock; Frances H,25,0,30,5
1649872552848,MATH 20C,A02,083447,Hammock; Frances H,29,0,30,1
1649872552848,MATH 20C,A03,083448,Hammock; Frances H,30,0,30,0
1649872552848,MATH 20C,A04,083449,Hammock; Frances H,30,0,30,0
1649872552848,MATH 20C,B01,083451,Hammock; Frances H,29,0,30,1
1649872552848,MATH 20C,B02,083452,Hammock; Frances H,29,0,30,1
1649872552848,MATH 20C,B03,083453,Hammock; Frances H,30,0,30,0
1649872552848,MATH 20C,B04,083454,Hammock; Frances H,30,0,30,0
1649872558878,MATH 20D,A01,084128,Staff,29,0,30,1
1649872558878,MATH 20D,A02,084129,Staff,30,0,30,0
1649872558878,MATH 20D,A03,084130,Staff,29,0,30,1
1649872558878,MATH 20D,B01,084133,Staff,28,0,30,2
1649872558878,MATH 20D,B02,084134,Staff,30,0,30,0
1649872558878,MATH 20D,B03,084135,Staff,30,0,30,0
1649872564905,MATH 20E,A01,084138,Staff,25,0,30,5
1649872564905,MATH 20E,A02,084139,Staff,28,0,30,2
1649872564905,MATH 20E,A03,084140,Staff,26,0,30,4
1649872564905,MATH 20E,A04,084141,Staff,29,0,30,1
1649872570953,MATH 102,A01,084143,Harel; Guershon,23,0,30,7
1649872570953,MATH 102,A02,084144,Harel; Guershon,24,0,30,6
1649872576986,MATH 103B,A01,083456,Staff,0,2,30,30
1649872576986,MATH 103B,A02,083457,Staff,12,0,30,18
1649872583025,MATH 109,A01,084146,Salehi Golsefidy; Alireza,29,0,30,1
1649872583025,MATH 109,A02,084147,Salehi Golsefidy; Alireza,25,0,30,5
1649872589069,MATH 120A,A01,085445,Eggers; John Dietrich,26,0,35,9
1649872589069,MATH 120A,A02,085446,Eggers; John Dietrich,30,0,35,5
1649872595096,MATH 142B,A01,084149,Verstraete; Jacques Allan,0,0,30,30
1649872595096,MATH 142B,A02,084150,Verstraete; Jacques Allan,23,0,30,7
1649872601125,MATH 170A,A01,083459,Nie; Jiawang,5,0,30,25
1649872601125,MATH 170A,A02,083460,Nie; Jiawang,22,0,30,8
1649872601125,MATH 170A,A03,083461,Nie; Jiawang,23,0,30,7
1649872607157,MATH 193B,A01,083463,Staff,12,0,30,18
1649872607157,MATH 193B,A02,083464,Staff,19,0,30,11
1649872607157,MATH 193B,A03,083465,Staff,26,0,30,4
1649872613223,COGS 2,A01,083966,Boyle; Mary E. T.,22,0,30,8
1649872619246,COGS 9,A01,083968,Staff,52,0,60,8
1649872625277,COGS 14B,A01,083970,Staff,46,0,50,4
1649872631302,COGS 17,A01,092679,Staff,71,0,75,4
1649872637329,COGS 100,A01,083972,Staff,43,0,60,17
1649872649383,COGS 101C,A01,083976,Staff,23,0,30,7
1649872655413,COGS 102A,A01,083978,Johnson; Christine M.,22,0,30,8
1649872661449,COGS 107B,A01,083980,Staff,27,0,50,23
1649872667475,COGS 115,A01,083982,Staff,19,0,30,11
1649872673524,COGS 118B,A01,083367,Staff,0,1,40,40
1649872679553,COGS 172,A01,083984,Provenzano; Emily Kara,18,0,30,12
1649872685581,COGS 177,A00,083368,Staff,0,2,30,30
1649872691629,COGS 186,A01,083986,Staff,25,0,40,15
1649872697651,COGS 187A,A01,083988,Boyle; Mary E. T.,36,0,60,24
1649872703680,CSE 8A,A50,084003,Miranda; Gregory Joseph,8,0,15,7
1649872709713,CSE 11,A01,084005,Miranda; Gregory Joseph,47,0,55,8
1649872715739,CSE 20,A01,084007,Staff,15,0,20,5
1649872721764,CSE 21,A01,084009,Staff,31,0,50,19
1649872727803,CSE 30,A01,083370,Cao; Yingjun,15,0,40,25
1649872733829,CSE 100,A01,083372,Cao; Yingjun,8,0,40,32
1649872739852,CSE 101,A01,084011,Staff,0,25,40,40
1649872745883,CSE 141,A01,083374,Eldon; John,1,32,75,74
1649872751914,CSE 141L,A01,083376,Eldon; John,1,36,75,74
1649872757940,CSE 175,A01,084013,Kumar; Rakesh,23,0,25,2
1649872763965,CSE 190,A00,092508,Staff,15,0,15,0
1649872769988,ECE 5,A01,084049,Morris; Karcher William,17,0,20,3
1649872776011,ECE 100,A01,084051,Baghdadchi; Saharnaz,13,0,20,7
1649872776011,ECE 100,A02,091916,Baghdadchi; Saharnaz,18,0,20,2
1649872782042,ECE 101,A01,084053,Baghdadchi; Saharnaz,21,0,37,16
1649872782042,ECE 101,A02,084054,Baghdadchi; Saharnaz,37,0,37,0
1649872788075,ECE 107,A01,083390,Staff,31,0,40,9
1649872794101,ECE 148,A01,084056,Silberman; Jack,7,0,12,5
1649872800138,ECE 180,A00,083391,Abi Samra; Nicholas Camill,27,0,30,3
1649872800138,ECE 180,B00,083392,Abi Samra; Nicholas Camill,26,0,30,4
1649872806169,MATH 10B,A01,084110,Staff,18,0,30,12
1649872806169,MATH 10B,A02,084111,Staff,29,0,30,1
1649872806169,MATH 10B,A03,084112,Staff,29,0,30,1
1649872812194,MATH 10C,A01,083443,Staff,17,0,30,13
1649872812194,MATH 10C,A02,083444,Staff,22,0,30,8
1649872812194,MATH 10C,B01,084114,Staff,26,0,30,4
1649872812194,MATH 10C,B02,084115,Staff,30,0,30,0
1649872818231,MATH 18,A01,084117,Harel; Guershon,27,0,30,3
1649872818231,MATH 18,A02,084119,Harel; Guershon,29,0,30,1
1649872818231,MATH 18,A03,084120,Harel; Guershon,30,0,30,0
1649872818231,MATH 18,A04,084121,Harel; Guershon,30,0,30,0
1649872824262,MATH 20B,A01,084124,Um; Ko Woon,33,0,35,2
1649872824262,MATH 20B,B01,084126,Um; Ko Woon,35,0,35,0
1649872830300,MATH 20C,A01,083446,Hammock; Frances H,25,0,30,5
1649872830300,MATH 20C,A02,083447,Hammock; Frances H,29,0,30,1
1649872830300,MATH 20C,A03,083448,Hammock; Frances H,30,0,30,0
1649872830300,MATH 20C,A04,083449,Hammock; Frances H,30,0,30,0
1649872830300,MATH 20C,B01,083451,Hammock; Frances H,29,0,30,1
1649872830300,MATH 20C,B02,083452,Hammock; Frances H,29,0,30,1
1649872830300,MATH 20C,B03,083453,Hammock; Frances H,30,0,30,0
1649872830300,MATH 20C,B04,083454,Hammock; Frances H,30,0,30,0
1649872836427,MATH 20D,A01,084128,Staff,29,0,30,1
1649872836427,MATH 20D,A02,084129,Staff,30,0,30,0
1649872836427,MATH 20D,A03,084130,Staff,29,0,30,1
1649872836427,MATH 20D,B01,084133,Staff,28,0,30,2
1649872836427,MATH 20D,B02,084134,Staff,30,0,30,0
1649872836427,MATH 20D,B03,084135,Staff,30,0,30,0
1649872842450,MATH 20E,A01,084138,Staff,25,0,30,5
1649872842450,MATH 20E,A02,084139,Staff,28,0,30,2
1649872842450,MATH 20E,A03,084140,Staff,26,0,30,4
1649872842450,MATH 20E,A04,084141,Staff,29,0,30,1
1649872848478,MATH 102,A01,084143,Harel; Guershon,23,0,30,7
1649872848478,MATH 102,A02,084144,Harel; Guershon,24,0,30,6
1649872854516,MATH 103B,A01,083456,Staff,0,2,30,30
1649872854516,MATH 103B,A02,083457,Staff,11,0,30,19
1649872860540,MATH 109,A01,084146,Salehi Golsefidy; Alireza,29,0,30,1
1649872860540,MATH 109,A02,084147,Salehi Golsefidy; Alireza,25,0,30,5
1649872866567,MATH 120A,A01,085445,Eggers; John Dietrich,26,0,35,9
1649872866567,MATH 120A,A02,085446,Eggers; John Dietrich,30,0,35,5
1649872872595,MATH 142B,A01,084149,Verstraete; Jacques Allan,0,0,30,30
1649872872595,MATH 142B,A02,084150,Verstraete; Jacques Allan,23,0,30,7
1649872878637,MATH 170A,A01,083459,Nie; Jiawang,5,0,30,25
1649872878637,MATH 170A,A02,083460,Nie; Jiawang,22,0,30,8
1649872878637,MATH 170A,A03,083461,Nie; Jiawang,23,0,30,7
1649872884671,MATH 193B,A01,083463,Staff,12,0,30,18
1649872884671,MATH 193B,A02,083464,Staff,18,0,30,12
1649872884671,MATH 193B,A03,083465,Staff,26,0,30,4
1649872890724,COGS 2,A01,083966,Boyle; Mary E. T.,22,0,30,8
1649872896764,COGS 9,A01,083968,Staff,52,0,60,8
1649872902792,COGS 14B,A01,083970,Staff,46,0,50,4
1649872908819,COGS 17,A01,092679,Staff,71,0,75,4
1649872914849,COGS 100,A01,083972,Staff,43,0,60,17
1649872926903,COGS 101C,A01,083976,Staff,23,0,30,7
1649872932936,COGS 102A,A01,083978,Johnson; Christine M.,22,0,30,8
1649872938960,COGS 107B,A01,083980,Staff,27,0,50,23
1649872944984,COGS 115,A01,083982,Staff,19,0,30,11
1649872951015,COGS 118B,A01,083367,Staff,0,1,40,40
1649872957038,COGS 172,A01,083984,Provenzano; Emily Kara,18,0,30,12
1649872963074,COGS 177,A00,083368,Staff,0,2,30,30
1649872969103,COGS 186,A01,083986,Staff,25,0,40,15
1649872975129,COGS 187A,A01,083988,Boyle; Mary E. T.,36,0,60,24
1649872981167,CSE 8A,A50,084003,Miranda; Gregory Joseph,8,0,15,7
1649872987202,CSE 11,A01,084005,Miranda; Gregory Joseph,47,0,55,8
1649872993225,CSE 20,A01,084007,Staff,15,0,20,5
1649872999249,CSE 21,A01,084009,Staff,31,0,50,19
1649873005277,CSE 30,A01,083370,Cao; Yingjun,13,0,40,27
1649873011309,CSE 100,A01,083372,Cao; Yingjun,7,0,40,33
1649873017334,CSE 101,A01,084011,Staff,0,26,40,40
1649873023361,CSE 141,A01,083374,Eldon; John,1,32,75,74
1649873029384,CSE 141L,A01,083376,Eldon; John,1,36,75,74
1649873035415,CSE 175,A01,084013,Kumar; Rakesh,22,0,25,3
1649873041437,CSE 190,A00,092508,Staff,15,0,15,0
1649873047461,ECE 5,A01,084049,Morris; Karcher William,17,0,20,3
1649873053485,ECE 100,A01,084051,Baghdadchi; Saharnaz,13,0,20,7
1649873053485,ECE 100,A02,091916,Baghdadchi; Saharnaz,18,0,20,2
1649873059508,ECE 101,A01,084053,Baghdadchi; Saharnaz,21,0,37,16
1649873059508,ECE 101,A02,084054,Baghdadchi; Saharnaz,37,0,37,0
1649873065541,ECE 107,A01,083390,Staff,31,0,40,9
1649873071573,ECE 148,A01,084056,Silberman; Jack,7,0,12,5
1649873077603,ECE 180,A00,083391,Abi Samra; Nicholas Camill,27,0,30,3
1649873077603,ECE 180,B00,083392,Abi Samra; Nicholas Camill,26,0,30,4
1649873083631,MATH 10B,A01,084110,Staff,18,0,30,12
1649873083631,MATH 10B,A02,084111,Staff,29,0,30,1
1649873083631,MATH 10B,A03,084112,Staff,29,0,30,1
1649873089653,MATH 10C,A01,083443,Staff,17,0,30,13
1649873089653,MATH 10C,A02,083444,Staff,22,0,30,8
1649873089653,MATH 10C,B01,084114,Staff,26,0,30,4
1649873089653,MATH 10C,B02,084115,Staff,30,0,30,0
1649873095689,MATH 18,A01,084117,Harel; Guershon,27,0,30,3
1649873095689,MATH 18,A02,084119,Harel; Guershon,29,0,30,1
1649873095689,MATH 18,A03,084120,Harel; Guershon,30,0,30,0
1649873095689,MATH 18,A04,084121,Harel; Guershon,30,0,30,0
1649873101725,MATH 20B,A01,084124,Um; Ko Woon,33,0,35,2
1649873101725,MATH 20B,B01,084126,Um; Ko Woon,35,0,35,0
1649873107764,MATH 20C,A01,083446,Hammock; Frances H,25,0,30,5
1649873107764,MATH 20C,A02,083447,Hammock; Frances H,29,0,30,1
1649873107764,MATH 20C,A03,083448,Hammock; Frances H,30,0,30,0
1649873107764,MATH 20C,A04,083449,Hammock; Frances H,30,0,30,0
1649873107764,MATH 20C,B01,083451,Hammock; Frances H,29,0,30,1
1649873107764,MATH 20C,B02,083452,Hammock; Frances H,29,0,30,1
1649873107764,MATH 20C,B03,083453,Hammock; Frances H,30,0,30,0
1649873107764,MATH 20C,B04,083454,Hammock; Frances H,30,0,30,0
1649873113786,MATH 20D,A01,084128,Staff,29,0,30,1
1649873113786,MATH 20D,A02,084129,Staff,30,0,30,0
1649873113786,MATH 20D,A03,084130,Staff,29,0,30,1
1649873113786,MATH 20D,B01,084133,Staff,28,0,30,2
1649873113786,MATH 20D,B02,084134,Staff,30,0,30,0
1649873113786,MATH 20D,B03,084135,Staff,30,0,30,0
1649873119815,MATH 20E,A01,084138,Staff,25,0,30,5
1649873119815,MATH 20E,A02,084139,Staff,28,0,30,2
1649873119815,MATH 20E,A03,084140,Staff,26,0,30,4
1649873119815,MATH 20E,A04,084141,Staff,29,0,30,1
1649873125839,MATH 102,A01,084143,Harel; Guershon,23,0,30,7
1649873125839,MATH 102,A02,084144,Harel; Guershon,24,0,30,6
1649873131955,MATH 103B,A01,083456,Staff,0,2,30,30
1649873131955,MATH 103B,A02,083457,Staff,10,0,30,20
1649873137989,MATH 109,A01,084146,Salehi Golsefidy; Alireza,29,0,30,1
1649873137989,MATH 109,A02,084147,Salehi Golsefidy; Alireza,25,0,30,5
1649873144014,MATH 120A,A01,085445,Eggers; John Dietrich,26,0,35,9
1649873144014,MATH 120A,A02,085446,Eggers; John Dietrich,30,0,35,5
1649873150046,MATH 142B,A01,084149,Verstraete; Jacques Allan,0,0,30,30
1649873150046,MATH 142B,A02,084150,Verstraete; Jacques Allan,23,0,30,7
1649873156074,MATH 170A,A01,083459,Nie; Jiawang,4,0,30,26
1649873156074,MATH 170A,A02,083460,Nie; Jiawang,22,0,30,8
1649873156074,MATH 170A,A03,083461,Nie; Jiawang,23,0,30,7
1649873162097,MATH 193B,A01,083463,Staff,12,0,30,18
1649873162097,MATH 193B,A02,083464,Staff,18,0,30,12
1649873162097,MATH 193B,A03,083465,Staff,26,0,30,4
1649873168170,COGS 2,A01,083966,Boyle; Mary E. T.,22,0,30,8
1649873174198,COGS 9,A01,083968,Staff,51,0,60,9
1649873180224,COGS 14B,A01,083970,Staff,46,0,50,4
1649873186246,COGS 17,A01,092679,Staff,71,0,75,4
1649873192270,COGS 100,A01,083972,Staff,43,0,60,17
1649873204328,COGS 101C,A01,083976,Staff,23,0,30,7
1649873210354,COGS 102A,A01,083978,Johnson; Christine M.,22,0,30,8
1649873216377,COGS 107B,A01,083980,Staff,27,0,50,23
1649873222401,COGS 115,A01,083982,Staff,19,0,30,11
1649873228423,COGS 118B,A01,083367,Staff,0,1,40,40
1649873234447,COGS 172,A01,083984,Provenzano; Emily Kara,18,0,30,12
1649873240481,COGS 177,A00,083368,Staff,0,2,30,30
1649873246509,COGS 186,A01,083986,Staff,25,0,40,15
1649873252536,COGS 187A,A01,083988,Boyle; Mary E. T.,36,0,60,24
1649873258560,CSE 8A,A50,084003,Miranda; Gregory Joseph,8,0,15,7
1649873264594,CSE 11,A01,084005,Miranda; Gregory Joseph,47,0,55,8
1649873270621,CSE 20,A01,084007,Staff,15,0,20,5
1649873276658,CSE 21,A01,084009,Staff,31,0,50,19
1649873282687,CSE 30,A01,083370,Cao; Yingjun,13,0,40,27
1649873288726,CSE 100,A01,083372,Cao; Yingjun,7,0,40,33
1649873294755,CSE 101,A01,084011,Staff,0,26,40,40
1649873300782,CSE 141,A01,083374,Eldon; John,1,33,75,74
1649873306815,CSE 141L,A01,083376,Eldon; John,1,37,75,74
1649873312843,CSE 175,A01,084013,Kumar; Rakesh,22,0,25,3
1649873318869,CSE 190,A00,092508,Staff,15,0,15,0
1649873324892,ECE 5,A01,084049,Morris; Karcher William,17,0,20,3
1649873330921,ECE 100,A01,084051,Baghdadchi; Saharnaz,13,0,20,7
1649873330921,ECE 100,A02,091916,Baghdadchi; Saharnaz,18,0,20,2
1649873336952,ECE 101,A01,084053,Baghdadchi; Saharnaz,21,0,37,16
1649873336952,ECE 101,A02,084054,Baghdadchi; Saharnaz,37,0,37,0
1649873342982,ECE 107,A01,083390,Staff,31,0,40,9
1649873349008,ECE 148,A01,084056,Silberman; Jack,7,0,12,5
1649873361365,ECE 180,A00,083391,Abi Samra; Nicholas Camill,27,0,30,3
1649873361365,ECE 180,B00,083392,Abi Samra; Nicholas Camill,25,0,30,5
1649873367395,MATH 10B,A01,084110,Staff,18,0,30,12
1649873367395,MATH 10B,A02,084111,Staff,29,0,30,1
1649873367395,MATH 10B,A03,084112,Staff,29,0,30,1
1649873373424,MATH 10C,A01,083443,Staff,17,0,30,13
1649873373424,MATH 10C,A02,083444,Staff,22,0,30,8
1649873373424,MATH 10C,B01,084114,Staff,26,0,30,4
1649873373424,MATH 10C,B02,084115,Staff,30,0,30,0
1649873379446,MATH 18,A01,084117,Harel; Guershon,27,0,30,3
1649873379446,MATH 18,A02,084119,Harel; Guershon,29,0,30,1
1649873379446,MATH 18,A03,084120,Harel; Guershon,30,0,30,0
1649873379446,MATH 18,A04,084121,Harel; Guershon,30,0,30,0
1649873385475,MATH 20B,A01,084124,Um; Ko Woon,33,0,35,2
1649873385475,MATH 20B,B01,084126,Um; Ko Woon,35,0,35,0
1649873391500,MATH 20C,A01,083446,Hammock; Frances H,25,0,30,5
1649873391500,MATH 20C,A02,083447,Hammock; Frances H,29,0,30,1
1649873391500,MATH 20C,A03,083448,Hammock; Frances H,30,0,30,0
1649873391500,MATH 20C,A04,083449,Hammock; Frances H,30,0,30,0
1649873391500,MATH 20C,B01,083451,Hammock; Frances H,29,0,30,1
1649873391500,MATH 20C,B02,083452,Hammock; Frances H,29,0,30,1
1649873391500,MATH 20C,B03,083453,Hammock; Frances H,30,0,30,0
1649873391500,MATH 20C,B04,083454,Hammock; Frances H,30,0,30,0
1649873397524,MATH 20D,A01,084128,Staff,29,0,30,1
1649873397524,MATH 20D,A02,084129,Staff,30,0,30,0
1649873397524,MATH 20D,A03,084130,Staff,29,0,30,1
1649873397524,MATH 20D,B01,084133,Staff,28,0,30,2
1649873397524,MATH 20D,B02,084134,Staff,30,0,30,0
1649873397524,MATH 20D,B03,084135,Staff,30,0,30,0
1649873403555,MATH 20E,A01,084138,Staff,25,0,30,5
1649873403555,MATH 20E,A02,084139,Staff,28,0,30,2
1649873403555,MATH 20E,A03,084140,Staff,26,0,30,4
1649873403555,MATH 20E,A04,084141,Staff,29,0,30,1
1649873409578,MATH 102,A01,084143,Harel; Guershon,23,0,30,7
1649873409578,MATH 102,A02,084144,Harel; Guershon,24,0,30,6
1649873415612,MATH 103B,A01,083456,Staff,0,2,30,30
1649873415612,MATH 103B,A02,083457,Staff,10,0,30,20
1649873421646,MATH 109,A01,084146,Salehi Golsefidy; Alireza,29,0,30,1
1649873421646,MATH 109,A02,084147,Salehi Golsefidy; Alireza,25,0,30,5
1649873427670,MATH 120A,A01,085445,Eggers; John Dietrich,26,0,35,9
1649873427670,MATH 120A,A02,085446,Eggers; John Dietrich,30,0,35,5
1649873433704,MATH 142B,A01,084149,Verstraete; Jacques Allan,0,0,30,30
1649873433704,MATH 142B,A02,084150,Verstraete; Jacques Allan,23,0,30,7
1649873439728,MATH 170A,A01,083459,Nie; Jiawang,4,0,30,26
1649873439728,MATH 170A,A02,083460,Nie; Jiawang,22,0,30,8
1649873439728,MATH 170A,A03,083461,Nie; Jiawang,23,0,30,7
1649873445749,MATH 193B,A01,083463,Staff,12,0,30,18
1649873445749,MATH 193B,A02,083464,Staff,18,0,30,12
1649873445749,MATH 193B,A03,083465,Staff,26,0,30,4
1649873451797,COGS 2,A01,083966,Boyle; Mary E. T.,22,0,30,8
1649873457823,COGS 9,A01,083968,Staff,52,0,60,8
1649873463856,COGS 14B,A01,083970,Staff,46,0,50,4
1649873469883,COGS 17,A01,092679,Staff,71,0,75,4
1649873475908,COGS 100,A01,083972,Staff,43,0,60,17
1649873487967,COGS 101C,A01,083976,Staff,23,0,30,7
1649873494002,COGS 102A,A01,083978,Johnson; Christine M.,22,0,30,8
1649873500034,COGS 107B,A01,083980,Staff,27,0,50,23
1649873506057,COGS 115,A01,083982,Staff,19,0,30,11
1649873512080,COGS 118B,A01,083367,Staff,0,1,40,40
1649873518103,COGS 172,A01,083984,Provenzano; Emily Kara,18,0,30,12
1649873524147,COGS 177,A00,083368,Staff,0,2,30,30
1649873530172,COGS 186,A01,083986,Staff,25,0,40,15
1649873536200,COGS 187A,A01,083988,Boyle; Mary E. T.,36,0,60,24
1649873542232,CSE 8A,A50,084003,Miranda; Gregory Joseph,8,0,15,7
1649873548260,CSE 11,A01,084005,Miranda; Gregory Joseph,47,0,55,8
1649873554283,CSE 20,A01,084007,Staff,15,0,20,5
1649873560321,CSE 21,A01,084009,Staff,31,0,50,19
1649873566348,CSE 30,A01,083370,Cao; Yingjun,13,0,40,27
1649873572374,CSE 100,A01,083372,Cao; Yingjun,7,0,40,33
1649873578408,CSE 101,A01,084011,Staff,0,26,40,40
1649873584441,CSE 141,A01,083374,Eldon; John,1,35,75,74
1649873590469,CSE 141L,A01,083376,Eldon; John,1,39,75,74
1649873596493,CSE 175,A01,084013,Kumar; Rakesh,22,0,25,3
1649873602516,CSE 190,A00,092508,Staff,15,0,15,0
1649873608540,ECE 5,A01,084049,Morris; Karcher William,17,0,20,3
1649873614568,ECE 100,A01,084051,Baghdadchi; Saharnaz,12,0,20,8
1649873614568,ECE 100,A02,091916,Baghdadchi; Saharnaz,18,0,20,2
1649873620592,ECE 101,A01,084053,Baghdadchi; Saharnaz,21,0,37,16
1649873620592,ECE 101,A02,084054,Baghdadchi; Saharnaz,37,0,37,0
1649873626619,ECE 107,A01,083390,Staff,31,0,40,9
1649873632652,ECE 148,A01,084056,Silberman; Jack,7,0,12,5
1649873638677,ECE 180,A00,083391,Abi Samra; Nicholas Camill,27,0,30,3
1649873638677,ECE 180,B00,083392,Abi Samra; Nicholas Camill,25,0,30,5
1649873644718,MATH 10B,A01,084110,Staff,18,0,30,12
1649873644718,MATH 10B,A02,084111,Staff,29,0,30,1
1649873644718,MATH 10B,A03,084112,Staff,29,0,30,1
1649873650744,MATH 10C,A01,083443,Staff,17,0,30,13
1649873650744,MATH 10C,A02,083444,Staff,22,0,30,8
1649873650744,MATH 10C,B01,084114,Staff,26,0,30,4
1649873650744,MATH 10C,B02,084115,Staff,30,0,30,0
1649873656772,MATH 18,A01,084117,Harel; Guershon,27,0,30,3
1649873656772,MATH 18,A02,084119,Harel; Guershon,29,0,30,1
1649873656772,MATH 18,A03,084120,Harel; Guershon,30,0,30,0
1649873656772,MATH 18,A04,084121,Harel; Guershon,30,0,30,0
1649873662814,MATH 20B,A01,084124,Um; Ko Woon,33,0,35,2
1649873662814,MATH 20B,B01,084126,Um; Ko Woon,35,0,35,0
1649873668841,MATH 20C,A01,083446,Hammock; Frances H,25,0,30,5
1649873668841,MATH 20C,A02,083447,Hammock; Frances H,29,0,30,1
1649873668841,MATH 20C,A03,083448,Hammock; Frances H,30,0,30,0
1649873668841,MATH 20C,A04,083449,Hammock; Frances H,30,0,30,0
1649873668841,MATH 20C,B01,083451,Hammock; Frances H,29,0,30,1
1649873668841,MATH 20C,B02,083452,Hammock; Frances H,29,0,30,1
1649873668841,MATH 20C,B03,083453,Hammock; Frances H,30,0,30,0
1649873668841,MATH 20C,B04,083454,Hammock; Frances H,30,0,30,0
1649873674874,MATH 20D,A01,084128,Staff,29,0,30,1
1649873674874,MATH 20D,A02,084129,Staff,30,0,30,0
1649873674874,MATH 20D,A03,084130,Staff,29,0,30,1
1649873674874,MATH 20D,B01,084133,Staff,28,0,30,2
1649873674874,MATH 20D,B02,084134,Staff,30,0,30,0
1649873674874,MATH 20D,B03,084135,Staff,30,0,30,0
1649873680897,MATH 20E,A01,084138,Staff,25,0,30,5
1649873680897,MATH 20E,A02,084139,Staff,27,0,30,3
1649873680897,MATH 20E,A03,084140,Staff,26,0,30,4
1649873680897,MATH 20E,A04,084141,Staff,29,0,30,1
1649873686925,MATH 102,A01,084143,Harel; Guershon,23,0,30,7
1649873686925,MATH 102,A02,084144,Harel; Guershon,24,0,30,6
1649873692951,MATH 103B,A01,083456,Staff,0,2,30,30
1649873692951,MATH 103B,A02,083457,Staff,10,0,30,20
1649873698974,MATH 109,A01,084146,Salehi Golsefidy; Alireza,29,0,30,1
1649873698974,MATH 109,A02,084147,Salehi Golsefidy; Alireza,25,0,30,5
1649873705013,MATH 120A,A01,085445,Eggers; John Dietrich,26,0,35,9
1649873705013,MATH 120A,A02,085446,Eggers; John Dietrich,30,0,35,5
1649873711040,MATH 142B,A01,084149,Verstraete; Jacques Allan,0,0,30,30
1649873711040,MATH 142B,A02,084150,Verstraete; Jacques Allan,22,0,30,8
1649873717075,MATH 170A,A01,083459,Nie; Jiawang,4,0,30,26
1649873717075,MATH 170A,A02,083460,Nie; Jiawang,22,0,30,8
1649873717075,MATH 170A,A03,083461,Nie; Jiawang,23,0,30,7
1649873723117,MATH 193B,A01,083463,Staff,12,0,30,18
1649873723117,MATH 193B,A02,083464,Staff,18,0,30,12
1649873723117,MATH 193B,A03,083465,Staff,26,0,30,4
1649873729287,COGS 2,A01,083966,Boyle; Mary E. T.,22,0,30,8
1649873735320,COGS 9,A01,083968,Staff,52,0,60,8
1649873741355,COGS 14B,A01,083970,Staff,46,0,50,4
1649873747383,COGS 17,A01,092679,Staff,71,0,75,4
1649873753406,COGS 100,A01,083972,Staff,41,0,60,19
1649873765454,COGS 101C,A01,083976,Staff,23,0,30,7
1649873771482,COGS 102A,A01,083978,Johnson; Christine M.,22,0,30,8
1649873777512,COGS 107B,A01,083980,Staff,26,0,50,24
1649873783536,COGS 115,A01,083982,Staff,19,0,30,11
1649873789565,COGS 118B,A01,083367,Staff,0,1,40,40
1649873795593,COGS 172,A01,083984,Provenzano; Emily Kara,18,0,30,12
1649873801624,COGS 177,A00,083368,Staff,0,2,30,30
1649873807646,COGS 186,A01,083986,Staff,25,0,40,15
1649873813673,COGS 187A,A01,083988,Boyle; Mary E. T.,36,0,60,24
1649873819704,CSE 8A,A50,084003,Miranda; Gregory Joseph,8,0,15,7
1649873825743,CSE 11,A01,084005,Miranda; Gregory Joseph,47,0,55,8
1649873831765,CSE 20,A01,084007,Staff,15,0,20,5
1649873837799,CSE 21,A01,084009,Staff,31,0,50,19
1649873843828,CSE 30,A01,083370,Cao; Yingjun,13,0,40,27
1649873849850,CSE 100,A01,083372,Cao; Yingjun,7,0,40,33
1649873855872,CSE 101,A01,084011,Staff,0,26,40,40
1649873861894,CSE 141,A01,083374,Eldon; John,1,35,75,74
1649873867933,CSE 141L,A01,083376,Eldon; John,1,39,75,74
1649873873956,CSE 175,A01,084013,Kumar; Rakesh,22,0,25,3
1649873879989,CSE 190,A00,092508,Staff,15,0,15,0
1649873886017,ECE 5,A01,084049,Morris; Karcher William,17,0,20,3
1649873892040,ECE 100,A01,084051,Baghdadchi; Saharnaz,12,0,20,8
1649873892040,ECE 100,A02,091916,Baghdadchi; Saharnaz,18,0,20,2
1649873898068,ECE 101,A01,084053,Baghdadchi; Saharnaz,21,0,37,16
1649873898068,ECE 101,A02,084054,Baghdadchi; Saharnaz,37,0,37,0
1649873904091,ECE 107,A01,083390,Staff,31,0,40,9
1649873910123,ECE 148,A01,084056,Silberman; Jack,7,0,12,5
1649873916147,ECE 180,A00,083391,Abi Samra; Nicholas Camill,27,0,30,3
1649873916147,ECE 180,B00,083392,Abi Samra; Nicholas Camill,25,0,30,5
1649873922175,MATH 10B,A01,084110,Staff,18,0,30,12
1649873922175,MATH 10B,A02,084111,Staff,29,0,30,1
1649873922175,MATH 10B,A03,084112,Staff,29,0,30,1
1649873928215,MATH 10C,A01,083443,Staff,17,0,30,13
1649873928215,MATH 10C,A02,083444,Staff,22,0,30,8
1649873928215,MATH 10C,B01,084114,Staff,26,0,30,4
1649873928215,MATH 10C,B02,084115,Staff,30,0,30,0
1649873934249,MATH 18,A01,084117,Harel; Guershon,27,0,30,3
1649873934249,MATH 18,A02,084119,Harel; Guershon,29,0,30,1
1649873934249,MATH 18,A03,084120,Harel; Guershon,30,0,30,0
1649873934249,MATH 18,A04,084121,Harel; Guershon,30,0,30,0
1649873940276,MATH 20B,A01,084124,Um; Ko Woon,33,0,35,2
1649873940276,MATH 20B,B01,084126,Um; Ko Woon,35,0,35,0
1649873946308,MATH 20C,A01,083446,Hammock; Frances H,25,0,30,5
1649873946308,MATH 20C,A02,083447,Hammock; Frances H,29,0,30,1
1649873946308,MATH 20C,A03,083448,Hammock; Frances H,30,0,30,0
1649873946308,MATH 20C,A04,083449,Hammock; Frances H,30,0,30,0
1649873946308,MATH 20C,B01,083451,Hammock; Frances H,29,0,30,1
1649873946308,MATH 20C,B02,083452,Hammock; Frances H,29,0,30,1
1649873946308,MATH 20C,B03,083453,Hammock; Frances H,30,0,30,0
1649873946308,MATH 20C,B04,083454,Hammock; Frances H,30,0,30,0
1649873952337,MATH 20D,A01,084128,Staff,29,0,30,1
1649873952337,MATH 20D,A02,084129,Staff,30,0,30,0
1649873952337,MATH 20D,A03,084130,Staff,29,0,30,1
1649873952337,MATH 20D,B01,084133,Staff,28,0,30,2
1649873952337,MATH 20D,B02,084134,Staff,30,0,30,0
1649873952337,MATH 20D,B03,084135,Staff,30,0,30,0
1649873958368,MATH 20E,A01,084138,Staff,25,0,30,5
1649873958368,MATH 20E,A02,084139,Staff,27,0,30,3
1649873958368,MATH 20E,A03,084140,Staff,26,0,30,4
1649873958368,MATH 20E,A04,084141,Staff,29,0,30,1
1649873964395,MATH 102,A01,084143,Harel; Guershon,23,0,30,7
1649873964395,MATH 102,A02,084144,Harel; Guershon,24,0,30,6
1649873970428,MATH 103B,A01,083456,Staff,0,2,30,30
1649873970428,MATH 103B,A02,083457,Staff,10,0,30,20
1649873976455,MATH 109,A01,084146,Salehi Golsefidy; Alireza,29,0,30,1
1649873976455,MATH 109,A02,084147,Salehi Golsefidy; Alireza,25,0,30,5
1649873982478,MATH 120A,A01,085445,Eggers; John Dietrich,26,0,35,9
1649873982478,MATH 120A,A02,085446,Eggers; John Dietrich,30,0,35,5
1649873988503,MATH 142B,A01,084149,Verstraete; Jacques Allan,0,0,30,30
1649873988503,MATH 142B,A02,084150,Verstraete; Jacques Allan,22,0,30,8
1649873994532,MATH 170A,A01,083459,Nie; Jiawang,4,0,30,26
1649873994532,MATH 170A,A02,083460,Nie; Jiawang,21,0,30,9
1649873994532,MATH 170A,A03,083461,Nie; Jiawang,23,0,30,7
1649874000566,MATH 193B,A01,083463,Staff,12,0,30,18
1649874000566,MATH 193B,A02,083464,Staff,18,0,30,12
1649874000566,MATH 193B,A03,083465,Staff,26,0,30,4
1649874006622,COGS 2,A01,083966,Boyle; Mary E. T.,22,0,30,8
1649874012645,COGS 9,A01,083968,Staff,52,0,60,8
1649874018669,COGS 14B,A01,083970,Staff,46,0,50,4
1649874024696,COGS 17,A01,092679,Staff,71,0,75,4
1649874030722,COGS 100,A01,083972,Staff,41,0,60,19
1649874042773,COGS 101C,A01,083976,Staff,23,0,30,7
1649874048797,COGS 102A,A01,083978,Johnson; Christine M.,22,0,30,8
1649874054833,COGS 107B,A01,083980,Staff,26,0,50,24
1649874060860,COGS 115,A01,083982,Staff,19,0,30,11
1649874066887,COGS 118B,A01,083367,Staff,0,1,40,40
1649874072915,COGS 172,A01,083984,Provenzano; Emily Kara,18,0,30,12
1649874078950,COGS 177,A00,083368,Staff,0,2,30,30
1649874084982,COGS 186,A01,083986,Staff,25,0,40,15
1649874091018,COGS 187A,A01,083988,Boyle; Mary E. T.,36,0,60,24
1649874097046,CSE 8A,A50,084003,Miranda; Gregory Joseph,8,0,15,7
1649874103075,CSE 11,A01,084005,Miranda; Gregory Joseph,47,0,55,8
1649874109098,CSE 20,A01,084007,Staff,15,0,20,5
1649874115134,CSE 21,A01,084009,Staff,31,0,50,19
1649874121167,CSE 30,A01,083370,Cao; Yingjun,13,0,40,27
1649874127192,CSE 100,A01,083372,Cao; Yingjun,6,0,40,34
1649874133215,CSE 101,A01,084011,Staff,0,26,40,40
1649874139238,CSE 141,A01,083374,Eldon; John,1,35,75,74
1649874145273,CSE 141L,A01,083376,Eldon; John,1,39,75,74
1649874151297,CSE 175,A01,084013,Kumar; Rakesh,22,0,25,3
1649874157320,CSE 190,A00,092508,Staff,15,0,15,0
1649874163345,ECE 5,A01,084049,Morris; Karcher William,17,0,20,3
1649874169372,ECE 100,A01,084051,Baghdadchi; Saharnaz,12,0,20,8
1649874169372,ECE 100,A02,091916,Baghdadchi; Saharnaz,18,0,20,2
1649874175404,ECE 101,A01,084053,Baghdadchi; Saharnaz,21,0,37,16
1649874175404,ECE 101,A02,084054,Baghdadchi; Saharnaz,37,0,37,0
1649874181443,ECE 107,A01,083390,Staff,31,0,40,9
1649874187469,ECE 148,A01,084056,Silberman; Jack,7,0,12,5
1649874193503,ECE 180,A00,083391,Abi Samra; Nicholas Camill,26,0,30,4
1649874193503,ECE 180,B00,083392,Abi Samra; Nicholas Camill,25,0,30,5
1649874199531,MATH 10B,A01,084110,Staff,18,0,30,12
1649874199531,MATH 10B,A02,084111,Staff,29,0,30,1
1649874199531,MATH 10B,A03,084112,Staff,29,0,30,1
1649874205564,MATH 10C,A01,083443,Staff,17,0,30,13
1649874205564,MATH 10C,A02,083444,Staff,22,0,30,8
1649874205564,MATH 10C,B01,084114,Staff,26,0,30,4
1649874205564,MATH 10C,B02,084115,Staff,30,0,30,0
1649874211595,MATH 18,A01,084117,Harel; Guershon,27,0,30,3
1649874211595,MATH 18,A02,084119,Harel; Guershon,29,0,30,1
1649874211595,MATH 18,A03,084120,Harel; Guershon,30,0,30,0
1649874211595,MATH 18,A04,084121,Harel; Guershon,30,0,30,0
1649874217623,MATH 20B,A01,084124,Um; Ko Woon,33,0,35,2
1649874217623,MATH 20B,B01,084126,Um; Ko Woon,34,0,35,1
1649874223652,MATH 20C,A01,083446,Hammock; Frances H,25,0,30,5
1649874223652,MATH 20C,A02,083447,Hammock; Frances H,29,0,30,1
1649874223652,MATH 20C,A03,083448,Hammock; Frances H,30,0,30,0
1649874223652,MATH 20C,A04,083449,Hammock; Frances H,30,0,30,0
1649874223652,MATH 20C,B01,083451,Hammock; Frances H,29,0,30,1
1649874223652,MATH 20C,B02,083452,Hammock; Frances H,29,0,30,1
1649874223652,MATH 20C,B03,083453,Hammock; Frances H,30,0,30,0
1649874223652,MATH 20C,B04,083454,Hammock; Frances H,30,0,30,0
1649874229676,MATH 20D,A01,084128,Staff,29,0,30,1
1649874229676,MATH 20D,A02,084129,Staff,30,0,30,0
1649874229676,MATH 20D,A03,084130,Staff,29,0,30,1
1649874229676,MATH 20D,B01,084133,Staff,28,0,30,2
1649874229676,MATH 20D,B02,084134,Staff,30,0,30,0
1649874229676,MATH 20D,B03,084135,Staff,30,0,30,0
1649874235699,MATH 20E,A01,084138,Staff,25,0,30,5
1649874235699,MATH 20E,A02,084139,Staff,27,0,30,3
1649874235699,MATH 20E,A03,084140,Staff,26,0,30,4
1649874235699,MATH 20E,A04,084141,Staff,29,0,30,1
1649874241725,MATH 102,A01,084143,Harel; Guershon,23,0,30,7
1649874241725,MATH 102,A02,084144,Harel; Guershon,24,0,30,6
1649874247753,MATH 103B,A01,083456,Staff,0,2,30,30
1649874247753,MATH 103B,A02,083457,Staff,9,0,30,21
1649874253779,MATH 109,A01,084146,Salehi Golsefidy; Alireza,29,0,30,1
1649874253779,MATH 109,A02,084147,Salehi Golsefidy; Alireza,25,0,30,5
1649874259802,MATH 120A,A01,085445,Eggers; John Dietrich,25,0,35,10
1649874259802,MATH 120A,A02,085446,Eggers; John Dietrich,30,0,35,5
1649874265832,MATH 142B,A01,084149,Verstraete; Jacques Allan,0,0,30,30
1649874265832,MATH 142B,A02,084150,Verstraete; Jacques Allan,21,0,30,9
1649874271869,MATH 170A,A01,083459,Nie; Jiawang,3,0,30,27
1649874271869,MATH 170A,A02,083460,Nie; Jiawang,21,0,30,9
1649874271869,MATH 170A,A03,083461,Nie; Jiawang,23,0,30,7
1649874277896,MATH 193B,A01,083463,Staff,12,0,30,18
1649874277896,MATH 193B,A02,083464,Staff,18,0,30,12
1649874277896,MATH 193B,A03,083465,Staff,26,0,30,4
1649874283965,COGS 2,A01,083966,Boyle; Mary E. T.,22,0,30,8
1649874289988,COGS 9,A01,083968,Staff,52,0,60,8
1649874296015,COGS 14B,A01,083970,Staff,46,0,50,4
1649874302039,COGS 17,A01,092679,Staff,71,0,75,4
1649874308063,COGS 100,A01,083972,Staff,41,0,60,19
1649874320120,COGS 101C,A01,083976,Staff,23,0,30,7
1649874326235,COGS 102A,A01,083978,Johnson; Christine M.,22,0,30,8
1649874332257,COGS 107B,A01,083980,Staff,26,0,50,24
1649874338283,COGS 115,A01,083982,Staff,19,0,30,11
1649874344308,COGS 118B,A01,083367,Staff,0,1,40,40
1649874350331,COGS 172,A01,083984,Provenzano; Emily Kara,18,0,30,12
1649874356353,COGS 177,A00,083368,Staff,0,2,30,30
1649874362377,COGS 186,A01,083986,Staff,25,0,40,15
1649874368400,COGS 187A,A01,083988,Boyle; Mary E. T.,36,0,60,24
1649874374424,CSE 8A,A50,084003,Miranda; Gregory Joseph,8,0,15,7
1649874380461,CSE 11,A01,084005,Miranda; Gregory Joseph,47,0,55,8
1649874386491,CSE 20,A01,084007,Staff,15,0,20,5
1649874392516,CSE 21,A01,084009,Staff,31,0,50,19
1649874398541,CSE 30,A01,083370,Cao; Yingjun,13,0,40,27
1649874404569,CSE 100,A01,083372,Cao; Yingjun,6,0,40,34
1649874410602,CSE 101,A01,084011,Staff,0,27,40,40
1649874416628,CSE 141,A01,083374,Eldon; John,1,35,75,74
1649874422656,CSE 141L,A01,083376,Eldon; John,1,39,75,74
1649874428683,CSE 175,A01,084013,Kumar; Rakesh,22,0,25,3
1649874434710,CSE 190,A00,092508,Staff,15,0,15,0
1649874440735,ECE 5,A01,084049,Morris; Karcher William,17,0,20,3
1649874446767,ECE 100,A01,084051,Baghdadchi; Saharnaz,12,0,20,8
1649874446767,ECE 100,A02,091916,Baghdadchi; Saharnaz,18,0,20,2
1649874452795,ECE 101,A01,084053,Baghdadchi; Saharnaz,21,0,37,16
1649874452795,ECE 101,A02,084054,Baghdadchi; Saharnaz,37,0,37,0
1649874458831,ECE 107,A01,083390,Staff,31,0,40,9
1649874464854,ECE 148,A01,084056,Silberman; Jack,7,0,12,5
1649874470892,ECE 180,A00,083391,Abi Samra; Nicholas Camill,26,0,30,4
1649874470892,ECE 180,B00,083392,Abi Samra; Nicholas Camill,25,0,30,5
1649874476916,MATH 10B,A01,084110,Staff,18,0,30,12
1649874476916,MATH 10B,A02,084111,Staff,29,0,30,1
1649874476916,MATH 10B,A03,084112,Staff,29,0,30,1
1649874482938,MATH 10C,A01,083443,Staff,17,0,30,13
1649874482938,MATH 10C,A02,083444,Staff,22,0,30,8
1649874482938,MATH 10C,B01,084114,Staff,26,0,30,4
1649874482938,MATH 10C,B02,084115,Staff,30,0,30,0
1649874488964,MATH 18,A01,084117,Harel; Guershon,27,0,30,3
1649874488964,MATH 18,A02,084119,Harel; Guershon,29,0,30,1
1649874488964,MATH 18,A03,084120,Harel; Guershon,30,0,30,0
1649874488964,MATH 18,A04,084121,Harel; Guershon,30,0,30,0
1649874494989,MATH 20B,A01,084124,Um; Ko Woon,33,0,35,2
1649874494989,MATH 20B,B01,084126,Um; Ko Woon,34,0,35,1
1649874501023,MATH 20C,A01,083446,Hammock; Frances H,25,0,30,5
1649874501023,MATH 20C,A02,083447,Hammock; Frances H,29,0,30,1
1649874501023,MATH 20C,A03,083448,Hammock; Frances H,30,0,30,0
1649874501023,MATH 20C,A04,083449,Hammock; Frances H,30,0,30,0
1649874501023,MATH 20C,B01,083451,Hammock; Frances H,29,0,30,1
1649874501023,MATH 20C,B02,083452,Hammock; Frances H,29,0,30,1
1649874501023,MATH 20C,B03,083453,Hammock; Frances H,30,0,30,0
1649874501023,MATH 20C,B04,083454,Hammock; Frances H,30,0,30,0
1649874507051,MATH 20D,A01,084128,Staff,29,0,30,1
1649874507051,MATH 20D,A02,084129,Staff,30,0,30,0
1649874507051,MATH 20D,A03,084130,Staff,29,0,30,1
1649874507051,MATH 20D,B01,084133,Staff,28,0,30,2
1649874507051,MATH 20D,B02,084134,Staff,30,0,30,0
1649874507051,MATH 20D,B03,084135,Staff,30,0,30,0
1649874513078,MATH 20E,A01,084138,Staff,25,0,30,5
1649874513078,MATH 20E,A02,084139,Staff,27,0,30,3
1649874513078,MATH 20E,A03,084140,Staff,26,0,30,4
1649874513078,MATH 20E,A04,084141,Staff,29,0,30,1
1649874519100,MATH 102,A01,084143,Harel; Guershon,23,0,30,7
1649874519100,MATH 102,A02,084144,Harel; Guershon,24,0,30,6
1649874525127,MATH 103B,A01,083456,Staff,0,2,30,30
1649874525127,MATH 103B,A02,083457,Staff,9,0,30,21
1649874531153,MATH 109,A01,084146,Salehi Golsefidy; Alireza,29,0,30,1
1649874531153,MATH 109,A02,084147,Salehi Golsefidy; Alireza,25,0,30,5
1649874537180,MATH 120A,A01,085445,Eggers; John Dietrich,25,0,35,10
1649874537180,MATH 120A,A02,085446,Eggers; John Dietrich,30,0,35,5
1649874543203,MATH 142B,A01,084149,Verstraete; Jacques Allan,0,0,30,30
1649874543203,MATH 142B,A02,084150,Verstraete; Jacques Allan,20,0,30,10
1649874549231,MATH 170A,A01,083459,Nie; Jiawang,2,0,30,28
1649874549231,MATH 170A,A02,083460,Nie; Jiawang,21,0,30,9
1649874549231,MATH 170A,A03,083461,Nie; Jiawang,23,0,30,7
1649874555255,MATH 193B,A01,083463,Staff,12,0,30,18
1649874555255,MATH 193B,A02,083464,Staff,18,0,30,12
1649874555255,MATH 193B,A03,083465,Staff,26,0,30,4
1649874561305,COGS 2,A01,083966,Boyle; Mary E. T.,22,0,30,8
1649874567329,COGS 9,A01,083968,Staff,52,0,60,8
1649874573353,COGS 14B,A01,083970,Staff,46,0,50,4
1649874579376,COGS 17,A01,092679,Staff,71,0,75,4
1649874585400,COGS 100,A01,083972,Staff,42,0,60,18
1649874597446,COGS 101C,A01,083976,Staff,23,0,30,7
1649874603469,COGS 102A,A01,083978,Johnson; Christine M.,22,0,30,8
1649874609511,COGS 107B,A01,083980,Staff,26,0,50,24
1649874615533,COGS 115,A01,083982,Staff,19,0,30,11
1649874621556,COGS 118B,A01,083367,Staff,0,1,40,40
1649874627580,COGS 172,A01,083984,Provenzano; Emily Kara,18,0,30,12
1649874633610,COGS 177,A00,083368,Staff,0,3,30,30
1649874639638,COGS 186,A01,083986,Staff,25,0,40,15
1649874645661,COGS 187A,A01,083988,Boyle; Mary E. T.,36,0,60,24
1649874651688,CSE 8A,A50,084003,Miranda; Gregory Joseph,8,0,15,7
1649874657720,CSE 11,A01,084005,Miranda; Gregory Joseph,47,0,55,8
1649874663744,CSE 20,A01,084007,Staff,15,0,20,5
1649874669768,CSE 21,A01,084009,Staff,31,0,50,19
1649874675795,CSE 30,A01,083370,Cao; Yingjun,13,0,40,27
1649874681819,CSE 100,A01,083372,Cao; Yingjun,6,0,40,34
1649874687854,CSE 101,A01,084011,Staff,0,27,40,40
1649874693878,CSE 141,A01,083374,Eldon; John,1,35,75,74
1649874699905,CSE 141L,A01,083376,Eldon; John,1,39,75,74
1649874705928,CSE 175,A01,084013,Kumar; Rakesh,22,0,25,3
1649874711951,CSE 190,A00,092508,Staff,15,0,15,0
1649874717984,ECE 5,A01,084049,Morris; Karcher William,17,0,20,3
1649874724007,ECE 100,A01,084051,Baghdadchi; Saharnaz,12,0,20,8
1649874724007,ECE 100,A02,091916,Baghdadchi; Saharnaz,18,0,20,2
1649874730036,ECE 101,A01,084053,Baghdadchi; Saharnaz,21,0,37,16
1649874730036,ECE 101,A02,084054,Baghdadchi; Saharnaz,37,0,37,0
1649874736076,ECE 107,A01,083390,Staff,31,0,40,9
1649874742106,ECE 148,A01,084056,Silberman; Jack,7,0,12,5
1649874748130,ECE 180,A00,083391,Abi Samra; Nicholas Camill,26,0,30,4
1649874748130,ECE 180,B00,083392,Abi Samra; Nicholas Camill,25,0,30,5
1649874754154,MATH 10B,A01,084110,Staff,18,0,30,12
1649874754154,MATH 10B,A02,084111,Staff,29,0,30,1
1649874754154,MATH 10B,A03,084112,Staff,29,0,30,1
1649874760181,MATH 10C,A01,083443,Staff,17,0,30,13
1649874760181,MATH 10C,A02,083444,Staff,22,0,30,8
1649874760181,MATH 10C,B01,084114,Staff,26,0,30,4
1649874760181,MATH 10C,B02,084115,Staff,30,0,30,0
1649874766215,MATH 18,A01,084117,Harel; Guershon,27,0,30,3
1649874766215,MATH 18,A02,084119,Harel; Guershon,29,0,30,1
1649874766215,MATH 18,A03,084120,Harel; Guershon,30,0,30,0
1649874766215,MATH 18,A04,084121,Harel; Guershon,30,0,30,0
1649874772246,MATH 20B,A01,084124,Um; Ko Woon,33,0,35,2
1649874772246,MATH 20B,B01,084126,Um; Ko Woon,34,0,35,1
1649874778278,MATH 20C,A01,083446,Hammock; Frances H,25,0,30,5
1649874778278,MATH 20C,A02,083447,Hammock; Frances H,29,0,30,1
1649874778278,MATH 20C,A03,083448,Hammock; Frances H,30,0,30,0
1649874778278,MATH 20C,A04,083449,Hammock; Frances H,30,0,30,0
1649874778278,MATH 20C,B01,083451,Hammock; Frances H,29,0,30,1
1649874778278,MATH 20C,B02,083452,Hammock; Frances H,29,0,30,1
1649874778278,MATH 20C,B03,083453,Hammock; Frances H,30,0,30,0
1649874778278,MATH 20C,B04,083454,Hammock; Frances H,30,0,30,0
1649874784300,MATH 20D,A01,084128,Staff,29,0,30,1
1649874784300,MATH 20D,A02,084129,Staff,30,0,30,0
1649874784300,MATH 20D,A03,084130,Staff,29,0,30,1
1649874784300,MATH 20D,B01,084133,Staff,28,0,30,2
1649874784300,MATH 20D,B02,084134,Staff,30,0,30,0
1649874784300,MATH 20D,B03,084135,Staff,30,0,30,0
1649874790322,MATH 20E,A01,084138,Staff,25,0,30,5
1649874790322,MATH 20E,A02,084139,Staff,27,0,30,3
1649874790322,MATH 20E,A03,084140,Staff,26,0,30,4
1649874790322,MATH 20E,A04,084141,Staff,29,0,30,1
1649874796344,MATH 102,A01,084143,Harel; Guershon,23,0,30,7
1649874796344,MATH 102,A02,084144,Harel; Guershon,24,0,30,6
1649874802371,MATH 103B,A01,083456,Staff,0,2,30,30
1649874802371,MATH 103B,A02,083457,Staff,9,0,30,21
1649874808393,MATH 109,A01,084146,Salehi Golsefidy; Alireza,29,0,30,1
1649874808393,MATH 109,A02,084147,Salehi Golsefidy; Alireza,25,0,30,5
1649874814420,MATH 120A,A01,085445,Eggers; John Dietrich,25,0,35,10
1649874814420,MATH 120A,A02,085446,Eggers; John Dietrich,30,0,35,5
1649874820447,MATH 142B,A01,084149,Verstraete; Jacques Allan,0,0,30,30
1649874820447,MATH 142B,A02,084150,Verstraete; Jacques Allan,20,0,30,10
1649874826471,MATH 170A,A01,083459,Nie; Jiawang,0,0,30,30
1649874826471,MATH 170A,A02,083460,Nie; Jiawang,21,0,30,9
1649874826471,MATH 170A,A03,083461,Nie; Jiawang,23,0,30,7
1649874832496,MATH 193B,A01,083463,Staff,12,0,30,18
1649874832496,MATH 193B,A02,083464,Staff,18,0,30,12
1649874832496,MATH 193B,A03,083465,Staff,26,0,30,4
1649874838560,COGS 2,A01,083966,Boyle; Mary E. T.,22,0,30,8
1649874844585,COGS 9,A01,083968,Staff,51,0,60,9
1649874850609,COGS 14B,A01,083970,Staff,45,0,50,5
1649874856631,COGS 17,A01,092679,Staff,71,0,75,4
1649874862660,COGS 100,A01,083972,Staff,41,0,60,19
1649874874713,COGS 101C,A01,083976,Staff,23,0,30,7
1649874880759,COGS 102A,A01,083978,Johnson; Christine M.,22,0,30,8
1649874886787,COGS 107B,A01,083980,Staff,26,0,50,24
1649874892827,COGS 115,A01,083982,Staff,19,0,30,11
1649874898854,COGS 118B,A01,083367,Staff,0,1,40,40
1649874904879,COGS 172,A01,083984,Provenzano; Emily Kara,18,0,30,12
1649874910904,COGS 177,A00,083368,Staff,0,3,30,30
1649874916931,COGS 186,A01,083986,Staff,25,0,40,15
1649874923053,COGS 187A,A01,083988,Boyle; Mary E. T.,36,0,60,24
1649874929083,CSE 8A,A50,084003,Miranda; Gregory Joseph,8,0,15,7
1649874935121,CSE 11,A01,084005,Miranda; Gregory Joseph,47,0,55,8
1649874941143,CSE 20,A01,084007,Staff,15,0,20,5
1649874947175,CSE 21,A01,084009,Staff,31,0,50,19
1649874953212,CSE 30,A01,083370,Cao; Yingjun,13,0,40,27
1649874959238,CSE 100,A01,083372,Cao; Yingjun,6,0,40,34
1649874965263,CSE 101,A01,084011,Staff,0,28,40,40
1649874971287,CSE 141,A01,083374,Eldon; John,1,35,75,74
1649874977309,CSE 141L,A01,083376,Eldon; John,1,39,75,74
1649874983335,CSE 175,A01,084013,Kumar; Rakesh,22,0,25,3
1649874989360,CSE 190,A00,092508,Staff,15,0,15,0
1649874995395,ECE 5,A01,084049,Morris; Karcher William,17,0,20,3
1649875001422,ECE 100,A01,084051,Baghdadchi; Saharnaz,12,0,20,8
1649875001422,ECE 100,A02,091916,Baghdadchi; Saharnaz,18,0,20,2
1649875007445,ECE 101,A01,084053,Baghdadchi; Saharnaz,21,0,37,16
1649875007445,ECE 101,A02,084054,Baghdadchi; Saharnaz,37,0,37,0
1649875013468,ECE 107,A01,083390,Staff,31,0,40,9
1649875019496,ECE 148,A01,084056,Silberman; Jack,7,0,12,5
1649875025539,ECE 180,A00,083391,Abi Samra; Nicholas Camill,26,0,30,4
1649875025539,ECE 180,B00,083392,Abi Samra; Nicholas Camill,25,0,30,5
1649875031563,MATH 10B,A01,084110,Staff,18,0,30,12
1649875031563,MATH 10B,A02,084111,Staff,29,0,30,1
1649875031563,MATH 10B,A03,084112,Staff,29,0,30,1
1649875037597,MATH 10C,A01,083443,Staff,17,0,30,13
1649875037597,MATH 10C,A02,083444,Staff,22,0,30,8
1649875037597,MATH 10C,B01,084114,Staff,26,0,30,4
1649875037597,MATH 10C,B02,084115,Staff,30,0,30,0
1649875043635,MATH 18,A01,084117,Harel; Guershon,27,0,30,3
1649875043635,MATH 18,A02,084119,Harel; Guershon,29,0,30,1
1649875043635,MATH 18,A03,084120,Harel; Guershon,30,0,30,0
1649875043635,MATH 18,A04,084121,Harel; Guershon,30,0,30,0
1649875049661,MATH 20B,A01,084124,Um; Ko Woon,33,0,35,2
1649875049661,MATH 20B,B01,084126,Um; Ko Woon,34,0,35,1
1649875055712,MATH 20C,A01,083446,Hammock; Frances H,25,0,30,5
1649875055712,MATH 20C,A02,083447,Hammock; Frances H,29,0,30,1
1649875055712,MATH 20C,A03,083448,Hammock; Frances H,30,0,30,0
1649875055712,MATH 20C,A04,083449,Hammock; Frances H,30,0,30,0
1649875055712,MATH 20C,B01,083451,Hammock; Frances H,29,0,30,1
1649875055712,MATH 20C,B02,083452,Hammock; Frances H,29,0,30,1
1649875055712,MATH 20C,B03,083453,Hammock; Frances H,30,0,30,0
1649875055712,MATH 20C,B04,083454,Hammock; Frances H,30,0,30,0
1649875061735,MATH 20D,A01,084128,Staff,29,0,30,1
1649875061735,MATH 20D,A02,084129,Staff,30,0,30,0
1649875061735,MATH 20D,A03,084130,Staff,29,0,30,1
1649875061735,MATH 20D,B01,084133,Staff,28,0,30,2
1649875061735,MATH 20D,B02,084134,Staff,30,0,30,0
1649875061735,MATH 20D,B03,084135,Staff,30,0,30,0
1649875067758,MATH 20E,A01,084138,Staff,25,0,30,5
1649875067758,MATH 20E,A02,084139,Staff,27,0,30,3
1649875067758,MATH 20E,A03,084140,Staff,26,0,30,4
1649875067758,MATH 20E,A04,084141,Staff,29,0,30,1
1649875073780,MATH 102,A01,084143,Harel; Guershon,23,0,30,7
1649875073780,MATH 102,A02,084144,Harel; Guershon,24,0,30,6
1649875079804,MATH 103B,A01,083456,Staff,0,2,30,30
1649875079804,MATH 103B,A02,083457,Staff,9,0,30,21
1649875085827,MATH 109,A01,084146,Salehi Golsefidy; Alireza,29,0,30,1
1649875085827,MATH 109,A02,084147,Salehi Golsefidy; Alireza,25,0,30,5
1649875091849,MATH 120A,A01,085445,Eggers; John Dietrich,25,0,35,10
1649875091849,MATH 120A,A02,085446,Eggers; John Dietrich,30,0,35,5
1649875097872,MATH 142B,A01,084149,Verstraete; Jacques Allan,0,0,30,30
1649875097872,MATH 142B,A02,084150,Verstraete; Jacques Allan,20,0,30,10
1649875103894,MATH 170A,A01,083459,Nie; Jiawang,0,0,30,30
1649875103894,MATH 170A,A02,083460,Nie; Jiawang,21,0,30,9
1649875103894,MATH 170A,A03,083461,Nie; Jiawang,23,0,30,7
1649875109917,MATH 193B,A01,083463,Staff,12,0,30,18
1649875109917,MATH 193B,A02,083464,Staff,18,0,30,12
1649875109917,MATH 193B,A03,083465,Staff,26,0,30,4
1649875115976,COGS 2,A01,083966,Boyle; Mary E. T.,22,0,30,8
1649875121998,COGS 9,A01,083968,Staff,51,0,60,9
1649875128021,COGS 14B,A01,083970,Staff,45,0,50,5
1649875134056,COGS 17,A01,092679,Staff,71,0,75,4
1649875140082,COGS 100,A01,083972,Staff,41,0,60,19
1649875152206,COGS 101C,A01,083976,Staff,23,0,30,7
1649875158233,COGS 102A,A01,083978,Johnson; Christine M.,22,0,30,8
1649875164265,COGS 107B,A01,083980,Staff,26,0,50,24
1649875170294,COGS 115,A01,083982,Staff,19,0,30,11
1649875176317,COGS 118B,A01,083367,Staff,0,1,40,40
1649875182341,COGS 172,A01,083984,Provenzano; Emily Kara,18,0,30,12
1649875188378,COGS 177,A00,083368,Staff,0,3,30,30
1649875194406,COGS 186,A01,083986,Staff,25,0,40,15
1649875200428,COGS 187A,A01,083988,Boyle; Mary E. T.,36,0,60,24
1649875206452,CSE 8A,A50,084003,Miranda; Gregory Joseph,8,0,15,7
1649875212479,CSE 11,A01,084005,Miranda; Gregory Joseph,47,0,55,8
1649875218510,CSE 20,A01,084007,Staff,15,0,20,5
1649875224536,CSE 21,A01,084009,Staff,31,0,50,19
1649875230562,CSE 30,A01,083370,Cao; Yingjun,13,0,40,27
1649875236587,CSE 100,A01,083372,Cao; Yingjun,5,0,40,35
1649875242617,CSE 101,A01,084011,Staff,0,28,40,40
1649875248640,CSE 141,A01,083374,Eldon; John,1,35,75,74
1649875254663,CSE 141L,A01,083376,Eldon; John,1,39,75,74
1649875260690,CSE 175,A01,084013,Kumar; Rakesh,22,0,25,3
1649875266713,CSE 190,A00,092508,Staff,15,0,15,0
1649875272752,ECE 5,A01,084049,Morris; Karcher William,17,0,20,3
1649875278787,ECE 100,A01,084051,Baghdadchi; Saharnaz,12,0,20,8
1649875278787,ECE 100,A02,091916,Baghdadchi; Saharnaz,18,0,20,2
1649875284812,ECE 101,A01,084053,Baghdadchi; Saharnaz,21,0,37,16
1649875284812,ECE 101,A02,084054,Baghdadchi; Saharnaz,37,0,37,0
1649875290838,ECE 107,A01,083390,Staff,31,0,40,9
1649875296860,ECE 148,A01,084056,Silberman; Jack,7,0,12,5
1649875302882,ECE 180,A00,083391,Abi Samra; Nicholas Camill,26,0,30,4
1649875302882,ECE 180,B00,083392,Abi Samra; Nicholas Camill,25,0,30,5
1649875308918,MATH 10B,A01,084110,Staff,18,0,30,12
1649875308918,MATH 10B,A02,084111,Staff,29,0,30,1
1649875308918,MATH 10B,A03,084112,Staff,29,0,30,1
1649875314951,MATH 10C,A01,083443,Staff,17,0,30,13
1649875314951,MATH 10C,A02,083444,Staff,22,0,30,8
1649875314951,MATH 10C,B01,084114,Staff,26,0,30,4
1649875314951,MATH 10C,B02,084115,Staff,30,0,30,0
1649875320980,MATH 18,A01,084117,Harel; Guershon,27,0,30,3
1649875320980,MATH 18,A02,084119,Harel; Guershon,29,0,30,1
1649875320980,MATH 18,A03,084120,Harel; Guershon,30,0,30,0
1649875320980,MATH 18,A04,084121,Harel; Guershon,30,0,30,0
1649875327004,MATH 20B,A01,084124,Um; Ko Woon,33,0,35,2
1649875327004,MATH 20B,B01,084126,Um; Ko Woon,34,0,35,1
1649875333030,MATH 20C,A01,083446,Hammock; Frances H,25,0,30,5
1649875333030,MATH 20C,A02,083447,Hammock; Frances H,29,0,30,1
1649875333030,MATH 20C,A03,083448,Hammock; Frances H,30,0,30,0
1649875333030,MATH 20C,A04,083449,Hammock; Frances H,30,0,30,0
1649875333030,MATH 20C,B01,083451,Hammock; Frances H,29,0,30,1
1649875333030,MATH 20C,B02,083452,Hammock; Frances H,29,0,30,1
1649875333030,MATH 20C,B03,083453,Hammock; Frances H,30,0,30,0
1649875333030,MATH 20C,B04,083454,Hammock; Frances H,30,0,30,0
1649875339054,MATH 20D,A01,084128,Staff,29,0,30,1
1649875339054,MATH 20D,A02,084129,Staff,30,0,30,0
1649875339054,MATH 20D,A03,084130,Staff,29,0,30,1
1649875339054,MATH 20D,B01,084133,Staff,28,0,30,2
1649875339054,MATH 20D,B02,084134,Staff,30,0,30,0
1649875339054,MATH 20D,B03,084135,Staff,30,0,30,0
1649875345077,MATH 20E,A01,084138,Staff,25,0,30,5
1649875345077,MATH 20E,A02,084139,Staff,27,0,30,3
1649875345077,MATH 20E,A03,084140,Staff,26,0,30,4
1649875345077,MATH 20E,A04,084141,Staff,29,0,30,1
1649875351104,MATH 102,A01,084143,Harel; Guershon,23,0,30,7
1649875351104,MATH 102,A02,084144,Harel; Guershon,24,0,30,6
1649875357134,MATH 103B,A01,083456,Staff,0,2,30,30
1649875357134,MATH 103B,A02,083457,Staff,8,0,30,22
1649875363160,MATH 109,A01,084146,Salehi Golsefidy; Alireza,29,0,30,1
1649875363160,MATH 109,A02,084147,Salehi Golsefidy; Alireza,25,0,30,5
1649875369191,MATH 120A,A01,085445,Eggers; John Dietrich,25,0,35,10
1649875369191,MATH 120A,A02,085446,Eggers; John Dietrich,30,0,35,5
1649875375221,MATH 142B,A01,084149,Verstraete; Jacques Allan,0,0,30,30
1649875375221,MATH 142B,A02,084150,Verstraete; Jacques Allan,20,0,30,10
1649875381249,MATH 170A,A01,083459,Nie; Jiawang,0,0,30,30
1649875381249,MATH 170A,A02,083460,Nie; Jiawang,21,0,30,9
1649875381249,MATH 170A,A03,083461,Nie; Jiawang,23,0,30,7
1649875387271,MATH 193B,A01,083463,Staff,12,0,30,18
1649875387271,MATH 193B,A02,083464,Staff,18,0,30,12
1649875387271,MATH 193B,A03,083465,Staff,26,0,30,4
1649875393320,COGS 2,A01,083966,Boyle; Mary E. T.,22,0,30,8
1649875399342,COGS 9,A01,083968,Staff,51,0,60,9
1649875405365,COGS 14B,A01,083970,Staff,45,0,50,5
1649875411389,COGS 17,A01,092679,Staff,71,0,75,4
1649875417412,COGS 100,A01,083972,Staff,40,0,60,20
1649875429469,COGS 101C,A01,083976,Staff,23,0,30,7
1649875435502,COGS 102A,A01,083978,Johnson; Christine M.,21,0,30,9
1649875441535,COGS 107B,A01,083980,Staff,26,0,50,24
1649875447563,COGS 115,A01,083982,Staff,19,0,30,11
1649875453591,COGS 118B,A01,083367,Staff,0,1,40,40
1649875459617,COGS 172,A01,083984,Provenzano; Emily Kara,18,0,30,12
1649875465641,COGS 177,A00,083368,Staff,0,3,30,30
1649875471668,COGS 186,A01,083986,Staff,25,0,40,15
1649875477690,COGS 187A,A01,083988,Boyle; Mary E. T.,36,0,60,24
1649875483713,CSE 8A,A50,084003,Miranda; Gregory Joseph,8,0,15,7
1649875489740,CSE 11,A01,084005,Miranda; Gregory Joseph,47,0,55,8
1649875495771,CSE 20,A01,084007,Staff,15,0,20,5
1649875501796,CSE 21,A01,084009,Staff,30,0,50,20
1649875507819,CSE 30,A01,083370,Cao; Yingjun,12,0,40,28
1649875513846,CSE 100,A01,083372,Cao; Yingjun,5,0,40,35
1649875519972,CSE 101,A01,084011,Staff,0,29,40,40
1649875525998,CSE 141,A01,083374,Eldon; John,1,37,75,74
1649875532022,CSE 141L,A01,083376,Eldon; John,1,41,75,74
1649875538053,CSE 175,A01,084013,Kumar; Rakesh,22,0,25,3
1649875544079,CSE 190,A00,092508,Staff,15,0,15,0
1649875550101,ECE 5,A01,084049,Morris; Karcher William,17,0,20,3
1649875556145,ECE 100,A01,084051,Baghdadchi; Saharnaz,12,0,20,8
1649875556145,ECE 100,A02,091916,Baghdadchi; Saharnaz,18,0,20,2
1649875562179,ECE 101,A01,084053,Baghdadchi; Saharnaz,21,0,37,16
1649875562179,ECE 101,A02,084054,Baghdadchi; Saharnaz,37,0,37,0
1649875568209,ECE 107,A01,083390,Staff,31,0,40,9
1649875574237,ECE 148,A01,084056,Silberman; Jack,7,0,12,5
1649875580260,ECE 180,A00,083391,Abi Samra; Nicholas Camill,26,0,30,4
1649875580260,ECE 180,B00,083392,Abi Samra; Nicholas Camill,25,0,30,5
1649875586284,MATH 10B,A01,084110,Staff,18,0,30,12
1649875586284,MATH 10B,A02,084111,Staff,29,0,30,1
1649875586284,MATH 10B,A03,084112,Staff,29,0,30,1
1649875592317,MATH 10C,A01,083443,Staff,17,0,30,13
1649875592317,MATH 10C,A02,083444,Staff,22,0,30,8
1649875592317,MATH 10C,B01,084114,Staff,26,0,30,4
1649875592317,MATH 10C,B02,084115,Staff,30,0,30,0
1649875598354,MATH 18,A01,084117,Harel; Guershon,27,0,30,3
1649875598354,MATH 18,A02,084119,Harel; Guershon,29,0,30,1
1649875598354,MATH 18,A03,084120,Harel; Guershon,30,0,30,0
1649875598354,MATH 18,A04,084121,Harel; Guershon,30,0,30,0
1649875604381,MATH 20B,A01,084124,Um; Ko Woon,33,0,35,2
1649875604381,MATH 20B,B01,084126,Um; Ko Woon,33,0,35,2
1649875610409,MATH 20C,A01,083446,Hammock; Frances H,25,0,30,5
1649875610409,MATH 20C,A02,083447,Hammock; Frances H,29,0,30,1
1649875610409,MATH 20C,A03,083448,Hammock; Frances H,30,0,30,0
1649875610409,MATH 20C,A04,083449,Hammock; Frances H,30,0,30,0
1649875610409,MATH 20C,B01,083451,Hammock; Frances H,29,0,30,1
1649875610409,MATH 20C,B02,083452,Hammock; Frances H,29,0,30,1
1649875610409,MATH 20C,B03,083453,Hammock; Frances H,30,0,30,0
1649875610409,MATH 20C,B04,083454,Hammock; Frances H,30,0,30,0
1649875616438,MATH 20D,A01,084128,Staff,29,0,30,1
1649875616438,MATH 20D,A02,084129,Staff,30,0,30,0
1649875616438,MATH 20D,A03,084130,Staff,29,0,30,1
1649875616438,MATH 20D,B01,084133,Staff,28,0,30,2
1649875616438,MATH 20D,B02,084134,Staff,30,0,30,0
1649875616438,MATH 20D,B03,084135,Staff,30,0,30,0
1649875622468,MATH 20E,A01,084138,Staff,25,0,30,5
1649875622468,MATH 20E,A02,084139,Staff,27,0,30,3
1649875622468,MATH 20E,A03,084140,Staff,26,0,30,4
1649875622468,MATH 20E,A04,084141,Staff,29,0,30,1
1649875628503,MATH 102,A01,084143,Harel; Guershon,23,0,30,7
1649875628503,MATH 102,A02,084144,Harel; Guershon,24,0,30,6
1649875634529,MATH 103B,A01,083456,Staff,0,2,30,30
1649875634529,MATH 103B,A02,083457,Staff,8,0,30,22
1649875640554,MATH 109,A01,084146,Salehi Golsefidy; Alireza,29,0,30,1
1649875640554,MATH 109,A02,084147,Salehi Golsefidy; Alireza,25,0,30,5
1649875646579,MATH 120A,A01,085445,Eggers; John Dietrich,25,0,35,10
1649875646579,MATH 120A,A02,085446,Eggers; John Dietrich,30,0,35,5
1649875652608,MATH 142B,A01,084149,Verstraete; Jacques Allan,0,0,30,30
1649875652608,MATH 142B,A02,084150,Verstraete; Jacques Allan,20,0,30,10
1649875658640,MATH 170A,A01,083459,Nie; Jiawang,0,0,30,30
1649875658640,MATH 170A,A02,083460,Nie; Jiawang,21,0,30,9
1649875658640,MATH 170A,A03,083461,Nie; Jiawang,23,0,30,7
1649875664666,MATH 193B,A01,083463,Staff,12,0,30,18
1649875664666,MATH 193B,A02,083464,Staff,18,0,30,12
1649875664666,MATH 193B,A03,083465,Staff,26,0,30,4
1649875670729,COGS 2,A01,083966,Boyle; Mary E. T.,22,0,30,8
1649875676750,COGS 9,A01,083968,Staff,51,0,60,9
1649875682774,COGS 14B,A01,083970,Staff,44,0,50,6
1649875688799,COGS 17,A01,092679,Staff,71,0,75,4
1649875694831,COGS 100,A01,083972,Staff,40,0,60,20
1649875723430,COGS 101C,A01,083976,Staff,23,0,30,7
1649875729455,COGS 102A,A01,083978,Johnson; Christine M.,21,0,30,9
1649875735493,COGS 107B,A01,083980,Staff,26,0,50,24
1649875741527,COGS 115,A01,083982,Staff,19,0,30,11
1649875747551,COGS 118B,A01,083367,Staff,0,1,40,40
1649875753576,COGS 172,A01,083984,Provenzano; Emily Kara,18,0,30,12
1649875759603,COGS 177,A00,083368,Staff,0,5,30,30
1649875765626,COGS 186,A01,083986,Staff,25,0,40,15
1649875771659,COGS 187A,A01,083988,Boyle; Mary E. T.,36,0,60,24
1649875777683,CSE 8A,A50,084003,Miranda; Gregory Joseph,8,0,15,7
1649875783708,CSE 11,A01,084005,Miranda; Gregory Joseph,47,0,55,8
1649875789731,CSE 20,A01,084007,Staff,15,0,20,5
1649875795758,CSE 21,A01,084009,Staff,30,0,50,20
1649875801784,CSE 30,A01,083370,Cao; Yingjun,12,0,40,28
1649875807819,CSE 100,A01,083372,Cao; Yingjun,4,0,40,36
1649875813848,CSE 101,A01,084011,Staff,0,29,40,40
1649875819875,CSE 141,A01,083374,Eldon; John,1,37,75,74
1649875825900,CSE 141L,A01,083376,Eldon; John,1,41,75,74
1649875831937,CSE 175,A01,084013,Kumar; Rakesh,22,0,25,3
1649875837960,CSE 190,A00,092508,Staff,15,0,15,0
1649875843985,ECE 5,A01,084049,Morris; Karcher William,17,0,20,3
1649875850013,ECE 100,A01,084051,Baghdadchi; Saharnaz,11,0,20,9
1649875850013,ECE 100,A02,091916,Baghdadchi; Saharnaz,18,0,20,2
1649875856035,ECE 101,A01,084053,Baghdadchi; Saharnaz,21,0,37,16
1649875856035,ECE 101,A02,084054,Baghdadchi; Saharnaz,37,0,37,0
1649875862060,ECE 107,A01,083390,Staff,31,0,40,9
1649875868087,ECE 148,A01,084056,Silberman; Jack,7,0,12,5
1649875874117,ECE 180,A00,083391,Abi Samra; Nicholas Camill,26,0,30,4
1649875874117,ECE 180,B00,083392,Abi Samra; Nicholas Camill,25,0,30,5
1649875880148,MATH 10B,A01,084110,Staff,18,0,30,12
1649875880148,MATH 10B,A02,084111,Staff,29,0,30,1
1649875880148,MATH 10B,A03,084112,Staff,29,0,30,1
1649875886181,MATH 10C,A01,083443,Staff,16,0,30,14
1649875886181,MATH 10C,A02,083444,Staff,22,0,30,8
1649875886181,MATH 10C,B01,084114,Staff,26,0,30,4
1649875886181,MATH 10C,B02,084115,Staff,30,0,30,0
1649875892204,MATH 18,A01,084117,Harel; Guershon,27,0,30,3
1649875892204,MATH 18,A02,084119,Harel; Guershon,29,0,30,1
1649875892204,MATH 18,A03,084120,Harel; Guershon,30,0,30,0
1649875892204,MATH 18,A04,084121,Harel; Guershon,30,0,30,0
1649875898231,MATH 20B,A01,084124,Um; Ko Woon,33,0,35,2
1649875898231,MATH 20B,B01,084126,Um; Ko Woon,33,0,35,2
1649875904264,MATH 20C,A01,083446,Hammock; Frances H,25,0,30,5
1649875904264,MATH 20C,A02,083447,Hammock; Frances H,29,0,30,1
1649875904264,MATH 20C,A03,083448,Hammock; Frances H,30,0,30,0
1649875904264,MATH 20C,A04,083449,Hammock; Frances H,30,0,30,0
1649875904264,MATH 20C,B01,083451,Hammock; Frances H,29,0,30,1
1649875904264,MATH 20C,B02,083452,Hammock; Frances H,29,0,30,1
1649875904264,MATH 20C,B03,083453,Hammock; Frances H,30,0,30,0
1649875904264,MATH 20C,B04,083454,Hammock; Frances H,30,0,30,0
1649875910291,MATH 20D,A01,084128,Staff,29,0,30,1
1649875910291,MATH 20D,A02,084129,Staff,30,0,30,0
1649875910291,MATH 20D,A03,084130,Staff,29,0,30,1
1649875910291,MATH 20D,B01,084133,Staff,28,0,30,2
1649875910291,MATH 20D,B02,084134,Staff,30,0,30,0
1649875910291,MATH 20D,B03,084135,Staff,30,0,30,0
1649875916322,MATH 20E,A01,084138,Staff,25,0,30,5
1649875916322,MATH 20E,A02,084139,Staff,27,0,30,3
1649875916322,MATH 20E,A03,084140,Staff,26,0,30,4
1649875916322,MATH 20E,A04,084141,Staff,29,0,30,1
1649875922344,MATH 102,A01,084143,Harel; Guershon,23,0,30,7
1649875922344,MATH 102,A02,084144,Harel; Guershon,24,0,30,6
1649875928370,MATH 103B,A01,083456,Staff,0,2,30,30
1649875928370,MATH 103B,A02,083457,Staff,8,0,30,22
1649875934396,MATH 109,A01,084146,Salehi Golsefidy; Alireza,29,0,30,1
1649875934396,MATH 109,A02,084147,Salehi Golsefidy; Alireza,25,0,30,5
1649875940421,MATH 120A,A01,085445,Eggers; John Dietrich,25,0,35,10
1649875940421,MATH 120A,A02,085446,Eggers; John Dietrich,30,0,35,5
1649875946448,MATH 142B,A01,084149,Verstraete; Jacques Allan,0,1,30,30
1649875946448,MATH 142B,A02,084150,Verstraete; Jacques Allan,20,0,30,10
1649875952476,MATH 170A,A01,083459,Nie; Jiawang,0,1,30,30
1649875952476,MATH 170A,A02,083460,Nie; Jiawang,21,0,30,9
1649875952476,MATH 170A,A03,083461,Nie; Jiawang,23,0,30,7
1649875958504,MATH 193B,A01,083463,Staff,12,0,30,18
1649875958504,MATH 193B,A02,083464,Staff,18,0,30,12
1649875958504,MATH 193B,A03,083465,Staff,26,0,30,4
1649875964564,COGS 2,A01,083966,Boyle; Mary E. T.,22,0,30,8
1649875970595,COGS 9,A01,083968,Staff,50,0,60,10
1649875976623,COGS 14B,A01,083970,Staff,44,0,50,6
1649875982647,COGS 17,A01,092679,Staff,71,0,75,4
1649875988670,COGS 100,A01,083972,Staff,40,0,60,20
1649876000718,COGS 101C,A01,083976,Staff,23,0,30,7
1649876006744,COGS 102A,A01,083978,Johnson; Christine M.,21,0,30,9
1649876012769,COGS 107B,A01,083980,Staff,26,0,50,24
1649876018795,COGS 115,A01,083982,Staff,18,0,30,12
1649876024819,COGS 118B,A01,083367,Staff,0,1,40,40
1649876030841,COGS 172,A01,083984,Provenzano; Emily Kara,17,0,30,13
1649876036865,COGS 177,A00,083368,Staff,0,6,30,30
1649876042893,COGS 186,A01,083986,Staff,25,0,40,15
1649876048923,COGS 187A,A01,083988,Boyle; Mary E. T.,36,0,60,24
1649876054954,CSE 8A,A50,084003,Miranda; Gregory Joseph,8,0,15,7
1649876060980,CSE 11,A01,084005,Miranda; Gregory Joseph,47,0,55,8
1649876067006,CSE 20,A01,084007,Staff,15,0,20,5
1649876073031,CSE 21,A01,084009,Staff,29,0,50,21
1649876079055,CSE 30,A01,083370,Cao; Yingjun,12,0,40,28
1649876085078,CSE 100,A01,083372,Cao; Yingjun,4,0,40,36
1649876091104,CSE 101,A01,084011,Staff,0,30,40,40
1649876097130,CSE 141,A01,083374,Eldon; John,1,37,75,74
1649876103158,CSE 141L,A01,083376,Eldon; John,1,41,75,74
1649876109183,CSE 175,A01,084013,Kumar; Rakesh,22,0,25,3
1649876115207,CSE 190,A00,092508,Staff,15,0,15,0
1649876121243,ECE 5,A01,084049,Morris; Karcher William,17,0,20,3
1649876127274,ECE 100,A01,084051,Baghdadchi; Saharnaz,11,0,20,9
1649876127274,ECE 100,A02,091916,Baghdadchi; Saharnaz,18,0,20,2
1649876133439,ECE 101,A01,084053,Baghdadchi; Saharnaz,21,0,37,16
1649876133439,ECE 101,A02,084054,Baghdadchi; Saharnaz,37,0,37,0
1649876139461,ECE 107,A01,083390,Staff,31,0,40,9
1649876145492,ECE 148,A01,084056,Silberman; Jack,7,0,12,5
1649876151526,ECE 180,A00,083391,Abi Samra; Nicholas Camill,26,0,30,4
1649876151526,ECE 180,B00,083392,Abi Samra; Nicholas Camill,25,0,30,5
1649876157549,MATH 10B,A01,084110,Staff,18,0,30,12
1649876157549,MATH 10B,A02,084111,Staff,29,0,30,1
1649876157549,MATH 10B,A03,084112,Staff,29,0,30,1
1649876163577,MATH 10C,A01,083443,Staff,16,0,30,14
1649876163577,MATH 10C,A02,083444,Staff,21,0,30,9
1649876163577,MATH 10C,B01,084114,Staff,26,0,30,4
1649876163577,MATH 10C,B02,084115,Staff,30,0,30,0
1649876169611,MATH 18,A01,084117,Harel; Guershon,27,0,30,3
1649876169611,MATH 18,A02,084119,Harel; Guershon,29,0,30,1
1649876169611,MATH 18,A03,084120,Harel; Guershon,30,0,30,0
1649876169611,MATH 18,A04,084121,Harel; Guershon,30,0,30,0
1649876175634,MATH 20B,A01,084124,Um; Ko Woon,33,0,35,2
1649876175634,MATH 20B,B01,084126,Um; Ko Woon,33,0,35,2
1649876181657,MATH 20C,A01,083446,Hammock; Frances H,25,0,30,5
1649876181657,MATH 20C,A02,083447,Hammock; Frances H,29,0,30,1
1649876181657,MATH 20C,A03,083448,Hammock; Frances H,30,0,30,0
1649876181657,MATH 20C,A04,083449,Hammock; Frances H,30,0,30,0
1649876181657,MATH 20C,B01,083451,Hammock; Frances H,29,0,30,1
1649876181657,MATH 20C,B02,083452,Hammock; Frances H,29,0,30,1
1649876181657,MATH 20C,B03,083453,Hammock; Frances H,30,0,30,0
1649876181657,MATH 20C,B04,083454,Hammock; Frances H,30,0,30,0
1649876187678,MATH 20D,A01,084128,Staff,29,0,30,1
1649876187678,MATH 20D,A02,084129,Staff,30,0,30,0
1649876187678,MATH 20D,A03,084130,Staff,29,0,30,1
1649876187678,MATH 20D,B01,084133,Staff,28,0,30,2
1649876187678,MATH 20D,B02,084134,Staff,30,0,30,0
1649876187678,MATH 20D,B03,084135,Staff,30,0,30,0
1649876193704,MATH 20E,A01,084138,Staff,25,0,30,5
1649876193704,MATH 20E,A02,084139,Staff,27,0,30,3
1649876193704,MATH 20E,A03,084140,Staff,26,0,30,4
1649876193704,MATH 20E,A04,084141,Staff,29,0,30,1
1649876199731,MATH 102,A01,084143,Harel; Guershon,23,0,30,7
1649876199731,MATH 102,A02,084144,Harel; Guershon,24,0,30,6
1649876205754,MATH 103B,A01,083456,Staff,0,2,30,30
1649876205754,MATH 103B,A02,083457,Staff,8,0,30,22
1649876211777,MATH 109,A01,084146,Salehi Golsefidy; Alireza,29,0,30,1
1649876211777,MATH 109,A02,084147,Salehi Golsefidy; Alireza,25,0,30,5
1649876217802,MATH 120A,A01,085445,Eggers; John Dietrich,25,0,35,10
1649876217802,MATH 120A,A02,085446,Eggers; John Dietrich,30,0,35,5
1649876223831,MATH 142B,A01,084149,Verstraete; Jacques Allan,0,1,30,30
1649876223831,MATH 142B,A02,084150,Verstraete; Jacques Allan,20,0,30,10
1649876229869,MATH 170A,A01,083459,Nie; Jiawang,0,0,30,30
1649876229869,MATH 170A,A02,083460,Nie; Jiawang,20,0,30,10
1649876229869,MATH 170A,A03,083461,Nie; Jiawang,23,0,30,7
1649876235891,MATH 193B,A01,083463,Staff,12,0,30,18
1649876235891,MATH 193B,A02,083464,Staff,18,0,30,12
1649876235891,MATH 193B,A03,083465,Staff,26,0,30,4
1649876241953,COGS 2,A01,083966,Boyle; Mary E. T.,22,0,30,8
1649876247976,COGS 9,A01,083968,Staff,50,0,60,10
1649876254011,COGS 14B,A01,083970,Staff,44,0,50,6
1649876260034,COGS 17,A01,092679,Staff,71,0,75,4
1649876266069,COGS 100,A01,083972,Staff,40,0,60,20
1649876278134,COGS 101C,A01,083976,Staff,23,0,30,7
1649876284165,COGS 102A,A01,083978,Johnson; Christine M.,21,0,30,9
1649876290193,COGS 107B,A01,083980,Staff,26,0,50,24
1649876296215,COGS 115,A01,083982,Staff,18,0,30,12
1649876302249,COGS 118B,A01,083367,Staff,0,2,40,40
1649876308272,COGS 172,A01,083984,Provenzano; Emily Kara,17,0,30,13
1649876314302,COGS 177,A00,083368,Staff,0,6,30,30
1649876320325,COGS 186,A01,083986,Staff,25,0,40,15
1649876326356,COGS 187A,A01,083988,Boyle; Mary E. T.,36,0,60,24
1649876332383,CSE 8A,A50,084003,Miranda; Gregory Joseph,8,0,15,7
1649876338410,CSE 11,A01,084005,Miranda; Gregory Joseph,47,0,55,8
1649876344443,CSE 20,A01,084007,Staff,15,0,20,5
1649876350470,CSE 21,A01,084009,Staff,29,0,50,21
1649876356493,CSE 30,A01,083370,Cao; Yingjun,11,0,40,29
1649876362523,CSE 100,A01,083372,Cao; Yingjun,4,0,40,36
1649876368569,CSE 101,A01,084011,Staff,0,30,40,40
1649876374591,CSE 141,A01,083374,Eldon; John,1,37,75,74
1649876380618,CSE 141L,A01,083376,Eldon; John,1,41,75,74
1649876386640,CSE 175,A01,084013,Kumar; Rakesh,22,0,25,3
1649876392663,CSE 190,A00,092508,Staff,15,0,15,0
1649876398686,ECE 5,A01,084049,Morris; Karcher William,17,0,20,3
1649876404724,ECE 100,A01,084051,Baghdadchi; Saharnaz,11,0,20,9
1649876404724,ECE 100,A02,091916,Baghdadchi; Saharnaz,18,0,20,2
1649876410750,ECE 101,A01,084053,Baghdadchi; Saharnaz,21,0,37,16
1649876410750,ECE 101,A02,084054,Baghdadchi; Saharnaz,37,0,37,0
1649876416783,ECE 107,A01,083390,Staff,31,0,40,9
1649876422805,ECE 148,A01,084056,Silberman; Jack,7,0,12,5
1649876428834,ECE 180,A00,083391,Abi Samra; Nicholas Camill,26,0,30,4
1649876428834,ECE 180,B00,083392,Abi Samra; Nicholas Camill,25,0,30,5
1649876434858,MATH 10B,A01,084110,Staff,18,0,30,12
1649876434858,MATH 10B,A02,084111,Staff,29,0,30,1
1649876434858,MATH 10B,A03,084112,Staff,29,0,30,1
1649876440887,MATH 10C,A01,083443,Staff,16,0,30,14
1649876440887,MATH 10C,A02,083444,Staff,21,0,30,9
1649876440887,MATH 10C,B01,084114,Staff,26,0,30,4
1649876440887,MATH 10C,B02,084115,Staff,30,0,30,0
1649876446913,MATH 18,A01,084117,Harel; Guershon,27,0,30,3
1649876446913,MATH 18,A02,084119,Harel; Guershon,29,0,30,1
1649876446913,MATH 18,A03,084120,Harel; Guershon,30,0,30,0
1649876446913,MATH 18,A04,084121,Harel; Guershon,30,0,30,0
1649876452935,MATH 20B,A01,084124,Um; Ko Woon,33,0,35,2
1649876452935,MATH 20B,B01,084126,Um; Ko Woon,33,0,35,2
1649876458970,MATH 20C,A01,083446,Hammock; Frances H,25,0,30,5
1649876458970,MATH 20C,A02,083447,Hammock; Frances H,29,0,30,1
1649876458970,MATH 20C,A03,083448,Hammock; Frances H,30,0,30,0
1649876458970,MATH 20C,A04,083449,Hammock; Frances H,30,0,30,0
1649876458970,MATH 20C,B01,083451,Hammock; Frances H,29,0,30,1
1649876458970,MATH 20C,B02,083452,Hammock; Frances H,29,0,30,1
1649876458970,MATH 20C,B03,083453,Hammock; Frances H,30,0,30,0
1649876458970,MATH 20C,B04,083454,Hammock; Frances H,30,0,30,0
1649876465003,MATH 20D,A01,084128,Staff,29,0,30,1
1649876465003,MATH 20D,A02,084129,Staff,30,0,30,0
1649876465003,MATH 20D,A03,084130,Staff,29,0,30,1
1649876465003,MATH 20D,B01,084133,Staff,28,0,30,2
1649876465003,MATH 20D,B02,084134,Staff,30,0,30,0
1649876465003,MATH 20D,B03,084135,Staff,30,0,30,0
1649876471028,MATH 20E,A01,084138,Staff,25,0,30,5
1649876471028,MATH 20E,A02,084139,Staff,27,0,30,3
1649876471028,MATH 20E,A03,084140,Staff,26,0,30,4
1649876471028,MATH 20E,A04,084141,Staff,29,0,30,1
1649876477052,MATH 102,A01,084143,Harel; Guershon,23,0,30,7
1649876477052,MATH 102,A02,084144,Harel; Guershon,24,0,30,6
1649876483079,MATH 103B,A01,083456,Staff,0,2,30,30
1649876483079,MATH 103B,A02,083457,Staff,8,0,30,22
1649876489107,MATH 109,A01,084146,Salehi Golsefidy; Alireza,29,0,30,1
1649876489107,MATH 109,A02,084147,Salehi Golsefidy; Alireza,25,0,30,5
1649876495131,MATH 120A,A01,085445,Eggers; John Dietrich,25,0,35,10
1649876495131,MATH 120A,A02,085446,Eggers; John Dietrich,30,0,35,5
1649876501161,MATH 142B,A01,084149,Verstraete; Jacques Allan,0,1,30,30
1649876501161,MATH 142B,A02,084150,Verstraete; Jacques Allan,20,0,30,10
1649876507188,MATH 170A,A01,083459,Nie; Jiawang,0,0,30,30
1649876507188,MATH 170A,A02,083460,Nie; Jiawang,20,0,30,10
1649876507188,MATH 170A,A03,083461,Nie; Jiawang,23,0,30,7
1649876513228,MATH 193B,A01,083463,Staff,12,0,30,18
1649876513228,MATH 193B,A02,083464,Staff,18,0,30,12
1649876513228,MATH 193B,A03,083465,Staff,26,0,30,4
1649876519280,COGS 2,A01,083966,Boyle; Mary E. T.,22,0,30,8
1649876525302,COGS 9,A01,083968,Staff,50,0,60,10
1649876531342,COGS 14B,A01,083970,Staff,44,0,50,6
1649876537376,COGS 17,A01,092679,Staff,71,0,75,4
1649876543408,COGS 100,A01,083972,Staff,40,0,60,20
1649876555463,COGS 101C,A01,083976,Staff,23,0,30,7
1649876561486,COGS 102A,A01,083978,Johnson; Christine M.,21,0,30,9
1649876567512,COGS 107B,A01,083980,Staff,25,0,50,25
1649876573539,COGS 115,A01,083982,Staff,18,0,30,12
1649876579563,COGS 118B,A01,083367,Staff,0,2,40,40
1649876585601,COGS 172,A01,083984,Provenzano; Emily Kara,17,0,30,13
1649876591627,COGS 177,A00,083368,Staff,1,6,30,29
1649876597655,COGS 186,A01,083986,Staff,25,0,40,15
1649876603678,COGS 187A,A01,083988,Boyle; Mary E. T.,36,0,60,24
1649876609714,CSE 8A,A50,084003,Miranda; Gregory Joseph,8,0,15,7
1649876615740,CSE 11,A01,084005,Miranda; Gregory Joseph,47,0,55,8
1649876621766,CSE 20,A01,084007,Staff,15,0,20,5
1649876627789,CSE 21,A01,084009,Staff,28,0,50,22
1649876633812,CSE 30,A01,083370,Cao; Yingjun,11,0,40,29
1649876639838,CSE 100,A01,083372,Cao; Yingjun,4,0,40,36
1649876645860,CSE 101,A01,084011,Staff,0,31,40,40
1649876651887,CSE 141,A01,083374,Eldon; John,1,37,75,74
1649876657908,CSE 141L,A01,083376,Eldon; John,1,41,75,74
1649876663936,CSE 175,A01,084013,Kumar; Rakesh,22,0,25,3
1649876669961,CSE 190,A00,092508,Staff,15,0,15,0
1649876675987,ECE 5,A01,084049,Morris; Karcher William,17,0,20,3
1649876682012,ECE 100,A01,084051,Baghdadchi; Saharnaz,11,0,20,9
1649876682012,ECE 100,A02,091916,Baghdadchi; Saharnaz,18,0,20,2
1649876688045,ECE 101,A01,084053,Baghdadchi; Saharnaz,21,0,37,16
1649876688045,ECE 101,A02,084054,Baghdadchi; Saharnaz,37,0,37,0
1649876694076,ECE 107,A01,083390,Staff,31,0,40,9
1649876700110,ECE 148,A01,084056,Silberman; Jack,7,0,12,5
1649876706134,ECE 180,A00,083391,Abi Samra; Nicholas Camill,26,0,30,4
1649876706134,ECE 180,B00,083392,Abi Samra; Nicholas Camill,24,0,30,6
1649876712161,MATH 10B,A01,084110,Staff,18,0,30,12
1649876712161,MATH 10B,A02,084111,Staff,29,0,30,1
1649876712161,MATH 10B,A03,084112,Staff,29,0,30,1
1649876718184,MATH 10C,A01,083443,Staff,16,0,30,14
1649876718184,MATH 10C,A02,083444,Staff,20,0,30,10
1649876718184,MATH 10C,B01,084114,Staff,26,0,30,4
1649876718184,MATH 10C,B02,084115,Staff,30,0,30,0
1649876724214,MATH 18,A01,084117,Harel; Guershon,27,0,30,3
1649876724214,MATH 18,A02,084119,Harel; Guershon,29,0,30,1
1649876724214,MATH 18,A03,084120,Harel; Guershon,30,0,30,0
1649876724214,MATH 18,A04,084121,Harel; Guershon,30,0,30,0
1649876730314,MATH 20B,A01,084124,Um; Ko Woon,33,0,35,2
1649876730314,MATH 20B,B01,084126,Um; Ko Woon,33,0,35,2
1649876736336,MATH 20C,A01,083446,Hammock; Frances H,25,0,30,5
1649876736336,MATH 20C,A02,083447,Hammock; Frances H,29,0,30,1
1649876736336,MATH 20C,A03,083448,Hammock; Frances H,30,0,30,0
1649876736336,MATH 20C,A04,083449,Hammock; Frances H,30,0,30,0
1649876736336,MATH 20C,B01,083451,Hammock; Frances H,29,0,30,1
1649876736336,MATH 20C,B02,083452,Hammock; Frances H,29,0,30,1
1649876736336,MATH 20C,B03,083453,Hammock; Frances H,30,0,30,0
1649876736336,MATH 20C,B04,083454,Hammock; Frances H,30,0,30,0
1649876742365,MATH 20D,A01,084128,Staff,29,0,30,1
1649876742365,MATH 20D,A02,084129,Staff,30,0,30,0
1649876742365,MATH 20D,A03,084130,Staff,29,0,30,1
1649876742365,MATH 20D,B01,084133,Staff,28,0,30,2
1649876742365,MATH 20D,B02,084134,Staff,29,0,30,1
1649876742365,MATH 20D,B03,084135,Staff,30,0,30,0
1649876748392,MATH 20E,A01,084138,Staff,25,0,30,5
1649876748392,MATH 20E,A02,084139,Staff,27,0,30,3
1649876748392,MATH 20E,A03,084140,Staff,26,0,30,4
1649876748392,MATH 20E,A04,084141,Staff,29,0,30,1
1649876754424,MATH 102,A01,084143,Harel; Guershon,23,0,30,7
1649876754424,MATH 102,A02,084144,Harel; Guershon,24,0,30,6
1649876760457,MATH 103B,A01,083456,Staff,0,2,30,30
1649876760457,MATH 103B,A02,083457,Staff,7,0,30,23
1649876766488,MATH 109,A01,084146,Salehi Golsefidy; Alireza,29,0,30,1
1649876766488,MATH 109,A02,084147,Salehi Golsefidy; Alireza,25,0,30,5
1649876772512,MATH 120A,A01,085445,Eggers; John Dietrich,25,0,35,10
1649876772512,MATH 120A,A02,085446,Eggers; John Dietrich,30,0,35,5
1649876778552,MATH 142B,A01,084149,Verstraete; Jacques Allan,0,2,30,30
1649876778552,MATH 142B,A02,084150,Verstraete; Jacques Allan,20,0,30,10
1649876784590,MATH 170A,A01,083459,Nie; Jiawang,0,1,30,30
1649876784590,MATH 170A,A02,083460,Nie; Jiawang,20,0,30,10
1649876784590,MATH 170A,A03,083461,Nie; Jiawang,22,0,30,8
1649876790617,MATH 193B,A01,083463,Staff,12,0,30,18
1649876790617,MATH 193B,A02,083464,Staff,18,0,30,12
1649876790617,MATH 193B,A03,083465,Staff,26,0,30,4
1649876796685,COGS 2,A01,083966,Boyle; Mary E. T.,22,0,30,8
1649876802711,COGS 9,A01,083968,Staff,50,0,60,10
1649876808738,COGS 14B,A01,083970,Staff,44,0,50,6
1649876814759,COGS 17,A01,092679,Staff,71,0,75,4
1649876820789,COGS 100,A01,083972,Staff,40,0,60,20
1649876832843,COGS 101C,A01,083976,Staff,23,0,30,7
1649876838866,COGS 102A,A01,083978,Johnson; Christine M.,21,0,30,9
1649876844888,COGS 107B,A01,083980,Staff,25,0,50,25
1649876850913,COGS 115,A01,083982,Staff,18,0,30,12
1649876856941,COGS 118B,A01,083367,Staff,0,3,40,40
1649876862968,COGS 172,A01,083984,Provenzano; Emily Kara,17,0,30,13
1649876868991,COGS 177,A00,083368,Staff,1,6,30,29
1649876875014,COGS 186,A01,083986,Staff,25,0,40,15
1649876881041,COGS 187A,A01,083988,Boyle; Mary E. T.,36,0,60,24
1649876887064,CSE 8A,A50,084003,Miranda; Gregory Joseph,8,0,15,7
1649876893114,CSE 11,A01,084005,Miranda; Gregory Joseph,47,0,55,8
1649876899138,CSE 20,A01,084007,Staff,15,0,20,5
1649876905169,CSE 21,A01,084009,Staff,28,0,50,22
1649876911201,CSE 30,A01,083370,Cao; Yingjun,11,0,40,29
1649876917231,CSE 100,A01,083372,Cao; Yingjun,4,0,40,36
1649876923257,CSE 101,A01,084011,Staff,0,31,40,40
1649876929280,CSE 141,A01,083374,Eldon; John,1,37,75,74
1649876935312,CSE 141L,A01,083376,Eldon; John,1,41,75,74
1649876941345,CSE 175,A01,084013,Kumar; Rakesh,22,0,25,3
1649876947368,CSE 190,A00,092508,Staff,15,0,15,0
1649876953393,ECE 5,A01,084049,Morris; Karcher William,17,0,20,3
1649876959419,ECE 100,A01,084051,Baghdadchi; Saharnaz,11,0,20,9
1649876959419,ECE 100,A02,091916,Baghdadchi; Saharnaz,18,0,20,2
1649876965441,ECE 101,A01,084053,Baghdadchi; Saharnaz,20,0,37,17
1649876965441,ECE 101,A02,084054,Baghdadchi; Saharnaz,37,0,37,0
1649876971468,ECE 107,A01,083390,Staff,31,0,40,9
1649876977498,ECE 148,A01,084056,Silberman; Jack,7,0,12,5
1649876983522,ECE 180,A00,083391,Abi Samra; Nicholas Camill,26,0,30,4
1649876983522,ECE 180,B00,083392,Abi Samra; Nicholas Camill,24,0,30,6
1649876989545,MATH 10B,A01,084110,Staff,18,0,30,12
1649876989545,MATH 10B,A02,084111,Staff,29,0,30,1
1649876989545,MATH 10B,A03,084112,Staff,29,0,30,1
1649876995570,MATH 10C,A01,083443,Staff,16,0,30,14
1649876995570,MATH 10C,A02,083444,Staff,20,0,30,10
1649876995570,MATH 10C,B01,084114,Staff,26,0,30,4
1649876995570,MATH 10C,B02,084115,Staff,30,0,30,0
1649877001593,MATH 18,A01,084117,Harel; Guershon,27,0,30,3
1649877001593,MATH 18,A02,084119,Harel; Guershon,29,0,30,1
1649877001593,MATH 18,A03,084120,Harel; Guershon,30,0,30,0
1649877001593,MATH 18,A04,084121,Harel; Guershon,30,0,30,0
1649877007633,MATH 20B,A01,084124,Um; Ko Woon,33,0,35,2
1649877007633,MATH 20B,B01,084126,Um; Ko Woon,33,0,35,2
1649877013661,MATH 20C,A01,083446,Hammock; Frances H,25,0,30,5
1649877013661,MATH 20C,A02,083447,Hammock; Frances H,29,0,30,1
1649877013661,MATH 20C,A03,083448,Hammock; Frances H,30,0,30,0
1649877013661,MATH 20C,A04,083449,Hammock; Frances H,30,0,30,0
1649877013661,MATH 20C,B01,083451,Hammock; Frances H,29,0,30,1
1649877013661,MATH 20C,B02,083452,Hammock; Frances H,29,0,30,1
1649877013661,MATH 20C,B03,083453,Hammock; Frances H,30,0,30,0
1649877013661,MATH 20C,B04,083454,Hammock; Frances H,30,0,30,0
1649877019690,MATH 20D,A01,084128,Staff,29,0,30,1
1649877019690,MATH 20D,A02,084129,Staff,30,0,30,0
1649877019690,MATH 20D,A03,084130,Staff,29,0,30,1
1649877019690,MATH 20D,B01,084133,Staff,28,0,30,2
1649877019690,MATH 20D,B02,084134,Staff,29,0,30,1
1649877019690,MATH 20D,B03,084135,Staff,30,0,30,0
1649877025719,MATH 20E,A01,084138,Staff,25,0,30,5
1649877025719,MATH 20E,A02,084139,Staff,27,0,30,3
1649877025719,MATH 20E,A03,084140,Staff,26,0,30,4
1649877025719,MATH 20E,A04,084141,Staff,29,0,30,1
1649877031758,MATH 102,A01,084143,Harel; Guershon,23,0,30,7
1649877031758,MATH 102,A02,084144,Harel; Guershon,24,0,30,6
1649877037784,MATH 103B,A01,083456,Staff,0,2,30,30
1649877037784,MATH 103B,A02,083457,Staff,7,0,30,23
1649877043807,MATH 109,A01,084146,Salehi Golsefidy; Alireza,29,0,30,1
1649877043807,MATH 109,A02,084147,Salehi Golsefidy; Alireza,25,0,30,5
1649877049830,MATH 120A,A01,085445,Eggers; John Dietrich,25,0,35,10
1649877049830,MATH 120A,A02,085446,Eggers; John Dietrich,30,0,35,5
1649877055864,MATH 142B,A01,084149,Verstraete; Jacques Allan,0,2,30,30
1649877055864,MATH 142B,A02,084150,Verstraete; Jacques Allan,20,0,30,10
1649877061893,MATH 170A,A01,083459,Nie; Jiawang,0,1,30,30
1649877061893,MATH 170A,A02,083460,Nie; Jiawang,20,0,30,10
1649877061893,MATH 170A,A03,083461,Nie; Jiawang,22,0,30,8
1649877067918,MATH 193B,A01,083463,Staff,12,0,30,18
1649877067918,MATH 193B,A02,083464,Staff,18,0,30,12
1649877067918,MATH 193B,A03,083465,Staff,26,0,30,4
1649877073996,COGS 2,A01,083966,Boyle; Mary E. T.,22,0,30,8
1649877080019,COGS 9,A01,083968,Staff,50,0,60,10
1649877086040,COGS 14B,A01,083970,Staff,44,0,50,6
1649877092064,COGS 17,A01,092679,Staff,71,0,75,4
1649877098084,COGS 100,A01,083972,Staff,40,0,60,20
1649877110141,COGS 101C,A01,083976,Staff,23,0,30,7
1649877116173,COGS 102A,A01,083978,Johnson; Christine M.,21,0,30,9
1649877122195,COGS 107B,A01,083980,Staff,25,0,50,25
1649877128229,COGS 115,A01,083982,Staff,18,0,30,12
1649877134255,COGS 118B,A01,083367,Staff,0,3,40,40
1649877140277,COGS 172,A01,083984,Provenzano; Emily Kara,17,0,30,13
1649877146300,COGS 177,A00,083368,Staff,1,6,30,29
1649877152326,COGS 186,A01,083986,Staff,25,0,40,15
1649877158349,COGS 187A,A01,083988,Boyle; Mary E. T.,36,0,60,24
1649877164374,CSE 8A,A50,084003,Miranda; Gregory Joseph,7,0,15,8
1649877170409,CSE 11,A01,084005,Miranda; Gregory Joseph,47,0,55,8
1649877176432,CSE 20,A01,084007,Staff,15,0,20,5
1649877182466,CSE 21,A01,084009,Staff,28,0,50,22
1649877188493,CSE 30,A01,083370,Cao; Yingjun,10,0,40,30
1649877194516,CSE 100,A01,083372,Cao; Yingjun,4,0,40,36
1649877200542,CSE 101,A01,084011,Staff,0,31,40,40
1649877206579,CSE 141,A01,083374,Eldon; John,1,37,75,74
1649877212603,CSE 141L,A01,083376,Eldon; John,1,41,75,74
1649877218629,CSE 175,A01,084013,Kumar; Rakesh,22,0,25,3
1649877224654,CSE 190,A00,092508,Staff,15,0,15,0
1649877230677,ECE 5,A01,084049,Morris; Karcher William,17,0,20,3
1649877236699,ECE 100,A01,084051,Baghdadchi; Saharnaz,11,0,20,9
1649877236699,ECE 100,A02,091916,Baghdadchi; Saharnaz,18,0,20,2
1649877242725,ECE 101,A01,084053,Baghdadchi; Saharnaz,20,0,37,17
1649877242725,ECE 101,A02,084054,Baghdadchi; Saharnaz,37,0,37,0
1649877248750,ECE 107,A01,083390,Staff,31,0,40,9
1649877254783,ECE 148,A01,084056,Silberman; Jack,7,0,12,5
1649877260809,ECE 180,A00,083391,Abi Samra; Nicholas Camill,26,0,30,4
1649877260809,ECE 180,B00,083392,Abi Samra; Nicholas Camill,24,0,30,6
1649877266835,MATH 10B,A01,084110,Staff,18,0,30,12
1649877266835,MATH 10B,A02,084111,Staff,29,0,30,1
1649877266835,MATH 10B,A03,084112,Staff,29,0,30,1
1649877272866,MATH 10C,A01,083443,Staff,15,0,30,15
1649877272866,MATH 10C,A02,083444,Staff,19,0,30,11
1649877272866,MATH 10C,B01,084114,Staff,26,0,30,4
1649877272866,MATH 10C,B02,084115,Staff,30,0,30,0
1649877278888,MATH 18,A01,084117,Harel; Guershon,27,0,30,3
1649877278888,MATH 18,A02,084119,Harel; Guershon,29,0,30,1
1649877278888,MATH 18,A03,084120,Harel; Guershon,30,0,30,0
1649877278888,MATH 18,A04,084121,Harel; Guershon,30,0,30,0
1649877284927,MATH 20B,A01,084124,Um; Ko Woon,33,0,35,2
1649877284927,MATH 20B,B01,084126,Um; Ko Woon,33,0,35,2
1649877290956,MATH 20C,A01,083446,Hammock; Frances H,25,0,30,5
1649877290956,MATH 20C,A02,083447,Hammock; Frances H,29,0,30,1
1649877290956,MATH 20C,A03,083448,Hammock; Frances H,30,0,30,0
1649877290956,MATH 20C,A04,083449,Hammock; Frances H,30,0,30,0
1649877290956,MATH 20C,B01,083451,Hammock; Frances H,29,0,30,1
1649877290956,MATH 20C,B02,083452,Hammock; Frances H,29,0,30,1
1649877290956,MATH 20C,B03,083453,Hammock; Frances H,30,0,30,0
1649877290956,MATH 20C,B04,083454,Hammock; Frances H,30,0,30,0
1649877296980,MATH 20D,A01,084128,Staff,29,0,30,1
1649877296980,MATH 20D,A02,084129,Staff,30,0,30,0
1649877296980,MATH 20D,A03,084130,Staff,29,0,30,1
1649877296980,MATH 20D,B01,084133,Staff,28,0,30,2
1649877296980,MATH 20D,B02,084134,Staff,29,0,30,1
1649877296980,MATH 20D,B03,084135,Staff,30,0,30,0
1649877303004,MATH 20E,A01,084138,Staff,25,0,30,5
1649877303004,MATH 20E,A02,084139,Staff,27,0,30,3
1649877303004,MATH 20E,A03,084140,Staff,26,0,30,4
1649877303004,MATH 20E,A04,084141,Staff,29,0,30,1
1649877309026,MATH 102,A01,084143,Harel; Guershon,23,0,30,7
1649877309026,MATH 102,A02,084144,Harel; Guershon,24,0,30,6
1649877315051,MATH 103B,A01,083456,Staff,0,2,30,30
1649877315051,MATH 103B,A02,083457,Staff,7,0,30,23
1649877321074,MATH 109,A01,084146,Salehi Golsefidy; Alireza,29,0,30,1
1649877321074,MATH 109,A02,084147,Salehi Golsefidy; Alireza,25,0,30,5
1649877327187,MATH 120A,A01,085445,Eggers; John Dietrich,25,0,35,10
1649877327187,MATH 120A,A02,085446,Eggers; John Dietrich,30,0,35,5
1649877333213,MATH 142B,A01,084149,Verstraete; Jacques Allan,0,2,30,30
1649877333213,MATH 142B,A02,084150,Verstraete; Jacques Allan,20,0,30,10
1649877339246,MATH 170A,A01,083459,Nie; Jiawang,0,1,30,30
1649877339246,MATH 170A,A02,083460,Nie; Jiawang,20,0,30,10
1649877339246,MATH 170A,A03,083461,Nie; Jiawang,22,0,30,8
1649877345268,MATH 193B,A01,083463,Staff,12,0,30,18
1649877345268,MATH 193B,A02,083464,Staff,18,0,30,12
1649877345268,MATH 193B,A03,083465,Staff,26,0,30,4
1649877351317,COGS 2,A01,083966,Boyle; Mary E. T.,22,0,30,8
1649877357344,COGS 9,A01,083968,Staff,50,0,60,10
1649877363370,COGS 14B,A01,083970,Staff,44,0,50,6
1649877369397,COGS 17,A01,092679,Staff,71,0,75,4
1649877375420,COGS 100,A01,083972,Staff,39,0,60,21
1649877387468,COGS 101C,A01,083976,Staff,23,0,30,7
1649877393490,COGS 102A,A01,083978,Johnson; Christine M.,21,0,30,9
1649877399524,COGS 107B,A01,083980,Staff,24,0,50,26
1649877405547,COGS 115,A01,083982,Staff,18,0,30,12
1649877411570,COGS 118B,A01,083367,Staff,0,3,40,40
1649877417609,COGS 172,A01,083984,Provenzano; Emily Kara,17,0,30,13
1649877423632,COGS 177,A00,083368,Staff,1,6,30,29
1649877429665,COGS 186,A01,083986,Staff,25,0,40,15
1649877435691,COGS 187A,A01,083988,Boyle; Mary E. T.,35,0,60,25
1649877441715,CSE 8A,A50,084003,Miranda; Gregory Joseph,7,0,15,8
1649877447740,CSE 11,A01,084005,Miranda; Gregory Joseph,46,0,55,9
1649877453764,CSE 20,A01,084007,Staff,15,0,20,5
1649877459788,CSE 21,A01,084009,Staff,28,0,50,22
1649877465814,CSE 30,A01,083370,Cao; Yingjun,10,0,40,30
1649877471848,CSE 100,A01,083372,Cao; Yingjun,4,0,40,36
1649877477879,CSE 101,A01,084011,Staff,0,32,40,40
1649877483901,CSE 141,A01,083374,Eldon; John,1,37,75,74
1649877489929,CSE 141L,A01,083376,Eldon; John,1,41,75,74
1649877495959,CSE 175,A01,084013,Kumar; Rakesh,22,0,25,3
1649877501983,CSE 190,A00,092508,Staff,15,0,15,0
1649877508018,ECE 5,A01,084049,Morris; Karcher William,17,0,20,3
1649877514043,ECE 100,A01,084051,Baghdadchi; Saharnaz,11,0,20,9
1649877514043,ECE 100,A02,091916,Baghdadchi; Saharnaz,18,0,20,2
1649877520070,ECE 101,A01,084053,Baghdadchi; Saharnaz,20,0,37,17
1649877520070,ECE 101,A02,084054,Baghdadchi; Saharnaz,37,0,37,0
1649877526098,ECE 107,A01,083390,Staff,31,0,40,9
1649877532140,ECE 148,A01,084056,Silberman; Jack,7,0,12,5
1649877538172,ECE 180,A00,083391,Abi Samra; Nicholas Camill,26,0,30,4
1649877538172,ECE 180,B00,083392,Abi Samra; Nicholas Camill,24,0,30,6
1649877544195,MATH 10B,A01,084110,Staff,18,0,30,12
1649877544195,MATH 10B,A02,084111,Staff,29,0,30,1
1649877544195,MATH 10B,A03,084112,Staff,29,0,30,1
1649877550219,MATH 10C,A01,083443,Staff,15,0,30,15
1649877550219,MATH 10C,A02,083444,Staff,19,0,30,11
1649877550219,MATH 10C,B01,084114,Staff,26,0,30,4
1649877550219,MATH 10C,B02,084115,Staff,30,0,30,0
1649877556245,MATH 18,A01,084117,Harel; Guershon,27,0,30,3
1649877556245,MATH 18,A02,084119,Harel; Guershon,29,0,30,1
1649877556245,MATH 18,A03,084120,Harel; Guershon,30,0,30,0
1649877556245,MATH 18,A04,084121,Harel; Guershon,30,0,30,0
1649877562273,MATH 20B,A01,084124,Um; Ko Woon,33,0,35,2
1649877562273,MATH 20B,B01,084126,Um; Ko Woon,33,0,35,2
1649877568296,MATH 20C,A01,083446,Hammock; Frances H,25,0,30,5
1649877568296,MATH 20C,A02,083447,Hammock; Frances H,29,0,30,1
1649877568296,MATH 20C,A03,083448,Hammock; Frances H,30,0,30,0
1649877568296,MATH 20C,A04,083449,Hammock; Frances H,30,0,30,0
1649877568296,MATH 20C,B01,083451,Hammock; Frances H,29,0,30,1
1649877568296,MATH 20C,B02,083452,Hammock; Frances H,29,0,30,1
1649877568296,MATH 20C,B03,083453,Hammock; Frances H,30,0,30,0
1649877568296,MATH 20C,B04,083454,Hammock; Frances H,30,0,30,0
1649877574331,MATH 20D,A01,084128,Staff,29,0,30,1
1649877574331,MATH 20D,A02,084129,Staff,30,0,30,0
1649877574331,MATH 20D,A03,084130,Staff,29,0,30,1
1649877574331,MATH 20D,B01,084133,Staff,28,0,30,2
1649877574331,MATH 20D,B02,084134,Staff,29,0,30,1
1649877574331,MATH 20D,B03,084135,Staff,30,0,30,0
1649877580360,MATH 20E,A01,084138,Staff,25,0,30,5
1649877580360,MATH 20E,A02,084139,Staff,27,0,30,3
1649877580360,MATH 20E,A03,084140,Staff,26,0,30,4
1649877580360,MATH 20E,A04,084141,Staff,29,0,30,1
1649877586386,MATH 102,A01,084143,Harel; Guershon,23,0,30,7
1649877586386,MATH 102,A02,084144,Harel; Guershon,24,0,30,6
1649877592422,MATH 103B,A01,083456,Staff,0,2,30,30
1649877592422,MATH 103B,A02,083457,Staff,6,0,30,24
1649877598453,MATH 109,A01,084146,Salehi Golsefidy; Alireza,29,0,30,1
1649877598453,MATH 109,A02,084147,Salehi Golsefidy; Alireza,25,0,30,5
1649877604481,MATH 120A,A01,085445,Eggers; John Dietrich,24,0,35,11
1649877604481,MATH 120A,A02,085446,Eggers; John Dietrich,30,0,35,5
1649877610509,MATH 142B,A01,084149,Verstraete; Jacques Allan,0,2,30,30
1649877610509,MATH 142B,A02,084150,Verstraete; Jacques Allan,20,0,30,10
1649877616552,MATH 170A,A01,083459,Nie; Jiawang,0,1,30,30
1649877616552,MATH 170A,A02,083460,Nie; Jiawang,20,0,30,10
1649877616552,MATH 170A,A03,083461,Nie; Jiawang,22,0,30,8
1649877622584,MATH 193B,A01,083463,Staff,12,0,30,18
1649877622584,MATH 193B,A02,083464,Staff,18,0,30,12
1649877622584,MATH 193B,A03,083465,Staff,26,0,30,4
1649877628645,COGS 2,A01,083966,Boyle; Mary E. T.,22,0,30,8
1649877634667,COGS 9,A01,083968,Staff,50,0,60,10
1649877640705,COGS 14B,A01,083970,Staff,43,0,50,7
1649877646728,COGS 17,A01,092679,Staff,71,0,75,4
1649877652751,COGS 100,A01,083972,Staff,39,0,60,21
1649877664817,COGS 101C,A01,083976,Staff,23,0,30,7
1649877670839,COGS 102A,A01,083978,Johnson; Christine M.,21,0,30,9
1649877676863,COGS 107B,A01,083980,Staff,24,0,50,26
1649877682886,COGS 115,A01,083982,Staff,18,0,30,12
1649877688915,COGS 118B,A01,083367,Staff,0,3,40,40
1649877694936,COGS 172,A01,083984,Provenzano; Emily Kara,17,0,30,13
1649877700959,COGS 177,A00,083368,Staff,1,6,30,29
1649877706984,COGS 186,A01,083986,Staff,25,0,40,15
1649877713010,COGS 187A,A01,083988,Boyle; Mary E. T.,35,0,60,25
1649877719033,CSE 8A,A50,084003,Miranda; Gregory Joseph,7,0,15,8
1649877725060,CSE 11,A01,084005,Miranda; Gregory Joseph,46,0,55,9
1649877731091,CSE 20,A01,084007,Staff,15,0,20,5
1649877737126,CSE 21,A01,084009,Staff,28,0,50,22
1649877743149,CSE 30,A01,083370,Cao; Yingjun,10,0,40,30
1649877749180,CSE 100,A01,083372,Cao; Yingjun,3,0,40,37
1649877755222,CSE 101,A01,084011,Staff,0,32,40,40
1649877761245,CSE 141,A01,083374,Eldon; John,1,37,75,74
1649877767268,CSE 141L,A01,083376,Eldon; John,1,41,75,74
1649877773298,CSE 175,A01,084013,Kumar; Rakesh,22,0,25,3
1649877779323,CSE 190,A00,092508,Staff,15,0,15,0
1649877785355,ECE 5,A01,084049,Morris; Karcher William,17,0,20,3
1649877791383,ECE 100,A01,084051,Baghdadchi; Saharnaz,11,0,20,9
1649877791383,ECE 100,A02,091916,Baghdadchi; Saharnaz,18,0,20,2
1649877797410,ECE 101,A01,084053,Baghdadchi; Saharnaz,20,0,37,17
1649877797410,ECE 101,A02,084054,Baghdadchi; Saharnaz,37,0,37,0
1649877803437,ECE 107,A01,083390,Staff,31,0,40,9
1649877809463,ECE 148,A01,084056,Silberman; Jack,7,0,12,5
1649877815493,ECE 180,A00,083391,Abi Samra; Nicholas Camill,26,0,30,4
1649877815493,ECE 180,B00,083392,Abi Samra; Nicholas Camill,24,0,30,6
1649877821516,MATH 10B,A01,084110,Staff,18,0,30,12
1649877821516,MATH 10B,A02,084111,Staff,29,0,30,1
1649877821516,MATH 10B,A03,084112,Staff,29,0,30,1
1649877827543,MATH 10C,A01,083443,Staff,15,0,30,15
1649877827543,MATH 10C,A02,083444,Staff,19,0,30,11
1649877827543,MATH 10C,B01,084114,Staff,26,0,30,4
1649877827543,MATH 10C,B02,084115,Staff,30,0,30,0
1649877833576,MATH 18,A01,084117,Harel; Guershon,27,0,30,3
1649877833576,MATH 18,A02,084119,Harel; Guershon,29,0,30,1
1649877833576,MATH 18,A03,084120,Harel; Guershon,30,0,30,0
1649877833576,MATH 18,A04,084121,Harel; Guershon,30,0,30,0
1649877839600,MATH 20B,A01,084124,Um; Ko Woon,33,0,35,2
1649877839600,MATH 20B,B01,084126,Um; Ko Woon,33,0,35,2
1649877845636,MATH 20C,A01,083446,Hammock; Frances H,25,0,30,5
1649877845636,MATH 20C,A02,083447,Hammock; Frances H,29,0,30,1
1649877845636,MATH 20C,A03,083448,Hammock; Frances H,30,0,30,0
1649877845636,MATH 20C,A04,083449,Hammock; Frances H,30,0,30,0
1649877845636,MATH 20C,B01,083451,Hammock; Frances H,29,0,30,1
1649877845636,MATH 20C,B02,083452,Hammock; Frances H,29,0,30,1
1649877845636,MATH 20C,B03,083453,Hammock; Frances H,30,0,30,0
1649877845636,MATH 20C,B04,083454,Hammock; Frances H,30,0,30,0
1649877851689,MATH 20D,A01,084128,Staff,29,0,30,1
1649877851689,MATH 20D,A02,084129,Staff,30,0,30,0
1649877851689,MATH 20D,A03,084130,Staff,29,0,30,1
1649877851689,MATH 20D,B01,084133,Staff,28,0,30,2
1649877851689,MATH 20D,B02,084134,Staff,29,0,30,1
1649877851689,MATH 20D,B03,084135,Staff,30,0,30,0
1649877857726,MATH 20E,A01,084138,Staff,25,0,30,5
1649877857726,MATH 20E,A02,084139,Staff,27,0,30,3
1649877857726,MATH 20E,A03,084140,Staff,26,0,30,4
1649877857726,MATH 20E,A04,084141,Staff,29,0,30,1
1649877863753,MATH 102,A01,084143,Harel; Guershon,23,0,30,7
1649877863753,MATH 102,A02,084144,Harel; Guershon,24,0,30,6
1649877869780,MATH 103B,A01,083456,Staff,0,2,30,30
1649877869780,MATH 103B,A02,083457,Staff,6,0,30,24
1649877875804,MATH 109,A01,084146,Salehi Golsefidy; Alireza,29,0,30,1
1649877875804,MATH 109,A02,084147,Salehi Golsefidy; Alireza,25,0,30,5
1649877881825,MATH 120A,A01,085445,Eggers; John Dietrich,24,0,35,11
1649877881825,MATH 120A,A02,085446,Eggers; John Dietrich,30,0,35,5
1649877887849,MATH 142B,A01,084149,Verstraete; Jacques Allan,0,2,30,30
1649877887849,MATH 142B,A02,084150,Verstraete; Jacques Allan,18,0,30,12
1649877893883,MATH 170A,A01,083459,Nie; Jiawang,0,1,30,30
1649877893883,MATH 170A,A02,083460,Nie; Jiawang,20,0,30,10
1649877893883,MATH 170A,A03,083461,Nie; Jiawang,21,0,30,9
1649877899911,MATH 193B,A01,083463,Staff,12,0,30,18
1649877899911,MATH 193B,A02,083464,Staff,18,0,30,12
1649877899911,MATH 193B,A03,083465,Staff,26,0,30,4
1649877905959,COGS 2,A01,083966,Boyle; Mary E. T.,22,0,30,8
1649877911984,COGS 9,A01,083968,Staff,49,0,60,11
1649877918104,COGS 14B,A01,083970,Staff,43,0,50,7
1649877924135,COGS 17,A01,092679,Staff,71,0,75,4
1649877930159,COGS 100,A01,083972,Staff,38,0,60,22
1649877942223,COGS 101C,A01,083976,Staff,23,0,30,7
1649877948248,COGS 102A,A01,083978,Johnson; Christine M.,21,0,30,9
1649877954274,COGS 107B,A01,083980,Staff,24,0,50,26
1649877960305,COGS 115,A01,083982,Staff,18,0,30,12
1649877966332,COGS 118B,A01,083367,Staff,0,3,40,40
1649877972367,COGS 172,A01,083984,Provenzano; Emily Kara,17,0,30,13
1649877978402,COGS 177,A00,083368,Staff,1,6,30,29
1649877984425,COGS 186,A01,083986,Staff,25,0,40,15
1649877990449,COGS 187A,A01,083988,Boyle; Mary E. T.,35,0,60,25
1649877996483,CSE 8A,A50,084003,Miranda; Gregory Joseph,7,0,15,8
1649878002506,CSE 11,A01,084005,Miranda; Gregory Joseph,46,0,55,9
1649878008528,CSE 20,A01,084007,Staff,15,0,20,5
1649878014551,CSE 21,A01,084009,Staff,28,0,50,22
1649878020578,CSE 30,A01,083370,Cao; Yingjun,9,0,40,31
1649878026607,CSE 100,A01,083372,Cao; Yingjun,2,0,40,38
1649878032636,CSE 101,A01,084011,Staff,0,32,40,40
1649878038662,CSE 141,A01,083374,Eldon; John,1,37,75,74
1649878044684,CSE 141L,A01,083376,Eldon; John,1,41,75,74
1649878050707,CSE 175,A01,084013,Kumar; Rakesh,22,0,25,3
1649878056729,CSE 190,A00,092508,Staff,15,0,15,0
1649878062755,ECE 5,A01,084049,Morris; Karcher William,17,0,20,3
1649878068790,ECE 100,A01,084051,Baghdadchi; Saharnaz,11,0,20,9
1649878068790,ECE 100,A02,091916,Baghdadchi; Saharnaz,18,0,20,2
1649878074812,ECE 101,A01,084053,Baghdadchi; Saharnaz,20,0,37,17
1649878074812,ECE 101,A02,084054,Baghdadchi; Saharnaz,37,0,37,0
1649878080839,ECE 107,A01,083390,Staff,31,0,40,9
1649878086863,ECE 148,A01,084056,Silberman; Jack,7,0,12,5
1649878092898,ECE 180,A00,083391,Abi Samra; Nicholas Camill,26,0,30,4
1649878092898,ECE 180,B00,083392,Abi Samra; Nicholas Camill,24,0,30,6
1649878098920,MATH 10B,A01,084110,Staff,18,0,30,12
1649878098920,MATH 10B,A02,084111,Staff,29,0,30,1
1649878098920,MATH 10B,A03,084112,Staff,29,0,30,1
1649878104946,MATH 10C,A01,083443,Staff,15,0,30,15
1649878104946,MATH 10C,A02,083444,Staff,19,0,30,11
1649878104946,MATH 10C,B01,084114,Staff,26,0,30,4
1649878104946,MATH 10C,B02,084115,Staff,30,0,30,0
1649878110969,MATH 18,A01,084117,Harel; Guershon,27,0,30,3
1649878110969,MATH 18,A02,084119,Harel; Guershon,29,0,30,1
1649878110969,MATH 18,A03,084120,Harel; Guershon,30,0,30,0
1649878110969,MATH 18,A04,084121,Harel; Guershon,30,0,30,0
1649878116995,MATH 20B,A01,084124,Um; Ko Woon,33,0,35,2
1649878116995,MATH 20B,B01,084126,Um; Ko Woon,33,0,35,2
1649878123022,MATH 20C,A01,083446,Hammock; Frances H,25,0,30,5
1649878123022,MATH 20C,A02,083447,Hammock; Frances H,29,0,30,1
1649878123022,MATH 20C,A03,083448,Hammock; Frances H,30,0,30,0
1649878123022,MATH 20C,A04,083449,Hammock; Frances H,30,0,30,0
1649878123022,MATH 20C,B01,083451,Hammock; Frances H,29,0,30,1
1649878123022,MATH 20C,B02,083452,Hammock; Frances H,29,0,30,1
1649878123022,MATH 20C,B03,083453,Hammock; Frances H,30,0,30,0
1649878123022,MATH 20C,B04,083454,Hammock; Frances H,30,0,30,0
1649878129052,MATH 20D,A01,084128,Staff,29,0,30,1
1649878129052,MATH 20D,A02,084129,Staff,30,0,30,0
1649878129052,MATH 20D,A03,084130,Staff,29,0,30,1
1649878129052,MATH 20D,B01,084133,Staff,28,0,30,2
1649878129052,MATH 20D,B02,084134,Staff,29,0,30,1
1649878129052,MATH 20D,B03,084135,Staff,30,0,30,0
1649878135081,MATH 20E,A01,084138,Staff,25,0,30,5
1649878135081,MATH 20E,A02,084139,Staff,27,0,30,3
1649878135081,MATH 20E,A03,084140,Staff,26,0,30,4
1649878135081,MATH 20E,A04,084141,Staff,29,0,30,1
1649878141110,MATH 102,A01,084143,Harel; Guershon,23,0,30,7
1649878141110,MATH 102,A02,084144,Harel; Guershon,24,0,30,6
1649878147133,MATH 103B,A01,083456,Staff,0,2,30,30
1649878147133,MATH 103B,A02,083457,Staff,5,0,30,25
1649878153162,MATH 109,A01,084146,Salehi Golsefidy; Alireza,29,0,30,1
1649878153162,MATH 109,A02,084147,Salehi Golsefidy; Alireza,25,0,30,5
1649878159189,MATH 120A,A01,085445,Eggers; John Dietrich,23,0,35,12
1649878159189,MATH 120A,A02,085446,Eggers; John Dietrich,30,0,35,5
1649878165212,MATH 142B,A01,084149,Verstraete; Jacques Allan,0,2,30,30
1649878165212,MATH 142B,A02,084150,Verstraete; Jacques Allan,18,0,30,12
1649878171236,MATH 170A,A01,083459,Nie; Jiawang,0,1,30,30
1649878171236,MATH 170A,A02,083460,Nie; Jiawang,20,0,30,10
1649878171236,MATH 170A,A03,083461,Nie; Jiawang,21,0,30,9
1649878177268,MATH 193B,A01,083463,Staff,12,0,30,18
1649878177268,MATH 193B,A02,083464,Staff,18,0,30,12
1649878177268,MATH 193B,A03,083465,Staff,26,0,30,4
1649878183344,COGS 2,A01,083966,Boyle; Mary E. T.,22,0,30,8
1649878189376,COGS 9,A01,083968,Staff,49,0,60,11
1649878195397,COGS 14B,A01,083970,Staff,43,0,50,7
1649878201423,COGS 17,A01,092679,Staff,71,0,75,4
1649878207447,COGS 100,A01,083972,Staff,38,0,60,22
1649878219495,COGS 101C,A01,083976,Staff,23,0,30,7
1649878225526,COGS 102A,A01,083978,Johnson; Christine M.,21,0,30,9
1649878231552,COGS 107B,A01,083980,Staff,24,0,50,26
1649878237580,COGS 115,A01,083982,Staff,18,0,30,12
1649878243675,COGS 118B,A01,083367,Staff,0,3,40,40
1649878249699,COGS 172,A01,083984,Provenzano; Emily Kara,17,0,30,13
1649878255722,COGS 177,A00,083368,Staff,1,6,30,29
1649878261753,COGS 186,A01,083986,Staff,25,0,40,15
1649878267790,COGS 187A,A01,083988,Boyle; Mary E. T.,35,0,60,25
1649878273811,CSE 8A,A50,084003,Miranda; Gregory Joseph,7,0,15,8
1649878279834,CSE 11,A01,084005,Miranda; Gregory Joseph,46,0,55,9
1649878285858,CSE 20,A01,084007,Staff,15,0,20,5
1649878291905,CSE 21,A01,084009,Staff,28,0,50,22
1649878297936,CSE 30,A01,083370,Cao; Yingjun,9,0,40,31
1649878303962,CSE 100,A01,083372,Cao; Yingjun,2,0,40,38
1649878309994,CSE 101,A01,084011,Staff,0,32,40,40
1649878316021,CSE 141,A01,083374,Eldon; John,1,37,75,74
1649878322044,CSE 141L,A01,083376,Eldon; John,1,41,75,74
1649878328081,CSE 175,A01,084013,Kumar; Rakesh,22,0,25,3
1649878334105,CSE 190,A00,092508,Staff,15,0,15,0
1649878340133,ECE 5,A01,084049,Morris; Karcher William,17,0,20,3
1649878346160,ECE 100,A01,084051,Baghdadchi; Saharnaz,11,0,20,9
1649878346160,ECE 100,A02,091916,Baghdadchi; Saharnaz,18,0,20,2
1649878352184,ECE 101,A01,084053,Baghdadchi; Saharnaz,19,0,37,18
1649878352184,ECE 101,A02,084054,Baghdadchi; Saharnaz,37,0,37,0
1649878358230,ECE 107,A01,083390,Staff,31,0,40,9
1649878364255,ECE 148,A01,084056,Silberman; Jack,7,0,12,5
1649878370279,ECE 180,A00,083391,Abi Samra; Nicholas Camill,26,0,30,4
1649878370279,ECE 180,B00,083392,Abi Samra; Nicholas Camill,24,0,30,6
1649878376300,MATH 10B,A01,084110,Staff,18,0,30,12
1649878376300,MATH 10B,A02,084111,Staff,29,0,30,1
1649878376300,MATH 10B,A03,084112,Staff,29,0,30,1
1649878382330,MATH 10C,A01,083443,Staff,15,0,30,15
1649878382330,MATH 10C,A02,083444,Staff,19,0,30,11
1649878382330,MATH 10C,B01,084114,Staff,26,0,30,4
1649878382330,MATH 10C,B02,084115,Staff,30,0,30,0
1649878388361,MATH 18,A01,084117,Harel; Guershon,27,0,30,3
1649878388361,MATH 18,A02,084119,Harel; Guershon,29,0,30,1
1649878388361,MATH 18,A03,084120,Harel; Guershon,30,0,30,0
1649878388361,MATH 18,A04,084121,Harel; Guershon,30,0,30,0
1649878394388,MATH 20B,A01,084124,Um; Ko Woon,33,0,35,2
1649878394388,MATH 20B,B01,084126,Um; Ko Woon,33,0,35,2
1649878400418,MATH 20C,A01,083446,Hammock; Frances H,25,0,30,5
1649878400418,MATH 20C,A02,083447,Hammock; Frances H,29,0,30,1
1649878400418,MATH 20C,A03,083448,Hammock; Frances H,30,0,30,0
1649878400418,MATH 20C,A04,083449,Hammock; Frances H,30,0,30,0
1649878400418,MATH 20C,B01,083451,Hammock; Frances H,29,0,30,1
1649878400418,MATH 20C,B02,083452,Hammock; Frances H,29,0,30,1
1649878400418,MATH 20C,B03,083453,Hammock; Frances H,30,0,30,0
1649878400418,MATH 20C,B04,083454,Hammock; Frances H,30,0,30,0
1649878406442,MATH 20D,A01,084128,Staff,29,0,30,1
1649878406442,MATH 20D,A02,084129,Staff,30,0,30,0
1649878406442,MATH 20D,A03,084130,Staff,29,0,30,1
1649878406442,MATH 20D,B01,084133,Staff,28,0,30,2
1649878406442,MATH 20D,B02,084134,Staff,29,0,30,1
1649878406442,MATH 20D,B03,084135,Staff,30,0,30,0
1649878412472,MATH 20E,A01,084138,Staff,25,0,30,5
1649878412472,MATH 20E,A02,084139,Staff,27,0,30,3
1649878412472,MATH 20E,A03,084140,Staff,26,0,30,4
1649878412472,MATH 20E,A04,084141,Staff,29,0,30,1
1649878418499,MATH 102,A01,084143,Harel; Guershon,23,0,30,7
1649878418499,MATH 102,A02,084144,Harel; Guershon,24,0,30,6
1649878424529,MATH 103B,A01,083456,Staff,0,2,30,30
1649878424529,MATH 103B,A02,083457,Staff,5,0,30,25
1649878430558,MATH 109,A01,084146,Salehi Golsefidy; Alireza,29,0,30,1
1649878430558,MATH 109,A02,084147,Salehi Golsefidy; Alireza,25,0,30,5
1649878436598,MATH 120A,A01,085445,Eggers; John Dietrich,23,0,35,12
1649878436598,MATH 120A,A02,085446,Eggers; John Dietrich,30,0,35,5
1649878442622,MATH 142B,A01,084149,Verstraete; Jacques Allan,0,2,30,30
1649878442622,MATH 142B,A02,084150,Verstraete; Jacques Allan,18,0,30,12
1649878448649,MATH 170A,A01,083459,Nie; Jiawang,0,1,30,30
1649878448649,MATH 170A,A02,083460,Nie; Jiawang,19,0,30,11
1649878448649,MATH 170A,A03,083461,Nie; Jiawang,21,0,30,9
1649878454681,MATH 193B,A01,083463,Staff,12,0,30,18
1649878454681,MATH 193B,A02,083464,Staff,18,0,30,12
1649878454681,MATH 193B,A03,083465,Staff,26,0,30,4
1649878460738,COGS 2,A01,083966,Boyle; Mary E. T.,22,0,30,8
1649878466762,COGS 9,A01,083968,Staff,49,0,60,11
1649878472791,COGS 14B,A01,083970,Staff,42,0,50,8
1649878478814,COGS 17,A01,092679,Staff,71,0,75,4
1649878484839,COGS 100,A01,083972,Staff,37,0,60,23
1649878496893,COGS 101C,A01,083976,Staff,23,0,30,7
1649878502921,COGS 102A,A01,083978,Johnson; Christine M.,21,0,30,9
1649878508946,COGS 107B,A01,083980,Staff,24,0,50,26
1649878515076,COGS 115,A01,083982,Staff,17,0,30,13
1649878521133,COGS 118B,A01,083367,Staff,0,3,40,40
1649878527160,COGS 172,A01,083984,Provenzano; Emily Kara,17,0,30,13
1649878533199,COGS 177,A00,083368,Staff,1,7,30,29
1649878539232,COGS 186,A01,083986,Staff,25,0,40,15
1649878545270,COGS 187A,A01,083988,Boyle; Mary E. T.,35,0,60,25
1649878551292,CSE 8A,A50,084003,Miranda; Gregory Joseph,7,0,15,8
1649878557315,CSE 11,A01,084005,Miranda; Gregory Joseph,45,0,55,10
1649878563336,CSE 20,A01,084007,Staff,14,0,20,6
1649878569373,CSE 21,A01,084009,Staff,28,0,50,22
1649878575396,CSE 30,A01,083370,Cao; Yingjun,9,0,40,31
1649878581420,CSE 100,A01,083372,Cao; Yingjun,2,0,40,38
1649878587444,CSE 101,A01,084011,Staff,0,32,40,40
1649878593467,CSE 141,A01,083374,Eldon; John,1,37,75,74
1649878599494,CSE 141L,A01,083376,Eldon; John,1,41,75,74
1649878605519,CSE 175,A01,084013,Kumar; Rakesh,22,0,25,3
1649878611548,CSE 190,A00,092508,Staff,15,0,15,0
1649878617574,ECE 5,A01,084049,Morris; Karcher William,17,0,20,3
1649878623607,ECE 100,A01,084051,Baghdadchi; Saharnaz,11,0,20,9
1649878623607,ECE 100,A02,091916,Baghdadchi; Saharnaz,18,0,20,2
1649878629631,ECE 101,A01,084053,Baghdadchi; Saharnaz,19,0,37,18
1649878629631,ECE 101,A02,084054,Baghdadchi; Saharnaz,37,0,37,0
1649878635658,ECE 107,A01,083390,Staff,31,0,40,9
1649878641683,ECE 148,A01,084056,Silberman; Jack,7,0,12,5
1649878647705,ECE 180,A00,083391,Abi Samra; Nicholas Camill,26,0,30,4
1649878647705,ECE 180,B00,083392,Abi Samra; Nicholas Camill,23,0,30,7
1649878653729,MATH 10B,A01,084110,Staff,18,0,30,12
1649878653729,MATH 10B,A02,084111,Staff,29,0,30,1
1649878653729,MATH 10B,A03,084112,Staff,29,0,30,1
1649878659753,MATH 10C,A01,083443,Staff,15,0,30,15
1649878659753,MATH 10C,A02,083444,Staff,19,0,30,11
1649878659753,MATH 10C,B01,084114,Staff,26,0,30,4
1649878659753,MATH 10C,B02,084115,Staff,30,0,30,0
1649878665776,MATH 18,A01,084117,Harel; Guershon,27,0,30,3
1649878665776,MATH 18,A02,084119,Harel; Guershon,29,0,30,1
1649878665776,MATH 18,A03,084120,Harel; Guershon,30,0,30,0
1649878665776,MATH 18,A04,084121,Harel; Guershon,30,0,30,0
1649878671799,MATH 20B,A01,084124,Um; Ko Woon,33,0,35,2
1649878671799,MATH 20B,B01,084126,Um; Ko Woon,33,0,35,2
1649878677826,MATH 20C,A01,083446,Hammock; Frances H,25,0,30,5
1649878677826,MATH 20C,A02,083447,Hammock; Frances H,29,0,30,1
1649878677826,MATH 20C,A03,083448,Hammock; Frances H,30,0,30,0
1649878677826,MATH 20C,A04,083449,Hammock; Frances H,30,0,30,0
1649878677826,MATH 20C,B01,083451,Hammock; Frances H,29,0,30,1
1649878677826,MATH 20C,B02,083452,Hammock; Frances H,29,0,30,1
1649878677826,MATH 20C,B03,083453,Hammock; Frances H,30,0,30,0
1649878677826,MATH 20C,B04,083454,Hammock; Frances H,30,0,30,0
1649878683848,MATH 20D,A01,084128,Staff,29,0,30,1
1649878683848,MATH 20D,A02,084129,Staff,30,0,30,0
1649878683848,MATH 20D,A03,084130,Staff,29,0,30,1
1649878683848,MATH 20D,B01,084133,Staff,28,0,30,2
1649878683848,MATH 20D,B02,084134,Staff,29,0,30,1
1649878683848,MATH 20D,B03,084135,Staff,30,0,30,0
1649878689882,MATH 20E,A01,084138,Staff,25,0,30,5
1649878689882,MATH 20E,A02,084139,Staff,27,0,30,3
1649878689882,MATH 20E,A03,084140,Staff,26,0,30,4
1649878689882,MATH 20E,A04,084141,Staff,29,0,30,1
1649878695905,MATH 102,A01,084143,Harel; Guershon,23,0,30,7
1649878695905,MATH 102,A02,084144,Harel; Guershon,24,0,30,6
1649878701928,MATH 103B,A01,083456,Staff,0,2,30,30
1649878701928,MATH 103B,A02,083457,Staff,4,0,30,26
1649878707951,MATH 109,A01,084146,Salehi Golsefidy; Alireza,29,0,30,1
1649878707951,MATH 109,A02,084147,Salehi Golsefidy; Alireza,25,0,30,5
1649878713978,MATH 120A,A01,085445,Eggers; John Dietrich,23,0,35,12
1649878713978,MATH 120A,A02,085446,Eggers; John Dietrich,30,0,35,5
1649878720009,MATH 142B,A01,084149,Verstraete; Jacques Allan,0,2,30,30
1649878720009,MATH 142B,A02,084150,Verstraete; Jacques Allan,18,0,30,12
1649878726035,MATH 170A,A01,083459,Nie; Jiawang,0,1,30,30
1649878726035,MATH 170A,A02,083460,Nie; Jiawang,19,0,30,11
1649878726035,MATH 170A,A03,083461,Nie; Jiawang,21,0,30,9
1649878732058,MATH 193B,A01,083463,Staff,12,0,30,18
1649878732058,MATH 193B,A02,083464,Staff,18,0,30,12
1649878732058,MATH 193B,A03,083465,Staff,26,0,30,4
1649878738113,COGS 2,A01,083966,Boyle; Mary E. T.,22,0,30,8
1649878744136,COGS 9,A01,083968,Staff,49,0,60,11
1649878750163,COGS 14B,A01,083970,Staff,42,0,50,8
1649878756189,COGS 17,A01,092679,Staff,71,0,75,4
1649878762211,COGS 100,A01,083972,Staff,37,0,60,23
1649878774264,COGS 101C,A01,083976,Staff,23,0,30,7
1649878780289,COGS 102A,A01,083978,Johnson; Christine M.,21,0,30,9
1649878786326,COGS 107B,A01,083980,Staff,24,0,50,26
1649878792350,COGS 115,A01,083982,Staff,17,0,30,13
1649878798374,COGS 118B,A01,083367,Staff,0,3,40,40
1649878804396,COGS 172,A01,083984,Provenzano; Emily Kara,17,0,30,13
1649878810426,COGS 177,A00,083368,Staff,1,8,30,29
1649878816450,COGS 186,A01,083986,Staff,25,0,40,15
1649878822476,COGS 187A,A01,083988,Boyle; Mary E. T.,35,0,60,25
1649878828504,CSE 8A,A50,084003,Miranda; Gregory Joseph,7,0,15,8
1649878834532,CSE 11,A01,084005,Miranda; Gregory Joseph,45,0,55,10
1649878847041,CSE 20,A01,084007,Staff,14,0,20,6
1649878853068,CSE 21,A01,084009,Staff,28,0,50,22
1649878859094,CSE 30,A01,083370,Cao; Yingjun,8,0,40,32
1649878865132,CSE 100,A01,083372,Cao; Yingjun,2,0,40,38
1649878871155,CSE 101,A01,084011,Staff,0,32,40,40
1649878877180,CSE 141,A01,083374,Eldon; John,1,37,75,74
1649878883203,CSE 141L,A01,083376,Eldon; John,1,41,75,74
1649878889225,CSE 175,A01,084013,Kumar; Rakesh,22,0,25,3
1649878895250,CSE 190,A00,092508,Staff,15,0,15,0
1649878901282,ECE 5,A01,084049,Morris; Karcher William,17,0,20,3
1649878907310,ECE 100,A01,084051,Baghdadchi; Saharnaz,11,0,20,9
1649878907310,ECE 100,A02,091916,Baghdadchi; Saharnaz,18,0,20,2
1649878913340,ECE 101,A01,084053,Baghdadchi; Saharnaz,19,0,37,18
1649878913340,ECE 101,A02,084054,Baghdadchi; Saharnaz,37,0,37,0
1649878919370,ECE 107,A01,083390,Staff,31,0,40,9
1649878925398,ECE 148,A01,084056,Silberman; Jack,7,0,12,5
1649878931425,ECE 180,A00,083391,Abi Samra; Nicholas Camill,26,0,30,4
1649878931425,ECE 180,B00,083392,Abi Samra; Nicholas Camill,23,0,30,7
1649878937452,MATH 10B,A01,084110,Staff,18,0,30,12
1649878937452,MATH 10B,A02,084111,Staff,29,0,30,1
1649878937452,MATH 10B,A03,084112,Staff,29,0,30,1
1649878943480,MATH 10C,A01,083443,Staff,15,0,30,15
1649878943480,MATH 10C,A02,083444,Staff,18,0,30,12
1649878943480,MATH 10C,B01,084114,Staff,26,0,30,4
1649878943480,MATH 10C,B02,084115,Staff,30,0,30,0
1649878949505,MATH 18,A01,084117,Harel; Guershon,27,0,30,3
1649878949505,MATH 18,A02,084119,Harel; Guershon,29,0,30,1
1649878949505,MATH 18,A03,084120,Harel; Guershon,30,0,30,0
1649878949505,MATH 18,A04,084121,Harel; Guershon,30,0,30,0
1649878955527,MATH 20B,A01,084124,Um; Ko Woon,33,0,35,2
1649878955527,MATH 20B,B01,084126,Um; Ko Woon,33,0,35,2
1649878961552,MATH 20C,A01,083446,Hammock; Frances H,25,0,30,5
1649878961552,MATH 20C,A02,083447,Hammock; Frances H,29,0,30,1
1649878961552,MATH 20C,A03,083448,Hammock; Frances H,30,0,30,0
1649878961552,MATH 20C,A04,083449,Hammock; Frances H,30,0,30,0
1649878961552,MATH 20C,B01,083451,Hammock; Frances H,29,0,30,1
1649878961552,MATH 20C,B02,083452,Hammock; Frances H,29,0,30,1
1649878961552,MATH 20C,B03,083453,Hammock; Frances H,30,0,30,0
1649878961552,MATH 20C,B04,083454,Hammock; Frances H,30,0,30,0
1649878967575,MATH 20D,A01,084128,Staff,29,0,30,1
1649878967575,MATH 20D,A02,084129,Staff,30,0,30,0
1649878967575,MATH 20D,A03,084130,Staff,29,0,30,1
1649878967575,MATH 20D,B01,084133,Staff,28,0,30,2
1649878967575,MATH 20D,B02,084134,Staff,29,0,30,1
1649878967575,MATH 20D,B03,084135,Staff,30,0,30,0
1649878973597,MATH 20E,A01,084138,Staff,25,0,30,5
1649878973597,MATH 20E,A02,084139,Staff,27,0,30,3
1649878973597,MATH 20E,A03,084140,Staff,26,0,30,4
1649878973597,MATH 20E,A04,084141,Staff,29,0,30,1
1649878979624,MATH 102,A01,084143,Harel; Guershon,23,0,30,7
1649878979624,MATH 102,A02,084144,Harel; Guershon,24,0,30,6
1649878985645,MATH 103B,A01,083456,Staff,0,2,30,30
1649878985645,MATH 103B,A02,083457,Staff,4,0,30,26
1649878991673,MATH 109,A01,084146,Salehi Golsefidy; Alireza,29,0,30,1
1649878991673,MATH 109,A02,084147,Salehi Golsefidy; Alireza,25,0,30,5
1649878997697,MATH 120A,A01,085445,Eggers; John Dietrich,23,0,35,12
1649878997697,MATH 120A,A02,085446,Eggers; John Dietrich,30,0,35,5
1649879003720,MATH 142B,A01,084149,Verstraete; Jacques Allan,0,2,30,30
1649879003720,MATH 142B,A02,084150,Verstraete; Jacques Allan,16,0,30,14
1649879009744,MATH 170A,A01,083459,Nie; Jiawang,0,1,30,30
1649879009744,MATH 170A,A02,083460,Nie; Jiawang,19,0,30,11
1649879009744,MATH 170A,A03,083461,Nie; Jiawang,21,0,30,9
1649879015771,MATH 193B,A01,083463,Staff,12,0,30,18
1649879015771,MATH 193B,A02,083464,Staff,18,0,30,12
1649879015771,MATH 193B,A03,083465,Staff,26,0,30,4
1649879021865,COGS 2,A01,083966,Boyle; Mary E. T.,22,0,30,8
1649879027887,COGS 9,A01,083968,Staff,49,0,60,11
1649879033927,COGS 14B,A01,083970,Staff,43,0,50,7
1649879039957,COGS 17,A01,092679,Staff,71,0,75,4
1649879045981,COGS 100,A01,083972,Staff,37,0,60,23
1649879058049,COGS 101C,A01,083976,Staff,23,0,30,7
1649879064071,COGS 102A,A01,083978,Johnson; Christine M.,21,0,30,9
1649879070099,COGS 107B,A01,083980,Staff,24,0,50,26
1649879076126,COGS 115,A01,083982,Staff,17,0,30,13
1649879082148,COGS 118B,A01,083367,Staff,0,3,40,40
1649879088175,COGS 172,A01,083984,Provenzano; Emily Kara,17,0,30,13
1649879094199,COGS 177,A00,083368,Staff,1,8,30,29
1649879100220,COGS 186,A01,083986,Staff,25,0,40,15
1649879106243,COGS 187A,A01,083988,Boyle; Mary E. T.,35,0,60,25
1649879112274,CSE 8A,A50,084003,Miranda; Gregory Joseph,7,0,15,8
1649879118389,CSE 11,A01,084005,Miranda; Gregory Joseph,45,0,55,10
1649879124413,CSE 20,A01,084007,Staff,14,0,20,6
1649879130438,CSE 21,A01,084009,Staff,28,0,50,22
1649879136461,CSE 30,A01,083370,Cao; Yingjun,8,0,40,32
1649879142485,CSE 100,A01,083372,Cao; Yingjun,2,0,40,38
1649879148513,CSE 101,A01,084011,Staff,0,33,40,40
1649879154536,CSE 141,A01,083374,Eldon; John,1,37,75,74
1649879160577,CSE 141L,A01,083376,Eldon; John,1,41,75,74
1649879166706,CSE 175,A01,084013,Kumar; Rakesh,22,0,25,3
1649879172750,CSE 190,A00,092508,Staff,15,0,15,0
1649879178777,ECE 5,A01,084049,Morris; Karcher William,17,0,20,3
1649879184812,ECE 100,A01,084051,Baghdadchi; Saharnaz,11,0,20,9
1649879184812,ECE 100,A02,091916,Baghdadchi; Saharnaz,18,0,20,2
1649879190833,ECE 101,A01,084053,Baghdadchi; Saharnaz,19,0,37,18
1649879190833,ECE 101,A02,084054,Baghdadchi; Saharnaz,37,0,37,0
1649879196875,ECE 107,A01,083390,Staff,31,0,40,9
1649879202919,ECE 148,A01,084056,Silberman; Jack,7,0,12,5
1649879208954,ECE 180,A00,083391,Abi Samra; Nicholas Camill,26,0,30,4
1649879208954,ECE 180,B00,083392,Abi Samra; Nicholas Camill,23,0,30,7
1649879214980,MATH 10B,A01,084110,Staff,18,0,30,12
1649879214980,MATH 10B,A02,084111,Staff,29,0,30,1
1649879214980,MATH 10B,A03,084112,Staff,29,0,30,1
1649879221011,MATH 10C,A01,083443,Staff,15,0,30,15
1649879221011,MATH 10C,A02,083444,Staff,18,0,30,12
1649879221011,MATH 10C,B01,084114,Staff,26,0,30,4
1649879221011,MATH 10C,B02,084115,Staff,30,0,30,0
1649879227050,MATH 18,A01,084117,Harel; Guershon,27,0,30,3
1649879227050,MATH 18,A02,084119,Harel; Guershon,29,0,30,1
1649879227050,MATH 18,A03,084120,Harel; Guershon,30,0,30,0
1649879227050,MATH 18,A04,084121,Harel; Guershon,30,0,30,0
1649879233082,MATH 20B,A01,084124,Um; Ko Woon,33,0,35,2
1649879233082,MATH 20B,B01,084126,Um; Ko Woon,33,0,35,2
1649879239112,MATH 20C,A01,083446,Hammock; Frances H,25,0,30,5
1649879239112,MATH 20C,A02,083447,Hammock; Frances H,29,0,30,1
1649879239112,MATH 20C,A03,083448,Hammock; Frances H,30,0,30,0
1649879239112,MATH 20C,A04,083449,Hammock; Frances H,30,0,30,0
1649879239112,MATH 20C,B01,083451,Hammock; Frances H,29,0,30,1
1649879239112,MATH 20C,B02,083452,Hammock; Frances H,29,0,30,1
1649879239112,MATH 20C,B03,083453,Hammock; Frances H,30,0,30,0
1649879239112,MATH 20C,B04,083454,Hammock; Frances H,30,0,30,0
1649879245134,MATH 20D,A01,084128,Staff,29,0,30,1
1649879245134,MATH 20D,A02,084129,Staff,30,0,30,0
1649879245134,MATH 20D,A03,084130,Staff,29,0,30,1
1649879245134,MATH 20D,B01,084133,Staff,28,0,30,2
1649879245134,MATH 20D,B02,084134,Staff,29,0,30,1
1649879245134,MATH 20D,B03,084135,Staff,30,0,30,0
1649879251183,MATH 20E,A01,084138,Staff,25,0,30,5
1649879251183,MATH 20E,A02,084139,Staff,27,0,30,3
1649879251183,MATH 20E,A03,084140,Staff,26,0,30,4
1649879251183,MATH 20E,A04,084141,Staff,29,0,30,1
1649879257222,MATH 102,A01,084143,Harel; Guershon,23,0,30,7
1649879257222,MATH 102,A02,084144,Harel; Guershon,24,0,30,6
1649879263248,MATH 103B,A01,083456,Staff,0,2,30,30
1649879263248,MATH 103B,A02,083457,Staff,3,0,30,27
1649879269288,MATH 109,A01,084146,Salehi Golsefidy; Alireza,29,0,30,1
1649879269288,MATH 109,A02,084147,Salehi Golsefidy; Alireza,25,0,30,5
1649879275313,MATH 120A,A01,085445,Eggers; John Dietrich,23,0,35,12
1649879275313,MATH 120A,A02,085446,Eggers; John Dietrich,30,0,35,5
1649879281349,MATH 142B,A01,084149,Verstraete; Jacques Allan,0,2,30,30
1649879281349,MATH 142B,A02,084150,Verstraete; Jacques Allan,16,0,30,14
1649879287378,MATH 170A,A01,083459,Nie; Jiawang,0,1,30,30
1649879287378,MATH 170A,A02,083460,Nie; Jiawang,19,0,30,11
1649879287378,MATH 170A,A03,083461,Nie; Jiawang,21,0,30,9
1649879293403,MATH 193B,A01,083463,Staff,12,0,30,18
1649879293403,MATH 193B,A02,083464,Staff,18,0,30,12
1649879293403,MATH 193B,A03,083465,Staff,25,0,30,5
1649879299450,COGS 2,A01,083966,Boyle; Mary E. T.,22,0,30,8
1649879305488,COGS 9,A01,083968,Staff,49,0,60,11
1649879311525,COGS 14B,A01,083970,Staff,43,0,50,7
1649879317553,COGS 17,A01,092679,Staff,71,0,75,4
1649879323580,COGS 100,A01,083972,Staff,37,0,60,23
1649879335626,COGS 101C,A01,083976,Staff,23,0,30,7
1649879341652,COGS 102A,A01,083978,Johnson; Christine M.,21,0,30,9
1649879347676,COGS 107B,A01,083980,Staff,24,0,50,26
1649879353721,COGS 115,A01,083982,Staff,17,0,30,13
1649879359743,COGS 118B,A01,083367,Staff,0,3,40,40
1649879365779,COGS 172,A01,083984,Provenzano; Emily Kara,17,0,30,13
1649879371804,COGS 177,A00,083368,Staff,1,8,30,29
1649879377828,COGS 186,A01,083986,Staff,25,0,40,15
1649879383869,COGS 187A,A01,083988,Boyle; Mary E. T.,35,0,60,25
1649879389895,CSE 8A,A50,084003,Miranda; Gregory Joseph,7,0,15,8
1649879395919,CSE 11,A01,084005,Miranda; Gregory Joseph,44,0,55,11
1649879401950,CSE 20,A01,084007,Staff,14,0,20,6
1649879407976,CSE 21,A01,084009,Staff,28,0,50,22
1649879413999,CSE 30,A01,083370,Cao; Yingjun,8,0,40,32
1649879420048,CSE 100,A01,083372,Cao; Yingjun,2,0,40,38
1649879426078,CSE 101,A01,084011,Staff,0,33,40,40
1649879432100,CSE 141,A01,083374,Eldon; John,1,37,75,74
1649879438134,CSE 141L,A01,083376,Eldon; John,1,41,75,74
1649879444160,CSE 175,A01,084013,Kumar; Rakesh,22,0,25,3
1649879450187,CSE 190,A00,092508,Staff,15,0,15,0
1649879456214,ECE 5,A01,084049,Morris; Karcher William,17,0,20,3
1649879462245,ECE 100,A01,084051,Baghdadchi; Saharnaz,11,0,20,9
1649879462245,ECE 100,A02,091916,Baghdadchi; Saharnaz,18,0,20,2
1649879468267,ECE 101,A01,084053,Baghdadchi; Saharnaz,19,0,37,18
1649879468267,ECE 101,A02,084054,Baghdadchi; Saharnaz,37,0,37,0
1649879474289,ECE 107,A01,083390,Staff,31,0,40,9
1649879480318,ECE 148,A01,084056,Silberman; Jack,7,0,12,5
1649879486345,ECE 180,A00,083391,Abi Samra; Nicholas Camill,26,0,30,4
1649879486345,ECE 180,B00,083392,Abi Samra; Nicholas Camill,23,0,30,7
1649879492372,MATH 10B,A01,084110,Staff,17,0,30,13
1649879492372,MATH 10B,A02,084111,Staff,29,0,30,1
1649879492372,MATH 10B,A03,084112,Staff,29,0,30,1
1649879498401,MATH 10C,A01,083443,Staff,15,0,30,15
1649879498401,MATH 10C,A02,083444,Staff,17,0,30,13
1649879498401,MATH 10C,B01,084114,Staff,26,0,30,4
1649879498401,MATH 10C,B02,084115,Staff,30,0,30,0
1649879504436,MATH 18,A01,084117,Harel; Guershon,27,0,30,3
1649879504436,MATH 18,A02,084119,Harel; Guershon,29,0,30,1
1649879504436,MATH 18,A03,084120,Harel; Guershon,30,0,30,0
1649879504436,MATH 18,A04,084121,Harel; Guershon,30,0,30,0
1649879510461,MATH 20B,A01,084124,Um; Ko Woon,33,0,35,2
1649879510461,MATH 20B,B01,084126,Um; Ko Woon,33,0,35,2
1649879516510,MATH 20C,A01,083446,Hammock; Frances H,25,0,30,5
1649879516510,MATH 20C,A02,083447,Hammock; Frances H,29,0,30,1
1649879516510,MATH 20C,A03,083448,Hammock; Frances H,30,0,30,0
1649879516510,MATH 20C,A04,083449,Hammock; Frances H,30,0,30,0
1649879516510,MATH 20C,B01,083451,Hammock; Frances H,29,0,30,1
1649879516510,MATH 20C,B02,083452,Hammock; Frances H,29,0,30,1
1649879516510,MATH 20C,B03,083453,Hammock; Frances H,30,0,30,0
1649879516510,MATH 20C,B04,083454,Hammock; Frances H,30,0,30,0
1649879522541,MATH 20D,A01,084128,Staff,29,0,30,1
1649879522541,MATH 20D,A02,084129,Staff,30,0,30,0
1649879522541,MATH 20D,A03,084130,Staff,29,0,30,1
1649879522541,MATH 20D,B01,084133,Staff,28,0,30,2
1649879522541,MATH 20D,B02,084134,Staff,29,0,30,1
1649879522541,MATH 20D,B03,084135,Staff,30,0,30,0
1649879528580,MATH 20E,A01,084138,Staff,25,0,30,5
1649879528580,MATH 20E,A02,084139,Staff,27,0,30,3
1649879528580,MATH 20E,A03,084140,Staff,26,0,30,4
1649879528580,MATH 20E,A04,084141,Staff,29,0,30,1
1649879534615,MATH 102,A01,084143,Harel; Guershon,23,0,30,7
1649879534615,MATH 102,A02,084144,Harel; Guershon,24,0,30,6
1649879540651,MATH 103B,A01,083456,Staff,0,2,30,30
1649879540651,MATH 103B,A02,083457,Staff,3,0,30,27
1649879546688,MATH 109,A01,084146,Salehi Golsefidy; Alireza,29,0,30,1
1649879546688,MATH 109,A02,084147,Salehi Golsefidy; Alireza,25,0,30,5
1649879552717,MATH 120A,A01,085445,Eggers; John Dietrich,23,0,35,12
1649879552717,MATH 120A,A02,085446,Eggers; John Dietrich,30,0,35,5
1649879558742,MATH 142B,A01,084149,Verstraete; Jacques Allan,0,2,30,30
1649879558742,MATH 142B,A02,084150,Verstraete; Jacques Allan,16,0,30,14
1649879564779,MATH 170A,A01,083459,Nie; Jiawang,0,1,30,30
1649879564779,MATH 170A,A02,083460,Nie; Jiawang,19,0,30,11
1649879564779,MATH 170A,A03,083461,Nie; Jiawang,21,0,30,9
1649879570817,MATH 193B,A01,083463,Staff,12,0,30,18
1649879570817,MATH 193B,A02,083464,Staff,18,0,30,12
1649879570817,MATH 193B,A03,083465,Staff,25,0,30,5
1649879576878,COGS 2,A01,083966,Boyle; Mary E. T.,22,0,30,8
1649879582913,COGS 9,A01,083968,Staff,48,0,60,12
1649879588935,COGS 14B,A01,083970,Staff,43,0,50,7
1649879594958,COGS 17,A01,092679,Staff,71,0,75,4
1649879601005,COGS 100,A01,083972,Staff,37,0,60,23
1649879613062,COGS 101C,A01,083976,Staff,23,0,30,7
1649879619094,COGS 102A,A01,083978,Johnson; Christine M.,21,0,30,9
1649879625120,COGS 107B,A01,083980,Staff,23,0,50,27
1649879631147,COGS 115,A01,083982,Staff,17,0,30,13
1649879637180,COGS 118B,A01,083367,Staff,0,3,40,40
1649879643206,COGS 172,A01,083984,Provenzano; Emily Kara,17,0,30,13
1649879649231,COGS 177,A00,083368,Staff,1,8,30,29
1649879655263,COGS 186,A01,083986,Staff,25,0,40,15
1649879661285,COGS 187A,A01,083988,Boyle; Mary E. T.,34,0,60,26
1649879667323,CSE 8A,A50,084003,Miranda; Gregory Joseph,7,0,15,8
1649879673353,CSE 11,A01,084005,Miranda; Gregory Joseph,44,0,55,11
1649879679376,CSE 20,A01,084007,Staff,14,0,20,6
1649879685407,CSE 21,A01,084009,Staff,26,0,50,24
1649879691430,CSE 30,A01,083370,Cao; Yingjun,8,0,40,32
1649879697453,CSE 100,A01,083372,Cao; Yingjun,2,0,40,38
1649879703490,CSE 101,A01,084011,Staff,0,33,40,40
1649879709518,CSE 141,A01,083374,Eldon; John,1,37,75,74
1649879715655,CSE 141L,A01,083376,Eldon; John,1,41,75,74
1649879721688,CSE 175,A01,084013,Kumar; Rakesh,22,0,25,3
1649879727712,CSE 190,A00,092508,Staff,15,0,15,0
1649879733766,ECE 5,A01,084049,Morris; Karcher William,17,0,20,3
1649879739807,ECE 100,A01,084051,Baghdadchi; Saharnaz,11,0,20,9
1649879739807,ECE 100,A02,091916,Baghdadchi; Saharnaz,18,0,20,2
1649879745839,ECE 101,A01,084053,Baghdadchi; Saharnaz,19,0,37,18
1649879745839,ECE 101,A02,084054,Baghdadchi; Saharnaz,37,0,37,0
1649879751872,ECE 107,A01,083390,Staff,31,0,40,9
1649879757894,ECE 148,A01,084056,Silberman; Jack,7,0,12,5
1649879763917,ECE 180,A00,083391,Abi Samra; Nicholas Camill,26,0,30,4
1649879763917,ECE 180,B00,083392,Abi Samra; Nicholas Camill,23,0,30,7
1649879769940,MATH 10B,A01,084110,Staff,17,0,30,13
1649879769940,MATH 10B,A02,084111,Staff,29,0,30,1
1649879769940,MATH 10B,A03,084112,Staff,29,0,30,1
1649879775967,MATH 10C,A01,083443,Staff,15,0,30,15
1649879775967,MATH 10C,A02,083444,Staff,17,0,30,13
1649879775967,MATH 10C,B01,084114,Staff,26,0,30,4
1649879775967,MATH 10C,B02,084115,Staff,30,0,30,0
1649879781995,MATH 18,A01,084117,Harel; Guershon,27,0,30,3
1649879781995,MATH 18,A02,084119,Harel; Guershon,29,0,30,1
1649879781995,MATH 18,A03,084120,Harel; Guershon,30,0,30,0
1649879781995,MATH 18,A04,084121,Harel; Guershon,30,0,30,0
1649879788018,MATH 20B,A01,084124,Um; Ko Woon,33,0,35,2
1649879788018,MATH 20B,B01,084126,Um; Ko Woon,33,0,35,2
1649879794043,MATH 20C,A01,083446,Hammock; Frances H,25,0,30,5
1649879794043,MATH 20C,A02,083447,Hammock; Frances H,29,0,30,1
1649879794043,MATH 20C,A03,083448,Hammock; Frances H,30,0,30,0
1649879794043,MATH 20C,A04,083449,Hammock; Frances H,30,0,30,0
1649879794043,MATH 20C,B01,083451,Hammock; Frances H,29,0,30,1
1649879794043,MATH 20C,B02,083452,Hammock; Frances H,29,0,30,1
1649879794043,MATH 20C,B03,083453,Hammock; Frances H,30,0,30,0
1649879794043,MATH 20C,B04,083454,Hammock; Frances H,30,0,30,0
1649879800071,MATH 20D,A01,084128,Staff,29,0,30,1
1649879800071,MATH 20D,A02,084129,Staff,30,0,30,0
1649879800071,MATH 20D,A03,084130,Staff,29,0,30,1
1649879800071,MATH 20D,B01,084133,Staff,28,0,30,2
1649879800071,MATH 20D,B02,084134,Staff,29,0,30,1
1649879800071,MATH 20D,B03,084135,Staff,30,0,30,0
1649879806104,MATH 20E,A01,084138,Staff,25,0,30,5
1649879806104,MATH 20E,A02,084139,Staff,27,0,30,3
1649879806104,MATH 20E,A03,084140,Staff,26,0,30,4
1649879806104,MATH 20E,A04,084141,Staff,29,0,30,1
1649879812127,MATH 102,A01,084143,Harel; Guershon,24,0,30,6
1649879812127,MATH 102,A02,084144,Harel; Guershon,24,0,30,6
1649879818152,MATH 103B,A01,083456,Staff,0,2,30,30
1649879818152,MATH 103B,A02,083457,Staff,3,0,30,27
1649879824173,MATH 109,A01,084146,Salehi Golsefidy; Alireza,29,0,30,1
1649879824173,MATH 109,A02,084147,Salehi Golsefidy; Alireza,25,0,30,5
1649879830202,MATH 120A,A01,085445,Eggers; John Dietrich,23,0,35,12
1649879830202,MATH 120A,A02,085446,Eggers; John Dietrich,30,0,35,5
1649879836235,MATH 142B,A01,084149,Verstraete; Jacques Allan,0,2,30,30
1649879836235,MATH 142B,A02,084150,Verstraete; Jacques Allan,15,0,30,15
1649879842259,MATH 170A,A01,083459,Nie; Jiawang,0,1,30,30
1649879842259,MATH 170A,A02,083460,Nie; Jiawang,19,0,30,11
1649879842259,MATH 170A,A03,083461,Nie; Jiawang,21,0,30,9
1649879848302,MATH 193B,A01,083463,Staff,12,0,30,18
1649879848302,MATH 193B,A02,083464,Staff,18,0,30,12
1649879848302,MATH 193B,A03,083465,Staff,25,0,30,5
1649879854370,COGS 2,A01,083966,Boyle; Mary E. T.,22,0,30,8
1649879860398,COGS 9,A01,083968,Staff,48,0,60,12
1649879866420,COGS 14B,A01,083970,Staff,43,0,50,7
1649879872463,COGS 17,A01,092679,Staff,71,0,75,4
1649879878486,COGS 100,A01,083972,Staff,37,0,60,23
1649879890549,COGS 101C,A01,083976,Staff,23,0,30,7
1649879896583,COGS 102A,A01,083978,Johnson; Christine M.,21,0,30,9
1649879902615,COGS 107B,A01,083980,Staff,23,0,50,27
1649879908643,COGS 115,A01,083982,Staff,17,0,30,13
1649879914674,COGS 118B,A01,083367,Staff,0,3,40,40
1649879920697,COGS 172,A01,083984,Provenzano; Emily Kara,17,0,30,13
1649879926723,COGS 177,A00,083368,Staff,1,8,30,29
1649879932755,COGS 186,A01,083986,Staff,25,0,40,15
1649879938784,COGS 187A,A01,083988,Boyle; Mary E. T.,34,0,60,26
1649879944810,CSE 8A,A50,084003,Miranda; Gregory Joseph,7,0,15,8
1649879950834,CSE 11,A01,084005,Miranda; Gregory Joseph,44,0,55,11
1649879956866,CSE 20,A01,084007,Staff,14,0,20,6
1649879962890,CSE 21,A01,084009,Staff,26,0,50,24
1649879968918,CSE 30,A01,083370,Cao; Yingjun,8,0,40,32
1649879974951,CSE 100,A01,083372,Cao; Yingjun,2,0,40,38
1649879980988,CSE 101,A01,084011,Staff,0,33,40,40
1649879987024,CSE 141,A01,083374,Eldon; John,1,37,75,74
1649879993051,CSE 141L,A01,083376,Eldon; John,1,41,75,74
1649879999078,CSE 175,A01,084013,Kumar; Rakesh,22,0,25,3
1649880005105,CSE 190,A00,092508,Staff,15,0,15,0
1649880011136,ECE 5,A01,084049,Morris; Karcher William,17,0,20,3
1649880017160,ECE 100,A01,084051,Baghdadchi; Saharnaz,11,0,20,9
1649880017160,ECE 100,A02,091916,Baghdadchi; Saharnaz,18,0,20,2
1649880023187,ECE 101,A01,084053,Baghdadchi; Saharnaz,19,0,37,18
1649880023187,ECE 101,A02,084054,Baghdadchi; Saharnaz,37,0,37,0
1649880029217,ECE 107,A01,083390,Staff,31,0,40,9
1649880035252,ECE 148,A01,084056,Silberman; Jack,7,0,12,5
1649880041273,ECE 180,A00,083391,Abi Samra; Nicholas Camill,26,0,30,4
1649880041273,ECE 180,B00,083392,Abi Samra; Nicholas Camill,23,0,30,7
1649880047295,MATH 10B,A01,084110,Staff,17,0,30,13
1649880047295,MATH 10B,A02,084111,Staff,29,0,30,1
1649880047295,MATH 10B,A03,084112,Staff,29,0,30,1
1649880053335,MATH 10C,A01,083443,Staff,15,0,30,15
1649880053335,MATH 10C,A02,083444,Staff,17,0,30,13
1649880053335,MATH 10C,B01,084114,Staff,26,0,30,4
1649880053335,MATH 10C,B02,084115,Staff,30,0,30,0
1649880059359,MATH 18,A01,084117,Harel; Guershon,27,0,30,3
1649880059359,MATH 18,A02,084119,Harel; Guershon,29,0,30,1
1649880059359,MATH 18,A03,084120,Harel; Guershon,30,0,30,0
1649880059359,MATH 18,A04,084121,Harel; Guershon,30,0,30,0
1649880065387,MATH 20B,A01,084124,Um; Ko Woon,33,0,35,2
1649880065387,MATH 20B,B01,084126,Um; Ko Woon,33,0,35,2
1649880071418,MATH 20C,A01,083446,Hammock; Frances H,25,0,30,5
1649880071418,MATH 20C,A02,083447,Hammock; Frances H,29,0,30,1
1649880071418,MATH 20C,A03,083448,Hammock; Frances H,30,0,30,0
1649880071418,MATH 20C,A04,083449,Hammock; Frances H,30,0,30,0
1649880071418,MATH 20C,B01,083451,Hammock; Frances H,29,0,30,1
1649880071418,MATH 20C,B02,083452,Hammock; Frances H,29,0,30,1
1649880071418,MATH 20C,B03,083453,Hammock; Frances H,30,0,30,0
1649880071418,MATH 20C,B04,083454,Hammock; Frances H,30,0,30,0
1649880077450,MATH 20D,A01,084128,Staff,29,0,30,1
1649880077450,MATH 20D,A02,084129,Staff,30,0,30,0
1649880077450,MATH 20D,A03,084130,Staff,29,0,30,1
1649880077450,MATH 20D,B01,084133,Staff,28,0,30,2
1649880077450,MATH 20D,B02,084134,Staff,29,0,30,1
1649880077450,MATH 20D,B03,084135,Staff,30,0,30,0
1649880083475,MATH 20E,A01,084138,Staff,25,0,30,5
1649880083475,MATH 20E,A02,084139,Staff,27,0,30,3
1649880083475,MATH 20E,A03,084140,Staff,26,0,30,4
1649880083475,MATH 20E,A04,084141,Staff,29,0,30,1
1649880089499,MATH 102,A01,084143,Harel; Guershon,24,0,30,6
1649880089499,MATH 102,A02,084144,Harel; Guershon,24,0,30,6
1649880095529,MATH 103B,A01,083456,Staff,0,2,30,30
1649880095529,MATH 103B,A02,083457,Staff,3,0,30,27
1649880101561,MATH 109,A01,084146,Salehi Golsefidy; Alireza,29,0,30,1
1649880101561,MATH 109,A02,084147,Salehi Golsefidy; Alireza,25,0,30,5
1649880107587,MATH 120A,A01,085445,Eggers; John Dietrich,23,0,35,12
1649880107587,MATH 120A,A02,085446,Eggers; John Dietrich,30,0,35,5
1649880113616,MATH 142B,A01,084149,Verstraete; Jacques Allan,0,2,30,30
1649880113616,MATH 142B,A02,084150,Verstraete; Jacques Allan,15,0,30,15
1649880119644,MATH 170A,A01,083459,Nie; Jiawang,0,1,30,30
1649880119644,MATH 170A,A02,083460,Nie; Jiawang,19,0,30,11
1649880119644,MATH 170A,A03,083461,Nie; Jiawang,21,0,30,9
1649880125670,MATH 193B,A01,083463,Staff,12,0,30,18
1649880125670,MATH 193B,A02,083464,Staff,18,0,30,12
1649880125670,MATH 193B,A03,083465,Staff,25,0,30,5
1649880131734,COGS 2,A01,083966,Boyle; Mary E. T.,22,0,30,8
1649880137756,COGS 9,A01,083968,Staff,48,0,60,12
1649880143792,COGS 14B,A01,083970,Staff,43,0,50,7
1649880149821,COGS 17,A01,092679,Staff,71,0,75,4
1649880155844,COGS 100,A01,083972,Staff,37,0,60,23
1649880167898,COGS 101C,A01,083976,Staff,23,0,30,7
1649880173925,COGS 102A,A01,083978,Johnson; Christine M.,21,0,30,9
1649880179953,COGS 107B,A01,083980,Staff,23,0,50,27
1649880185990,COGS 115,A01,083982,Staff,17,0,30,13
1649880192013,COGS 118B,A01,083367,Staff,0,3,40,40
1649880198037,COGS 172,A01,083984,Provenzano; Emily Kara,17,0,30,13
1649880204064,COGS 177,A00,083368,Staff,1,9,30,29
1649880210091,COGS 186,A01,083986,Staff,25,0,40,15
1649880216129,COGS 187A,A01,083988,Boyle; Mary E. T.,32,0,60,28
1649880222157,CSE 8A,A50,084003,Miranda; Gregory Joseph,7,0,15,8
1649880228183,CSE 11,A01,084005,Miranda; Gregory Joseph,44,0,55,11
1649880234208,CSE 20,A01,084007,Staff,14,0,20,6
1649880240232,CSE 21,A01,084009,Staff,26,0,50,24
1649880246276,CSE 30,A01,083370,Cao; Yingjun,7,0,40,33
1649880252300,CSE 100,A01,083372,Cao; Yingjun,1,0,40,39
1649880258322,CSE 101,A01,084011,Staff,0,33,40,40
1649880264346,CSE 141,A01,083374,Eldon; John,1,37,75,74
1649880270376,CSE 141L,A01,083376,Eldon; John,1,41,75,74
1649880276398,CSE 175,A01,084013,Kumar; Rakesh,22,0,25,3
1649880282433,CSE 190,A00,092508,Staff,15,0,15,0
1649880288461,ECE 5,A01,084049,Morris; Karcher William,17,0,20,3
1649880294484,ECE 100,A01,084051,Baghdadchi; Saharnaz,11,0,20,9
1649880294484,ECE 100,A02,091916,Baghdadchi; Saharnaz,17,0,20,3
1649880300521,ECE 101,A01,084053,Baghdadchi; Saharnaz,19,0,37,18
1649880300521,ECE 101,A02,084054,Baghdadchi; Saharnaz,37,0,37,0
1649880306553,ECE 107,A01,083390,Staff,31,0,40,9
1649880312718,ECE 148,A01,084056,Silberman; Jack,7,0,12,5
1649880318752,ECE 180,A00,083391,Abi Samra; Nicholas Camill,26,0,30,4
1649880318752,ECE 180,B00,083392,Abi Samra; Nicholas Camill,23,0,30,7
1649880324776,MATH 10B,A01,084110,Staff,17,0,30,13
1649880324776,MATH 10B,A02,084111,Staff,29,0,30,1
1649880324776,MATH 10B,A03,084112,Staff,29,0,30,1
1649880330814,MATH 10C,A01,083443,Staff,14,0,30,16
1649880330814,MATH 10C,A02,083444,Staff,17,0,30,13
1649880330814,MATH 10C,B01,084114,Staff,26,0,30,4
1649880330814,MATH 10C,B02,084115,Staff,30,0,30,0
1649880336838,MATH 18,A01,084117,Harel; Guershon,27,0,30,3
1649880336838,MATH 18,A02,084119,Harel; Guershon,29,0,30,1
1649880336838,MATH 18,A03,084120,Harel; Guershon,30,0,30,0
1649880336838,MATH 18,A04,084121,Harel; Guershon,30,0,30,0
1649880342864,MATH 20B,A01,084124,Um; Ko Woon,33,0,35,2
1649880342864,MATH 20B,B01,084126,Um; Ko Woon,33,0,35,2
1649880348896,MATH 20C,A01,083446,Hammock; Frances H,25,0,30,5
1649880348896,MATH 20C,A02,083447,Hammock; Frances H,29,0,30,1
1649880348896,MATH 20C,A03,083448,Hammock; Frances H,30,0,30,0
1649880348896,MATH 20C,A04,083449,Hammock; Frances H,30,0,30,0
1649880348896,MATH 20C,B01,083451,Hammock; Frances H,29,0,30,1
1649880348896,MATH 20C,B02,083452,Hammock; Frances H,29,0,30,1
1649880348896,MATH 20C,B03,083453,Hammock; Frances H,30,0,30,0
1649880348896,MATH 20C,B04,083454,Hammock; Frances H,30,0,30,0
1649880354921,MATH 20D,A01,084128,Staff,29,0,30,1
1649880354921,MATH 20D,A02,084129,Staff,30,0,30,0
1649880354921,MATH 20D,A03,084130,Staff,29,0,30,1
1649880354921,MATH 20D,B01,084133,Staff,28,0,30,2
1649880354921,MATH 20D,B02,084134,Staff,29,0,30,1
1649880354921,MATH 20D,B03,084135,Staff,30,0,30,0
1649880360950,MATH 20E,A01,084138,Staff,25,0,30,5
1649880360950,MATH 20E,A02,084139,Staff,27,0,30,3
1649880360950,MATH 20E,A03,084140,Staff,25,0,30,5
1649880360950,MATH 20E,A04,084141,Staff,29,0,30,1
1649880366977,MATH 102,A01,084143,Harel; Guershon,24,0,30,6
1649880366977,MATH 102,A02,084144,Harel; Guershon,24,0,30,6
1649880372998,MATH 103B,A01,083456,Staff,0,2,30,30
1649880372998,MATH 103B,A02,083457,Staff,3,0,30,27
1649880379033,MATH 109,A01,084146,Salehi Golsefidy; Alireza,29,0,30,1
1649880379033,MATH 109,A02,084147,Salehi Golsefidy; Alireza,25,0,30,5
1649880385056,MATH 120A,A01,085445,Eggers; John Dietrich,23,0,35,12
1649880385056,MATH 120A,A02,085446,Eggers; John Dietrich,30,0,35,5
1649880391079,MATH 142B,A01,084149,Verstraete; Jacques Allan,0,2,30,30
1649880391079,MATH 142B,A02,084150,Verstraete; Jacques Allan,15,0,30,15
1649880397103,MATH 170A,A01,083459,Nie; Jiawang,0,1,30,30
1649880397103,MATH 170A,A02,083460,Nie; Jiawang,19,0,30,11
1649880397103,MATH 170A,A03,083461,Nie; Jiawang,21,0,30,9
1649880403125,MATH 193B,A01,083463,Staff,12,0,30,18
1649880403125,MATH 193B,A02,083464,Staff,18,0,30,12
1649880403125,MATH 193B,A03,083465,Staff,25,0,30,5
1649880409197,COGS 2,A01,083966,Boyle; Mary E. T.,22,0,30,8
1649880415230,COGS 9,A01,083968,Staff,48,0,60,12
1649880421261,COGS 14B,A01,083970,Staff,43,0,50,7
1649880427284,COGS 17,A01,092679,Staff,71,0,75,4
1649880433314,COGS 100,A01,083972,Staff,37,0,60,23
1649880445374,COGS 101C,A01,083976,Staff,23,0,30,7
1649880451397,COGS 102A,A01,083978,Johnson; Christine M.,21,0,30,9
1649880457430,COGS 107B,A01,083980,Staff,23,0,50,27
1649880463456,COGS 115,A01,083982,Staff,16,0,30,14
1649880469482,COGS 118B,A01,083367,Staff,0,3,40,40
1649880475514,COGS 172,A01,083984,Provenzano; Emily Kara,17,0,30,13
1649880481538,COGS 177,A00,083368,Staff,1,9,30,29
1649880487561,COGS 186,A01,083986,Staff,25,0,40,15
1649880493591,COGS 187A,A01,083988,Boyle; Mary E. T.,32,0,60,28
1649880499622,CSE 8A,A50,084003,Miranda; Gregory Joseph,7,0,15,8
1649880505654,CSE 11,A01,084005,Miranda; Gregory Joseph,44,0,55,11
1649880511685,CSE 20,A01,084007,Staff,14,0,20,6
1649880517707,CSE 21,A01,084009,Staff,26,0,50,24
1649880523731,CSE 30,A01,083370,Cao; Yingjun,7,0,40,33
1649880529763,CSE 100,A01,083372,Cao; Yingjun,0,0,40,40
1649880535787,CSE 101,A01,084011,Staff,0,33,40,40
1649880541811,CSE 141,A01,083374,Eldon; John,1,37,75,74
1649880547851,CSE 141L,A01,083376,Eldon; John,1,41,75,74
1649880553875,CSE 175,A01,084013,Kumar; Rakesh,22,0,25,3
1649880559914,CSE 190,A00,092508,Staff,15,0,15,0
1649880565940,ECE 5,A01,084049,Morris; Karcher William,17,0,20,3
1649880571965,ECE 100,A01,084051,Baghdadchi; Saharnaz,11,0,20,9
1649880571965,ECE 100,A02,091916,Baghdadchi; Saharnaz,17,0,20,3
1649880578000,ECE 101,A01,084053,Baghdadchi; Saharnaz,19,0,37,18
1649880578000,ECE 101,A02,084054,Baghdadchi; Saharnaz,37,0,37,0
1649880584028,ECE 107,A01,083390,Staff,31,0,40,9
1649880590067,ECE 148,A01,084056,Silberman; Jack,7,0,12,5
1649880596090,ECE 180,A00,083391,Abi Samra; Nicholas Camill,26,0,30,4
1649880596090,ECE 180,B00,083392,Abi Samra; Nicholas Camill,23,0,30,7
1649880602121,MATH 10B,A01,084110,Staff,17,0,30,13
1649880602121,MATH 10B,A02,084111,Staff,29,0,30,1
1649880602121,MATH 10B,A03,084112,Staff,29,0,30,1
1649880608150,MATH 10C,A01,083443,Staff,14,0,30,16
1649880608150,MATH 10C,A02,083444,Staff,17,0,30,13
1649880608150,MATH 10C,B01,084114,Staff,26,0,30,4
1649880608150,MATH 10C,B02,084115,Staff,30,0,30,0
1649880614173,MATH 18,A01,084117,Harel; Guershon,27,0,30,3
1649880614173,MATH 18,A02,084119,Harel; Guershon,29,0,30,1
1649880614173,MATH 18,A03,084120,Harel; Guershon,30,0,30,0
1649880614173,MATH 18,A04,084121,Harel; Guershon,30,0,30,0
1649880620213,MATH 20B,A01,084124,Um; Ko Woon,33,0,35,2
1649880620213,MATH 20B,B01,084126,Um; Ko Woon,33,0,35,2
1649880626246,MATH 20C,A01,083446,Hammock; Frances H,25,0,30,5
1649880626246,MATH 20C,A02,083447,Hammock; Frances H,29,0,30,1
1649880626246,MATH 20C,A03,083448,Hammock; Frances H,30,0,30,0
1649880626246,MATH 20C,A04,083449,Hammock; Frances H,30,0,30,0
1649880626246,MATH 20C,B01,083451,Hammock; Frances H,29,0,30,1
1649880626246,MATH 20C,B02,083452,Hammock; Frances H,29,0,30,1
1649880626246,MATH 20C,B03,083453,Hammock; Frances H,30,0,30,0
1649880626246,MATH 20C,B04,083454,Hammock; Frances H,30,0,30,0
1649880632278,MATH 20D,A01,084128,Staff,29,0,30,1
1649880632278,MATH 20D,A02,084129,Staff,30,0,30,0
1649880632278,MATH 20D,A03,084130,Staff,29,0,30,1
1649880632278,MATH 20D,B01,084133,Staff,28,0,30,2
1649880632278,MATH 20D,B02,084134,Staff,29,0,30,1
1649880632278,MATH 20D,B03,084135,Staff,30,0,30,0
1649880638304,MATH 20E,A01,084138,Staff,25,0,30,5
1649880638304,MATH 20E,A02,084139,Staff,27,0,30,3
1649880638304,MATH 20E,A03,084140,Staff,25,0,30,5
1649880638304,MATH 20E,A04,084141,Staff,29,0,30,1
1649880644327,MATH 102,A01,084143,Harel; Guershon,24,0,30,6
1649880644327,MATH 102,A02,084144,Harel; Guershon,24,0,30,6
1649880650363,MATH 103B,A01,083456,Staff,0,2,30,30
1649880650363,MATH 103B,A02,083457,Staff,3,0,30,27
1649880656389,MATH 109,A01,084146,Salehi Golsefidy; Alireza,29,0,30,1
1649880656389,MATH 109,A02,084147,Salehi Golsefidy; Alireza,25,0,30,5
1649880662417,MATH 120A,A01,085445,Eggers; John Dietrich,22,0,35,13
1649880662417,MATH 120A,A02,085446,Eggers; John Dietrich,30,0,35,5
1649880668453,MATH 142B,A01,084149,Verstraete; Jacques Allan,0,2,30,30
1649880668453,MATH 142B,A02,084150,Verstraete; Jacques Allan,14,0,30,16
1649880674477,MATH 170A,A01,083459,Nie; Jiawang,0,1,30,30
1649880674477,MATH 170A,A02,083460,Nie; Jiawang,19,0,30,11
1649880674477,MATH 170A,A03,083461,Nie; Jiawang,21,0,30,9
1649880680504,MATH 193B,A01,083463,Staff,12,0,30,18
1649880680504,MATH 193B,A02,083464,Staff,18,0,30,12
1649880680504,MATH 193B,A03,083465,Staff,25,0,30,5
1649880686572,COGS 2,A01,083966,Boyle; Mary E. T.,22,0,30,8
1649880692604,COGS 9,A01,083968,Staff,48,0,60,12
1649880698627,COGS 14B,A01,083970,Staff,43,0,50,7
1649880704652,COGS 17,A01,092679,Staff,71,0,75,4
1649880710683,COGS 100,A01,083972,Staff,37,0,60,23
1649880722744,COGS 101C,A01,083976,Staff,23,0,30,7
1649880728769,COGS 102A,A01,083978,Johnson; Christine M.,21,0,30,9
1649880734799,COGS 107B,A01,083980,Staff,23,0,50,27
1649880740830,COGS 115,A01,083982,Staff,15,0,30,15
1649880746853,COGS 118B,A01,083367,Staff,0,3,40,40
1649880752882,COGS 172,A01,083984,Provenzano; Emily Kara,17,0,30,13
1649880758905,COGS 177,A00,083368,Staff,1,9,30,29
1649880764933,COGS 186,A01,083986,Staff,25,0,40,15
1649880770960,COGS 187A,A01,083988,Boyle; Mary E. T.,32,0,60,28
1649880777003,CSE 8A,A50,084003,Miranda; Gregory Joseph,7,0,15,8
1649880783027,CSE 11,A01,084005,Miranda; Gregory Joseph,44,0,55,11
1649880789052,CSE 20,A01,084007,Staff,14,0,20,6
1649880795074,CSE 21,A01,084009,Staff,26,0,50,24
1649880801118,CSE 30,A01,083370,Cao; Yingjun,7,0,40,33
1649880807147,CSE 100,A01,083372,Cao; Yingjun,0,0,40,40
1649880813170,CSE 101,A01,084011,Staff,0,33,40,40
1649880819192,CSE 141,A01,083374,Eldon; John,1,37,75,74
1649880825213,CSE 141L,A01,083376,Eldon; John,1,41,75,74
1649880831240,CSE 175,A01,084013,Kumar; Rakesh,22,0,25,3
1649880837263,CSE 190,A00,092508,Staff,15,0,15,0
1649880843292,ECE 5,A01,084049,Morris; Karcher William,17,0,20,3
1649880849315,ECE 100,A01,084051,Baghdadchi; Saharnaz,11,0,20,9
1649880849315,ECE 100,A02,091916,Baghdadchi; Saharnaz,17,0,20,3
1649880855348,ECE 101,A01,084053,Baghdadchi; Saharnaz,19,0,37,18
1649880855348,ECE 101,A02,084054,Baghdadchi; Saharnaz,37,0,37,0
1649880861375,ECE 107,A01,083390,Staff,31,0,40,9
1649880867404,ECE 148,A01,084056,Silberman; Jack,7,0,12,5
1649880873439,ECE 180,A00,083391,Abi Samra; Nicholas Camill,26,0,30,4
1649880873439,ECE 180,B00,083392,Abi Samra; Nicholas Camill,23,0,30,7
1649880879466,MATH 10B,A01,084110,Staff,17,0,30,13
1649880879466,MATH 10B,A02,084111,Staff,29,0,30,1
1649880879466,MATH 10B,A03,084112,Staff,29,0,30,1
1649880885490,MATH 10C,A01,083443,Staff,14,0,30,16
1649880885490,MATH 10C,A02,083444,Staff,17,0,30,13
1649880885490,MATH 10C,B01,084114,Staff,26,0,30,4
1649880885490,MATH 10C,B02,084115,Staff,30,0,30,0
1649880891520,MATH 18,A01,084117,Harel; Guershon,27,0,30,3
1649880891520,MATH 18,A02,084119,Harel; Guershon,29,0,30,1
1649880891520,MATH 18,A03,084120,Harel; Guershon,30,0,30,0
1649880891520,MATH 18,A04,084121,Harel; Guershon,30,0,30,0
1649880897544,MATH 20B,A01,084124,Um; Ko Woon,32,0,35,3
1649880897544,MATH 20B,B01,084126,Um; Ko Woon,33,0,35,2
1649880903580,MATH 20C,A01,083446,Hammock; Frances H,25,0,30,5
1649880903580,MATH 20C,A02,083447,Hammock; Frances H,29,0,30,1
1649880903580,MATH 20C,A03,083448,Hammock; Frances H,30,0,30,0
1649880903580,MATH 20C,A04,083449,Hammock; Frances H,30,0,30,0
1649880903580,MATH 20C,B01,083451,Hammock; Frances H,29,0,30,1
1649880903580,MATH 20C,B02,083452,Hammock; Frances H,29,0,30,1
1649880903580,MATH 20C,B03,083453,Hammock; Frances H,30,0,30,0
1649880903580,MATH 20C,B04,083454,Hammock; Frances H,30,0,30,0
1649880909695,MATH 20D,A01,084128,Staff,29,0,30,1
1649880909695,MATH 20D,A02,084129,Staff,30,0,30,0
1649880909695,MATH 20D,A03,084130,Staff,29,0,30,1
1649880909695,MATH 20D,B01,084133,Staff,28,0,30,2
1649880909695,MATH 20D,B02,084134,Staff,29,0,30,1
1649880909695,MATH 20D,B03,084135,Staff,30,0,30,0
1649880915724,MATH 20E,A01,084138,Staff,25,0,30,5
1649880915724,MATH 20E,A02,084139,Staff,27,0,30,3
1649880915724,MATH 20E,A03,084140,Staff,25,0,30,5
1649880915724,MATH 20E,A04,084141,Staff,29,0,30,1
1649880921769,MATH 102,A01,084143,Harel; Guershon,24,0,30,6
1649880921769,MATH 102,A02,084144,Harel; Guershon,24,0,30,6
1649880927798,MATH 103B,A01,083456,Staff,0,2,30,30
1649880927798,MATH 103B,A02,083457,Staff,3,0,30,27
1649880933827,MATH 109,A01,084146,Salehi Golsefidy; Alireza,29,0,30,1
1649880933827,MATH 109,A02,084147,Salehi Golsefidy; Alireza,25,0,30,5
1649880939856,MATH 120A,A01,085445,Eggers; John Dietrich,22,0,35,13
1649880939856,MATH 120A,A02,085446,Eggers; John Dietrich,30,0,35,5
1649880945878,MATH 142B,A01,084149,Verstraete; Jacques Allan,0,2,30,30
1649880945878,MATH 142B,A02,084150,Verstraete; Jacques Allan,14,0,30,16
1649880951914,MATH 170A,A01,083459,Nie; Jiawang,0,1,30,30
1649880951914,MATH 170A,A02,083460,Nie; Jiawang,19,0,30,11
1649880951914,MATH 170A,A03,083461,Nie; Jiawang,21,0,30,9
1649880957941,MATH 193B,A01,083463,Staff,12,0,30,18
1649880957941,MATH 193B,A02,083464,Staff,18,0,30,12
1649880957941,MATH 193B,A03,083465,Staff,25,0,30,5
1649880963991,COGS 2,A01,083966,Boyle; Mary E. T.,22,0,30,8
1649880970014,COGS 9,A01,083968,Staff,48,0,60,12
1649880976043,COGS 14B,A01,083970,Staff,43,0,50,7
1649880982071,COGS 17,A01,092679,Staff,71,0,75,4
1649880988106,COGS 100,A01,083972,Staff,37,0,60,23
1649881000159,COGS 101C,A01,083976,Staff,23,0,30,7
1649881006202,COGS 102A,A01,083978,Johnson; Christine M.,21,0,30,9
1649881012224,COGS 107B,A01,083980,Staff,23,0,50,27
1649881018247,COGS 115,A01,083982,Staff,15,0,30,15
1649881024271,COGS 118B,A01,083367,Staff,0,3,40,40
1649881030294,COGS 172,A01,083984,Provenzano; Emily Kara,17,0,30,13
1649881036336,COGS 177,A00,083368,Staff,1,9,30,29
1649881042362,COGS 186,A01,083986,Staff,25,0,40,15
1649881048389,COGS 187A,A01,083988,Boyle; Mary E. T.,32,0,60,28
1649881054415,CSE 8A,A50,084003,Miranda; Gregory Joseph,7,0,15,8
1649881060442,CSE 11,A01,084005,Miranda; Gregory Joseph,44,0,55,11
1649881066470,CSE 20,A01,084007,Staff,14,0,20,6
1649881072498,CSE 21,A01,084009,Staff,26,0,50,24
1649881078584,CSE 30,A01,083370,Cao; Yingjun,7,0,40,33
1649881084616,CSE 100,A01,083372,Cao; Yingjun,0,0,40,40
1649881090645,CSE 101,A01,084011,Staff,0,33,40,40
1649881096672,CSE 141,A01,083374,Eldon; John,1,37,75,74
1649881102695,CSE 141L,A01,083376,Eldon; John,1,41,75,74
1649881108729,CSE 175,A01,084013,Kumar; Rakesh,22,0,25,3
1649881114756,CSE 190,A00,092508,Staff,15,0,15,0
1649881120782,ECE 5,A01,084049,Morris; Karcher William,17,0,20,3
1649881126816,ECE 100,A01,084051,Baghdadchi; Saharnaz,11,0,20,9
1649881126816,ECE 100,A02,091916,Baghdadchi; Saharnaz,18,0,20,2
1649881132839,ECE 101,A01,084053,Baghdadchi; Saharnaz,19,0,37,18
1649881132839,ECE 101,A02,084054,Baghdadchi; Saharnaz,37,0,37,0
1649881138875,ECE 107,A01,083390,Staff,31,0,40,9
1649881144903,ECE 148,A01,084056,Silberman; Jack,7,0,12,5
1649881150943,ECE 180,A00,083391,Abi Samra; Nicholas Camill,26,0,30,4
1649881150943,ECE 180,B00,083392,Abi Samra; Nicholas Camill,23,0,30,7
1649881156973,MATH 10B,A01,084110,Staff,17,0,30,13
1649881156973,MATH 10B,A02,084111,Staff,29,0,30,1
1649881156973,MATH 10B,A03,084112,Staff,29,0,30,1
1649881162997,MATH 10C,A01,083443,Staff,14,0,30,16
1649881162997,MATH 10C,A02,083444,Staff,17,0,30,13
1649881162997,MATH 10C,B01,084114,Staff,26,0,30,4
1649881162997,MATH 10C,B02,084115,Staff,30,0,30,0
1649881169019,MATH 18,A01,084117,Harel; Guershon,27,0,30,3
1649881169019,MATH 18,A02,084119,Harel; Guershon,29,0,30,1
1649881169019,MATH 18,A03,084120,Harel; Guershon,30,0,30,0
1649881169019,MATH 18,A04,084121,Harel; Guershon,30,0,30,0
1649881175041,MATH 20B,A01,084124,Um; Ko Woon,32,0,35,3
1649881175041,MATH 20B,B01,084126,Um; Ko Woon,33,0,35,2
1649881181073,MATH 20C,A01,083446,Hammock; Frances H,25,0,30,5
1649881181073,MATH 20C,A02,083447,Hammock; Frances H,29,0,30,1
1649881181073,MATH 20C,A03,083448,Hammock; Frances H,30,0,30,0
1649881181073,MATH 20C,A04,083449,Hammock; Frances H,30,0,30,0
1649881181073,MATH 20C,B01,083451,Hammock; Frances H,29,0,30,1
1649881181073,MATH 20C,B02,083452,Hammock; Frances H,29,0,30,1
1649881181073,MATH 20C,B03,083453,Hammock; Frances H,30,0,30,0
1649881181073,MATH 20C,B04,083454,Hammock; Frances H,30,0,30,0
1649881187096,MATH 20D,A01,084128,Staff,29,0,30,1
1649881187096,MATH 20D,A02,084129,Staff,30,0,30,0
1649881187096,MATH 20D,A03,084130,Staff,29,0,30,1
1649881187096,MATH 20D,B01,084133,Staff,28,0,30,2
1649881187096,MATH 20D,B02,084134,Staff,29,0,30,1
1649881187096,MATH 20D,B03,084135,Staff,30,0,30,0
1649881193128,MATH 20E,A01,084138,Staff,25,0,30,5
1649881193128,MATH 20E,A02,084139,Staff,27,0,30,3
1649881193128,MATH 20E,A03,084140,Staff,25,0,30,5
1649881193128,MATH 20E,A04,084141,Staff,29,0,30,1
1649881199166,MATH 102,A01,084143,Harel; Guershon,24,0,30,6
1649881199166,MATH 102,A02,084144,Harel; Guershon,24,0,30,6
1649881205192,MATH 103B,A01,083456,Staff,0,2,30,30
1649881205192,MATH 103B,A02,083457,Staff,3,0,30,27
1649881211216,MATH 109,A01,084146,Salehi Golsefidy; Alireza,29,0,30,1
1649881211216,MATH 109,A02,084147,Salehi Golsefidy; Alireza,25,0,30,5
1649881217245,MATH 120A,A01,085445,Eggers; John Dietrich,22,0,35,13
1649881217245,MATH 120A,A02,085446,Eggers; John Dietrich,30,0,35,5
1649881223273,MATH 142B,A01,084149,Verstraete; Jacques Allan,0,2,30,30
1649881223273,MATH 142B,A02,084150,Verstraete; Jacques Allan,13,0,30,17
1649881229297,MATH 170A,A01,083459,Nie; Jiawang,0,1,30,30
1649881229297,MATH 170A,A02,083460,Nie; Jiawang,19,0,30,11
1649881229297,MATH 170A,A03,083461,Nie; Jiawang,21,0,30,9
1649881235321,MATH 193B,A01,083463,Staff,12,0,30,18
1649881235321,MATH 193B,A02,083464,Staff,18,0,30,12
1649881235321,MATH 193B,A03,083465,Staff,25,0,30,5
1649881241382,COGS 2,A01,083966,Boyle; Mary E. T.,22,0,30,8
1649881247404,COGS 9,A01,083968,Staff,48,0,60,12
1649881253426,COGS 14B,A01,083970,Staff,43,0,50,7
1649881259456,COGS 17,A01,092679,Staff,71,0,75,4
1649881265487,COGS 100,A01,083972,Staff,37,0,60,23
1649881277553,COGS 101C,A01,083976,Staff,23,0,30,7
1649881283583,COGS 102A,A01,083978,Johnson; Christine M.,21,0,30,9
1649881289606,COGS 107B,A01,083980,Staff,23,0,50,27
1649881295635,COGS 115,A01,083982,Staff,15,0,30,15
1649881301668,COGS 118B,A01,083367,Staff,0,3,40,40
1649881307692,COGS 172,A01,083984,Provenzano; Emily Kara,17,0,30,13
1649881320166,COGS 177,A00,083368,Staff,1,8,30,29
1649881326189,COGS 186,A01,083986,Staff,25,0,40,15
1649881332218,COGS 187A,A01,083988,Boyle; Mary E. T.,32,0,60,28
1649881338256,CSE 8A,A50,084003,Miranda; Gregory Joseph,7,0,15,8
1649881344284,CSE 11,A01,084005,Miranda; Gregory Joseph,44,0,55,11
1649881350320,CSE 20,A01,084007,Staff,14,0,20,6
1649881356346,CSE 21,A01,084009,Staff,25,0,50,25
1649881362368,CSE 30,A01,083370,Cao; Yingjun,7,0,40,33
1649881368393,CSE 100,A01,083372,Cao; Yingjun,0,0,40,40
1649881374424,CSE 101,A01,084011,Staff,0,34,40,40
1649881380446,CSE 141,A01,083374,Eldon; John,1,38,75,74
1649881386476,CSE 141L,A01,083376,Eldon; John,1,42,75,74
1649881392506,CSE 175,A01,084013,Kumar; Rakesh,22,0,25,3
1649881398532,CSE 190,A00,092508,Staff,15,0,15,0
1649881404555,ECE 5,A01,084049,Morris; Karcher William,17,0,20,3
1649881410578,ECE 100,A01,084051,Baghdadchi; Saharnaz,11,0,20,9
1649881410578,ECE 100,A02,091916,Baghdadchi; Saharnaz,18,0,20,2
1649881416601,ECE 101,A01,084053,Baghdadchi; Saharnaz,19,0,37,18
1649881416601,ECE 101,A02,084054,Baghdadchi; Saharnaz,37,0,37,0
1649881422624,ECE 107,A01,083390,Staff,31,0,40,9
1649881428653,ECE 148,A01,084056,Silberman; Jack,7,0,12,5
1649881434679,ECE 180,A00,083391,Abi Samra; Nicholas Camill,26,0,30,4
1649881434679,ECE 180,B00,083392,Abi Samra; Nicholas Camill,23,0,30,7
1649881440701,MATH 10B,A01,084110,Staff,17,0,30,13
1649881440701,MATH 10B,A02,084111,Staff,29,0,30,1
1649881440701,MATH 10B,A03,084112,Staff,29,0,30,1
1649881446732,MATH 10C,A01,083443,Staff,14,0,30,16
1649881446732,MATH 10C,A02,083444,Staff,17,0,30,13
1649881446732,MATH 10C,B01,084114,Staff,26,0,30,4
1649881446732,MATH 10C,B02,084115,Staff,30,0,30,0
1649881452760,MATH 18,A01,084117,Harel; Guershon,27,0,30,3
1649881452760,MATH 18,A02,084119,Harel; Guershon,29,0,30,1
1649881452760,MATH 18,A03,084120,Harel; Guershon,30,0,30,0
1649881452760,MATH 18,A04,084121,Harel; Guershon,30,0,30,0
1649881458784,MATH 20B,A01,084124,Um; Ko Woon,32,0,35,3
1649881458784,MATH 20B,B01,084126,Um; Ko Woon,33,0,35,2
1649881464824,MATH 20C,A01,083446,Hammock; Frances H,25,0,30,5
1649881464824,MATH 20C,A02,083447,Hammock; Frances H,29,0,30,1
1649881464824,MATH 20C,A03,083448,Hammock; Frances H,30,0,30,0
1649881464824,MATH 20C,A04,083449,Hammock; Frances H,30,0,30,0
1649881464824,MATH 20C,B01,083451,Hammock; Frances H,29,0,30,1
1649881464824,MATH 20C,B02,083452,Hammock; Frances H,29,0,30,1
1649881464824,MATH 20C,B03,083453,Hammock; Frances H,30,0,30,0
1649881464824,MATH 20C,B04,083454,Hammock; Frances H,30,0,30,0
1649881470852,MATH 20D,A01,084128,Staff,29,0,30,1
1649881470852,MATH 20D,A02,084129,Staff,30,0,30,0
1649881470852,MATH 20D,A03,084130,Staff,29,0,30,1
1649881470852,MATH 20D,B01,084133,Staff,28,0,30,2
1649881470852,MATH 20D,B02,084134,Staff,29,0,30,1
1649881470852,MATH 20D,B03,084135,Staff,30,0,30,0
1649881476878,MATH 20E,A01,084138,Staff,25,0,30,5
1649881476878,MATH 20E,A02,084139,Staff,27,0,30,3
1649881476878,MATH 20E,A03,084140,Staff,25,0,30,5
1649881476878,MATH 20E,A04,084141,Staff,29,0,30,1
1649881482905,MATH 102,A01,084143,Harel; Guershon,24,0,30,6
1649881482905,MATH 102,A02,084144,Harel; Guershon,24,0,30,6
1649881488932,MATH 103B,A01,083456,Staff,0,2,30,30
1649881488932,MATH 103B,A02,083457,Staff,3,0,30,27
1649881494964,MATH 109,A01,084146,Salehi Golsefidy; Alireza,29,0,30,1
1649881494964,MATH 109,A02,084147,Salehi Golsefidy; Alireza,25,0,30,5
1649881500991,MATH 120A,A01,085445,Eggers; John Dietrich,22,0,35,13
1649881500991,MATH 120A,A02,085446,Eggers; John Dietrich,30,0,35,5
1649881507022,MATH 142B,A01,084149,Verstraete; Jacques Allan,0,2,30,30
1649881507022,MATH 142B,A02,084150,Verstraete; Jacques Allan,12,0,30,18
1649881513138,MATH 170A,A01,083459,Nie; Jiawang,0,1,30,30
1649881513138,MATH 170A,A02,083460,Nie; Jiawang,19,0,30,11
1649881513138,MATH 170A,A03,083461,Nie; Jiawang,21,0,30,9
1649881519161,MATH 193B,A01,083463,Staff,12,0,30,18
1649881519161,MATH 193B,A02,083464,Staff,18,0,30,12
1649881519161,MATH 193B,A03,083465,Staff,25,0,30,5
1649881525219,COGS 2,A01,083966,Boyle; Mary E. T.,22,0,30,8
1649881531244,COGS 9,A01,083968,Staff,48,0,60,12
1649881537271,COGS 14B,A01,083970,Staff,43,0,50,7
1649881543296,COGS 17,A01,092679,Staff,71,0,75,4
1649881549321,COGS 100,A01,083972,Staff,37,0,60,23
1649881561392,COGS 101C,A01,083976,Staff,23,0,30,7
1649881567426,COGS 102A,A01,083978,Johnson; Christine M.,21,0,30,9
1649881573450,COGS 107B,A01,083980,Staff,23,0,50,27
1649881579473,COGS 115,A01,083982,Staff,15,0,30,15
1649881585497,COGS 118B,A01,083367,Staff,0,3,40,40
1649881591519,COGS 172,A01,083984,Provenzano; Emily Kara,17,0,30,13
1649881597543,COGS 177,A00,083368,Staff,1,8,30,29
1649881603580,COGS 186,A01,083986,Staff,24,0,40,16
1649881609603,COGS 187A,A01,083988,Boyle; Mary E. T.,32,0,60,28
1649881615627,CSE 8A,A50,084003,Miranda; Gregory Joseph,7,0,15,8
1649881621650,CSE 11,A01,084005,Miranda; Gregory Joseph,43,0,55,12
1649881627677,CSE 20,A01,084007,Staff,13,0,20,7
1649881633699,CSE 21,A01,084009,Staff,25,0,50,25
1649881639732,CSE 30,A01,083370,Cao; Yingjun,7,0,40,33
1649881645756,CSE 100,A01,083372,Cao; Yingjun,0,1,40,40
1649881651793,CSE 101,A01,084011,Staff,0,34,40,40
1649881657816,CSE 141,A01,083374,Eldon; John,1,38,75,74
1649881663843,CSE 141L,A01,083376,Eldon; John,1,42,75,74
1649881669868,CSE 175,A01,084013,Kumar; Rakesh,22,0,25,3
1649881675902,CSE 190,A00,092508,Dubnov; Shlomo,15,0,15,0
1649881681935,ECE 5,A01,084049,Morris; Karcher William,17,0,20,3
1649881687972,ECE 100,A01,084051,Baghdadchi; Saharnaz,11,0,20,9
1649881687972,ECE 100,A02,091916,Baghdadchi; Saharnaz,18,0,20,2
1649881694000,ECE 101,A01,084053,Baghdadchi; Saharnaz,19,0,37,18
1649881694000,ECE 101,A02,084054,Baghdadchi; Saharnaz,37,0,37,0
1649881700022,ECE 107,A01,083390,Staff,31,0,40,9
1649881706045,ECE 148,A01,084056,Silberman; Jack,7,0,12,5
1649881712079,ECE 180,A00,083391,Abi Samra; Nicholas Camill,26,0,30,4
1649881712079,ECE 180,B00,083392,Abi Samra; Nicholas Camill,23,0,30,7
1649881718106,MATH 10B,A01,084110,Staff,17,0,30,13
1649881718106,MATH 10B,A02,084111,Staff,29,0,30,1
1649881718106,MATH 10B,A03,084112,Staff,29,0,30,1
1649881724132,MATH 10C,A01,083443,Staff,14,0,30,16
1649881724132,MATH 10C,A02,083444,Staff,17,0,30,13
1649881724132,MATH 10C,B01,084114,Staff,26,0,30,4
1649881724132,MATH 10C,B02,084115,Staff,30,0,30,0
1649881730160,MATH 18,A01,084117,Harel; Guershon,27,0,30,3
1649881730160,MATH 18,A02,084119,Harel; Guershon,29,0,30,1
1649881730160,MATH 18,A03,084120,Harel; Guershon,30,0,30,0
1649881730160,MATH 18,A04,084121,Harel; Guershon,30,0,30,0
1649881736183,MATH 20B,A01,084124,Um; Ko Woon,32,0,35,3
1649881736183,MATH 20B,B01,084126,Um; Ko Woon,33,0,35,2
1649881742209,MATH 20C,A01,083446,Hammock; Frances H,25,0,30,5
1649881742209,MATH 20C,A02,083447,Hammock; Frances H,29,0,30,1
1649881742209,MATH 20C,A03,083448,Hammock; Frances H,30,0,30,0
1649881742209,MATH 20C,A04,083449,Hammock; Frances H,30,0,30,0
1649881742209,MATH 20C,B01,083451,Hammock; Frances H,29,0,30,1
1649881742209,MATH 20C,B02,083452,Hammock; Frances H,29,0,30,1
1649881742209,MATH 20C,B03,083453,Hammock; Frances H,30,0,30,0
1649881742209,MATH 20C,B04,083454,Hammock; Frances H,30,0,30,0
1649881748237,MATH 20D,A01,084128,Staff,29,0,30,1
1649881748237,MATH 20D,A02,084129,Staff,30,0,30,0
1649881748237,MATH 20D,A03,084130,Staff,29,0,30,1
1649881748237,MATH 20D,B01,084133,Staff,28,0,30,2
1649881748237,MATH 20D,B02,084134,Staff,29,0,30,1
1649881748237,MATH 20D,B03,084135,Staff,30,0,30,0
1649881754261,MATH 20E,A01,084138,Staff,25,0,30,5
1649881754261,MATH 20E,A02,084139,Staff,27,0,30,3
1649881754261,MATH 20E,A03,084140,Staff,25,0,30,5
1649881754261,MATH 20E,A04,084141,Staff,29,0,30,1
1649881760287,MATH 102,A01,084143,Harel; Guershon,24,0,30,6
1649881760287,MATH 102,A02,084144,Harel; Guershon,24,0,30,6
1649881766313,MATH 103B,A01,083456,Staff,0,2,30,30
1649881766313,MATH 103B,A02,083457,Staff,3,0,30,27
1649881772337,MATH 109,A01,084146,Salehi Golsefidy; Alireza,29,0,30,1
1649881772337,MATH 109,A02,084147,Salehi Golsefidy; Alireza,25,0,30,5
1649881778358,MATH 120A,A01,085445,Eggers; John Dietrich,22,0,35,13
1649881778358,MATH 120A,A02,085446,Eggers; John Dietrich,30,0,35,5
1649881784389,MATH 142B,A01,084149,Verstraete; Jacques Allan,0,2,30,30
1649881784389,MATH 142B,A02,084150,Verstraete; Jacques Allan,11,0,30,19
1649881790424,MATH 170A,A01,083459,Nie; Jiawang,0,1,30,30
1649881790424,MATH 170A,A02,083460,Nie; Jiawang,19,0,30,11
1649881790424,MATH 170A,A03,083461,Nie; Jiawang,21,0,30,9
1649881796456,MATH 193B,A01,083463,Staff,12,0,30,18
1649881796456,MATH 193B,A02,083464,Staff,18,0,30,12
1649881796456,MATH 193B,A03,083465,Staff,25,0,30,5
1649881802508,COGS 2,A01,083966,Boyle; Mary E. T.,22,0,30,8
1649881808549,COGS 9,A01,083968,Staff,48,0,60,12
1649881814578,COGS 14B,A01,083970,Staff,43,0,50,7
1649881820616,COGS 17,A01,092679,Staff,71,0,75,4
1649881826646,COGS 100,A01,083972,Staff,37,0,60,23
1649881838697,COGS 101C,A01,083976,Staff,23,0,30,7
1649881844722,COGS 102A,A01,083978,Johnson; Christine M.,21,0,30,9
1649881850754,COGS 107B,A01,083980,Staff,23,0,50,27
1649881856778,COGS 115,A01,083982,Staff,14,0,30,16
1649881862806,COGS 118B,A01,083367,Staff,0,4,40,40
1649881868831,COGS 172,A01,083984,Provenzano; Emily Kara,17,0,30,13
1649881874858,COGS 177,A00,083368,Staff,1,9,30,29
1649881880883,COGS 186,A01,083986,Staff,24,0,40,16
1649881886913,COGS 187A,A01,083988,Boyle; Mary E. T.,32,0,60,28
1649881892946,CSE 8A,A50,084003,Miranda; Gregory Joseph,7,0,15,8
1649881898977,CSE 11,A01,084005,Miranda; Gregory Joseph,43,0,55,12
1649881905000,CSE 20,A01,084007,Staff,13,0,20,7
1649881911023,CSE 21,A01,084009,Staff,25,0,50,25
1649881917051,CSE 30,A01,083370,Cao; Yingjun,7,0,40,33
1649881923078,CSE 100,A01,083372,Cao; Yingjun,0,1,40,40
1649881929111,CSE 101,A01,084011,Staff,0,34,40,40
1649881935132,CSE 141,A01,083374,Eldon; John,1,38,75,74
1649881941166,CSE 141L,A01,083376,Eldon; John,1,42,75,74
1649881947201,CSE 175,A01,084013,Kumar; Rakesh,22,0,25,3
1649881953229,CSE 190,A00,092508,Dubnov; Shlomo,15,0,15,0
1649881959259,ECE 5,A01,084049,Morris; Karcher William,17,0,20,3
1649881965285,ECE 100,A01,084051,Baghdadchi; Saharnaz,10,0,20,10
1649881965285,ECE 100,A02,091916,Baghdadchi; Saharnaz,18,0,20,2
1649881971308,ECE 101,A01,084053,Baghdadchi; Saharnaz,19,0,37,18
1649881971308,ECE 101,A02,084054,Baghdadchi; Saharnaz,37,0,37,0
1649881977332,ECE 107,A01,083390,Staff,31,0,40,9
1649881983363,ECE 148,A01,084056,Silberman; Jack,7,0,12,5
1649881989386,ECE 180,A00,083391,Abi Samra; Nicholas Camill,26,0,30,4
1649881989386,ECE 180,B00,083392,Abi Samra; Nicholas Camill,23,0,30,7
1649881995409,MATH 10B,A01,084110,Staff,17,0,30,13
1649881995409,MATH 10B,A02,084111,Staff,29,0,30,1
1649881995409,MATH 10B,A03,084112,Staff,29,0,30,1
1649882001443,MATH 10C,A01,083443,Staff,14,0,30,16
1649882001443,MATH 10C,A02,083444,Staff,17,0,30,13
1649882001443,MATH 10C,B01,084114,Staff,26,0,30,4
1649882001443,MATH 10C,B02,084115,Staff,30,0,30,0
1649882007470,MATH 18,A01,084117,Harel; Guershon,27,0,30,3
1649882007470,MATH 18,A02,084119,Harel; Guershon,29,0,30,1
1649882007470,MATH 18,A03,084120,Harel; Guershon,30,0,30,0
1649882007470,MATH 18,A04,084121,Harel; Guershon,30,0,30,0
1649882013501,MATH 20B,A01,084124,Um; Ko Woon,32,0,35,3
1649882013501,MATH 20B,B01,084126,Um; Ko Woon,33,0,35,2
1649882019529,MATH 20C,A01,083446,Hammock; Frances H,25,0,30,5
1649882019529,MATH 20C,A02,083447,Hammock; Frances H,29,0,30,1
1649882019529,MATH 20C,A03,083448,Hammock; Frances H,30,0,30,0
1649882019529,MATH 20C,A04,083449,Hammock; Frances H,30,0,30,0
1649882019529,MATH 20C,B01,083451,Hammock; Frances H,29,0,30,1
1649882019529,MATH 20C,B02,083452,Hammock; Frances H,29,0,30,1
1649882019529,MATH 20C,B03,083453,Hammock; Frances H,30,0,30,0
1649882019529,MATH 20C,B04,083454,Hammock; Frances H,30,0,30,0
1649882025564,MATH 20D,A01,084128,Staff,29,0,30,1
1649882025564,MATH 20D,A02,084129,Staff,30,0,30,0
1649882025564,MATH 20D,A03,084130,Staff,29,0,30,1
1649882025564,MATH 20D,B01,084133,Staff,28,0,30,2
1649882025564,MATH 20D,B02,084134,Staff,29,0,30,1
1649882025564,MATH 20D,B03,084135,Staff,30,0,30,0
1649882031592,MATH 20E,A01,084138,Staff,25,0,30,5
1649882031592,MATH 20E,A02,084139,Staff,27,0,30,3
1649882031592,MATH 20E,A03,084140,Staff,25,0,30,5
1649882031592,MATH 20E,A04,084141,Staff,29,0,30,1
1649882037616,MATH 102,A01,084143,Harel; Guershon,23,0,30,7
1649882037616,MATH 102,A02,084144,Harel; Guershon,24,0,30,6
1649882043640,MATH 103B,A01,083456,Staff,0,2,30,30
1649882043640,MATH 103B,A02,083457,Staff,3,0,30,27
1649882049745,MATH 109,A01,084146,Salehi Golsefidy; Alireza,29,0,30,1
1649882049745,MATH 109,A02,084147,Salehi Golsefidy; Alireza,25,0,30,5
1649882055767,MATH 120A,A01,085445,Eggers; John Dietrich,22,0,35,13
1649882055767,MATH 120A,A02,085446,Eggers; John Dietrich,30,0,35,5
1649882061790,MATH 142B,A01,084149,Verstraete; Jacques Allan,0,2,30,30
1649882061790,MATH 142B,A02,084150,Verstraete; Jacques Allan,11,0,30,19
1649882067818,MATH 170A,A01,083459,Nie; Jiawang,0,1,30,30
1649882067818,MATH 170A,A02,083460,Nie; Jiawang,19,0,30,11
1649882067818,MATH 170A,A03,083461,Nie; Jiawang,21,0,30,9
1649882073843,MATH 193B,A01,083463,Staff,12,0,30,18
1649882073843,MATH 193B,A02,083464,Staff,18,0,30,12
1649882073843,MATH 193B,A03,083465,Staff,25,0,30,5
1649882079896,COGS 2,A01,083966,Boyle; Mary E. T.,22,0,30,8
1649882085925,COGS 9,A01,083968,Staff,48,0,60,12
1649882091949,COGS 14B,A01,083970,Staff,43,0,50,7
1649882097985,COGS 17,A01,092679,Staff,71,0,75,4
1649882104084,COGS 100,A01,083972,Staff,37,0,60,23
1649882116134,COGS 101C,A01,083976,Staff,23,0,30,7
1649882122160,COGS 102A,A01,083978,Johnson; Christine M.,21,0,30,9
1649882128184,COGS 107B,A01,083980,Staff,23,0,50,27
1649882134218,COGS 115,A01,083982,Staff,14,0,30,16
1649882140241,COGS 118B,A01,083367,Staff,0,4,40,40
1649882146272,COGS 172,A01,083984,Provenzano; Emily Kara,17,0,30,13
1649882152308,COGS 177,A00,083368,Staff,1,9,30,29
1649882158331,COGS 186,A01,083986,Staff,24,0,40,16
1649882164359,COGS 187A,A01,083988,Boyle; Mary E. T.,32,0,60,28
1649882170388,CSE 8A,A50,084003,Miranda; Gregory Joseph,7,0,15,8
1649882176427,CSE 11,A01,084005,Miranda; Gregory Joseph,43,0,55,12
1649882182452,CSE 20,A01,084007,Staff,13,0,20,7
1649882188483,CSE 21,A01,084009,Staff,25,0,50,25
1649882194509,CSE 30,A01,083370,Cao; Yingjun,6,0,40,34
1649882200533,CSE 100,A01,083372,Cao; Yingjun,0,1,40,40
1649882206557,CSE 101,A01,084011,Staff,0,34,40,40
1649882212581,CSE 141,A01,083374,Eldon; John,1,38,75,74
1649882218603,CSE 141L,A01,083376,Eldon; John,1,42,75,74
1649882224630,CSE 175,A01,084013,Kumar; Rakesh,22,0,25,3
1649882230659,CSE 190,A00,092508,Dubnov; Shlomo,15,0,15,0
1649882236686,ECE 5,A01,084049,Morris; Karcher William,17,0,20,3
1649882242709,ECE 100,A01,084051,Baghdadchi; Saharnaz,10,0,20,10
1649882242709,ECE 100,A02,091916,Baghdadchi; Saharnaz,18,0,20,2
1649882248735,ECE 101,A01,084053,Baghdadchi; Saharnaz,19,0,37,18
1649882248735,ECE 101,A02,084054,Baghdadchi; Saharnaz,37,0,37,0
1649882254762,ECE 107,A01,083390,Staff,31,0,40,9
1649882260785,ECE 148,A01,084056,Silberman; Jack,7,0,12,5
1649882266813,ECE 180,A00,083391,Abi Samra; Nicholas Camill,26,0,30,4
1649882266813,ECE 180,B00,083392,Abi Samra; Nicholas Camill,23,0,30,7
1649882272841,MATH 10B,A01,084110,Staff,17,0,30,13
1649882272841,MATH 10B,A02,084111,Staff,29,0,30,1
1649882272841,MATH 10B,A03,084112,Staff,29,0,30,1
1649882278864,MATH 10C,A01,083443,Staff,14,0,30,16
1649882278864,MATH 10C,A02,083444,Staff,17,0,30,13
1649882278864,MATH 10C,B01,084114,Staff,26,0,30,4
1649882278864,MATH 10C,B02,084115,Staff,30,0,30,0
1649882284896,MATH 18,A01,084117,Harel; Guershon,27,0,30,3
1649882284896,MATH 18,A02,084119,Harel; Guershon,29,0,30,1
1649882284896,MATH 18,A03,084120,Harel; Guershon,30,0,30,0
1649882284896,MATH 18,A04,084121,Harel; Guershon,30,0,30,0
1649882290920,MATH 20B,A01,084124,Um; Ko Woon,32,0,35,3
1649882290920,MATH 20B,B01,084126,Um; Ko Woon,33,0,35,2
1649882296949,MATH 20C,A01,083446,Hammock; Frances H,25,0,30,5
1649882296949,MATH 20C,A02,083447,Hammock; Frances H,29,0,30,1
1649882296949,MATH 20C,A03,083448,Hammock; Frances H,30,0,30,0
1649882296949,MATH 20C,A04,083449,Hammock; Frances H,30,0,30,0
1649882296949,MATH 20C,B01,083451,Hammock; Frances H,29,0,30,1
1649882296949,MATH 20C,B02,083452,Hammock; Frances H,29,0,30,1
1649882296949,MATH 20C,B03,083453,Hammock; Frances H,30,0,30,0
1649882296949,MATH 20C,B04,083454,Hammock; Frances H,30,0,30,0
1649882302975,MATH 20D,A01,084128,Staff,29,0,30,1
1649882302975,MATH 20D,A02,084129,Staff,30,0,30,0
1649882302975,MATH 20D,A03,084130,Staff,29,0,30,1
1649882302975,MATH 20D,B01,084133,Staff,28,0,30,2
1649882302975,MATH 20D,B02,084134,Staff,29,0,30,1
1649882302975,MATH 20D,B03,084135,Staff,30,0,30,0
1649882308998,MATH 20E,A01,084138,Staff,25,0,30,5
1649882308998,MATH 20E,A02,084139,Staff,27,0,30,3
1649882308998,MATH 20E,A03,084140,Staff,25,0,30,5
1649882308998,MATH 20E,A04,084141,Staff,29,0,30,1
1649882315021,MATH 102,A01,084143,Harel; Guershon,23,0,30,7
1649882315021,MATH 102,A02,084144,Harel; Guershon,24,0,30,6
1649882321055,MATH 103B,A01,083456,Staff,0,2,30,30
1649882321055,MATH 103B,A02,083457,Staff,3,0,30,27
1649882327085,MATH 109,A01,084146,Salehi Golsefidy; Alireza,29,0,30,1
1649882327085,MATH 109,A02,084147,Salehi Golsefidy; Alireza,25,0,30,5
1649882333119,MATH 120A,A01,085445,Eggers; John Dietrich,22,0,35,13
1649882333119,MATH 120A,A02,085446,Eggers; John Dietrich,30,0,35,5
1649882339149,MATH 142B,A01,084149,Verstraete; Jacques Allan,0,2,30,30
1649882339149,MATH 142B,A02,084150,Verstraete; Jacques Allan,11,0,30,19
1649882345172,MATH 170A,A01,083459,Nie; Jiawang,0,1,30,30
1649882345172,MATH 170A,A02,083460,Nie; Jiawang,19,0,30,11
1649882345172,MATH 170A,A03,083461,Nie; Jiawang,21,0,30,9
1649882351201,MATH 193B,A01,083463,Staff,12,0,30,18
1649882351201,MATH 193B,A02,083464,Staff,18,0,30,12
1649882351201,MATH 193B,A03,083465,Staff,25,0,30,5
1649882357249,COGS 2,A01,083966,Boyle; Mary E. T.,22,0,30,8
1649882363279,COGS 9,A01,083968,Staff,48,0,60,12
1649882369306,COGS 14B,A01,083970,Staff,43,0,50,7
1649882375333,COGS 17,A01,092679,Staff,71,0,75,4
1649882381365,COGS 100,A01,083972,Staff,37,0,60,23
1649882393421,COGS 101C,A01,083976,Staff,23,0,30,7
1649882399451,COGS 102A,A01,083978,Johnson; Christine M.,21,0,30,9
1649882405477,COGS 107B,A01,083980,Staff,23,0,50,27
1649882411503,COGS 115,A01,083982,Staff,14,0,30,16
1649882417528,COGS 118B,A01,083367,Staff,0,4,40,40
1649882423557,COGS 172,A01,083984,Provenzano; Emily Kara,17,0,30,13
1649882429580,COGS 177,A00,083368,Staff,1,9,30,29
1649882435613,COGS 186,A01,083986,Staff,24,0,40,16
1649882441650,COGS 187A,A01,083988,Boyle; Mary E. T.,32,0,60,28
1649882447674,CSE 8A,A50,084003,Miranda; Gregory Joseph,7,0,15,8
1649882453705,CSE 11,A01,084005,Miranda; Gregory Joseph,43,0,55,12
1649882459730,CSE 20,A01,084007,Staff,13,0,20,7
1649882465769,CSE 21,A01,084009,Staff,25,0,50,25
1649882471795,CSE 30,A01,083370,Cao; Yingjun,6,0,40,34
1649882477818,CSE 100,A01,083372,Cao; Yingjun,0,1,40,40
1649882483846,CSE 101,A01,084011,Staff,0,34,40,40
1649882489869,CSE 141,A01,083374,Eldon; John,1,38,75,74
1649882495896,CSE 141L,A01,083376,Eldon; John,1,42,75,74
1649882501954,CSE 175,A01,084013,Kumar; Rakesh,22,0,25,3
1649882507977,CSE 190,A00,092508,Dubnov; Shlomo,15,0,15,0
1649882514006,ECE 5,A01,084049,Morris; Karcher William,17,0,20,3
1649882520029,ECE 100,A01,084051,Baghdadchi; Saharnaz,10,0,20,10
1649882520029,ECE 100,A02,091916,Baghdadchi; Saharnaz,18,0,20,2
1649882526056,ECE 101,A01,084053,Baghdadchi; Saharnaz,19,0,37,18
1649882526056,ECE 101,A02,084054,Baghdadchi; Saharnaz,37,0,37,0
1649882532080,ECE 107,A01,083390,Staff,31,0,40,9
1649882538113,ECE 148,A01,084056,Silberman; Jack,7,0,12,5
1649882544143,ECE 180,A00,083391,Abi Samra; Nicholas Camill,26,0,30,4
1649882544143,ECE 180,B00,083392,Abi Samra; Nicholas Camill,23,0,30,7
1649882550169,MATH 10B,A01,084110,Staff,17,0,30,13
1649882550169,MATH 10B,A02,084111,Staff,29,0,30,1
1649882550169,MATH 10B,A03,084112,Staff,29,0,30,1
1649882556196,MATH 10C,A01,083443,Staff,14,0,30,16
1649882556196,MATH 10C,A02,083444,Staff,17,0,30,13
1649882556196,MATH 10C,B01,084114,Staff,26,0,30,4
1649882556196,MATH 10C,B02,084115,Staff,30,0,30,0
1649882562225,MATH 18,A01,084117,Harel; Guershon,27,0,30,3
1649882562225,MATH 18,A02,084119,Harel; Guershon,29,0,30,1
1649882562225,MATH 18,A03,084120,Harel; Guershon,30,0,30,0
1649882562225,MATH 18,A04,084121,Harel; Guershon,30,0,30,0
1649882568249,MATH 20B,A01,084124,Um; Ko Woon,32,0,35,3
1649882568249,MATH 20B,B01,084126,Um; Ko Woon,33,0,35,2
1649882574290,MATH 20C,A01,083446,Hammock; Frances H,25,0,30,5
1649882574290,MATH 20C,A02,083447,Hammock; Frances H,29,0,30,1
1649882574290,MATH 20C,A03,083448,Hammock; Frances H,30,0,30,0
1649882574290,MATH 20C,A04,083449,Hammock; Frances H,30,0,30,0
1649882574290,MATH 20C,B01,083451,Hammock; Frances H,29,0,30,1
1649882574290,MATH 20C,B02,083452,Hammock; Frances H,29,0,30,1
1649882574290,MATH 20C,B03,083453,Hammock; Frances H,30,0,30,0
1649882574290,MATH 20C,B04,083454,Hammock; Frances H,30,0,30,0
1649882580314,MATH 20D,A01,084128,Staff,29,0,30,1
1649882580314,MATH 20D,A02,084129,Staff,30,0,30,0
1649882580314,MATH 20D,A03,084130,Staff,29,0,30,1
1649882580314,MATH 20D,B01,084133,Staff,28,0,30,2
1649882580314,MATH 20D,B02,084134,Staff,29,0,30,1
1649882580314,MATH 20D,B03,084135,Staff,30,0,30,0
1649882586351,MATH 20E,A01,084138,Staff,25,0,30,5
1649882586351,MATH 20E,A02,084139,Staff,27,0,30,3
1649882586351,MATH 20E,A03,084140,Staff,25,0,30,5
1649882586351,MATH 20E,A04,084141,Staff,29,0,30,1
1649882592378,MATH 102,A01,084143,Harel; Guershon,23,0,30,7
1649882592378,MATH 102,A02,084144,Harel; Guershon,24,0,30,6
1649882598408,MATH 103B,A01,083456,Staff,0,2,30,30
1649882598408,MATH 103B,A02,083457,Staff,3,0,30,27
1649882604435,MATH 109,A01,084146,Salehi Golsefidy; Alireza,29,0,30,1
1649882604435,MATH 109,A02,084147,Salehi Golsefidy; Alireza,25,0,30,5
1649882610462,MATH 120A,A01,085445,Eggers; John Dietrich,22,0,35,13
1649882610462,MATH 120A,A02,085446,Eggers; John Dietrich,30,0,35,5
1649882616502,MATH 142B,A01,084149,Verstraete; Jacques Allan,0,2,30,30
1649882616502,MATH 142B,A02,084150,Verstraete; Jacques Allan,11,0,30,19
1649882622529,MATH 170A,A01,083459,Nie; Jiawang,0,1,30,30
1649882622529,MATH 170A,A02,083460,Nie; Jiawang,19,0,30,11
1649882622529,MATH 170A,A03,083461,Nie; Jiawang,21,0,30,9
1649882628564,MATH 193B,A01,083463,Staff,12,0,30,18
1649882628564,MATH 193B,A02,083464,Staff,18,0,30,12
1649882628564,MATH 193B,A03,083465,Staff,25,0,30,5
1649882634621,COGS 2,A01,083966,Boyle; Mary E. T.,22,0,30,8
1649882640645,COGS 9,A01,083968,Staff,48,0,60,12
1649882646672,COGS 14B,A01,083970,Staff,43,0,50,7
1649882652698,COGS 17,A01,092679,Staff,70,0,75,5
1649882658726,COGS 100,A01,083972,Staff,37,0,60,23
1649882670776,COGS 101C,A01,083976,Staff,23,0,30,7
1649882676803,COGS 102A,A01,083978,Johnson; Christine M.,21,0,30,9
1649882682828,COGS 107B,A01,083980,Staff,23,0,50,27
1649882688851,COGS 115,A01,083982,Staff,14,0,30,16
1649882694879,COGS 118B,A01,083367,Staff,0,5,40,40
1649882701011,COGS 172,A01,083984,Provenzano; Emily Kara,17,0,30,13
1649882707039,COGS 177,A00,083368,Staff,1,9,30,29
1649882713066,COGS 186,A01,083986,Staff,23,0,40,17
1649882719090,COGS 187A,A01,083988,Boyle; Mary E. T.,31,0,60,29
1649882725114,CSE 8A,A50,084003,Miranda; Gregory Joseph,7,0,15,8
1649882731136,CSE 11,A01,084005,Miranda; Gregory Joseph,43,0,55,12
1649882737161,CSE 20,A01,084007,Staff,13,0,20,7
1649882743185,CSE 21,A01,084009,Staff,25,0,50,25
1649882749213,CSE 30,A01,083370,Cao; Yingjun,6,0,40,34
1649882755242,CSE 100,A01,083372,Cao; Yingjun,0,4,40,40
1649882761264,CSE 101,A01,084011,Staff,1,35,40,39
1649882767289,CSE 141,A01,083374,Eldon; John,1,39,75,74
1649882773320,CSE 141L,A01,083376,Eldon; John,1,43,75,74
1649882779350,CSE 175,A01,084013,Kumar; Rakesh,22,0,25,3
1649882785373,CSE 190,A00,092508,Dubnov; Shlomo,15,0,15,0
1649882791406,ECE 5,A01,084049,Morris; Karcher William,17,0,20,3
1649882797431,ECE 100,A01,084051,Baghdadchi; Saharnaz,10,0,20,10
1649882797431,ECE 100,A02,091916,Baghdadchi; Saharnaz,18,0,20,2
1649882803454,ECE 101,A01,084053,Baghdadchi; Saharnaz,19,0,37,18
1649882803454,ECE 101,A02,084054,Baghdadchi; Saharnaz,37,0,37,0
1649882809480,ECE 107,A01,083390,Staff,31,0,40,9
1649882815508,ECE 148,A01,084056,Silberman; Jack,7,0,12,5
1649882821532,ECE 180,A00,083391,Abi Samra; Nicholas Camill,26,0,30,4
1649882821532,ECE 180,B00,083392,Abi Samra; Nicholas Camill,23,0,30,7
1649882827556,MATH 10B,A01,084110,Staff,17,0,30,13
1649882827556,MATH 10B,A02,084111,Staff,29,0,30,1
1649882827556,MATH 10B,A03,084112,Staff,29,0,30,1
1649882833580,MATH 10C,A01,083443,Staff,14,0,30,16
1649882833580,MATH 10C,A02,083444,Staff,17,0,30,13
1649882833580,MATH 10C,B01,084114,Staff,26,0,30,4
1649882833580,MATH 10C,B02,084115,Staff,30,0,30,0
1649882839611,MATH 18,A01,084117,Harel; Guershon,27,0,30,3
1649882839611,MATH 18,A02,084119,Harel; Guershon,29,0,30,1
1649882839611,MATH 18,A03,084120,Harel; Guershon,30,0,30,0
1649882839611,MATH 18,A04,084121,Harel; Guershon,30,0,30,0
1649882845642,MATH 20B,A01,084124,Um; Ko Woon,32,0,35,3
1649882845642,MATH 20B,B01,084126,Um; Ko Woon,33,0,35,2
1649882851665,MATH 20C,A01,083446,Hammock; Frances H,25,0,30,5
1649882851665,MATH 20C,A02,083447,Hammock; Frances H,29,0,30,1
1649882851665,MATH 20C,A03,083448,Hammock; Frances H,30,0,30,0
1649882851665,MATH 20C,A04,083449,Hammock; Frances H,30,0,30,0
1649882851665,MATH 20C,B01,083451,Hammock; Frances H,29,0,30,1
1649882851665,MATH 20C,B02,083452,Hammock; Frances H,29,0,30,1
1649882851665,MATH 20C,B03,083453,Hammock; Frances H,30,0,30,0
1649882851665,MATH 20C,B04,083454,Hammock; Frances H,30,0,30,0
1649882857696,MATH 20D,A01,084128,Staff,29,0,30,1
1649882857696,MATH 20D,A02,084129,Staff,30,0,30,0
1649882857696,MATH 20D,A03,084130,Staff,29,0,30,1
1649882857696,MATH 20D,B01,084133,Staff,28,0,30,2
1649882857696,MATH 20D,B02,084134,Staff,29,0,30,1
1649882857696,MATH 20D,B03,084135,Staff,30,0,30,0
1649882863720,MATH 20E,A01,084138,Staff,25,0,30,5
1649882863720,MATH 20E,A02,084139,Staff,27,0,30,3
1649882863720,MATH 20E,A03,084140,Staff,25,0,30,5
1649882863720,MATH 20E,A04,084141,Staff,29,0,30,1
1649882869750,MATH 102,A01,084143,Harel; Guershon,23,0,30,7
1649882869750,MATH 102,A02,084144,Harel; Guershon,24,0,30,6
1649882875777,MATH 103B,A01,083456,Staff,0,2,30,30
1649882875777,MATH 103B,A02,083457,Staff,2,0,30,28
1649882881823,MATH 109,A01,084146,Salehi Golsefidy; Alireza,29,0,30,1
1649882881823,MATH 109,A02,084147,Salehi Golsefidy; Alireza,25,0,30,5
1649882887853,MATH 120A,A01,085445,Eggers; John Dietrich,22,0,35,13
1649882887853,MATH 120A,A02,085446,Eggers; John Dietrich,30,0,35,5
1649882893877,MATH 142B,A01,084149,Verstraete; Jacques Allan,0,2,30,30
1649882893877,MATH 142B,A02,084150,Verstraete; Jacques Allan,11,0,30,19
1649882899905,MATH 170A,A01,083459,Nie; Jiawang,0,1,30,30
1649882899905,MATH 170A,A02,083460,Nie; Jiawang,18,0,30,12
1649882899905,MATH 170A,A03,083461,Nie; Jiawang,21,0,30,9
1649882905929,MATH 193B,A01,083463,Staff,12,0,30,18
1649882905929,MATH 193B,A02,083464,Staff,18,0,30,12
1649882905929,MATH 193B,A03,083465,Staff,25,0,30,5
1649882912008,COGS 2,A01,083966,Boyle; Mary E. T.,22,0,30,8
1649882918034,COGS 9,A01,083968,Staff,48,0,60,12
1649882924059,COGS 14B,A01,083970,Staff,43,0,50,7
1649882930085,COGS 17,A01,092679,Staff,70,0,75,5
1649882936109,COGS 100,A01,083972,Staff,37,0,60,23
1649882948174,COGS 101C,A01,083976,Staff,23,0,30,7
1649882954206,COGS 102A,A01,083978,Johnson; Christine M.,21,0,30,9
1649882960233,COGS 107B,A01,083980,Staff,23,0,50,27
1649882966257,COGS 115,A01,083982,Staff,14,0,30,16
1649882972280,COGS 118B,A01,083367,Staff,0,5,40,40
1649882978321,COGS 172,A01,083984,Provenzano; Emily Kara,17,0,30,13
1649882984348,COGS 177,A00,083368,Staff,1,9,30,29
1649882990373,COGS 186,A01,083986,Staff,23,0,40,17
1649882996397,COGS 187A,A01,083988,Boyle; Mary E. T.,31,0,60,29
1649883002429,CSE 8A,A50,084003,Miranda; Gregory Joseph,7,0,15,8
1649883008479,CSE 11,A01,084005,Miranda; Gregory Joseph,43,0,55,12
1649883014502,CSE 20,A01,084007,Staff,13,0,20,7
1649883020525,CSE 21,A01,084009,Staff,25,0,50,25
1649883026558,CSE 30,A01,083370,Cao; Yingjun,6,0,40,34
1649883032581,CSE 100,A01,083372,Cao; Yingjun,0,4,40,40
1649883038611,CSE 101,A01,084011,Staff,1,35,40,39
1649883044647,CSE 141,A01,083374,Eldon; John,1,39,75,74
1649883050670,CSE 141L,A01,083376,Eldon; John,1,43,75,74
1649883056712,CSE 175,A01,084013,Kumar; Rakesh,22,0,25,3
1649883062739,CSE 190,A00,092508,Dubnov; Shlomo,15,0,15,0
1649883068763,ECE 5,A01,084049,Morris; Karcher William,17,0,20,3
1649883074801,ECE 100,A01,084051,Baghdadchi; Saharnaz,10,0,20,10
1649883074801,ECE 100,A02,091916,Baghdadchi; Saharnaz,18,0,20,2
1649883080840,ECE 101,A01,084053,Baghdadchi; Saharnaz,19,0,37,18
1649883080840,ECE 101,A02,084054,Baghdadchi; Saharnaz,37,0,37,0
1649883086871,ECE 107,A01,083390,Staff,31,0,40,9
1649883092895,ECE 148,A01,084056,Silberman; Jack,7,0,12,5
1649883098927,ECE 180,A00,083391,Abi Samra; Nicholas Camill,26,0,30,4
1649883098927,ECE 180,B00,083392,Abi Samra; Nicholas Camill,23,0,30,7
1649883104952,MATH 10B,A01,084110,Staff,17,0,30,13
1649883104952,MATH 10B,A02,084111,Staff,29,0,30,1
1649883104952,MATH 10B,A03,084112,Staff,29,0,30,1
1649883110981,MATH 10C,A01,083443,Staff,14,0,30,16
1649883110981,MATH 10C,A02,083444,Staff,17,0,30,13
1649883110981,MATH 10C,B01,084114,Staff,26,0,30,4
1649883110981,MATH 10C,B02,084115,Staff,30,0,30,0
1649883117008,MATH 18,A01,084117,Harel; Guershon,27,0,30,3
1649883117008,MATH 18,A02,084119,Harel; Guershon,29,0,30,1
1649883117008,MATH 18,A03,084120,Harel; Guershon,30,0,30,0
1649883117008,MATH 18,A04,084121,Harel; Guershon,30,0,30,0
1649883123030,MATH 20B,A01,084124,Um; Ko Woon,32,0,35,3
1649883123030,MATH 20B,B01,084126,Um; Ko Woon,33,0,35,2
1649883129066,MATH 20C,A01,083446,Hammock; Frances H,25,0,30,5
1649883129066,MATH 20C,A02,083447,Hammock; Frances H,29,0,30,1
1649883129066,MATH 20C,A03,083448,Hammock; Frances H,30,0,30,0
1649883129066,MATH 20C,A04,083449,Hammock; Frances H,30,0,30,0
1649883129066,MATH 20C,B01,083451,Hammock; Frances H,29,0,30,1
1649883129066,MATH 20C,B02,083452,Hammock; Frances H,29,0,30,1
1649883129066,MATH 20C,B03,083453,Hammock; Frances H,30,0,30,0
1649883129066,MATH 20C,B04,083454,Hammock; Frances H,30,0,30,0
1649883135087,MATH 20D,A01,084128,Staff,29,0,30,1
1649883135087,MATH 20D,A02,084129,Staff,30,0,30,0
1649883135087,MATH 20D,A03,084130,Staff,29,0,30,1
1649883135087,MATH 20D,B01,084133,Staff,28,0,30,2
1649883135087,MATH 20D,B02,084134,Staff,29,0,30,1
1649883135087,MATH 20D,B03,084135,Staff,30,0,30,0
1649883141111,MATH 20E,A01,084138,Staff,25,0,30,5
1649883141111,MATH 20E,A02,084139,Staff,27,0,30,3
1649883141111,MATH 20E,A03,084140,Staff,25,0,30,5
1649883141111,MATH 20E,A04,084141,Staff,29,0,30,1
1649883147142,MATH 102,A01,084143,Harel; Guershon,23,0,30,7
1649883147142,MATH 102,A02,084144,Harel; Guershon,24,0,30,6
1649883153172,MATH 103B,A01,083456,Staff,0,2,30,30
1649883153172,MATH 103B,A02,083457,Staff,2,0,30,28
1649883159193,MATH 109,A01,084146,Salehi Golsefidy; Alireza,29,0,30,1
1649883159193,MATH 109,A02,084147,Salehi Golsefidy; Alireza,25,0,30,5
1649883165229,MATH 120A,A01,085445,Eggers; John Dietrich,22,0,35,13
1649883165229,MATH 120A,A02,085446,Eggers; John Dietrich,30,0,35,5
1649883171251,MATH 142B,A01,084149,Verstraete; Jacques Allan,0,2,30,30
1649883171251,MATH 142B,A02,084150,Verstraete; Jacques Allan,9,0,30,21
1649883177274,MATH 170A,A01,083459,Nie; Jiawang,0,1,30,30
1649883177274,MATH 170A,A02,083460,Nie; Jiawang,18,0,30,12
1649883177274,MATH 170A,A03,083461,Nie; Jiawang,21,0,30,9
1649883183305,MATH 193B,A01,083463,Staff,12,0,30,18
1649883183305,MATH 193B,A02,083464,Staff,18,0,30,12
1649883183305,MATH 193B,A03,083465,Staff,25,0,30,5
1649883189374,COGS 2,A01,083966,Boyle; Mary E. T.,22,0,30,8
1649883195400,COGS 9,A01,083968,Staff,48,0,60,12
1649883201426,COGS 14B,A01,083970,Staff,42,0,50,8
1649883207454,COGS 17,A01,092679,Staff,69,0,75,6
1649883213478,COGS 100,A01,083972,Staff,37,0,60,23
1649883225542,COGS 101C,A01,083976,Staff,23,0,30,7
1649883231571,COGS 102A,A01,083978,Johnson; Christine M.,21,0,30,9
1649883237597,COGS 107B,A01,083980,Staff,23,0,50,27
1649883243620,COGS 115,A01,083982,Staff,14,0,30,16
1649883249644,COGS 118B,A01,083367,Staff,0,5,40,40
1649883255668,COGS 172,A01,083984,Provenzano; Emily Kara,17,0,30,13
1649883261696,COGS 177,A00,083368,Staff,1,9,30,29
1649883267732,COGS 186,A01,083986,Staff,23,0,40,17
1649883273755,COGS 187A,A01,083988,Boyle; Mary E. T.,29,0,60,31
1649883279784,CSE 8A,A50,084003,Miranda; Gregory Joseph,7,0,15,8
1649883285807,CSE 11,A01,084005,Miranda; Gregory Joseph,43,0,55,12
1649883291835,CSE 20,A01,084007,Staff,13,0,20,7
1649883297955,CSE 21,A01,084009,Staff,25,0,50,25
1649883303984,CSE 30,A01,083370,Cao; Yingjun,6,0,40,34
1649883310008,CSE 100,A01,083372,Cao; Yingjun,0,5,40,40
1649883316043,CSE 101,A01,084011,Staff,1,35,40,39
1649883322066,CSE 141,A01,083374,Eldon; John,1,40,75,74
1649883328097,CSE 141L,A01,083376,Eldon; John,1,44,75,74
1649883334123,CSE 175,A01,084013,Kumar; Rakesh,22,0,25,3
1649883340145,CSE 190,A00,092508,Dubnov; Shlomo,15,0,15,0
1649883346171,ECE 5,A01,084049,Morris; Karcher William,17,0,20,3
1649883352197,ECE 100,A01,084051,Baghdadchi; Saharnaz,10,0,20,10
1649883352197,ECE 100,A02,091916,Baghdadchi; Saharnaz,18,0,20,2
1649883358240,ECE 101,A01,084053,Baghdadchi; Saharnaz,19,0,37,18
1649883358240,ECE 101,A02,084054,Baghdadchi; Saharnaz,37,0,37,0
1649883364270,ECE 107,A01,083390,Staff,31,0,40,9
1649883370296,ECE 148,A01,084056,Silberman; Jack,7,0,12,5
1649883376322,ECE 180,A00,083391,Abi Samra; Nicholas Camill,26,0,30,4
1649883376322,ECE 180,B00,083392,Abi Samra; Nicholas Camill,23,0,30,7
1649883382352,MATH 10B,A01,084110,Staff,17,0,30,13
1649883382352,MATH 10B,A02,084111,Staff,29,0,30,1
1649883382352,MATH 10B,A03,084112,Staff,29,0,30,1
1649883388381,MATH 10C,A01,083443,Staff,14,0,30,16
1649883388381,MATH 10C,A02,083444,Staff,17,0,30,13
1649883388381,MATH 10C,B01,084114,Staff,26,0,30,4
1649883388381,MATH 10C,B02,084115,Staff,30,0,30,0
1649883394423,MATH 18,A01,084117,Harel; Guershon,27,0,30,3
1649883394423,MATH 18,A02,084119,Harel; Guershon,29,0,30,1
1649883394423,MATH 18,A03,084120,Harel; Guershon,30,0,30,0
1649883394423,MATH 18,A04,084121,Harel; Guershon,30,0,30,0
1649883400447,MATH 20B,A01,084124,Um; Ko Woon,32,0,35,3
1649883400447,MATH 20B,B01,084126,Um; Ko Woon,33,0,35,2
1649883406477,MATH 20C,A01,083446,Hammock; Frances H,24,0,30,6
1649883406477,MATH 20C,A02,083447,Hammock; Frances H,29,0,30,1
1649883406477,MATH 20C,A03,083448,Hammock; Frances H,30,0,30,0
1649883406477,MATH 20C,A04,083449,Hammock; Frances H,30,0,30,0
1649883406477,MATH 20C,B01,083451,Hammock; Frances H,29,0,30,1
1649883406477,MATH 20C,B02,083452,Hammock; Frances H,29,0,30,1
1649883406477,MATH 20C,B03,083453,Hammock; Frances H,30,0,30,0
1649883406477,MATH 20C,B04,083454,Hammock; Frances H,30,0,30,0
1649883412506,MATH 20D,A01,084128,Staff,29,0,30,1
1649883412506,MATH 20D,A02,084129,Staff,30,0,30,0
1649883412506,MATH 20D,A03,084130,Staff,29,0,30,1
1649883412506,MATH 20D,B01,084133,Staff,28,0,30,2
1649883412506,MATH 20D,B02,084134,Staff,29,0,30,1
1649883412506,MATH 20D,B03,084135,Staff,30,0,30,0
1649883418538,MATH 20E,A01,084138,Staff,25,0,30,5
1649883418538,MATH 20E,A02,084139,Staff,27,0,30,3
1649883418538,MATH 20E,A03,084140,Staff,25,0,30,5
1649883418538,MATH 20E,A04,084141,Staff,29,0,30,1
1649883424563,MATH 102,A01,084143,Harel; Guershon,23,0,30,7
1649883424563,MATH 102,A02,084144,Harel; Guershon,24,0,30,6
1649883430590,MATH 103B,A01,083456,Staff,0,2,30,30
1649883430590,MATH 103B,A02,083457,Staff,2,0,30,28
1649883436631,MATH 109,A01,084146,Salehi Golsefidy; Alireza,29,0,30,1
1649883436631,MATH 109,A02,084147,Salehi Golsefidy; Alireza,25,0,30,5
1649883442659,MATH 120A,A01,085445,Eggers; John Dietrich,22,0,35,13
1649883442659,MATH 120A,A02,085446,Eggers; John Dietrich,30,0,35,5
1649883448685,MATH 142B,A01,084149,Verstraete; Jacques Allan,0,2,30,30
1649883448685,MATH 142B,A02,084150,Verstraete; Jacques Allan,9,0,30,21
1649883454710,MATH 170A,A01,083459,Nie; Jiawang,0,1,30,30
1649883454710,MATH 170A,A02,083460,Nie; Jiawang,17,0,30,13
1649883454710,MATH 170A,A03,083461,Nie; Jiawang,21,0,30,9
1649883460737,MATH 193B,A01,083463,Staff,12,0,30,18
1649883460737,MATH 193B,A02,083464,Staff,18,0,30,12
1649883460737,MATH 193B,A03,083465,Staff,25,0,30,5
1649883466797,COGS 2,A01,083966,Boyle; Mary E. T.,22,0,30,8
1649883472834,COGS 9,A01,083968,Staff,48,0,60,12
1649883478859,COGS 14B,A01,083970,Staff,42,0,50,8
1649883484885,COGS 17,A01,092679,Staff,69,0,75,6
1649883490915,COGS 100,A01,083972,Staff,37,0,60,23
1649883502978,COGS 101C,A01,083976,Staff,23,0,30,7
1649883509006,COGS 102A,A01,083978,Johnson; Christine M.,21,0,30,9
1649883515039,COGS 107B,A01,083980,Staff,23,0,50,27
1649883521070,COGS 115,A01,083982,Staff,14,0,30,16
1649883527099,COGS 118B,A01,083367,Staff,0,5,40,40
1649883533133,COGS 172,A01,083984,Provenzano; Emily Kara,17,0,30,13
1649883539156,COGS 177,A00,083368,Staff,1,9,30,29
1649883545183,COGS 186,A01,083986,Staff,23,0,40,17
1649883551206,COGS 187A,A01,083988,Boyle; Mary E. T.,29,0,60,31
1649883557240,CSE 8A,A50,084003,Miranda; Gregory Joseph,7,0,15,8
1649883563277,CSE 11,A01,084005,Miranda; Gregory Joseph,43,0,55,12
1649883569303,CSE 20,A01,084007,Staff,13,0,20,7
1649883575336,CSE 21,A01,084009,Staff,24,0,50,26
1649883581358,CSE 30,A01,083370,Cao; Yingjun,5,0,40,35
1649883587384,CSE 100,A01,083372,Cao; Yingjun,0,5,40,40
1649883593409,CSE 101,A01,084011,Staff,1,34,40,39
1649883599438,CSE 141,A01,083374,Eldon; John,1,40,75,74
1649883605461,CSE 141L,A01,083376,Eldon; John,1,44,75,74
1649883611489,CSE 175,A01,084013,Kumar; Rakesh,22,0,25,3
1649883617521,CSE 190,A00,092508,Dubnov; Shlomo,15,0,15,0
1649883623544,ECE 5,A01,084049,Morris; Karcher William,17,0,20,3
1649883629571,ECE 100,A01,084051,Baghdadchi; Saharnaz,9,0,20,11
1649883629571,ECE 100,A02,091916,Baghdadchi; Saharnaz,18,0,20,2
1649883635595,ECE 101,A01,084053,Baghdadchi; Saharnaz,18,0,37,19
1649883635595,ECE 101,A02,084054,Baghdadchi; Saharnaz,37,0,37,0
1649883641629,ECE 107,A01,083390,Staff,30,0,40,10
1649883647652,ECE 148,A01,084056,Silberman; Jack,7,0,12,5
1649883653691,ECE 180,A00,083391,Abi Samra; Nicholas Camill,26,0,30,4
1649883653691,ECE 180,B00,083392,Abi Samra; Nicholas Camill,23,0,30,7
1649883659714,MATH 10B,A01,084110,Staff,17,0,30,13
1649883659714,MATH 10B,A02,084111,Staff,29,0,30,1
1649883659714,MATH 10B,A03,084112,Staff,29,0,30,1
1649883665750,MATH 10C,A01,083443,Staff,14,0,30,16
1649883665750,MATH 10C,A02,083444,Staff,17,0,30,13
1649883665750,MATH 10C,B01,084114,Staff,26,0,30,4
1649883665750,MATH 10C,B02,084115,Staff,30,0,30,0
1649883671778,MATH 18,A01,084117,Harel; Guershon,27,0,30,3
1649883671778,MATH 18,A02,084119,Harel; Guershon,29,0,30,1
1649883671778,MATH 18,A03,084120,Harel; Guershon,30,0,30,0
1649883671778,MATH 18,A04,084121,Harel; Guershon,30,0,30,0
1649883677805,MATH 20B,A01,084124,Um; Ko Woon,32,0,35,3
1649883677805,MATH 20B,B01,084126,Um; Ko Woon,33,0,35,2
1649883683836,MATH 20C,A01,083446,Hammock; Frances H,24,0,30,6
1649883683836,MATH 20C,A02,083447,Hammock; Frances H,29,0,30,1
1649883683836,MATH 20C,A03,083448,Hammock; Frances H,30,0,30,0
1649883683836,MATH 20C,A04,083449,Hammock; Frances H,30,0,30,0
1649883683836,MATH 20C,B01,083451,Hammock; Frances H,29,0,30,1
1649883683836,MATH 20C,B02,083452,Hammock; Frances H,29,0,30,1
1649883683836,MATH 20C,B03,083453,Hammock; Frances H,30,0,30,0
1649883683836,MATH 20C,B04,083454,Hammock; Frances H,30,0,30,0
1649883689861,MATH 20D,A01,084128,Staff,29,0,30,1
1649883689861,MATH 20D,A02,084129,Staff,30,0,30,0
1649883689861,MATH 20D,A03,084130,Staff,29,0,30,1
1649883689861,MATH 20D,B01,084133,Staff,28,0,30,2
1649883689861,MATH 20D,B02,084134,Staff,29,0,30,1
1649883689861,MATH 20D,B03,084135,Staff,30,0,30,0
1649883695887,MATH 20E,A01,084138,Staff,25,0,30,5
1649883695887,MATH 20E,A02,084139,Staff,27,0,30,3
1649883695887,MATH 20E,A03,084140,Staff,25,0,30,5
1649883695887,MATH 20E,A04,084141,Staff,29,0,30,1
1649883701939,MATH 102,A01,084143,Harel; Guershon,23,0,30,7
1649883701939,MATH 102,A02,084144,Harel; Guershon,24,0,30,6
1649883707965,MATH 103B,A01,083456,Staff,0,2,30,30
1649883707965,MATH 103B,A02,083457,Staff,2,0,30,28
1649883714001,MATH 109,A01,084146,Salehi Golsefidy; Alireza,29,0,30,1
1649883714001,MATH 109,A02,084147,Salehi Golsefidy; Alireza,25,0,30,5
1649883720025,MATH 120A,A01,085445,Eggers; John Dietrich,22,0,35,13
1649883720025,MATH 120A,A02,085446,Eggers; John Dietrich,30,0,35,5
1649883726049,MATH 142B,A01,084149,Verstraete; Jacques Allan,0,2,30,30
1649883726049,MATH 142B,A02,084150,Verstraete; Jacques Allan,8,0,30,22
1649883732079,MATH 170A,A01,083459,Nie; Jiawang,0,1,30,30
1649883732079,MATH 170A,A02,083460,Nie; Jiawang,17,0,30,13
1649883732079,MATH 170A,A03,083461,Nie; Jiawang,21,0,30,9
1649883738101,MATH 193B,A01,083463,Staff,11,0,30,19
1649883738101,MATH 193B,A02,083464,Staff,18,0,30,12
1649883738101,MATH 193B,A03,083465,Staff,25,0,30,5
1649883744182,COGS 2,A01,083966,Boyle; Mary E. T.,22,0,30,8
1649883750208,COGS 9,A01,083968,Staff,48,0,60,12
1649883756239,COGS 14B,A01,083970,Staff,42,0,50,8
1649883762276,COGS 17,A01,092679,Staff,69,0,75,6
1649883768307,COGS 100,A01,083972,Staff,37,0,60,23
1649883780359,COGS 101C,A01,083976,Staff,23,0,30,7
1649883786381,COGS 102A,A01,083978,Johnson; Christine M.,21,0,30,9
1649883792405,COGS 107B,A01,083980,Staff,22,0,50,28
1649883798434,COGS 115,A01,083982,Staff,14,0,30,16
1649883804461,COGS 118B,A01,083367,Staff,0,5,40,40
1649883810491,COGS 172,A01,083984,Provenzano; Emily Kara,17,0,30,13
1649883816531,COGS 177,A00,083368,Staff,1,9,30,29
1649883822557,COGS 186,A01,083986,Staff,23,0,40,17
1649883828588,COGS 187A,A01,083988,Boyle; Mary E. T.,29,0,60,31
1649883834619,CSE 8A,A50,084003,Miranda; Gregory Joseph,7,0,15,8
1649883840649,CSE 11,A01,084005,Miranda; Gregory Joseph,43,0,55,12
1649883846676,CSE 20,A01,084007,Staff,13,0,20,7
1649883852701,CSE 21,A01,084009,Staff,23,0,50,27
1649883858728,CSE 30,A01,083370,Cao; Yingjun,3,0,40,37
1649883864754,CSE 100,A01,083372,Cao; Yingjun,0,5,40,40
1649883870779,CSE 101,A01,084011,Staff,1,34,40,39
1649883876810,CSE 141,A01,083374,Eldon; John,1,40,75,74
1649883882841,CSE 141L,A01,083376,Eldon; John,1,44,75,74
1649883888876,CSE 175,A01,084013,Kumar; Rakesh,22,0,25,3
1649883895023,CSE 190,A00,092508,Dubnov; Shlomo,15,0,15,0
1649883901046,ECE 5,A01,084049,Morris; Karcher William,17,0,20,3
1649883907075,ECE 100,A01,084051,Baghdadchi; Saharnaz,8,0,20,12
1649883907075,ECE 100,A02,091916,Baghdadchi; Saharnaz,18,0,20,2
1649883913114,ECE 101,A01,084053,Baghdadchi; Saharnaz,18,0,37,19
1649883913114,ECE 101,A02,084054,Baghdadchi; Saharnaz,37,0,37,0
1649883919144,ECE 107,A01,083390,Staff,30,0,40,10
1649883925171,ECE 148,A01,084056,Silberman; Jack,7,0,12,5
1649883931197,ECE 180,A00,083391,Abi Samra; Nicholas Camill,26,0,30,4
1649883931197,ECE 180,B00,083392,Abi Samra; Nicholas Camill,23,0,30,7
1649883937219,MATH 10B,A01,084110,Staff,17,0,30,13
1649883937219,MATH 10B,A02,084111,Staff,29,0,30,1
1649883937219,MATH 10B,A03,084112,Staff,29,0,30,1
1649883943244,MATH 10C,A01,083443,Staff,14,0,30,16
1649883943244,MATH 10C,A02,083444,Staff,17,0,30,13
1649883943244,MATH 10C,B01,084114,Staff,26,0,30,4
1649883943244,MATH 10C,B02,084115,Staff,30,0,30,0
1649883949273,MATH 18,A01,084117,Harel; Guershon,27,0,30,3
1649883949273,MATH 18,A02,084119,Harel; Guershon,29,0,30,1
1649883949273,MATH 18,A03,084120,Harel; Guershon,30,0,30,0
1649883949273,MATH 18,A04,084121,Harel; Guershon,30,0,30,0
1649883955307,MATH 20B,A01,084124,Um; Ko Woon,32,0,35,3
1649883955307,MATH 20B,B01,084126,Um; Ko Woon,33,0,35,2
1649883961337,MATH 20C,A01,083446,Hammock; Frances H,24,0,30,6
1649883961337,MATH 20C,A02,083447,Hammock; Frances H,29,0,30,1
1649883961337,MATH 20C,A03,083448,Hammock; Frances H,30,0,30,0
1649883961337,MATH 20C,A04,083449,Hammock; Frances H,30,0,30,0
1649883961337,MATH 20C,B01,083451,Hammock; Frances H,29,0,30,1
1649883961337,MATH 20C,B02,083452,Hammock; Frances H,29,0,30,1
1649883961337,MATH 20C,B03,083453,Hammock; Frances H,30,0,30,0
1649883961337,MATH 20C,B04,083454,Hammock; Frances H,30,0,30,0
1649883967369,MATH 20D,A01,084128,Staff,29,0,30,1
1649883967369,MATH 20D,A02,084129,Staff,30,0,30,0
1649883967369,MATH 20D,A03,084130,Staff,29,0,30,1
1649883967369,MATH 20D,B01,084133,Staff,28,0,30,2
1649883967369,MATH 20D,B02,084134,Staff,29,0,30,1
1649883967369,MATH 20D,B03,084135,Staff,30,0,30,0
1649883973397,MATH 20E,A01,084138,Staff,25,0,30,5
1649883973397,MATH 20E,A02,084139,Staff,27,0,30,3
1649883973397,MATH 20E,A03,084140,Staff,25,0,30,5
1649883973397,MATH 20E,A04,084141,Staff,29,0,30,1
1649883979421,MATH 102,A01,084143,Harel; Guershon,22,0,30,8
1649883979421,MATH 102,A02,084144,Harel; Guershon,24,0,30,6
1649883985446,MATH 103B,A01,083456,Staff,0,2,30,30
1649883985446,MATH 103B,A02,083457,Staff,1,0,30,29
1649883991471,MATH 109,A01,084146,Salehi Golsefidy; Alireza,29,0,30,1
1649883991471,MATH 109,A02,084147,Salehi Golsefidy; Alireza,25,0,30,5
1649883997495,MATH 120A,A01,085445,Eggers; John Dietrich,22,0,35,13
1649883997495,MATH 120A,A02,085446,Eggers; John Dietrich,30,0,35,5
1649884003522,MATH 142B,A01,084149,Verstraete; Jacques Allan,0,2,30,30
1649884003522,MATH 142B,A02,084150,Verstraete; Jacques Allan,6,0,30,24
1649884009560,MATH 170A,A01,083459,Nie; Jiawang,0,1,30,30
1649884009560,MATH 170A,A02,083460,Nie; Jiawang,18,0,30,12
1649884009560,MATH 170A,A03,083461,Nie; Jiawang,21,0,30,9
1649884015584,MATH 193B,A01,083463,Staff,11,0,30,19
1649884015584,MATH 193B,A02,083464,Staff,18,0,30,12
1649884015584,MATH 193B,A03,083465,Staff,25,0,30,5
1649884021645,COGS 2,A01,083966,Boyle; Mary E. T.,22,0,30,8
1649884027671,COGS 9,A01,083968,Staff,48,0,60,12
1649884033702,COGS 14B,A01,083970,Staff,42,0,50,8
1649884039734,COGS 17,A01,092679,Staff,68,0,75,7
1649884045761,COGS 100,A01,083972,Staff,37,0,60,23
1649884057823,COGS 101C,A01,083976,Staff,23,0,30,7
1649884063850,COGS 102A,A01,083978,Johnson; Christine M.,21,0,30,9
1649884069871,COGS 107B,A01,083980,Staff,22,0,50,28
1649884075894,COGS 115,A01,083982,Staff,14,0,30,16
1649884081920,COGS 118B,A01,083367,Staff,0,5,40,40
1649884087954,COGS 172,A01,083984,Provenzano; Emily Kara,17,0,30,13
1649884093976,COGS 177,A00,083368,Staff,1,9,30,29
1649884100002,COGS 186,A01,083986,Staff,23,0,40,17
1649884106026,COGS 187A,A01,083988,Boyle; Mary E. T.,29,0,60,31
1649884112050,CSE 8A,A50,084003,Miranda; Gregory Joseph,7,0,15,8
1649884118074,CSE 11,A01,084005,Miranda; Gregory Joseph,43,0,55,12
1649884124098,CSE 20,A01,084007,Staff,13,0,20,7
1649884130130,CSE 21,A01,084009,Staff,23,0,50,27
1649884136154,CSE 30,A01,083370,Cao; Yingjun,3,0,40,37
1649884142185,CSE 100,A01,083372,Cao; Yingjun,0,5,40,40
1649884148226,CSE 101,A01,084011,Staff,1,34,40,39
1649884154256,CSE 141,A01,083374,Eldon; John,1,40,75,74
1649884160285,CSE 141L,A01,083376,Eldon; John,1,44,75,74
1649884166312,CSE 175,A01,084013,Kumar; Rakesh,22,0,25,3
1649884172352,CSE 190,A00,092508,Dubnov; Shlomo,15,0,15,0
1649884178383,ECE 5,A01,084049,Morris; Karcher William,17,0,20,3
1649884184406,ECE 100,A01,084051,Baghdadchi; Saharnaz,8,0,20,12
1649884184406,ECE 100,A02,091916,Baghdadchi; Saharnaz,18,0,20,2
1649884190430,ECE 101,A01,084053,Baghdadchi; Saharnaz,18,0,37,19
1649884190430,ECE 101,A02,084054,Baghdadchi; Saharnaz,37,0,37,0
1649884196455,ECE 107,A01,083390,Staff,30,0,40,10
1649884202485,ECE 148,A01,084056,Silberman; Jack,7,0,12,5
1649884208507,ECE 180,A00,083391,Abi Samra; Nicholas Camill,26,0,30,4
1649884208507,ECE 180,B00,083392,Abi Samra; Nicholas Camill,23,0,30,7
1649884214529,MATH 10B,A01,084110,Staff,17,0,30,13
1649884214529,MATH 10B,A02,084111,Staff,29,0,30,1
1649884214529,MATH 10B,A03,084112,Staff,29,0,30,1
1649884220563,MATH 10C,A01,083443,Staff,14,0,30,16
1649884220563,MATH 10C,A02,083444,Staff,17,0,30,13
1649884220563,MATH 10C,B01,084114,Staff,26,0,30,4
1649884220563,MATH 10C,B02,084115,Staff,30,0,30,0
1649884226587,MATH 18,A01,084117,Harel; Guershon,27,0,30,3
1649884226587,MATH 18,A02,084119,Harel; Guershon,29,0,30,1
1649884226587,MATH 18,A03,084120,Harel; Guershon,30,0,30,0
1649884226587,MATH 18,A04,084121,Harel; Guershon,30,0,30,0
1649884232614,MATH 20B,A01,084124,Um; Ko Woon,32,0,35,3
1649884232614,MATH 20B,B01,084126,Um; Ko Woon,33,0,35,2
1649884238661,MATH 20C,A01,083446,Hammock; Frances H,24,0,30,6
1649884238661,MATH 20C,A02,083447,Hammock; Frances H,29,0,30,1
1649884238661,MATH 20C,A03,083448,Hammock; Frances H,30,0,30,0
1649884238661,MATH 20C,A04,083449,Hammock; Frances H,30,0,30,0
1649884238661,MATH 20C,B01,083451,Hammock; Frances H,29,0,30,1
1649884238661,MATH 20C,B02,083452,Hammock; Frances H,29,0,30,1
1649884238661,MATH 20C,B03,083453,Hammock; Frances H,30,0,30,0
1649884238661,MATH 20C,B04,083454,Hammock; Frances H,30,0,30,0
1649884244694,MATH 20D,A01,084128,Staff,29,0,30,1
1649884244694,MATH 20D,A02,084129,Staff,30,0,30,0
1649884244694,MATH 20D,A03,084130,Staff,29,0,30,1
1649884244694,MATH 20D,B01,084133,Staff,28,0,30,2
1649884244694,MATH 20D,B02,084134,Staff,29,0,30,1
1649884244694,MATH 20D,B03,084135,Staff,30,0,30,0
1649884250718,MATH 20E,A01,084138,Staff,25,0,30,5
1649884250718,MATH 20E,A02,084139,Staff,26,0,30,4
1649884250718,MATH 20E,A03,084140,Staff,25,0,30,5
1649884250718,MATH 20E,A04,084141,Staff,29,0,30,1
1649884256748,MATH 102,A01,084143,Harel; Guershon,22,0,30,8
1649884256748,MATH 102,A02,084144,Harel; Guershon,24,0,30,6
1649884262773,MATH 103B,A01,083456,Staff,0,2,30,30
1649884262773,MATH 103B,A02,083457,Staff,1,0,30,29
1649884268795,MATH 109,A01,084146,Salehi Golsefidy; Alireza,29,0,30,1
1649884268795,MATH 109,A02,084147,Salehi Golsefidy; Alireza,25,0,30,5
1649884274828,MATH 120A,A01,085445,Eggers; John Dietrich,22,0,35,13
1649884274828,MATH 120A,A02,085446,Eggers; John Dietrich,30,0,35,5
1649884280857,MATH 142B,A01,084149,Verstraete; Jacques Allan,0,2,30,30
1649884280857,MATH 142B,A02,084150,Verstraete; Jacques Allan,6,0,30,24
1649884286888,MATH 170A,A01,083459,Nie; Jiawang,0,1,30,30
1649884286888,MATH 170A,A02,083460,Nie; Jiawang,18,0,30,12
1649884286888,MATH 170A,A03,083461,Nie; Jiawang,21,0,30,9
1649884292915,MATH 193B,A01,083463,Staff,10,0,30,20
1649884292915,MATH 193B,A02,083464,Staff,18,0,30,12
1649884292915,MATH 193B,A03,083465,Staff,25,0,30,5
1649884298980,COGS 2,A01,083966,Boyle; Mary E. T.,22,0,30,8
1649884305015,COGS 9,A01,083968,Staff,48,0,60,12
1649884311042,COGS 14B,A01,083970,Staff,41,0,50,9
1649884317074,COGS 17,A01,092679,Staff,68,0,75,7
1649884323096,COGS 100,A01,083972,Staff,37,0,60,23
1649884335143,COGS 101C,A01,083976,Staff,23,0,30,7
1649884341176,COGS 102A,A01,083978,Johnson; Christine M.,21,0,30,9
1649884347210,COGS 107B,A01,083980,Staff,22,0,50,28
1649884353239,COGS 115,A01,083982,Staff,14,0,30,16
1649884359264,COGS 118B,A01,083367,Staff,0,5,40,40
1649884365293,COGS 172,A01,083984,Provenzano; Emily Kara,17,0,30,13
1649884371321,COGS 177,A00,083368,Staff,1,9,30,29
1649884377347,COGS 186,A01,083986,Staff,23,0,40,17
1649884383377,COGS 187A,A01,083988,Boyle; Mary E. T.,29,0,60,31
1649884389399,CSE 8A,A50,084003,Miranda; Gregory Joseph,7,0,15,8
1649884395423,CSE 11,A01,084005,Miranda; Gregory Joseph,43,0,55,12
1649884401446,CSE 20,A01,084007,Staff,13,0,20,7
1649884407480,CSE 21,A01,084009,Staff,22,0,50,28
1649884413503,CSE 30,A01,083370,Cao; Yingjun,3,0,40,37
1649884419529,CSE 100,A01,083372,Cao; Yingjun,0,5,40,40
1649884425555,CSE 101,A01,084011,Staff,1,34,40,39
1649884431579,CSE 141,A01,083374,Eldon; John,1,40,75,74
1649884437606,CSE 141L,A01,083376,Eldon; John,1,44,75,74
1649884443629,CSE 175,A01,084013,Kumar; Rakesh,22,0,25,3
1649884449655,CSE 190,A00,092508,Dubnov; Shlomo,15,0,15,0
1649884455677,ECE 5,A01,084049,Morris; Karcher William,17,0,20,3
1649884461702,ECE 100,A01,084051,Baghdadchi; Saharnaz,7,0,20,13
1649884461702,ECE 100,A02,091916,Baghdadchi; Saharnaz,18,0,20,2
1649884467725,ECE 101,A01,084053,Baghdadchi; Saharnaz,17,0,37,20
1649884467725,ECE 101,A02,084054,Baghdadchi; Saharnaz,37,0,37,0
1649884473748,ECE 107,A01,083390,Staff,30,0,40,10
1649884479772,ECE 148,A01,084056,Silberman; Jack,7,0,12,5
1649884485804,ECE 180,A00,083391,Abi Samra; Nicholas Camill,25,0,30,5
1649884485804,ECE 180,B00,083392,Abi Samra; Nicholas Camill,23,0,30,7
1649884491920,MATH 10B,A01,084110,Staff,17,0,30,13
1649884491920,MATH 10B,A02,084111,Staff,29,0,30,1
1649884491920,MATH 10B,A03,084112,Staff,29,0,30,1
1649884497947,MATH 10C,A01,083443,Staff,14,0,30,16
1649884497947,MATH 10C,A02,083444,Staff,17,0,30,13
1649884497947,MATH 10C,B01,084114,Staff,26,0,30,4
1649884497947,MATH 10C,B02,084115,Staff,30,0,30,0
1649884503984,MATH 18,A01,084117,Harel; Guershon,27,0,30,3
1649884503984,MATH 18,A02,084119,Harel; Guershon,29,0,30,1
1649884503984,MATH 18,A03,084120,Harel; Guershon,30,0,30,0
1649884503984,MATH 18,A04,084121,Harel; Guershon,30,0,30,0
1649884510012,MATH 20B,A01,084124,Um; Ko Woon,32,0,35,3
1649884510012,MATH 20B,B01,084126,Um; Ko Woon,33,0,35,2
1649884516042,MATH 20C,A01,083446,Hammock; Frances H,23,0,30,7
1649884516042,MATH 20C,A02,083447,Hammock; Frances H,29,0,30,1
1649884516042,MATH 20C,A03,083448,Hammock; Frances H,30,0,30,0
1649884516042,MATH 20C,A04,083449,Hammock; Frances H,30,0,30,0
1649884516042,MATH 20C,B01,083451,Hammock; Frances H,29,0,30,1
1649884516042,MATH 20C,B02,083452,Hammock; Frances H,29,0,30,1
1649884516042,MATH 20C,B03,083453,Hammock; Frances H,30,0,30,0
1649884516042,MATH 20C,B04,083454,Hammock; Frances H,30,0,30,0
1649884522068,MATH 20D,A01,084128,Staff,29,0,30,1
1649884522068,MATH 20D,A02,084129,Staff,30,0,30,0
1649884522068,MATH 20D,A03,084130,Staff,29,0,30,1
1649884522068,MATH 20D,B01,084133,Staff,28,0,30,2
1649884522068,MATH 20D,B02,084134,Staff,29,0,30,1
1649884522068,MATH 20D,B03,084135,Staff,30,0,30,0
1649884528097,MATH 20E,A01,084138,Staff,25,0,30,5
1649884528097,MATH 20E,A02,084139,Staff,26,0,30,4
1649884528097,MATH 20E,A03,084140,Staff,25,0,30,5
1649884528097,MATH 20E,A04,084141,Staff,29,0,30,1
1649884534121,MATH 102,A01,084143,Harel; Guershon,22,0,30,8
1649884534121,MATH 102,A02,084144,Harel; Guershon,24,0,30,6
1649884540142,MATH 103B,A01,083456,Staff,0,2,30,30
1649884540142,MATH 103B,A02,083457,Staff,1,0,30,29
1649884546165,MATH 109,A01,084146,Salehi Golsefidy; Alireza,29,0,30,1
1649884546165,MATH 109,A02,084147,Salehi Golsefidy; Alireza,25,0,30,5
1649884552189,MATH 120A,A01,085445,Eggers; John Dietrich,22,0,35,13
1649884552189,MATH 120A,A02,085446,Eggers; John Dietrich,30,0,35,5
1649884558220,MATH 142B,A01,084149,Verstraete; Jacques Allan,0,2,30,30
1649884558220,MATH 142B,A02,084150,Verstraete; Jacques Allan,6,0,30,24
1649884564246,MATH 170A,A01,083459,Nie; Jiawang,0,1,30,30
1649884564246,MATH 170A,A02,083460,Nie; Jiawang,18,0,30,12
1649884564246,MATH 170A,A03,083461,Nie; Jiawang,21,0,30,9
1649884570273,MATH 193B,A01,083463,Staff,10,0,30,20
1649884570273,MATH 193B,A02,083464,Staff,17,0,30,13
1649884570273,MATH 193B,A03,083465,Staff,25,0,30,5
1649884576328,COGS 2,A01,083966,Boyle; Mary E. T.,22,0,30,8
1649884582360,COGS 9,A01,083968,Staff,48,0,60,12
1649884588385,COGS 14B,A01,083970,Staff,42,0,50,8
1649884594411,COGS 17,A01,092679,Staff,68,0,75,7
1649884600434,COGS 100,A01,083972,Staff,36,0,60,24
1649884612487,COGS 101C,A01,083976,Staff,23,0,30,7
1649884618513,COGS 102A,A01,083978,Johnson; Christine M.,21,0,30,9
1649884624536,COGS 107B,A01,083980,Staff,21,0,50,29
1649884630569,COGS 115,A01,083982,Staff,14,0,30,16
1649884636602,COGS 118B,A01,083367,Staff,0,5,40,40
1649884642629,COGS 172,A01,083984,Provenzano; Emily Kara,17,0,30,13
1649884648652,COGS 177,A00,083368,Staff,1,10,30,29
1649884654682,COGS 186,A01,083986,Staff,23,0,40,17
1649884660709,COGS 187A,A01,083988,Boyle; Mary E. T.,28,0,60,32
1649884666732,CSE 8A,A50,084003,Miranda; Gregory Joseph,7,0,15,8
1649884672757,CSE 11,A01,084005,Miranda; Gregory Joseph,42,0,55,13
1649884678787,CSE 20,A01,084007,Staff,13,0,20,7
1649884684814,CSE 21,A01,084009,Staff,22,0,50,28
1649884690840,CSE 30,A01,083370,Cao; Yingjun,2,0,40,38
1649884696885,CSE 100,A01,083372,Cao; Yingjun,0,5,40,40
1649884702908,CSE 101,A01,084011,Staff,1,34,40,39
1649884708931,CSE 141,A01,083374,Eldon; John,1,40,75,74
1649884714956,CSE 141L,A01,083376,Eldon; John,1,44,75,74
1649884720977,CSE 175,A01,084013,Kumar; Rakesh,22,0,25,3
1649884727008,CSE 190,A00,092508,Dubnov; Shlomo,15,0,15,0
1649884733031,ECE 5,A01,084049,Morris; Karcher William,17,0,20,3
1649884739057,ECE 100,A01,084051,Baghdadchi; Saharnaz,7,0,20,13
1649884739057,ECE 100,A02,091916,Baghdadchi; Saharnaz,18,0,20,2
1649884745078,ECE 101,A01,084053,Baghdadchi; Saharnaz,17,0,37,20
1649884745078,ECE 101,A02,084054,Baghdadchi; Saharnaz,37,0,37,0
1649884751102,ECE 107,A01,083390,Staff,30,0,40,10
1649884757127,ECE 148,A01,084056,Silberman; Jack,7,0,12,5
1649884763149,ECE 180,A00,083391,Abi Samra; Nicholas Camill,25,0,30,5
1649884763149,ECE 180,B00,083392,Abi Samra; Nicholas Camill,23,0,30,7
1649884769177,MATH 10B,A01,084110,Staff,17,0,30,13
1649884769177,MATH 10B,A02,084111,Staff,29,0,30,1
1649884769177,MATH 10B,A03,084112,Staff,29,0,30,1
1649884775242,MATH 10C,A01,083443,Staff,14,0,30,16
1649884775242,MATH 10C,A02,083444,Staff,17,0,30,13
1649884775242,MATH 10C,B01,084114,Staff,26,0,30,4
1649884775242,MATH 10C,B02,084115,Staff,30,0,30,0
1649884781269,MATH 18,A01,084117,Harel; Guershon,27,0,30,3
1649884781269,MATH 18,A02,084119,Harel; Guershon,29,0,30,1
1649884781269,MATH 18,A03,084120,Harel; Guershon,30,0,30,0
1649884781269,MATH 18,A04,084121,Harel; Guershon,30,0,30,0
1649884787295,MATH 20B,A01,084124,Um; Ko Woon,32,0,35,3
1649884787295,MATH 20B,B01,084126,Um; Ko Woon,33,0,35,2
1649884793319,MATH 20C,A01,083446,Hammock; Frances H,23,0,30,7
1649884793319,MATH 20C,A02,083447,Hammock; Frances H,29,0,30,1
1649884793319,MATH 20C,A03,083448,Hammock; Frances H,30,0,30,0
1649884793319,MATH 20C,A04,083449,Hammock; Frances H,30,0,30,0
1649884793319,MATH 20C,B01,083451,Hammock; Frances H,29,0,30,1
1649884793319,MATH 20C,B02,083452,Hammock; Frances H,29,0,30,1
1649884793319,MATH 20C,B03,083453,Hammock; Frances H,30,0,30,0
1649884793319,MATH 20C,B04,083454,Hammock; Frances H,30,0,30,0
1649884799343,MATH 20D,A01,084128,Staff,29,0,30,1
1649884799343,MATH 20D,A02,084129,Staff,30,0,30,0
1649884799343,MATH 20D,A03,084130,Staff,29,0,30,1
1649884799343,MATH 20D,B01,084133,Staff,28,0,30,2
1649884799343,MATH 20D,B02,084134,Staff,29,0,30,1
1649884799343,MATH 20D,B03,084135,Staff,30,0,30,0
1649884805368,MATH 20E,A01,084138,Staff,25,0,30,5
1649884805368,MATH 20E,A02,084139,Staff,26,0,30,4
1649884805368,MATH 20E,A03,084140,Staff,25,0,30,5
1649884805368,MATH 20E,A04,084141,Staff,29,0,30,1
1649884811395,MATH 102,A01,084143,Harel; Guershon,22,0,30,8
1649884811395,MATH 102,A02,084144,Harel; Guershon,24,0,30,6
1649884817418,MATH 103B,A01,083456,Staff,0,2,30,30
1649884817418,MATH 103B,A02,083457,Staff,1,0,30,29
1649884823450,MATH 109,A01,084146,Salehi Golsefidy; Alireza,29,0,30,1
1649884823450,MATH 109,A02,084147,Salehi Golsefidy; Alireza,25,0,30,5
1649884829474,MATH 120A,A01,085445,Eggers; John Dietrich,22,0,35,13
1649884829474,MATH 120A,A02,085446,Eggers; John Dietrich,30,0,35,5
1649884835504,MATH 142B,A01,084149,Verstraete; Jacques Allan,0,2,30,30
1649884835504,MATH 142B,A02,084150,Verstraete; Jacques Allan,6,0,30,24
1649884841549,MATH 170A,A01,083459,Nie; Jiawang,0,1,30,30
1649884841549,MATH 170A,A02,083460,Nie; Jiawang,18,0,30,12
1649884841549,MATH 170A,A03,083461,Nie; Jiawang,20,0,30,10
1649884847575,MATH 193B,A01,083463,Staff,10,0,30,20
1649884847575,MATH 193B,A02,083464,Staff,17,0,30,13
1649884847575,MATH 193B,A03,083465,Staff,25,0,30,5
1649884853630,COGS 2,A01,083966,Boyle; Mary E. T.,22,0,30,8
1649884859654,COGS 9,A01,083968,Staff,48,0,60,12
1649884865678,COGS 14B,A01,083970,Staff,41,0,50,9
1649884871702,COGS 17,A01,092679,Staff,67,0,75,8
1649884877743,COGS 100,A01,083972,Staff,35,0,60,25
1649884889805,COGS 101C,A01,083976,Staff,23,0,30,7
1649884895829,COGS 102A,A01,083978,Johnson; Christine M.,21,0,30,9
1649884901862,COGS 107B,A01,083980,Staff,21,0,50,29
1649884907885,COGS 115,A01,083982,Staff,13,0,30,17
1649884913911,COGS 118B,A01,083367,Staff,0,5,40,40
1649884919937,COGS 172,A01,083984,Provenzano; Emily Kara,17,0,30,13
1649884925972,COGS 177,A00,083368,Staff,1,10,30,29
1649884931996,COGS 186,A01,083986,Staff,23,0,40,17
1649884938022,COGS 187A,A01,083988,Boyle; Mary E. T.,28,0,60,32
1649884944050,CSE 8A,A50,084003,Miranda; Gregory Joseph,7,0,15,8
1649884950075,CSE 11,A01,084005,Miranda; Gregory Joseph,42,0,55,13
1649884956103,CSE 20,A01,084007,Staff,13,0,20,7
1649884962137,CSE 21,A01,084009,Staff,22,0,50,28
1649884968178,CSE 30,A01,083370,Cao; Yingjun,2,0,40,38
1649884974212,CSE 100,A01,083372,Cao; Yingjun,0,5,40,40
1649884980234,CSE 101,A01,084011,Staff,1,35,40,39
1649884986257,CSE 141,A01,083374,Eldon; John,1,40,75,74
1649884992280,CSE 141L,A01,083376,Eldon; John,1,44,75,74
1649884998308,CSE 175,A01,084013,Kumar; Rakesh,22,0,25,3
1649885004330,CSE 190,A00,092508,Dubnov; Shlomo,15,0,15,0
1649885010354,ECE 5,A01,084049,Morris; Karcher William,17,0,20,3
1649885016377,ECE 100,A01,084051,Baghdadchi; Saharnaz,7,0,20,13
1649885016377,ECE 100,A02,091916,Baghdadchi; Saharnaz,18,0,20,2
1649885022399,ECE 101,A01,084053,Baghdadchi; Saharnaz,17,0,37,20
1649885022399,ECE 101,A02,084054,Baghdadchi; Saharnaz,37,0,37,0
1649885028425,ECE 107,A01,083390,Staff,30,0,40,10
1649885034452,ECE 148,A01,084056,Silberman; Jack,7,0,12,5
1649885040490,ECE 180,A00,083391,Abi Samra; Nicholas Camill,25,0,30,5
1649885040490,ECE 180,B00,083392,Abi Samra; Nicholas Camill,23,0,30,7
1649885046514,MATH 10B,A01,084110,Staff,17,0,30,13
1649885046514,MATH 10B,A02,084111,Staff,29,0,30,1
1649885046514,MATH 10B,A03,084112,Staff,29,0,30,1
1649885052544,MATH 10C,A01,083443,Staff,14,0,30,16
1649885052544,MATH 10C,A02,083444,Staff,17,0,30,13
1649885052544,MATH 10C,B01,084114,Staff,26,0,30,4
1649885052544,MATH 10C,B02,084115,Staff,30,0,30,0
1649885058568,MATH 18,A01,084117,Harel; Guershon,27,0,30,3
1649885058568,MATH 18,A02,084119,Harel; Guershon,29,0,30,1
1649885058568,MATH 18,A03,084120,Harel; Guershon,30,0,30,0
1649885058568,MATH 18,A04,084121,Harel; Guershon,30,0,30,0
1649885064595,MATH 20B,A01,084124,Um; Ko Woon,32,0,35,3
1649885064595,MATH 20B,B01,084126,Um; Ko Woon,33,0,35,2
1649885070631,MATH 20C,A01,083446,Hammock; Frances H,23,0,30,7
1649885070631,MATH 20C,A02,083447,Hammock; Frances H,29,0,30,1
1649885070631,MATH 20C,A03,083448,Hammock; Frances H,30,0,30,0
1649885070631,MATH 20C,A04,083449,Hammock; Frances H,30,0,30,0
1649885070631,MATH 20C,B01,083451,Hammock; Frances H,29,0,30,1
1649885070631,MATH 20C,B02,083452,Hammock; Frances H,29,0,30,1
1649885070631,MATH 20C,B03,083453,Hammock; Frances H,30,0,30,0
1649885070631,MATH 20C,B04,083454,Hammock; Frances H,30,0,30,0
1649885076655,MATH 20D,A01,084128,Staff,29,0,30,1
1649885076655,MATH 20D,A02,084129,Staff,30,0,30,0
1649885076655,MATH 20D,A03,084130,Staff,29,0,30,1
1649885076655,MATH 20D,B01,084133,Staff,28,0,30,2
1649885076655,MATH 20D,B02,084134,Staff,29,0,30,1
1649885076655,MATH 20D,B03,084135,Staff,30,0,30,0
1649885082683,MATH 20E,A01,084138,Staff,25,0,30,5
1649885082683,MATH 20E,A02,084139,Staff,26,0,30,4
1649885082683,MATH 20E,A03,084140,Staff,25,0,30,5
1649885082683,MATH 20E,A04,084141,Staff,29,0,30,1
1649885088799,MATH 102,A01,084143,Harel; Guershon,22,0,30,8
1649885088799,MATH 102,A02,084144,Harel; Guershon,24,0,30,6
1649885094826,MATH 103B,A01,083456,Staff,0,2,30,30
1649885094826,MATH 103B,A02,083457,Staff,1,0,30,29
1649885100849,MATH 109,A01,084146,Salehi Golsefidy; Alireza,29,0,30,1
1649885100849,MATH 109,A02,084147,Salehi Golsefidy; Alireza,25,0,30,5
1649885106875,MATH 120A,A01,085445,Eggers; John Dietrich,22,0,35,13
1649885106875,MATH 120A,A02,085446,Eggers; John Dietrich,30,0,35,5
1649885112899,MATH 142B,A01,084149,Verstraete; Jacques Allan,0,2,30,30
1649885112899,MATH 142B,A02,084150,Verstraete; Jacques Allan,6,0,30,24
1649885118924,MATH 170A,A01,083459,Nie; Jiawang,0,2,30,30
1649885118924,MATH 170A,A02,083460,Nie; Jiawang,18,0,30,12
1649885118924,MATH 170A,A03,083461,Nie; Jiawang,20,0,30,10
1649885124954,MATH 193B,A01,083463,Staff,10,0,30,20
1649885124954,MATH 193B,A02,083464,Staff,17,0,30,13
1649885124954,MATH 193B,A03,083465,Staff,25,0,30,5
1649885131014,COGS 2,A01,083966,Boyle; Mary E. T.,22,0,30,8
1649885137037,COGS 9,A01,083968,Staff,48,0,60,12
1649885143072,COGS 14B,A01,083970,Staff,40,0,50,10
1649885149095,COGS 17,A01,092679,Staff,68,0,75,7
1649885155127,COGS 100,A01,083972,Staff,35,0,60,25
1649885167179,COGS 101C,A01,083976,Staff,23,0,30,7
1649885173201,COGS 102A,A01,083978,Johnson; Christine M.,21,0,30,9
1649885179228,COGS 107B,A01,083980,Staff,21,0,50,29
1649885185260,COGS 115,A01,083982,Staff,13,0,30,17
1649885191287,COGS 118B,A01,083367,Staff,0,5,40,40
1649885197310,COGS 172,A01,083984,Provenzano; Emily Kara,17,0,30,13
1649885203335,COGS 177,A00,083368,Staff,1,10,30,29
1649885209358,COGS 186,A01,083986,Staff,23,0,40,17
1649885215382,COGS 187A,A01,083988,Boyle; Mary E. T.,28,0,60,32
1649885221421,CSE 8A,A50,084003,Miranda; Gregory Joseph,7,0,15,8
1649885234316,CSE 11,A01,084005,Miranda; Gregory Joseph,42,0,55,13
1649885240364,CSE 20,A01,084007,Staff,13,0,20,7
1649885246386,CSE 21,A01,084009,Staff,22,0,50,28
1649885252425,CSE 30,A01,083370,Cao; Yingjun,2,0,40,38
1649885258452,CSE 100,A01,083372,Cao; Yingjun,0,5,40,40
1649885264477,CSE 101,A01,084011,Staff,1,35,40,39
1649885270502,CSE 141,A01,083374,Eldon; John,1,40,75,74
1649885276538,CSE 141L,A01,083376,Eldon; John,1,44,75,74
1649885282570,CSE 175,A01,084013,Kumar; Rakesh,22,0,25,3
1649885288594,CSE 190,A00,092508,Dubnov; Shlomo,15,0,15,0
1649885294621,ECE 5,A01,084049,Morris; Karcher William,17,0,20,3
1649885300648,ECE 100,A01,084051,Baghdadchi; Saharnaz,7,0,20,13
1649885300648,ECE 100,A02,091916,Baghdadchi; Saharnaz,18,0,20,2
1649885306677,ECE 101,A01,084053,Baghdadchi; Saharnaz,17,0,37,20
1649885306677,ECE 101,A02,084054,Baghdadchi; Saharnaz,37,0,37,0
1649885312709,ECE 107,A01,083390,Staff,30,0,40,10
1649885318738,ECE 148,A01,084056,Silberman; Jack,7,0,12,5
1649885324765,ECE 180,A00,083391,Abi Samra; Nicholas Camill,25,0,30,5
1649885324765,ECE 180,B00,083392,Abi Samra; Nicholas Camill,23,0,30,7
1649885330794,MATH 10B,A01,084110,Staff,17,0,30,13
1649885330794,MATH 10B,A02,084111,Staff,29,0,30,1
1649885330794,MATH 10B,A03,084112,Staff,29,0,30,1
1649885336816,MATH 10C,A01,083443,Staff,14,0,30,16
1649885336816,MATH 10C,A02,083444,Staff,17,0,30,13
1649885336816,MATH 10C,B01,084114,Staff,26,0,30,4
1649885336816,MATH 10C,B02,084115,Staff,30,0,30,0
1649885342854,MATH 18,A01,084117,Harel; Guershon,27,0,30,3
1649885342854,MATH 18,A02,084119,Harel; Guershon,29,0,30,1
1649885342854,MATH 18,A03,084120,Harel; Guershon,30,0,30,0
1649885342854,MATH 18,A04,084121,Harel; Guershon,30,0,30,0
1649885348883,MATH 20B,A01,084124,Um; Ko Woon,32,0,35,3
1649885348883,MATH 20B,B01,084126,Um; Ko Woon,33,0,35,2
1649885354908,MATH 20C,A01,083446,Hammock; Frances H,23,0,30,7
1649885354908,MATH 20C,A02,083447,Hammock; Frances H,29,0,30,1
1649885354908,MATH 20C,A03,083448,Hammock; Frances H,30,0,30,0
1649885354908,MATH 20C,A04,083449,Hammock; Frances H,30,0,30,0
1649885354908,MATH 20C,B01,083451,Hammock; Frances H,29,0,30,1
1649885354908,MATH 20C,B02,083452,Hammock; Frances H,29,0,30,1
1649885354908,MATH 20C,B03,083453,Hammock; Frances H,30,0,30,0
1649885354908,MATH 20C,B04,083454,Hammock; Frances H,30,0,30,0
1649885360934,MATH 20D,A01,084128,Staff,29,0,30,1
1649885360934,MATH 20D,A02,084129,Staff,30,0,30,0
1649885360934,MATH 20D,A03,084130,Staff,29,0,30,1
1649885360934,MATH 20D,B01,084133,Staff,28,0,30,2
1649885360934,MATH 20D,B02,084134,Staff,29,0,30,1
1649885360934,MATH 20D,B03,084135,Staff,30,0,30,0
1649885366959,MATH 20E,A01,084138,Staff,25,0,30,5
1649885366959,MATH 20E,A02,084139,Staff,26,0,30,4
1649885366959,MATH 20E,A03,084140,Staff,25,0,30,5
1649885366959,MATH 20E,A04,084141,Staff,29,0,30,1
1649885372986,MATH 102,A01,084143,Harel; Guershon,22,0,30,8
1649885372986,MATH 102,A02,084144,Harel; Guershon,24,0,30,6
1649885379016,MATH 103B,A01,083456,Staff,0,2,30,30
1649885379016,MATH 103B,A02,083457,Staff,1,0,30,29
1649885385044,MATH 109,A01,084146,Salehi Golsefidy; Alireza,29,0,30,1
1649885385044,MATH 109,A02,084147,Salehi Golsefidy; Alireza,25,0,30,5
1649885391069,MATH 120A,A01,085445,Eggers; John Dietrich,22,0,35,13
1649885391069,MATH 120A,A02,085446,Eggers; John Dietrich,30,0,35,5
1649885397090,MATH 142B,A01,084149,Verstraete; Jacques Allan,0,2,30,30
1649885397090,MATH 142B,A02,084150,Verstraete; Jacques Allan,6,0,30,24
1649885403118,MATH 170A,A01,083459,Nie; Jiawang,0,1,30,30
1649885403118,MATH 170A,A02,083460,Nie; Jiawang,17,0,30,13
1649885403118,MATH 170A,A03,083461,Nie; Jiawang,20,0,30,10
1649885409154,MATH 193B,A01,083463,Staff,10,0,30,20
1649885409154,MATH 193B,A02,083464,Staff,17,0,30,13
1649885409154,MATH 193B,A03,083465,Staff,25,0,30,5
1649885415223,COGS 2,A01,083966,Boyle; Mary E. T.,22,0,30,8
1649885421249,COGS 9,A01,083968,Staff,48,0,60,12
1649885427272,COGS 14B,A01,083970,Staff,40,0,50,10
1649885433299,COGS 17,A01,092679,Staff,68,0,75,7
1649885439341,COGS 100,A01,083972,Staff,35,0,60,25
1649885451389,COGS 101C,A01,083976,Staff,23,0,30,7
1649885457488,COGS 102A,A01,083978,Johnson; Christine M.,21,0,30,9
1649885463522,COGS 107B,A01,083980,Staff,21,0,50,29
1649885469546,COGS 115,A01,083982,Staff,13,0,30,17
1649885475571,COGS 118B,A01,083367,Staff,0,5,40,40
1649885481599,COGS 172,A01,083984,Provenzano; Emily Kara,17,0,30,13
1649885487623,COGS 177,A00,083368,Staff,1,10,30,29
1649885493653,COGS 186,A01,083986,Staff,23,0,40,17
1649885499680,COGS 187A,A01,083988,Boyle; Mary E. T.,28,0,60,32
1649885505712,CSE 8A,A50,084003,Miranda; Gregory Joseph,7,0,15,8
1649885511743,CSE 11,A01,084005,Miranda; Gregory Joseph,41,0,55,14
1649885517769,CSE 20,A01,084007,Staff,13,0,20,7
1649885523797,CSE 21,A01,084009,Staff,22,0,50,28
1649885529823,CSE 30,A01,083370,Cao; Yingjun,2,0,40,38
1649885535849,CSE 100,A01,083372,Cao; Yingjun,0,5,40,40
1649885541873,CSE 101,A01,084011,Staff,1,34,40,39
1649885547897,CSE 141,A01,083374,Eldon; John,1,40,75,74
1649885553919,CSE 141L,A01,083376,Eldon; John,1,44,75,74
1649885559953,CSE 175,A01,084013,Kumar; Rakesh,22,0,25,3
1649885565978,CSE 190,A00,092508,Dubnov; Shlomo,15,0,15,0
1649885572005,ECE 5,A01,084049,Morris; Karcher William,17,0,20,3
1649885578040,ECE 100,A01,084051,Baghdadchi; Saharnaz,7,0,20,13
1649885578040,ECE 100,A02,091916,Baghdadchi; Saharnaz,18,0,20,2
1649885584069,ECE 101,A01,084053,Baghdadchi; Saharnaz,17,0,37,20
1649885584069,ECE 101,A02,084054,Baghdadchi; Saharnaz,37,0,37,0
1649885590100,ECE 107,A01,083390,Staff,30,0,40,10
1649885596129,ECE 148,A01,084056,Silberman; Jack,7,0,12,5
1649885602171,ECE 180,A00,083391,Abi Samra; Nicholas Camill,25,0,30,5
1649885602171,ECE 180,B00,083392,Abi Samra; Nicholas Camill,23,0,30,7
1649885608203,MATH 10B,A01,084110,Staff,17,0,30,13
1649885608203,MATH 10B,A02,084111,Staff,29,0,30,1
1649885608203,MATH 10B,A03,084112,Staff,29,0,30,1
1649885614233,MATH 10C,A01,083443,Staff,14,0,30,16
1649885614233,MATH 10C,A02,083444,Staff,17,0,30,13
1649885614233,MATH 10C,B01,084114,Staff,26,0,30,4
1649885614233,MATH 10C,B02,084115,Staff,30,0,30,0
1649885620255,MATH 18,A01,084117,Harel; Guershon,27,0,30,3
1649885620255,MATH 18,A02,084119,Harel; Guershon,29,0,30,1
1649885620255,MATH 18,A03,084120,Harel; Guershon,30,0,30,0
1649885620255,MATH 18,A04,084121,Harel; Guershon,30,0,30,0
1649885626279,MATH 20B,A01,084124,Um; Ko Woon,32,0,35,3
1649885626279,MATH 20B,B01,084126,Um; Ko Woon,33,0,35,2
1649885632308,MATH 20C,A01,083446,Hammock; Frances H,23,0,30,7
1649885632308,MATH 20C,A02,083447,Hammock; Frances H,29,0,30,1
1649885632308,MATH 20C,A03,083448,Hammock; Frances H,30,0,30,0
1649885632308,MATH 20C,A04,083449,Hammock; Frances H,30,0,30,0
1649885632308,MATH 20C,B01,083451,Hammock; Frances H,28,0,30,2
1649885632308,MATH 20C,B02,083452,Hammock; Frances H,29,0,30,1
1649885632308,MATH 20C,B03,083453,Hammock; Frances H,30,0,30,0
1649885632308,MATH 20C,B04,083454,Hammock; Frances H,30,0,30,0
1649885638341,MATH 20D,A01,084128,Staff,29,0,30,1
1649885638341,MATH 20D,A02,084129,Staff,30,0,30,0
1649885638341,MATH 20D,A03,084130,Staff,29,0,30,1
1649885638341,MATH 20D,B01,084133,Staff,28,0,30,2
1649885638341,MATH 20D,B02,084134,Staff,29,0,30,1
1649885638341,MATH 20D,B03,084135,Staff,30,0,30,0
1649885644365,MATH 20E,A01,084138,Staff,25,0,30,5
1649885644365,MATH 20E,A02,084139,Staff,26,0,30,4
1649885644365,MATH 20E,A03,084140,Staff,25,0,30,5
1649885644365,MATH 20E,A04,084141,Staff,28,0,30,2
1649885650391,MATH 102,A01,084143,Harel; Guershon,22,0,30,8
1649885650391,MATH 102,A02,084144,Harel; Guershon,24,0,30,6
1649885656418,MATH 103B,A01,083456,Staff,0,2,30,30
1649885656418,MATH 103B,A02,083457,Staff,1,0,30,29
1649885662446,MATH 109,A01,084146,Salehi Golsefidy; Alireza,29,0,30,1
1649885662446,MATH 109,A02,084147,Salehi Golsefidy; Alireza,25,0,30,5
1649885668488,MATH 120A,A01,085445,Eggers; John Dietrich,22,0,35,13
1649885668488,MATH 120A,A02,085446,Eggers; John Dietrich,30,0,35,5
1649885674511,MATH 142B,A01,084149,Verstraete; Jacques Allan,0,2,30,30
1649885674511,MATH 142B,A02,084150,Verstraete; Jacques Allan,6,0,30,24
1649885680538,MATH 170A,A01,083459,Nie; Jiawang,0,1,30,30
1649885680538,MATH 170A,A02,083460,Nie; Jiawang,17,0,30,13
1649885680538,MATH 170A,A03,083461,Nie; Jiawang,20,0,30,10
1649885686563,MATH 193B,A01,083463,Staff,10,0,30,20
1649885686563,MATH 193B,A02,083464,Staff,17,0,30,13
1649885686563,MATH 193B,A03,083465,Staff,25,0,30,5
1649885692755,COGS 2,A01,083966,Boyle; Mary E. T.,22,0,30,8
1649885698779,COGS 9,A01,083968,Staff,48,0,60,12
1649885704807,COGS 14B,A01,083970,Staff,40,0,50,10
1649885710832,COGS 17,A01,092679,Staff,68,0,75,7
1649885716857,COGS 100,A01,083972,Staff,35,0,60,25
1649885728906,COGS 101C,A01,083976,Staff,23,0,30,7
1649885734935,COGS 102A,A01,083978,Johnson; Christine M.,21,0,30,9
1649885740962,COGS 107B,A01,083980,Staff,21,0,50,29
1649885746984,COGS 115,A01,083982,Staff,13,0,30,17
1649885753008,COGS 118B,A01,083367,Staff,0,5,40,40
1649885759035,COGS 172,A01,083984,Provenzano; Emily Kara,17,0,30,13
1649885765060,COGS 177,A00,083368,Staff,1,10,30,29
1649885771086,COGS 186,A01,083986,Staff,23,0,40,17
1649885777112,COGS 187A,A01,083988,Boyle; Mary E. T.,28,0,60,32
1649885783140,CSE 8A,A50,084003,Miranda; Gregory Joseph,6,0,15,9
1649885789167,CSE 11,A01,084005,Miranda; Gregory Joseph,41,0,55,14
1649885795194,CSE 20,A01,084007,Staff,13,0,20,7
1649885801216,CSE 21,A01,084009,Staff,22,0,50,28
1649885807248,CSE 30,A01,083370,Cao; Yingjun,2,0,40,38
1649885813273,CSE 100,A01,083372,Cao; Yingjun,0,5,40,40
1649885819297,CSE 101,A01,084011,Staff,1,34,40,39
1649885825319,CSE 141,A01,083374,Eldon; John,1,40,75,74
1649885831343,CSE 141L,A01,083376,Eldon; John,1,44,75,74
1649885837380,CSE 175,A01,084013,Kumar; Rakesh,22,0,25,3
1649885843411,CSE 190,A00,092508,Dubnov; Shlomo,15,0,15,0
1649885849432,ECE 5,A01,084049,Morris; Karcher William,17,0,20,3
1649885855456,ECE 100,A01,084051,Baghdadchi; Saharnaz,7,0,20,13
1649885855456,ECE 100,A02,091916,Baghdadchi; Saharnaz,18,0,20,2
1649885861485,ECE 101,A01,084053,Baghdadchi; Saharnaz,16,0,37,21
1649885861485,ECE 101,A02,084054,Baghdadchi; Saharnaz,37,0,37,0
1649885867511,ECE 107,A01,083390,Staff,30,0,40,10
1649885873541,ECE 148,A01,084056,Silberman; Jack,7,0,12,5
1649885879566,ECE 180,A00,083391,Abi Samra; Nicholas Camill,25,0,30,5
1649885879566,ECE 180,B00,083392,Abi Samra; Nicholas Camill,23,0,30,7
1649885885598,MATH 10B,A01,084110,Staff,16,0,30,14
1649885885598,MATH 10B,A02,084111,Staff,29,0,30,1
1649885885598,MATH 10B,A03,084112,Staff,29,0,30,1
1649885891621,MATH 10C,A01,083443,Staff,14,0,30,16
1649885891621,MATH 10C,A02,083444,Staff,17,0,30,13
1649885891621,MATH 10C,B01,084114,Staff,26,0,30,4
1649885891621,MATH 10C,B02,084115,Staff,30,0,30,0
1649885897649,MATH 18,A01,084117,Harel; Guershon,27,0,30,3
1649885897649,MATH 18,A02,084119,Harel; Guershon,29,0,30,1
1649885897649,MATH 18,A03,084120,Harel; Guershon,30,0,30,0
1649885897649,MATH 18,A04,084121,Harel; Guershon,30,0,30,0
1649885903684,MATH 20B,A01,084124,Um; Ko Woon,32,0,35,3
1649885903684,MATH 20B,B01,084126,Um; Ko Woon,33,0,35,2
1649885909711,MATH 20C,A01,083446,Hammock; Frances H,23,0,30,7
1649885909711,MATH 20C,A02,083447,Hammock; Frances H,29,0,30,1
1649885909711,MATH 20C,A03,083448,Hammock; Frances H,30,0,30,0
1649885909711,MATH 20C,A04,083449,Hammock; Frances H,30,0,30,0
1649885909711,MATH 20C,B01,083451,Hammock; Frances H,28,0,30,2
1649885909711,MATH 20C,B02,083452,Hammock; Frances H,29,0,30,1
1649885909711,MATH 20C,B03,083453,Hammock; Frances H,30,0,30,0
1649885909711,MATH 20C,B04,083454,Hammock; Frances H,30,0,30,0
1649885915740,MATH 20D,A01,084128,Staff,29,0,30,1
1649885915740,MATH 20D,A02,084129,Staff,30,0,30,0
1649885915740,MATH 20D,A03,084130,Staff,29,0,30,1
1649885915740,MATH 20D,B01,084133,Staff,28,0,30,2
1649885915740,MATH 20D,B02,084134,Staff,29,0,30,1
1649885915740,MATH 20D,B03,084135,Staff,30,0,30,0
1649885921773,MATH 20E,A01,084138,Staff,25,0,30,5
1649885921773,MATH 20E,A02,084139,Staff,26,0,30,4
1649885921773,MATH 20E,A03,084140,Staff,25,0,30,5
1649885921773,MATH 20E,A04,084141,Staff,28,0,30,2
1649885927801,MATH 102,A01,084143,Harel; Guershon,22,0,30,8
1649885927801,MATH 102,A02,084144,Harel; Guershon,24,0,30,6
1649885933845,MATH 103B,A01,083456,Staff,0,2,30,30
1649885933845,MATH 103B,A02,083457,Staff,0,1,30,30
1649885939877,MATH 109,A01,084146,Salehi Golsefidy; Alireza,29,0,30,1
1649885939877,MATH 109,A02,084147,Salehi Golsefidy; Alireza,25,0,30,5
1649885945919,MATH 120A,A01,085445,Eggers; John Dietrich,22,0,35,13
1649885945919,MATH 120A,A02,085446,Eggers; John Dietrich,30,0,35,5
1649885951940,MATH 142B,A01,084149,Verstraete; Jacques Allan,0,1,30,30
1649885951940,MATH 142B,A02,084150,Verstraete; Jacques Allan,5,0,30,25
1649885957971,MATH 170A,A01,083459,Nie; Jiawang,0,1,30,30
1649885957971,MATH 170A,A02,083460,Nie; Jiawang,17,0,30,13
1649885957971,MATH 170A,A03,083461,Nie; Jiawang,20,0,30,10
1649885964015,MATH 193B,A01,083463,Staff,10,0,30,20
1649885964015,MATH 193B,A02,083464,Staff,17,0,30,13
1649885964015,MATH 193B,A03,083465,Staff,25,0,30,5
1649885970068,COGS 2,A01,083966,Boyle; Mary E. T.,22,0,30,8
1649885976092,COGS 9,A01,083968,Staff,48,0,60,12
1649885982115,COGS 14B,A01,083970,Staff,40,0,50,10
1649885988141,COGS 17,A01,092679,Staff,68,0,75,7
1649885994163,COGS 100,A01,083972,Staff,35,0,60,25
1649886006212,COGS 101C,A01,083976,Staff,23,0,30,7
1649886012240,COGS 102A,A01,083978,Johnson; Christine M.,21,0,30,9
1649886018272,COGS 107B,A01,083980,Staff,20,0,50,30
1649886024298,COGS 115,A01,083982,Staff,13,0,30,17
1649886030331,COGS 118B,A01,083367,Staff,0,5,40,40
1649886036362,COGS 172,A01,083984,Provenzano; Emily Kara,17,0,30,13
1649886042385,COGS 177,A00,083368,Staff,1,10,30,29
1649886048418,COGS 186,A01,083986,Staff,23,0,40,17
1649886054444,COGS 187A,A01,083988,Boyle; Mary E. T.,28,0,60,32
1649886060479,CSE 8A,A50,084003,Miranda; Gregory Joseph,6,0,15,9
1649886066507,CSE 11,A01,084005,Miranda; Gregory Joseph,41,0,55,14
1649886072530,CSE 20,A01,084007,Staff,13,0,20,7
1649886078553,CSE 21,A01,084009,Staff,22,0,50,28
1649886084575,CSE 30,A01,083370,Cao; Yingjun,2,0,40,38
1649886090612,CSE 100,A01,083372,Cao; Yingjun,0,5,40,40
1649886096640,CSE 101,A01,084011,Staff,1,34,40,39
1649886102673,CSE 141,A01,083374,Eldon; John,1,40,75,74
1649886108698,CSE 141L,A01,083376,Eldon; John,1,44,75,74
1649886114725,CSE 175,A01,084013,Kumar; Rakesh,22,0,25,3
1649886120748,CSE 190,A00,092508,Dubnov; Shlomo,15,0,15,0
1649886126774,ECE 5,A01,084049,Morris; Karcher William,17,0,20,3
1649886132807,ECE 100,A01,084051,Baghdadchi; Saharnaz,7,0,20,13
1649886132807,ECE 100,A02,091916,Baghdadchi; Saharnaz,18,0,20,2
1649886138830,ECE 101,A01,084053,Baghdadchi; Saharnaz,15,0,37,22
1649886138830,ECE 101,A02,084054,Baghdadchi; Saharnaz,37,0,37,0
1649886144853,ECE 107,A01,083390,Staff,30,0,40,10
1649886150878,ECE 148,A01,084056,Silberman; Jack,7,0,12,5
1649886156901,ECE 180,A00,083391,Abi Samra; Nicholas Camill,25,0,30,5
1649886156901,ECE 180,B00,083392,Abi Samra; Nicholas Camill,23,0,30,7
1649886162924,MATH 10B,A01,084110,Staff,16,0,30,14
1649886162924,MATH 10B,A02,084111,Staff,29,0,30,1
1649886162924,MATH 10B,A03,084112,Staff,29,0,30,1
1649886168971,MATH 10C,A01,083443,Staff,14,0,30,16
1649886168971,MATH 10C,A02,083444,Staff,17,0,30,13
1649886168971,MATH 10C,B01,084114,Staff,26,0,30,4
1649886168971,MATH 10C,B02,084115,Staff,30,0,30,0
1649886175002,MATH 18,A01,084117,Harel; Guershon,27,0,30,3
1649886175002,MATH 18,A02,084119,Harel; Guershon,29,0,30,1
1649886175002,MATH 18,A03,084120,Harel; Guershon,30,0,30,0
1649886175002,MATH 18,A04,084121,Harel; Guershon,30,0,30,0
1649886181027,MATH 20B,A01,084124,Um; Ko Woon,32,0,35,3
1649886181027,MATH 20B,B01,084126,Um; Ko Woon,33,0,35,2
1649886187057,MATH 20C,A01,083446,Hammock; Frances H,23,0,30,7
1649886187057,MATH 20C,A02,083447,Hammock; Frances H,29,0,30,1
1649886187057,MATH 20C,A03,083448,Hammock; Frances H,30,0,30,0
1649886187057,MATH 20C,A04,083449,Hammock; Frances H,30,0,30,0
1649886187057,MATH 20C,B01,083451,Hammock; Frances H,28,0,30,2
1649886187057,MATH 20C,B02,083452,Hammock; Frances H,29,0,30,1
1649886187057,MATH 20C,B03,083453,Hammock; Frances H,30,0,30,0
1649886187057,MATH 20C,B04,083454,Hammock; Frances H,30,0,30,0
1649886193084,MATH 20D,A01,084128,Staff,29,0,30,1
1649886193084,MATH 20D,A02,084129,Staff,30,0,30,0
1649886193084,MATH 20D,A03,084130,Staff,29,0,30,1
1649886193084,MATH 20D,B01,084133,Staff,28,0,30,2
1649886193084,MATH 20D,B02,084134,Staff,29,0,30,1
1649886193084,MATH 20D,B03,084135,Staff,30,0,30,0
1649886199117,MATH 20E,A01,084138,Staff,25,0,30,5
1649886199117,MATH 20E,A02,084139,Staff,26,0,30,4
1649886199117,MATH 20E,A03,084140,Staff,25,0,30,5
1649886199117,MATH 20E,A04,084141,Staff,28,0,30,2
1649886205141,MATH 102,A01,084143,Harel; Guershon,22,0,30,8
1649886205141,MATH 102,A02,084144,Harel; Guershon,24,0,30,6
1649886211173,MATH 103B,A01,083456,Staff,0,2,30,30
1649886211173,MATH 103B,A02,083457,Staff,0,1,30,30
1649886217208,MATH 109,A01,084146,Salehi Golsefidy; Alireza,29,0,30,1
1649886217208,MATH 109,A02,084147,Salehi Golsefidy; Alireza,25,0,30,5
1649886223230,MATH 120A,A01,085445,Eggers; John Dietrich,22,0,35,13
1649886223230,MATH 120A,A02,085446,Eggers; John Dietrich,30,0,35,5
1649886229257,MATH 142B,A01,084149,Verstraete; Jacques Allan,0,1,30,30
1649886229257,MATH 142B,A02,084150,Verstraete; Jacques Allan,5,0,30,25
1649886235280,MATH 170A,A01,083459,Nie; Jiawang,0,1,30,30
1649886235280,MATH 170A,A02,083460,Nie; Jiawang,16,0,30,14
1649886235280,MATH 170A,A03,083461,Nie; Jiawang,20,0,30,10
1649886241307,MATH 193B,A01,083463,Staff,10,0,30,20
1649886241307,MATH 193B,A02,083464,Staff,17,0,30,13
1649886241307,MATH 193B,A03,083465,Staff,25,0,30,5
1649886247383,COGS 2,A01,083966,Boyle; Mary E. T.,22,0,30,8
1649886253405,COGS 9,A01,083968,Staff,48,0,60,12
1649886259440,COGS 14B,A01,083970,Staff,40,0,50,10
1649886265463,COGS 17,A01,092679,Staff,68,0,75,7
1649886271486,COGS 100,A01,083972,Staff,34,0,60,26
1649886283623,COGS 101C,A01,083976,Staff,22,0,30,8
1649886289647,COGS 102A,A01,083978,Johnson; Christine M.,21,0,30,9
1649886295669,COGS 107B,A01,083980,Staff,20,0,50,30
1649886301691,COGS 115,A01,083982,Staff,13,0,30,17
1649886307718,COGS 118B,A01,083367,Staff,0,5,40,40
1649886313742,COGS 172,A01,083984,Provenzano; Emily Kara,17,0,30,13
1649886319769,COGS 177,A00,083368,Staff,1,11,30,29
1649886325790,COGS 186,A01,083986,Staff,23,0,40,17
1649886331818,COGS 187A,A01,083988,Boyle; Mary E. T.,28,0,60,32
1649886337844,CSE 8A,A50,084003,Miranda; Gregory Joseph,6,0,15,9
1649886343872,CSE 11,A01,084005,Miranda; Gregory Joseph,41,0,55,14
1649886349902,CSE 20,A01,084007,Staff,13,0,20,7
1649886355928,CSE 21,A01,084009,Staff,22,0,50,28
1649886361956,CSE 30,A01,083370,Cao; Yingjun,2,0,40,38
1649886367989,CSE 100,A01,083372,Cao; Yingjun,0,5,40,40
1649886374011,CSE 101,A01,084011,Staff,1,35,40,39
1649886380034,CSE 141,A01,083374,Eldon; John,1,41,75,74
1649886386061,CSE 141L,A01,083376,Eldon; John,1,44,75,74
1649886392096,CSE 175,A01,084013,Kumar; Rakesh,22,0,25,3
1649886398121,CSE 190,A00,092508,Dubnov; Shlomo,15,0,15,0
1649886404158,ECE 5,A01,084049,Morris; Karcher William,16,0,20,4
1649886410185,ECE 100,A01,084051,Baghdadchi; Saharnaz,7,0,20,13
1649886410185,ECE 100,A02,091916,Baghdadchi; Saharnaz,18,0,20,2
1649886416206,ECE 101,A01,084053,Baghdadchi; Saharnaz,14,0,37,23
1649886416206,ECE 101,A02,084054,Baghdadchi; Saharnaz,37,0,37,0
1649886422234,ECE 107,A01,083390,Staff,30,0,40,10
1649886428258,ECE 148,A01,084056,Silberman; Jack,7,0,12,5
1649886434289,ECE 180,A00,083391,Abi Samra; Nicholas Camill,25,0,30,5
1649886434289,ECE 180,B00,083392,Abi Samra; Nicholas Camill,23,0,30,7
1649886440312,MATH 10B,A01,084110,Staff,16,0,30,14
1649886440312,MATH 10B,A02,084111,Staff,29,0,30,1
1649886440312,MATH 10B,A03,084112,Staff,29,0,30,1
1649886446341,MATH 10C,A01,083443,Staff,14,0,30,16
1649886446341,MATH 10C,A02,083444,Staff,17,0,30,13
1649886446341,MATH 10C,B01,084114,Staff,26,0,30,4
1649886446341,MATH 10C,B02,084115,Staff,30,0,30,0
1649886452364,MATH 18,A01,084117,Harel; Guershon,27,0,30,3
1649886452364,MATH 18,A02,084119,Harel; Guershon,29,0,30,1
1649886452364,MATH 18,A03,084120,Harel; Guershon,30,0,30,0
1649886452364,MATH 18,A04,084121,Harel; Guershon,30,0,30,0
1649886458393,MATH 20B,A01,084124,Um; Ko Woon,32,0,35,3
1649886458393,MATH 20B,B01,084126,Um; Ko Woon,33,0,35,2
1649886464424,MATH 20C,A01,083446,Hammock; Frances H,23,0,30,7
1649886464424,MATH 20C,A02,083447,Hammock; Frances H,29,0,30,1
1649886464424,MATH 20C,A03,083448,Hammock; Frances H,30,0,30,0
1649886464424,MATH 20C,A04,083449,Hammock; Frances H,30,0,30,0
1649886464424,MATH 20C,B01,083451,Hammock; Frances H,28,0,30,2
1649886464424,MATH 20C,B02,083452,Hammock; Frances H,29,0,30,1
1649886464424,MATH 20C,B03,083453,Hammock; Frances H,30,0,30,0
1649886464424,MATH 20C,B04,083454,Hammock; Frances H,30,0,30,0
1649886470453,MATH 20D,A01,084128,Staff,29,0,30,1
1649886470453,MATH 20D,A02,084129,Staff,30,0,30,0
1649886470453,MATH 20D,A03,084130,Staff,29,0,30,1
1649886470453,MATH 20D,B01,084133,Staff,28,0,30,2
1649886470453,MATH 20D,B02,084134,Staff,29,0,30,1
1649886470453,MATH 20D,B03,084135,Staff,30,0,30,0
1649886476477,MATH 20E,A01,084138,Staff,25,0,30,5
1649886476477,MATH 20E,A02,084139,Staff,26,0,30,4
1649886476477,MATH 20E,A03,084140,Staff,25,0,30,5
1649886476477,MATH 20E,A04,084141,Staff,28,0,30,2
1649886482500,MATH 102,A01,084143,Harel; Guershon,22,0,30,8
1649886482500,MATH 102,A02,084144,Harel; Guershon,24,0,30,6
1649886488533,MATH 103B,A01,083456,Staff,0,2,30,30
1649886488533,MATH 103B,A02,083457,Staff,0,1,30,30
1649886494564,MATH 109,A01,084146,Salehi Golsefidy; Alireza,29,0,30,1
1649886494564,MATH 109,A02,084147,Salehi Golsefidy; Alireza,25,0,30,5
1649886500587,MATH 120A,A01,085445,Eggers; John Dietrich,22,0,35,13
1649886500587,MATH 120A,A02,085446,Eggers; John Dietrich,30,0,35,5
1649886506609,MATH 142B,A01,084149,Verstraete; Jacques Allan,0,1,30,30
1649886506609,MATH 142B,A02,084150,Verstraete; Jacques Allan,5,0,30,25
1649886512634,MATH 170A,A01,083459,Nie; Jiawang,0,1,30,30
1649886512634,MATH 170A,A02,083460,Nie; Jiawang,15,0,30,15
1649886512634,MATH 170A,A03,083461,Nie; Jiawang,20,0,30,10
1649886518662,MATH 193B,A01,083463,Staff,9,0,30,21
1649886518662,MATH 193B,A02,083464,Staff,17,0,30,13
1649886518662,MATH 193B,A03,083465,Staff,25,0,30,5
1649886524720,COGS 2,A01,083966,Boyle; Mary E. T.,22,0,30,8
1649886530758,COGS 9,A01,083968,Staff,48,0,60,12
1649886536794,COGS 14B,A01,083970,Staff,40,0,50,10
1649886542817,COGS 17,A01,092679,Staff,68,0,75,7
1649886548844,COGS 100,A01,083972,Staff,34,0,60,26
1649886560897,COGS 101C,A01,083976,Staff,22,0,30,8
1649886566923,COGS 102A,A01,083978,Johnson; Christine M.,21,0,30,9
1649886572948,COGS 107B,A01,083980,Staff,20,0,50,30
1649886578971,COGS 115,A01,083982,Staff,13,0,30,17
1649886584992,COGS 118B,A01,083367,Staff,0,5,40,40
1649886591018,COGS 172,A01,083984,Provenzano; Emily Kara,17,0,30,13
1649886597041,COGS 177,A00,083368,Staff,1,11,30,29
1649886603072,COGS 186,A01,083986,Staff,23,0,40,17
1649886609093,COGS 187A,A01,083988,Boyle; Mary E. T.,28,0,60,32
1649886615123,CSE 8A,A50,084003,Miranda; Gregory Joseph,6,0,15,9
1649886621154,CSE 11,A01,084005,Miranda; Gregory Joseph,41,0,55,14
1649886627185,CSE 20,A01,084007,Staff,13,0,20,7
1649886633208,CSE 21,A01,084009,Staff,22,0,50,28
1649886639233,CSE 30,A01,083370,Cao; Yingjun,2,0,40,38
1649886645257,CSE 100,A01,083372,Cao; Yingjun,0,7,40,40
1649886651281,CSE 101,A01,084011,Staff,1,35,40,39
1649886657308,CSE 141,A01,083374,Eldon; John,1,41,75,74
1649886663334,CSE 141L,A01,083376,Eldon; John,1,44,75,74
1649886669356,CSE 175,A01,084013,Kumar; Rakesh,22,0,25,3
1649886675382,CSE 190,A00,092508,Dubnov; Shlomo,15,0,15,0
1649886681406,ECE 5,A01,084049,Morris; Karcher William,16,0,20,4
1649886687429,ECE 100,A01,084051,Baghdadchi; Saharnaz,7,0,20,13
1649886687429,ECE 100,A02,091916,Baghdadchi; Saharnaz,18,0,20,2
1649886693452,ECE 101,A01,084053,Baghdadchi; Saharnaz,14,0,37,23
1649886693452,ECE 101,A02,084054,Baghdadchi; Saharnaz,37,0,37,0
1649886699478,ECE 107,A01,083390,Staff,30,0,40,10
1649886705503,ECE 148,A01,084056,Silberman; Jack,7,0,12,5
1649886711538,ECE 180,A00,083391,Abi Samra; Nicholas Camill,25,0,30,5
1649886711538,ECE 180,B00,083392,Abi Samra; Nicholas Camill,23,0,30,7
1649886717564,MATH 10B,A01,084110,Staff,15,0,30,15
1649886717564,MATH 10B,A02,084111,Staff,29,0,30,1
1649886717564,MATH 10B,A03,084112,Staff,29,0,30,1
1649886723592,MATH 10C,A01,083443,Staff,14,0,30,16
1649886723592,MATH 10C,A02,083444,Staff,17,0,30,13
1649886723592,MATH 10C,B01,084114,Staff,26,0,30,4
1649886723592,MATH 10C,B02,084115,Staff,30,0,30,0
1649886729620,MATH 18,A01,084117,Harel; Guershon,27,0,30,3
1649886729620,MATH 18,A02,084119,Harel; Guershon,29,0,30,1
1649886729620,MATH 18,A03,084120,Harel; Guershon,30,0,30,0
1649886729620,MATH 18,A04,084121,Harel; Guershon,30,0,30,0
1649886735641,MATH 20B,A01,084124,Um; Ko Woon,32,0,35,3
1649886735641,MATH 20B,B01,084126,Um; Ko Woon,33,0,35,2
1649886741673,MATH 20C,A01,083446,Hammock; Frances H,23,0,30,7
1649886741673,MATH 20C,A02,083447,Hammock; Frances H,29,0,30,1
1649886741673,MATH 20C,A03,083448,Hammock; Frances H,30,0,30,0
1649886741673,MATH 20C,A04,083449,Hammock; Frances H,30,0,30,0
1649886741673,MATH 20C,B01,083451,Hammock; Frances H,28,0,30,2
1649886741673,MATH 20C,B02,083452,Hammock; Frances H,29,0,30,1
1649886741673,MATH 20C,B03,083453,Hammock; Frances H,30,0,30,0
1649886741673,MATH 20C,B04,083454,Hammock; Frances H,30,0,30,0
1649886747700,MATH 20D,A01,084128,Staff,29,0,30,1
1649886747700,MATH 20D,A02,084129,Staff,30,0,30,0
1649886747700,MATH 20D,A03,084130,Staff,29,0,30,1
1649886747700,MATH 20D,B01,084133,Staff,28,0,30,2
1649886747700,MATH 20D,B02,084134,Staff,29,0,30,1
1649886747700,MATH 20D,B03,084135,Staff,30,0,30,0
1649886753724,MATH 20E,A01,084138,Staff,25,0,30,5
1649886753724,MATH 20E,A02,084139,Staff,26,0,30,4
1649886753724,MATH 20E,A03,084140,Staff,25,0,30,5
1649886753724,MATH 20E,A04,084141,Staff,28,0,30,2
1649886759749,MATH 102,A01,084143,Harel; Guershon,22,0,30,8
1649886759749,MATH 102,A02,084144,Harel; Guershon,24,0,30,6
1649886765772,MATH 103B,A01,083456,Staff,0,2,30,30
1649886765772,MATH 103B,A02,083457,Staff,0,1,30,30
1649886771801,MATH 109,A01,084146,Salehi Golsefidy; Alireza,29,0,30,1
1649886771801,MATH 109,A02,084147,Salehi Golsefidy; Alireza,25,0,30,5
1649886777827,MATH 120A,A01,085445,Eggers; John Dietrich,22,0,35,13
1649886777827,MATH 120A,A02,085446,Eggers; John Dietrich,30,0,35,5
1649886783856,MATH 142B,A01,084149,Verstraete; Jacques Allan,0,1,30,30
1649886783856,MATH 142B,A02,084150,Verstraete; Jacques Allan,4,0,30,26
1649886789889,MATH 170A,A01,083459,Nie; Jiawang,0,1,30,30
1649886789889,MATH 170A,A02,083460,Nie; Jiawang,15,0,30,15
1649886789889,MATH 170A,A03,083461,Nie; Jiawang,20,0,30,10
1649886795923,MATH 193B,A01,083463,Staff,9,0,30,21
1649886795923,MATH 193B,A02,083464,Staff,17,0,30,13
1649886795923,MATH 193B,A03,083465,Staff,25,0,30,5
1649886801990,COGS 2,A01,083966,Boyle; Mary E. T.,22,0,30,8
1649886808031,COGS 9,A01,083968,Staff,48,0,60,12
1649886814056,COGS 14B,A01,083970,Staff,40,0,50,10
1649886820081,COGS 17,A01,092679,Staff,68,0,75,7
1649886826113,COGS 100,A01,083972,Staff,34,0,60,26
1649886838162,COGS 101C,A01,083976,Staff,22,0,30,8
1649886844191,COGS 102A,A01,083978,Johnson; Christine M.,21,0,30,9
1649886850216,COGS 107B,A01,083980,Staff,19,0,50,31
1649886856239,COGS 115,A01,083982,Staff,13,0,30,17
1649886862265,COGS 118B,A01,083367,Staff,0,5,40,40
1649886868294,COGS 172,A01,083984,Provenzano; Emily Kara,17,0,30,13
1649886874316,COGS 177,A00,083368,Staff,1,11,30,29
1649886880441,COGS 186,A01,083986,Staff,23,0,40,17
1649886886473,COGS 187A,A01,083988,Boyle; Mary E. T.,28,0,60,32
1649886892496,CSE 8A,A50,084003,Miranda; Gregory Joseph,6,0,15,9
1649886898523,CSE 11,A01,084005,Miranda; Gregory Joseph,41,0,55,14
1649886904553,CSE 20,A01,084007,Staff,13,0,20,7
1649886910578,CSE 21,A01,084009,Staff,21,0,50,29
1649886916601,CSE 30,A01,083370,Cao; Yingjun,1,0,40,39
1649886922623,CSE 100,A01,083372,Cao; Yingjun,0,7,40,40
1649886928657,CSE 101,A01,084011,Staff,1,35,40,39
1649886934683,CSE 141,A01,083374,Eldon; John,1,41,75,74
1649886940712,CSE 141L,A01,083376,Eldon; John,1,44,75,74
1649886946735,CSE 175,A01,084013,Kumar; Rakesh,22,0,25,3
1649886952761,CSE 190,A00,092508,Dubnov; Shlomo,15,0,15,0
1649886958786,ECE 5,A01,084049,Morris; Karcher William,16,0,20,4
1649886964818,ECE 100,A01,084051,Baghdadchi; Saharnaz,7,0,20,13
1649886964818,ECE 100,A02,091916,Baghdadchi; Saharnaz,18,0,20,2
1649886970849,ECE 101,A01,084053,Baghdadchi; Saharnaz,14,0,37,23
1649886970849,ECE 101,A02,084054,Baghdadchi; Saharnaz,37,0,37,0
1649886976876,ECE 107,A01,083390,Staff,30,0,40,10
1649886982900,ECE 148,A01,084056,Silberman; Jack,7,0,12,5
1649886988932,ECE 180,A00,083391,Abi Samra; Nicholas Camill,25,0,30,5
1649886988932,ECE 180,B00,083392,Abi Samra; Nicholas Camill,23,0,30,7
1649886994956,MATH 10B,A01,084110,Staff,15,0,30,15
1649886994956,MATH 10B,A02,084111,Staff,29,0,30,1
1649886994956,MATH 10B,A03,084112,Staff,29,0,30,1
1649887000983,MATH 10C,A01,083443,Staff,14,0,30,16
1649887000983,MATH 10C,A02,083444,Staff,17,0,30,13
1649887000983,MATH 10C,B01,084114,Staff,26,0,30,4
1649887000983,MATH 10C,B02,084115,Staff,30,0,30,0
1649887007008,MATH 18,A01,084117,Harel; Guershon,27,0,30,3
1649887007008,MATH 18,A02,084119,Harel; Guershon,29,0,30,1
1649887007008,MATH 18,A03,084120,Harel; Guershon,30,0,30,0
1649887007008,MATH 18,A04,084121,Harel; Guershon,30,0,30,0
1649887013036,MATH 20B,A01,084124,Um; Ko Woon,32,0,35,3
1649887013036,MATH 20B,B01,084126,Um; Ko Woon,33,0,35,2
1649887019066,MATH 20C,A01,083446,Hammock; Frances H,23,0,30,7
1649887019066,MATH 20C,A02,083447,Hammock; Frances H,29,0,30,1
1649887019066,MATH 20C,A03,083448,Hammock; Frances H,30,0,30,0
1649887019066,MATH 20C,A04,083449,Hammock; Frances H,30,0,30,0
1649887019066,MATH 20C,B01,083451,Hammock; Frances H,28,0,30,2
1649887019066,MATH 20C,B02,083452,Hammock; Frances H,29,0,30,1
1649887019066,MATH 20C,B03,083453,Hammock; Frances H,30,0,30,0
1649887019066,MATH 20C,B04,083454,Hammock; Frances H,30,0,30,0
1649887025092,MATH 20D,A01,084128,Staff,29,0,30,1
1649887025092,MATH 20D,A02,084129,Staff,30,0,30,0
1649887025092,MATH 20D,A03,084130,Staff,29,0,30,1
1649887025092,MATH 20D,B01,084133,Staff,28,0,30,2
1649887025092,MATH 20D,B02,084134,Staff,29,0,30,1
1649887025092,MATH 20D,B03,084135,Staff,30,0,30,0
1649887031116,MATH 20E,A01,084138,Staff,25,0,30,5
1649887031116,MATH 20E,A02,084139,Staff,26,0,30,4
1649887031116,MATH 20E,A03,084140,Staff,25,0,30,5
1649887031116,MATH 20E,A04,084141,Staff,28,0,30,2
1649887037149,MATH 102,A01,084143,Harel; Guershon,22,0,30,8
1649887037149,MATH 102,A02,084144,Harel; Guershon,24,0,30,6
1649887043171,MATH 103B,A01,083456,Staff,0,2,30,30
1649887043171,MATH 103B,A02,083457,Staff,0,1,30,30
1649887049200,MATH 109,A01,084146,Salehi Golsefidy; Alireza,29,0,30,1
1649887049200,MATH 109,A02,084147,Salehi Golsefidy; Alireza,25,0,30,5
1649887055230,MATH 120A,A01,085445,Eggers; John Dietrich,22,0,35,13
1649887055230,MATH 120A,A02,085446,Eggers; John Dietrich,30,0,35,5
1649887061257,MATH 142B,A01,084149,Verstraete; Jacques Allan,0,1,30,30
1649887061257,MATH 142B,A02,084150,Verstraete; Jacques Allan,4,0,30,26
1649887067289,MATH 170A,A01,083459,Nie; Jiawang,0,1,30,30
1649887067289,MATH 170A,A02,083460,Nie; Jiawang,15,0,30,15
1649887067289,MATH 170A,A03,083461,Nie; Jiawang,20,0,30,10
1649887073312,MATH 193B,A01,083463,Staff,9,0,30,21
1649887073312,MATH 193B,A02,083464,Staff,17,0,30,13
1649887073312,MATH 193B,A03,083465,Staff,25,0,30,5
1649887079378,COGS 2,A01,083966,Boyle; Mary E. T.,22,0,30,8
1649887085399,COGS 9,A01,083968,Staff,48,0,60,12
1649887091447,COGS 14B,A01,083970,Staff,40,0,50,10
1649887097471,COGS 17,A01,092679,Staff,68,0,75,7
1649887103494,COGS 100,A01,083972,Staff,34,0,60,26
1649887115551,COGS 101C,A01,083976,Staff,22,0,30,8
1649887121574,COGS 102A,A01,083978,Johnson; Christine M.,20,0,30,10
1649887127600,COGS 107B,A01,083980,Staff,19,0,50,31
1649887133625,COGS 115,A01,083982,Staff,13,0,30,17
1649887139666,COGS 118B,A01,083367,Staff,0,5,40,40
1649887145689,COGS 172,A01,083984,Provenzano; Emily Kara,17,0,30,13
1649887151721,COGS 177,A00,083368,Staff,1,11,30,29
1649887157762,COGS 186,A01,083986,Staff,23,0,40,17
1649887163785,COGS 187A,A01,083988,Boyle; Mary E. T.,28,0,60,32
1649887169814,CSE 8A,A50,084003,Miranda; Gregory Joseph,6,0,15,9
1649887175855,CSE 11,A01,084005,Miranda; Gregory Joseph,41,0,55,14
1649887181888,CSE 20,A01,084007,Staff,13,0,20,7
1649887187917,CSE 21,A01,084009,Staff,21,0,50,29
1649887193945,CSE 30,A01,083370,Cao; Yingjun,1,0,40,39
1649887199966,CSE 100,A01,083372,Cao; Yingjun,0,7,40,40
1649887205990,CSE 101,A01,084011,Staff,1,35,40,39
1649887212030,CSE 141,A01,083374,Eldon; John,1,41,75,74
1649887218057,CSE 141L,A01,083376,Eldon; John,1,44,75,74
1649887224078,CSE 175,A01,084013,Kumar; Rakesh,22,0,25,3
1649887230110,CSE 190,A00,092508,Dubnov; Shlomo,15,0,15,0
1649887236155,ECE 5,A01,084049,Morris; Karcher William,16,0,20,4
1649887242177,ECE 100,A01,084051,Baghdadchi; Saharnaz,7,0,20,13
1649887242177,ECE 100,A02,091916,Baghdadchi; Saharnaz,18,0,20,2
1649887248201,ECE 101,A01,084053,Baghdadchi; Saharnaz,14,0,37,23
1649887248201,ECE 101,A02,084054,Baghdadchi; Saharnaz,37,0,37,0
1649887254229,ECE 107,A01,083390,Staff,30,0,40,10
1649887260251,ECE 148,A01,084056,Silberman; Jack,7,0,12,5
1649887266273,ECE 180,A00,083391,Abi Samra; Nicholas Camill,25,0,30,5
1649887266273,ECE 180,B00,083392,Abi Samra; Nicholas Camill,23,0,30,7
1649887272313,MATH 10B,A01,084110,Staff,15,0,30,15
1649887272313,MATH 10B,A02,084111,Staff,29,0,30,1
1649887272313,MATH 10B,A03,084112,Staff,29,0,30,1
1649887278356,MATH 10C,A01,083443,Staff,14,0,30,16
1649887278356,MATH 10C,A02,083444,Staff,17,0,30,13
1649887278356,MATH 10C,B01,084114,Staff,26,0,30,4
1649887278356,MATH 10C,B02,084115,Staff,30,0,30,0
1649887284381,MATH 18,A01,084117,Harel; Guershon,27,0,30,3
1649887284381,MATH 18,A02,084119,Harel; Guershon,29,0,30,1
1649887284381,MATH 18,A03,084120,Harel; Guershon,30,0,30,0
1649887284381,MATH 18,A04,084121,Harel; Guershon,30,0,30,0
1649887290410,MATH 20B,A01,084124,Um; Ko Woon,32,0,35,3
1649887290410,MATH 20B,B01,084126,Um; Ko Woon,33,0,35,2
1649887296445,MATH 20C,A01,083446,Hammock; Frances H,23,0,30,7
1649887296445,MATH 20C,A02,083447,Hammock; Frances H,29,0,30,1
1649887296445,MATH 20C,A03,083448,Hammock; Frances H,30,0,30,0
1649887296445,MATH 20C,A04,083449,Hammock; Frances H,30,0,30,0
1649887296445,MATH 20C,B01,083451,Hammock; Frances H,28,0,30,2
1649887296445,MATH 20C,B02,083452,Hammock; Frances H,29,0,30,1
1649887296445,MATH 20C,B03,083453,Hammock; Frances H,30,0,30,0
1649887296445,MATH 20C,B04,083454,Hammock; Frances H,30,0,30,0
1649887302471,MATH 20D,A01,084128,Staff,29,0,30,1
1649887302471,MATH 20D,A02,084129,Staff,30,0,30,0
1649887302471,MATH 20D,A03,084130,Staff,29,0,30,1
1649887302471,MATH 20D,B01,084133,Staff,28,0,30,2
1649887302471,MATH 20D,B02,084134,Staff,29,0,30,1
1649887302471,MATH 20D,B03,084135,Staff,30,0,30,0
1649887308495,MATH 20E,A01,084138,Staff,25,0,30,5
1649887308495,MATH 20E,A02,084139,Staff,26,0,30,4
1649887308495,MATH 20E,A03,084140,Staff,25,0,30,5
1649887308495,MATH 20E,A04,084141,Staff,28,0,30,2
1649887314537,MATH 102,A01,084143,Harel; Guershon,22,0,30,8
1649887314537,MATH 102,A02,084144,Harel; Guershon,23,0,30,7
1649887320572,MATH 103B,A01,083456,Staff,0,2,30,30
1649887320572,MATH 103B,A02,083457,Staff,0,2,30,30
1649887326598,MATH 109,A01,084146,Salehi Golsefidy; Alireza,29,0,30,1
1649887326598,MATH 109,A02,084147,Salehi Golsefidy; Alireza,25,0,30,5
1649887332621,MATH 120A,A01,085445,Eggers; John Dietrich,22,0,35,13
1649887332621,MATH 120A,A02,085446,Eggers; John Dietrich,29,0,35,6
1649887338656,MATH 142B,A01,084149,Verstraete; Jacques Allan,0,1,30,30
1649887338656,MATH 142B,A02,084150,Verstraete; Jacques Allan,3,0,30,27
1649887344686,MATH 170A,A01,083459,Nie; Jiawang,0,1,30,30
1649887344686,MATH 170A,A02,083460,Nie; Jiawang,15,0,30,15
1649887344686,MATH 170A,A03,083461,Nie; Jiawang,20,0,30,10
1649887350713,MATH 193B,A01,083463,Staff,9,0,30,21
1649887350713,MATH 193B,A02,083464,Staff,16,0,30,14
1649887350713,MATH 193B,A03,083465,Staff,25,0,30,5
1649887356774,COGS 2,A01,083966,Boyle; Mary E. T.,22,0,30,8
1649887362805,COGS 9,A01,083968,Staff,48,0,60,12
1649887368848,COGS 14B,A01,083970,Staff,40,0,50,10
1649887374873,COGS 17,A01,092679,Staff,68,0,75,7
1649887380910,COGS 100,A01,083972,Staff,34,0,60,26
1649887392970,COGS 101C,A01,083976,Staff,22,0,30,8
1649887399000,COGS 102A,A01,083978,Johnson; Christine M.,20,0,30,10
1649887405020,COGS 107B,A01,083980,Staff,18,0,50,32
1649887411046,COGS 115,A01,083982,Staff,13,0,30,17
1649887417074,COGS 118B,A01,083367,Staff,0,6,40,40
1649887423098,COGS 172,A01,083984,Provenzano; Emily Kara,17,0,30,13
1649887429122,COGS 177,A00,083368,Staff,1,11,30,29
1649887435154,COGS 186,A01,083986,Staff,23,0,40,17
1649887441185,COGS 187A,A01,083988,Boyle; Mary E. T.,28,0,60,32
1649887447212,CSE 8A,A50,084003,Miranda; Gregory Joseph,6,0,15,9
1649887453239,CSE 11,A01,084005,Miranda; Gregory Joseph,41,0,55,14
1649887459264,CSE 20,A01,084007,Staff,13,0,20,7
1649887465288,CSE 21,A01,084009,Staff,21,0,50,29
1649887471312,CSE 30,A01,083370,Cao; Yingjun,1,0,40,39
1649887477413,CSE 100,A01,083372,Cao; Yingjun,0,7,40,40
1649887483439,CSE 101,A01,084011,Staff,1,35,40,39
1649887489465,CSE 141,A01,083374,Eldon; John,1,41,75,74
1649887495495,CSE 141L,A01,083376,Eldon; John,1,44,75,74
1649887501525,CSE 175,A01,084013,Kumar; Rakesh,22,0,25,3
1649887507560,CSE 190,A00,092508,Dubnov; Shlomo,15,0,15,0
1649887513583,ECE 5,A01,084049,Morris; Karcher William,16,0,20,4
1649887519627,ECE 100,A01,084051,Baghdadchi; Saharnaz,7,0,20,13
1649887519627,ECE 100,A02,091916,Baghdadchi; Saharnaz,18,0,20,2
1649887525654,ECE 101,A01,084053,Baghdadchi; Saharnaz,14,0,37,23
1649887525654,ECE 101,A02,084054,Baghdadchi; Saharnaz,37,0,37,0
1649887531684,ECE 107,A01,083390,Staff,30,0,40,10
1649887537711,ECE 148,A01,084056,Silberman; Jack,7,0,12,5
1649887543745,ECE 180,A00,083391,Abi Samra; Nicholas Camill,25,0,30,5
1649887543745,ECE 180,B00,083392,Abi Samra; Nicholas Camill,23,0,30,7
1649887549775,MATH 10B,A01,084110,Staff,15,0,30,15
1649887549775,MATH 10B,A02,084111,Staff,29,0,30,1
1649887549775,MATH 10B,A03,084112,Staff,29,0,30,1
1649887555805,MATH 10C,A01,083443,Staff,14,0,30,16
1649887555805,MATH 10C,A02,083444,Staff,17,0,30,13
1649887555805,MATH 10C,B01,084114,Staff,26,0,30,4
1649887555805,MATH 10C,B02,084115,Staff,30,0,30,0
1649887561832,MATH 18,A01,084117,Harel; Guershon,27,0,30,3
1649887561832,MATH 18,A02,084119,Harel; Guershon,29,0,30,1
1649887561832,MATH 18,A03,084120,Harel; Guershon,30,0,30,0
1649887561832,MATH 18,A04,084121,Harel; Guershon,30,0,30,0
1649887567869,MATH 20B,A01,084124,Um; Ko Woon,32,0,35,3
1649887567869,MATH 20B,B01,084126,Um; Ko Woon,33,0,35,2
1649887573901,MATH 20C,A01,083446,Hammock; Frances H,23,0,30,7
1649887573901,MATH 20C,A02,083447,Hammock; Frances H,29,0,30,1
1649887573901,MATH 20C,A03,083448,Hammock; Frances H,30,0,30,0
1649887573901,MATH 20C,A04,083449,Hammock; Frances H,30,0,30,0
1649887573901,MATH 20C,B01,083451,Hammock; Frances H,28,0,30,2
1649887573901,MATH 20C,B02,083452,Hammock; Frances H,29,0,30,1
1649887573901,MATH 20C,B03,083453,Hammock; Frances H,30,0,30,0
1649887573901,MATH 20C,B04,083454,Hammock; Frances H,30,0,30,0
1649887579926,MATH 20D,A01,084128,Staff,29,0,30,1
1649887579926,MATH 20D,A02,084129,Staff,30,0,30,0
1649887579926,MATH 20D,A03,084130,Staff,29,0,30,1
1649887579926,MATH 20D,B01,084133,Staff,28,0,30,2
1649887579926,MATH 20D,B02,084134,Staff,29,0,30,1
1649887579926,MATH 20D,B03,084135,Staff,30,0,30,0
1649887585951,MATH 20E,A01,084138,Staff,25,0,30,5
1649887585951,MATH 20E,A02,084139,Staff,26,0,30,4
1649887585951,MATH 20E,A03,084140,Staff,25,0,30,5
1649887585951,MATH 20E,A04,084141,Staff,28,0,30,2
1649887591983,MATH 102,A01,084143,Harel; Guershon,21,0,30,9
1649887591983,MATH 102,A02,084144,Harel; Guershon,23,0,30,7
1649887598009,MATH 103B,A01,083456,Staff,0,2,30,30
1649887598009,MATH 103B,A02,083457,Staff,0,2,30,30
1649887604038,MATH 109,A01,084146,Salehi Golsefidy; Alireza,29,0,30,1
1649887604038,MATH 109,A02,084147,Salehi Golsefidy; Alireza,25,0,30,5
1649887610061,MATH 120A,A01,085445,Eggers; John Dietrich,22,0,35,13
1649887610061,MATH 120A,A02,085446,Eggers; John Dietrich,29,0,35,6
1649887616086,MATH 142B,A01,084149,Verstraete; Jacques Allan,0,1,30,30
1649887616086,MATH 142B,A02,084150,Verstraete; Jacques Allan,3,0,30,27
1649887622117,MATH 170A,A01,083459,Nie; Jiawang,0,1,30,30
1649887622117,MATH 170A,A02,083460,Nie; Jiawang,15,0,30,15
1649887622117,MATH 170A,A03,083461,Nie; Jiawang,20,0,30,10
1649887628144,MATH 193B,A01,083463,Staff,8,0,30,22
1649887628144,MATH 193B,A02,083464,Staff,16,0,30,14
1649887628144,MATH 193B,A03,083465,Staff,25,0,30,5
1649887634228,COGS 2,A01,083966,Boyle; Mary E. T.,22,0,30,8
1649887640258,COGS 9,A01,083968,Staff,48,0,60,12
1649887646287,COGS 14B,A01,083970,Staff,40,0,50,10
1649887652320,COGS 17,A01,092679,Staff,68,0,75,7
1649887658347,COGS 100,A01,083972,Staff,34,0,60,26
1649887670399,COGS 101C,A01,083976,Staff,22,0,30,8
1649887676425,COGS 102A,A01,083978,Johnson; Christine M.,20,0,30,10
1649887682450,COGS 107B,A01,083980,Staff,18,0,50,32
1649887688477,COGS 115,A01,083982,Staff,13,0,30,17
1649887694502,COGS 118B,A01,083367,Staff,0,6,40,40
1649887714299,COGS 172,A01,083984,Provenzano; Emily Kara,17,0,30,13
1649887720326,COGS 177,A00,083368,Staff,1,12,30,29
1649887726353,COGS 186,A01,083986,Staff,23,0,40,17
1649887732393,COGS 187A,A01,083988,Boyle; Mary E. T.,28,0,60,32
1649887738419,CSE 8A,A50,084003,Miranda; Gregory Joseph,6,0,15,9
1649887744448,CSE 11,A01,084005,Miranda; Gregory Joseph,41,0,55,14
1649887750473,CSE 20,A01,084007,Staff,13,0,20,7
1649887756497,CSE 21,A01,084009,Staff,20,0,50,30
1649887762524,CSE 30,A01,083370,Cao; Yingjun,1,0,40,39
1649887768551,CSE 100,A01,083372,Cao; Yingjun,0,7,40,40
1649887774582,CSE 101,A01,084011,Staff,1,36,40,39
1649887780604,CSE 141,A01,083374,Eldon; John,1,41,75,74
1649887786631,CSE 141L,A01,083376,Eldon; John,1,44,75,74
1649887792653,CSE 175,A01,084013,Kumar; Rakesh,22,0,25,3
1649887798678,CSE 190,A00,092508,Dubnov; Shlomo,15,0,15,0
1649887804705,ECE 5,A01,084049,Morris; Karcher William,16,0,20,4
1649887810728,ECE 100,A01,084051,Baghdadchi; Saharnaz,7,0,20,13
1649887810728,ECE 100,A02,091916,Baghdadchi; Saharnaz,18,0,20,2
1649887816753,ECE 101,A01,084053,Baghdadchi; Saharnaz,14,0,37,23
1649887816753,ECE 101,A02,084054,Baghdadchi; Saharnaz,37,0,37,0
1649887822781,ECE 107,A01,083390,Staff,30,0,40,10
1649887828812,ECE 148,A01,084056,Silberman; Jack,7,0,12,5
1649887834835,ECE 180,A00,083391,Abi Samra; Nicholas Camill,25,0,30,5
1649887834835,ECE 180,B00,083392,Abi Samra; Nicholas Camill,23,0,30,7
1649887840865,MATH 10B,A01,084110,Staff,15,0,30,15
1649887840865,MATH 10B,A02,084111,Staff,29,0,30,1
1649887840865,MATH 10B,A03,084112,Staff,29,0,30,1
1649887846900,MATH 10C,A01,083443,Staff,14,0,30,16
1649887846900,MATH 10C,A02,083444,Staff,17,0,30,13
1649887846900,MATH 10C,B01,084114,Staff,26,0,30,4
1649887846900,MATH 10C,B02,084115,Staff,30,0,30,0
1649887852929,MATH 18,A01,084117,Harel; Guershon,27,0,30,3
1649887852929,MATH 18,A02,084119,Harel; Guershon,29,0,30,1
1649887852929,MATH 18,A03,084120,Harel; Guershon,30,0,30,0
1649887852929,MATH 18,A04,084121,Harel; Guershon,30,0,30,0
1649887858958,MATH 20B,A01,084124,Um; Ko Woon,32,0,35,3
1649887858958,MATH 20B,B01,084126,Um; Ko Woon,33,0,35,2
1649887864997,MATH 20C,A01,083446,Hammock; Frances H,23,0,30,7
1649887864997,MATH 20C,A02,083447,Hammock; Frances H,29,0,30,1
1649887864997,MATH 20C,A03,083448,Hammock; Frances H,30,0,30,0
1649887864997,MATH 20C,A04,083449,Hammock; Frances H,30,0,30,0
1649887864997,MATH 20C,B01,083451,Hammock; Frances H,28,0,30,2
1649887864997,MATH 20C,B02,083452,Hammock; Frances H,29,0,30,1
1649887864997,MATH 20C,B03,083453,Hammock; Frances H,30,0,30,0
1649887864997,MATH 20C,B04,083454,Hammock; Frances H,30,0,30,0
1649887871032,MATH 20D,A01,084128,Staff,29,0,30,1
1649887871032,MATH 20D,A02,084129,Staff,30,0,30,0
1649887871032,MATH 20D,A03,084130,Staff,29,0,30,1
1649887871032,MATH 20D,B01,084133,Staff,28,0,30,2
1649887871032,MATH 20D,B02,084134,Staff,29,0,30,1
1649887871032,MATH 20D,B03,084135,Staff,30,0,30,0
1649887877076,MATH 20E,A01,084138,Staff,25,0,30,5
1649887877076,MATH 20E,A02,084139,Staff,26,0,30,4
1649887877076,MATH 20E,A03,084140,Staff,25,0,30,5
1649887877076,MATH 20E,A04,084141,Staff,28,0,30,2
1649887883111,MATH 102,A01,084143,Harel; Guershon,21,0,30,9
1649887883111,MATH 102,A02,084144,Harel; Guershon,23,0,30,7
1649887889140,MATH 103B,A01,083456,Staff,0,2,30,30
1649887889140,MATH 103B,A02,083457,Staff,0,2,30,30
1649887895182,MATH 109,A01,084146,Salehi Golsefidy; Alireza,29,0,30,1
1649887895182,MATH 109,A02,084147,Salehi Golsefidy; Alireza,25,0,30,5
1649887901208,MATH 120A,A01,085445,Eggers; John Dietrich,22,0,35,13
1649887901208,MATH 120A,A02,085446,Eggers; John Dietrich,29,0,35,6
1649887907239,MATH 142B,A01,084149,Verstraete; Jacques Allan,0,1,30,30
1649887907239,MATH 142B,A02,084150,Verstraete; Jacques Allan,3,0,30,27
1649887913274,MATH 170A,A01,083459,Nie; Jiawang,0,1,30,30
1649887913274,MATH 170A,A02,083460,Nie; Jiawang,15,0,30,15
1649887913274,MATH 170A,A03,083461,Nie; Jiawang,20,0,30,10
1649887919300,MATH 193B,A01,083463,Staff,8,0,30,22
1649887919300,MATH 193B,A02,083464,Staff,16,0,30,14
1649887919300,MATH 193B,A03,083465,Staff,25,0,30,5
1649887925380,COGS 2,A01,083966,Boyle; Mary E. T.,22,0,30,8
1649887931408,COGS 9,A01,083968,Staff,48,0,60,12
1649887937435,COGS 14B,A01,083970,Staff,40,0,50,10
1649887943475,COGS 17,A01,092679,Staff,68,0,75,7
1649887949500,COGS 100,A01,083972,Staff,34,0,60,26
1649887961546,COGS 101C,A01,083976,Staff,22,0,30,8
1649887967572,COGS 102A,A01,083978,Johnson; Christine M.,20,0,30,10
1649887973598,COGS 107B,A01,083980,Staff,18,0,50,32
1649887979620,COGS 115,A01,083982,Staff,13,0,30,17
1649887985656,COGS 118B,A01,083367,Staff,0,6,40,40
1649887991692,COGS 172,A01,083984,Provenzano; Emily Kara,17,0,30,13
1649887997725,COGS 177,A00,083368,Staff,1,12,30,29
1649888003752,COGS 186,A01,083986,Staff,23,0,40,17
1649888009784,COGS 187A,A01,083988,Boyle; Mary E. T.,28,0,60,32
1649888015807,CSE 8A,A50,084003,Miranda; Gregory Joseph,6,0,15,9
1649888021830,CSE 11,A01,084005,Miranda; Gregory Joseph,41,0,55,14
1649888027854,CSE 20,A01,084007,Staff,13,0,20,7
1649888033877,CSE 21,A01,084009,Staff,20,0,50,30
1649888039906,CSE 30,A01,083370,Cao; Yingjun,1,0,40,39
1649888045929,CSE 100,A01,083372,Cao; Yingjun,0,7,40,40
1649888051955,CSE 101,A01,084011,Staff,1,36,40,39
1649888057978,CSE 141,A01,083374,Eldon; John,1,41,75,74
1649888064005,CSE 141L,A01,083376,Eldon; John,1,44,75,74
1649888070031,CSE 175,A01,084013,Kumar; Rakesh,22,0,25,3
1649888076055,CSE 190,A00,092508,Dubnov; Shlomo,15,0,15,0
1649888082078,ECE 5,A01,084049,Morris; Karcher William,16,0,20,4
1649888088248,ECE 100,A01,084051,Baghdadchi; Saharnaz,7,0,20,13
1649888088248,ECE 100,A02,091916,Baghdadchi; Saharnaz,18,0,20,2
1649888094274,ECE 101,A01,084053,Baghdadchi; Saharnaz,14,0,37,23
1649888094274,ECE 101,A02,084054,Baghdadchi; Saharnaz,37,0,37,0
1649888100301,ECE 107,A01,083390,Staff,30,0,40,10
1649888106333,ECE 148,A01,084056,Silberman; Jack,7,0,12,5
1649888112355,ECE 180,A00,083391,Abi Samra; Nicholas Camill,25,0,30,5
1649888112355,ECE 180,B00,083392,Abi Samra; Nicholas Camill,23,0,30,7
1649888118389,MATH 10B,A01,084110,Staff,14,0,30,16
1649888118389,MATH 10B,A02,084111,Staff,29,0,30,1
1649888118389,MATH 10B,A03,084112,Staff,29,0,30,1
1649888124417,MATH 10C,A01,083443,Staff,14,0,30,16
1649888124417,MATH 10C,A02,083444,Staff,17,0,30,13
1649888124417,MATH 10C,B01,084114,Staff,26,0,30,4
1649888124417,MATH 10C,B02,084115,Staff,30,0,30,0
1649888130450,MATH 18,A01,084117,Harel; Guershon,27,0,30,3
1649888130450,MATH 18,A02,084119,Harel; Guershon,29,0,30,1
1649888130450,MATH 18,A03,084120,Harel; Guershon,30,0,30,0
1649888130450,MATH 18,A04,084121,Harel; Guershon,30,0,30,0
1649888136475,MATH 20B,A01,084124,Um; Ko Woon,32,0,35,3
1649888136475,MATH 20B,B01,084126,Um; Ko Woon,33,0,35,2
1649888142510,MATH 20C,A01,083446,Hammock; Frances H,23,0,30,7
1649888142510,MATH 20C,A02,083447,Hammock; Frances H,28,0,30,2
1649888142510,MATH 20C,A03,083448,Hammock; Frances H,30,0,30,0
1649888142510,MATH 20C,A04,083449,Hammock; Frances H,30,0,30,0
1649888142510,MATH 20C,B01,083451,Hammock; Frances H,28,0,30,2
1649888142510,MATH 20C,B02,083452,Hammock; Frances H,29,0,30,1
1649888142510,MATH 20C,B03,083453,Hammock; Frances H,30,0,30,0
1649888142510,MATH 20C,B04,083454,Hammock; Frances H,30,0,30,0
1649888148543,MATH 20D,A01,084128,Staff,29,0,30,1
1649888148543,MATH 20D,A02,084129,Staff,30,0,30,0
1649888148543,MATH 20D,A03,084130,Staff,29,0,30,1
1649888148543,MATH 20D,B01,084133,Staff,28,0,30,2
1649888148543,MATH 20D,B02,084134,Staff,29,0,30,1
1649888148543,MATH 20D,B03,084135,Staff,30,0,30,0
1649888154571,MATH 20E,A01,084138,Staff,25,0,30,5
1649888154571,MATH 20E,A02,084139,Staff,26,0,30,4
1649888154571,MATH 20E,A03,084140,Staff,25,0,30,5
1649888154571,MATH 20E,A04,084141,Staff,28,0,30,2
1649888160599,MATH 102,A01,084143,Harel; Guershon,22,0,30,8
1649888160599,MATH 102,A02,084144,Harel; Guershon,23,0,30,7
1649888166621,MATH 103B,A01,083456,Staff,0,2,30,30
1649888166621,MATH 103B,A02,083457,Staff,0,2,30,30
1649888172655,MATH 109,A01,084146,Salehi Golsefidy; Alireza,29,0,30,1
1649888172655,MATH 109,A02,084147,Salehi Golsefidy; Alireza,25,0,30,5
1649888178683,MATH 120A,A01,085445,Eggers; John Dietrich,22,0,35,13
1649888178683,MATH 120A,A02,085446,Eggers; John Dietrich,29,0,35,6
1649888184711,MATH 142B,A01,084149,Verstraete; Jacques Allan,0,1,30,30
1649888184711,MATH 142B,A02,084150,Verstraete; Jacques Allan,3,0,30,27
1649888190733,MATH 170A,A01,083459,Nie; Jiawang,0,1,30,30
1649888190733,MATH 170A,A02,083460,Nie; Jiawang,15,0,30,15
1649888190733,MATH 170A,A03,083461,Nie; Jiawang,20,0,30,10
1649888196756,MATH 193B,A01,083463,Staff,8,0,30,22
1649888196756,MATH 193B,A02,083464,Staff,16,0,30,14
1649888196756,MATH 193B,A03,083465,Staff,25,0,30,5
1649888202818,COGS 2,A01,083966,Boyle; Mary E. T.,22,0,30,8
1649888208841,COGS 9,A01,083968,Staff,48,0,60,12
1649888214864,COGS 14B,A01,083970,Staff,40,0,50,10
1649888220887,COGS 17,A01,092679,Staff,68,0,75,7
1649888226920,COGS 100,A01,083972,Staff,34,0,60,26
1649888238969,COGS 101C,A01,083976,Staff,22,0,30,8
1649888244991,COGS 102A,A01,083978,Johnson; Christine M.,20,0,30,10
1649888251017,COGS 107B,A01,083980,Staff,18,0,50,32
1649888257051,COGS 115,A01,083982,Staff,13,0,30,17
1649888263085,COGS 118B,A01,083367,Staff,0,6,40,40
1649888269111,COGS 172,A01,083984,Provenzano; Emily Kara,17,0,30,13
1649888275135,COGS 177,A00,083368,Staff,1,12,30,29
1649888281158,COGS 186,A01,083986,Staff,23,0,40,17
1649888287180,COGS 187A,A01,083988,Boyle; Mary E. T.,28,0,60,32
1649888293214,CSE 8A,A50,084003,Miranda; Gregory Joseph,6,0,15,9
1649888299238,CSE 11,A01,084005,Miranda; Gregory Joseph,41,0,55,14
1649888305266,CSE 20,A01,084007,Staff,13,0,20,7
1649888311290,CSE 21,A01,084009,Staff,20,0,50,30
1649888317316,CSE 30,A01,083370,Cao; Yingjun,1,0,40,39
1649888323339,CSE 100,A01,083372,Cao; Yingjun,0,8,40,40
1649888329383,CSE 101,A01,084011,Staff,1,36,40,39
1649888335410,CSE 141,A01,083374,Eldon; John,1,41,75,74
1649888341433,CSE 141L,A01,083376,Eldon; John,1,44,75,74
1649888347459,CSE 175,A01,084013,Kumar; Rakesh,22,0,25,3
1649888353494,CSE 190,A00,092508,Dubnov; Shlomo,15,0,15,0
1649888359518,ECE 5,A01,084049,Morris; Karcher William,16,0,20,4
1649888365542,ECE 100,A01,084051,Baghdadchi; Saharnaz,7,0,20,13
1649888365542,ECE 100,A02,091916,Baghdadchi; Saharnaz,18,0,20,2
1649888371564,ECE 101,A01,084053,Baghdadchi; Saharnaz,14,0,37,23
1649888371564,ECE 101,A02,084054,Baghdadchi; Saharnaz,37,0,37,0
1649888377587,ECE 107,A01,083390,Staff,30,0,40,10
1649888383610,ECE 148,A01,084056,Silberman; Jack,7,0,12,5
1649888389638,ECE 180,A00,083391,Abi Samra; Nicholas Camill,25,0,30,5
1649888389638,ECE 180,B00,083392,Abi Samra; Nicholas Camill,23,0,30,7
1649888395659,MATH 10B,A01,084110,Staff,14,0,30,16
1649888395659,MATH 10B,A02,084111,Staff,29,0,30,1
1649888395659,MATH 10B,A03,084112,Staff,28,0,30,2
1649888401694,MATH 10C,A01,083443,Staff,14,0,30,16
1649888401694,MATH 10C,A02,083444,Staff,17,0,30,13
1649888401694,MATH 10C,B01,084114,Staff,26,0,30,4
1649888401694,MATH 10C,B02,084115,Staff,30,0,30,0
1649888407722,MATH 18,A01,084117,Harel; Guershon,27,0,30,3
1649888407722,MATH 18,A02,084119,Harel; Guershon,29,0,30,1
1649888407722,MATH 18,A03,084120,Harel; Guershon,30,0,30,0
1649888407722,MATH 18,A04,084121,Harel; Guershon,30,0,30,0
1649888413745,MATH 20B,A01,084124,Um; Ko Woon,32,0,35,3
1649888413745,MATH 20B,B01,084126,Um; Ko Woon,33,0,35,2
1649888419798,MATH 20C,A01,083446,Hammock; Frances H,23,0,30,7
1649888419798,MATH 20C,A02,083447,Hammock; Frances H,28,0,30,2
1649888419798,MATH 20C,A03,083448,Hammock; Frances H,30,0,30,0
1649888419798,MATH 20C,A04,083449,Hammock; Frances H,30,0,30,0
1649888419798,MATH 20C,B01,083451,Hammock; Frances H,28,0,30,2
1649888419798,MATH 20C,B02,083452,Hammock; Frances H,29,0,30,1
1649888419798,MATH 20C,B03,083453,Hammock; Frances H,30,0,30,0
1649888419798,MATH 20C,B04,083454,Hammock; Frances H,30,0,30,0
1649888425825,MATH 20D,A01,084128,Staff,29,0,30,1
1649888425825,MATH 20D,A02,084129,Staff,30,0,30,0
1649888425825,MATH 20D,A03,084130,Staff,29,0,30,1
1649888425825,MATH 20D,B01,084133,Staff,28,0,30,2
1649888425825,MATH 20D,B02,084134,Staff,29,0,30,1
1649888425825,MATH 20D,B03,084135,Staff,30,0,30,0
1649888431852,MATH 20E,A01,084138,Staff,25,0,30,5
1649888431852,MATH 20E,A02,084139,Staff,26,0,30,4
1649888431852,MATH 20E,A03,084140,Staff,25,0,30,5
1649888431852,MATH 20E,A04,084141,Staff,28,0,30,2
1649888437875,MATH 102,A01,084143,Harel; Guershon,22,0,30,8
1649888437875,MATH 102,A02,084144,Harel; Guershon,23,0,30,7
1649888443910,MATH 103B,A01,083456,Staff,0,2,30,30
1649888443910,MATH 103B,A02,083457,Staff,0,2,30,30
1649888449940,MATH 109,A01,084146,Salehi Golsefidy; Alireza,29,0,30,1
1649888449940,MATH 109,A02,084147,Salehi Golsefidy; Alireza,25,0,30,5
1649888455974,MATH 120A,A01,085445,Eggers; John Dietrich,22,0,35,13
1649888455974,MATH 120A,A02,085446,Eggers; John Dietrich,29,0,35,6
1649888462004,MATH 142B,A01,084149,Verstraete; Jacques Allan,0,1,30,30
1649888462004,MATH 142B,A02,084150,Verstraete; Jacques Allan,3,0,30,27
1649888468030,MATH 170A,A01,083459,Nie; Jiawang,0,1,30,30
1649888468030,MATH 170A,A02,083460,Nie; Jiawang,15,0,30,15
1649888468030,MATH 170A,A03,083461,Nie; Jiawang,20,0,30,10
1649888474054,MATH 193B,A01,083463,Staff,8,0,30,22
1649888474054,MATH 193B,A02,083464,Staff,16,0,30,14
1649888474054,MATH 193B,A03,083465,Staff,25,0,30,5
1649888480109,COGS 2,A01,083966,Boyle; Mary E. T.,22,0,30,8
1649888486142,COGS 9,A01,083968,Staff,48,0,60,12
1649888492174,COGS 14B,A01,083970,Staff,40,0,50,10
1649888498199,COGS 17,A01,092679,Staff,68,0,75,7
1649888504226,COGS 100,A01,083972,Staff,34,0,60,26
1649888516355,COGS 101C,A01,083976,Staff,22,0,30,8
1649888522385,COGS 102A,A01,083978,Johnson; Christine M.,19,0,30,11
1649888528419,COGS 107B,A01,083980,Staff,18,0,50,32
1649888534443,COGS 115,A01,083982,Staff,13,0,30,17
1649888540467,COGS 118B,A01,083367,Staff,0,6,40,40
1649888546495,COGS 172,A01,083984,Provenzano; Emily Kara,17,0,30,13
1649888552520,COGS 177,A00,083368,Staff,1,12,30,29
1649888558549,COGS 186,A01,083986,Staff,23,0,40,17
1649888564591,COGS 187A,A01,083988,Boyle; Mary E. T.,28,0,60,32
1649888570617,CSE 8A,A50,084003,Miranda; Gregory Joseph,6,0,15,9
1649888576644,CSE 11,A01,084005,Miranda; Gregory Joseph,41,0,55,14
1649888582673,CSE 20,A01,084007,Staff,13,0,20,7
1649888588702,CSE 21,A01,084009,Staff,20,0,50,30
1649888594724,CSE 30,A01,083370,Cao; Yingjun,1,0,40,39
1649888600758,CSE 100,A01,083372,Cao; Yingjun,0,8,40,40
1649888606787,CSE 101,A01,084011,Staff,1,36,40,39
1649888612810,CSE 141,A01,083374,Eldon; John,1,41,75,74
1649888618833,CSE 141L,A01,083376,Eldon; John,1,44,75,74
1649888624856,CSE 175,A01,084013,Kumar; Rakesh,22,0,25,3
1649888630882,CSE 190,A00,092508,Dubnov; Shlomo,15,0,15,0
1649888636907,ECE 5,A01,084049,Morris; Karcher William,16,0,20,4
1649888642936,ECE 100,A01,084051,Baghdadchi; Saharnaz,7,0,20,13
1649888642936,ECE 100,A02,091916,Baghdadchi; Saharnaz,18,0,20,2
1649888648962,ECE 101,A01,084053,Baghdadchi; Saharnaz,13,0,37,24
1649888648962,ECE 101,A02,084054,Baghdadchi; Saharnaz,37,0,37,0
1649888654998,ECE 107,A01,083390,Staff,30,0,40,10
1649888661021,ECE 148,A01,084056,Silberman; Jack,7,0,12,5
1649888667044,ECE 180,A00,083391,Abi Samra; Nicholas Camill,25,0,30,5
1649888667044,ECE 180,B00,083392,Abi Samra; Nicholas Camill,23,0,30,7
1649888673066,MATH 10B,A01,084110,Staff,14,0,30,16
1649888673066,MATH 10B,A02,084111,Staff,29,0,30,1
1649888673066,MATH 10B,A03,084112,Staff,28,0,30,2
1649888679094,MATH 10C,A01,083443,Staff,14,0,30,16
1649888679094,MATH 10C,A02,083444,Staff,17,0,30,13
1649888679094,MATH 10C,B01,084114,Staff,26,0,30,4
1649888679094,MATH 10C,B02,084115,Staff,30,0,30,0
1649888685235,MATH 18,A01,084117,Harel; Guershon,27,0,30,3
1649888685235,MATH 18,A02,084119,Harel; Guershon,29,0,30,1
1649888685235,MATH 18,A03,084120,Harel; Guershon,30,0,30,0
1649888685235,MATH 18,A04,084121,Harel; Guershon,30,0,30,0
1649888691260,MATH 20B,A01,084124,Um; Ko Woon,32,0,35,3
1649888691260,MATH 20B,B01,084126,Um; Ko Woon,33,0,35,2
1649888697292,MATH 20C,A01,083446,Hammock; Frances H,23,0,30,7
1649888697292,MATH 20C,A02,083447,Hammock; Frances H,28,0,30,2
1649888697292,MATH 20C,A03,083448,Hammock; Frances H,30,0,30,0
1649888697292,MATH 20C,A04,083449,Hammock; Frances H,30,0,30,0
1649888697292,MATH 20C,B01,083451,Hammock; Frances H,27,0,30,3
1649888697292,MATH 20C,B02,083452,Hammock; Frances H,29,0,30,1
1649888697292,MATH 20C,B03,083453,Hammock; Frances H,30,0,30,0
1649888697292,MATH 20C,B04,083454,Hammock; Frances H,30,0,30,0
1649888703318,MATH 20D,A01,084128,Staff,29,0,30,1
1649888703318,MATH 20D,A02,084129,Staff,30,0,30,0
1649888703318,MATH 20D,A03,084130,Staff,29,0,30,1
1649888703318,MATH 20D,B01,084133,Staff,28,0,30,2
1649888703318,MATH 20D,B02,084134,Staff,29,0,30,1
1649888703318,MATH 20D,B03,084135,Staff,30,0,30,0
1649888709348,MATH 20E,A01,084138,Staff,25,0,30,5
1649888709348,MATH 20E,A02,084139,Staff,25,0,30,5
1649888709348,MATH 20E,A03,084140,Staff,25,0,30,5
1649888709348,MATH 20E,A04,084141,Staff,28,0,30,2
1649888715373,MATH 102,A01,084143,Harel; Guershon,22,0,30,8
1649888715373,MATH 102,A02,084144,Harel; Guershon,23,0,30,7
1649888721409,MATH 103B,A01,083456,Staff,0,2,30,30
1649888721409,MATH 103B,A02,083457,Staff,0,2,30,30
1649888727433,MATH 109,A01,084146,Salehi Golsefidy; Alireza,29,0,30,1
1649888727433,MATH 109,A02,084147,Salehi Golsefidy; Alireza,25,0,30,5
1649888733456,MATH 120A,A01,085445,Eggers; John Dietrich,22,0,35,13
1649888733456,MATH 120A,A02,085446,Eggers; John Dietrich,29,0,35,6
1649888739484,MATH 142B,A01,084149,Verstraete; Jacques Allan,0,1,30,30
1649888739484,MATH 142B,A02,084150,Verstraete; Jacques Allan,3,0,30,27
1649888745517,MATH 170A,A01,083459,Nie; Jiawang,0,1,30,30
1649888745517,MATH 170A,A02,083460,Nie; Jiawang,14,0,30,16
1649888745517,MATH 170A,A03,083461,Nie; Jiawang,20,0,30,10
1649888751542,MATH 193B,A01,083463,Staff,8,0,30,22
1649888751542,MATH 193B,A02,083464,Staff,16,0,30,14
1649888751542,MATH 193B,A03,083465,Staff,25,0,30,5
1649888757624,COGS 2,A01,083966,Boyle; Mary E. T.,22,0,30,8
1649888763653,COGS 9,A01,083968,Staff,48,0,60,12
1649888769687,COGS 14B,A01,083970,Staff,40,0,50,10
1649888775719,COGS 17,A01,092679,Staff,68,0,75,7
1649888781753,COGS 100,A01,083972,Staff,34,0,60,26
1649888793800,COGS 101C,A01,083976,Staff,22,0,30,8
1649888799828,COGS 102A,A01,083978,Johnson; Christine M.,19,0,30,11
1649888805852,COGS 107B,A01,083980,Staff,17,0,50,33
1649888811891,COGS 115,A01,083982,Staff,13,0,30,17
1649888817913,COGS 118B,A01,083367,Staff,0,6,40,40
1649888823937,COGS 172,A01,083984,Provenzano; Emily Kara,17,0,30,13
1649888829960,COGS 177,A00,083368,Staff,1,12,30,29
1649888835994,COGS 186,A01,083986,Staff,23,0,40,17
1649888842026,COGS 187A,A01,083988,Boyle; Mary E. T.,27,0,60,33
1649888848054,CSE 8A,A50,084003,Miranda; Gregory Joseph,6,0,15,9
1649888854087,CSE 11,A01,084005,Miranda; Gregory Joseph,41,0,55,14
1649888860113,CSE 20,A01,084007,Staff,13,0,20,7
1649888866146,CSE 21,A01,084009,Staff,20,0,50,30
1649888872181,CSE 30,A01,083370,Cao; Yingjun,1,0,40,39
1649888878204,CSE 100,A01,083372,Cao; Yingjun,0,8,40,40
1649888884228,CSE 101,A01,084011,Staff,1,36,40,39
1649888890259,CSE 141,A01,083374,Eldon; John,1,42,75,74
1649888896282,CSE 141L,A01,083376,Eldon; John,1,45,75,74
1649888902306,CSE 175,A01,084013,Kumar; Rakesh,22,0,25,3
1649888908339,CSE 190,A00,092508,Dubnov; Shlomo,15,0,15,0
1649888914373,ECE 5,A01,084049,Morris; Karcher William,16,0,20,4
1649888920398,ECE 100,A01,084051,Baghdadchi; Saharnaz,6,0,20,14
1649888920398,ECE 100,A02,091916,Baghdadchi; Saharnaz,18,0,20,2
1649888926423,ECE 101,A01,084053,Baghdadchi; Saharnaz,13,0,37,24
1649888926423,ECE 101,A02,084054,Baghdadchi; Saharnaz,37,0,37,0
1649888932445,ECE 107,A01,083390,Staff,30,0,40,10
1649888938476,ECE 148,A01,084056,Silberman; Jack,7,0,12,5
1649888944505,ECE 180,A00,083391,Abi Samra; Nicholas Camill,25,0,30,5
1649888944505,ECE 180,B00,083392,Abi Samra; Nicholas Camill,23,0,30,7
1649888950528,MATH 10B,A01,084110,Staff,14,0,30,16
1649888950528,MATH 10B,A02,084111,Staff,29,0,30,1
1649888950528,MATH 10B,A03,084112,Staff,28,0,30,2
1649888956557,MATH 10C,A01,083443,Staff,14,0,30,16
1649888956557,MATH 10C,A02,083444,Staff,17,0,30,13
1649888956557,MATH 10C,B01,084114,Staff,26,0,30,4
1649888956557,MATH 10C,B02,084115,Staff,30,0,30,0
1649888962580,MATH 18,A01,084117,Harel; Guershon,27,0,30,3
1649888962580,MATH 18,A02,084119,Harel; Guershon,29,0,30,1
1649888962580,MATH 18,A03,084120,Harel; Guershon,30,0,30,0
1649888962580,MATH 18,A04,084121,Harel; Guershon,30,0,30,0
1649888968609,MATH 20B,A01,084124,Um; Ko Woon,32,0,35,3
1649888968609,MATH 20B,B01,084126,Um; Ko Woon,33,0,35,2
1649888974641,MATH 20C,A01,083446,Hammock; Frances H,22,0,30,8
1649888974641,MATH 20C,A02,083447,Hammock; Frances H,28,0,30,2
1649888974641,MATH 20C,A03,083448,Hammock; Frances H,30,0,30,0
1649888974641,MATH 20C,A04,083449,Hammock; Frances H,30,0,30,0
1649888974641,MATH 20C,B01,083451,Hammock; Frances H,27,0,30,3
1649888974641,MATH 20C,B02,083452,Hammock; Frances H,29,0,30,1
1649888974641,MATH 20C,B03,083453,Hammock; Frances H,30,0,30,0
1649888974641,MATH 20C,B04,083454,Hammock; Frances H,30,0,30,0
1649888980665,MATH 20D,A01,084128,Staff,29,0,30,1
1649888980665,MATH 20D,A02,084129,Staff,30,0,30,0
1649888980665,MATH 20D,A03,084130,Staff,29,0,30,1
1649888980665,MATH 20D,B01,084133,Staff,28,0,30,2
1649888980665,MATH 20D,B02,084134,Staff,29,0,30,1
1649888980665,MATH 20D,B03,084135,Staff,30,0,30,0
1649888986692,MATH 20E,A01,084138,Staff,25,0,30,5
1649888986692,MATH 20E,A02,084139,Staff,25,0,30,5
1649888986692,MATH 20E,A03,084140,Staff,25,0,30,5
1649888986692,MATH 20E,A04,084141,Staff,28,0,30,2
1649888992714,MATH 102,A01,084143,Harel; Guershon,22,0,30,8
1649888992714,MATH 102,A02,084144,Harel; Guershon,23,0,30,7
1649888998754,MATH 103B,A01,083456,Staff,0,2,30,30
1649888998754,MATH 103B,A02,083457,Staff,0,2,30,30
1649889004782,MATH 109,A01,084146,Salehi Golsefidy; Alireza,29,0,30,1
1649889004782,MATH 109,A02,084147,Salehi Golsefidy; Alireza,25,0,30,5
1649889010812,MATH 120A,A01,085445,Eggers; John Dietrich,22,0,35,13
1649889010812,MATH 120A,A02,085446,Eggers; John Dietrich,29,0,35,6
1649889016845,MATH 142B,A01,084149,Verstraete; Jacques Allan,0,1,30,30
1649889016845,MATH 142B,A02,084150,Verstraete; Jacques Allan,3,0,30,27
1649889022887,MATH 170A,A01,083459,Nie; Jiawang,0,1,30,30
1649889022887,MATH 170A,A02,083460,Nie; Jiawang,14,0,30,16
1649889022887,MATH 170A,A03,083461,Nie; Jiawang,20,0,30,10
1649889028917,MATH 193B,A01,083463,Staff,8,0,30,22
1649889028917,MATH 193B,A02,083464,Staff,16,0,30,14
1649889028917,MATH 193B,A03,083465,Staff,25,0,30,5
1649889034970,COGS 2,A01,083966,Boyle; Mary E. T.,22,0,30,8
1649889041005,COGS 9,A01,083968,Staff,49,0,60,11
1649889047036,COGS 14B,A01,083970,Staff,40,0,50,10
1649889053058,COGS 17,A01,092679,Staff,68,0,75,7
1649889059085,COGS 100,A01,083972,Staff,34,0,60,26
1649889071137,COGS 101C,A01,083976,Staff,22,0,30,8
1649889077161,COGS 102A,A01,083978,Johnson; Christine M.,19,0,30,11
1649889083186,COGS 107B,A01,083980,Staff,17,0,50,33
1649889089210,COGS 115,A01,083982,Staff,13,0,30,17
1649889095244,COGS 118B,A01,083367,Staff,0,6,40,40
1649889101274,COGS 172,A01,083984,Provenzano; Emily Kara,17,0,30,13
1649889107302,COGS 177,A00,083368,Staff,1,12,30,29
1649889113325,COGS 186,A01,083986,Staff,23,0,40,17
1649889119349,COGS 187A,A01,083988,Boyle; Mary E. T.,27,0,60,33
1649889125382,CSE 8A,A50,084003,Miranda; Gregory Joseph,6,0,15,9
1649889131408,CSE 11,A01,084005,Miranda; Gregory Joseph,40,0,55,15
1649889137431,CSE 20,A01,084007,Staff,13,0,20,7
1649889143456,CSE 21,A01,084009,Staff,20,0,50,30
1649889149482,CSE 30,A01,083370,Cao; Yingjun,1,0,40,39
1649889155513,CSE 100,A01,083372,Cao; Yingjun,0,8,40,40
1649889161535,CSE 101,A01,084011,Staff,1,36,40,39
1649889167558,CSE 141,A01,083374,Eldon; John,1,42,75,74
1649889173581,CSE 141L,A01,083376,Eldon; John,1,45,75,74
1649889179612,CSE 175,A01,084013,Kumar; Rakesh,22,0,25,3
1649889185636,CSE 190,A00,092508,Dubnov; Shlomo,15,0,15,0
1649889191667,ECE 5,A01,084049,Morris; Karcher William,16,0,20,4
1649889197693,ECE 100,A01,084051,Baghdadchi; Saharnaz,6,0,20,14
1649889197693,ECE 100,A02,091916,Baghdadchi; Saharnaz,18,0,20,2
1649889203730,ECE 101,A01,084053,Baghdadchi; Saharnaz,13,0,37,24
1649889203730,ECE 101,A02,084054,Baghdadchi; Saharnaz,37,0,37,0
1649889209756,ECE 107,A01,083390,Staff,30,0,40,10
1649889215779,ECE 148,A01,084056,Silberman; Jack,7,0,12,5
1649889221806,ECE 180,A00,083391,Abi Samra; Nicholas Camill,25,0,30,5
1649889221806,ECE 180,B00,083392,Abi Samra; Nicholas Camill,22,0,30,8
1649889227829,MATH 10B,A01,084110,Staff,14,0,30,16
1649889227829,MATH 10B,A02,084111,Staff,29,0,30,1
1649889227829,MATH 10B,A03,084112,Staff,28,0,30,2
1649889233854,MATH 10C,A01,083443,Staff,14,0,30,16
1649889233854,MATH 10C,A02,083444,Staff,17,0,30,13
1649889233854,MATH 10C,B01,084114,Staff,26,0,30,4
1649889233854,MATH 10C,B02,084115,Staff,30,0,30,0
1649889239898,MATH 18,A01,084117,Harel; Guershon,27,0,30,3
1649889239898,MATH 18,A02,084119,Harel; Guershon,29,0,30,1
1649889239898,MATH 18,A03,084120,Harel; Guershon,30,0,30,0
1649889239898,MATH 18,A04,084121,Harel; Guershon,30,0,30,0
1649889245930,MATH 20B,A01,084124,Um; Ko Woon,32,0,35,3
1649889245930,MATH 20B,B01,084126,Um; Ko Woon,33,0,35,2
1649889251955,MATH 20C,A01,083446,Hammock; Frances H,21,0,30,9
1649889251955,MATH 20C,A02,083447,Hammock; Frances H,28,0,30,2
1649889251955,MATH 20C,A03,083448,Hammock; Frances H,30,0,30,0
1649889251955,MATH 20C,A04,083449,Hammock; Frances H,30,0,30,0
1649889251955,MATH 20C,B01,083451,Hammock; Frances H,26,0,30,4
1649889251955,MATH 20C,B02,083452,Hammock; Frances H,29,0,30,1
1649889251955,MATH 20C,B03,083453,Hammock; Frances H,30,0,30,0
1649889251955,MATH 20C,B04,083454,Hammock; Frances H,30,0,30,0
1649889257978,MATH 20D,A01,084128,Staff,29,0,30,1
1649889257978,MATH 20D,A02,084129,Staff,30,0,30,0
1649889257978,MATH 20D,A03,084130,Staff,29,0,30,1
1649889257978,MATH 20D,B01,084133,Staff,28,0,30,2
1649889257978,MATH 20D,B02,084134,Staff,29,0,30,1
1649889257978,MATH 20D,B03,084135,Staff,30,0,30,0
1649889264005,MATH 20E,A01,084138,Staff,25,0,30,5
1649889264005,MATH 20E,A02,084139,Staff,25,0,30,5
1649889264005,MATH 20E,A03,084140,Staff,25,0,30,5
1649889264005,MATH 20E,A04,084141,Staff,28,0,30,2
1649889270030,MATH 102,A01,084143,Harel; Guershon,22,0,30,8
1649889270030,MATH 102,A02,084144,Harel; Guershon,23,0,30,7
1649889276058,MATH 103B,A01,083456,Staff,0,2,30,30
1649889276058,MATH 103B,A02,083457,Staff,0,2,30,30
1649889282176,MATH 109,A01,084146,Salehi Golsefidy; Alireza,29,0,30,1
1649889282176,MATH 109,A02,084147,Salehi Golsefidy; Alireza,24,0,30,6
1649889288200,MATH 120A,A01,085445,Eggers; John Dietrich,22,0,35,13
1649889288200,MATH 120A,A02,085446,Eggers; John Dietrich,29,0,35,6
1649889294222,MATH 142B,A01,084149,Verstraete; Jacques Allan,0,1,30,30
1649889294222,MATH 142B,A02,084150,Verstraete; Jacques Allan,3,0,30,27
1649889300263,MATH 170A,A01,083459,Nie; Jiawang,0,1,30,30
1649889300263,MATH 170A,A02,083460,Nie; Jiawang,13,0,30,17
1649889300263,MATH 170A,A03,083461,Nie; Jiawang,20,0,30,10
1649889306285,MATH 193B,A01,083463,Staff,8,0,30,22
1649889306285,MATH 193B,A02,083464,Staff,15,0,30,15
1649889306285,MATH 193B,A03,083465,Staff,25,0,30,5
1649889312339,COGS 2,A01,083966,Boyle; Mary E. T.,22,0,30,8
1649889318365,COGS 9,A01,083968,Staff,48,0,60,12
1649889324399,COGS 14B,A01,083970,Staff,40,0,50,10
1649889330422,COGS 17,A01,092679,Staff,68,0,75,7
1649889336448,COGS 100,A01,083972,Staff,34,0,60,26
1649889348504,COGS 101C,A01,083976,Staff,22,0,30,8
1649889354533,COGS 102A,A01,083978,Johnson; Christine M.,19,0,30,11
1649889360563,COGS 107B,A01,083980,Staff,17,0,50,33
1649889366597,COGS 115,A01,083982,Staff,13,0,30,17
1649889372634,COGS 118B,A01,083367,Staff,0,6,40,40
1649889378657,COGS 172,A01,083984,Provenzano; Emily Kara,17,0,30,13
1649889384683,COGS 177,A00,083368,Staff,1,12,30,29
1649889390711,COGS 186,A01,083986,Staff,23,0,40,17
1649889396740,COGS 187A,A01,083988,Boyle; Mary E. T.,27,0,60,33
1649889402766,CSE 8A,A50,084003,Miranda; Gregory Joseph,6,0,15,9
1649889408791,CSE 11,A01,084005,Miranda; Gregory Joseph,40,0,55,15
1649889414826,CSE 20,A01,084007,Staff,13,0,20,7
1649889420852,CSE 21,A01,084009,Staff,20,0,50,30
1649889426876,CSE 30,A01,083370,Cao; Yingjun,1,0,40,39
1649889432899,CSE 100,A01,083372,Cao; Yingjun,0,8,40,40
1649889438923,CSE 101,A01,084011,Staff,1,37,40,39
1649889444951,CSE 141,A01,083374,Eldon; John,1,43,75,74
1649889450977,CSE 141L,A01,083376,Eldon; John,1,46,75,74
1649889456999,CSE 175,A01,084013,Kumar; Rakesh,22,0,25,3
1649889463025,CSE 190,A00,092508,Dubnov; Shlomo,15,0,15,0
1649889469054,ECE 5,A01,084049,Morris; Karcher William,16,0,20,4
1649889475076,ECE 100,A01,084051,Baghdadchi; Saharnaz,6,0,20,14
1649889475076,ECE 100,A02,091916,Baghdadchi; Saharnaz,18,0,20,2
1649889481115,ECE 101,A01,084053,Baghdadchi; Saharnaz,13,0,37,24
1649889481115,ECE 101,A02,084054,Baghdadchi; Saharnaz,37,0,37,0
1649889487148,ECE 107,A01,083390,Staff,30,0,40,10
1649889493174,ECE 148,A01,084056,Silberman; Jack,7,0,12,5
1649889499204,ECE 180,A00,083391,Abi Samra; Nicholas Camill,25,0,30,5
1649889499204,ECE 180,B00,083392,Abi Samra; Nicholas Camill,22,0,30,8
1649889505231,MATH 10B,A01,084110,Staff,14,0,30,16
1649889505231,MATH 10B,A02,084111,Staff,29,0,30,1
1649889505231,MATH 10B,A03,084112,Staff,28,0,30,2
1649889511266,MATH 10C,A01,083443,Staff,14,0,30,16
1649889511266,MATH 10C,A02,083444,Staff,17,0,30,13
1649889511266,MATH 10C,B01,084114,Staff,26,0,30,4
1649889511266,MATH 10C,B02,084115,Staff,30,0,30,0
1649889517294,MATH 18,A01,084117,Harel; Guershon,27,0,30,3
1649889517294,MATH 18,A02,084119,Harel; Guershon,29,0,30,1
1649889517294,MATH 18,A03,084120,Harel; Guershon,30,0,30,0
1649889517294,MATH 18,A04,084121,Harel; Guershon,30,0,30,0
1649889523325,MATH 20B,A01,084124,Um; Ko Woon,32,0,35,3
1649889523325,MATH 20B,B01,084126,Um; Ko Woon,33,0,35,2
1649889529352,MATH 20C,A01,083446,Hammock; Frances H,21,0,30,9
1649889529352,MATH 20C,A02,083447,Hammock; Frances H,28,0,30,2
1649889529352,MATH 20C,A03,083448,Hammock; Frances H,30,0,30,0
1649889529352,MATH 20C,A04,083449,Hammock; Frances H,30,0,30,0
1649889529352,MATH 20C,B01,083451,Hammock; Frances H,26,0,30,4
1649889529352,MATH 20C,B02,083452,Hammock; Frances H,29,0,30,1
1649889529352,MATH 20C,B03,083453,Hammock; Frances H,30,0,30,0
1649889529352,MATH 20C,B04,083454,Hammock; Frances H,30,0,30,0
1649889535375,MATH 20D,A01,084128,Staff,29,0,30,1
1649889535375,MATH 20D,A02,084129,Staff,30,0,30,0
1649889535375,MATH 20D,A03,084130,Staff,29,0,30,1
1649889535375,MATH 20D,B01,084133,Staff,28,0,30,2
1649889535375,MATH 20D,B02,084134,Staff,29,0,30,1
1649889535375,MATH 20D,B03,084135,Staff,30,0,30,0
1649889541399,MATH 20E,A01,084138,Staff,25,0,30,5
1649889541399,MATH 20E,A02,084139,Staff,25,0,30,5
1649889541399,MATH 20E,A03,084140,Staff,25,0,30,5
1649889541399,MATH 20E,A04,084141,Staff,28,0,30,2
1649889547491,MATH 102,A01,084143,Harel; Guershon,22,0,30,8
1649889547491,MATH 102,A02,084144,Harel; Guershon,23,0,30,7
1649889553519,MATH 103B,A01,083456,Staff,0,2,30,30
1649889553519,MATH 103B,A02,083457,Staff,0,2,30,30
1649889559542,MATH 109,A01,084146,Salehi Golsefidy; Alireza,29,0,30,1
1649889559542,MATH 109,A02,084147,Salehi Golsefidy; Alireza,24,0,30,6
1649889565566,MATH 120A,A01,085445,Eggers; John Dietrich,22,0,35,13
1649889565566,MATH 120A,A02,085446,Eggers; John Dietrich,29,0,35,6
1649889571591,MATH 142B,A01,084149,Verstraete; Jacques Allan,0,1,30,30
1649889571591,MATH 142B,A02,084150,Verstraete; Jacques Allan,3,0,30,27
1649889577638,MATH 170A,A01,083459,Nie; Jiawang,0,1,30,30
1649889577638,MATH 170A,A02,083460,Nie; Jiawang,13,0,30,17
1649889577638,MATH 170A,A03,083461,Nie; Jiawang,20,0,30,10
1649889583671,MATH 193B,A01,083463,Staff,8,0,30,22
1649889583671,MATH 193B,A02,083464,Staff,15,0,30,15
1649889583671,MATH 193B,A03,083465,Staff,25,0,30,5
1649889589733,COGS 2,A01,083966,Boyle; Mary E. T.,22,0,30,8
1649889595765,COGS 9,A01,083968,Staff,48,0,60,12
1649889601795,COGS 14B,A01,083970,Staff,40,0,50,10
1649889607818,COGS 17,A01,092679,Staff,68,0,75,7
1649889613848,COGS 100,A01,083972,Staff,34,0,60,26
1649889625905,COGS 101C,A01,083976,Staff,22,0,30,8
1649889631932,COGS 102A,A01,083978,Johnson; Christine M.,19,0,30,11
1649889637955,COGS 107B,A01,083980,Staff,17,0,50,33
1649889644000,COGS 115,A01,083982,Staff,13,0,30,17
1649889650023,COGS 118B,A01,083367,Staff,0,6,40,40
1649889656051,COGS 172,A01,083984,Provenzano; Emily Kara,17,0,30,13
1649889662075,COGS 177,A00,083368,Staff,1,13,30,29
1649889668098,COGS 186,A01,083986,Staff,23,0,40,17
1649889674122,COGS 187A,A01,083988,Boyle; Mary E. T.,26,0,60,34
1649889680150,CSE 8A,A50,084003,Miranda; Gregory Joseph,6,0,15,9
1649889686173,CSE 11,A01,084005,Miranda; Gregory Joseph,40,0,55,15
1649889692218,CSE 20,A01,084007,Staff,13,0,20,7
1649889698244,CSE 21,A01,084009,Staff,20,0,50,30
1649889704267,CSE 30,A01,083370,Cao; Yingjun,1,0,40,39
1649889710292,CSE 100,A01,083372,Cao; Yingjun,0,9,40,40
1649889716318,CSE 101,A01,084011,Staff,1,37,40,39
1649889722344,CSE 141,A01,083374,Eldon; John,1,44,75,74
1649889728367,CSE 141L,A01,083376,Eldon; John,1,47,75,74
1649889734392,CSE 175,A01,084013,Kumar; Rakesh,22,0,25,3
1649889740426,CSE 190,A00,092508,Dubnov; Shlomo,15,0,15,0
1649889746454,ECE 5,A01,084049,Morris; Karcher William,16,0,20,4
1649889752482,ECE 100,A01,084051,Baghdadchi; Saharnaz,6,0,20,14
1649889752482,ECE 100,A02,091916,Baghdadchi; Saharnaz,18,0,20,2
1649889758508,ECE 101,A01,084053,Baghdadchi; Saharnaz,13,0,37,24
1649889758508,ECE 101,A02,084054,Baghdadchi; Saharnaz,37,0,37,0
1649889764537,ECE 107,A01,083390,Staff,30,0,40,10
1649889770566,ECE 148,A01,084056,Silberman; Jack,7,0,12,5
1649889776589,ECE 180,A00,083391,Abi Samra; Nicholas Camill,25,0,30,5
1649889776589,ECE 180,B00,083392,Abi Samra; Nicholas Camill,22,0,30,8
1649889782626,MATH 10B,A01,084110,Staff,14,0,30,16
1649889782626,MATH 10B,A02,084111,Staff,29,0,30,1
1649889782626,MATH 10B,A03,084112,Staff,28,0,30,2
1649889788656,MATH 10C,A01,083443,Staff,14,0,30,16
1649889788656,MATH 10C,A02,083444,Staff,17,0,30,13
1649889788656,MATH 10C,B01,084114,Staff,26,0,30,4
1649889788656,MATH 10C,B02,084115,Staff,30,0,30,0
1649889794684,MATH 18,A01,084117,Harel; Guershon,27,0,30,3
1649889794684,MATH 18,A02,084119,Harel; Guershon,29,0,30,1
1649889794684,MATH 18,A03,084120,Harel; Guershon,30,0,30,0
1649889794684,MATH 18,A04,084121,Harel; Guershon,30,0,30,0
1649889800716,MATH 20B,A01,084124,Um; Ko Woon,32,0,35,3
1649889800716,MATH 20B,B01,084126,Um; Ko Woon,33,0,35,2
1649889806739,MATH 20C,A01,083446,Hammock; Frances H,21,0,30,9
1649889806739,MATH 20C,A02,083447,Hammock; Frances H,28,0,30,2
1649889806739,MATH 20C,A03,083448,Hammock; Frances H,30,0,30,0
1649889806739,MATH 20C,A04,083449,Hammock; Frances H,30,0,30,0
1649889806739,MATH 20C,B01,083451,Hammock; Frances H,26,0,30,4
1649889806739,MATH 20C,B02,083452,Hammock; Frances H,29,0,30,1
1649889806739,MATH 20C,B03,083453,Hammock; Frances H,30,0,30,0
1649889806739,MATH 20C,B04,083454,Hammock; Frances H,30,0,30,0
1649889812775,MATH 20D,A01,084128,Staff,29,0,30,1
1649889812775,MATH 20D,A02,084129,Staff,30,0,30,0
1649889812775,MATH 20D,A03,084130,Staff,29,0,30,1
1649889812775,MATH 20D,B01,084133,Staff,28,0,30,2
1649889812775,MATH 20D,B02,084134,Staff,29,0,30,1
1649889812775,MATH 20D,B03,084135,Staff,30,0,30,0
1649889818803,MATH 20E,A01,084138,Staff,25,0,30,5
1649889818803,MATH 20E,A02,084139,Staff,25,0,30,5
1649889818803,MATH 20E,A03,084140,Staff,25,0,30,5
1649889818803,MATH 20E,A04,084141,Staff,28,0,30,2
1649889824830,MATH 102,A01,084143,Harel; Guershon,22,0,30,8
1649889824830,MATH 102,A02,084144,Harel; Guershon,23,0,30,7
1649889830851,MATH 103B,A01,083456,Staff,0,2,30,30
1649889830851,MATH 103B,A02,083457,Staff,0,2,30,30
1649889836874,MATH 109,A01,084146,Salehi Golsefidy; Alireza,29,0,30,1
1649889836874,MATH 109,A02,084147,Salehi Golsefidy; Alireza,24,0,30,6
1649889842897,MATH 120A,A01,085445,Eggers; John Dietrich,22,0,35,13
1649889842897,MATH 120A,A02,085446,Eggers; John Dietrich,29,0,35,6
1649889848922,MATH 142B,A01,084149,Verstraete; Jacques Allan,0,1,30,30
1649889848922,MATH 142B,A02,084150,Verstraete; Jacques Allan,2,0,30,28
1649889854959,MATH 170A,A01,083459,Nie; Jiawang,0,1,30,30
1649889854959,MATH 170A,A02,083460,Nie; Jiawang,14,0,30,16
1649889854959,MATH 170A,A03,083461,Nie; Jiawang,20,0,30,10
1649889860981,MATH 193B,A01,083463,Staff,8,0,30,22
1649889860981,MATH 193B,A02,083464,Staff,15,0,30,15
1649889860981,MATH 193B,A03,083465,Staff,25,0,30,5
1649889867032,COGS 2,A01,083966,Boyle; Mary E. T.,22,0,30,8
1649889873163,COGS 9,A01,083968,Staff,48,0,60,12
1649889879188,COGS 14B,A01,083970,Staff,40,0,50,10
1649889885223,COGS 17,A01,092679,Staff,68,0,75,7
1649889891249,COGS 100,A01,083972,Staff,34,0,60,26
1649889903309,COGS 101C,A01,083976,Staff,22,0,30,8
1649889909331,COGS 102A,A01,083978,Johnson; Christine M.,19,0,30,11
1649889915361,COGS 107B,A01,083980,Staff,17,0,50,33
1649889921387,COGS 115,A01,083982,Staff,13,0,30,17
1649889927414,COGS 118B,A01,083367,Staff,0,6,40,40
1649889933439,COGS 172,A01,083984,Provenzano; Emily Kara,17,0,30,13
1649889939461,COGS 177,A00,083368,Staff,1,13,30,29
1649889945494,COGS 186,A01,083986,Staff,23,0,40,17
1649889951516,COGS 187A,A01,083988,Boyle; Mary E. T.,25,0,60,35
1649889957546,CSE 8A,A50,084003,Miranda; Gregory Joseph,6,0,15,9
1649889963573,CSE 11,A01,084005,Miranda; Gregory Joseph,40,0,55,15
1649889969595,CSE 20,A01,084007,Staff,12,0,20,8
1649889975627,CSE 21,A01,084009,Staff,20,0,50,30
1649889981657,CSE 30,A01,083370,Cao; Yingjun,1,0,40,39
1649889987687,CSE 100,A01,083372,Cao; Yingjun,0,9,40,40
1649889993710,CSE 101,A01,084011,Staff,1,37,40,39
1649889999738,CSE 141,A01,083374,Eldon; John,1,44,75,74
1649890005763,CSE 141L,A01,083376,Eldon; John,1,47,75,74
1649890011789,CSE 175,A01,084013,Kumar; Rakesh,22,0,25,3
1649890017825,CSE 190,A00,092508,Dubnov; Shlomo,15,0,15,0
1649890023846,ECE 5,A01,084049,Morris; Karcher William,16,0,20,4
1649890029873,ECE 100,A01,084051,Baghdadchi; Saharnaz,6,0,20,14
1649890029873,ECE 100,A02,091916,Baghdadchi; Saharnaz,18,0,20,2
1649890035900,ECE 101,A01,084053,Baghdadchi; Saharnaz,13,0,37,24
1649890035900,ECE 101,A02,084054,Baghdadchi; Saharnaz,37,0,37,0
1649890041925,ECE 107,A01,083390,Staff,30,0,40,10
1649890047950,ECE 148,A01,084056,Silberman; Jack,7,0,12,5
1649890053973,ECE 180,A00,083391,Abi Samra; Nicholas Camill,25,0,30,5
1649890053973,ECE 180,B00,083392,Abi Samra; Nicholas Camill,22,0,30,8
1649890060000,MATH 10B,A01,084110,Staff,14,0,30,16
1649890060000,MATH 10B,A02,084111,Staff,29,0,30,1
1649890060000,MATH 10B,A03,084112,Staff,28,0,30,2
1649890066027,MATH 10C,A01,083443,Staff,14,0,30,16
1649890066027,MATH 10C,A02,083444,Staff,17,0,30,13
1649890066027,MATH 10C,B01,084114,Staff,26,0,30,4
1649890066027,MATH 10C,B02,084115,Staff,30,0,30,0
1649890072049,MATH 18,A01,084117,Harel; Guershon,27,0,30,3
1649890072049,MATH 18,A02,084119,Harel; Guershon,29,0,30,1
1649890072049,MATH 18,A03,084120,Harel; Guershon,30,0,30,0
1649890072049,MATH 18,A04,084121,Harel; Guershon,30,0,30,0
1649890078086,MATH 20B,A01,084124,Um; Ko Woon,32,0,35,3
1649890078086,MATH 20B,B01,084126,Um; Ko Woon,33,0,35,2
1649890084113,MATH 20C,A01,083446,Hammock; Frances H,21,0,30,9
1649890084113,MATH 20C,A02,083447,Hammock; Frances H,28,0,30,2
1649890084113,MATH 20C,A03,083448,Hammock; Frances H,30,0,30,0
1649890084113,MATH 20C,A04,083449,Hammock; Frances H,30,0,30,0
1649890084113,MATH 20C,B01,083451,Hammock; Frances H,26,0,30,4
1649890084113,MATH 20C,B02,083452,Hammock; Frances H,29,0,30,1
1649890084113,MATH 20C,B03,083453,Hammock; Frances H,30,0,30,0
1649890084113,MATH 20C,B04,083454,Hammock; Frances H,30,0,30,0
1649890090146,MATH 20D,A01,084128,Staff,29,0,30,1
1649890090146,MATH 20D,A02,084129,Staff,30,0,30,0
1649890090146,MATH 20D,A03,084130,Staff,29,0,30,1
1649890090146,MATH 20D,B01,084133,Staff,28,0,30,2
1649890090146,MATH 20D,B02,084134,Staff,29,0,30,1
1649890090146,MATH 20D,B03,084135,Staff,30,0,30,0
1649890096174,MATH 20E,A01,084138,Staff,25,0,30,5
1649890096174,MATH 20E,A02,084139,Staff,25,0,30,5
1649890096174,MATH 20E,A03,084140,Staff,25,0,30,5
1649890096174,MATH 20E,A04,084141,Staff,28,0,30,2
1649890102211,MATH 102,A01,084143,Harel; Guershon,21,0,30,9
1649890102211,MATH 102,A02,084144,Harel; Guershon,23,0,30,7
1649890108250,MATH 103B,A01,083456,Staff,0,3,30,30
1649890108250,MATH 103B,A02,083457,Staff,0,2,30,30
1649890114274,MATH 109,A01,084146,Salehi Golsefidy; Alireza,29,0,30,1
1649890114274,MATH 109,A02,084147,Salehi Golsefidy; Alireza,24,0,30,6
1649890120297,MATH 120A,A01,085445,Eggers; John Dietrich,22,0,35,13
1649890120297,MATH 120A,A02,085446,Eggers; John Dietrich,29,0,35,6
1649890126327,MATH 142B,A01,084149,Verstraete; Jacques Allan,0,1,30,30
1649890126327,MATH 142B,A02,084150,Verstraete; Jacques Allan,1,0,30,29
1649890132356,MATH 170A,A01,083459,Nie; Jiawang,0,1,30,30
1649890132356,MATH 170A,A02,083460,Nie; Jiawang,14,0,30,16
1649890132356,MATH 170A,A03,083461,Nie; Jiawang,20,0,30,10
1649890138431,MATH 193B,A01,083463,Staff,7,0,30,23
1649890138431,MATH 193B,A02,083464,Staff,15,0,30,15
1649890138431,MATH 193B,A03,083465,Staff,25,0,30,5
1649890144491,COGS 2,A01,083966,Boyle; Mary E. T.,22,0,30,8
1649890150525,COGS 9,A01,083968,Staff,48,0,60,12
1649890156553,COGS 14B,A01,083970,Staff,40,0,50,10
1649890162576,COGS 17,A01,092679,Staff,68,0,75,7
1649890168601,COGS 100,A01,083972,Staff,33,0,60,27
1649890180651,COGS 101C,A01,083976,Staff,22,0,30,8
1649890186679,COGS 102A,A01,083978,Johnson; Christine M.,19,0,30,11
1649890192712,COGS 107B,A01,083980,Staff,17,0,50,33
1649890198734,COGS 115,A01,083982,Staff,13,0,30,17
1649890204758,COGS 118B,A01,083367,Staff,0,6,40,40
1649890210789,COGS 172,A01,083984,Provenzano; Emily Kara,17,0,30,13
1649890216811,COGS 177,A00,083368,Staff,1,13,30,29
1649890222835,COGS 186,A01,083986,Staff,23,0,40,17
1649890228857,COGS 187A,A01,083988,Boyle; Mary E. T.,25,0,60,35
1649890234881,CSE 8A,A50,084003,Miranda; Gregory Joseph,6,0,15,9
1649890240910,CSE 11,A01,084005,Miranda; Gregory Joseph,40,0,55,15
1649890246937,CSE 20,A01,084007,Staff,12,0,20,8
1649890252968,CSE 21,A01,084009,Staff,20,0,50,30
1649890258994,CSE 30,A01,083370,Cao; Yingjun,1,0,40,39
1649890265021,CSE 100,A01,083372,Cao; Yingjun,0,10,40,40
1649890271043,CSE 101,A01,084011,Staff,1,37,40,39
1649890277065,CSE 141,A01,083374,Eldon; John,1,44,75,74
1649890283102,CSE 141L,A01,083376,Eldon; John,1,47,75,74
1649890289126,CSE 175,A01,084013,Kumar; Rakesh,22,0,25,3
1649890295150,CSE 190,A00,092508,Dubnov; Shlomo,15,0,15,0
1649890301179,ECE 5,A01,084049,Morris; Karcher William,16,0,20,4
1649890307206,ECE 100,A01,084051,Baghdadchi; Saharnaz,6,0,20,14
1649890307206,ECE 100,A02,091916,Baghdadchi; Saharnaz,18,0,20,2
1649890313236,ECE 101,A01,084053,Baghdadchi; Saharnaz,13,0,37,24
1649890313236,ECE 101,A02,084054,Baghdadchi; Saharnaz,37,0,37,0
1649890319259,ECE 107,A01,083390,Staff,30,0,40,10
1649890325286,ECE 148,A01,084056,Silberman; Jack,7,0,12,5
1649890331313,ECE 180,A00,083391,Abi Samra; Nicholas Camill,25,0,30,5
1649890331313,ECE 180,B00,083392,Abi Samra; Nicholas Camill,22,0,30,8
1649890337348,MATH 10B,A01,084110,Staff,14,0,30,16
1649890337348,MATH 10B,A02,084111,Staff,29,0,30,1
1649890337348,MATH 10B,A03,084112,Staff,28,0,30,2
1649890343371,MATH 10C,A01,083443,Staff,14,0,30,16
1649890343371,MATH 10C,A02,083444,Staff,17,0,30,13
1649890343371,MATH 10C,B01,084114,Staff,26,0,30,4
1649890343371,MATH 10C,B02,084115,Staff,30,0,30,0
1649890349406,MATH 18,A01,084117,Harel; Guershon,27,0,30,3
1649890349406,MATH 18,A02,084119,Harel; Guershon,29,0,30,1
1649890349406,MATH 18,A03,084120,Harel; Guershon,30,0,30,0
1649890349406,MATH 18,A04,084121,Harel; Guershon,30,0,30,0
1649890355449,MATH 20B,A01,084124,Um; Ko Woon,32,0,35,3
1649890355449,MATH 20B,B01,084126,Um; Ko Woon,33,0,35,2
1649890361472,MATH 20C,A01,083446,Hammock; Frances H,20,0,30,10
1649890361472,MATH 20C,A02,083447,Hammock; Frances H,28,0,30,2
1649890361472,MATH 20C,A03,083448,Hammock; Frances H,30,0,30,0
1649890361472,MATH 20C,A04,083449,Hammock; Frances H,30,0,30,0
1649890361472,MATH 20C,B01,083451,Hammock; Frances H,26,0,30,4
1649890361472,MATH 20C,B02,083452,Hammock; Frances H,29,0,30,1
1649890361472,MATH 20C,B03,083453,Hammock; Frances H,30,0,30,0
1649890361472,MATH 20C,B04,083454,Hammock; Frances H,30,0,30,0
1649890367499,MATH 20D,A01,084128,Staff,29,0,30,1
1649890367499,MATH 20D,A02,084129,Staff,30,0,30,0
1649890367499,MATH 20D,A03,084130,Staff,29,0,30,1
1649890367499,MATH 20D,B01,084133,Staff,28,0,30,2
1649890367499,MATH 20D,B02,084134,Staff,29,0,30,1
1649890367499,MATH 20D,B03,084135,Staff,30,0,30,0
1649890373523,MATH 20E,A01,084138,Staff,25,0,30,5
1649890373523,MATH 20E,A02,084139,Staff,25,0,30,5
1649890373523,MATH 20E,A03,084140,Staff,25,0,30,5
1649890373523,MATH 20E,A04,084141,Staff,28,0,30,2
1649890379547,MATH 102,A01,084143,Harel; Guershon,21,0,30,9
1649890379547,MATH 102,A02,084144,Harel; Guershon,23,0,30,7
1649890385571,MATH 103B,A01,083456,Staff,0,3,30,30
1649890385571,MATH 103B,A02,083457,Staff,0,2,30,30
1649890391595,MATH 109,A01,084146,Salehi Golsefidy; Alireza,29,0,30,1
1649890391595,MATH 109,A02,084147,Salehi Golsefidy; Alireza,24,0,30,6
1649890397622,MATH 120A,A01,085445,Eggers; John Dietrich,22,0,35,13
1649890397622,MATH 120A,A02,085446,Eggers; John Dietrich,29,0,35,6
1649890403649,MATH 142B,A01,084149,Verstraete; Jacques Allan,0,2,30,30
1649890403649,MATH 142B,A02,084150,Verstraete; Jacques Allan,1,0,30,29
1649890409682,MATH 170A,A01,083459,Nie; Jiawang,0,1,30,30
1649890409682,MATH 170A,A02,083460,Nie; Jiawang,14,0,30,16
1649890409682,MATH 170A,A03,083461,Nie; Jiawang,20,0,30,10
1649890415711,MATH 193B,A01,083463,Staff,7,0,30,23
1649890415711,MATH 193B,A02,083464,Staff,15,0,30,15
1649890415711,MATH 193B,A03,083465,Staff,24,0,30,6
1649890421765,COGS 2,A01,083966,Boyle; Mary E. T.,22,0,30,8
1649890427790,COGS 9,A01,083968,Staff,48,0,60,12
1649890433825,COGS 14B,A01,083970,Staff,40,0,50,10
1649890439847,COGS 17,A01,092679,Staff,68,0,75,7
1649890445879,COGS 100,A01,083972,Staff,33,0,60,27
1649890457932,COGS 101C,A01,083976,Staff,22,0,30,8
1649890463965,COGS 102A,A01,083978,Johnson; Christine M.,19,0,30,11
1649890470089,COGS 107B,A01,083980,Staff,16,0,50,34
1649890476113,COGS 115,A01,083982,Staff,13,0,30,17
1649890482139,COGS 118B,A01,083367,Staff,0,6,40,40
1649890488166,COGS 172,A01,083984,Provenzano; Emily Kara,17,0,30,13
1649890494191,COGS 177,A00,083368,Staff,1,13,30,29
1649890500219,COGS 186,A01,083986,Staff,23,0,40,17
1649890506244,COGS 187A,A01,083988,Boyle; Mary E. T.,25,0,60,35
1649890512274,CSE 8A,A50,084003,Miranda; Gregory Joseph,6,0,15,9
1649890518296,CSE 11,A01,084005,Miranda; Gregory Joseph,39,0,55,16
1649890524320,CSE 20,A01,084007,Staff,12,0,20,8
1649890530343,CSE 21,A01,084009,Staff,20,0,50,30
1649890536371,CSE 30,A01,083370,Cao; Yingjun,0,0,40,40
1649890542395,CSE 100,A01,083372,Cao; Yingjun,0,10,40,40
1649890548434,CSE 101,A01,084011,Staff,1,37,40,39
1649890554461,CSE 141,A01,083374,Eldon; John,1,43,75,74
1649890560490,CSE 141L,A01,083376,Eldon; John,1,46,75,74
1649890566518,CSE 175,A01,084013,Kumar; Rakesh,22,0,25,3
1649890572555,CSE 190,A00,092508,Dubnov; Shlomo,15,0,15,0
1649890578591,ECE 5,A01,084049,Morris; Karcher William,16,0,20,4
1649890584618,ECE 100,A01,084051,Baghdadchi; Saharnaz,6,0,20,14
1649890584618,ECE 100,A02,091916,Baghdadchi; Saharnaz,18,0,20,2
1649890590645,ECE 101,A01,084053,Baghdadchi; Saharnaz,13,0,37,24
1649890590645,ECE 101,A02,084054,Baghdadchi; Saharnaz,37,0,37,0
1649890596672,ECE 107,A01,083390,Staff,29,0,40,11
1649890602700,ECE 148,A01,084056,Silberman; Jack,7,0,12,5
1649890608726,ECE 180,A00,083391,Abi Samra; Nicholas Camill,25,0,30,5
1649890608726,ECE 180,B00,083392,Abi Samra; Nicholas Camill,22,0,30,8
1649890614757,MATH 10B,A01,084110,Staff,14,0,30,16
1649890614757,MATH 10B,A02,084111,Staff,29,0,30,1
1649890614757,MATH 10B,A03,084112,Staff,28,0,30,2
1649890620779,MATH 10C,A01,083443,Staff,14,0,30,16
1649890620779,MATH 10C,A02,083444,Staff,17,0,30,13
1649890620779,MATH 10C,B01,084114,Staff,26,0,30,4
1649890620779,MATH 10C,B02,084115,Staff,30,0,30,0
1649890626803,MATH 18,A01,084117,Harel; Guershon,27,0,30,3
1649890626803,MATH 18,A02,084119,Harel; Guershon,29,0,30,1
1649890626803,MATH 18,A03,084120,Harel; Guershon,30,0,30,0
1649890626803,MATH 18,A04,084121,Harel; Guershon,30,0,30,0
1649890632827,MATH 20B,A01,084124,Um; Ko Woon,32,0,35,3
1649890632827,MATH 20B,B01,084126,Um; Ko Woon,33,0,35,2
1649890638852,MATH 20C,A01,083446,Hammock; Frances H,20,0,30,10
1649890638852,MATH 20C,A02,083447,Hammock; Frances H,28,0,30,2
1649890638852,MATH 20C,A03,083448,Hammock; Frances H,30,0,30,0
1649890638852,MATH 20C,A04,083449,Hammock; Frances H,30,0,30,0
1649890638852,MATH 20C,B01,083451,Hammock; Frances H,26,0,30,4
1649890638852,MATH 20C,B02,083452,Hammock; Frances H,29,0,30,1
1649890638852,MATH 20C,B03,083453,Hammock; Frances H,29,0,30,1
1649890638852,MATH 20C,B04,083454,Hammock; Frances H,30,0,30,0
1649890644878,MATH 20D,A01,084128,Staff,29,0,30,1
1649890644878,MATH 20D,A02,084129,Staff,30,0,30,0
1649890644878,MATH 20D,A03,084130,Staff,29,0,30,1
1649890644878,MATH 20D,B01,084133,Staff,28,0,30,2
1649890644878,MATH 20D,B02,084134,Staff,29,0,30,1
1649890644878,MATH 20D,B03,084135,Staff,30,0,30,0
1649890650905,MATH 20E,A01,084138,Staff,25,0,30,5
1649890650905,MATH 20E,A02,084139,Staff,25,0,30,5
1649890650905,MATH 20E,A03,084140,Staff,25,0,30,5
1649890650905,MATH 20E,A04,084141,Staff,28,0,30,2
1649890656928,MATH 102,A01,084143,Harel; Guershon,21,0,30,9
1649890656928,MATH 102,A02,084144,Harel; Guershon,23,0,30,7
1649890662951,MATH 103B,A01,083456,Staff,0,4,30,30
1649890662951,MATH 103B,A02,083457,Staff,0,2,30,30
1649890668975,MATH 109,A01,084146,Salehi Golsefidy; Alireza,29,0,30,1
1649890668975,MATH 109,A02,084147,Salehi Golsefidy; Alireza,24,0,30,6
1649890675013,MATH 120A,A01,085445,Eggers; John Dietrich,22,0,35,13
1649890675013,MATH 120A,A02,085446,Eggers; John Dietrich,29,0,35,6
1649890681042,MATH 142B,A01,084149,Verstraete; Jacques Allan,0,2,30,30
1649890681042,MATH 142B,A02,084150,Verstraete; Jacques Allan,0,1,30,30
1649890687152,MATH 170A,A01,083459,Nie; Jiawang,0,1,30,30
1649890687152,MATH 170A,A02,083460,Nie; Jiawang,13,0,30,17
1649890687152,MATH 170A,A03,083461,Nie; Jiawang,20,0,30,10
1649890693178,MATH 193B,A01,083463,Staff,7,0,30,23
1649890693178,MATH 193B,A02,083464,Staff,15,0,30,15
1649890693178,MATH 193B,A03,083465,Staff,24,0,30,6
1649890699232,COGS 2,A01,083966,Boyle; Mary E. T.,22,0,30,8
1649890705262,COGS 9,A01,083968,Staff,48,0,60,12
1649890711284,COGS 14B,A01,083970,Staff,40,0,50,10
1649890717312,COGS 17,A01,092679,Staff,68,0,75,7
1649890723336,COGS 100,A01,083972,Staff,33,0,60,27
1649890735402,COGS 101C,A01,083976,Staff,22,0,30,8
1649890741436,COGS 102A,A01,083978,Johnson; Christine M.,19,0,30,11
1649890747463,COGS 107B,A01,083980,Staff,16,0,50,34
1649890753486,COGS 115,A01,083982,Staff,13,0,30,17
1649890759511,COGS 118B,A01,083367,Staff,0,6,40,40
1649890765534,COGS 172,A01,083984,Provenzano; Emily Kara,17,0,30,13
1649890771573,COGS 177,A00,083368,Staff,1,13,30,29
1649890777597,COGS 186,A01,083986,Staff,23,0,40,17
1649890783622,COGS 187A,A01,083988,Boyle; Mary E. T.,25,0,60,35
1649890789658,CSE 8A,A50,084003,Miranda; Gregory Joseph,6,0,15,9
1649890795683,CSE 11,A01,084005,Miranda; Gregory Joseph,39,0,55,16
1649890801709,CSE 20,A01,084007,Staff,12,0,20,8
1649890807741,CSE 21,A01,084009,Staff,20,0,50,30
1649890813764,CSE 30,A01,083370,Cao; Yingjun,0,1,40,40
1649890819799,CSE 100,A01,083372,Cao; Yingjun,0,10,40,40
1649890825826,CSE 101,A01,084011,Staff,1,38,40,39
1649890831851,CSE 141,A01,083374,Eldon; John,1,43,75,74
1649890837873,CSE 141L,A01,083376,Eldon; John,1,46,75,74
1649890843896,CSE 175,A01,084013,Kumar; Rakesh,22,0,25,3
1649890849920,CSE 190,A00,092508,Dubnov; Shlomo,15,0,15,0
1649890855944,ECE 5,A01,084049,Morris; Karcher William,16,0,20,4
1649890861968,ECE 100,A01,084051,Baghdadchi; Saharnaz,6,0,20,14
1649890861968,ECE 100,A02,091916,Baghdadchi; Saharnaz,18,0,20,2
1649890868025,ECE 101,A01,084053,Baghdadchi; Saharnaz,13,0,37,24
1649890868025,ECE 101,A02,084054,Baghdadchi; Saharnaz,37,0,37,0
1649890874062,ECE 107,A01,083390,Staff,29,0,40,11
1649890880100,ECE 148,A01,084056,Silberman; Jack,7,0,12,5
1649890886130,ECE 180,A00,083391,Abi Samra; Nicholas Camill,25,0,30,5
1649890886130,ECE 180,B00,083392,Abi Samra; Nicholas Camill,22,0,30,8
1649890892168,MATH 10B,A01,084110,Staff,13,0,30,17
1649890892168,MATH 10B,A02,084111,Staff,29,0,30,1
1649890892168,MATH 10B,A03,084112,Staff,28,0,30,2
1649890898200,MATH 10C,A01,083443,Staff,14,0,30,16
1649890898200,MATH 10C,A02,083444,Staff,17,0,30,13
1649890898200,MATH 10C,B01,084114,Staff,25,0,30,5
1649890898200,MATH 10C,B02,084115,Staff,30,0,30,0
1649890904227,MATH 18,A01,084117,Harel; Guershon,27,0,30,3
1649890904227,MATH 18,A02,084119,Harel; Guershon,29,0,30,1
1649890904227,MATH 18,A03,084120,Harel; Guershon,30,0,30,0
1649890904227,MATH 18,A04,084121,Harel; Guershon,30,0,30,0
1649890910250,MATH 20B,A01,084124,Um; Ko Woon,32,0,35,3
1649890910250,MATH 20B,B01,084126,Um; Ko Woon,33,0,35,2
1649890916282,MATH 20C,A01,083446,Hammock; Frances H,20,0,30,10
1649890916282,MATH 20C,A02,083447,Hammock; Frances H,28,0,30,2
1649890916282,MATH 20C,A03,083448,Hammock; Frances H,30,0,30,0
1649890916282,MATH 20C,A04,083449,Hammock; Frances H,30,0,30,0
1649890916282,MATH 20C,B01,083451,Hammock; Frances H,26,0,30,4
1649890916282,MATH 20C,B02,083452,Hammock; Frances H,29,0,30,1
1649890916282,MATH 20C,B03,083453,Hammock; Frances H,29,0,30,1
1649890916282,MATH 20C,B04,083454,Hammock; Frances H,30,0,30,0
1649890922306,MATH 20D,A01,084128,Staff,29,0,30,1
1649890922306,MATH 20D,A02,084129,Staff,30,0,30,0
1649890922306,MATH 20D,A03,084130,Staff,29,0,30,1
1649890922306,MATH 20D,B01,084133,Staff,28,0,30,2
1649890922306,MATH 20D,B02,084134,Staff,29,0,30,1
1649890922306,MATH 20D,B03,084135,Staff,30,0,30,0
1649890928328,MATH 20E,A01,084138,Staff,25,0,30,5
1649890928328,MATH 20E,A02,084139,Staff,25,0,30,5
1649890928328,MATH 20E,A03,084140,Staff,25,0,30,5
1649890928328,MATH 20E,A04,084141,Staff,28,0,30,2
1649890934356,MATH 102,A01,084143,Harel; Guershon,21,0,30,9
1649890934356,MATH 102,A02,084144,Harel; Guershon,23,0,30,7
1649890940381,MATH 103B,A01,083456,Staff,0,4,30,30
1649890940381,MATH 103B,A02,083457,Staff,0,2,30,30
1649890946409,MATH 109,A01,084146,Salehi Golsefidy; Alireza,29,0,30,1
1649890946409,MATH 109,A02,084147,Salehi Golsefidy; Alireza,24,0,30,6
1649890952436,MATH 120A,A01,085445,Eggers; John Dietrich,22,0,35,13
1649890952436,MATH 120A,A02,085446,Eggers; John Dietrich,29,0,35,6
1649890958459,MATH 142B,A01,084149,Verstraete; Jacques Allan,0,3,30,30
1649890958459,MATH 142B,A02,084150,Verstraete; Jacques Allan,0,1,30,30
1649890964482,MATH 170A,A01,083459,Nie; Jiawang,0,1,30,30
1649890964482,MATH 170A,A02,083460,Nie; Jiawang,13,0,30,17
1649890964482,MATH 170A,A03,083461,Nie; Jiawang,20,0,30,10
1649890970513,MATH 193B,A01,083463,Staff,7,0,30,23
1649890970513,MATH 193B,A02,083464,Staff,14,0,30,16
1649890970513,MATH 193B,A03,083465,Staff,24,0,30,6
1649890976585,COGS 2,A01,083966,Boyle; Mary E. T.,22,0,30,8
1649890982613,COGS 9,A01,083968,Staff,48,0,60,12
1649890988654,COGS 14B,A01,083970,Staff,40,0,50,10
1649890994687,COGS 17,A01,092679,Staff,68,0,75,7
1649891000721,COGS 100,A01,083972,Staff,33,0,60,27
1649891020018,COGS 101C,A01,083976,Staff,22,0,30,8
1649891026044,COGS 102A,A01,083978,Johnson; Christine M.,19,0,30,11
1649891032073,COGS 107B,A01,083980,Staff,15,0,50,35
1649891038096,COGS 115,A01,083982,Staff,13,0,30,17
1649891044122,COGS 118B,A01,083367,Staff,0,6,40,40
1649891050157,COGS 172,A01,083984,Provenzano; Emily Kara,17,0,30,13
1649891056184,COGS 177,A00,083368,Staff,1,13,30,29
1649891062208,COGS 186,A01,083986,Staff,23,0,40,17
1649891068234,COGS 187A,A01,083988,Boyle; Mary E. T.,25,0,60,35
1649891074377,CSE 8A,A50,084003,Miranda; Gregory Joseph,6,0,15,9
1649891080398,CSE 11,A01,084005,Miranda; Gregory Joseph,38,0,55,17
1649891086430,CSE 20,A01,084007,Staff,12,0,20,8
1649891092453,CSE 21,A01,084009,Staff,20,0,50,30
1649891098486,CSE 30,A01,083370,Cao; Yingjun,0,1,40,40
1649891104510,CSE 100,A01,083372,Cao; Yingjun,0,11,40,40
1649891110537,CSE 101,A01,084011,Staff,1,38,40,39
1649891116560,CSE 141,A01,083374,Eldon; John,1,43,75,74
1649891122583,CSE 141L,A01,083376,Eldon; John,1,46,75,74
1649891128609,CSE 175,A01,084013,Kumar; Rakesh,22,0,25,3
1649891134634,CSE 190,A00,092508,Dubnov; Shlomo,15,0,15,0
1649891140657,ECE 5,A01,084049,Morris; Karcher William,16,0,20,4
1649891146684,ECE 100,A01,084051,Baghdadchi; Saharnaz,6,0,20,14
1649891146684,ECE 100,A02,091916,Baghdadchi; Saharnaz,18,0,20,2
1649891152714,ECE 101,A01,084053,Baghdadchi; Saharnaz,13,0,37,24
1649891152714,ECE 101,A02,084054,Baghdadchi; Saharnaz,37,0,37,0
1649891158740,ECE 107,A01,083390,Staff,29,0,40,11
1649891164763,ECE 148,A01,084056,Silberman; Jack,7,0,12,5
1649891170793,ECE 180,A00,083391,Abi Samra; Nicholas Camill,25,0,30,5
1649891170793,ECE 180,B00,083392,Abi Samra; Nicholas Camill,22,0,30,8
1649891176820,MATH 10B,A01,084110,Staff,13,0,30,17
1649891176820,MATH 10B,A02,084111,Staff,29,0,30,1
1649891176820,MATH 10B,A03,084112,Staff,28,0,30,2
1649891182854,MATH 10C,A01,083443,Staff,13,0,30,17
1649891182854,MATH 10C,A02,083444,Staff,17,0,30,13
1649891182854,MATH 10C,B01,084114,Staff,26,0,30,4
1649891182854,MATH 10C,B02,084115,Staff,30,0,30,0
1649891188883,MATH 18,A01,084117,Harel; Guershon,27,0,30,3
1649891188883,MATH 18,A02,084119,Harel; Guershon,29,0,30,1
1649891188883,MATH 18,A03,084120,Harel; Guershon,30,0,30,0
1649891188883,MATH 18,A04,084121,Harel; Guershon,30,0,30,0
1649891194910,MATH 20B,A01,084124,Um; Ko Woon,32,0,35,3
1649891194910,MATH 20B,B01,084126,Um; Ko Woon,33,0,35,2
1649891200942,MATH 20C,A01,083446,Hammock; Frances H,20,0,30,10
1649891200942,MATH 20C,A02,083447,Hammock; Frances H,28,0,30,2
1649891200942,MATH 20C,A03,083448,Hammock; Frances H,30,0,30,0
1649891200942,MATH 20C,A04,083449,Hammock; Frances H,30,0,30,0
1649891200942,MATH 20C,B01,083451,Hammock; Frances H,26,0,30,4
1649891200942,MATH 20C,B02,083452,Hammock; Frances H,29,0,30,1
1649891200942,MATH 20C,B03,083453,Hammock; Frances H,29,0,30,1
1649891200942,MATH 20C,B04,083454,Hammock; Frances H,30,0,30,0
1649891206966,MATH 20D,A01,084128,Staff,29,0,30,1
1649891206966,MATH 20D,A02,084129,Staff,30,0,30,0
1649891206966,MATH 20D,A03,084130,Staff,29,0,30,1
1649891206966,MATH 20D,B01,084133,Staff,28,0,30,2
1649891206966,MATH 20D,B02,084134,Staff,29,0,30,1
1649891206966,MATH 20D,B03,084135,Staff,30,0,30,0
1649891212994,MATH 20E,A01,084138,Staff,25,0,30,5
1649891212994,MATH 20E,A02,084139,Staff,25,0,30,5
1649891212994,MATH 20E,A03,084140,Staff,25,0,30,5
1649891212994,MATH 20E,A04,084141,Staff,28,0,30,2
1649891219023,MATH 102,A01,084143,Harel; Guershon,21,0,30,9
1649891219023,MATH 102,A02,084144,Harel; Guershon,23,0,30,7
1649891225057,MATH 103B,A01,083456,Staff,0,4,30,30
1649891225057,MATH 103B,A02,083457,Staff,0,3,30,30
1649891231080,MATH 109,A01,084146,Salehi Golsefidy; Alireza,29,0,30,1
1649891231080,MATH 109,A02,084147,Salehi Golsefidy; Alireza,24,0,30,6
1649891237103,MATH 120A,A01,085445,Eggers; John Dietrich,22,0,35,13
1649891237103,MATH 120A,A02,085446,Eggers; John Dietrich,29,0,35,6
1649891243129,MATH 142B,A01,084149,Verstraete; Jacques Allan,0,3,30,30
1649891243129,MATH 142B,A02,084150,Verstraete; Jacques Allan,0,1,30,30
1649891249157,MATH 170A,A01,083459,Nie; Jiawang,0,1,30,30
1649891249157,MATH 170A,A02,083460,Nie; Jiawang,12,0,30,18
1649891249157,MATH 170A,A03,083461,Nie; Jiawang,20,0,30,10
1649891255186,MATH 193B,A01,083463,Staff,7,0,30,23
1649891255186,MATH 193B,A02,083464,Staff,13,0,30,17
1649891255186,MATH 193B,A03,083465,Staff,24,0,30,6
1649891261248,COGS 2,A01,083966,Boyle; Mary E. T.,22,0,30,8
1649891267295,COGS 9,A01,083968,Staff,48,0,60,12
1649891273330,COGS 14B,A01,083970,Staff,40,0,50,10
1649891279354,COGS 17,A01,092679,Staff,68,0,75,7
1649891285377,COGS 100,A01,083972,Staff,33,0,60,27
1649891297434,COGS 101C,A01,083976,Staff,22,0,30,8
1649891303467,COGS 102A,A01,083978,Johnson; Christine M.,19,0,30,11
1649891309490,COGS 107B,A01,083980,Staff,15,0,50,35
1649891315524,COGS 115,A01,083982,Staff,13,0,30,17
1649891321556,COGS 118B,A01,083367,Staff,0,6,40,40
1649891327589,COGS 172,A01,083984,Provenzano; Emily Kara,17,0,30,13
1649891333622,COGS 177,A00,083368,Staff,1,13,30,29
1649891339648,COGS 186,A01,083986,Staff,23,0,40,17
1649891345671,COGS 187A,A01,083988,Boyle; Mary E. T.,25,0,60,35
1649891351701,CSE 8A,A50,084003,Miranda; Gregory Joseph,6,0,15,9
1649891357725,CSE 11,A01,084005,Miranda; Gregory Joseph,38,0,55,17
1649891363748,CSE 20,A01,084007,Staff,12,0,20,8
1649891369771,CSE 21,A01,084009,Staff,20,0,50,30
1649891375796,CSE 30,A01,083370,Cao; Yingjun,0,1,40,40
1649891381820,CSE 100,A01,083372,Cao; Yingjun,0,11,40,40
1649891387859,CSE 101,A01,084011,Staff,1,38,40,39
1649891393894,CSE 141,A01,083374,Eldon; John,1,43,75,74
1649891399917,CSE 141L,A01,083376,Eldon; John,1,46,75,74
1649891405940,CSE 175,A01,084013,Kumar; Rakesh,22,0,25,3
1649891411970,CSE 190,A00,092508,Dubnov; Shlomo,15,0,15,0
1649891417999,ECE 5,A01,084049,Morris; Karcher William,16,0,20,4
1649891424040,ECE 100,A01,084051,Baghdadchi; Saharnaz,6,0,20,14
1649891424040,ECE 100,A02,091916,Baghdadchi; Saharnaz,18,0,20,2
1649891430067,ECE 101,A01,084053,Baghdadchi; Saharnaz,11,0,37,26
1649891430067,ECE 101,A02,084054,Baghdadchi; Saharnaz,37,0,37,0
1649891436093,ECE 107,A01,083390,Staff,29,0,40,11
1649891442115,ECE 148,A01,084056,Silberman; Jack,7,0,12,5
1649891448148,ECE 180,A00,083391,Abi Samra; Nicholas Camill,25,0,30,5
1649891448148,ECE 180,B00,083392,Abi Samra; Nicholas Camill,22,0,30,8
1649891454174,MATH 10B,A01,084110,Staff,12,0,30,18
1649891454174,MATH 10B,A02,084111,Staff,29,0,30,1
1649891454174,MATH 10B,A03,084112,Staff,28,0,30,2
1649891460201,MATH 10C,A01,083443,Staff,13,0,30,17
1649891460201,MATH 10C,A02,083444,Staff,17,0,30,13
1649891460201,MATH 10C,B01,084114,Staff,26,0,30,4
1649891460201,MATH 10C,B02,084115,Staff,30,0,30,0
1649891466237,MATH 18,A01,084117,Harel; Guershon,27,0,30,3
1649891466237,MATH 18,A02,084119,Harel; Guershon,29,0,30,1
1649891466237,MATH 18,A03,084120,Harel; Guershon,30,0,30,0
1649891466237,MATH 18,A04,084121,Harel; Guershon,30,0,30,0
1649891472267,MATH 20B,A01,084124,Um; Ko Woon,32,0,35,3
1649891472267,MATH 20B,B01,084126,Um; Ko Woon,33,0,35,2
1649891478293,MATH 20C,A01,083446,Hammock; Frances H,20,0,30,10
1649891478293,MATH 20C,A02,083447,Hammock; Frances H,28,0,30,2
1649891478293,MATH 20C,A03,083448,Hammock; Frances H,30,0,30,0
1649891478293,MATH 20C,A04,083449,Hammock; Frances H,30,0,30,0
1649891478293,MATH 20C,B01,083451,Hammock; Frances H,26,0,30,4
1649891478293,MATH 20C,B02,083452,Hammock; Frances H,29,0,30,1
1649891478293,MATH 20C,B03,083453,Hammock; Frances H,29,0,30,1
1649891478293,MATH 20C,B04,083454,Hammock; Frances H,30,0,30,0
1649891484322,MATH 20D,A01,084128,Staff,29,0,30,1
1649891484322,MATH 20D,A02,084129,Staff,30,0,30,0
1649891484322,MATH 20D,A03,084130,Staff,29,0,30,1
1649891484322,MATH 20D,B01,084133,Staff,28,0,30,2
1649891484322,MATH 20D,B02,084134,Staff,29,0,30,1
1649891484322,MATH 20D,B03,084135,Staff,30,0,30,0
1649891490347,MATH 20E,A01,084138,Staff,25,0,30,5
1649891490347,MATH 20E,A02,084139,Staff,25,0,30,5
1649891490347,MATH 20E,A03,084140,Staff,25,0,30,5
1649891490347,MATH 20E,A04,084141,Staff,28,0,30,2
1649891496373,MATH 102,A01,084143,Harel; Guershon,21,0,30,9
1649891496373,MATH 102,A02,084144,Harel; Guershon,23,0,30,7
1649891502399,MATH 103B,A01,083456,Staff,0,4,30,30
1649891502399,MATH 103B,A02,083457,Staff,0,3,30,30
1649891508421,MATH 109,A01,084146,Salehi Golsefidy; Alireza,29,0,30,1
1649891508421,MATH 109,A02,084147,Salehi Golsefidy; Alireza,24,0,30,6
1649891514445,MATH 120A,A01,085445,Eggers; John Dietrich,22,0,35,13
1649891514445,MATH 120A,A02,085446,Eggers; John Dietrich,28,0,35,7
1649891520472,MATH 142B,A01,084149,Verstraete; Jacques Allan,0,3,30,30
1649891520472,MATH 142B,A02,084150,Verstraete; Jacques Allan,0,1,30,30
1649891526504,MATH 170A,A01,083459,Nie; Jiawang,0,1,30,30
1649891526504,MATH 170A,A02,083460,Nie; Jiawang,12,0,30,18
1649891526504,MATH 170A,A03,083461,Nie; Jiawang,20,0,30,10
1649891532528,MATH 193B,A01,083463,Staff,7,0,30,23
1649891532528,MATH 193B,A02,083464,Staff,13,0,30,17
1649891532528,MATH 193B,A03,083465,Staff,24,0,30,6
1649891538586,COGS 2,A01,083966,Boyle; Mary E. T.,22,0,30,8
1649891544613,COGS 9,A01,083968,Staff,48,0,60,12
1649891550637,COGS 14B,A01,083970,Staff,40,0,50,10
1649891556664,COGS 17,A01,092679,Staff,68,0,75,7
1649891562689,COGS 100,A01,083972,Staff,33,0,60,27
1649891574739,COGS 101C,A01,083976,Staff,22,0,30,8
1649891580773,COGS 102A,A01,083978,Johnson; Christine M.,19,0,30,11
1649891586803,COGS 107B,A01,083980,Staff,15,0,50,35
1649891592830,COGS 115,A01,083982,Staff,13,0,30,17
1649891598854,COGS 118B,A01,083367,Staff,0,6,40,40
1649891604879,COGS 172,A01,083984,Provenzano; Emily Kara,17,0,30,13
1649891610906,COGS 177,A00,083368,Staff,1,13,30,29
1649891616949,COGS 186,A01,083986,Staff,23,0,40,17
1649891622972,COGS 187A,A01,083988,Boyle; Mary E. T.,25,0,60,35
1649891628995,CSE 8A,A50,084003,Miranda; Gregory Joseph,6,0,15,9
1649891635025,CSE 11,A01,084005,Miranda; Gregory Joseph,37,0,55,18
1649891641048,CSE 20,A01,084007,Staff,12,0,20,8
1649891647077,CSE 21,A01,084009,Staff,20,0,50,30
1649891653109,CSE 30,A01,083370,Cao; Yingjun,0,1,40,40
1649891659146,CSE 100,A01,083372,Cao; Yingjun,0,13,40,40
1649891665175,CSE 101,A01,084011,Staff,1,38,40,39
1649891671290,CSE 141,A01,083374,Eldon; John,1,43,75,74
1649891677314,CSE 141L,A01,083376,Eldon; John,1,46,75,74
1649891683347,CSE 175,A01,084013,Kumar; Rakesh,22,0,25,3
1649891689372,CSE 190,A00,092508,Dubnov; Shlomo,15,0,15,0
1649891695425,ECE 5,A01,084049,Morris; Karcher William,16,0,20,4
1649891701454,ECE 100,A01,084051,Baghdadchi; Saharnaz,5,0,20,15
1649891701454,ECE 100,A02,091916,Baghdadchi; Saharnaz,18,0,20,2
1649891707478,ECE 101,A01,084053,Baghdadchi; Saharnaz,11,0,37,26
1649891707478,ECE 101,A02,084054,Baghdadchi; Saharnaz,37,0,37,0
1649891713503,ECE 107,A01,083390,Staff,29,0,40,11
1649891719532,ECE 148,A01,084056,Silberman; Jack,7,0,12,5
1649891725555,ECE 180,A00,083391,Abi Samra; Nicholas Camill,25,0,30,5
1649891725555,ECE 180,B00,083392,Abi Samra; Nicholas Camill,22,0,30,8
1649891731590,MATH 10B,A01,084110,Staff,12,0,30,18
1649891731590,MATH 10B,A02,084111,Staff,29,0,30,1
1649891731590,MATH 10B,A03,084112,Staff,28,0,30,2
1649891737617,MATH 10C,A01,083443,Staff,13,0,30,17
1649891737617,MATH 10C,A02,083444,Staff,17,0,30,13
1649891737617,MATH 10C,B01,084114,Staff,26,0,30,4
1649891737617,MATH 10C,B02,084115,Staff,30,0,30,0
1649891743647,MATH 18,A01,084117,Harel; Guershon,27,0,30,3
1649891743647,MATH 18,A02,084119,Harel; Guershon,29,0,30,1
1649891743647,MATH 18,A03,084120,Harel; Guershon,30,0,30,0
1649891743647,MATH 18,A04,084121,Harel; Guershon,30,0,30,0
1649891749673,MATH 20B,A01,084124,Um; Ko Woon,32,0,35,3
1649891749673,MATH 20B,B01,084126,Um; Ko Woon,33,0,35,2
1649891755699,MATH 20C,A01,083446,Hammock; Frances H,20,0,30,10
1649891755699,MATH 20C,A02,083447,Hammock; Frances H,28,0,30,2
1649891755699,MATH 20C,A03,083448,Hammock; Frances H,30,0,30,0
1649891755699,MATH 20C,A04,083449,Hammock; Frances H,30,0,30,0
1649891755699,MATH 20C,B01,083451,Hammock; Frances H,26,0,30,4
1649891755699,MATH 20C,B02,083452,Hammock; Frances H,29,0,30,1
1649891755699,MATH 20C,B03,083453,Hammock; Frances H,29,0,30,1
1649891755699,MATH 20C,B04,083454,Hammock; Frances H,30,0,30,0
1649891761728,MATH 20D,A01,084128,Staff,29,0,30,1
1649891761728,MATH 20D,A02,084129,Staff,30,0,30,0
1649891761728,MATH 20D,A03,084130,Staff,29,0,30,1
1649891761728,MATH 20D,B01,084133,Staff,28,0,30,2
1649891761728,MATH 20D,B02,084134,Staff,28,0,30,2
1649891761728,MATH 20D,B03,084135,Staff,30,0,30,0
1649891767751,MATH 20E,A01,084138,Staff,25,0,30,5
1649891767751,MATH 20E,A02,084139,Staff,25,0,30,5
1649891767751,MATH 20E,A03,084140,Staff,25,0,30,5
1649891767751,MATH 20E,A04,084141,Staff,28,0,30,2
1649891773782,MATH 102,A01,084143,Harel; Guershon,21,0,30,9
1649891773782,MATH 102,A02,084144,Harel; Guershon,23,0,30,7
1649891779821,MATH 103B,A01,083456,Staff,0,4,30,30
1649891779821,MATH 103B,A02,083457,Staff,0,3,30,30
1649891785844,MATH 109,A01,084146,Salehi Golsefidy; Alireza,29,0,30,1
1649891785844,MATH 109,A02,084147,Salehi Golsefidy; Alireza,24,0,30,6
1649891791866,MATH 120A,A01,085445,Eggers; John Dietrich,22,0,35,13
1649891791866,MATH 120A,A02,085446,Eggers; John Dietrich,28,0,35,7
1649891797898,MATH 142B,A01,084149,Verstraete; Jacques Allan,0,3,30,30
1649891797898,MATH 142B,A02,084150,Verstraete; Jacques Allan,0,2,30,30
1649891803923,MATH 170A,A01,083459,Nie; Jiawang,0,1,30,30
1649891803923,MATH 170A,A02,083460,Nie; Jiawang,12,0,30,18
1649891803923,MATH 170A,A03,083461,Nie; Jiawang,20,0,30,10
1649891809948,MATH 193B,A01,083463,Staff,7,0,30,23
1649891809948,MATH 193B,A02,083464,Staff,13,0,30,17
1649891809948,MATH 193B,A03,083465,Staff,24,0,30,6
1649891816013,COGS 2,A01,083966,Boyle; Mary E. T.,22,0,30,8
1649891822035,COGS 9,A01,083968,Staff,48,0,60,12
1649891828066,COGS 14B,A01,083970,Staff,40,0,50,10
1649891834089,COGS 17,A01,092679,Staff,68,0,75,7
1649891840116,COGS 100,A01,083972,Staff,33,0,60,27
1649891852164,COGS 101C,A01,083976,Staff,22,0,30,8
1649891858189,COGS 102A,A01,083978,Johnson; Christine M.,19,0,30,11
1649891864213,COGS 107B,A01,083980,Staff,14,0,50,36
1649891870234,COGS 115,A01,083982,Staff,13,0,30,17
1649891876258,COGS 118B,A01,083367,Staff,0,6,40,40
1649891882294,COGS 172,A01,083984,Provenzano; Emily Kara,17,0,30,13
1649891888317,COGS 177,A00,083368,Staff,1,13,30,29
1649891894345,COGS 186,A01,083986,Staff,23,0,40,17
1649891900368,COGS 187A,A01,083988,Boyle; Mary E. T.,25,0,60,35
1649891906394,CSE 8A,A50,084003,Miranda; Gregory Joseph,6,0,15,9
1649891912421,CSE 11,A01,084005,Miranda; Gregory Joseph,36,0,55,19
1649891918444,CSE 20,A01,084007,Staff,12,0,20,8
1649891924465,CSE 21,A01,084009,Staff,20,0,50,30
1649891930488,CSE 30,A01,083370,Cao; Yingjun,0,1,40,40
1649891936514,CSE 100,A01,083372,Cao; Yingjun,0,13,40,40
1649891942540,CSE 101,A01,084011,Staff,1,38,40,39
1649891948571,CSE 141,A01,083374,Eldon; John,1,43,75,74
1649891954594,CSE 141L,A01,083376,Eldon; John,1,46,75,74
1649891960621,CSE 175,A01,084013,Kumar; Rakesh,22,0,25,3
1649891966643,CSE 190,A00,092508,Dubnov; Shlomo,15,0,15,0
1649891972674,ECE 5,A01,084049,Morris; Karcher William,16,0,20,4
1649891978698,ECE 100,A01,084051,Baghdadchi; Saharnaz,5,0,20,15
1649891978698,ECE 100,A02,091916,Baghdadchi; Saharnaz,18,0,20,2
1649891984732,ECE 101,A01,084053,Baghdadchi; Saharnaz,11,0,37,26
1649891984732,ECE 101,A02,084054,Baghdadchi; Saharnaz,37,0,37,0
1649891990770,ECE 107,A01,083390,Staff,29,0,40,11
1649891996795,ECE 148,A01,084056,Silberman; Jack,7,0,12,5
1649892002820,ECE 180,A00,083391,Abi Samra; Nicholas Camill,25,0,30,5
1649892002820,ECE 180,B00,083392,Abi Samra; Nicholas Camill,22,0,30,8
1649892008849,MATH 10B,A01,084110,Staff,12,0,30,18
1649892008849,MATH 10B,A02,084111,Staff,29,0,30,1
1649892008849,MATH 10B,A03,084112,Staff,28,0,30,2
1649892014877,MATH 10C,A01,083443,Staff,13,0,30,17
1649892014877,MATH 10C,A02,083444,Staff,17,0,30,13
1649892014877,MATH 10C,B01,084114,Staff,26,0,30,4
1649892014877,MATH 10C,B02,084115,Staff,30,0,30,0
1649892020904,MATH 18,A01,084117,Harel; Guershon,27,0,30,3
1649892020904,MATH 18,A02,084119,Harel; Guershon,29,0,30,1
1649892020904,MATH 18,A03,084120,Harel; Guershon,30,0,30,0
1649892020904,MATH 18,A04,084121,Harel; Guershon,30,0,30,0
1649892026933,MATH 20B,A01,084124,Um; Ko Woon,32,0,35,3
1649892026933,MATH 20B,B01,084126,Um; Ko Woon,33,0,35,2
1649892032957,MATH 20C,A01,083446,Hammock; Frances H,20,0,30,10
1649892032957,MATH 20C,A02,083447,Hammock; Frances H,28,0,30,2
1649892032957,MATH 20C,A03,083448,Hammock; Frances H,30,0,30,0
1649892032957,MATH 20C,A04,083449,Hammock; Frances H,30,0,30,0
1649892032957,MATH 20C,B01,083451,Hammock; Frances H,26,0,30,4
1649892032957,MATH 20C,B02,083452,Hammock; Frances H,29,0,30,1
1649892032957,MATH 20C,B03,083453,Hammock; Frances H,29,0,30,1
1649892032957,MATH 20C,B04,083454,Hammock; Frances H,30,0,30,0
1649892038980,MATH 20D,A01,084128,Staff,29,0,30,1
1649892038980,MATH 20D,A02,084129,Staff,30,0,30,0
1649892038980,MATH 20D,A03,084130,Staff,29,0,30,1
1649892038980,MATH 20D,B01,084133,Staff,28,0,30,2
1649892038980,MATH 20D,B02,084134,Staff,28,0,30,2
1649892038980,MATH 20D,B03,084135,Staff,30,0,30,0
1649892045008,MATH 20E,A01,084138,Staff,25,0,30,5
1649892045008,MATH 20E,A02,084139,Staff,25,0,30,5
1649892045008,MATH 20E,A03,084140,Staff,25,0,30,5
1649892045008,MATH 20E,A04,084141,Staff,28,0,30,2
1649892051035,MATH 102,A01,084143,Harel; Guershon,21,0,30,9
1649892051035,MATH 102,A02,084144,Harel; Guershon,23,0,30,7
1649892057059,MATH 103B,A01,083456,Staff,0,4,30,30
1649892057059,MATH 103B,A02,083457,Staff,0,3,30,30
1649892063092,MATH 109,A01,084146,Salehi Golsefidy; Alireza,29,0,30,1
1649892063092,MATH 109,A02,084147,Salehi Golsefidy; Alireza,24,0,30,6
1649892069114,MATH 120A,A01,085445,Eggers; John Dietrich,21,0,35,14
1649892069114,MATH 120A,A02,085446,Eggers; John Dietrich,28,0,35,7
1649892075137,MATH 142B,A01,084149,Verstraete; Jacques Allan,0,3,30,30
1649892075137,MATH 142B,A02,084150,Verstraete; Jacques Allan,0,3,30,30
1649892081166,MATH 170A,A01,083459,Nie; Jiawang,0,1,30,30
1649892081166,MATH 170A,A02,083460,Nie; Jiawang,12,0,30,18
1649892081166,MATH 170A,A03,083461,Nie; Jiawang,20,0,30,10
1649892087193,MATH 193B,A01,083463,Staff,7,0,30,23
1649892087193,MATH 193B,A02,083464,Staff,13,0,30,17
1649892087193,MATH 193B,A03,083465,Staff,24,0,30,6
1649892093249,COGS 2,A01,083966,Boyle; Mary E. T.,22,0,30,8
1649892099276,COGS 9,A01,083968,Staff,48,0,60,12
1649892105299,COGS 14B,A01,083970,Staff,40,0,50,10
1649892111343,COGS 17,A01,092679,Staff,68,0,75,7
1649892117365,COGS 100,A01,083972,Staff,33,0,60,27
1649892129412,COGS 101C,A01,083976,Staff,22,0,30,8
1649892135439,COGS 102A,A01,083978,Johnson; Christine M.,19,0,30,11
1649892141469,COGS 107B,A01,083980,Staff,14,0,50,36
1649892147494,COGS 115,A01,083982,Staff,13,0,30,17
1649892153520,COGS 118B,A01,083367,Staff,0,6,40,40
1649892159544,COGS 172,A01,083984,Provenzano; Emily Kara,17,0,30,13
1649892165573,COGS 177,A00,083368,Staff,1,13,30,29
1649892171608,COGS 186,A01,083986,Staff,23,0,40,17
1649892177633,COGS 187A,A01,083988,Boyle; Mary E. T.,25,0,60,35
1649892183661,CSE 8A,A50,084003,Miranda; Gregory Joseph,7,0,15,8
1649892189686,CSE 11,A01,084005,Miranda; Gregory Joseph,36,0,55,19
1649892195712,CSE 20,A01,084007,Staff,12,0,20,8
1649892201736,CSE 21,A01,084009,Staff,20,0,50,30
1649892207762,CSE 30,A01,083370,Cao; Yingjun,0,1,40,40
1649892213794,CSE 100,A01,083372,Cao; Yingjun,0,13,40,40
1649892219818,CSE 101,A01,084011,Staff,1,38,40,39
1649892225844,CSE 141,A01,083374,Eldon; John,1,43,75,74
1649892231876,CSE 141L,A01,083376,Eldon; John,1,46,75,74
1649892237925,CSE 175,A01,084013,Kumar; Rakesh,22,0,25,3
1649892243952,CSE 190,A00,092508,Dubnov; Shlomo,15,0,15,0
1649892249979,ECE 5,A01,084049,Morris; Karcher William,16,0,20,4
1649892256007,ECE 100,A01,084051,Baghdadchi; Saharnaz,5,0,20,15
1649892256007,ECE 100,A02,091916,Baghdadchi; Saharnaz,18,0,20,2
1649892262031,ECE 101,A01,084053,Baghdadchi; Saharnaz,11,0,37,26
1649892262031,ECE 101,A02,084054,Baghdadchi; Saharnaz,37,0,37,0
1649892268133,ECE 107,A01,083390,Staff,29,0,40,11
1649892274161,ECE 148,A01,084056,Silberman; Jack,7,0,12,5
1649892280184,ECE 180,A00,083391,Abi Samra; Nicholas Camill,25,0,30,5
1649892280184,ECE 180,B00,083392,Abi Samra; Nicholas Camill,22,0,30,8
1649892286210,MATH 10B,A01,084110,Staff,12,0,30,18
1649892286210,MATH 10B,A02,084111,Staff,29,0,30,1
1649892286210,MATH 10B,A03,084112,Staff,28,0,30,2
1649892292238,MATH 10C,A01,083443,Staff,13,0,30,17
1649892292238,MATH 10C,A02,083444,Staff,17,0,30,13
1649892292238,MATH 10C,B01,084114,Staff,26,0,30,4
1649892292238,MATH 10C,B02,084115,Staff,30,0,30,0
1649892298262,MATH 18,A01,084117,Harel; Guershon,27,0,30,3
1649892298262,MATH 18,A02,084119,Harel; Guershon,29,0,30,1
1649892298262,MATH 18,A03,084120,Harel; Guershon,30,0,30,0
1649892298262,MATH 18,A04,084121,Harel; Guershon,30,0,30,0
1649892304283,MATH 20B,A01,084124,Um; Ko Woon,32,0,35,3
1649892304283,MATH 20B,B01,084126,Um; Ko Woon,33,0,35,2
1649892310307,MATH 20C,A01,083446,Hammock; Frances H,20,0,30,10
1649892310307,MATH 20C,A02,083447,Hammock; Frances H,28,0,30,2
1649892310307,MATH 20C,A03,083448,Hammock; Frances H,30,0,30,0
1649892310307,MATH 20C,A04,083449,Hammock; Frances H,30,0,30,0
1649892310307,MATH 20C,B01,083451,Hammock; Frances H,26,0,30,4
1649892310307,MATH 20C,B02,083452,Hammock; Frances H,29,0,30,1
1649892310307,MATH 20C,B03,083453,Hammock; Frances H,29,0,30,1
1649892310307,MATH 20C,B04,083454,Hammock; Frances H,30,0,30,0
1649892316333,MATH 20D,A01,084128,Staff,29,0,30,1
1649892316333,MATH 20D,A02,084129,Staff,30,0,30,0
1649892316333,MATH 20D,A03,084130,Staff,29,0,30,1
1649892316333,MATH 20D,B01,084133,Staff,28,0,30,2
1649892316333,MATH 20D,B02,084134,Staff,28,0,30,2
1649892316333,MATH 20D,B03,084135,Staff,30,0,30,0
1649892322358,MATH 20E,A01,084138,Staff,25,0,30,5
1649892322358,MATH 20E,A02,084139,Staff,25,0,30,5
1649892322358,MATH 20E,A03,084140,Staff,25,0,30,5
1649892322358,MATH 20E,A04,084141,Staff,28,0,30,2
1649892328382,MATH 102,A01,084143,Harel; Guershon,21,0,30,9
1649892328382,MATH 102,A02,084144,Harel; Guershon,23,0,30,7
1649892334404,MATH 103B,A01,083456,Staff,0,4,30,30
1649892334404,MATH 103B,A02,083457,Staff,0,3,30,30
1649892340430,MATH 109,A01,084146,Salehi Golsefidy; Alireza,29,0,30,1
1649892340430,MATH 109,A02,084147,Salehi Golsefidy; Alireza,24,0,30,6
1649892346466,MATH 120A,A01,085445,Eggers; John Dietrich,21,0,35,14
1649892346466,MATH 120A,A02,085446,Eggers; John Dietrich,28,0,35,7
1649892352490,MATH 142B,A01,084149,Verstraete; Jacques Allan,0,3,30,30
1649892352490,MATH 142B,A02,084150,Verstraete; Jacques Allan,0,3,30,30
1649892358514,MATH 170A,A01,083459,Nie; Jiawang,0,1,30,30
1649892358514,MATH 170A,A02,083460,Nie; Jiawang,12,0,30,18
1649892358514,MATH 170A,A03,083461,Nie; Jiawang,20,0,30,10
1649892364553,MATH 193B,A01,083463,Staff,7,0,30,23
1649892364553,MATH 193B,A02,083464,Staff,13,0,30,17
1649892364553,MATH 193B,A03,083465,Staff,24,0,30,6
1649892370611,COGS 2,A01,083966,Boyle; Mary E. T.,22,0,30,8
1649892376651,COGS 9,A01,083968,Staff,48,0,60,12
1649892382687,COGS 14B,A01,083970,Staff,41,0,50,9
1649892388710,COGS 17,A01,092679,Staff,68,0,75,7
1649892394737,COGS 100,A01,083972,Staff,33,0,60,27
1649892406803,COGS 101C,A01,083976,Staff,22,0,30,8
1649892412829,COGS 102A,A01,083978,Johnson; Christine M.,19,0,30,11
1649892418855,COGS 107B,A01,083980,Staff,14,0,50,36
1649892424879,COGS 115,A01,083982,Staff,13,0,30,17
1649892430906,COGS 118B,A01,083367,Staff,0,6,40,40
1649892436941,COGS 172,A01,083984,Provenzano; Emily Kara,17,0,30,13
1649892442970,COGS 177,A00,083368,Staff,1,13,30,29
1649892449000,COGS 186,A01,083986,Staff,23,0,40,17
1649892455030,COGS 187A,A01,083988,Boyle; Mary E. T.,25,0,60,35
1649892461054,CSE 8A,A50,084003,Miranda; Gregory Joseph,6,0,15,9
1649892467076,CSE 11,A01,084005,Miranda; Gregory Joseph,36,0,55,19
1649892473102,CSE 20,A01,084007,Staff,12,0,20,8
1649892479140,CSE 21,A01,084009,Staff,20,0,50,30
1649892485166,CSE 30,A01,083370,Cao; Yingjun,0,1,40,40
1649892491193,CSE 100,A01,083372,Cao; Yingjun,0,13,40,40
1649892497220,CSE 101,A01,084011,Staff,1,38,40,39
1649892503249,CSE 141,A01,083374,Eldon; John,1,43,75,74
1649892509286,CSE 141L,A01,083376,Eldon; John,1,46,75,74
1649892515314,CSE 175,A01,084013,Kumar; Rakesh,22,0,25,3
1649892521344,CSE 190,A00,092508,Dubnov; Shlomo,15,0,15,0
1649892527378,ECE 5,A01,084049,Morris; Karcher William,16,0,20,4
1649892533412,ECE 100,A01,084051,Baghdadchi; Saharnaz,5,0,20,15
1649892533412,ECE 100,A02,091916,Baghdadchi; Saharnaz,18,0,20,2
1649892539464,ECE 101,A01,084053,Baghdadchi; Saharnaz,11,0,37,26
1649892539464,ECE 101,A02,084054,Baghdadchi; Saharnaz,37,0,37,0
1649892545486,ECE 107,A01,083390,Staff,29,0,40,11
1649892551510,ECE 148,A01,084056,Silberman; Jack,7,0,12,5
1649892557537,ECE 180,A00,083391,Abi Samra; Nicholas Camill,25,0,30,5
1649892557537,ECE 180,B00,083392,Abi Samra; Nicholas Camill,22,0,30,8
1649892563560,MATH 10B,A01,084110,Staff,12,0,30,18
1649892563560,MATH 10B,A02,084111,Staff,29,0,30,1
1649892563560,MATH 10B,A03,084112,Staff,28,0,30,2
1649892569584,MATH 10C,A01,083443,Staff,13,0,30,17
1649892569584,MATH 10C,A02,083444,Staff,17,0,30,13
1649892569584,MATH 10C,B01,084114,Staff,26,0,30,4
1649892569584,MATH 10C,B02,084115,Staff,30,0,30,0
1649892575615,MATH 18,A01,084117,Harel; Guershon,27,0,30,3
1649892575615,MATH 18,A02,084119,Harel; Guershon,29,0,30,1
1649892575615,MATH 18,A03,084120,Harel; Guershon,30,0,30,0
1649892575615,MATH 18,A04,084121,Harel; Guershon,30,0,30,0
1649892581642,MATH 20B,A01,084124,Um; Ko Woon,32,0,35,3
1649892581642,MATH 20B,B01,084126,Um; Ko Woon,33,0,35,2
1649892587670,MATH 20C,A01,083446,Hammock; Frances H,20,0,30,10
1649892587670,MATH 20C,A02,083447,Hammock; Frances H,28,0,30,2
1649892587670,MATH 20C,A03,083448,Hammock; Frances H,30,0,30,0
1649892587670,MATH 20C,A04,083449,Hammock; Frances H,30,0,30,0
1649892587670,MATH 20C,B01,083451,Hammock; Frances H,26,0,30,4
1649892587670,MATH 20C,B02,083452,Hammock; Frances H,29,0,30,1
1649892587670,MATH 20C,B03,083453,Hammock; Frances H,29,0,30,1
1649892587670,MATH 20C,B04,083454,Hammock; Frances H,30,0,30,0
1649892593692,MATH 20D,A01,084128,Staff,29,0,30,1
1649892593692,MATH 20D,A02,084129,Staff,30,0,30,0
1649892593692,MATH 20D,A03,084130,Staff,29,0,30,1
1649892593692,MATH 20D,B01,084133,Staff,28,0,30,2
1649892593692,MATH 20D,B02,084134,Staff,28,0,30,2
1649892593692,MATH 20D,B03,084135,Staff,30,0,30,0
1649892599714,MATH 20E,A01,084138,Staff,25,0,30,5
1649892599714,MATH 20E,A02,084139,Staff,25,0,30,5
1649892599714,MATH 20E,A03,084140,Staff,25,0,30,5
1649892599714,MATH 20E,A04,084141,Staff,28,0,30,2
1649892605745,MATH 102,A01,084143,Harel; Guershon,21,0,30,9
1649892605745,MATH 102,A02,084144,Harel; Guershon,23,0,30,7
1649892611770,MATH 103B,A01,083456,Staff,0,4,30,30
1649892611770,MATH 103B,A02,083457,Staff,0,3,30,30
1649892617799,MATH 109,A01,084146,Salehi Golsefidy; Alireza,29,0,30,1
1649892617799,MATH 109,A02,084147,Salehi Golsefidy; Alireza,24,0,30,6
1649892623833,MATH 120A,A01,085445,Eggers; John Dietrich,21,0,35,14
1649892623833,MATH 120A,A02,085446,Eggers; John Dietrich,28,0,35,7
1649892629859,MATH 142B,A01,084149,Verstraete; Jacques Allan,0,3,30,30
1649892629859,MATH 142B,A02,084150,Verstraete; Jacques Allan,0,3,30,30
1649892635883,MATH 170A,A01,083459,Nie; Jiawang,0,1,30,30
1649892635883,MATH 170A,A02,083460,Nie; Jiawang,12,0,30,18
1649892635883,MATH 170A,A03,083461,Nie; Jiawang,20,0,30,10
1649892641906,MATH 193B,A01,083463,Staff,7,0,30,23
1649892641906,MATH 193B,A02,083464,Staff,13,0,30,17
1649892641906,MATH 193B,A03,083465,Staff,24,0,30,6
1649892647966,COGS 2,A01,083966,Boyle; Mary E. T.,22,0,30,8
1649892653996,COGS 9,A01,083968,Staff,48,0,60,12
1649892660028,COGS 14B,A01,083970,Staff,40,0,50,10
1649892666055,COGS 17,A01,092679,Staff,68,0,75,7
1649892672088,COGS 100,A01,083972,Staff,33,0,60,27
1649892684134,COGS 101C,A01,083976,Staff,22,0,30,8
1649892690161,COGS 102A,A01,083978,Johnson; Christine M.,19,0,30,11
1649892696184,COGS 107B,A01,083980,Staff,14,0,50,36
1649892702211,COGS 115,A01,083982,Staff,13,0,30,17
1649892708239,COGS 118B,A01,083367,Staff,0,6,40,40
1649892714269,COGS 172,A01,083984,Provenzano; Emily Kara,17,0,30,13
1649892720297,COGS 177,A00,083368,Staff,1,13,30,29
1649892726323,COGS 186,A01,083986,Staff,23,0,40,17
1649892732353,COGS 187A,A01,083988,Boyle; Mary E. T.,25,0,60,35
1649892738388,CSE 8A,A50,084003,Miranda; Gregory Joseph,6,0,15,9
1649892744415,CSE 11,A01,084005,Miranda; Gregory Joseph,36,0,55,19
1649892750444,CSE 20,A01,084007,Staff,12,0,20,8
1649892756480,CSE 21,A01,084009,Staff,20,0,50,30
1649892762514,CSE 30,A01,083370,Cao; Yingjun,0,1,40,40
1649892768549,CSE 100,A01,083372,Cao; Yingjun,0,13,40,40
1649892774579,CSE 101,A01,084011,Staff,1,38,40,39
1649892780611,CSE 141,A01,083374,Eldon; John,1,43,75,74
1649892786641,CSE 141L,A01,083376,Eldon; John,1,46,75,74
1649892792665,CSE 175,A01,084013,Kumar; Rakesh,22,0,25,3
1649892798694,CSE 190,A00,092508,Dubnov; Shlomo,15,0,15,0
1649892804717,ECE 5,A01,084049,Morris; Karcher William,16,0,20,4
1649892810751,ECE 100,A01,084051,Baghdadchi; Saharnaz,4,0,20,16
1649892810751,ECE 100,A02,091916,Baghdadchi; Saharnaz,18,0,20,2
1649892816775,ECE 101,A01,084053,Baghdadchi; Saharnaz,10,0,37,27
1649892816775,ECE 101,A02,084054,Baghdadchi; Saharnaz,37,0,37,0
1649892822799,ECE 107,A01,083390,Staff,29,0,40,11
1649892828821,ECE 148,A01,084056,Silberman; Jack,7,0,12,5
1649892834848,ECE 180,A00,083391,Abi Samra; Nicholas Camill,25,0,30,5
1649892834848,ECE 180,B00,083392,Abi Samra; Nicholas Camill,22,0,30,8
1649892840881,MATH 10B,A01,084110,Staff,12,0,30,18
1649892840881,MATH 10B,A02,084111,Staff,29,0,30,1
1649892840881,MATH 10B,A03,084112,Staff,28,0,30,2
1649892846910,MATH 10C,A01,083443,Staff,13,0,30,17
1649892846910,MATH 10C,A02,083444,Staff,17,0,30,13
1649892846910,MATH 10C,B01,084114,Staff,26,0,30,4
1649892846910,MATH 10C,B02,084115,Staff,30,0,30,0
1649892852943,MATH 18,A01,084117,Harel; Guershon,27,0,30,3
1649892852943,MATH 18,A02,084119,Harel; Guershon,29,0,30,1
1649892852943,MATH 18,A03,084120,Harel; Guershon,30,0,30,0
1649892852943,MATH 18,A04,084121,Harel; Guershon,30,0,30,0
1649892858970,MATH 20B,A01,084124,Um; Ko Woon,32,0,35,3
1649892858970,MATH 20B,B01,084126,Um; Ko Woon,33,0,35,2
1649892865073,MATH 20C,A01,083446,Hammock; Frances H,20,0,30,10
1649892865073,MATH 20C,A02,083447,Hammock; Frances H,28,0,30,2
1649892865073,MATH 20C,A03,083448,Hammock; Frances H,30,0,30,0
1649892865073,MATH 20C,A04,083449,Hammock; Frances H,30,0,30,0
1649892865073,MATH 20C,B01,083451,Hammock; Frances H,26,0,30,4
1649892865073,MATH 20C,B02,083452,Hammock; Frances H,29,0,30,1
1649892865073,MATH 20C,B03,083453,Hammock; Frances H,29,0,30,1
1649892865073,MATH 20C,B04,083454,Hammock; Frances H,30,0,30,0
1649892871099,MATH 20D,A01,084128,Staff,29,0,30,1
1649892871099,MATH 20D,A02,084129,Staff,30,0,30,0
1649892871099,MATH 20D,A03,084130,Staff,29,0,30,1
1649892871099,MATH 20D,B01,084133,Staff,28,0,30,2
1649892871099,MATH 20D,B02,084134,Staff,28,0,30,2
1649892871099,MATH 20D,B03,084135,Staff,30,0,30,0
1649892877126,MATH 20E,A01,084138,Staff,25,0,30,5
1649892877126,MATH 20E,A02,084139,Staff,25,0,30,5
1649892877126,MATH 20E,A03,084140,Staff,25,0,30,5
1649892877126,MATH 20E,A04,084141,Staff,28,0,30,2
1649892883166,MATH 102,A01,084143,Harel; Guershon,21,0,30,9
1649892883166,MATH 102,A02,084144,Harel; Guershon,23,0,30,7
1649892889204,MATH 103B,A01,083456,Staff,0,4,30,30
1649892889204,MATH 103B,A02,083457,Staff,0,3,30,30
1649892895235,MATH 109,A01,084146,Salehi Golsefidy; Alireza,29,0,30,1
1649892895235,MATH 109,A02,084147,Salehi Golsefidy; Alireza,24,0,30,6
1649892901259,MATH 120A,A01,085445,Eggers; John Dietrich,21,0,35,14
1649892901259,MATH 120A,A02,085446,Eggers; John Dietrich,28,0,35,7
1649892907286,MATH 142B,A01,084149,Verstraete; Jacques Allan,0,3,30,30
1649892907286,MATH 142B,A02,084150,Verstraete; Jacques Allan,0,3,30,30
1649892913321,MATH 170A,A01,083459,Nie; Jiawang,0,1,30,30
1649892913321,MATH 170A,A02,083460,Nie; Jiawang,11,0,30,19
1649892913321,MATH 170A,A03,083461,Nie; Jiawang,20,0,30,10
1649892919344,MATH 193B,A01,083463,Staff,7,0,30,23
1649892919344,MATH 193B,A02,083464,Staff,13,0,30,17
1649892919344,MATH 193B,A03,083465,Staff,23,0,30,7
1649892925403,COGS 2,A01,083966,Boyle; Mary E. T.,22,0,30,8
1649892931430,COGS 9,A01,083968,Staff,48,0,60,12
1649892937455,COGS 14B,A01,083970,Staff,40,0,50,10
1649892943478,COGS 17,A01,092679,Staff,68,0,75,7
1649892949502,COGS 100,A01,083972,Staff,33,0,60,27
1649892961550,COGS 101C,A01,083976,Staff,22,0,30,8
1649892967578,COGS 102A,A01,083978,Johnson; Christine M.,19,0,30,11
1649892973599,COGS 107B,A01,083980,Staff,14,0,50,36
1649892979625,COGS 115,A01,083982,Staff,13,0,30,17
1649892985649,COGS 118B,A01,083367,Staff,0,6,40,40
1649892991676,COGS 172,A01,083984,Provenzano; Emily Kara,17,0,30,13
1649892997701,COGS 177,A00,083368,Staff,1,13,30,29
1649893003724,COGS 186,A01,083986,Staff,23,0,40,17
1649893009754,COGS 187A,A01,083988,Boyle; Mary E. T.,25,0,60,35
1649893015782,CSE 8A,A50,084003,Miranda; Gregory Joseph,6,0,15,9
1649893021814,CSE 11,A01,084005,Miranda; Gregory Joseph,36,0,55,19
1649893027837,CSE 20,A01,084007,Staff,12,0,20,8
1649893033866,CSE 21,A01,084009,Staff,19,0,50,31
1649893039928,CSE 30,A01,083370,Cao; Yingjun,0,2,40,40
1649893045954,CSE 100,A01,083372,Cao; Yingjun,0,13,40,40
1649893051977,CSE 101,A01,084011,Staff,1,38,40,39
1649893058000,CSE 141,A01,083374,Eldon; John,1,43,75,74
1649893064023,CSE 141L,A01,083376,Eldon; John,1,46,75,74
1649893070047,CSE 175,A01,084013,Kumar; Rakesh,22,0,25,3
1649893076075,CSE 190,A00,092508,Dubnov; Shlomo,15,0,15,0
1649893082104,ECE 5,A01,084049,Morris; Karcher William,16,0,20,4
1649893088128,ECE 100,A01,084051,Baghdadchi; Saharnaz,4,0,20,16
1649893088128,ECE 100,A02,091916,Baghdadchi; Saharnaz,18,0,20,2
1649893094168,ECE 101,A01,084053,Baghdadchi; Saharnaz,10,0,37,27
1649893094168,ECE 101,A02,084054,Baghdadchi; Saharnaz,37,0,37,0
1649893100197,ECE 107,A01,083390,Staff,29,0,40,11
1649893106225,ECE 148,A01,084056,Silberman; Jack,7,0,12,5
1649893112247,ECE 180,A00,083391,Abi Samra; Nicholas Camill,25,0,30,5
1649893112247,ECE 180,B00,083392,Abi Samra; Nicholas Camill,22,0,30,8
1649893118276,MATH 10B,A01,084110,Staff,11,0,30,19
1649893118276,MATH 10B,A02,084111,Staff,29,0,30,1
1649893118276,MATH 10B,A03,084112,Staff,28,0,30,2
1649893124300,MATH 10C,A01,083443,Staff,13,0,30,17
1649893124300,MATH 10C,A02,083444,Staff,17,0,30,13
1649893124300,MATH 10C,B01,084114,Staff,26,0,30,4
1649893124300,MATH 10C,B02,084115,Staff,30,0,30,0
1649893130336,MATH 18,A01,084117,Harel; Guershon,27,0,30,3
1649893130336,MATH 18,A02,084119,Harel; Guershon,29,0,30,1
1649893130336,MATH 18,A03,084120,Harel; Guershon,30,0,30,0
1649893130336,MATH 18,A04,084121,Harel; Guershon,30,0,30,0
1649893136376,MATH 20B,A01,084124,Um; Ko Woon,32,0,35,3
1649893136376,MATH 20B,B01,084126,Um; Ko Woon,33,0,35,2
1649893142406,MATH 20C,A01,083446,Hammock; Frances H,20,0,30,10
1649893142406,MATH 20C,A02,083447,Hammock; Frances H,28,0,30,2
1649893142406,MATH 20C,A03,083448,Hammock; Frances H,30,0,30,0
1649893142406,MATH 20C,A04,083449,Hammock; Frances H,30,0,30,0
1649893142406,MATH 20C,B01,083451,Hammock; Frances H,26,0,30,4
1649893142406,MATH 20C,B02,083452,Hammock; Frances H,29,0,30,1
1649893142406,MATH 20C,B03,083453,Hammock; Frances H,29,0,30,1
1649893142406,MATH 20C,B04,083454,Hammock; Frances H,30,0,30,0
1649893148429,MATH 20D,A01,084128,Staff,29,0,30,1
1649893148429,MATH 20D,A02,084129,Staff,30,0,30,0
1649893148429,MATH 20D,A03,084130,Staff,29,0,30,1
1649893148429,MATH 20D,B01,084133,Staff,28,0,30,2
1649893148429,MATH 20D,B02,084134,Staff,28,0,30,2
1649893148429,MATH 20D,B03,084135,Staff,30,0,30,0
1649893154457,MATH 20E,A01,084138,Staff,25,0,30,5
1649893154457,MATH 20E,A02,084139,Staff,25,0,30,5
1649893154457,MATH 20E,A03,084140,Staff,25,0,30,5
1649893154457,MATH 20E,A04,084141,Staff,28,0,30,2
1649893160487,MATH 102,A01,084143,Harel; Guershon,21,0,30,9
1649893160487,MATH 102,A02,084144,Harel; Guershon,23,0,30,7
1649893166517,MATH 103B,A01,083456,Staff,0,4,30,30
1649893166517,MATH 103B,A02,083457,Staff,0,4,30,30
1649893172541,MATH 109,A01,084146,Salehi Golsefidy; Alireza,29,0,30,1
1649893172541,MATH 109,A02,084147,Salehi Golsefidy; Alireza,24,0,30,6
1649893178566,MATH 120A,A01,085445,Eggers; John Dietrich,21,0,35,14
1649893178566,MATH 120A,A02,085446,Eggers; John Dietrich,28,0,35,7
1649893184595,MATH 142B,A01,084149,Verstraete; Jacques Allan,0,3,30,30
1649893184595,MATH 142B,A02,084150,Verstraete; Jacques Allan,0,3,30,30
1649893190623,MATH 170A,A01,083459,Nie; Jiawang,0,1,30,30
1649893190623,MATH 170A,A02,083460,Nie; Jiawang,11,0,30,19
1649893190623,MATH 170A,A03,083461,Nie; Jiawang,21,0,30,9
1649893196665,MATH 193B,A01,083463,Staff,7,0,30,23
1649893196665,MATH 193B,A02,083464,Staff,13,0,30,17
1649893196665,MATH 193B,A03,083465,Staff,23,0,30,7
1649893202727,COGS 2,A01,083966,Boyle; Mary E. T.,21,0,30,9
1649893208748,COGS 9,A01,083968,Staff,48,0,60,12
1649893214771,COGS 14B,A01,083970,Staff,40,0,50,10
1649893220795,COGS 17,A01,092679,Staff,68,0,75,7
1649893226820,COGS 100,A01,083972,Staff,33,0,60,27
1649893238884,COGS 101C,A01,083976,Staff,22,0,30,8
1649893244907,COGS 102A,A01,083978,Johnson; Christine M.,19,0,30,11
1649893250934,COGS 107B,A01,083980,Staff,14,0,50,36
1649893256960,COGS 115,A01,083982,Staff,13,0,30,17
1649893262985,COGS 118B,A01,083367,Staff,0,7,40,40
1649893269009,COGS 172,A01,083984,Provenzano; Emily Kara,17,0,30,13
1649893275033,COGS 177,A00,083368,Staff,1,13,30,29
1649893281069,COGS 186,A01,083986,Staff,23,0,40,17
1649893287096,COGS 187A,A01,083988,Boyle; Mary E. T.,25,0,60,35
1649893293124,CSE 8A,A50,084003,Miranda; Gregory Joseph,5,0,15,10
1649893299147,CSE 11,A01,084005,Miranda; Gregory Joseph,34,0,55,21
1649893305171,CSE 20,A01,084007,Staff,12,0,20,8
1649893311197,CSE 21,A01,084009,Staff,19,0,50,31
1649893317220,CSE 30,A01,083370,Cao; Yingjun,0,2,40,40
1649893323247,CSE 100,A01,083372,Cao; Yingjun,0,13,40,40
1649893329270,CSE 101,A01,084011,Staff,1,38,40,39
1649893335293,CSE 141,A01,083374,Eldon; John,1,45,75,74
1649893341320,CSE 141L,A01,083376,Eldon; John,1,48,75,74
1649893347348,CSE 175,A01,084013,Kumar; Rakesh,22,0,25,3
1649893353374,CSE 190,A00,092508,Dubnov; Shlomo,15,0,15,0
1649893359396,ECE 5,A01,084049,Morris; Karcher William,16,0,20,4
1649893365420,ECE 100,A01,084051,Baghdadchi; Saharnaz,4,0,20,16
1649893365420,ECE 100,A02,091916,Baghdadchi; Saharnaz,18,0,20,2
1649893371443,ECE 101,A01,084053,Baghdadchi; Saharnaz,10,0,37,27
1649893371443,ECE 101,A02,084054,Baghdadchi; Saharnaz,37,0,37,0
1649893377466,ECE 107,A01,083390,Staff,29,0,40,11
1649893383490,ECE 148,A01,084056,Silberman; Jack,7,0,12,5
1649893389513,ECE 180,A00,083391,Abi Samra; Nicholas Camill,25,0,30,5
1649893389513,ECE 180,B00,083392,Abi Samra; Nicholas Camill,22,0,30,8
1649893395538,MATH 10B,A01,084110,Staff,10,0,30,20
1649893395538,MATH 10B,A02,084111,Staff,29,0,30,1
1649893395538,MATH 10B,A03,084112,Staff,28,0,30,2
1649893401564,MATH 10C,A01,083443,Staff,13,0,30,17
1649893401564,MATH 10C,A02,083444,Staff,17,0,30,13
1649893401564,MATH 10C,B01,084114,Staff,26,0,30,4
1649893401564,MATH 10C,B02,084115,Staff,30,0,30,0
1649893407593,MATH 18,A01,084117,Harel; Guershon,27,0,30,3
1649893407593,MATH 18,A02,084119,Harel; Guershon,29,0,30,1
1649893407593,MATH 18,A03,084120,Harel; Guershon,30,0,30,0
1649893407593,MATH 18,A04,084121,Harel; Guershon,30,0,30,0
1649893413620,MATH 20B,A01,084124,Um; Ko Woon,32,0,35,3
1649893413620,MATH 20B,B01,084126,Um; Ko Woon,33,0,35,2
1649893419658,MATH 20C,A01,083446,Hammock; Frances H,20,0,30,10
1649893419658,MATH 20C,A02,083447,Hammock; Frances H,28,0,30,2
1649893419658,MATH 20C,A03,083448,Hammock; Frances H,30,0,30,0
1649893419658,MATH 20C,A04,083449,Hammock; Frances H,30,0,30,0
1649893419658,MATH 20C,B01,083451,Hammock; Frances H,26,0,30,4
1649893419658,MATH 20C,B02,083452,Hammock; Frances H,29,0,30,1
1649893419658,MATH 20C,B03,083453,Hammock; Frances H,29,0,30,1
1649893419658,MATH 20C,B04,083454,Hammock; Frances H,30,0,30,0
1649893425685,MATH 20D,A01,084128,Staff,29,0,30,1
1649893425685,MATH 20D,A02,084129,Staff,30,0,30,0
1649893425685,MATH 20D,A03,084130,Staff,29,0,30,1
1649893425685,MATH 20D,B01,084133,Staff,27,0,30,3
1649893425685,MATH 20D,B02,084134,Staff,28,0,30,2
1649893425685,MATH 20D,B03,084135,Staff,30,0,30,0
1649893431709,MATH 20E,A01,084138,Staff,25,0,30,5
1649893431709,MATH 20E,A02,084139,Staff,25,0,30,5
1649893431709,MATH 20E,A03,084140,Staff,25,0,30,5
1649893431709,MATH 20E,A04,084141,Staff,28,0,30,2
1649893437744,MATH 102,A01,084143,Harel; Guershon,21,0,30,9
1649893437744,MATH 102,A02,084144,Harel; Guershon,23,0,30,7
1649893443779,MATH 103B,A01,083456,Staff,0,5,30,30
1649893443779,MATH 103B,A02,083457,Staff,0,4,30,30
1649893449813,MATH 109,A01,084146,Salehi Golsefidy; Alireza,29,0,30,1
1649893449813,MATH 109,A02,084147,Salehi Golsefidy; Alireza,24,0,30,6
1649893455857,MATH 120A,A01,085445,Eggers; John Dietrich,21,0,35,14
1649893455857,MATH 120A,A02,085446,Eggers; John Dietrich,28,0,35,7
1649893461962,MATH 142B,A01,084149,Verstraete; Jacques Allan,0,3,30,30
1649893461962,MATH 142B,A02,084150,Verstraete; Jacques Allan,0,3,30,30
1649893467991,MATH 170A,A01,083459,Nie; Jiawang,0,1,30,30
1649893467991,MATH 170A,A02,083460,Nie; Jiawang,12,0,30,18
1649893467991,MATH 170A,A03,083461,Nie; Jiawang,21,0,30,9
1649893474012,MATH 193B,A01,083463,Staff,7,0,30,23
1649893474012,MATH 193B,A02,083464,Staff,13,0,30,17
1649893474012,MATH 193B,A03,083465,Staff,23,0,30,7
1649893480069,COGS 2,A01,083966,Boyle; Mary E. T.,21,0,30,9
1649893486092,COGS 9,A01,083968,Staff,47,0,60,13
1649893492116,COGS 14B,A01,083970,Staff,40,0,50,10
1649893498141,COGS 17,A01,092679,Staff,68,0,75,7
1649893504164,COGS 100,A01,083972,Staff,33,0,60,27
1649893516214,COGS 101C,A01,083976,Staff,22,0,30,8
1649893522237,COGS 102A,A01,083978,Johnson; Christine M.,19,0,30,11
1649893528260,COGS 107B,A01,083980,Staff,13,0,50,37
1649893534285,COGS 115,A01,083982,Staff,13,0,30,17
1649893540316,COGS 118B,A01,083367,Staff,0,7,40,40
1649893546339,COGS 172,A01,083984,Provenzano; Emily Kara,17,0,30,13
1649893552361,COGS 177,A00,083368,Staff,1,13,30,29
1649893558394,COGS 186,A01,083986,Staff,23,0,40,17
1649893564422,COGS 187A,A01,083988,Boyle; Mary E. T.,25,0,60,35
1649893570452,CSE 8A,A50,084003,Miranda; Gregory Joseph,4,0,15,11
1649893576479,CSE 11,A01,084005,Miranda; Gregory Joseph,34,0,55,21
1649893582509,CSE 20,A01,084007,Staff,12,0,20,8
1649893588539,CSE 21,A01,084009,Staff,18,0,50,32
1649893594564,CSE 30,A01,083370,Cao; Yingjun,0,4,40,40
1649893600587,CSE 100,A01,083372,Cao; Yingjun,0,13,40,40
1649893606617,CSE 101,A01,084011,Staff,1,38,40,39
1649893612639,CSE 141,A01,083374,Eldon; John,1,45,75,74
1649893618666,CSE 141L,A01,083376,Eldon; John,1,48,75,74
1649893624689,CSE 175,A01,084013,Kumar; Rakesh,22,0,25,3
1649893630711,CSE 190,A00,092508,Dubnov; Shlomo,15,0,15,0
1649893636732,ECE 5,A01,084049,Morris; Karcher William,16,0,20,4
1649893642756,ECE 100,A01,084051,Baghdadchi; Saharnaz,4,0,20,16
1649893642756,ECE 100,A02,091916,Baghdadchi; Saharnaz,18,0,20,2
1649893648793,ECE 101,A01,084053,Baghdadchi; Saharnaz,10,0,37,27
1649893648793,ECE 101,A02,084054,Baghdadchi; Saharnaz,37,0,37,0
1649893654818,ECE 107,A01,083390,Staff,29,0,40,11
1649893660840,ECE 148,A01,084056,Silberman; Jack,7,0,12,5
1649893666864,ECE 180,A00,083391,Abi Samra; Nicholas Camill,25,0,30,5
1649893666864,ECE 180,B00,083392,Abi Samra; Nicholas Camill,22,0,30,8
1649893672891,MATH 10B,A01,084110,Staff,10,0,30,20
1649893672891,MATH 10B,A02,084111,Staff,29,0,30,1
1649893672891,MATH 10B,A03,084112,Staff,28,0,30,2
1649893678912,MATH 10C,A01,083443,Staff,13,0,30,17
1649893678912,MATH 10C,A02,083444,Staff,17,0,30,13
1649893678912,MATH 10C,B01,084114,Staff,26,0,30,4
1649893678912,MATH 10C,B02,084115,Staff,30,0,30,0
1649893684940,MATH 18,A01,084117,Harel; Guershon,27,0,30,3
1649893684940,MATH 18,A02,084119,Harel; Guershon,29,0,30,1
1649893684940,MATH 18,A03,084120,Harel; Guershon,30,0,30,0
1649893684940,MATH 18,A04,084121,Harel; Guershon,30,0,30,0
1649893690965,MATH 20B,A01,084124,Um; Ko Woon,32,0,35,3
1649893690965,MATH 20B,B01,084126,Um; Ko Woon,33,0,35,2
1649893696989,MATH 20C,A01,083446,Hammock; Frances H,20,0,30,10
1649893696989,MATH 20C,A02,083447,Hammock; Frances H,28,0,30,2
1649893696989,MATH 20C,A03,083448,Hammock; Frances H,30,0,30,0
1649893696989,MATH 20C,A04,083449,Hammock; Frances H,30,0,30,0
1649893696989,MATH 20C,B01,083451,Hammock; Frances H,26,0,30,4
1649893696989,MATH 20C,B02,083452,Hammock; Frances H,29,0,30,1
1649893696989,MATH 20C,B03,083453,Hammock; Frances H,29,0,30,1
1649893696989,MATH 20C,B04,083454,Hammock; Frances H,30,0,30,0
1649893703024,MATH 20D,A01,084128,Staff,29,0,30,1
1649893703024,MATH 20D,A02,084129,Staff,30,0,30,0
1649893703024,MATH 20D,A03,084130,Staff,29,0,30,1
1649893703024,MATH 20D,B01,084133,Staff,27,0,30,3
1649893703024,MATH 20D,B02,084134,Staff,28,0,30,2
1649893703024,MATH 20D,B03,084135,Staff,30,0,30,0
1649893709049,MATH 20E,A01,084138,Staff,25,0,30,5
1649893709049,MATH 20E,A02,084139,Staff,25,0,30,5
1649893709049,MATH 20E,A03,084140,Staff,25,0,30,5
1649893709049,MATH 20E,A04,084141,Staff,28,0,30,2
1649893715077,MATH 102,A01,084143,Harel; Guershon,21,0,30,9
1649893715077,MATH 102,A02,084144,Harel; Guershon,23,0,30,7
1649893721100,MATH 103B,A01,083456,Staff,0,5,30,30
1649893721100,MATH 103B,A02,083457,Staff,0,4,30,30
1649893727134,MATH 109,A01,084146,Salehi Golsefidy; Alireza,29,0,30,1
1649893727134,MATH 109,A02,084147,Salehi Golsefidy; Alireza,23,0,30,7
1649893733161,MATH 120A,A01,085445,Eggers; John Dietrich,21,0,35,14
1649893733161,MATH 120A,A02,085446,Eggers; John Dietrich,28,0,35,7
1649893739195,MATH 142B,A01,084149,Verstraete; Jacques Allan,0,3,30,30
1649893739195,MATH 142B,A02,084150,Verstraete; Jacques Allan,0,3,30,30
1649893745222,MATH 170A,A01,083459,Nie; Jiawang,0,1,30,30
1649893745222,MATH 170A,A02,083460,Nie; Jiawang,12,0,30,18
1649893745222,MATH 170A,A03,083461,Nie; Jiawang,21,0,30,9
1649893751246,MATH 193B,A01,083463,Staff,7,0,30,23
1649893751246,MATH 193B,A02,083464,Staff,13,0,30,17
1649893751246,MATH 193B,A03,083465,Staff,23,0,30,7
1649893757297,COGS 2,A01,083966,Boyle; Mary E. T.,21,0,30,9
1649893763321,COGS 9,A01,083968,Staff,47,0,60,13
1649893769344,COGS 14B,A01,083970,Staff,40,0,50,10
1649893775368,COGS 17,A01,092679,Staff,68,0,75,7
1649893781392,COGS 100,A01,083972,Staff,33,0,60,27
1649893793443,COGS 101C,A01,083976,Staff,22,0,30,8
1649893799473,COGS 102A,A01,083978,Johnson; Christine M.,19,0,30,11
1649893805497,COGS 107B,A01,083980,Staff,13,0,50,37
1649893811520,COGS 115,A01,083982,Staff,13,0,30,17
1649893817551,COGS 118B,A01,083367,Staff,0,7,40,40
1649893823575,COGS 172,A01,083984,Provenzano; Emily Kara,17,0,30,13
1649893829603,COGS 177,A00,083368,Staff,1,13,30,29
1649893835629,COGS 186,A01,083986,Staff,23,0,40,17
1649893841653,COGS 187A,A01,083988,Boyle; Mary E. T.,25,0,60,35
1649893847676,CSE 8A,A50,084003,Miranda; Gregory Joseph,4,0,15,11
1649893853707,CSE 11,A01,084005,Miranda; Gregory Joseph,34,0,55,21
1649893859740,CSE 20,A01,084007,Staff,11,0,20,9
1649893865767,CSE 21,A01,084009,Staff,18,0,50,32
1649893871791,CSE 30,A01,083370,Cao; Yingjun,0,4,40,40
1649893877820,CSE 100,A01,083372,Cao; Yingjun,0,13,40,40
1649893883846,CSE 101,A01,084011,Staff,1,38,40,39
1649893889869,CSE 141,A01,083374,Eldon; John,1,45,75,74
1649893895891,CSE 141L,A01,083376,Eldon; John,1,48,75,74
1649893901918,CSE 175,A01,084013,Kumar; Rakesh,22,0,25,3
1649893907943,CSE 190,A00,092508,Dubnov; Shlomo,15,0,15,0
1649893913977,ECE 5,A01,084049,Morris; Karcher William,16,0,20,4
1649893920000,ECE 100,A01,084051,Baghdadchi; Saharnaz,4,0,20,16
1649893920000,ECE 100,A02,091916,Baghdadchi; Saharnaz,18,0,20,2
1649893926023,ECE 101,A01,084053,Baghdadchi; Saharnaz,10,0,37,27
1649893926023,ECE 101,A02,084054,Baghdadchi; Saharnaz,37,0,37,0
1649893932045,ECE 107,A01,083390,Staff,29,0,40,11
1649893938071,ECE 148,A01,084056,Silberman; Jack,7,0,12,5
1649893944098,ECE 180,A00,083391,Abi Samra; Nicholas Camill,25,0,30,5
1649893944098,ECE 180,B00,083392,Abi Samra; Nicholas Camill,22,0,30,8
1649893950121,MATH 10B,A01,084110,Staff,10,0,30,20
1649893950121,MATH 10B,A02,084111,Staff,29,0,30,1
1649893950121,MATH 10B,A03,084112,Staff,28,0,30,2
1649893956146,MATH 10C,A01,083443,Staff,13,0,30,17
1649893956146,MATH 10C,A02,083444,Staff,17,0,30,13
1649893956146,MATH 10C,B01,084114,Staff,26,0,30,4
1649893956146,MATH 10C,B02,084115,Staff,30,0,30,0
1649893962171,MATH 18,A01,084117,Harel; Guershon,27,0,30,3
1649893962171,MATH 18,A02,084119,Harel; Guershon,29,0,30,1
1649893962171,MATH 18,A03,084120,Harel; Guershon,30,0,30,0
1649893962171,MATH 18,A04,084121,Harel; Guershon,30,0,30,0
1649893968194,MATH 20B,A01,084124,Um; Ko Woon,32,0,35,3
1649893968194,MATH 20B,B01,084126,Um; Ko Woon,33,0,35,2
1649893974218,MATH 20C,A01,083446,Hammock; Frances H,20,0,30,10
1649893974218,MATH 20C,A02,083447,Hammock; Frances H,28,0,30,2
1649893974218,MATH 20C,A03,083448,Hammock; Frances H,30,0,30,0
1649893974218,MATH 20C,A04,083449,Hammock; Frances H,30,0,30,0
1649893974218,MATH 20C,B01,083451,Hammock; Frances H,26,0,30,4
1649893974218,MATH 20C,B02,083452,Hammock; Frances H,29,0,30,1
1649893974218,MATH 20C,B03,083453,Hammock; Frances H,29,0,30,1
1649893974218,MATH 20C,B04,083454,Hammock; Frances H,30,0,30,0
1649893980257,MATH 20D,A01,084128,Staff,29,0,30,1
1649893980257,MATH 20D,A02,084129,Staff,30,0,30,0
1649893980257,MATH 20D,A03,084130,Staff,29,0,30,1
1649893980257,MATH 20D,B01,084133,Staff,27,0,30,3
1649893980257,MATH 20D,B02,084134,Staff,28,0,30,2
1649893980257,MATH 20D,B03,084135,Staff,30,0,30,0
1649893986288,MATH 20E,A01,084138,Staff,25,0,30,5
1649893986288,MATH 20E,A02,084139,Staff,25,0,30,5
1649893986288,MATH 20E,A03,084140,Staff,25,0,30,5
1649893986288,MATH 20E,A04,084141,Staff,28,0,30,2
1649893992313,MATH 102,A01,084143,Harel; Guershon,21,0,30,9
1649893992313,MATH 102,A02,084144,Harel; Guershon,23,0,30,7
1649893998342,MATH 103B,A01,083456,Staff,0,5,30,30
1649893998342,MATH 103B,A02,083457,Staff,0,4,30,30
1649894004365,MATH 109,A01,084146,Salehi Golsefidy; Alireza,29,0,30,1
1649894004365,MATH 109,A02,084147,Salehi Golsefidy; Alireza,23,0,30,7
1649894010388,MATH 120A,A01,085445,Eggers; John Dietrich,21,0,35,14
1649894010388,MATH 120A,A02,085446,Eggers; John Dietrich,28,0,35,7
1649894016416,MATH 142B,A01,084149,Verstraete; Jacques Allan,0,4,30,30
1649894016416,MATH 142B,A02,084150,Verstraete; Jacques Allan,0,3,30,30
1649894022438,MATH 170A,A01,083459,Nie; Jiawang,0,1,30,30
1649894022438,MATH 170A,A02,083460,Nie; Jiawang,12,0,30,18
1649894022438,MATH 170A,A03,083461,Nie; Jiawang,21,0,30,9
1649894028463,MATH 193B,A01,083463,Staff,7,0,30,23
1649894028463,MATH 193B,A02,083464,Staff,13,0,30,17
1649894028463,MATH 193B,A03,083465,Staff,23,0,30,7
1649894034526,COGS 2,A01,083966,Boyle; Mary E. T.,21,0,30,9
1649894040549,COGS 9,A01,083968,Staff,47,0,60,13
1649894046577,COGS 14B,A01,083970,Staff,39,0,50,11
1649894052678,COGS 17,A01,092679,Staff,68,0,75,7
1649894058702,COGS 100,A01,083972,Staff,32,0,60,28
1649894070764,COGS 101C,A01,083976,Staff,22,0,30,8
1649894076791,COGS 102A,A01,083978,Johnson; Christine M.,19,0,30,11
1649894082820,COGS 107B,A01,083980,Staff,13,0,50,37
1649894088842,COGS 115,A01,083982,Staff,13,0,30,17
1649894094869,COGS 118B,A01,083367,Staff,0,7,40,40
1649894100904,COGS 172,A01,083984,Provenzano; Emily Kara,17,0,30,13
1649894106931,COGS 177,A00,083368,Staff,1,13,30,29
1649894112953,COGS 186,A01,083986,Staff,23,0,40,17
1649894118977,COGS 187A,A01,083988,Boyle; Mary E. T.,25,0,60,35
1649894125003,CSE 8A,A50,084003,Miranda; Gregory Joseph,3,0,15,12
1649894131029,CSE 11,A01,084005,Miranda; Gregory Joseph,33,0,55,22
1649894137073,CSE 20,A01,084007,Staff,11,0,20,9
1649894143098,CSE 21,A01,084009,Staff,17,0,50,33
1649894149123,CSE 30,A01,083370,Cao; Yingjun,0,5,40,40
1649894155149,CSE 100,A01,083372,Cao; Yingjun,0,13,40,40
1649894161182,CSE 101,A01,084011,Staff,1,38,40,39
1649894167213,CSE 141,A01,083374,Eldon; John,1,45,75,74
1649894173235,CSE 141L,A01,083376,Eldon; John,1,48,75,74
1649894179259,CSE 175,A01,084013,Kumar; Rakesh,22,0,25,3
1649894185286,CSE 190,A00,092508,Dubnov; Shlomo,15,0,15,0
1649894191309,ECE 5,A01,084049,Morris; Karcher William,16,0,20,4
1649894197331,ECE 100,A01,084051,Baghdadchi; Saharnaz,4,0,20,16
1649894197331,ECE 100,A02,091916,Baghdadchi; Saharnaz,18,0,20,2
1649894203357,ECE 101,A01,084053,Baghdadchi; Saharnaz,10,0,37,27
1649894203357,ECE 101,A02,084054,Baghdadchi; Saharnaz,37,0,37,0
1649894209390,ECE 107,A01,083390,Staff,29,0,40,11
1649894215412,ECE 148,A01,084056,Silberman; Jack,7,0,12,5
1649894221436,ECE 180,A00,083391,Abi Samra; Nicholas Camill,25,0,30,5
1649894221436,ECE 180,B00,083392,Abi Samra; Nicholas Camill,22,0,30,8
1649894227462,MATH 10B,A01,084110,Staff,10,0,30,20
1649894227462,MATH 10B,A02,084111,Staff,29,0,30,1
1649894227462,MATH 10B,A03,084112,Staff,28,0,30,2
1649894233488,MATH 10C,A01,083443,Staff,13,0,30,17
1649894233488,MATH 10C,A02,083444,Staff,17,0,30,13
1649894233488,MATH 10C,B01,084114,Staff,26,0,30,4
1649894233488,MATH 10C,B02,084115,Staff,30,0,30,0
1649894239514,MATH 18,A01,084117,Harel; Guershon,27,0,30,3
1649894239514,MATH 18,A02,084119,Harel; Guershon,29,0,30,1
1649894239514,MATH 18,A03,084120,Harel; Guershon,30,0,30,0
1649894239514,MATH 18,A04,084121,Harel; Guershon,29,0,30,1
1649894245537,MATH 20B,A01,084124,Um; Ko Woon,31,0,35,4
1649894245537,MATH 20B,B01,084126,Um; Ko Woon,33,0,35,2
1649894251564,MATH 20C,A01,083446,Hammock; Frances H,20,0,30,10
1649894251564,MATH 20C,A02,083447,Hammock; Frances H,28,0,30,2
1649894251564,MATH 20C,A03,083448,Hammock; Frances H,30,0,30,0
1649894251564,MATH 20C,A04,083449,Hammock; Frances H,30,0,30,0
1649894251564,MATH 20C,B01,083451,Hammock; Frances H,26,0,30,4
1649894251564,MATH 20C,B02,083452,Hammock; Frances H,29,0,30,1
1649894251564,MATH 20C,B03,083453,Hammock; Frances H,29,0,30,1
1649894251564,MATH 20C,B04,083454,Hammock; Frances H,30,0,30,0
1649894257589,MATH 20D,A01,084128,Staff,29,0,30,1
1649894257589,MATH 20D,A02,084129,Staff,30,0,30,0
1649894257589,MATH 20D,A03,084130,Staff,29,0,30,1
1649894257589,MATH 20D,B01,084133,Staff,27,0,30,3
1649894257589,MATH 20D,B02,084134,Staff,28,0,30,2
1649894257589,MATH 20D,B03,084135,Staff,30,0,30,0
1649894263613,MATH 20E,A01,084138,Staff,25,0,30,5
1649894263613,MATH 20E,A02,084139,Staff,25,0,30,5
1649894263613,MATH 20E,A03,084140,Staff,25,0,30,5
1649894263613,MATH 20E,A04,084141,Staff,28,0,30,2
1649894269637,MATH 102,A01,084143,Harel; Guershon,21,0,30,9
1649894269637,MATH 102,A02,084144,Harel; Guershon,23,0,30,7
1649894275671,MATH 103B,A01,083456,Staff,0,5,30,30
1649894275671,MATH 103B,A02,083457,Staff,0,4,30,30
1649894281699,MATH 109,A01,084146,Salehi Golsefidy; Alireza,29,0,30,1
1649894281699,MATH 109,A02,084147,Salehi Golsefidy; Alireza,23,0,30,7
1649894287727,MATH 120A,A01,085445,Eggers; John Dietrich,21,0,35,14
1649894287727,MATH 120A,A02,085446,Eggers; John Dietrich,28,0,35,7
1649894293751,MATH 142B,A01,084149,Verstraete; Jacques Allan,0,4,30,30
1649894293751,MATH 142B,A02,084150,Verstraete; Jacques Allan,0,3,30,30
1649894299772,MATH 170A,A01,083459,Nie; Jiawang,0,1,30,30
1649894299772,MATH 170A,A02,083460,Nie; Jiawang,12,0,30,18
1649894299772,MATH 170A,A03,083461,Nie; Jiawang,21,0,30,9
1649894305802,MATH 193B,A01,083463,Staff,7,0,30,23
1649894305802,MATH 193B,A02,083464,Staff,13,0,30,17
1649894305802,MATH 193B,A03,083465,Staff,23,0,30,7
1649894311860,COGS 2,A01,083966,Boyle; Mary E. T.,21,0,30,9
1649894317892,COGS 9,A01,083968,Staff,47,0,60,13
1649894323915,COGS 14B,A01,083970,Staff,39,0,50,11
1649894329939,COGS 17,A01,092679,Staff,68,0,75,7
1649894335964,COGS 100,A01,083972,Staff,32,0,60,28
1649894348013,COGS 101C,A01,083976,Staff,22,0,30,8
1649894354037,COGS 102A,A01,083978,Johnson; Christine M.,19,0,30,11
1649894360069,COGS 107B,A01,083980,Staff,13,0,50,37
1649894366105,COGS 115,A01,083982,Staff,13,0,30,17
1649894372136,COGS 118B,A01,083367,Staff,0,7,40,40
1649894378162,COGS 172,A01,083984,Provenzano; Emily Kara,17,0,30,13
1649894384189,COGS 177,A00,083368,Staff,1,13,30,29
1649894390210,COGS 186,A01,083986,Staff,23,0,40,17
1649894396234,COGS 187A,A01,083988,Boyle; Mary E. T.,25,0,60,35
1649894402256,CSE 8A,A50,084003,Miranda; Gregory Joseph,3,0,15,12
1649894408279,CSE 11,A01,084005,Miranda; Gregory Joseph,33,0,55,22
1649894414308,CSE 20,A01,084007,Staff,11,0,20,9
1649894420331,CSE 21,A01,084009,Staff,17,0,50,33
1649894426354,CSE 30,A01,083370,Cao; Yingjun,0,5,40,40
1649894432376,CSE 100,A01,083372,Cao; Yingjun,0,13,40,40
1649894438403,CSE 101,A01,084011,Staff,1,38,40,39
1649894444425,CSE 141,A01,083374,Eldon; John,1,45,75,74
1649894450449,CSE 141L,A01,083376,Eldon; John,1,48,75,74
1649894456472,CSE 175,A01,084013,Kumar; Rakesh,22,0,25,3
1649894462502,CSE 190,A00,092508,Dubnov; Shlomo,15,0,15,0
1649894468537,ECE 5,A01,084049,Morris; Karcher William,16,0,20,4
1649894474567,ECE 100,A01,084051,Baghdadchi; Saharnaz,4,0,20,16
1649894474567,ECE 100,A02,091916,Baghdadchi; Saharnaz,18,0,20,2
1649894480590,ECE 101,A01,084053,Baghdadchi; Saharnaz,10,0,37,27
1649894480590,ECE 101,A02,084054,Baghdadchi; Saharnaz,37,0,37,0
1649894486618,ECE 107,A01,083390,Staff,29,0,40,11
1649894492650,ECE 148,A01,084056,Silberman; Jack,7,0,12,5
1649894498703,ECE 180,A00,083391,Abi Samra; Nicholas Camill,25,0,30,5
1649894498703,ECE 180,B00,083392,Abi Samra; Nicholas Camill,22,0,30,8
1649894504742,MATH 10B,A01,084110,Staff,10,0,30,20
1649894504742,MATH 10B,A02,084111,Staff,29,0,30,1
1649894504742,MATH 10B,A03,084112,Staff,28,0,30,2
1649894510772,MATH 10C,A01,083443,Staff,13,0,30,17
1649894510772,MATH 10C,A02,083444,Staff,17,0,30,13
1649894510772,MATH 10C,B01,084114,Staff,26,0,30,4
1649894510772,MATH 10C,B02,084115,Staff,30,0,30,0
1649894516802,MATH 18,A01,084117,Harel; Guershon,27,0,30,3
1649894516802,MATH 18,A02,084119,Harel; Guershon,29,0,30,1
1649894516802,MATH 18,A03,084120,Harel; Guershon,30,0,30,0
1649894516802,MATH 18,A04,084121,Harel; Guershon,29,0,30,1
1649894522826,MATH 20B,A01,084124,Um; Ko Woon,31,0,35,4
1649894522826,MATH 20B,B01,084126,Um; Ko Woon,33,0,35,2
1649894528852,MATH 20C,A01,083446,Hammock; Frances H,20,0,30,10
1649894528852,MATH 20C,A02,083447,Hammock; Frances H,28,0,30,2
1649894528852,MATH 20C,A03,083448,Hammock; Frances H,30,0,30,0
1649894528852,MATH 20C,A04,083449,Hammock; Frances H,30,0,30,0
1649894528852,MATH 20C,B01,083451,Hammock; Frances H,26,0,30,4
1649894528852,MATH 20C,B02,083452,Hammock; Frances H,29,0,30,1
1649894528852,MATH 20C,B03,083453,Hammock; Frances H,29,0,30,1
1649894528852,MATH 20C,B04,083454,Hammock; Frances H,30,0,30,0
1649894534886,MATH 20D,A01,084128,Staff,29,0,30,1
1649894534886,MATH 20D,A02,084129,Staff,30,0,30,0
1649894534886,MATH 20D,A03,084130,Staff,29,0,30,1
1649894534886,MATH 20D,B01,084133,Staff,27,0,30,3
1649894534886,MATH 20D,B02,084134,Staff,28,0,30,2
1649894534886,MATH 20D,B03,084135,Staff,30,0,30,0
1649894540913,MATH 20E,A01,084138,Staff,25,0,30,5
1649894540913,MATH 20E,A02,084139,Staff,25,0,30,5
1649894540913,MATH 20E,A03,084140,Staff,25,0,30,5
1649894540913,MATH 20E,A04,084141,Staff,28,0,30,2
1649894546948,MATH 102,A01,084143,Harel; Guershon,21,0,30,9
1649894546948,MATH 102,A02,084144,Harel; Guershon,23,0,30,7
1649894552975,MATH 103B,A01,083456,Staff,0,5,30,30
1649894552975,MATH 103B,A02,083457,Staff,0,4,30,30
1649894558997,MATH 109,A01,084146,Salehi Golsefidy; Alireza,29,0,30,1
1649894558997,MATH 109,A02,084147,Salehi Golsefidy; Alireza,23,0,30,7
1649894565024,MATH 120A,A01,085445,Eggers; John Dietrich,21,0,35,14
1649894565024,MATH 120A,A02,085446,Eggers; John Dietrich,28,0,35,7
1649894571051,MATH 142B,A01,084149,Verstraete; Jacques Allan,0,4,30,30
1649894571051,MATH 142B,A02,084150,Verstraete; Jacques Allan,0,3,30,30
1649894577077,MATH 170A,A01,083459,Nie; Jiawang,0,1,30,30
1649894577077,MATH 170A,A02,083460,Nie; Jiawang,12,0,30,18
1649894577077,MATH 170A,A03,083461,Nie; Jiawang,21,0,30,9
1649894583105,MATH 193B,A01,083463,Staff,7,0,30,23
1649894583105,MATH 193B,A02,083464,Staff,13,0,30,17
1649894583105,MATH 193B,A03,083465,Staff,23,0,30,7
1649894589156,COGS 2,A01,083966,Boyle; Mary E. T.,21,0,30,9
1649894595180,COGS 9,A01,083968,Staff,47,0,60,13
1649894601205,COGS 14B,A01,083970,Staff,39,0,50,11
1649894607229,COGS 17,A01,092679,Staff,68,0,75,7
1649894613258,COGS 100,A01,083972,Staff,31,0,60,29
1649894625318,COGS 101C,A01,083976,Staff,22,0,30,8
1649894631343,COGS 102A,A01,083978,Johnson; Christine M.,19,0,30,11
1649894637366,COGS 107B,A01,083980,Staff,13,0,50,37
1649894643391,COGS 115,A01,083982,Staff,13,0,30,17
1649894649487,COGS 118B,A01,083367,Staff,0,7,40,40
1649894655516,COGS 172,A01,083984,Provenzano; Emily Kara,17,0,30,13
1649894661538,COGS 177,A00,083368,Staff,1,13,30,29
1649894667570,COGS 186,A01,083986,Staff,23,0,40,17
1649894673594,COGS 187A,A01,083988,Boyle; Mary E. T.,25,0,60,35
1649894679622,CSE 8A,A50,084003,Miranda; Gregory Joseph,3,0,15,12
1649894685649,CSE 11,A01,084005,Miranda; Gregory Joseph,33,0,55,22
1649894691676,CSE 20,A01,084007,Staff,11,0,20,9
1649894697772,CSE 21,A01,084009,Staff,17,0,50,33
1649894703799,CSE 30,A01,083370,Cao; Yingjun,0,6,40,40
1649894709824,CSE 100,A01,083372,Cao; Yingjun,0,14,40,40
1649894715853,CSE 101,A01,084011,Staff,1,39,40,39
1649894721877,CSE 141,A01,083374,Eldon; John,1,45,75,74
1649894727902,CSE 141L,A01,083376,Eldon; John,1,48,75,74
1649894733928,CSE 175,A01,084013,Kumar; Rakesh,22,0,25,3
1649894739951,CSE 190,A00,092508,Dubnov; Shlomo,15,0,15,0
1649894745976,ECE 5,A01,084049,Morris; Karcher William,16,0,20,4
1649894752004,ECE 100,A01,084051,Baghdadchi; Saharnaz,4,0,20,16
1649894752004,ECE 100,A02,091916,Baghdadchi; Saharnaz,18,0,20,2
1649894758033,ECE 101,A01,084053,Baghdadchi; Saharnaz,10,0,37,27
1649894758033,ECE 101,A02,084054,Baghdadchi; Saharnaz,37,0,37,0
1649894764063,ECE 107,A01,083390,Staff,29,0,40,11
1649894770090,ECE 148,A01,084056,Silberman; Jack,7,0,12,5
1649894776118,ECE 180,A00,083391,Abi Samra; Nicholas Camill,25,0,30,5
1649894776118,ECE 180,B00,083392,Abi Samra; Nicholas Camill,22,0,30,8
1649894782141,MATH 10B,A01,084110,Staff,10,0,30,20
1649894782141,MATH 10B,A02,084111,Staff,29,0,30,1
1649894782141,MATH 10B,A03,084112,Staff,28,0,30,2
1649894788171,MATH 10C,A01,083443,Staff,13,0,30,17
1649894788171,MATH 10C,A02,083444,Staff,17,0,30,13
1649894788171,MATH 10C,B01,084114,Staff,26,0,30,4
1649894788171,MATH 10C,B02,084115,Staff,30,0,30,0
1649894794194,MATH 18,A01,084117,Harel; Guershon,27,0,30,3
1649894794194,MATH 18,A02,084119,Harel; Guershon,29,0,30,1
1649894794194,MATH 18,A03,084120,Harel; Guershon,30,0,30,0
1649894794194,MATH 18,A04,084121,Harel; Guershon,29,0,30,1
1649894800221,MATH 20B,A01,084124,Um; Ko Woon,31,0,35,4
1649894800221,MATH 20B,B01,084126,Um; Ko Woon,33,0,35,2
1649894813073,MATH 20C,A01,083446,Hammock; Frances H,20,0,30,10
1649894813073,MATH 20C,A02,083447,Hammock; Frances H,28,0,30,2
1649894813073,MATH 20C,A03,083448,Hammock; Frances H,30,0,30,0
1649894813073,MATH 20C,A04,083449,Hammock; Frances H,30,0,30,0
1649894813073,MATH 20C,B01,083451,Hammock; Frances H,26,0,30,4
1649894813073,MATH 20C,B02,083452,Hammock; Frances H,29,0,30,1
1649894813073,MATH 20C,B03,083453,Hammock; Frances H,29,0,30,1
1649894813073,MATH 20C,B04,083454,Hammock; Frances H,30,0,30,0
1649894819103,MATH 20D,A01,084128,Staff,29,0,30,1
1649894819103,MATH 20D,A02,084129,Staff,30,0,30,0
1649894819103,MATH 20D,A03,084130,Staff,29,0,30,1
1649894819103,MATH 20D,B01,084133,Staff,26,0,30,4
1649894819103,MATH 20D,B02,084134,Staff,28,0,30,2
1649894819103,MATH 20D,B03,084135,Staff,30,0,30,0
1649894825125,MATH 20E,A01,084138,Staff,25,0,30,5
1649894825125,MATH 20E,A02,084139,Staff,25,0,30,5
1649894825125,MATH 20E,A03,084140,Staff,25,0,30,5
1649894825125,MATH 20E,A04,084141,Staff,28,0,30,2
1649894831152,MATH 102,A01,084143,Harel; Guershon,21,0,30,9
1649894831152,MATH 102,A02,084144,Harel; Guershon,23,0,30,7
1649894837179,MATH 103B,A01,083456,Staff,0,5,30,30
1649894837179,MATH 103B,A02,083457,Staff,0,4,30,30
1649894843203,MATH 109,A01,084146,Salehi Golsefidy; Alireza,29,0,30,1
1649894843203,MATH 109,A02,084147,Salehi Golsefidy; Alireza,23,0,30,7
1649894849236,MATH 120A,A01,085445,Eggers; John Dietrich,21,0,35,14
1649894849236,MATH 120A,A02,085446,Eggers; John Dietrich,28,0,35,7
1649894855259,MATH 142B,A01,084149,Verstraete; Jacques Allan,0,4,30,30
1649894855259,MATH 142B,A02,084150,Verstraete; Jacques Allan,0,3,30,30
1649894861285,MATH 170A,A01,083459,Nie; Jiawang,0,1,30,30
1649894861285,MATH 170A,A02,083460,Nie; Jiawang,12,0,30,18
1649894861285,MATH 170A,A03,083461,Nie; Jiawang,21,0,30,9
1649894867313,MATH 193B,A01,083463,Staff,7,0,30,23
1649894867313,MATH 193B,A02,083464,Staff,13,0,30,17
1649894867313,MATH 193B,A03,083465,Staff,23,0,30,7
1649894873374,COGS 2,A01,083966,Boyle; Mary E. T.,21,0,30,9
1649894879414,COGS 9,A01,083968,Staff,47,0,60,13
1649894885441,COGS 14B,A01,083970,Staff,39,0,50,11
1649894891465,COGS 17,A01,092679,Staff,68,0,75,7
1649894897487,COGS 100,A01,083972,Staff,30,0,60,30
1649894909535,COGS 101C,A01,083976,Staff,22,0,30,8
1649894915572,COGS 102A,A01,083978,Johnson; Christine M.,19,0,30,11
1649894921599,COGS 107B,A01,083980,Staff,13,0,50,37
1649894927625,COGS 115,A01,083982,Staff,13,0,30,17
1649894933652,COGS 118B,A01,083367,Staff,0,7,40,40
1649894939682,COGS 172,A01,083984,Provenzano; Emily Kara,17,0,30,13
1649894945705,COGS 177,A00,083368,Staff,1,13,30,29
1649894951728,COGS 186,A01,083986,Staff,23,0,40,17
1649894957752,COGS 187A,A01,083988,Boyle; Mary E. T.,25,0,60,35
1649894963787,CSE 8A,A50,084003,Miranda; Gregory Joseph,3,0,15,12
1649894969821,CSE 11,A01,084005,Miranda; Gregory Joseph,33,0,55,22
1649894975849,CSE 20,A01,084007,Staff,11,0,20,9
1649894981879,CSE 21,A01,084009,Staff,17,0,50,33
1649894987922,CSE 30,A01,083370,Cao; Yingjun,0,6,40,40
1649894993945,CSE 100,A01,083372,Cao; Yingjun,0,14,40,40
1649894999969,CSE 101,A01,084011,Staff,1,39,40,39
1649895005998,CSE 141,A01,083374,Eldon; John,1,45,75,74
1649895012028,CSE 141L,A01,083376,Eldon; John,1,48,75,74
1649895018055,CSE 175,A01,084013,Kumar; Rakesh,22,0,25,3
1649895024087,CSE 190,A00,092508,Dubnov; Shlomo,15,0,15,0
1649895030114,ECE 5,A01,084049,Morris; Karcher William,16,0,20,4
1649895036153,ECE 100,A01,084051,Baghdadchi; Saharnaz,4,0,20,16
1649895036153,ECE 100,A02,091916,Baghdadchi; Saharnaz,18,0,20,2
1649895042176,ECE 101,A01,084053,Baghdadchi; Saharnaz,10,0,37,27
1649895042176,ECE 101,A02,084054,Baghdadchi; Saharnaz,37,0,37,0
1649895048198,ECE 107,A01,083390,Staff,29,0,40,11
1649895054232,ECE 148,A01,084056,Silberman; Jack,7,0,12,5
1649895060277,ECE 180,A00,083391,Abi Samra; Nicholas Camill,25,0,30,5
1649895060277,ECE 180,B00,083392,Abi Samra; Nicholas Camill,22,0,30,8
1649895066305,MATH 10B,A01,084110,Staff,10,0,30,20
1649895066305,MATH 10B,A02,084111,Staff,29,0,30,1
1649895066305,MATH 10B,A03,084112,Staff,28,0,30,2
1649895072332,MATH 10C,A01,083443,Staff,13,0,30,17
1649895072332,MATH 10C,A02,083444,Staff,17,0,30,13
1649895072332,MATH 10C,B01,084114,Staff,26,0,30,4
1649895072332,MATH 10C,B02,084115,Staff,30,0,30,0
1649895078360,MATH 18,A01,084117,Harel; Guershon,27,0,30,3
1649895078360,MATH 18,A02,084119,Harel; Guershon,29,0,30,1
1649895078360,MATH 18,A03,084120,Harel; Guershon,30,0,30,0
1649895078360,MATH 18,A04,084121,Harel; Guershon,29,0,30,1
1649895084384,MATH 20B,A01,084124,Um; Ko Woon,31,0,35,4
1649895084384,MATH 20B,B01,084126,Um; Ko Woon,33,0,35,2
1649895090421,MATH 20C,A01,083446,Hammock; Frances H,20,0,30,10
1649895090421,MATH 20C,A02,083447,Hammock; Frances H,28,0,30,2
1649895090421,MATH 20C,A03,083448,Hammock; Frances H,30,0,30,0
1649895090421,MATH 20C,A04,083449,Hammock; Frances H,30,0,30,0
1649895090421,MATH 20C,B01,083451,Hammock; Frances H,26,0,30,4
1649895090421,MATH 20C,B02,083452,Hammock; Frances H,29,0,30,1
1649895090421,MATH 20C,B03,083453,Hammock; Frances H,29,0,30,1
1649895090421,MATH 20C,B04,083454,Hammock; Frances H,30,0,30,0
1649895096450,MATH 20D,A01,084128,Staff,29,0,30,1
1649895096450,MATH 20D,A02,084129,Staff,30,0,30,0
1649895096450,MATH 20D,A03,084130,Staff,29,0,30,1
1649895096450,MATH 20D,B01,084133,Staff,26,0,30,4
1649895096450,MATH 20D,B02,084134,Staff,28,0,30,2
1649895096450,MATH 20D,B03,084135,Staff,30,0,30,0
1649895102474,MATH 20E,A01,084138,Staff,25,0,30,5
1649895102474,MATH 20E,A02,084139,Staff,25,0,30,5
1649895102474,MATH 20E,A03,084140,Staff,25,0,30,5
1649895102474,MATH 20E,A04,084141,Staff,28,0,30,2
1649895108504,MATH 102,A01,084143,Harel; Guershon,21,0,30,9
1649895108504,MATH 102,A02,084144,Harel; Guershon,23,0,30,7
1649895114542,MATH 103B,A01,083456,Staff,0,5,30,30
1649895114542,MATH 103B,A02,083457,Staff,0,4,30,30
1649895120578,MATH 109,A01,084146,Salehi Golsefidy; Alireza,29,0,30,1
1649895120578,MATH 109,A02,084147,Salehi Golsefidy; Alireza,23,0,30,7
1649895126612,MATH 120A,A01,085445,Eggers; John Dietrich,21,0,35,14
1649895126612,MATH 120A,A02,085446,Eggers; John Dietrich,28,0,35,7
1649895132637,MATH 142B,A01,084149,Verstraete; Jacques Allan,0,4,30,30
1649895132637,MATH 142B,A02,084150,Verstraete; Jacques Allan,0,3,30,30
1649895138662,MATH 170A,A01,083459,Nie; Jiawang,0,1,30,30
1649895138662,MATH 170A,A02,083460,Nie; Jiawang,12,0,30,18
1649895138662,MATH 170A,A03,083461,Nie; Jiawang,21,0,30,9
1649895144688,MATH 193B,A01,083463,Staff,7,0,30,23
1649895144688,MATH 193B,A02,083464,Staff,13,0,30,17
1649895144688,MATH 193B,A03,083465,Staff,23,0,30,7
1649895150768,COGS 2,A01,083966,Boyle; Mary E. T.,21,0,30,9
1649895156799,COGS 9,A01,083968,Staff,47,0,60,13
1649895162823,COGS 14B,A01,083970,Staff,39,0,50,11
1649895168850,COGS 17,A01,092679,Staff,68,0,75,7
1649895174877,COGS 100,A01,083972,Staff,30,0,60,30
1649895186943,COGS 101C,A01,083976,Staff,22,0,30,8
1649895192973,COGS 102A,A01,083978,Johnson; Christine M.,19,0,30,11
1649895199000,COGS 107B,A01,083980,Staff,13,0,50,37
1649895205028,COGS 115,A01,083982,Staff,13,0,30,17
1649895211058,COGS 118B,A01,083367,Staff,0,7,40,40
1649895217086,COGS 172,A01,083984,Provenzano; Emily Kara,17,0,30,13
1649895223119,COGS 177,A00,083368,Staff,1,13,30,29
1649895229145,COGS 186,A01,083986,Staff,23,0,40,17
1649895235169,COGS 187A,A01,083988,Boyle; Mary E. T.,25,0,60,35
1649895241201,CSE 8A,A50,084003,Miranda; Gregory Joseph,3,0,15,12
1649895247225,CSE 11,A01,084005,Miranda; Gregory Joseph,33,0,55,22
1649895253324,CSE 20,A01,084007,Staff,11,0,20,9
1649895259351,CSE 21,A01,084009,Staff,17,0,50,33
1649895265378,CSE 30,A01,083370,Cao; Yingjun,0,6,40,40
1649895271407,CSE 100,A01,083372,Cao; Yingjun,0,14,40,40
1649895277429,CSE 101,A01,084011,Staff,1,40,40,39
1649895283452,CSE 141,A01,083374,Eldon; John,1,45,75,74
1649895289475,CSE 141L,A01,083376,Eldon; John,1,48,75,74
1649895295498,CSE 175,A01,084013,Kumar; Rakesh,22,0,25,3
1649895301528,CSE 190,A00,092508,Dubnov; Shlomo,15,0,15,0
1649895307554,ECE 5,A01,084049,Morris; Karcher William,16,0,20,4
1649895313577,ECE 100,A01,084051,Baghdadchi; Saharnaz,4,0,20,16
1649895313577,ECE 100,A02,091916,Baghdadchi; Saharnaz,18,0,20,2
1649895319604,ECE 101,A01,084053,Baghdadchi; Saharnaz,10,0,37,27
1649895319604,ECE 101,A02,084054,Baghdadchi; Saharnaz,37,0,37,0
1649895325636,ECE 107,A01,083390,Staff,29,0,40,11
1649895331660,ECE 148,A01,084056,Silberman; Jack,7,0,12,5
1649895337684,ECE 180,A00,083391,Abi Samra; Nicholas Camill,25,0,30,5
1649895337684,ECE 180,B00,083392,Abi Samra; Nicholas Camill,22,0,30,8
1649895343710,MATH 10B,A01,084110,Staff,10,0,30,20
1649895343710,MATH 10B,A02,084111,Staff,29,0,30,1
1649895343710,MATH 10B,A03,084112,Staff,28,0,30,2
1649895349748,MATH 10C,A01,083443,Staff,13,0,30,17
1649895349748,MATH 10C,A02,083444,Staff,17,0,30,13
1649895349748,MATH 10C,B01,084114,Staff,26,0,30,4
1649895349748,MATH 10C,B02,084115,Staff,30,0,30,0
1649895355771,MATH 18,A01,084117,Harel; Guershon,27,0,30,3
1649895355771,MATH 18,A02,084119,Harel; Guershon,29,0,30,1
1649895355771,MATH 18,A03,084120,Harel; Guershon,30,0,30,0
1649895355771,MATH 18,A04,084121,Harel; Guershon,29,0,30,1
1649895361795,MATH 20B,A01,084124,Um; Ko Woon,31,0,35,4
1649895361795,MATH 20B,B01,084126,Um; Ko Woon,33,0,35,2
1649895367828,MATH 20C,A01,083446,Hammock; Frances H,20,0,30,10
1649895367828,MATH 20C,A02,083447,Hammock; Frances H,28,0,30,2
1649895367828,MATH 20C,A03,083448,Hammock; Frances H,30,0,30,0
1649895367828,MATH 20C,A04,083449,Hammock; Frances H,30,0,30,0
1649895367828,MATH 20C,B01,083451,Hammock; Frances H,26,0,30,4
1649895367828,MATH 20C,B02,083452,Hammock; Frances H,29,0,30,1
1649895367828,MATH 20C,B03,083453,Hammock; Frances H,29,0,30,1
1649895367828,MATH 20C,B04,083454,Hammock; Frances H,30,0,30,0
1649895373856,MATH 20D,A01,084128,Staff,29,0,30,1
1649895373856,MATH 20D,A02,084129,Staff,30,0,30,0
1649895373856,MATH 20D,A03,084130,Staff,29,0,30,1
1649895373856,MATH 20D,B01,084133,Staff,26,0,30,4
1649895373856,MATH 20D,B02,084134,Staff,28,0,30,2
1649895373856,MATH 20D,B03,084135,Staff,30,0,30,0
1649895379885,MATH 20E,A01,084138,Staff,25,0,30,5
1649895379885,MATH 20E,A02,084139,Staff,25,0,30,5
1649895379885,MATH 20E,A03,084140,Staff,25,0,30,5
1649895379885,MATH 20E,A04,084141,Staff,28,0,30,2
1649895385929,MATH 102,A01,084143,Harel; Guershon,21,0,30,9
1649895385929,MATH 102,A02,084144,Harel; Guershon,23,0,30,7
1649895391955,MATH 103B,A01,083456,Staff,0,5,30,30
1649895391955,MATH 103B,A02,083457,Staff,0,4,30,30
1649895397981,MATH 109,A01,084146,Salehi Golsefidy; Alireza,29,0,30,1
1649895397981,MATH 109,A02,084147,Salehi Golsefidy; Alireza,23,0,30,7
1649895404015,MATH 120A,A01,085445,Eggers; John Dietrich,21,0,35,14
1649895404015,MATH 120A,A02,085446,Eggers; John Dietrich,28,0,35,7
1649895410041,MATH 142B,A01,084149,Verstraete; Jacques Allan,0,4,30,30
1649895410041,MATH 142B,A02,084150,Verstraete; Jacques Allan,0,3,30,30
1649895416069,MATH 170A,A01,083459,Nie; Jiawang,0,1,30,30
1649895416069,MATH 170A,A02,083460,Nie; Jiawang,12,0,30,18
1649895416069,MATH 170A,A03,083461,Nie; Jiawang,21,0,30,9
1649895422093,MATH 193B,A01,083463,Staff,7,0,30,23
1649895422093,MATH 193B,A02,083464,Staff,13,0,30,17
1649895422093,MATH 193B,A03,083465,Staff,23,0,30,7
1649895428151,COGS 2,A01,083966,Boyle; Mary E. T.,21,0,30,9
1649895434178,COGS 9,A01,083968,Staff,47,0,60,13
1649895440218,COGS 14B,A01,083970,Staff,39,0,50,11
1649895446241,COGS 17,A01,092679,Staff,68,0,75,7
1649895452275,COGS 100,A01,083972,Staff,30,0,60,30
1649895464331,COGS 101C,A01,083976,Staff,22,0,30,8
1649895470359,COGS 102A,A01,083978,Johnson; Christine M.,19,0,30,11
1649895476383,COGS 107B,A01,083980,Staff,13,0,50,37
1649895482409,COGS 115,A01,083982,Staff,13,0,30,17
1649895488433,COGS 118B,A01,083367,Staff,0,7,40,40
1649895494460,COGS 172,A01,083984,Provenzano; Emily Kara,17,0,30,13
1649895500483,COGS 177,A00,083368,Staff,1,13,30,29
1649895506510,COGS 186,A01,083986,Staff,23,0,40,17
1649895512535,COGS 187A,A01,083988,Boyle; Mary E. T.,25,0,60,35
1649895518565,CSE 8A,A50,084003,Miranda; Gregory Joseph,3,0,15,12
1649895524588,CSE 11,A01,084005,Miranda; Gregory Joseph,33,0,55,22
1649895530616,CSE 20,A01,084007,Staff,11,0,20,9
1649895536639,CSE 21,A01,084009,Staff,17,0,50,33
1649895542663,CSE 30,A01,083370,Cao; Yingjun,0,6,40,40
1649895548694,CSE 100,A01,083372,Cao; Yingjun,0,14,40,40
1649895554721,CSE 101,A01,084011,Staff,1,40,40,39
1649895560747,CSE 141,A01,083374,Eldon; John,1,45,75,74
1649895566774,CSE 141L,A01,083376,Eldon; John,1,48,75,74
1649895572798,CSE 175,A01,084013,Kumar; Rakesh,22,0,25,3
1649895578824,CSE 190,A00,092508,Dubnov; Shlomo,15,0,15,0
1649895584862,ECE 5,A01,084049,Morris; Karcher William,16,0,20,4
1649895590896,ECE 100,A01,084051,Baghdadchi; Saharnaz,4,0,20,16
1649895590896,ECE 100,A02,091916,Baghdadchi; Saharnaz,18,0,20,2
1649895596928,ECE 101,A01,084053,Baghdadchi; Saharnaz,10,0,37,27
1649895596928,ECE 101,A02,084054,Baghdadchi; Saharnaz,37,0,37,0
1649895602961,ECE 107,A01,083390,Staff,29,0,40,11
1649895608996,ECE 148,A01,084056,Silberman; Jack,7,0,12,5
1649895615023,ECE 180,A00,083391,Abi Samra; Nicholas Camill,25,0,30,5
1649895615023,ECE 180,B00,083392,Abi Samra; Nicholas Camill,22,0,30,8
1649895621049,MATH 10B,A01,084110,Staff,10,0,30,20
1649895621049,MATH 10B,A02,084111,Staff,29,0,30,1
1649895621049,MATH 10B,A03,084112,Staff,28,0,30,2
1649895627076,MATH 10C,A01,083443,Staff,13,0,30,17
1649895627076,MATH 10C,A02,083444,Staff,17,0,30,13
1649895627076,MATH 10C,B01,084114,Staff,26,0,30,4
1649895627076,MATH 10C,B02,084115,Staff,30,0,30,0
1649895633101,MATH 18,A01,084117,Harel; Guershon,27,0,30,3
1649895633101,MATH 18,A02,084119,Harel; Guershon,29,0,30,1
1649895633101,MATH 18,A03,084120,Harel; Guershon,30,0,30,0
1649895633101,MATH 18,A04,084121,Harel; Guershon,29,0,30,1
1649895639128,MATH 20B,A01,084124,Um; Ko Woon,31,0,35,4
1649895639128,MATH 20B,B01,084126,Um; Ko Woon,33,0,35,2
1649895645153,MATH 20C,A01,083446,Hammock; Frances H,20,0,30,10
1649895645153,MATH 20C,A02,083447,Hammock; Frances H,28,0,30,2
1649895645153,MATH 20C,A03,083448,Hammock; Frances H,30,0,30,0
1649895645153,MATH 20C,A04,083449,Hammock; Frances H,30,0,30,0
1649895645153,MATH 20C,B01,083451,Hammock; Frances H,26,0,30,4
1649895645153,MATH 20C,B02,083452,Hammock; Frances H,29,0,30,1
1649895645153,MATH 20C,B03,083453,Hammock; Frances H,29,0,30,1
1649895645153,MATH 20C,B04,083454,Hammock; Frances H,30,0,30,0
1649895651176,MATH 20D,A01,084128,Staff,29,0,30,1
1649895651176,MATH 20D,A02,084129,Staff,30,0,30,0
1649895651176,MATH 20D,A03,084130,Staff,29,0,30,1
1649895651176,MATH 20D,B01,084133,Staff,26,0,30,4
1649895651176,MATH 20D,B02,084134,Staff,28,0,30,2
1649895651176,MATH 20D,B03,084135,Staff,30,0,30,0
1649895657204,MATH 20E,A01,084138,Staff,25,0,30,5
1649895657204,MATH 20E,A02,084139,Staff,24,0,30,6
1649895657204,MATH 20E,A03,084140,Staff,25,0,30,5
1649895657204,MATH 20E,A04,084141,Staff,28,0,30,2
1649895663227,MATH 102,A01,084143,Harel; Guershon,21,0,30,9
1649895663227,MATH 102,A02,084144,Harel; Guershon,23,0,30,7
1649895669262,MATH 103B,A01,083456,Staff,0,5,30,30
1649895669262,MATH 103B,A02,083457,Staff,0,4,30,30
1649895675286,MATH 109,A01,084146,Salehi Golsefidy; Alireza,29,0,30,1
1649895675286,MATH 109,A02,084147,Salehi Golsefidy; Alireza,23,0,30,7
1649895681313,MATH 120A,A01,085445,Eggers; John Dietrich,21,0,35,14
1649895681313,MATH 120A,A02,085446,Eggers; John Dietrich,28,0,35,7
1649895687339,MATH 142B,A01,084149,Verstraete; Jacques Allan,0,4,30,30
1649895687339,MATH 142B,A02,084150,Verstraete; Jacques Allan,0,4,30,30
1649895693375,MATH 170A,A01,083459,Nie; Jiawang,0,1,30,30
1649895693375,MATH 170A,A02,083460,Nie; Jiawang,12,0,30,18
1649895693375,MATH 170A,A03,083461,Nie; Jiawang,21,0,30,9
1649895699398,MATH 193B,A01,083463,Staff,7,0,30,23
1649895699398,MATH 193B,A02,083464,Staff,13,0,30,17
1649895699398,MATH 193B,A03,083465,Staff,23,0,30,7
1649895705456,COGS 2,A01,083966,Boyle; Mary E. T.,21,0,30,9
1649895711482,COGS 9,A01,083968,Staff,47,0,60,13
1649895717509,COGS 14B,A01,083970,Staff,38,0,50,12
1649895723536,COGS 17,A01,092679,Staff,68,0,75,7
1649895729562,COGS 100,A01,083972,Staff,30,0,60,30
1649895741617,COGS 101C,A01,083976,Staff,22,0,30,8
1649895747644,COGS 102A,A01,083978,Johnson; Christine M.,19,0,30,11
1649895753666,COGS 107B,A01,083980,Staff,13,0,50,37
1649895759689,COGS 115,A01,083982,Staff,13,0,30,17
1649895765715,COGS 118B,A01,083367,Staff,0,7,40,40
1649895771739,COGS 172,A01,083984,Provenzano; Emily Kara,17,0,30,13
1649895777766,COGS 177,A00,083368,Staff,1,13,30,29
1649895783788,COGS 186,A01,083986,Staff,23,0,40,17
1649895789810,COGS 187A,A01,083988,Boyle; Mary E. T.,25,0,60,35
1649895795838,CSE 8A,A50,084003,Miranda; Gregory Joseph,3,0,15,12
1649895801873,CSE 11,A01,084005,Miranda; Gregory Joseph,32,0,55,23
1649895807900,CSE 20,A01,084007,Staff,11,0,20,9
1649895813926,CSE 21,A01,084009,Staff,17,0,50,33
1649895819949,CSE 30,A01,083370,Cao; Yingjun,0,6,40,40
1649895825974,CSE 100,A01,083372,Cao; Yingjun,0,14,40,40
1649895832000,CSE 101,A01,084011,Staff,1,41,40,39
1649895838023,CSE 141,A01,083374,Eldon; John,1,45,75,74
1649895844048,CSE 141L,A01,083376,Eldon; John,1,48,75,74
1649895850166,CSE 175,A01,084013,Kumar; Rakesh,22,0,25,3
1649895856194,CSE 190,A00,092508,Dubnov; Shlomo,15,0,15,0
1649895862237,ECE 5,A01,084049,Morris; Karcher William,16,0,20,4
1649895868263,ECE 100,A01,084051,Baghdadchi; Saharnaz,4,0,20,16
1649895868263,ECE 100,A02,091916,Baghdadchi; Saharnaz,18,0,20,2
1649895874287,ECE 101,A01,084053,Baghdadchi; Saharnaz,10,0,37,27
1649895874287,ECE 101,A02,084054,Baghdadchi; Saharnaz,37,0,37,0
1649895880309,ECE 107,A01,083390,Staff,29,0,40,11
1649895886336,ECE 148,A01,084056,Silberman; Jack,7,0,12,5
1649895892363,ECE 180,A00,083391,Abi Samra; Nicholas Camill,25,0,30,5
1649895892363,ECE 180,B00,083392,Abi Samra; Nicholas Camill,22,0,30,8
1649895898392,MATH 10B,A01,084110,Staff,10,0,30,20
1649895898392,MATH 10B,A02,084111,Staff,29,0,30,1
1649895898392,MATH 10B,A03,084112,Staff,28,0,30,2
1649895904416,MATH 10C,A01,083443,Staff,12,0,30,18
1649895904416,MATH 10C,A02,083444,Staff,17,0,30,13
1649895904416,MATH 10C,B01,084114,Staff,26,0,30,4
1649895904416,MATH 10C,B02,084115,Staff,30,0,30,0
1649895910446,MATH 18,A01,084117,Harel; Guershon,27,0,30,3
1649895910446,MATH 18,A02,084119,Harel; Guershon,29,0,30,1
1649895910446,MATH 18,A03,084120,Harel; Guershon,30,0,30,0
1649895910446,MATH 18,A04,084121,Harel; Guershon,29,0,30,1
1649895916469,MATH 20B,A01,084124,Um; Ko Woon,31,0,35,4
1649895916469,MATH 20B,B01,084126,Um; Ko Woon,33,0,35,2
1649895922495,MATH 20C,A01,083446,Hammock; Frances H,20,0,30,10
1649895922495,MATH 20C,A02,083447,Hammock; Frances H,28,0,30,2
1649895922495,MATH 20C,A03,083448,Hammock; Frances H,30,0,30,0
1649895922495,MATH 20C,A04,083449,Hammock; Frances H,30,0,30,0
1649895922495,MATH 20C,B01,083451,Hammock; Frances H,26,0,30,4
1649895922495,MATH 20C,B02,083452,Hammock; Frances H,29,0,30,1
1649895922495,MATH 20C,B03,083453,Hammock; Frances H,29,0,30,1
1649895922495,MATH 20C,B04,083454,Hammock; Frances H,30,0,30,0
1649895928519,MATH 20D,A01,084128,Staff,29,0,30,1
1649895928519,MATH 20D,A02,084129,Staff,30,0,30,0
1649895928519,MATH 20D,A03,084130,Staff,29,0,30,1
1649895928519,MATH 20D,B01,084133,Staff,26,0,30,4
1649895928519,MATH 20D,B02,084134,Staff,28,0,30,2
1649895928519,MATH 20D,B03,084135,Staff,30,0,30,0
1649895934561,MATH 20E,A01,084138,Staff,25,0,30,5
1649895934561,MATH 20E,A02,084139,Staff,24,0,30,6
1649895934561,MATH 20E,A03,084140,Staff,25,0,30,5
1649895934561,MATH 20E,A04,084141,Staff,28,0,30,2
1649895940584,MATH 102,A01,084143,Harel; Guershon,21,0,30,9
1649895940584,MATH 102,A02,084144,Harel; Guershon,23,0,30,7
1649895946616,MATH 103B,A01,083456,Staff,0,5,30,30
1649895946616,MATH 103B,A02,083457,Staff,0,5,30,30
1649895952649,MATH 109,A01,084146,Salehi Golsefidy; Alireza,29,0,30,1
1649895952649,MATH 109,A02,084147,Salehi Golsefidy; Alireza,23,0,30,7
1649895958672,MATH 120A,A01,085445,Eggers; John Dietrich,21,0,35,14
1649895958672,MATH 120A,A02,085446,Eggers; John Dietrich,28,0,35,7
1649895964694,MATH 142B,A01,084149,Verstraete; Jacques Allan,0,4,30,30
1649895964694,MATH 142B,A02,084150,Verstraete; Jacques Allan,0,5,30,30
1649895970726,MATH 170A,A01,083459,Nie; Jiawang,0,1,30,30
1649895970726,MATH 170A,A02,083460,Nie; Jiawang,11,0,30,19
1649895970726,MATH 170A,A03,083461,Nie; Jiawang,21,0,30,9
1649895976748,MATH 193B,A01,083463,Staff,7,0,30,23
1649895976748,MATH 193B,A02,083464,Staff,13,0,30,17
1649895976748,MATH 193B,A03,083465,Staff,23,0,30,7
1649895982808,COGS 2,A01,083966,Boyle; Mary E. T.,21,0,30,9
1649895988832,COGS 9,A01,083968,Staff,47,0,60,13
1649895994855,COGS 14B,A01,083970,Staff,38,0,50,12
1649896000893,COGS 17,A01,092679,Staff,68,0,75,7
1649896006925,COGS 100,A01,083972,Staff,30,0,60,30
1649896018981,COGS 101C,A01,083976,Staff,22,0,30,8
1649896025017,COGS 102A,A01,083978,Johnson; Christine M.,19,0,30,11
1649896031050,COGS 107B,A01,083980,Staff,13,0,50,37
1649896037076,COGS 115,A01,083982,Staff,13,0,30,17
1649896043103,COGS 118B,A01,083367,Staff,0,7,40,40
1649896049127,COGS 172,A01,083984,Provenzano; Emily Kara,17,0,30,13
1649896055154,COGS 177,A00,083368,Staff,1,13,30,29
1649896061290,COGS 186,A01,083986,Staff,23,0,40,17
1649896067316,COGS 187A,A01,083988,Boyle; Mary E. T.,25,0,60,35
1649896073343,CSE 8A,A50,084003,Miranda; Gregory Joseph,3,0,15,12
1649896079368,CSE 11,A01,084005,Miranda; Gregory Joseph,32,0,55,23
1649896085394,CSE 20,A01,084007,Staff,11,0,20,9
1649896091417,CSE 21,A01,084009,Staff,17,0,50,33
1649896097440,CSE 30,A01,083370,Cao; Yingjun,0,6,40,40
1649896103462,CSE 100,A01,083372,Cao; Yingjun,0,14,40,40
1649896109486,CSE 101,A01,084011,Staff,1,42,40,39
1649896115511,CSE 141,A01,083374,Eldon; John,1,45,75,74
1649896121534,CSE 141L,A01,083376,Eldon; John,1,48,75,74
1649896127560,CSE 175,A01,084013,Kumar; Rakesh,22,0,25,3
1649896133581,CSE 190,A00,092508,Dubnov; Shlomo,15,0,15,0
1649896139608,ECE 5,A01,084049,Morris; Karcher William,16,0,20,4
1649896145631,ECE 100,A01,084051,Baghdadchi; Saharnaz,4,0,20,16
1649896145631,ECE 100,A02,091916,Baghdadchi; Saharnaz,18,0,20,2
1649896151654,ECE 101,A01,084053,Baghdadchi; Saharnaz,10,0,37,27
1649896151654,ECE 101,A02,084054,Baghdadchi; Saharnaz,37,0,37,0
1649896157679,ECE 107,A01,083390,Staff,29,0,40,11
1649896163702,ECE 148,A01,084056,Silberman; Jack,7,0,12,5
1649896169726,ECE 180,A00,083391,Abi Samra; Nicholas Camill,25,0,30,5
1649896169726,ECE 180,B00,083392,Abi Samra; Nicholas Camill,22,0,30,8
1649896175759,MATH 10B,A01,084110,Staff,10,0,30,20
1649896175759,MATH 10B,A02,084111,Staff,29,0,30,1
1649896175759,MATH 10B,A03,084112,Staff,28,0,30,2
1649896181785,MATH 10C,A01,083443,Staff,12,0,30,18
1649896181785,MATH 10C,A02,083444,Staff,17,0,30,13
1649896181785,MATH 10C,B01,084114,Staff,26,0,30,4
1649896181785,MATH 10C,B02,084115,Staff,30,0,30,0
1649896187817,MATH 18,A01,084117,Harel; Guershon,27,0,30,3
1649896187817,MATH 18,A02,084119,Harel; Guershon,29,0,30,1
1649896187817,MATH 18,A03,084120,Harel; Guershon,30,0,30,0
1649896187817,MATH 18,A04,084121,Harel; Guershon,29,0,30,1
1649896193848,MATH 20B,A01,084124,Um; Ko Woon,31,0,35,4
1649896193848,MATH 20B,B01,084126,Um; Ko Woon,33,0,35,2
1649896199873,MATH 20C,A01,083446,Hammock; Frances H,20,0,30,10
1649896199873,MATH 20C,A02,083447,Hammock; Frances H,28,0,30,2
1649896199873,MATH 20C,A03,083448,Hammock; Frances H,30,0,30,0
1649896199873,MATH 20C,A04,083449,Hammock; Frances H,30,0,30,0
1649896199873,MATH 20C,B01,083451,Hammock; Frances H,26,0,30,4
1649896199873,MATH 20C,B02,083452,Hammock; Frances H,29,0,30,1
1649896199873,MATH 20C,B03,083453,Hammock; Frances H,29,0,30,1
1649896199873,MATH 20C,B04,083454,Hammock; Frances H,30,0,30,0
1649896205904,MATH 20D,A01,084128,Staff,29,0,30,1
1649896205904,MATH 20D,A02,084129,Staff,30,0,30,0
1649896205904,MATH 20D,A03,084130,Staff,29,0,30,1
1649896205904,MATH 20D,B01,084133,Staff,26,0,30,4
1649896205904,MATH 20D,B02,084134,Staff,28,0,30,2
1649896205904,MATH 20D,B03,084135,Staff,30,0,30,0
1649896211939,MATH 20E,A01,084138,Staff,25,0,30,5
1649896211939,MATH 20E,A02,084139,Staff,24,0,30,6
1649896211939,MATH 20E,A03,084140,Staff,25,0,30,5
1649896211939,MATH 20E,A04,084141,Staff,28,0,30,2
1649896217962,MATH 102,A01,084143,Harel; Guershon,21,0,30,9
1649896217962,MATH 102,A02,084144,Harel; Guershon,22,0,30,8
1649896223999,MATH 103B,A01,083456,Staff,0,5,30,30
1649896223999,MATH 103B,A02,083457,Staff,0,5,30,30
1649896230023,MATH 109,A01,084146,Salehi Golsefidy; Alireza,29,0,30,1
1649896230023,MATH 109,A02,084147,Salehi Golsefidy; Alireza,23,0,30,7
1649896236046,MATH 120A,A01,085445,Eggers; John Dietrich,21,0,35,14
1649896236046,MATH 120A,A02,085446,Eggers; John Dietrich,28,0,35,7
1649896242073,MATH 142B,A01,084149,Verstraete; Jacques Allan,0,4,30,30
1649896242073,MATH 142B,A02,084150,Verstraete; Jacques Allan,0,5,30,30
1649896248099,MATH 170A,A01,083459,Nie; Jiawang,0,1,30,30
1649896248099,MATH 170A,A02,083460,Nie; Jiawang,11,0,30,19
1649896248099,MATH 170A,A03,083461,Nie; Jiawang,21,0,30,9
1649896254125,MATH 193B,A01,083463,Staff,7,0,30,23
1649896254125,MATH 193B,A02,083464,Staff,13,0,30,17
1649896254125,MATH 193B,A03,083465,Staff,23,0,30,7
1649896260191,COGS 2,A01,083966,Boyle; Mary E. T.,21,0,30,9
1649896266215,COGS 9,A01,083968,Staff,47,0,60,13
1649896272250,COGS 14B,A01,083970,Staff,38,0,50,12
1649896278278,COGS 17,A01,092679,Staff,68,0,75,7
1649896284314,COGS 100,A01,083972,Staff,29,0,60,31
1649896296361,COGS 101C,A01,083976,Staff,22,0,30,8
1649896302394,COGS 102A,A01,083978,Johnson; Christine M.,19,0,30,11
1649896308431,COGS 107B,A01,083980,Staff,13,0,50,37
1649896314473,COGS 115,A01,083982,Staff,13,0,30,17
1649896320503,COGS 118B,A01,083367,Staff,0,7,40,40
1649896326527,COGS 172,A01,083984,Provenzano; Emily Kara,17,0,30,13
1649896332562,COGS 177,A00,083368,Staff,1,13,30,29
1649896338594,COGS 186,A01,083986,Staff,23,0,40,17
1649896344620,COGS 187A,A01,083988,Boyle; Mary E. T.,24,0,60,36
1649896350645,CSE 8A,A50,084003,Miranda; Gregory Joseph,3,0,15,12
1649896356678,CSE 11,A01,084005,Miranda; Gregory Joseph,32,0,55,23
1649896362701,CSE 20,A01,084007,Staff,11,0,20,9
1649896368725,CSE 21,A01,084009,Staff,17,0,50,33
1649896374749,CSE 30,A01,083370,Cao; Yingjun,0,6,40,40
1649896380780,CSE 100,A01,083372,Cao; Yingjun,0,14,40,40
1649896386807,CSE 101,A01,084011,Staff,1,42,40,39
1649896392831,CSE 141,A01,083374,Eldon; John,1,45,75,74
1649896398854,CSE 141L,A01,083376,Eldon; John,1,48,75,74
1649896404935,CSE 175,A01,084013,Kumar; Rakesh,22,0,25,3
1649896410958,CSE 190,A00,092508,Dubnov; Shlomo,15,0,15,0
1649896416993,ECE 5,A01,084049,Morris; Karcher William,16,0,20,4
1649896423017,ECE 100,A01,084051,Baghdadchi; Saharnaz,4,0,20,16
1649896423017,ECE 100,A02,091916,Baghdadchi; Saharnaz,18,0,20,2
1649896429043,ECE 101,A01,084053,Baghdadchi; Saharnaz,10,0,37,27
1649896429043,ECE 101,A02,084054,Baghdadchi; Saharnaz,37,0,37,0
1649896435066,ECE 107,A01,083390,Staff,29,0,40,11
1649896441090,ECE 148,A01,084056,Silberman; Jack,7,0,12,5
1649896447114,ECE 180,A00,083391,Abi Samra; Nicholas Camill,25,0,30,5
1649896447114,ECE 180,B00,083392,Abi Samra; Nicholas Camill,22,0,30,8
1649896453140,MATH 10B,A01,084110,Staff,10,0,30,20
1649896453140,MATH 10B,A02,084111,Staff,29,0,30,1
1649896453140,MATH 10B,A03,084112,Staff,28,0,30,2
1649896459168,MATH 10C,A01,083443,Staff,11,0,30,19
1649896459168,MATH 10C,A02,083444,Staff,17,0,30,13
1649896459168,MATH 10C,B01,084114,Staff,26,0,30,4
1649896459168,MATH 10C,B02,084115,Staff,30,0,30,0
1649896465198,MATH 18,A01,084117,Harel; Guershon,27,0,30,3
1649896465198,MATH 18,A02,084119,Harel; Guershon,29,0,30,1
1649896465198,MATH 18,A03,084120,Harel; Guershon,30,0,30,0
1649896465198,MATH 18,A04,084121,Harel; Guershon,29,0,30,1
1649896471222,MATH 20B,A01,084124,Um; Ko Woon,31,0,35,4
1649896471222,MATH 20B,B01,084126,Um; Ko Woon,33,0,35,2
1649896477247,MATH 20C,A01,083446,Hammock; Frances H,19,0,30,11
1649896477247,MATH 20C,A02,083447,Hammock; Frances H,28,0,30,2
1649896477247,MATH 20C,A03,083448,Hammock; Frances H,30,0,30,0
1649896477247,MATH 20C,A04,083449,Hammock; Frances H,30,0,30,0
1649896477247,MATH 20C,B01,083451,Hammock; Frances H,26,0,30,4
1649896477247,MATH 20C,B02,083452,Hammock; Frances H,29,0,30,1
1649896477247,MATH 20C,B03,083453,Hammock; Frances H,29,0,30,1
1649896477247,MATH 20C,B04,083454,Hammock; Frances H,30,0,30,0
1649896483270,MATH 20D,A01,084128,Staff,29,0,30,1
1649896483270,MATH 20D,A02,084129,Staff,30,0,30,0
1649896483270,MATH 20D,A03,084130,Staff,29,0,30,1
1649896483270,MATH 20D,B01,084133,Staff,25,0,30,5
1649896483270,MATH 20D,B02,084134,Staff,28,0,30,2
1649896483270,MATH 20D,B03,084135,Staff,30,0,30,0
1649896489293,MATH 20E,A01,084138,Staff,25,0,30,5
1649896489293,MATH 20E,A02,084139,Staff,24,0,30,6
1649896489293,MATH 20E,A03,084140,Staff,25,0,30,5
1649896489293,MATH 20E,A04,084141,Staff,28,0,30,2
1649896495319,MATH 102,A01,084143,Harel; Guershon,21,0,30,9
1649896495319,MATH 102,A02,084144,Harel; Guershon,22,0,30,8
1649896501352,MATH 103B,A01,083456,Staff,0,5,30,30
1649896501352,MATH 103B,A02,083457,Staff,0,5,30,30
1649896507373,MATH 109,A01,084146,Salehi Golsefidy; Alireza,29,0,30,1
1649896507373,MATH 109,A02,084147,Salehi Golsefidy; Alireza,23,0,30,7
1649896513402,MATH 120A,A01,085445,Eggers; John Dietrich,21,0,35,14
1649896513402,MATH 120A,A02,085446,Eggers; John Dietrich,28,0,35,7
1649896519429,MATH 142B,A01,084149,Verstraete; Jacques Allan,0,4,30,30
1649896519429,MATH 142B,A02,084150,Verstraete; Jacques Allan,0,5,30,30
1649896525451,MATH 170A,A01,083459,Nie; Jiawang,0,1,30,30
1649896525451,MATH 170A,A02,083460,Nie; Jiawang,11,0,30,19
1649896525451,MATH 170A,A03,083461,Nie; Jiawang,21,0,30,9
1649896531479,MATH 193B,A01,083463,Staff,7,0,30,23
1649896531479,MATH 193B,A02,083464,Staff,13,0,30,17
1649896531479,MATH 193B,A03,083465,Staff,22,0,30,8
1649896537537,COGS 2,A01,083966,Boyle; Mary E. T.,21,0,30,9
1649896543568,COGS 9,A01,083968,Staff,47,0,60,13
1649896549593,COGS 14B,A01,083970,Staff,38,0,50,12
1649896555617,COGS 17,A01,092679,Staff,68,0,75,7
1649896561641,COGS 100,A01,083972,Staff,29,0,60,31
1649896573697,COGS 101C,A01,083976,Staff,22,0,30,8
1649896579719,COGS 102A,A01,083978,Johnson; Christine M.,19,0,30,11
1649896585744,COGS 107B,A01,083980,Staff,13,0,50,37
1649896591770,COGS 115,A01,083982,Staff,13,0,30,17
1649896597797,COGS 118B,A01,083367,Staff,0,7,40,40
1649896603824,COGS 172,A01,083984,Provenzano; Emily Kara,17,0,30,13
1649896609848,COGS 177,A00,083368,Staff,1,13,30,29
1649896615870,COGS 186,A01,083986,Staff,23,0,40,17
1649896621903,COGS 187A,A01,083988,Boyle; Mary E. T.,24,0,60,36
1649896627941,CSE 8A,A50,084003,Miranda; Gregory Joseph,3,0,15,12
1649896633964,CSE 11,A01,084005,Miranda; Gregory Joseph,32,0,55,23
1649896639990,CSE 20,A01,084007,Staff,11,0,20,9
1649896646013,CSE 21,A01,084009,Staff,17,0,50,33
1649896652036,CSE 30,A01,083370,Cao; Yingjun,0,6,40,40
1649896658156,CSE 100,A01,083372,Cao; Yingjun,0,14,40,40
1649896664179,CSE 101,A01,084011,Staff,1,42,40,39
1649896670217,CSE 141,A01,083374,Eldon; John,1,45,75,74
1649896676240,CSE 141L,A01,083376,Eldon; John,1,48,75,74
1649896682266,CSE 175,A01,084013,Kumar; Rakesh,22,0,25,3
1649896688293,CSE 190,A00,092508,Dubnov; Shlomo,15,0,15,0
1649896694318,ECE 5,A01,084049,Morris; Karcher William,16,0,20,4
1649896700354,ECE 100,A01,084051,Baghdadchi; Saharnaz,4,0,20,16
1649896700354,ECE 100,A02,091916,Baghdadchi; Saharnaz,18,0,20,2
1649896706379,ECE 101,A01,084053,Baghdadchi; Saharnaz,10,0,37,27
1649896706379,ECE 101,A02,084054,Baghdadchi; Saharnaz,37,0,37,0
1649896712420,ECE 107,A01,083390,Staff,29,0,40,11
1649896718455,ECE 148,A01,084056,Silberman; Jack,7,0,12,5
1649896724478,ECE 180,A00,083391,Abi Samra; Nicholas Camill,25,0,30,5
1649896724478,ECE 180,B00,083392,Abi Samra; Nicholas Camill,22,0,30,8
1649896730501,MATH 10B,A01,084110,Staff,10,0,30,20
1649896730501,MATH 10B,A02,084111,Staff,29,0,30,1
1649896730501,MATH 10B,A03,084112,Staff,28,0,30,2
1649896736527,MATH 10C,A01,083443,Staff,11,0,30,19
1649896736527,MATH 10C,A02,083444,Staff,17,0,30,13
1649896736527,MATH 10C,B01,084114,Staff,26,0,30,4
1649896736527,MATH 10C,B02,084115,Staff,30,0,30,0
1649896742551,MATH 18,A01,084117,Harel; Guershon,27,0,30,3
1649896742551,MATH 18,A02,084119,Harel; Guershon,29,0,30,1
1649896742551,MATH 18,A03,084120,Harel; Guershon,30,0,30,0
1649896742551,MATH 18,A04,084121,Harel; Guershon,29,0,30,1
1649896748578,MATH 20B,A01,084124,Um; Ko Woon,31,0,35,4
1649896748578,MATH 20B,B01,084126,Um; Ko Woon,33,0,35,2
1649896754604,MATH 20C,A01,083446,Hammock; Frances H,19,0,30,11
1649896754604,MATH 20C,A02,083447,Hammock; Frances H,28,0,30,2
1649896754604,MATH 20C,A03,083448,Hammock; Frances H,30,0,30,0
1649896754604,MATH 20C,A04,083449,Hammock; Frances H,30,0,30,0
1649896754604,MATH 20C,B01,083451,Hammock; Frances H,26,0,30,4
1649896754604,MATH 20C,B02,083452,Hammock; Frances H,29,0,30,1
1649896754604,MATH 20C,B03,083453,Hammock; Frances H,29,0,30,1
1649896754604,MATH 20C,B04,083454,Hammock; Frances H,30,0,30,0
1649896760637,MATH 20D,A01,084128,Staff,29,0,30,1
1649896760637,MATH 20D,A02,084129,Staff,30,0,30,0
1649896760637,MATH 20D,A03,084130,Staff,29,0,30,1
1649896760637,MATH 20D,B01,084133,Staff,25,0,30,5
1649896760637,MATH 20D,B02,084134,Staff,28,0,30,2
1649896760637,MATH 20D,B03,084135,Staff,30,0,30,0
1649896766664,MATH 20E,A01,084138,Staff,25,0,30,5
1649896766664,MATH 20E,A02,084139,Staff,24,0,30,6
1649896766664,MATH 20E,A03,084140,Staff,25,0,30,5
1649896766664,MATH 20E,A04,084141,Staff,28,0,30,2
1649896772693,MATH 102,A01,084143,Harel; Guershon,21,0,30,9
1649896772693,MATH 102,A02,084144,Harel; Guershon,22,0,30,8
1649896778721,MATH 103B,A01,083456,Staff,0,5,30,30
1649896778721,MATH 103B,A02,083457,Staff,0,5,30,30
1649896784757,MATH 109,A01,084146,Salehi Golsefidy; Alireza,29,0,30,1
1649896784757,MATH 109,A02,084147,Salehi Golsefidy; Alireza,23,0,30,7
1649896790780,MATH 120A,A01,085445,Eggers; John Dietrich,20,0,35,15
1649896790780,MATH 120A,A02,085446,Eggers; John Dietrich,28,0,35,7
1649896796804,MATH 142B,A01,084149,Verstraete; Jacques Allan,0,4,30,30
1649896796804,MATH 142B,A02,084150,Verstraete; Jacques Allan,0,5,30,30
1649896802834,MATH 170A,A01,083459,Nie; Jiawang,0,1,30,30
1649896802834,MATH 170A,A02,083460,Nie; Jiawang,11,0,30,19
1649896802834,MATH 170A,A03,083461,Nie; Jiawang,21,0,30,9
1649896808869,MATH 193B,A01,083463,Staff,7,0,30,23
1649896808869,MATH 193B,A02,083464,Staff,13,0,30,17
1649896808869,MATH 193B,A03,083465,Staff,22,0,30,8
1649896814922,COGS 2,A01,083966,Boyle; Mary E. T.,21,0,30,9
1649896820949,COGS 9,A01,083968,Staff,47,0,60,13
1649896826972,COGS 14B,A01,083970,Staff,37,0,50,13
1649896832995,COGS 17,A01,092679,Staff,68,0,75,7
1649896839021,COGS 100,A01,083972,Staff,29,0,60,31
1649896851070,COGS 101C,A01,083976,Staff,22,0,30,8
1649896857094,COGS 102A,A01,083978,Johnson; Christine M.,19,0,30,11
1649896863141,COGS 107B,A01,083980,Staff,12,0,50,38
1649896869162,COGS 115,A01,083982,Staff,13,0,30,17
1649896875212,COGS 118B,A01,083367,Staff,0,7,40,40
1649896881235,COGS 172,A01,083984,Provenzano; Emily Kara,17,0,30,13
1649896887261,COGS 177,A00,083368,Staff,1,13,30,29
1649896893285,COGS 186,A01,083986,Staff,23,0,40,17
1649896899307,COGS 187A,A01,083988,Boyle; Mary E. T.,24,0,60,36
1649896905331,CSE 8A,A50,084003,Miranda; Gregory Joseph,3,0,15,12
1649896911356,CSE 11,A01,084005,Miranda; Gregory Joseph,32,0,55,23
1649896917379,CSE 20,A01,084007,Staff,11,0,20,9
1649896923400,CSE 21,A01,084009,Staff,17,0,50,33
1649896929425,CSE 30,A01,083370,Cao; Yingjun,0,6,40,40
1649896935454,CSE 100,A01,083372,Cao; Yingjun,0,14,40,40
1649896941477,CSE 101,A01,084011,Staff,1,42,40,39
1649896947505,CSE 141,A01,083374,Eldon; John,1,45,75,74
1649896953529,CSE 141L,A01,083376,Eldon; John,1,48,75,74
1649896959556,CSE 175,A01,084013,Kumar; Rakesh,22,0,25,3
1649896965580,CSE 190,A00,092508,Dubnov; Shlomo,15,0,15,0
1649896971610,ECE 5,A01,084049,Morris; Karcher William,16,0,20,4
1649896977634,ECE 100,A01,084051,Baghdadchi; Saharnaz,4,0,20,16
1649896977634,ECE 100,A02,091916,Baghdadchi; Saharnaz,18,0,20,2
1649896983658,ECE 101,A01,084053,Baghdadchi; Saharnaz,9,0,37,28
1649896983658,ECE 101,A02,084054,Baghdadchi; Saharnaz,37,0,37,0
1649896989681,ECE 107,A01,083390,Staff,29,0,40,11
1649896995707,ECE 148,A01,084056,Silberman; Jack,7,0,12,5
1649897001732,ECE 180,A00,083391,Abi Samra; Nicholas Camill,25,0,30,5
1649897001732,ECE 180,B00,083392,Abi Samra; Nicholas Camill,22,0,30,8
1649897007755,MATH 10B,A01,084110,Staff,10,0,30,20
1649897007755,MATH 10B,A02,084111,Staff,29,0,30,1
1649897007755,MATH 10B,A03,084112,Staff,28,0,30,2
1649897013794,MATH 10C,A01,083443,Staff,11,0,30,19
1649897013794,MATH 10C,A02,083444,Staff,17,0,30,13
1649897013794,MATH 10C,B01,084114,Staff,26,0,30,4
1649897013794,MATH 10C,B02,084115,Staff,30,0,30,0
1649897019821,MATH 18,A01,084117,Harel; Guershon,27,0,30,3
1649897019821,MATH 18,A02,084119,Harel; Guershon,29,0,30,1
1649897019821,MATH 18,A03,084120,Harel; Guershon,30,0,30,0
1649897019821,MATH 18,A04,084121,Harel; Guershon,29,0,30,1
1649897025848,MATH 20B,A01,084124,Um; Ko Woon,31,0,35,4
1649897025848,MATH 20B,B01,084126,Um; Ko Woon,33,0,35,2
1649897031877,MATH 20C,A01,083446,Hammock; Frances H,19,0,30,11
1649897031877,MATH 20C,A02,083447,Hammock; Frances H,28,0,30,2
1649897031877,MATH 20C,A03,083448,Hammock; Frances H,30,0,30,0
1649897031877,MATH 20C,A04,083449,Hammock; Frances H,30,0,30,0
1649897031877,MATH 20C,B01,083451,Hammock; Frances H,26,0,30,4
1649897031877,MATH 20C,B02,083452,Hammock; Frances H,29,0,30,1
1649897031877,MATH 20C,B03,083453,Hammock; Frances H,29,0,30,1
1649897031877,MATH 20C,B04,083454,Hammock; Frances H,30,0,30,0
1649897037905,MATH 20D,A01,084128,Staff,29,0,30,1
1649897037905,MATH 20D,A02,084129,Staff,30,0,30,0
1649897037905,MATH 20D,A03,084130,Staff,29,0,30,1
1649897037905,MATH 20D,B01,084133,Staff,25,0,30,5
1649897037905,MATH 20D,B02,084134,Staff,28,0,30,2
1649897037905,MATH 20D,B03,084135,Staff,30,0,30,0
1649897043936,MATH 20E,A01,084138,Staff,25,0,30,5
1649897043936,MATH 20E,A02,084139,Staff,24,0,30,6
1649897043936,MATH 20E,A03,084140,Staff,25,0,30,5
1649897043936,MATH 20E,A04,084141,Staff,27,0,30,3
1649897049963,MATH 102,A01,084143,Harel; Guershon,21,0,30,9
1649897049963,MATH 102,A02,084144,Harel; Guershon,22,0,30,8
1649897055991,MATH 103B,A01,083456,Staff,0,5,30,30
1649897055991,MATH 103B,A02,083457,Staff,0,5,30,30
1649897062014,MATH 109,A01,084146,Salehi Golsefidy; Alireza,29,0,30,1
1649897062014,MATH 109,A02,084147,Salehi Golsefidy; Alireza,23,0,30,7
1649897068043,MATH 120A,A01,085445,Eggers; John Dietrich,20,0,35,15
1649897068043,MATH 120A,A02,085446,Eggers; John Dietrich,28,0,35,7
1649897074071,MATH 142B,A01,084149,Verstraete; Jacques Allan,0,4,30,30
1649897074071,MATH 142B,A02,084150,Verstraete; Jacques Allan,0,5,30,30
1649897080097,MATH 170A,A01,083459,Nie; Jiawang,0,1,30,30
1649897080097,MATH 170A,A02,083460,Nie; Jiawang,11,0,30,19
1649897080097,MATH 170A,A03,083461,Nie; Jiawang,21,0,30,9
1649897086132,MATH 193B,A01,083463,Staff,7,0,30,23
1649897086132,MATH 193B,A02,083464,Staff,13,0,30,17
1649897086132,MATH 193B,A03,083465,Staff,22,0,30,8
1649897092190,COGS 2,A01,083966,Boyle; Mary E. T.,21,0,30,9
1649897098217,COGS 9,A01,083968,Staff,47,0,60,13
1649897104239,COGS 14B,A01,083970,Staff,37,0,50,13
1649897110262,COGS 17,A01,092679,Staff,68,0,75,7
1649897116285,COGS 100,A01,083972,Staff,27,0,60,33
1649897128331,COGS 101C,A01,083976,Staff,22,0,30,8
1649897134359,COGS 102A,A01,083978,Johnson; Christine M.,19,0,30,11
1649897140383,COGS 107B,A01,083980,Staff,12,0,50,38
1649897146416,COGS 115,A01,083982,Staff,13,0,30,17
1649897152446,COGS 118B,A01,083367,Staff,0,7,40,40
1649897158468,COGS 172,A01,083984,Provenzano; Emily Kara,17,0,30,13
1649897164494,COGS 177,A00,083368,Staff,1,13,30,29
1649897170519,COGS 186,A01,083986,Staff,23,0,40,17
1649897176542,COGS 187A,A01,083988,Boyle; Mary E. T.,24,0,60,36
1649897182576,CSE 8A,A50,084003,Miranda; Gregory Joseph,3,0,15,12
1649897188604,CSE 11,A01,084005,Miranda; Gregory Joseph,32,0,55,23
1649897194632,CSE 20,A01,084007,Staff,11,0,20,9
1649897200662,CSE 21,A01,084009,Staff,17,0,50,33
1649897206685,CSE 30,A01,083370,Cao; Yingjun,0,6,40,40
1649897212708,CSE 100,A01,083372,Cao; Yingjun,0,14,40,40
1649897218736,CSE 101,A01,084011,Staff,1,42,40,39
1649897224760,CSE 141,A01,083374,Eldon; John,1,46,75,74
1649897230785,CSE 141L,A01,083376,Eldon; John,1,49,75,74
1649897236809,CSE 175,A01,084013,Kumar; Rakesh,22,0,25,3
1649897242833,CSE 190,A00,092508,Dubnov; Shlomo,15,0,15,0
1649897248861,ECE 5,A01,084049,Morris; Karcher William,16,0,20,4
1649897254974,ECE 100,A01,084051,Baghdadchi; Saharnaz,4,0,20,16
1649897254974,ECE 100,A02,091916,Baghdadchi; Saharnaz,18,0,20,2
1649897260998,ECE 101,A01,084053,Baghdadchi; Saharnaz,9,0,37,28
1649897260998,ECE 101,A02,084054,Baghdadchi; Saharnaz,37,0,37,0
1649897267027,ECE 107,A01,083390,Staff,29,0,40,11
1649897273050,ECE 148,A01,084056,Silberman; Jack,7,0,12,5
1649897279074,ECE 180,A00,083391,Abi Samra; Nicholas Camill,25,0,30,5
1649897279074,ECE 180,B00,083392,Abi Samra; Nicholas Camill,22,0,30,8
1649897285097,MATH 10B,A01,084110,Staff,10,0,30,20
1649897285097,MATH 10B,A02,084111,Staff,29,0,30,1
1649897285097,MATH 10B,A03,084112,Staff,28,0,30,2
1649897291125,MATH 10C,A01,083443,Staff,11,0,30,19
1649897291125,MATH 10C,A02,083444,Staff,17,0,30,13
1649897291125,MATH 10C,B01,084114,Staff,26,0,30,4
1649897291125,MATH 10C,B02,084115,Staff,30,0,30,0
1649897297149,MATH 18,A01,084117,Harel; Guershon,27,0,30,3
1649897297149,MATH 18,A02,084119,Harel; Guershon,29,0,30,1
1649897297149,MATH 18,A03,084120,Harel; Guershon,30,0,30,0
1649897297149,MATH 18,A04,084121,Harel; Guershon,29,0,30,1
1649897303172,MATH 20B,A01,084124,Um; Ko Woon,31,0,35,4
1649897303172,MATH 20B,B01,084126,Um; Ko Woon,33,0,35,2
1649897309197,MATH 20C,A01,083446,Hammock; Frances H,19,0,30,11
1649897309197,MATH 20C,A02,083447,Hammock; Frances H,28,0,30,2
1649897309197,MATH 20C,A03,083448,Hammock; Frances H,30,0,30,0
1649897309197,MATH 20C,A04,083449,Hammock; Frances H,30,0,30,0
1649897309197,MATH 20C,B01,083451,Hammock; Frances H,26,0,30,4
1649897309197,MATH 20C,B02,083452,Hammock; Frances H,29,0,30,1
1649897309197,MATH 20C,B03,083453,Hammock; Frances H,29,0,30,1
1649897309197,MATH 20C,B04,083454,Hammock; Frances H,30,0,30,0
1649897315221,MATH 20D,A01,084128,Staff,29,0,30,1
1649897315221,MATH 20D,A02,084129,Staff,30,0,30,0
1649897315221,MATH 20D,A03,084130,Staff,29,0,30,1
1649897315221,MATH 20D,B01,084133,Staff,25,0,30,5
1649897315221,MATH 20D,B02,084134,Staff,28,0,30,2
1649897315221,MATH 20D,B03,084135,Staff,30,0,30,0
1649897321245,MATH 20E,A01,084138,Staff,25,0,30,5
1649897321245,MATH 20E,A02,084139,Staff,24,0,30,6
1649897321245,MATH 20E,A03,084140,Staff,25,0,30,5
1649897321245,MATH 20E,A04,084141,Staff,27,0,30,3
1649897327268,MATH 102,A01,084143,Harel; Guershon,21,0,30,9
1649897327268,MATH 102,A02,084144,Harel; Guershon,22,0,30,8
1649897333297,MATH 103B,A01,083456,Staff,0,5,30,30
1649897333297,MATH 103B,A02,083457,Staff,0,5,30,30
1649897339333,MATH 109,A01,084146,Salehi Golsefidy; Alireza,29,0,30,1
1649897339333,MATH 109,A02,084147,Salehi Golsefidy; Alireza,23,0,30,7
1649897345364,MATH 120A,A01,085445,Eggers; John Dietrich,20,0,35,15
1649897345364,MATH 120A,A02,085446,Eggers; John Dietrich,28,0,35,7
1649897351388,MATH 142B,A01,084149,Verstraete; Jacques Allan,0,4,30,30
1649897351388,MATH 142B,A02,084150,Verstraete; Jacques Allan,0,5,30,30
1649897357418,MATH 170A,A01,083459,Nie; Jiawang,0,1,30,30
1649897357418,MATH 170A,A02,083460,Nie; Jiawang,11,0,30,19
1649897357418,MATH 170A,A03,083461,Nie; Jiawang,21,0,30,9
1649897363451,MATH 193B,A01,083463,Staff,7,0,30,23
1649897363451,MATH 193B,A02,083464,Staff,13,0,30,17
1649897363451,MATH 193B,A03,083465,Staff,22,0,30,8
1649897369514,COGS 2,A01,083966,Boyle; Mary E. T.,21,0,30,9
1649897375540,COGS 9,A01,083968,Staff,47,0,60,13
1649897381568,COGS 14B,A01,083970,Staff,37,0,50,13
1649897387591,COGS 17,A01,092679,Staff,68,0,75,7
1649897393613,COGS 100,A01,083972,Staff,27,0,60,33
1649897405673,COGS 101C,A01,083976,Staff,22,0,30,8
1649897411698,COGS 102A,A01,083978,Johnson; Christine M.,19,0,30,11
1649897417726,COGS 107B,A01,083980,Staff,13,0,50,37
1649897423750,COGS 115,A01,083982,Staff,13,0,30,17
1649897429773,COGS 118B,A01,083367,Staff,0,7,40,40
1649897435796,COGS 172,A01,083984,Provenzano; Emily Kara,17,0,30,13
1649897441820,COGS 177,A00,083368,Staff,1,13,30,29
1649897447843,COGS 186,A01,083986,Staff,23,0,40,17
1649897453866,COGS 187A,A01,083988,Boyle; Mary E. T.,24,0,60,36
1649897459901,CSE 8A,A50,084003,Miranda; Gregory Joseph,3,0,15,12
1649897465928,CSE 11,A01,084005,Miranda; Gregory Joseph,32,0,55,23
1649897471952,CSE 20,A01,084007,Staff,11,0,20,9
1649897477980,CSE 21,A01,084009,Staff,17,0,50,33
1649897484003,CSE 30,A01,083370,Cao; Yingjun,0,6,40,40
1649897490026,CSE 100,A01,083372,Cao; Yingjun,0,14,40,40
1649897496050,CSE 101,A01,084011,Staff,1,43,40,39
1649897502081,CSE 141,A01,083374,Eldon; John,1,46,75,74
1649897508108,CSE 141L,A01,083376,Eldon; John,1,49,75,74
1649897514133,CSE 175,A01,084013,Kumar; Rakesh,22,0,25,3
1649897520159,CSE 190,A00,092508,Dubnov; Shlomo,15,0,15,0
1649897526182,ECE 5,A01,084049,Morris; Karcher William,16,0,20,4
1649897532209,ECE 100,A01,084051,Baghdadchi; Saharnaz,4,0,20,16
1649897532209,ECE 100,A02,091916,Baghdadchi; Saharnaz,18,0,20,2
1649897538231,ECE 101,A01,084053,Baghdadchi; Saharnaz,9,0,37,28
1649897538231,ECE 101,A02,084054,Baghdadchi; Saharnaz,37,0,37,0
1649897544255,ECE 107,A01,083390,Staff,29,0,40,11
1649897550294,ECE 148,A01,084056,Silberman; Jack,7,0,12,5
1649897556317,ECE 180,A00,083391,Abi Samra; Nicholas Camill,25,0,30,5
1649897556317,ECE 180,B00,083392,Abi Samra; Nicholas Camill,22,0,30,8
1649897562339,MATH 10B,A01,084110,Staff,10,0,30,20
1649897562339,MATH 10B,A02,084111,Staff,29,0,30,1
1649897562339,MATH 10B,A03,084112,Staff,28,0,30,2
1649897568361,MATH 10C,A01,083443,Staff,11,0,30,19
1649897568361,MATH 10C,A02,083444,Staff,17,0,30,13
1649897568361,MATH 10C,B01,084114,Staff,26,0,30,4
1649897568361,MATH 10C,B02,084115,Staff,30,0,30,0
1649897574385,MATH 18,A01,084117,Harel; Guershon,27,0,30,3
1649897574385,MATH 18,A02,084119,Harel; Guershon,29,0,30,1
1649897574385,MATH 18,A03,084120,Harel; Guershon,30,0,30,0
1649897574385,MATH 18,A04,084121,Harel; Guershon,29,0,30,1
1649897580477,MATH 20B,A01,084124,Um; Ko Woon,31,0,35,4
1649897580477,MATH 20B,B01,084126,Um; Ko Woon,33,0,35,2
1649897586511,MATH 20C,A01,083446,Hammock; Frances H,19,0,30,11
1649897586511,MATH 20C,A02,083447,Hammock; Frances H,28,0,30,2
1649897586511,MATH 20C,A03,083448,Hammock; Frances H,30,0,30,0
1649897586511,MATH 20C,A04,083449,Hammock; Frances H,30,0,30,0
1649897586511,MATH 20C,B01,083451,Hammock; Frances H,26,0,30,4
1649897586511,MATH 20C,B02,083452,Hammock; Frances H,29,0,30,1
1649897586511,MATH 20C,B03,083453,Hammock; Frances H,29,0,30,1
1649897586511,MATH 20C,B04,083454,Hammock; Frances H,30,0,30,0
1649897592540,MATH 20D,A01,084128,Staff,29,0,30,1
1649897592540,MATH 20D,A02,084129,Staff,30,0,30,0
1649897592540,MATH 20D,A03,084130,Staff,29,0,30,1
1649897592540,MATH 20D,B01,084133,Staff,25,0,30,5
1649897592540,MATH 20D,B02,084134,Staff,28,0,30,2
1649897592540,MATH 20D,B03,084135,Staff,30,0,30,0
1649897598562,MATH 20E,A01,084138,Staff,25,0,30,5
1649897598562,MATH 20E,A02,084139,Staff,24,0,30,6
1649897598562,MATH 20E,A03,084140,Staff,25,0,30,5
1649897598562,MATH 20E,A04,084141,Staff,27,0,30,3
1649897604595,MATH 102,A01,084143,Harel; Guershon,21,0,30,9
1649897604595,MATH 102,A02,084144,Harel; Guershon,22,0,30,8
1649897610627,MATH 103B,A01,083456,Staff,0,5,30,30
1649897610627,MATH 103B,A02,083457,Staff,0,6,30,30
1649897616650,MATH 109,A01,084146,Salehi Golsefidy; Alireza,29,0,30,1
1649897616650,MATH 109,A02,084147,Salehi Golsefidy; Alireza,23,0,30,7
1649897622673,MATH 120A,A01,085445,Eggers; John Dietrich,20,0,35,15
1649897622673,MATH 120A,A02,085446,Eggers; John Dietrich,28,0,35,7
1649897628698,MATH 142B,A01,084149,Verstraete; Jacques Allan,0,4,30,30
1649897628698,MATH 142B,A02,084150,Verstraete; Jacques Allan,0,5,30,30
1649897634726,MATH 170A,A01,083459,Nie; Jiawang,0,1,30,30
1649897634726,MATH 170A,A02,083460,Nie; Jiawang,11,0,30,19
1649897634726,MATH 170A,A03,083461,Nie; Jiawang,21,0,30,9
1649897640760,MATH 193B,A01,083463,Staff,7,0,30,23
1649897640760,MATH 193B,A02,083464,Staff,13,0,30,17
1649897640760,MATH 193B,A03,083465,Staff,22,0,30,8
1649897646817,COGS 2,A01,083966,Boyle; Mary E. T.,21,0,30,9
1649897652844,COGS 9,A01,083968,Staff,45,0,60,15
1649897658870,COGS 14B,A01,083970,Staff,36,0,50,14
1649897664894,COGS 17,A01,092679,Staff,68,0,75,7
1649897670922,COGS 100,A01,083972,Staff,27,0,60,33
1649897682982,COGS 101C,A01,083976,Staff,22,0,30,8
1649897689009,COGS 102A,A01,083978,Johnson; Christine M.,19,0,30,11
1649897695033,COGS 107B,A01,083980,Staff,12,0,50,38
1649897701057,COGS 115,A01,083982,Staff,13,0,30,17
1649897707084,COGS 118B,A01,083367,Staff,0,7,40,40
1649897713107,COGS 172,A01,083984,Provenzano; Emily Kara,17,0,30,13
1649897719140,COGS 177,A00,083368,Staff,1,14,30,29
1649897725165,COGS 186,A01,083986,Staff,23,0,40,17
1649897731192,COGS 187A,A01,083988,Boyle; Mary E. T.,24,0,60,36
1649897737218,CSE 8A,A50,084003,Miranda; Gregory Joseph,3,0,15,12
1649897743245,CSE 11,A01,084005,Miranda; Gregory Joseph,31,0,55,24
1649897749269,CSE 20,A01,084007,Staff,11,0,20,9
1649897755295,CSE 21,A01,084009,Staff,17,0,50,33
1649897761334,CSE 30,A01,083370,Cao; Yingjun,0,6,40,40
1649897767361,CSE 100,A01,083372,Cao; Yingjun,0,14,40,40
1649897773390,CSE 101,A01,084011,Staff,1,45,40,39
1649897779418,CSE 141,A01,083374,Eldon; John,1,47,75,74
1649897785449,CSE 141L,A01,083376,Eldon; John,1,50,75,74
1649897791479,CSE 175,A01,084013,Kumar; Rakesh,22,0,25,3
1649897797512,CSE 190,A00,092508,Dubnov; Shlomo,15,0,15,0
1649897803536,ECE 5,A01,084049,Morris; Karcher William,16,0,20,4
1649897809567,ECE 100,A01,084051,Baghdadchi; Saharnaz,4,0,20,16
1649897809567,ECE 100,A02,091916,Baghdadchi; Saharnaz,18,0,20,2
1649897815595,ECE 101,A01,084053,Baghdadchi; Saharnaz,9,0,37,28
1649897815595,ECE 101,A02,084054,Baghdadchi; Saharnaz,37,0,37,0
1649897821623,ECE 107,A01,083390,Staff,29,0,40,11
1649897827646,ECE 148,A01,084056,Silberman; Jack,7,0,12,5
1649897833668,ECE 180,A00,083391,Abi Samra; Nicholas Camill,25,0,30,5
1649897833668,ECE 180,B00,083392,Abi Samra; Nicholas Camill,22,0,30,8
1649897839693,MATH 10B,A01,084110,Staff,10,0,30,20
1649897839693,MATH 10B,A02,084111,Staff,29,0,30,1
1649897839693,MATH 10B,A03,084112,Staff,28,0,30,2
1649897845730,MATH 10C,A01,083443,Staff,11,0,30,19
1649897845730,MATH 10C,A02,083444,Staff,17,0,30,13
1649897845730,MATH 10C,B01,084114,Staff,26,0,30,4
1649897845730,MATH 10C,B02,084115,Staff,30,0,30,0
1649897851861,MATH 18,A01,084117,Harel; Guershon,27,0,30,3
1649897851861,MATH 18,A02,084119,Harel; Guershon,29,0,30,1
1649897851861,MATH 18,A03,084120,Harel; Guershon,30,0,30,0
1649897851861,MATH 18,A04,084121,Harel; Guershon,29,0,30,1
1649897857894,MATH 20B,A01,084124,Um; Ko Woon,31,0,35,4
1649897857894,MATH 20B,B01,084126,Um; Ko Woon,33,0,35,2
1649897863916,MATH 20C,A01,083446,Hammock; Frances H,19,0,30,11
1649897863916,MATH 20C,A02,083447,Hammock; Frances H,28,0,30,2
1649897863916,MATH 20C,A03,083448,Hammock; Frances H,30,0,30,0
1649897863916,MATH 20C,A04,083449,Hammock; Frances H,30,0,30,0
1649897863916,MATH 20C,B01,083451,Hammock; Frances H,26,0,30,4
1649897863916,MATH 20C,B02,083452,Hammock; Frances H,29,0,30,1
1649897863916,MATH 20C,B03,083453,Hammock; Frances H,29,0,30,1
1649897863916,MATH 20C,B04,083454,Hammock; Frances H,30,0,30,0
1649897869939,MATH 20D,A01,084128,Staff,29,0,30,1
1649897869939,MATH 20D,A02,084129,Staff,30,0,30,0
1649897869939,MATH 20D,A03,084130,Staff,29,0,30,1
1649897869939,MATH 20D,B01,084133,Staff,25,0,30,5
1649897869939,MATH 20D,B02,084134,Staff,28,0,30,2
1649897869939,MATH 20D,B03,084135,Staff,30,0,30,0
1649897875965,MATH 20E,A01,084138,Staff,25,0,30,5
1649897875965,MATH 20E,A02,084139,Staff,24,0,30,6
1649897875965,MATH 20E,A03,084140,Staff,25,0,30,5
1649897875965,MATH 20E,A04,084141,Staff,27,0,30,3
1649897881989,MATH 102,A01,084143,Harel; Guershon,21,0,30,9
1649897881989,MATH 102,A02,084144,Harel; Guershon,22,0,30,8
1649897888020,MATH 103B,A01,083456,Staff,0,5,30,30
1649897888020,MATH 103B,A02,083457,Staff,0,6,30,30
1649897894050,MATH 109,A01,084146,Salehi Golsefidy; Alireza,29,0,30,1
1649897894050,MATH 109,A02,084147,Salehi Golsefidy; Alireza,23,0,30,7
1649897900074,MATH 120A,A01,085445,Eggers; John Dietrich,20,0,35,15
1649897900074,MATH 120A,A02,085446,Eggers; John Dietrich,28,0,35,7
1649897906103,MATH 142B,A01,084149,Verstraete; Jacques Allan,0,4,30,30
1649897906103,MATH 142B,A02,084150,Verstraete; Jacques Allan,0,5,30,30
1649897912137,MATH 170A,A01,083459,Nie; Jiawang,0,1,30,30
1649897912137,MATH 170A,A02,083460,Nie; Jiawang,10,0,30,20
1649897912137,MATH 170A,A03,083461,Nie; Jiawang,21,0,30,9
1649897918163,MATH 193B,A01,083463,Staff,7,0,30,23
1649897918163,MATH 193B,A02,083464,Staff,13,0,30,17
1649897918163,MATH 193B,A03,083465,Staff,22,0,30,8
1649897924213,COGS 2,A01,083966,Boyle; Mary E. T.,21,0,30,9
1649897930239,COGS 9,A01,083968,Staff,45,0,60,15
1649897936263,COGS 14B,A01,083970,Staff,36,0,50,14
1649897942290,COGS 17,A01,092679,Staff,68,0,75,7
1649897948315,COGS 100,A01,083972,Staff,27,0,60,33
1649897960366,COGS 101C,A01,083976,Staff,22,0,30,8
1649897966390,COGS 102A,A01,083978,Johnson; Christine M.,19,0,30,11
1649897972413,COGS 107B,A01,083980,Staff,12,0,50,38
1649897978444,COGS 115,A01,083982,Staff,13,0,30,17
1649897984471,COGS 118B,A01,083367,Staff,0,7,40,40
1649897990500,COGS 172,A01,083984,Provenzano; Emily Kara,17,0,30,13
1649897996523,COGS 177,A00,083368,Staff,1,14,30,29
1649898002549,COGS 186,A01,083986,Staff,23,0,40,17
1649898008579,COGS 187A,A01,083988,Boyle; Mary E. T.,24,0,60,36
1649898014603,CSE 8A,A50,084003,Miranda; Gregory Joseph,3,0,15,12
1649898020627,CSE 11,A01,084005,Miranda; Gregory Joseph,31,0,55,24
1649898026649,CSE 20,A01,084007,Staff,11,0,20,9
1649898032675,CSE 21,A01,084009,Staff,17,0,50,33
1649898038698,CSE 30,A01,083370,Cao; Yingjun,0,7,40,40
1649898044722,CSE 100,A01,083372,Cao; Yingjun,0,14,40,40
1649898050747,CSE 101,A01,084011,Staff,1,45,40,39
1649898056769,CSE 141,A01,083374,Eldon; John,1,47,75,74
1649898062795,CSE 141L,A01,083376,Eldon; John,1,50,75,74
1649898068817,CSE 175,A01,084013,Kumar; Rakesh,22,0,25,3
1649898074861,CSE 190,A00,092508,Dubnov; Shlomo,15,0,15,0
1649898080884,ECE 5,A01,084049,Morris; Karcher William,16,0,20,4
1649898086913,ECE 100,A01,084051,Baghdadchi; Saharnaz,4,0,20,16
1649898086913,ECE 100,A02,091916,Baghdadchi; Saharnaz,18,0,20,2
1649898092940,ECE 101,A01,084053,Baghdadchi; Saharnaz,9,0,37,28
1649898092940,ECE 101,A02,084054,Baghdadchi; Saharnaz,37,0,37,0
1649898098963,ECE 107,A01,083390,Staff,29,0,40,11
1649898104989,ECE 148,A01,084056,Silberman; Jack,7,0,12,5
1649898111019,ECE 180,A00,083391,Abi Samra; Nicholas Camill,25,0,30,5
1649898111019,ECE 180,B00,083392,Abi Samra; Nicholas Camill,22,0,30,8
1649898117053,MATH 10B,A01,084110,Staff,10,0,30,20
1649898117053,MATH 10B,A02,084111,Staff,29,0,30,1
1649898117053,MATH 10B,A03,084112,Staff,28,0,30,2
1649898123094,MATH 10C,A01,083443,Staff,11,0,30,19
1649898123094,MATH 10C,A02,083444,Staff,17,0,30,13
1649898123094,MATH 10C,B01,084114,Staff,26,0,30,4
1649898123094,MATH 10C,B02,084115,Staff,30,0,30,0
1649898129125,MATH 18,A01,084117,Harel; Guershon,27,0,30,3
1649898129125,MATH 18,A02,084119,Harel; Guershon,29,0,30,1
1649898129125,MATH 18,A03,084120,Harel; Guershon,30,0,30,0
1649898129125,MATH 18,A04,084121,Harel; Guershon,29,0,30,1
1649898135147,MATH 20B,A01,084124,Um; Ko Woon,31,0,35,4
1649898135147,MATH 20B,B01,084126,Um; Ko Woon,33,0,35,2
1649898141170,MATH 20C,A01,083446,Hammock; Frances H,19,0,30,11
1649898141170,MATH 20C,A02,083447,Hammock; Frances H,28,0,30,2
1649898141170,MATH 20C,A03,083448,Hammock; Frances H,30,0,30,0
1649898141170,MATH 20C,A04,083449,Hammock; Frances H,30,0,30,0
1649898141170,MATH 20C,B01,083451,Hammock; Frances H,26,0,30,4
1649898141170,MATH 20C,B02,083452,Hammock; Frances H,29,0,30,1
1649898141170,MATH 20C,B03,083453,Hammock; Frances H,29,0,30,1
1649898141170,MATH 20C,B04,083454,Hammock; Frances H,30,0,30,0
1649898147204,MATH 20D,A01,084128,Staff,29,0,30,1
1649898147204,MATH 20D,A02,084129,Staff,30,0,30,0
1649898147204,MATH 20D,A03,084130,Staff,29,0,30,1
1649898147204,MATH 20D,B01,084133,Staff,25,0,30,5
1649898147204,MATH 20D,B02,084134,Staff,28,0,30,2
1649898147204,MATH 20D,B03,084135,Staff,30,0,30,0
1649898153227,MATH 20E,A01,084138,Staff,25,0,30,5
1649898153227,MATH 20E,A02,084139,Staff,24,0,30,6
1649898153227,MATH 20E,A03,084140,Staff,25,0,30,5
1649898153227,MATH 20E,A04,084141,Staff,27,0,30,3
1649898159251,MATH 102,A01,084143,Harel; Guershon,21,0,30,9
1649898159251,MATH 102,A02,084144,Harel; Guershon,22,0,30,8
1649898165275,MATH 103B,A01,083456,Staff,0,5,30,30
1649898165275,MATH 103B,A02,083457,Staff,0,6,30,30
1649898171298,MATH 109,A01,084146,Salehi Golsefidy; Alireza,29,0,30,1
1649898171298,MATH 109,A02,084147,Salehi Golsefidy; Alireza,23,0,30,7
1649898177326,MATH 120A,A01,085445,Eggers; John Dietrich,20,0,35,15
1649898177326,MATH 120A,A02,085446,Eggers; John Dietrich,28,0,35,7
1649898183350,MATH 142B,A01,084149,Verstraete; Jacques Allan,0,4,30,30
1649898183350,MATH 142B,A02,084150,Verstraete; Jacques Allan,0,5,30,30
1649898189377,MATH 170A,A01,083459,Nie; Jiawang,0,1,30,30
1649898189377,MATH 170A,A02,083460,Nie; Jiawang,10,0,30,20
1649898189377,MATH 170A,A03,083461,Nie; Jiawang,21,0,30,9
1649898195400,MATH 193B,A01,083463,Staff,7,0,30,23
1649898195400,MATH 193B,A02,083464,Staff,13,0,30,17
1649898195400,MATH 193B,A03,083465,Staff,22,0,30,8
1649898201462,COGS 2,A01,083966,Boyle; Mary E. T.,21,0,30,9
1649898207488,COGS 9,A01,083968,Staff,45,0,60,15
1649898213512,COGS 14B,A01,083970,Staff,36,0,50,14
1649898219539,COGS 17,A01,092679,Staff,68,0,75,7
1649898225563,COGS 100,A01,083972,Staff,27,0,60,33
1649898237617,COGS 101C,A01,083976,Staff,21,0,30,9
1649898243643,COGS 102A,A01,083978,Johnson; Christine M.,19,0,30,11
1649898249670,COGS 107B,A01,083980,Staff,11,0,50,39
1649898255693,COGS 115,A01,083982,Staff,13,0,30,17
1649898261718,COGS 118B,A01,083367,Staff,0,7,40,40
1649898267748,COGS 172,A01,083984,Provenzano; Emily Kara,17,0,30,13
1649898273772,COGS 177,A00,083368,Staff,1,14,30,29
1649898279794,COGS 186,A01,083986,Staff,23,0,40,17
1649898285830,COGS 187A,A01,083988,Boyle; Mary E. T.,24,0,60,36
1649898291853,CSE 8A,A50,084003,Miranda; Gregory Joseph,3,0,15,12
1649898297884,CSE 11,A01,084005,Miranda; Gregory Joseph,31,0,55,24
1649898303916,CSE 20,A01,084007,Staff,11,0,20,9
1649898309944,CSE 21,A01,084009,Staff,17,0,50,33
1649898315971,CSE 30,A01,083370,Cao; Yingjun,0,7,40,40
1649898321997,CSE 100,A01,083372,Cao; Yingjun,0,14,40,40
1649898328028,CSE 101,A01,084011,Staff,1,45,40,39
1649898334056,CSE 141,A01,083374,Eldon; John,1,47,75,74
1649898340079,CSE 141L,A01,083376,Eldon; John,1,50,75,74
1649898346106,CSE 175,A01,084013,Kumar; Rakesh,22,0,25,3
1649898352137,CSE 190,A00,092508,Dubnov; Shlomo,15,0,15,0
1649898358163,ECE 5,A01,084049,Morris; Karcher William,16,0,20,4
1649898364189,ECE 100,A01,084051,Baghdadchi; Saharnaz,4,0,20,16
1649898364189,ECE 100,A02,091916,Baghdadchi; Saharnaz,18,0,20,2
1649898370215,ECE 101,A01,084053,Baghdadchi; Saharnaz,9,0,37,28
1649898370215,ECE 101,A02,084054,Baghdadchi; Saharnaz,37,0,37,0
1649898376240,ECE 107,A01,083390,Staff,29,0,40,11
1649898382269,ECE 148,A01,084056,Silberman; Jack,7,0,12,5
1649898388295,ECE 180,A00,083391,Abi Samra; Nicholas Camill,25,0,30,5
1649898388295,ECE 180,B00,083392,Abi Samra; Nicholas Camill,22,0,30,8
1649898394324,MATH 10B,A01,084110,Staff,10,0,30,20
1649898394324,MATH 10B,A02,084111,Staff,29,0,30,1
1649898394324,MATH 10B,A03,084112,Staff,28,0,30,2
1649898400348,MATH 10C,A01,083443,Staff,11,0,30,19
1649898400348,MATH 10C,A02,083444,Staff,17,0,30,13
1649898400348,MATH 10C,B01,084114,Staff,26,0,30,4
1649898400348,MATH 10C,B02,084115,Staff,30,0,30,0
1649898406371,MATH 18,A01,084117,Harel; Guershon,27,0,30,3
1649898406371,MATH 18,A02,084119,Harel; Guershon,29,0,30,1
1649898406371,MATH 18,A03,084120,Harel; Guershon,30,0,30,0
1649898406371,MATH 18,A04,084121,Harel; Guershon,29,0,30,1
1649898412403,MATH 20B,A01,084124,Um; Ko Woon,31,0,35,4
1649898412403,MATH 20B,B01,084126,Um; Ko Woon,33,0,35,2
1649898418438,MATH 20C,A01,083446,Hammock; Frances H,19,0,30,11
1649898418438,MATH 20C,A02,083447,Hammock; Frances H,28,0,30,2
1649898418438,MATH 20C,A03,083448,Hammock; Frances H,30,0,30,0
1649898418438,MATH 20C,A04,083449,Hammock; Frances H,30,0,30,0
1649898418438,MATH 20C,B01,083451,Hammock; Frances H,26,0,30,4
1649898418438,MATH 20C,B02,083452,Hammock; Frances H,29,0,30,1
1649898418438,MATH 20C,B03,083453,Hammock; Frances H,29,0,30,1
1649898418438,MATH 20C,B04,083454,Hammock; Frances H,30,0,30,0
1649898424466,MATH 20D,A01,084128,Staff,29,0,30,1
1649898424466,MATH 20D,A02,084129,Staff,30,0,30,0
1649898424466,MATH 20D,A03,084130,Staff,29,0,30,1
1649898424466,MATH 20D,B01,084133,Staff,25,0,30,5
1649898424466,MATH 20D,B02,084134,Staff,28,0,30,2
1649898424466,MATH 20D,B03,084135,Staff,30,0,30,0
1649898430490,MATH 20E,A01,084138,Staff,25,0,30,5
1649898430490,MATH 20E,A02,084139,Staff,24,0,30,6
1649898430490,MATH 20E,A03,084140,Staff,25,0,30,5
1649898430490,MATH 20E,A04,084141,Staff,27,0,30,3
1649898436514,MATH 102,A01,084143,Harel; Guershon,21,0,30,9
1649898436514,MATH 102,A02,084144,Harel; Guershon,22,0,30,8
1649898442544,MATH 103B,A01,083456,Staff,0,5,30,30
1649898442544,MATH 103B,A02,083457,Staff,0,6,30,30
1649898448663,MATH 109,A01,084146,Salehi Golsefidy; Alireza,29,0,30,1
1649898448663,MATH 109,A02,084147,Salehi Golsefidy; Alireza,23,0,30,7
1649898454692,MATH 120A,A01,085445,Eggers; John Dietrich,20,0,35,15
1649898454692,MATH 120A,A02,085446,Eggers; John Dietrich,28,0,35,7
1649898460728,MATH 142B,A01,084149,Verstraete; Jacques Allan,0,4,30,30
1649898460728,MATH 142B,A02,084150,Verstraete; Jacques Allan,0,5,30,30
1649898466761,MATH 170A,A01,083459,Nie; Jiawang,0,1,30,30
1649898466761,MATH 170A,A02,083460,Nie; Jiawang,9,0,30,21
1649898466761,MATH 170A,A03,083461,Nie; Jiawang,21,0,30,9
1649898472786,MATH 193B,A01,083463,Staff,7,0,30,23
1649898472786,MATH 193B,A02,083464,Staff,12,0,30,18
1649898472786,MATH 193B,A03,083465,Staff,22,0,30,8
1649898478843,COGS 2,A01,083966,Boyle; Mary E. T.,21,0,30,9
1649898484864,COGS 9,A01,083968,Staff,45,0,60,15
1649898490887,COGS 14B,A01,083970,Staff,36,0,50,14
1649898496909,COGS 17,A01,092679,Staff,68,0,75,7
1649898502932,COGS 100,A01,083972,Staff,27,0,60,33
1649898514981,COGS 101C,A01,083976,Staff,21,0,30,9
1649898521006,COGS 102A,A01,083978,Johnson; Christine M.,19,0,30,11
1649898527030,COGS 107B,A01,083980,Staff,11,0,50,39
1649898533057,COGS 115,A01,083982,Staff,13,0,30,17
1649898539079,COGS 118B,A01,083367,Staff,0,7,40,40
1649898545113,COGS 172,A01,083984,Provenzano; Emily Kara,17,0,30,13
1649898551136,COGS 177,A00,083368,Staff,1,14,30,29
1649898557158,COGS 186,A01,083986,Staff,23,0,40,17
1649898563182,COGS 187A,A01,083988,Boyle; Mary E. T.,24,0,60,36
1649898569205,CSE 8A,A50,084003,Miranda; Gregory Joseph,3,0,15,12
1649898575233,CSE 11,A01,084005,Miranda; Gregory Joseph,31,0,55,24
1649898581261,CSE 20,A01,084007,Staff,11,0,20,9
1649898587285,CSE 21,A01,084009,Staff,17,0,50,33
1649898593309,CSE 30,A01,083370,Cao; Yingjun,0,7,40,40
1649898599349,CSE 100,A01,083372,Cao; Yingjun,0,14,40,40
1649898605376,CSE 101,A01,084011,Staff,1,45,40,39
1649898611404,CSE 141,A01,083374,Eldon; John,1,47,75,74
1649898617427,CSE 141L,A01,083376,Eldon; John,1,51,75,74
1649898623463,CSE 175,A01,084013,Kumar; Rakesh,22,0,25,3
1649898629495,CSE 190,A00,092508,Dubnov; Shlomo,15,0,15,0
1649898635520,ECE 5,A01,084049,Morris; Karcher William,16,0,20,4
1649898641543,ECE 100,A01,084051,Baghdadchi; Saharnaz,4,0,20,16
1649898641543,ECE 100,A02,091916,Baghdadchi; Saharnaz,18,0,20,2
1649898647571,ECE 101,A01,084053,Baghdadchi; Saharnaz,9,0,37,28
1649898647571,ECE 101,A02,084054,Baghdadchi; Saharnaz,37,0,37,0
1649898653617,ECE 107,A01,083390,Staff,29,0,40,11
1649898659645,ECE 148,A01,084056,Silberman; Jack,7,0,12,5
1649898665672,ECE 180,A00,083391,Abi Samra; Nicholas Camill,25,0,30,5
1649898665672,ECE 180,B00,083392,Abi Samra; Nicholas Camill,22,0,30,8
1649898671725,MATH 10B,A01,084110,Staff,10,0,30,20
1649898671725,MATH 10B,A02,084111,Staff,29,0,30,1
1649898671725,MATH 10B,A03,084112,Staff,28,0,30,2
1649898677750,MATH 10C,A01,083443,Staff,11,0,30,19
1649898677750,MATH 10C,A02,083444,Staff,17,0,30,13
1649898677750,MATH 10C,B01,084114,Staff,26,0,30,4
1649898677750,MATH 10C,B02,084115,Staff,30,0,30,0
1649898683779,MATH 18,A01,084117,Harel; Guershon,27,0,30,3
1649898683779,MATH 18,A02,084119,Harel; Guershon,29,0,30,1
1649898683779,MATH 18,A03,084120,Harel; Guershon,30,0,30,0
1649898683779,MATH 18,A04,084121,Harel; Guershon,29,0,30,1
1649898689808,MATH 20B,A01,084124,Um; Ko Woon,31,0,35,4
1649898689808,MATH 20B,B01,084126,Um; Ko Woon,33,0,35,2
1649898695840,MATH 20C,A01,083446,Hammock; Frances H,19,0,30,11
1649898695840,MATH 20C,A02,083447,Hammock; Frances H,28,0,30,2
1649898695840,MATH 20C,A03,083448,Hammock; Frances H,30,0,30,0
1649898695840,MATH 20C,A04,083449,Hammock; Frances H,30,0,30,0
1649898695840,MATH 20C,B01,083451,Hammock; Frances H,26,0,30,4
1649898695840,MATH 20C,B02,083452,Hammock; Frances H,29,0,30,1
1649898695840,MATH 20C,B03,083453,Hammock; Frances H,29,0,30,1
1649898695840,MATH 20C,B04,083454,Hammock; Frances H,30,0,30,0
1649898701868,MATH 20D,A01,084128,Staff,29,0,30,1
1649898701868,MATH 20D,A02,084129,Staff,30,0,30,0
1649898701868,MATH 20D,A03,084130,Staff,29,0,30,1
1649898701868,MATH 20D,B01,084133,Staff,25,0,30,5
1649898701868,MATH 20D,B02,084134,Staff,28,0,30,2
1649898701868,MATH 20D,B03,084135,Staff,30,0,30,0
1649898707892,MATH 20E,A01,084138,Staff,25,0,30,5
1649898707892,MATH 20E,A02,084139,Staff,24,0,30,6
1649898707892,MATH 20E,A03,084140,Staff,24,0,30,6
1649898707892,MATH 20E,A04,084141,Staff,27,0,30,3
1649898713916,MATH 102,A01,084143,Harel; Guershon,21,0,30,9
1649898713916,MATH 102,A02,084144,Harel; Guershon,22,0,30,8
1649898719952,MATH 103B,A01,083456,Staff,0,6,30,30
1649898719952,MATH 103B,A02,083457,Staff,0,6,30,30
1649898725984,MATH 109,A01,084146,Salehi Golsefidy; Alireza,29,0,30,1
1649898725984,MATH 109,A02,084147,Salehi Golsefidy; Alireza,23,0,30,7
1649898732014,MATH 120A,A01,085445,Eggers; John Dietrich,20,0,35,15
1649898732014,MATH 120A,A02,085446,Eggers; John Dietrich,28,0,35,7
1649898738037,MATH 142B,A01,084149,Verstraete; Jacques Allan,0,4,30,30
1649898738037,MATH 142B,A02,084150,Verstraete; Jacques Allan,0,5,30,30
1649898744061,MATH 170A,A01,083459,Nie; Jiawang,0,1,30,30
1649898744061,MATH 170A,A02,083460,Nie; Jiawang,9,0,30,21
1649898744061,MATH 170A,A03,083461,Nie; Jiawang,21,0,30,9
1649898750097,MATH 193B,A01,083463,Staff,6,0,30,24
1649898750097,MATH 193B,A02,083464,Staff,12,0,30,18
1649898750097,MATH 193B,A03,083465,Staff,22,0,30,8
1649898762268,COGS 9,A01,083968,Staff,45,0,60,15
1649898768292,COGS 14B,A01,083970,Staff,35,0,50,15
1649898774316,COGS 17,A01,092679,Staff,68,0,75,7
1649898780343,COGS 100,A01,083972,Staff,26,0,60,34
1649898792402,COGS 101C,A01,083976,Staff,21,0,30,9
1649898798427,COGS 102A,A01,083978,Johnson; Christine M.,19,0,30,11
1649898804450,COGS 107B,A01,083980,Staff,11,0,50,39
1649898810477,COGS 115,A01,083982,Staff,13,0,30,17
1649898816504,COGS 118B,A01,083367,Staff,0,7,40,40
1649898822527,COGS 172,A01,083984,Provenzano; Emily Kara,17,0,30,13
1649898828557,COGS 177,A00,083368,Staff,1,14,30,29
1649898834583,COGS 186,A01,083986,Staff,23,0,40,17
1649898840608,COGS 187A,A01,083988,Boyle; Mary E. T.,24,0,60,36
1649898846631,CSE 8A,A50,084003,Miranda; Gregory Joseph,3,0,15,12
1649898852654,CSE 11,A01,084005,Miranda; Gregory Joseph,31,0,55,24
1649898858680,CSE 20,A01,084007,Staff,11,0,20,9
1649898864708,CSE 21,A01,084009,Staff,17,0,50,33
1649898870730,CSE 30,A01,083370,Cao; Yingjun,0,8,40,40
1649898876753,CSE 100,A01,083372,Cao; Yingjun,0,14,40,40
1649898882779,CSE 101,A01,084011,Staff,1,45,40,39
1649898888803,CSE 141,A01,083374,Eldon; John,1,47,75,74
1649898894830,CSE 141L,A01,083376,Eldon; John,1,51,75,74
1649898900854,CSE 175,A01,084013,Kumar; Rakesh,22,0,25,3
1649898906890,CSE 190,A00,092508,Dubnov; Shlomo,15,0,15,0
1649898912919,ECE 5,A01,084049,Morris; Karcher William,16,0,20,4
1649898918947,ECE 100,A01,084051,Baghdadchi; Saharnaz,4,0,20,16
1649898918947,ECE 100,A02,091916,Baghdadchi; Saharnaz,18,0,20,2
1649898924970,ECE 101,A01,084053,Baghdadchi; Saharnaz,9,0,37,28
1649898924970,ECE 101,A02,084054,Baghdadchi; Saharnaz,37,0,37,0
1649898930997,ECE 107,A01,083390,Staff,29,0,40,11
1649898937020,ECE 148,A01,084056,Silberman; Jack,7,0,12,5
1649898943043,ECE 180,A00,083391,Abi Samra; Nicholas Camill,25,0,30,5
1649898943043,ECE 180,B00,083392,Abi Samra; Nicholas Camill,22,0,30,8
1649898949070,MATH 10B,A01,084110,Staff,10,0,30,20
1649898949070,MATH 10B,A02,084111,Staff,29,0,30,1
1649898949070,MATH 10B,A03,084112,Staff,28,0,30,2
1649898955100,MATH 10C,A01,083443,Staff,11,0,30,19
1649898955100,MATH 10C,A02,083444,Staff,17,0,30,13
1649898955100,MATH 10C,B01,084114,Staff,26,0,30,4
1649898955100,MATH 10C,B02,084115,Staff,30,0,30,0
1649898961124,MATH 18,A01,084117,Harel; Guershon,27,0,30,3
1649898961124,MATH 18,A02,084119,Harel; Guershon,29,0,30,1
1649898961124,MATH 18,A03,084120,Harel; Guershon,30,0,30,0
1649898961124,MATH 18,A04,084121,Harel; Guershon,29,0,30,1
1649898967152,MATH 20B,A01,084124,Um; Ko Woon,31,0,35,4
1649898967152,MATH 20B,B01,084126,Um; Ko Woon,33,0,35,2
1649898973179,MATH 20C,A01,083446,Hammock; Frances H,19,0,30,11
1649898973179,MATH 20C,A02,083447,Hammock; Frances H,28,0,30,2
1649898973179,MATH 20C,A03,083448,Hammock; Frances H,30,0,30,0
1649898973179,MATH 20C,A04,083449,Hammock; Frances H,30,0,30,0
1649898973179,MATH 20C,B01,083451,Hammock; Frances H,26,0,30,4
1649898973179,MATH 20C,B02,083452,Hammock; Frances H,29,0,30,1
1649898973179,MATH 20C,B03,083453,Hammock; Frances H,29,0,30,1
1649898973179,MATH 20C,B04,083454,Hammock; Frances H,30,0,30,0
1649898979209,MATH 20D,A01,084128,Staff,29,0,30,1
1649898979209,MATH 20D,A02,084129,Staff,30,0,30,0
1649898979209,MATH 20D,A03,084130,Staff,29,0,30,1
1649898979209,MATH 20D,B01,084133,Staff,25,0,30,5
1649898979209,MATH 20D,B02,084134,Staff,28,0,30,2
1649898979209,MATH 20D,B03,084135,Staff,30,0,30,0
1649898985234,MATH 20E,A01,084138,Staff,25,0,30,5
1649898985234,MATH 20E,A02,084139,Staff,24,0,30,6
1649898985234,MATH 20E,A03,084140,Staff,25,0,30,5
1649898985234,MATH 20E,A04,084141,Staff,27,0,30,3
1649898991262,MATH 102,A01,084143,Harel; Guershon,21,0,30,9
1649898991262,MATH 102,A02,084144,Harel; Guershon,22,0,30,8
1649898997287,MATH 103B,A01,083456,Staff,0,6,30,30
1649898997287,MATH 103B,A02,083457,Staff,0,6,30,30
1649899003315,MATH 109,A01,084146,Salehi Golsefidy; Alireza,29,0,30,1
1649899003315,MATH 109,A02,084147,Salehi Golsefidy; Alireza,23,0,30,7
1649899009338,MATH 120A,A01,085445,Eggers; John Dietrich,20,0,35,15
1649899009338,MATH 120A,A02,085446,Eggers; John Dietrich,28,0,35,7
1649899015365,MATH 142B,A01,084149,Verstraete; Jacques Allan,0,4,30,30
1649899015365,MATH 142B,A02,084150,Verstraete; Jacques Allan,0,5,30,30
1649899021394,MATH 170A,A01,083459,Nie; Jiawang,0,1,30,30
1649899021394,MATH 170A,A02,083460,Nie; Jiawang,9,0,30,21
1649899021394,MATH 170A,A03,083461,Nie; Jiawang,21,0,30,9
1649899027417,MATH 193B,A01,083463,Staff,6,0,30,24
1649899027417,MATH 193B,A02,083464,Staff,12,0,30,18
1649899027417,MATH 193B,A03,083465,Staff,22,0,30,8
1649899033469,COGS 2,A01,083966,Boyle; Mary E. T.,21,0,30,9
1649899039493,COGS 9,A01,083968,Staff,45,0,60,15
1649899045516,COGS 14B,A01,083970,Staff,35,0,50,15
1649899051544,COGS 17,A01,092679,Staff,68,0,75,7
1649899057565,COGS 100,A01,083972,Staff,26,0,60,34
1649899069616,COGS 101C,A01,083976,Staff,21,0,30,9
1649899075643,COGS 102A,A01,083978,Johnson; Christine M.,19,0,30,11
1649899081669,COGS 107B,A01,083980,Staff,11,0,50,39
1649899087691,COGS 115,A01,083982,Staff,13,0,30,17
1649899093715,COGS 118B,A01,083367,Staff,0,8,40,40
1649899099744,COGS 172,A01,083984,Provenzano; Emily Kara,17,0,30,13
1649899105770,COGS 177,A00,083368,Staff,1,15,30,29
1649899111804,COGS 186,A01,083986,Staff,23,0,40,17
1649899117826,COGS 187A,A01,083988,Boyle; Mary E. T.,24,0,60,36
1649899123853,CSE 8A,A50,084003,Miranda; Gregory Joseph,3,0,15,12
1649899129885,CSE 11,A01,084005,Miranda; Gregory Joseph,31,0,55,24
1649899135912,CSE 20,A01,084007,Staff,11,0,20,9
1649899141938,CSE 21,A01,084009,Staff,17,0,50,33
1649899147967,CSE 30,A01,083370,Cao; Yingjun,0,8,40,40
1649899153989,CSE 100,A01,083372,Cao; Yingjun,0,14,40,40
1649899160015,CSE 101,A01,084011,Staff,1,45,40,39
1649899166040,CSE 141,A01,083374,Eldon; John,1,47,75,74
1649899172064,CSE 141L,A01,083376,Eldon; John,1,51,75,74
1649899178087,CSE 175,A01,084013,Kumar; Rakesh,22,0,25,3
1649899184116,CSE 190,A00,092508,Dubnov; Shlomo,15,0,15,0
1649899190142,ECE 5,A01,084049,Morris; Karcher William,16,0,20,4
1649899196166,ECE 100,A01,084051,Baghdadchi; Saharnaz,4,0,20,16
1649899196166,ECE 100,A02,091916,Baghdadchi; Saharnaz,18,0,20,2
1649899202189,ECE 101,A01,084053,Baghdadchi; Saharnaz,9,0,37,28
1649899202189,ECE 101,A02,084054,Baghdadchi; Saharnaz,37,0,37,0
1649899208221,ECE 107,A01,083390,Staff,29,0,40,11
1649899214249,ECE 148,A01,084056,Silberman; Jack,7,0,12,5
1649899220272,ECE 180,A00,083391,Abi Samra; Nicholas Camill,25,0,30,5
1649899220272,ECE 180,B00,083392,Abi Samra; Nicholas Camill,22,0,30,8
1649899226299,MATH 10B,A01,084110,Staff,10,0,30,20
1649899226299,MATH 10B,A02,084111,Staff,29,0,30,1
1649899226299,MATH 10B,A03,084112,Staff,28,0,30,2
1649899232329,MATH 10C,A01,083443,Staff,11,0,30,19
1649899232329,MATH 10C,A02,083444,Staff,17,0,30,13
1649899232329,MATH 10C,B01,084114,Staff,26,0,30,4
1649899232329,MATH 10C,B02,084115,Staff,30,0,30,0
1649899238357,MATH 18,A01,084117,Harel; Guershon,27,0,30,3
1649899238357,MATH 18,A02,084119,Harel; Guershon,29,0,30,1
1649899238357,MATH 18,A03,084120,Harel; Guershon,30,0,30,0
1649899238357,MATH 18,A04,084121,Harel; Guershon,29,0,30,1
1649899244380,MATH 20B,A01,084124,Um; Ko Woon,31,0,35,4
1649899244380,MATH 20B,B01,084126,Um; Ko Woon,33,0,35,2
1649899250403,MATH 20C,A01,083446,Hammock; Frances H,19,0,30,11
1649899250403,MATH 20C,A02,083447,Hammock; Frances H,28,0,30,2
1649899250403,MATH 20C,A03,083448,Hammock; Frances H,30,0,30,0
1649899250403,MATH 20C,A04,083449,Hammock; Frances H,30,0,30,0
1649899250403,MATH 20C,B01,083451,Hammock; Frances H,26,0,30,4
1649899250403,MATH 20C,B02,083452,Hammock; Frances H,29,0,30,1
1649899250403,MATH 20C,B03,083453,Hammock; Frances H,29,0,30,1
1649899250403,MATH 20C,B04,083454,Hammock; Frances H,30,0,30,0
1649899256433,MATH 20D,A01,084128,Staff,29,0,30,1
1649899256433,MATH 20D,A02,084129,Staff,30,0,30,0
1649899256433,MATH 20D,A03,084130,Staff,29,0,30,1
1649899256433,MATH 20D,B01,084133,Staff,25,0,30,5
1649899256433,MATH 20D,B02,084134,Staff,28,0,30,2
1649899256433,MATH 20D,B03,084135,Staff,30,0,30,0
1649899262458,MATH 20E,A01,084138,Staff,25,0,30,5
1649899262458,MATH 20E,A02,084139,Staff,24,0,30,6
1649899262458,MATH 20E,A03,084140,Staff,25,0,30,5
1649899262458,MATH 20E,A04,084141,Staff,27,0,30,3
1649899268482,MATH 102,A01,084143,Harel; Guershon,21,0,30,9
1649899268482,MATH 102,A02,084144,Harel; Guershon,22,0,30,8
1649899274505,MATH 103B,A01,083456,Staff,0,6,30,30
1649899274505,MATH 103B,A02,083457,Staff,0,6,30,30
1649899280528,MATH 109,A01,084146,Salehi Golsefidy; Alireza,29,0,30,1
1649899280528,MATH 109,A02,084147,Salehi Golsefidy; Alireza,23,0,30,7
1649899286551,MATH 120A,A01,085445,Eggers; John Dietrich,20,0,35,15
1649899286551,MATH 120A,A02,085446,Eggers; John Dietrich,28,0,35,7
1649899292580,MATH 142B,A01,084149,Verstraete; Jacques Allan,0,5,30,30
1649899292580,MATH 142B,A02,084150,Verstraete; Jacques Allan,0,5,30,30
1649899298608,MATH 170A,A01,083459,Nie; Jiawang,0,1,30,30
1649899298608,MATH 170A,A02,083460,Nie; Jiawang,9,0,30,21
1649899298608,MATH 170A,A03,083461,Nie; Jiawang,21,0,30,9
1649899304635,MATH 193B,A01,083463,Staff,6,0,30,24
1649899304635,MATH 193B,A02,083464,Staff,12,0,30,18
1649899304635,MATH 193B,A03,083465,Staff,22,0,30,8
1649899310683,COGS 2,A01,083966,Boyle; Mary E. T.,21,0,30,9
1649899316710,COGS 9,A01,083968,Staff,45,0,60,15
1649899322735,COGS 14B,A01,083970,Staff,35,0,50,15
1649899328759,COGS 17,A01,092679,Staff,68,0,75,7
1649899334785,COGS 100,A01,083972,Staff,26,0,60,34
1649899346835,COGS 101C,A01,083976,Staff,21,0,30,9
1649899352864,COGS 102A,A01,083978,Johnson; Christine M.,18,0,30,12
1649899358988,COGS 107B,A01,083980,Staff,10,0,50,40
1649899365011,COGS 115,A01,083982,Staff,13,0,30,17
1649899371043,COGS 118B,A01,083367,Staff,0,8,40,40
1649899377070,COGS 172,A01,083984,Provenzano; Emily Kara,17,0,30,13
1649899383097,COGS 177,A00,083368,Staff,1,15,30,29
1649899389120,COGS 186,A01,083986,Staff,23,0,40,17
1649899395147,COGS 187A,A01,083988,Boyle; Mary E. T.,24,0,60,36
1649899401188,CSE 8A,A50,084003,Miranda; Gregory Joseph,3,0,15,12
1649899407210,CSE 11,A01,084005,Miranda; Gregory Joseph,31,0,55,24
1649899413232,CSE 20,A01,084007,Staff,10,0,20,10
1649899419254,CSE 21,A01,084009,Staff,17,0,50,33
1649899425293,CSE 30,A01,083370,Cao; Yingjun,0,8,40,40
1649899431316,CSE 100,A01,083372,Cao; Yingjun,0,14,40,40
1649899437338,CSE 101,A01,084011,Staff,1,45,40,39
1649899443361,CSE 141,A01,083374,Eldon; John,1,47,75,74
1649899449395,CSE 141L,A01,083376,Eldon; John,1,51,75,74
1649899455418,CSE 175,A01,084013,Kumar; Rakesh,22,0,25,3
1649899461445,CSE 190,A00,092508,Dubnov; Shlomo,15,0,15,0
1649899467468,ECE 5,A01,084049,Morris; Karcher William,16,0,20,4
1649899473493,ECE 100,A01,084051,Baghdadchi; Saharnaz,4,0,20,16
1649899473493,ECE 100,A02,091916,Baghdadchi; Saharnaz,18,0,20,2
1649899479516,ECE 101,A01,084053,Baghdadchi; Saharnaz,9,0,37,28
1649899479516,ECE 101,A02,084054,Baghdadchi; Saharnaz,37,0,37,0
1649899485544,ECE 107,A01,083390,Staff,29,0,40,11
1649899491569,ECE 148,A01,084056,Silberman; Jack,7,0,12,5
1649899497597,ECE 180,A00,083391,Abi Samra; Nicholas Camill,25,0,30,5
1649899497597,ECE 180,B00,083392,Abi Samra; Nicholas Camill,22,0,30,8
1649899503628,MATH 10B,A01,084110,Staff,10,0,30,20
1649899503628,MATH 10B,A02,084111,Staff,29,0,30,1
1649899503628,MATH 10B,A03,084112,Staff,28,0,30,2
1649899509657,MATH 10C,A01,083443,Staff,11,0,30,19
1649899509657,MATH 10C,A02,083444,Staff,17,0,30,13
1649899509657,MATH 10C,B01,084114,Staff,25,0,30,5
1649899509657,MATH 10C,B02,084115,Staff,30,0,30,0
1649899515684,MATH 18,A01,084117,Harel; Guershon,27,0,30,3
1649899515684,MATH 18,A02,084119,Harel; Guershon,29,0,30,1
1649899515684,MATH 18,A03,084120,Harel; Guershon,30,0,30,0
1649899515684,MATH 18,A04,084121,Harel; Guershon,29,0,30,1
1649899521710,MATH 20B,A01,084124,Um; Ko Woon,31,0,35,4
1649899521710,MATH 20B,B01,084126,Um; Ko Woon,33,0,35,2
1649899527741,MATH 20C,A01,083446,Hammock; Frances H,19,0,30,11
1649899527741,MATH 20C,A02,083447,Hammock; Frances H,28,0,30,2
1649899527741,MATH 20C,A03,083448,Hammock; Frances H,30,0,30,0
1649899527741,MATH 20C,A04,083449,Hammock; Frances H,30,0,30,0
1649899527741,MATH 20C,B01,083451,Hammock; Frances H,26,0,30,4
1649899527741,MATH 20C,B02,083452,Hammock; Frances H,29,0,30,1
1649899527741,MATH 20C,B03,083453,Hammock; Frances H,28,0,30,2
1649899527741,MATH 20C,B04,083454,Hammock; Frances H,30,0,30,0
1649899533769,MATH 20D,A01,084128,Staff,29,0,30,1
1649899533769,MATH 20D,A02,084129,Staff,30,0,30,0
1649899533769,MATH 20D,A03,084130,Staff,29,0,30,1
1649899533769,MATH 20D,B01,084133,Staff,25,0,30,5
1649899533769,MATH 20D,B02,084134,Staff,28,0,30,2
1649899533769,MATH 20D,B03,084135,Staff,30,0,30,0
1649899539796,MATH 20E,A01,084138,Staff,25,0,30,5
1649899539796,MATH 20E,A02,084139,Staff,24,0,30,6
1649899539796,MATH 20E,A03,084140,Staff,25,0,30,5
1649899539796,MATH 20E,A04,084141,Staff,27,0,30,3
1649899545824,MATH 102,A01,084143,Harel; Guershon,21,0,30,9
1649899545824,MATH 102,A02,084144,Harel; Guershon,22,0,30,8
1649899551848,MATH 103B,A01,083456,Staff,0,6,30,30
1649899551848,MATH 103B,A02,083457,Staff,0,6,30,30
1649899565485,MATH 109,A01,084146,Salehi Golsefidy; Alireza,29,0,30,1
1649899565485,MATH 109,A02,084147,Salehi Golsefidy; Alireza,23,0,30,7
1649899571507,MATH 120A,A01,085445,Eggers; John Dietrich,20,0,35,15
1649899571507,MATH 120A,A02,085446,Eggers; John Dietrich,28,0,35,7
1649899577536,MATH 142B,A01,084149,Verstraete; Jacques Allan,0,5,30,30
1649899577536,MATH 142B,A02,084150,Verstraete; Jacques Allan,0,5,30,30
1649899583564,MATH 170A,A01,083459,Nie; Jiawang,0,1,30,30
1649899583564,MATH 170A,A02,083460,Nie; Jiawang,7,0,30,23
1649899583564,MATH 170A,A03,083461,Nie; Jiawang,21,0,30,9
1649899589596,MATH 193B,A01,083463,Staff,6,0,30,24
1649899589596,MATH 193B,A02,083464,Staff,12,0,30,18
1649899589596,MATH 193B,A03,083465,Staff,22,0,30,8
1649899595647,COGS 2,A01,083966,Boyle; Mary E. T.,21,0,30,9
1649899601676,COGS 9,A01,083968,Staff,45,0,60,15
1649899607702,COGS 14B,A01,083970,Staff,35,0,50,15
1649899613729,COGS 17,A01,092679,Staff,68,0,75,7
1649899619764,COGS 100,A01,083972,Staff,26,0,60,34
1649899631813,COGS 101C,A01,083976,Staff,21,0,30,9
1649899637837,COGS 102A,A01,083978,Johnson; Christine M.,18,0,30,12
1649899643862,COGS 107B,A01,083980,Staff,10,0,50,40
1649899649885,COGS 115,A01,083982,Staff,13,0,30,17
1649899655912,COGS 118B,A01,083367,Staff,0,8,40,40
1649899661935,COGS 172,A01,083984,Provenzano; Emily Kara,17,0,30,13
1649899667959,COGS 177,A00,083368,Staff,1,15,30,29
1649899673981,COGS 186,A01,083986,Staff,23,0,40,17
1649899680006,COGS 187A,A01,083988,Boyle; Mary E. T.,24,0,60,36
1649899686034,CSE 8A,A50,084003,Miranda; Gregory Joseph,3,0,15,12
1649899692062,CSE 11,A01,084005,Miranda; Gregory Joseph,31,0,55,24
1649899698084,CSE 20,A01,084007,Staff,10,0,20,10
1649899704107,CSE 21,A01,084009,Staff,16,0,50,34
1649899710222,CSE 30,A01,083370,Cao; Yingjun,0,8,40,40
1649899716245,CSE 100,A01,083372,Cao; Yingjun,0,14,40,40
1649899722274,CSE 101,A01,084011,Staff,1,45,40,39
1649899728295,CSE 141,A01,083374,Eldon; John,1,47,75,74
1649899734327,CSE 141L,A01,083376,Eldon; John,1,51,75,74
1649899740350,CSE 175,A01,084013,Kumar; Rakesh,22,0,25,3
1649899746374,CSE 190,A00,092508,Dubnov; Shlomo,15,0,15,0
1649899752398,ECE 5,A01,084049,Morris; Karcher William,16,0,20,4
1649899758421,ECE 100,A01,084051,Baghdadchi; Saharnaz,4,0,20,16
1649899758421,ECE 100,A02,091916,Baghdadchi; Saharnaz,18,0,20,2
1649899764450,ECE 101,A01,084053,Baghdadchi; Saharnaz,9,0,37,28
1649899764450,ECE 101,A02,084054,Baghdadchi; Saharnaz,37,0,37,0
1649899770472,ECE 107,A01,083390,Staff,29,0,40,11
1649899776498,ECE 148,A01,084056,Silberman; Jack,7,0,12,5
1649899782530,ECE 180,A00,083391,Abi Samra; Nicholas Camill,25,0,30,5
1649899782530,ECE 180,B00,083392,Abi Samra; Nicholas Camill,22,0,30,8
1649899788558,MATH 10B,A01,084110,Staff,10,0,30,20
1649899788558,MATH 10B,A02,084111,Staff,29,0,30,1
1649899788558,MATH 10B,A03,084112,Staff,28,0,30,2
1649899794586,MATH 10C,A01,083443,Staff,11,0,30,19
1649899794586,MATH 10C,A02,083444,Staff,17,0,30,13
1649899794586,MATH 10C,B01,084114,Staff,25,0,30,5
1649899794586,MATH 10C,B02,084115,Staff,30,0,30,0
1649899800622,MATH 18,A01,084117,Harel; Guershon,27,0,30,3
1649899800622,MATH 18,A02,084119,Harel; Guershon,29,0,30,1
1649899800622,MATH 18,A03,084120,Harel; Guershon,30,0,30,0
1649899800622,MATH 18,A04,084121,Harel; Guershon,29,0,30,1
1649899806652,MATH 20B,A01,084124,Um; Ko Woon,31,0,35,4
1649899806652,MATH 20B,B01,084126,Um; Ko Woon,33,0,35,2
1649899812678,MATH 20C,A01,083446,Hammock; Frances H,19,0,30,11
1649899812678,MATH 20C,A02,083447,Hammock; Frances H,28,0,30,2
1649899812678,MATH 20C,A03,083448,Hammock; Frances H,30,0,30,0
1649899812678,MATH 20C,A04,083449,Hammock; Frances H,30,0,30,0
1649899812678,MATH 20C,B01,083451,Hammock; Frances H,26,0,30,4
1649899812678,MATH 20C,B02,083452,Hammock; Frances H,29,0,30,1
1649899812678,MATH 20C,B03,083453,Hammock; Frances H,28,0,30,2
1649899812678,MATH 20C,B04,083454,Hammock; Frances H,30,0,30,0
1649899818702,MATH 20D,A01,084128,Staff,29,0,30,1
1649899818702,MATH 20D,A02,084129,Staff,30,0,30,0
1649899818702,MATH 20D,A03,084130,Staff,29,0,30,1
1649899818702,MATH 20D,B01,084133,Staff,25,0,30,5
1649899818702,MATH 20D,B02,084134,Staff,28,0,30,2
1649899818702,MATH 20D,B03,084135,Staff,30,0,30,0
1649899824724,MATH 20E,A01,084138,Staff,25,0,30,5
1649899824724,MATH 20E,A02,084139,Staff,24,0,30,6
1649899824724,MATH 20E,A03,084140,Staff,25,0,30,5
1649899824724,MATH 20E,A04,084141,Staff,27,0,30,3
1649899830747,MATH 102,A01,084143,Harel; Guershon,21,0,30,9
1649899830747,MATH 102,A02,084144,Harel; Guershon,22,0,30,8
1649899836774,MATH 103B,A01,083456,Staff,0,6,30,30
1649899836774,MATH 103B,A02,083457,Staff,0,6,30,30
1649899842802,MATH 109,A01,084146,Salehi Golsefidy; Alireza,29,0,30,1
1649899842802,MATH 109,A02,084147,Salehi Golsefidy; Alireza,23,0,30,7
1649899848829,MATH 120A,A01,085445,Eggers; John Dietrich,20,0,35,15
1649899848829,MATH 120A,A02,085446,Eggers; John Dietrich,28,0,35,7
1649899854853,MATH 142B,A01,084149,Verstraete; Jacques Allan,0,5,30,30
1649899854853,MATH 142B,A02,084150,Verstraete; Jacques Allan,0,5,30,30
1649899860891,MATH 170A,A01,083459,Nie; Jiawang,0,1,30,30
1649899860891,MATH 170A,A02,083460,Nie; Jiawang,7,0,30,23
1649899860891,MATH 170A,A03,083461,Nie; Jiawang,21,0,30,9
1649899866914,MATH 193B,A01,083463,Staff,6,0,30,24
1649899866914,MATH 193B,A02,083464,Staff,12,0,30,18
1649899866914,MATH 193B,A03,083465,Staff,22,0,30,8
1649899872981,COGS 2,A01,083966,Boyle; Mary E. T.,20,0,30,10
1649899879007,COGS 9,A01,083968,Staff,45,0,60,15
1649899885036,COGS 14B,A01,083970,Staff,35,0,50,15
1649899891060,COGS 17,A01,092679,Staff,68,0,75,7
1649899897082,COGS 100,A01,083972,Staff,26,0,60,34
1649899909134,COGS 101C,A01,083976,Staff,21,0,30,9
1649899915173,COGS 102A,A01,083978,Johnson; Christine M.,18,0,30,12
1649899921196,COGS 107B,A01,083980,Staff,10,0,50,40
1649899927222,COGS 115,A01,083982,Staff,13,0,30,17
1649899933246,COGS 118B,A01,083367,Staff,0,8,40,40
1649899939271,COGS 172,A01,083984,Provenzano; Emily Kara,17,0,30,13
1649899945294,COGS 177,A00,083368,Staff,1,15,30,29
1649899951317,COGS 186,A01,083986,Staff,23,0,40,17
1649899957340,COGS 187A,A01,083988,Boyle; Mary E. T.,24,0,60,36
1649899963452,CSE 8A,A50,084003,Miranda; Gregory Joseph,3,0,15,12
1649899969480,CSE 11,A01,084005,Miranda; Gregory Joseph,30,0,55,25
1649899975504,CSE 20,A01,084007,Staff,10,0,20,10
1649899981528,CSE 21,A01,084009,Staff,16,0,50,34
1649899987550,CSE 30,A01,083370,Cao; Yingjun,0,9,40,40
1649899993579,CSE 100,A01,083372,Cao; Yingjun,0,14,40,40
1649899999603,CSE 101,A01,084011,Staff,1,45,40,39
1649900005625,CSE 141,A01,083374,Eldon; John,1,47,75,74
1649900011651,CSE 141L,A01,083376,Eldon; John,1,51,75,74
1649900017673,CSE 175,A01,084013,Kumar; Rakesh,22,0,25,3
1649900023696,CSE 190,A00,092508,Dubnov; Shlomo,15,0,15,0
1649900029722,ECE 5,A01,084049,Morris; Karcher William,16,0,20,4
1649900035746,ECE 100,A01,084051,Baghdadchi; Saharnaz,4,0,20,16
1649900035746,ECE 100,A02,091916,Baghdadchi; Saharnaz,18,0,20,2
1649900041772,ECE 101,A01,084053,Baghdadchi; Saharnaz,9,0,37,28
1649900041772,ECE 101,A02,084054,Baghdadchi; Saharnaz,37,0,37,0
1649900047795,ECE 107,A01,083390,Staff,29,0,40,11
1649900053821,ECE 148,A01,084056,Silberman; Jack,7,0,12,5
1649900059845,ECE 180,A00,083391,Abi Samra; Nicholas Camill,25,0,30,5
1649900059845,ECE 180,B00,083392,Abi Samra; Nicholas Camill,22,0,30,8
1649900065866,MATH 10B,A01,084110,Staff,10,0,30,20
1649900065866,MATH 10B,A02,084111,Staff,29,0,30,1
1649900065866,MATH 10B,A03,084112,Staff,28,0,30,2
1649900071895,MATH 10C,A01,083443,Staff,11,0,30,19
1649900071895,MATH 10C,A02,083444,Staff,17,0,30,13
1649900071895,MATH 10C,B01,084114,Staff,25,0,30,5
1649900071895,MATH 10C,B02,084115,Staff,30,0,30,0
1649900077917,MATH 18,A01,084117,Harel; Guershon,27,0,30,3
1649900077917,MATH 18,A02,084119,Harel; Guershon,29,0,30,1
1649900077917,MATH 18,A03,084120,Harel; Guershon,30,0,30,0
1649900077917,MATH 18,A04,084121,Harel; Guershon,29,0,30,1
1649900083943,MATH 20B,A01,084124,Um; Ko Woon,31,0,35,4
1649900083943,MATH 20B,B01,084126,Um; Ko Woon,33,0,35,2
1649900089971,MATH 20C,A01,083446,Hammock; Frances H,19,0,30,11
1649900089971,MATH 20C,A02,083447,Hammock; Frances H,28,0,30,2
1649900089971,MATH 20C,A03,083448,Hammock; Frances H,30,0,30,0
1649900089971,MATH 20C,A04,083449,Hammock; Frances H,30,0,30,0
1649900089971,MATH 20C,B01,083451,Hammock; Frances H,26,0,30,4
1649900089971,MATH 20C,B02,083452,Hammock; Frances H,29,0,30,1
1649900089971,MATH 20C,B03,083453,Hammock; Frances H,28,0,30,2
1649900089971,MATH 20C,B04,083454,Hammock; Frances H,30,0,30,0
1649900095995,MATH 20D,A01,084128,Staff,29,0,30,1
1649900095995,MATH 20D,A02,084129,Staff,30,0,30,0
1649900095995,MATH 20D,A03,084130,Staff,29,0,30,1
1649900095995,MATH 20D,B01,084133,Staff,25,0,30,5
1649900095995,MATH 20D,B02,084134,Staff,27,0,30,3
1649900095995,MATH 20D,B03,084135,Staff,30,0,30,0
1649900102021,MATH 20E,A01,084138,Staff,25,0,30,5
1649900102021,MATH 20E,A02,084139,Staff,24,0,30,6
1649900102021,MATH 20E,A03,084140,Staff,25,0,30,5
1649900102021,MATH 20E,A04,084141,Staff,27,0,30,3
1649900108045,MATH 102,A01,084143,Harel; Guershon,20,0,30,10
1649900108045,MATH 102,A02,084144,Harel; Guershon,22,0,30,8
1649900114068,MATH 103B,A01,083456,Staff,0,6,30,30
1649900114068,MATH 103B,A02,083457,Staff,0,6,30,30
1649900120094,MATH 109,A01,084146,Salehi Golsefidy; Alireza,29,0,30,1
1649900120094,MATH 109,A02,084147,Salehi Golsefidy; Alireza,23,0,30,7
1649900126128,MATH 120A,A01,085445,Eggers; John Dietrich,20,0,35,15
1649900126128,MATH 120A,A02,085446,Eggers; John Dietrich,28,0,35,7
1649900132189,MATH 142B,A01,084149,Verstraete; Jacques Allan,0,5,30,30
1649900132189,MATH 142B,A02,084150,Verstraete; Jacques Allan,0,5,30,30
1649900138212,MATH 170A,A01,083459,Nie; Jiawang,0,1,30,30
1649900138212,MATH 170A,A02,083460,Nie; Jiawang,6,0,30,24
1649900138212,MATH 170A,A03,083461,Nie; Jiawang,21,0,30,9
1649900144236,MATH 193B,A01,083463,Staff,6,0,30,24
1649900144236,MATH 193B,A02,083464,Staff,12,0,30,18
1649900144236,MATH 193B,A03,083465,Staff,22,0,30,8
1649900150302,COGS 2,A01,083966,Boyle; Mary E. T.,20,0,30,10
1649900156329,COGS 9,A01,083968,Staff,45,0,60,15
1649900162358,COGS 14B,A01,083970,Staff,35,0,50,15
1649900168381,COGS 17,A01,092679,Staff,68,0,75,7
1649900174409,COGS 100,A01,083972,Staff,26,0,60,34
1649900186454,COGS 101C,A01,083976,Staff,21,0,30,9
1649900192477,COGS 102A,A01,083978,Johnson; Christine M.,18,0,30,12
1649900198501,COGS 107B,A01,083980,Staff,10,0,50,40
1649900204527,COGS 115,A01,083982,Staff,13,0,30,17
1649900210552,COGS 118B,A01,083367,Staff,0,8,40,40
1649900216574,COGS 172,A01,083984,Provenzano; Emily Kara,17,0,30,13
1649900222601,COGS 177,A00,083368,Staff,1,15,30,29
1649900228628,COGS 186,A01,083986,Staff,23,0,40,17
1649900234652,COGS 187A,A01,083988,Boyle; Mary E. T.,24,0,60,36
1649900240676,CSE 8A,A50,084003,Miranda; Gregory Joseph,3,0,15,12
1649900246709,CSE 11,A01,084005,Miranda; Gregory Joseph,30,0,55,25
1649900252738,CSE 20,A01,084007,Staff,9,0,20,11
1649900258768,CSE 21,A01,084009,Staff,16,0,50,34
1649900264791,CSE 30,A01,083370,Cao; Yingjun,0,9,40,40
1649900270813,CSE 100,A01,083372,Cao; Yingjun,0,14,40,40
1649900276838,CSE 101,A01,084011,Staff,1,45,40,39
1649900282864,CSE 141,A01,083374,Eldon; John,1,47,75,74
1649900288888,CSE 141L,A01,083376,Eldon; John,1,51,75,74
1649900294911,CSE 175,A01,084013,Kumar; Rakesh,22,0,25,3
1649900300935,CSE 190,A00,092508,Dubnov; Shlomo,15,0,15,0
1649900306957,ECE 5,A01,084049,Morris; Karcher William,16,0,20,4
1649900312980,ECE 100,A01,084051,Baghdadchi; Saharnaz,4,0,20,16
1649900312980,ECE 100,A02,091916,Baghdadchi; Saharnaz,18,0,20,2
1649900319003,ECE 101,A01,084053,Baghdadchi; Saharnaz,9,0,37,28
1649900319003,ECE 101,A02,084054,Baghdadchi; Saharnaz,37,0,37,0
1649900325029,ECE 107,A01,083390,Staff,29,0,40,11
1649900331053,ECE 148,A01,084056,Silberman; Jack,7,0,12,5
1649900337075,ECE 180,A00,083391,Abi Samra; Nicholas Camill,25,0,30,5
1649900337075,ECE 180,B00,083392,Abi Samra; Nicholas Camill,22,0,30,8
1649900343103,MATH 10B,A01,084110,Staff,10,0,30,20
1649900343103,MATH 10B,A02,084111,Staff,29,0,30,1
1649900343103,MATH 10B,A03,084112,Staff,28,0,30,2
1649900349125,MATH 10C,A01,083443,Staff,10,0,30,20
1649900349125,MATH 10C,A02,083444,Staff,17,0,30,13
1649900349125,MATH 10C,B01,084114,Staff,25,0,30,5
1649900349125,MATH 10C,B02,084115,Staff,30,0,30,0
1649900355147,MATH 18,A01,084117,Harel; Guershon,27,0,30,3
1649900355147,MATH 18,A02,084119,Harel; Guershon,29,0,30,1
1649900355147,MATH 18,A03,084120,Harel; Guershon,30,0,30,0
1649900355147,MATH 18,A04,084121,Harel; Guershon,29,0,30,1
1649900361171,MATH 20B,A01,084124,Um; Ko Woon,31,0,35,4
1649900361171,MATH 20B,B01,084126,Um; Ko Woon,33,0,35,2
1649900367203,MATH 20C,A01,083446,Hammock; Frances H,19,0,30,11
1649900367203,MATH 20C,A02,083447,Hammock; Frances H,28,0,30,2
1649900367203,MATH 20C,A03,083448,Hammock; Frances H,30,0,30,0
1649900367203,MATH 20C,A04,083449,Hammock; Frances H,30,0,30,0
1649900367203,MATH 20C,B01,083451,Hammock; Frances H,26,0,30,4
1649900367203,MATH 20C,B02,083452,Hammock; Frances H,29,0,30,1
1649900367203,MATH 20C,B03,083453,Hammock; Frances H,28,0,30,2
1649900367203,MATH 20C,B04,083454,Hammock; Frances H,30,0,30,0
1649900373225,MATH 20D,A01,084128,Staff,29,0,30,1
1649900373225,MATH 20D,A02,084129,Staff,30,0,30,0
1649900373225,MATH 20D,A03,084130,Staff,29,0,30,1
1649900373225,MATH 20D,B01,084133,Staff,25,0,30,5
1649900373225,MATH 20D,B02,084134,Staff,27,0,30,3
1649900373225,MATH 20D,B03,084135,Staff,30,0,30,0
1649900379247,MATH 20E,A01,084138,Staff,25,0,30,5
1649900379247,MATH 20E,A02,084139,Staff,24,0,30,6
1649900379247,MATH 20E,A03,084140,Staff,25,0,30,5
1649900379247,MATH 20E,A04,084141,Staff,27,0,30,3
1649900385270,MATH 102,A01,084143,Harel; Guershon,20,0,30,10
1649900385270,MATH 102,A02,084144,Harel; Guershon,22,0,30,8
1649900391294,MATH 103B,A01,083456,Staff,0,6,30,30
1649900391294,MATH 103B,A02,083457,Staff,0,6,30,30
1649900397318,MATH 109,A01,084146,Salehi Golsefidy; Alireza,29,0,30,1
1649900397318,MATH 109,A02,084147,Salehi Golsefidy; Alireza,23,0,30,7
1649900403346,MATH 120A,A01,085445,Eggers; John Dietrich,20,0,35,15
1649900403346,MATH 120A,A02,085446,Eggers; John Dietrich,28,0,35,7
1649900409367,MATH 142B,A01,084149,Verstraete; Jacques Allan,0,5,30,30
1649900409367,MATH 142B,A02,084150,Verstraete; Jacques Allan,0,5,30,30
1649900415393,MATH 170A,A01,083459,Nie; Jiawang,0,1,30,30
1649900415393,MATH 170A,A02,083460,Nie; Jiawang,7,0,30,23
1649900415393,MATH 170A,A03,083461,Nie; Jiawang,21,0,30,9
1649900421416,MATH 193B,A01,083463,Staff,6,0,30,24
1649900421416,MATH 193B,A02,083464,Staff,12,0,30,18
1649900421416,MATH 193B,A03,083465,Staff,22,0,30,8
1649900427478,COGS 2,A01,083966,Boyle; Mary E. T.,20,0,30,10
1649900433501,COGS 9,A01,083968,Staff,44,0,60,16
1649900439525,COGS 14B,A01,083970,Staff,35,0,50,15
1649900445552,COGS 17,A01,092679,Staff,68,0,75,7
1649900451576,COGS 100,A01,083972,Staff,26,0,60,34
1649900463636,COGS 101C,A01,083976,Staff,21,0,30,9
1649900469666,COGS 102A,A01,083978,Johnson; Christine M.,18,0,30,12
1649900475693,COGS 107B,A01,083980,Staff,10,0,50,40
1649900481719,COGS 115,A01,083982,Staff,13,0,30,17
1649900487747,COGS 118B,A01,083367,Staff,0,8,40,40
1649900493778,COGS 172,A01,083984,Provenzano; Emily Kara,17,0,30,13
1649900499812,COGS 177,A00,083368,Staff,1,15,30,29
1649900505838,COGS 186,A01,083986,Staff,23,0,40,17
1649900511862,COGS 187A,A01,083988,Boyle; Mary E. T.,24,0,60,36
1649900517892,CSE 8A,A50,084003,Miranda; Gregory Joseph,3,0,15,12
1649900523926,CSE 11,A01,084005,Miranda; Gregory Joseph,29,0,55,26
1649900529950,CSE 20,A01,084007,Staff,9,0,20,11
1649900535973,CSE 21,A01,084009,Staff,16,0,50,34
1649900542000,CSE 30,A01,083370,Cao; Yingjun,0,9,40,40
1649900548023,CSE 100,A01,083372,Cao; Yingjun,0,14,40,40
1649900554046,CSE 101,A01,084011,Staff,1,45,40,39
1649900560161,CSE 141,A01,083374,Eldon; John,1,48,75,74
1649900566189,CSE 141L,A01,083376,Eldon; John,1,52,75,74
1649900572224,CSE 175,A01,084013,Kumar; Rakesh,22,0,25,3
1649900578249,CSE 190,A00,092508,Dubnov; Shlomo,15,0,15,0
1649900584272,ECE 5,A01,084049,Morris; Karcher William,16,0,20,4
1649900590300,ECE 100,A01,084051,Baghdadchi; Saharnaz,4,0,20,16
1649900590300,ECE 100,A02,091916,Baghdadchi; Saharnaz,18,0,20,2
1649900596325,ECE 101,A01,084053,Baghdadchi; Saharnaz,8,0,37,29
1649900596325,ECE 101,A02,084054,Baghdadchi; Saharnaz,37,0,37,0
1649900602358,ECE 107,A01,083390,Staff,29,0,40,11
1649900608380,ECE 148,A01,084056,Silberman; Jack,7,0,12,5
1649900614407,ECE 180,A00,083391,Abi Samra; Nicholas Camill,25,0,30,5
1649900614407,ECE 180,B00,083392,Abi Samra; Nicholas Camill,22,0,30,8
1649900620431,MATH 10B,A01,084110,Staff,10,0,30,20
1649900620431,MATH 10B,A02,084111,Staff,29,0,30,1
1649900620431,MATH 10B,A03,084112,Staff,28,0,30,2
1649900626464,MATH 10C,A01,083443,Staff,10,0,30,20
1649900626464,MATH 10C,A02,083444,Staff,17,0,30,13
1649900626464,MATH 10C,B01,084114,Staff,25,0,30,5
1649900626464,MATH 10C,B02,084115,Staff,30,0,30,0
1649900632493,MATH 18,A01,084117,Harel; Guershon,27,0,30,3
1649900632493,MATH 18,A02,084119,Harel; Guershon,29,0,30,1
1649900632493,MATH 18,A03,084120,Harel; Guershon,30,0,30,0
1649900632493,MATH 18,A04,084121,Harel; Guershon,29,0,30,1
1649900638516,MATH 20B,A01,084124,Um; Ko Woon,31,0,35,4
1649900638516,MATH 20B,B01,084126,Um; Ko Woon,33,0,35,2
1649900644540,MATH 20C,A01,083446,Hammock; Frances H,19,0,30,11
1649900644540,MATH 20C,A02,083447,Hammock; Frances H,28,0,30,2
1649900644540,MATH 20C,A03,083448,Hammock; Frances H,30,0,30,0
1649900644540,MATH 20C,A04,083449,Hammock; Frances H,30,0,30,0
1649900644540,MATH 20C,B01,083451,Hammock; Frances H,26,0,30,4
1649900644540,MATH 20C,B02,083452,Hammock; Frances H,29,0,30,1
1649900644540,MATH 20C,B03,083453,Hammock; Frances H,28,0,30,2
1649900644540,MATH 20C,B04,083454,Hammock; Frances H,30,0,30,0
1649900650563,MATH 20D,A01,084128,Staff,29,0,30,1
1649900650563,MATH 20D,A02,084129,Staff,30,0,30,0
1649900650563,MATH 20D,A03,084130,Staff,29,0,30,1
1649900650563,MATH 20D,B01,084133,Staff,25,0,30,5
1649900650563,MATH 20D,B02,084134,Staff,27,0,30,3
1649900650563,MATH 20D,B03,084135,Staff,30,0,30,0
1649900656586,MATH 20E,A01,084138,Staff,25,0,30,5
1649900656586,MATH 20E,A02,084139,Staff,24,0,30,6
1649900656586,MATH 20E,A03,084140,Staff,25,0,30,5
1649900656586,MATH 20E,A04,084141,Staff,27,0,30,3
1649900662614,MATH 102,A01,084143,Harel; Guershon,20,0,30,10
1649900662614,MATH 102,A02,084144,Harel; Guershon,22,0,30,8
1649900668641,MATH 103B,A01,083456,Staff,0,6,30,30
1649900668641,MATH 103B,A02,083457,Staff,0,6,30,30
1649900674675,MATH 109,A01,084146,Salehi Golsefidy; Alireza,29,0,30,1
1649900674675,MATH 109,A02,084147,Salehi Golsefidy; Alireza,23,0,30,7
1649900680699,MATH 120A,A01,085445,Eggers; John Dietrich,20,0,35,15
1649900680699,MATH 120A,A02,085446,Eggers; John Dietrich,28,0,35,7
1649900686725,MATH 142B,A01,084149,Verstraete; Jacques Allan,0,6,30,30
1649900686725,MATH 142B,A02,084150,Verstraete; Jacques Allan,0,5,30,30
1649900692756,MATH 170A,A01,083459,Nie; Jiawang,0,1,30,30
1649900692756,MATH 170A,A02,083460,Nie; Jiawang,6,0,30,24
1649900692756,MATH 170A,A03,083461,Nie; Jiawang,21,0,30,9
1649900698785,MATH 193B,A01,083463,Staff,6,0,30,24
1649900698785,MATH 193B,A02,083464,Staff,12,0,30,18
1649900698785,MATH 193B,A03,083465,Staff,21,0,30,9
1649900704839,COGS 2,A01,083966,Boyle; Mary E. T.,19,0,30,11
1649900710867,COGS 9,A01,083968,Staff,43,0,60,17
1649900716894,COGS 14B,A01,083970,Staff,35,0,50,15
1649900722917,COGS 17,A01,092679,Staff,68,0,75,7
1649900728957,COGS 100,A01,083972,Staff,26,0,60,34
1649900741013,COGS 101C,A01,083976,Staff,21,0,30,9
1649900747034,COGS 102A,A01,083978,Johnson; Christine M.,18,0,30,12
1649900753071,COGS 107B,A01,083980,Staff,10,0,50,40
1649900759098,COGS 115,A01,083982,Staff,13,0,30,17
1649900765125,COGS 118B,A01,083367,Staff,0,8,40,40
1649900771151,COGS 172,A01,083984,Provenzano; Emily Kara,17,0,30,13
1649900777179,COGS 177,A00,083368,Staff,1,15,30,29
1649900783208,COGS 186,A01,083986,Staff,23,0,40,17
1649900789237,COGS 187A,A01,083988,Boyle; Mary E. T.,24,0,60,36
1649900795263,CSE 8A,A50,084003,Miranda; Gregory Joseph,3,0,15,12
1649900801292,CSE 11,A01,084005,Miranda; Gregory Joseph,29,0,55,26
1649900807319,CSE 20,A01,084007,Staff,9,0,20,11
1649900813348,CSE 21,A01,084009,Staff,16,0,50,34
1649900819384,CSE 30,A01,083370,Cao; Yingjun,0,9,40,40
1649900825415,CSE 100,A01,083372,Cao; Yingjun,0,14,40,40
1649900831439,CSE 101,A01,084011,Staff,1,45,40,39
1649900837462,CSE 141,A01,083374,Eldon; John,1,49,75,74
1649900843489,CSE 141L,A01,083376,Eldon; John,1,53,75,74
1649900849512,CSE 175,A01,084013,Kumar; Rakesh,22,0,25,3
1649900855538,CSE 190,A00,092508,Dubnov; Shlomo,15,0,15,0
1649900861571,ECE 5,A01,084049,Morris; Karcher William,16,0,20,4
1649900867600,ECE 100,A01,084051,Baghdadchi; Saharnaz,4,0,20,16
1649900867600,ECE 100,A02,091916,Baghdadchi; Saharnaz,18,0,20,2
1649900873624,ECE 101,A01,084053,Baghdadchi; Saharnaz,8,0,37,29
1649900873624,ECE 101,A02,084054,Baghdadchi; Saharnaz,37,0,37,0
1649900879648,ECE 107,A01,083390,Staff,29,0,40,11
1649900885678,ECE 148,A01,084056,Silberman; Jack,7,0,12,5
1649900891708,ECE 180,A00,083391,Abi Samra; Nicholas Camill,25,0,30,5
1649900891708,ECE 180,B00,083392,Abi Samra; Nicholas Camill,22,0,30,8
1649900897743,MATH 10B,A01,084110,Staff,10,0,30,20
1649900897743,MATH 10B,A02,084111,Staff,29,0,30,1
1649900897743,MATH 10B,A03,084112,Staff,28,0,30,2
1649900903771,MATH 10C,A01,083443,Staff,10,0,30,20
1649900903771,MATH 10C,A02,083444,Staff,17,0,30,13
1649900903771,MATH 10C,B01,084114,Staff,25,0,30,5
1649900903771,MATH 10C,B02,084115,Staff,30,0,30,0
1649900909795,MATH 18,A01,084117,Harel; Guershon,27,0,30,3
1649900909795,MATH 18,A02,084119,Harel; Guershon,29,0,30,1
1649900909795,MATH 18,A03,084120,Harel; Guershon,30,0,30,0
1649900909795,MATH 18,A04,084121,Harel; Guershon,29,0,30,1
1649900915821,MATH 20B,A01,084124,Um; Ko Woon,31,0,35,4
1649900915821,MATH 20B,B01,084126,Um; Ko Woon,33,0,35,2
1649900921865,MATH 20C,A01,083446,Hammock; Frances H,19,0,30,11
1649900921865,MATH 20C,A02,083447,Hammock; Frances H,28,0,30,2
1649900921865,MATH 20C,A03,083448,Hammock; Frances H,30,0,30,0
1649900921865,MATH 20C,A04,083449,Hammock; Frances H,30,0,30,0
1649900921865,MATH 20C,B01,083451,Hammock; Frances H,26,0,30,4
1649900921865,MATH 20C,B02,083452,Hammock; Frances H,29,0,30,1
1649900921865,MATH 20C,B03,083453,Hammock; Frances H,28,0,30,2
1649900921865,MATH 20C,B04,083454,Hammock; Frances H,30,0,30,0
1649900927889,MATH 20D,A01,084128,Staff,29,0,30,1
1649900927889,MATH 20D,A02,084129,Staff,30,0,30,0
1649900927889,MATH 20D,A03,084130,Staff,29,0,30,1
1649900927889,MATH 20D,B01,084133,Staff,25,0,30,5
1649900927889,MATH 20D,B02,084134,Staff,27,0,30,3
1649900927889,MATH 20D,B03,084135,Staff,30,0,30,0
1649900933912,MATH 20E,A01,084138,Staff,25,0,30,5
1649900933912,MATH 20E,A02,084139,Staff,24,0,30,6
1649900933912,MATH 20E,A03,084140,Staff,25,0,30,5
1649900933912,MATH 20E,A04,084141,Staff,27,0,30,3
1649900939936,MATH 102,A01,084143,Harel; Guershon,20,0,30,10
1649900939936,MATH 102,A02,084144,Harel; Guershon,22,0,30,8
1649900945959,MATH 103B,A01,083456,Staff,0,6,30,30
1649900945959,MATH 103B,A02,083457,Staff,0,6,30,30
1649900951988,MATH 109,A01,084146,Salehi Golsefidy; Alireza,29,0,30,1
1649900951988,MATH 109,A02,084147,Salehi Golsefidy; Alireza,23,0,30,7
1649900958016,MATH 120A,A01,085445,Eggers; John Dietrich,20,0,35,15
1649900958016,MATH 120A,A02,085446,Eggers; John Dietrich,28,0,35,7
1649900964043,MATH 142B,A01,084149,Verstraete; Jacques Allan,0,6,30,30
1649900964043,MATH 142B,A02,084150,Verstraete; Jacques Allan,0,5,30,30
1649900970070,MATH 170A,A01,083459,Nie; Jiawang,0,1,30,30
1649900970070,MATH 170A,A02,083460,Nie; Jiawang,6,0,30,24
1649900970070,MATH 170A,A03,083461,Nie; Jiawang,21,0,30,9
1649900976093,MATH 193B,A01,083463,Staff,6,0,30,24
1649900976093,MATH 193B,A02,083464,Staff,12,0,30,18
1649900976093,MATH 193B,A03,083465,Staff,21,0,30,9
1649900982153,COGS 2,A01,083966,Boyle; Mary E. T.,19,0,30,11
1649900988177,COGS 9,A01,083968,Staff,43,0,60,17
1649900994200,COGS 14B,A01,083970,Staff,35,0,50,15
1649901000223,COGS 17,A01,092679,Staff,68,0,75,7
1649901006246,COGS 100,A01,083972,Staff,25,0,60,35
1649901018294,COGS 101C,A01,083976,Staff,21,0,30,9
1649901024319,COGS 102A,A01,083978,Johnson; Christine M.,18,0,30,12
1649901030346,COGS 107B,A01,083980,Staff,10,0,50,40
1649901036369,COGS 115,A01,083982,Staff,13,0,30,17
1649901042392,COGS 118B,A01,083367,Staff,0,8,40,40
1649901048425,COGS 172,A01,083984,Provenzano; Emily Kara,17,0,30,13
1649901054448,COGS 177,A00,083368,Staff,1,15,30,29
1649901060472,COGS 186,A01,083986,Staff,23,0,40,17
1649901066495,COGS 187A,A01,083988,Boyle; Mary E. T.,24,0,60,36
1649901072518,CSE 8A,A50,084003,Miranda; Gregory Joseph,3,0,15,12
1649901078545,CSE 11,A01,084005,Miranda; Gregory Joseph,29,0,55,26
1649901084584,CSE 20,A01,084007,Staff,9,0,20,11
1649901090617,CSE 21,A01,084009,Staff,16,0,50,34
1649901096644,CSE 30,A01,083370,Cao; Yingjun,0,9,40,40
1649901102670,CSE 100,A01,083372,Cao; Yingjun,0,14,40,40
1649901108694,CSE 101,A01,084011,Staff,1,45,40,39
1649901114716,CSE 141,A01,083374,Eldon; John,1,49,75,74
1649901120743,CSE 141L,A01,083376,Eldon; John,1,53,75,74
1649901126766,CSE 175,A01,084013,Kumar; Rakesh,22,0,25,3
1649901132789,CSE 190,A00,092508,Dubnov; Shlomo,15,0,15,0
1649901138817,ECE 5,A01,084049,Morris; Karcher William,16,0,20,4
1649901144840,ECE 100,A01,084051,Baghdadchi; Saharnaz,4,0,20,16
1649901144840,ECE 100,A02,091916,Baghdadchi; Saharnaz,18,0,20,2
1649901150868,ECE 101,A01,084053,Baghdadchi; Saharnaz,8,0,37,29
1649901150868,ECE 101,A02,084054,Baghdadchi; Saharnaz,37,0,37,0
1649901156981,ECE 107,A01,083390,Staff,29,0,40,11
1649901163003,ECE 148,A01,084056,Silberman; Jack,7,0,12,5
1649901169047,ECE 180,A00,083391,Abi Samra; Nicholas Camill,25,0,30,5
1649901169047,ECE 180,B00,083392,Abi Samra; Nicholas Camill,22,0,30,8
1649901175070,MATH 10B,A01,084110,Staff,10,0,30,20
1649901175070,MATH 10B,A02,084111,Staff,29,0,30,1
1649901175070,MATH 10B,A03,084112,Staff,28,0,30,2
1649901181095,MATH 10C,A01,083443,Staff,10,0,30,20
1649901181095,MATH 10C,A02,083444,Staff,17,0,30,13
1649901181095,MATH 10C,B01,084114,Staff,25,0,30,5
1649901181095,MATH 10C,B02,084115,Staff,30,0,30,0
1649901187118,MATH 18,A01,084117,Harel; Guershon,27,0,30,3
1649901187118,MATH 18,A02,084119,Harel; Guershon,29,0,30,1
1649901187118,MATH 18,A03,084120,Harel; Guershon,30,0,30,0
1649901187118,MATH 18,A04,084121,Harel; Guershon,29,0,30,1
1649901193142,MATH 20B,A01,084124,Um; Ko Woon,31,0,35,4
1649901193142,MATH 20B,B01,084126,Um; Ko Woon,33,0,35,2
1649901199169,MATH 20C,A01,083446,Hammock; Frances H,19,0,30,11
1649901199169,MATH 20C,A02,083447,Hammock; Frances H,28,0,30,2
1649901199169,MATH 20C,A03,083448,Hammock; Frances H,30,0,30,0
1649901199169,MATH 20C,A04,083449,Hammock; Frances H,30,0,30,0
1649901199169,MATH 20C,B01,083451,Hammock; Frances H,26,0,30,4
1649901199169,MATH 20C,B02,083452,Hammock; Frances H,29,0,30,1
1649901199169,MATH 20C,B03,083453,Hammock; Frances H,28,0,30,2
1649901199169,MATH 20C,B04,083454,Hammock; Frances H,30,0,30,0
1649901205195,MATH 20D,A01,084128,Staff,29,0,30,1
1649901205195,MATH 20D,A02,084129,Staff,30,0,30,0
1649901205195,MATH 20D,A03,084130,Staff,29,0,30,1
1649901205195,MATH 20D,B01,084133,Staff,25,0,30,5
1649901205195,MATH 20D,B02,084134,Staff,27,0,30,3
1649901205195,MATH 20D,B03,084135,Staff,30,0,30,0
1649901211220,MATH 20E,A01,084138,Staff,25,0,30,5
1649901211220,MATH 20E,A02,084139,Staff,24,0,30,6
1649901211220,MATH 20E,A03,084140,Staff,25,0,30,5
1649901211220,MATH 20E,A04,084141,Staff,27,0,30,3
1649901217244,MATH 102,A01,084143,Harel; Guershon,20,0,30,10
1649901217244,MATH 102,A02,084144,Harel; Guershon,22,0,30,8
1649901223272,MATH 103B,A01,083456,Staff,0,7,30,30
1649901223272,MATH 103B,A02,083457,Staff,0,6,30,30
1649901229295,MATH 109,A01,084146,Salehi Golsefidy; Alireza,29,0,30,1
1649901229295,MATH 109,A02,084147,Salehi Golsefidy; Alireza,23,0,30,7
1649901235326,MATH 120A,A01,085445,Eggers; John Dietrich,20,0,35,15
1649901235326,MATH 120A,A02,085446,Eggers; John Dietrich,28,0,35,7
1649901241351,MATH 142B,A01,084149,Verstraete; Jacques Allan,0,6,30,30
1649901241351,MATH 142B,A02,084150,Verstraete; Jacques Allan,0,5,30,30
1649901247378,MATH 170A,A01,083459,Nie; Jiawang,0,1,30,30
1649901247378,MATH 170A,A02,083460,Nie; Jiawang,6,0,30,24
1649901247378,MATH 170A,A03,083461,Nie; Jiawang,20,0,30,10
1649901253404,MATH 193B,A01,083463,Staff,6,0,30,24
1649901253404,MATH 193B,A02,083464,Staff,12,0,30,18
1649901253404,MATH 193B,A03,083465,Staff,21,0,30,9
1649901259479,COGS 2,A01,083966,Boyle; Mary E. T.,19,0,30,11
1649901265501,COGS 9,A01,083968,Staff,43,0,60,17
1649901271536,COGS 14B,A01,083970,Staff,34,0,50,16
1649901277563,COGS 17,A01,092679,Staff,68,0,75,7
1649901283590,COGS 100,A01,083972,Staff,25,0,60,35
1649901295643,COGS 101C,A01,083976,Staff,20,0,30,10
1649901301668,COGS 102A,A01,083978,Johnson; Christine M.,18,0,30,12
1649901307692,COGS 107B,A01,083980,Staff,10,0,50,40
1649901313716,COGS 115,A01,083982,Staff,13,0,30,17
1649901319738,COGS 118B,A01,083367,Staff,0,8,40,40
1649901325775,COGS 172,A01,083984,Provenzano; Emily Kara,16,0,30,14
1649901331799,COGS 177,A00,083368,Staff,1,15,30,29
1649901337822,COGS 186,A01,083986,Staff,23,0,40,17
1649901343846,COGS 187A,A01,083988,Boyle; Mary E. T.,24,0,60,36
1649901349878,CSE 8A,A50,084003,Miranda; Gregory Joseph,3,0,15,12
1649901355901,CSE 11,A01,084005,Miranda; Gregory Joseph,29,0,55,26
1649901361925,CSE 20,A01,084007,Staff,9,0,20,11
1649901367949,CSE 21,A01,084009,Staff,16,0,50,34
1649901373996,CSE 30,A01,083370,Cao; Yingjun,0,9,40,40
1649901380019,CSE 100,A01,083372,Cao; Yingjun,0,15,40,40
1649901386043,CSE 101,A01,084011,Staff,1,45,40,39
1649901392067,CSE 141,A01,083374,Eldon; John,1,49,75,74
1649901398091,CSE 141L,A01,083376,Eldon; John,1,53,75,74
1649901404113,CSE 175,A01,084013,Kumar; Rakesh,22,0,25,3
1649901410140,CSE 190,A00,092508,Dubnov; Shlomo,15,0,15,0
1649901416166,ECE 5,A01,084049,Morris; Karcher William,16,0,20,4
1649901422203,ECE 100,A01,084051,Baghdadchi; Saharnaz,4,0,20,16
1649901422203,ECE 100,A02,091916,Baghdadchi; Saharnaz,18,0,20,2
1649901428226,ECE 101,A01,084053,Baghdadchi; Saharnaz,8,0,37,29
1649901428226,ECE 101,A02,084054,Baghdadchi; Saharnaz,37,0,37,0
1649901434257,ECE 107,A01,083390,Staff,29,0,40,11
1649901440287,ECE 148,A01,084056,Silberman; Jack,7,0,12,5
1649901446311,ECE 180,A00,083391,Abi Samra; Nicholas Camill,25,0,30,5
1649901446311,ECE 180,B00,083392,Abi Samra; Nicholas Camill,22,0,30,8
1649901452333,MATH 10B,A01,084110,Staff,10,0,30,20
1649901452333,MATH 10B,A02,084111,Staff,29,0,30,1
1649901452333,MATH 10B,A03,084112,Staff,28,0,30,2
1649901458356,MATH 10C,A01,083443,Staff,10,0,30,20
1649901458356,MATH 10C,A02,083444,Staff,17,0,30,13
1649901458356,MATH 10C,B01,084114,Staff,25,0,30,5
1649901458356,MATH 10C,B02,084115,Staff,30,0,30,0
1649901464381,MATH 18,A01,084117,Harel; Guershon,27,0,30,3
1649901464381,MATH 18,A02,084119,Harel; Guershon,29,0,30,1
1649901464381,MATH 18,A03,084120,Harel; Guershon,30,0,30,0
1649901464381,MATH 18,A04,084121,Harel; Guershon,29,0,30,1
1649901470408,MATH 20B,A01,084124,Um; Ko Woon,31,0,35,4
1649901470408,MATH 20B,B01,084126,Um; Ko Woon,33,0,35,2
1649901476433,MATH 20C,A01,083446,Hammock; Frances H,19,0,30,11
1649901476433,MATH 20C,A02,083447,Hammock; Frances H,28,0,30,2
1649901476433,MATH 20C,A03,083448,Hammock; Frances H,30,0,30,0
1649901476433,MATH 20C,A04,083449,Hammock; Frances H,30,0,30,0
1649901476433,MATH 20C,B01,083451,Hammock; Frances H,26,0,30,4
1649901476433,MATH 20C,B02,083452,Hammock; Frances H,29,0,30,1
1649901476433,MATH 20C,B03,083453,Hammock; Frances H,28,0,30,2
1649901476433,MATH 20C,B04,083454,Hammock; Frances H,30,0,30,0
1649901482464,MATH 20D,A01,084128,Staff,29,0,30,1
1649901482464,MATH 20D,A02,084129,Staff,30,0,30,0
1649901482464,MATH 20D,A03,084130,Staff,29,0,30,1
1649901482464,MATH 20D,B01,084133,Staff,25,0,30,5
1649901482464,MATH 20D,B02,084134,Staff,27,0,30,3
1649901482464,MATH 20D,B03,084135,Staff,30,0,30,0
1649901488488,MATH 20E,A01,084138,Staff,25,0,30,5
1649901488488,MATH 20E,A02,084139,Staff,23,0,30,7
1649901488488,MATH 20E,A03,084140,Staff,25,0,30,5
1649901488488,MATH 20E,A04,084141,Staff,27,0,30,3
1649901494511,MATH 102,A01,084143,Harel; Guershon,20,0,30,10
1649901494511,MATH 102,A02,084144,Harel; Guershon,22,0,30,8
1649901500537,MATH 103B,A01,083456,Staff,0,7,30,30
1649901500537,MATH 103B,A02,083457,Staff,0,6,30,30
1649901506560,MATH 109,A01,084146,Salehi Golsefidy; Alireza,29,0,30,1
1649901506560,MATH 109,A02,084147,Salehi Golsefidy; Alireza,23,0,30,7
1649901512586,MATH 120A,A01,085445,Eggers; John Dietrich,20,0,35,15
1649901512586,MATH 120A,A02,085446,Eggers; John Dietrich,28,0,35,7
1649901518612,MATH 142B,A01,084149,Verstraete; Jacques Allan,0,6,30,30
1649901518612,MATH 142B,A02,084150,Verstraete; Jacques Allan,0,5,30,30
1649901524639,MATH 170A,A01,083459,Nie; Jiawang,0,1,30,30
1649901524639,MATH 170A,A02,083460,Nie; Jiawang,6,0,30,24
1649901524639,MATH 170A,A03,083461,Nie; Jiawang,20,0,30,10
1649901530663,MATH 193B,A01,083463,Staff,6,0,30,24
1649901530663,MATH 193B,A02,083464,Staff,12,0,30,18
1649901530663,MATH 193B,A03,083465,Staff,21,0,30,9
1649901536738,COGS 2,A01,083966,Boyle; Mary E. T.,19,0,30,11
1649901542761,COGS 9,A01,083968,Staff,43,0,60,17
1649901548795,COGS 14B,A01,083970,Staff,34,0,50,16
1649901554818,COGS 17,A01,092679,Staff,68,0,75,7
1649901560840,COGS 100,A01,083972,Staff,25,0,60,35
1649901572890,COGS 101C,A01,083976,Staff,20,0,30,10
1649901578912,COGS 102A,A01,083978,Johnson; Christine M.,18,0,30,12
1649901584936,COGS 107B,A01,083980,Staff,10,0,50,40
1649901590958,COGS 115,A01,083982,Staff,13,0,30,17
1649901596985,COGS 118B,A01,083367,Staff,0,9,40,40
1649901603008,COGS 172,A01,083984,Provenzano; Emily Kara,17,0,30,13
1649901609031,COGS 177,A00,083368,Staff,1,15,30,29
1649901615058,COGS 186,A01,083986,Staff,22,0,40,18
1649901621080,COGS 187A,A01,083988,Boyle; Mary E. T.,24,0,60,36
1649901627108,CSE 8A,A50,084003,Miranda; Gregory Joseph,3,0,15,12
1649901633133,CSE 11,A01,084005,Miranda; Gregory Joseph,29,0,55,26
1649901639157,CSE 20,A01,084007,Staff,9,0,20,11
1649901645185,CSE 21,A01,084009,Staff,16,0,50,34
1649901651211,CSE 30,A01,083370,Cao; Yingjun,0,9,40,40
1649901657237,CSE 100,A01,083372,Cao; Yingjun,0,15,40,40
1649901663262,CSE 101,A01,084011,Staff,1,45,40,39
1649901669295,CSE 141,A01,083374,Eldon; John,1,49,75,74
1649901675321,CSE 141L,A01,083376,Eldon; John,1,53,75,74
1649901681351,CSE 175,A01,084013,Kumar; Rakesh,22,0,25,3
1649901687380,CSE 190,A00,092508,Dubnov; Shlomo,15,0,15,0
1649901693408,ECE 5,A01,084049,Morris; Karcher William,16,0,20,4
1649901699439,ECE 100,A01,084051,Baghdadchi; Saharnaz,4,0,20,16
1649901699439,ECE 100,A02,091916,Baghdadchi; Saharnaz,18,0,20,2
1649901705463,ECE 101,A01,084053,Baghdadchi; Saharnaz,8,0,37,29
1649901705463,ECE 101,A02,084054,Baghdadchi; Saharnaz,37,0,37,0
1649901711486,ECE 107,A01,083390,Staff,29,0,40,11
1649901717510,ECE 148,A01,084056,Silberman; Jack,7,0,12,5
1649901723534,ECE 180,A00,083391,Abi Samra; Nicholas Camill,25,0,30,5
1649901723534,ECE 180,B00,083392,Abi Samra; Nicholas Camill,22,0,30,8
1649901729556,MATH 10B,A01,084110,Staff,10,0,30,20
1649901729556,MATH 10B,A02,084111,Staff,29,0,30,1
1649901729556,MATH 10B,A03,084112,Staff,28,0,30,2
1649901735580,MATH 10C,A01,083443,Staff,10,0,30,20
1649901735580,MATH 10C,A02,083444,Staff,17,0,30,13
1649901735580,MATH 10C,B01,084114,Staff,25,0,30,5
1649901735580,MATH 10C,B02,084115,Staff,30,0,30,0
1649901741607,MATH 18,A01,084117,Harel; Guershon,27,0,30,3
1649901741607,MATH 18,A02,084119,Harel; Guershon,29,0,30,1
1649901741607,MATH 18,A03,084120,Harel; Guershon,30,0,30,0
1649901741607,MATH 18,A04,084121,Harel; Guershon,29,0,30,1
1649901747631,MATH 20B,A01,084124,Um; Ko Woon,31,0,35,4
1649901747631,MATH 20B,B01,084126,Um; Ko Woon,33,0,35,2
1649901753732,MATH 20C,A01,083446,Hammock; Frances H,19,0,30,11
1649901753732,MATH 20C,A02,083447,Hammock; Frances H,28,0,30,2
1649901753732,MATH 20C,A03,083448,Hammock; Frances H,30,0,30,0
1649901753732,MATH 20C,A04,083449,Hammock; Frances H,30,0,30,0
1649901753732,MATH 20C,B01,083451,Hammock; Frances H,26,0,30,4
1649901753732,MATH 20C,B02,083452,Hammock; Frances H,29,0,30,1
1649901753732,MATH 20C,B03,083453,Hammock; Frances H,27,0,30,3
1649901753732,MATH 20C,B04,083454,Hammock; Frances H,30,0,30,0
1649901759758,MATH 20D,A01,084128,Staff,29,0,30,1
1649901759758,MATH 20D,A02,084129,Staff,30,0,30,0
1649901759758,MATH 20D,A03,084130,Staff,29,0,30,1
1649901759758,MATH 20D,B01,084133,Staff,25,0,30,5
1649901759758,MATH 20D,B02,084134,Staff,27,0,30,3
1649901759758,MATH 20D,B03,084135,Staff,30,0,30,0
1649901765786,MATH 20E,A01,084138,Staff,24,0,30,6
1649901765786,MATH 20E,A02,084139,Staff,24,0,30,6
1649901765786,MATH 20E,A03,084140,Staff,25,0,30,5
1649901765786,MATH 20E,A04,084141,Staff,27,0,30,3
1649901771809,MATH 102,A01,084143,Harel; Guershon,20,0,30,10
1649901771809,MATH 102,A02,084144,Harel; Guershon,22,0,30,8
1649901777832,MATH 103B,A01,083456,Staff,0,7,30,30
1649901777832,MATH 103B,A02,083457,Staff,0,6,30,30
1649901783860,MATH 109,A01,084146,Salehi Golsefidy; Alireza,29,0,30,1
1649901783860,MATH 109,A02,084147,Salehi Golsefidy; Alireza,23,0,30,7
1649901789883,MATH 120A,A01,085445,Eggers; John Dietrich,20,0,35,15
1649901789883,MATH 120A,A02,085446,Eggers; John Dietrich,28,0,35,7
1649901795911,MATH 142B,A01,084149,Verstraete; Jacques Allan,0,6,30,30
1649901795911,MATH 142B,A02,084150,Verstraete; Jacques Allan,0,5,30,30
1649901801937,MATH 170A,A01,083459,Nie; Jiawang,0,1,30,30
1649901801937,MATH 170A,A02,083460,Nie; Jiawang,6,0,30,24
1649901801937,MATH 170A,A03,083461,Nie; Jiawang,20,0,30,10
1649901807965,MATH 193B,A01,083463,Staff,6,0,30,24
1649901807965,MATH 193B,A02,083464,Staff,12,0,30,18
1649901807965,MATH 193B,A03,083465,Staff,21,0,30,9
1649901814023,COGS 2,A01,083966,Boyle; Mary E. T.,19,0,30,11
1649901820050,COGS 9,A01,083968,Staff,43,0,60,17
1649901826074,COGS 14B,A01,083970,Staff,34,0,50,16
1649901832096,COGS 17,A01,092679,Staff,68,0,75,7
1649901838119,COGS 100,A01,083972,Staff,25,0,60,35
1649901850171,COGS 101C,A01,083976,Staff,20,0,30,10
1649901856196,COGS 102A,A01,083978,Johnson; Christine M.,18,0,30,12
1649901862222,COGS 107B,A01,083980,Staff,10,0,50,40
1649901868244,COGS 115,A01,083982,Staff,13,0,30,17
1649901874271,COGS 118B,A01,083367,Staff,0,9,40,40
1649901880294,COGS 172,A01,083984,Provenzano; Emily Kara,17,0,30,13
1649901886323,COGS 177,A00,083368,Staff,1,15,30,29
1649901892350,COGS 186,A01,083986,Staff,22,0,40,18
1649901898375,COGS 187A,A01,083988,Boyle; Mary E. T.,24,0,60,36
1649901904398,CSE 8A,A50,084003,Miranda; Gregory Joseph,3,0,15,12
1649901910432,CSE 11,A01,084005,Miranda; Gregory Joseph,29,0,55,26
1649901916457,CSE 20,A01,084007,Staff,9,0,20,11
1649901922499,CSE 21,A01,084009,Staff,16,0,50,34
1649901928526,CSE 30,A01,083370,Cao; Yingjun,0,10,40,40
1649901934555,CSE 100,A01,083372,Cao; Yingjun,0,15,40,40
1649901940580,CSE 101,A01,084011,Staff,1,45,40,39
1649901946602,CSE 141,A01,083374,Eldon; John,1,49,75,74
1649901952636,CSE 141L,A01,083376,Eldon; John,1,53,75,74
1649901958659,CSE 175,A01,084013,Kumar; Rakesh,22,0,25,3
1649901964687,CSE 190,A00,092508,Dubnov; Shlomo,15,0,15,0
1649901970710,ECE 5,A01,084049,Morris; Karcher William,16,0,20,4
1649901976736,ECE 100,A01,084051,Baghdadchi; Saharnaz,4,0,20,16
1649901976736,ECE 100,A02,091916,Baghdadchi; Saharnaz,18,0,20,2
1649901982761,ECE 101,A01,084053,Baghdadchi; Saharnaz,8,0,37,29
1649901982761,ECE 101,A02,084054,Baghdadchi; Saharnaz,37,0,37,0
1649901988783,ECE 107,A01,083390,Staff,29,0,40,11
1649901994806,ECE 148,A01,084056,Silberman; Jack,7,0,12,5
1649902000838,ECE 180,A00,083391,Abi Samra; Nicholas Camill,25,0,30,5
1649902000838,ECE 180,B00,083392,Abi Samra; Nicholas Camill,22,0,30,8
1649902006862,MATH 10B,A01,084110,Staff,10,0,30,20
1649902006862,MATH 10B,A02,084111,Staff,29,0,30,1
1649902006862,MATH 10B,A03,084112,Staff,28,0,30,2
1649902012885,MATH 10C,A01,083443,Staff,10,0,30,20
1649902012885,MATH 10C,A02,083444,Staff,17,0,30,13
1649902012885,MATH 10C,B01,084114,Staff,25,0,30,5
1649902012885,MATH 10C,B02,084115,Staff,30,0,30,0
1649902018913,MATH 18,A01,084117,Harel; Guershon,27,0,30,3
1649902018913,MATH 18,A02,084119,Harel; Guershon,29,0,30,1
1649902018913,MATH 18,A03,084120,Harel; Guershon,30,0,30,0
1649902018913,MATH 18,A04,084121,Harel; Guershon,29,0,30,1
1649902024936,MATH 20B,A01,084124,Um; Ko Woon,31,0,35,4
1649902024936,MATH 20B,B01,084126,Um; Ko Woon,33,0,35,2
1649902030962,MATH 20C,A01,083446,Hammock; Frances H,19,0,30,11
1649902030962,MATH 20C,A02,083447,Hammock; Frances H,28,0,30,2
1649902030962,MATH 20C,A03,083448,Hammock; Frances H,30,0,30,0
1649902030962,MATH 20C,A04,083449,Hammock; Frances H,30,0,30,0
1649902030962,MATH 20C,B01,083451,Hammock; Frances H,26,0,30,4
1649902030962,MATH 20C,B02,083452,Hammock; Frances H,29,0,30,1
1649902030962,MATH 20C,B03,083453,Hammock; Frances H,27,0,30,3
1649902030962,MATH 20C,B04,083454,Hammock; Frances H,30,0,30,0
1649902036989,MATH 20D,A01,084128,Staff,29,0,30,1
1649902036989,MATH 20D,A02,084129,Staff,30,0,30,0
1649902036989,MATH 20D,A03,084130,Staff,29,0,30,1
1649902036989,MATH 20D,B01,084133,Staff,25,0,30,5
1649902036989,MATH 20D,B02,084134,Staff,27,0,30,3
1649902036989,MATH 20D,B03,084135,Staff,30,0,30,0
1649902043014,MATH 20E,A01,084138,Staff,24,0,30,6
1649902043014,MATH 20E,A02,084139,Staff,24,0,30,6
1649902043014,MATH 20E,A03,084140,Staff,25,0,30,5
1649902043014,MATH 20E,A04,084141,Staff,27,0,30,3
1649902049041,MATH 102,A01,084143,Harel; Guershon,20,0,30,10
1649902049041,MATH 102,A02,084144,Harel; Guershon,22,0,30,8
1649902055069,MATH 103B,A01,083456,Staff,0,8,30,30
1649902055069,MATH 103B,A02,083457,Staff,0,6,30,30
1649902061094,MATH 109,A01,084146,Salehi Golsefidy; Alireza,29,0,30,1
1649902061094,MATH 109,A02,084147,Salehi Golsefidy; Alireza,23,0,30,7
1649902067116,MATH 120A,A01,085445,Eggers; John Dietrich,20,0,35,15
1649902067116,MATH 120A,A02,085446,Eggers; John Dietrich,28,0,35,7
1649902073140,MATH 142B,A01,084149,Verstraete; Jacques Allan,0,6,30,30
1649902073140,MATH 142B,A02,084150,Verstraete; Jacques Allan,0,5,30,30
1649902079169,MATH 170A,A01,083459,Nie; Jiawang,0,1,30,30
1649902079169,MATH 170A,A02,083460,Nie; Jiawang,6,0,30,24
1649902079169,MATH 170A,A03,083461,Nie; Jiawang,20,0,30,10
1649902085196,MATH 193B,A01,083463,Staff,6,0,30,24
1649902085196,MATH 193B,A02,083464,Staff,12,0,30,18
1649902085196,MATH 193B,A03,083465,Staff,21,0,30,9
1649902091247,COGS 2,A01,083966,Boyle; Mary E. T.,19,0,30,11
1649902097278,COGS 9,A01,083968,Staff,43,0,60,17
1649902103307,COGS 14B,A01,083970,Staff,34,0,50,16
1649902109333,COGS 17,A01,092679,Staff,68,0,75,7
1649902115357,COGS 100,A01,083972,Staff,25,0,60,35
1649902127405,COGS 101C,A01,083976,Staff,20,0,30,10
1649902133429,COGS 102A,A01,083978,Johnson; Christine M.,18,0,30,12
1649902139460,COGS 107B,A01,083980,Staff,10,0,50,40
1649902145484,COGS 115,A01,083982,Staff,13,0,30,17
1649902151509,COGS 118B,A01,083367,Staff,0,10,40,40
1649902157531,COGS 172,A01,083984,Provenzano; Emily Kara,17,0,30,13
1649902163565,COGS 177,A00,083368,Staff,1,15,30,29
1649902169592,COGS 186,A01,083986,Staff,22,0,40,18
1649902175618,COGS 187A,A01,083988,Boyle; Mary E. T.,24,0,60,36
1649902181643,CSE 8A,A50,084003,Miranda; Gregory Joseph,2,0,15,13
1649902187668,CSE 11,A01,084005,Miranda; Gregory Joseph,29,0,55,26
1649902193692,CSE 20,A01,084007,Staff,9,0,20,11
1649902199717,CSE 21,A01,084009,Staff,16,0,50,34
1649902205756,CSE 30,A01,083370,Cao; Yingjun,0,10,40,40
1649902211780,CSE 100,A01,083372,Cao; Yingjun,0,15,40,40
1649902217806,CSE 101,A01,084011,Staff,1,45,40,39
1649902223830,CSE 141,A01,083374,Eldon; John,1,49,75,74
1649902229852,CSE 141L,A01,083376,Eldon; John,1,53,75,74
1649902235883,CSE 175,A01,084013,Kumar; Rakesh,22,0,25,3
1649902241906,CSE 190,A00,092508,Dubnov; Shlomo,15,0,15,0
1649902247936,ECE 5,A01,084049,Morris; Karcher William,16,0,20,4
1649902253964,ECE 100,A01,084051,Baghdadchi; Saharnaz,4,0,20,16
1649902253964,ECE 100,A02,091916,Baghdadchi; Saharnaz,18,0,20,2
1649902259993,ECE 101,A01,084053,Baghdadchi; Saharnaz,8,0,37,29
1649902259993,ECE 101,A02,084054,Baghdadchi; Saharnaz,37,0,37,0
1649902266023,ECE 107,A01,083390,Staff,29,0,40,11
1649902272049,ECE 148,A01,084056,Silberman; Jack,7,0,12,5
1649902278076,ECE 180,A00,083391,Abi Samra; Nicholas Camill,25,0,30,5
1649902278076,ECE 180,B00,083392,Abi Samra; Nicholas Camill,22,0,30,8
1649902284100,MATH 10B,A01,084110,Staff,10,0,30,20
1649902284100,MATH 10B,A02,084111,Staff,29,0,30,1
1649902284100,MATH 10B,A03,084112,Staff,28,0,30,2
1649902290123,MATH 10C,A01,083443,Staff,10,0,30,20
1649902290123,MATH 10C,A02,083444,Staff,17,0,30,13
1649902290123,MATH 10C,B01,084114,Staff,25,0,30,5
1649902290123,MATH 10C,B02,084115,Staff,30,0,30,0
1649902296147,MATH 18,A01,084117,Harel; Guershon,27,0,30,3
1649902296147,MATH 18,A02,084119,Harel; Guershon,29,0,30,1
1649902296147,MATH 18,A03,084120,Harel; Guershon,30,0,30,0
1649902296147,MATH 18,A04,084121,Harel; Guershon,29,0,30,1
1649902302169,MATH 20B,A01,084124,Um; Ko Woon,31,0,35,4
1649902302169,MATH 20B,B01,084126,Um; Ko Woon,33,0,35,2
1649902308201,MATH 20C,A01,083446,Hammock; Frances H,19,0,30,11
1649902308201,MATH 20C,A02,083447,Hammock; Frances H,28,0,30,2
1649902308201,MATH 20C,A03,083448,Hammock; Frances H,30,0,30,0
1649902308201,MATH 20C,A04,083449,Hammock; Frances H,30,0,30,0
1649902308201,MATH 20C,B01,083451,Hammock; Frances H,26,0,30,4
1649902308201,MATH 20C,B02,083452,Hammock; Frances H,29,0,30,1
1649902308201,MATH 20C,B03,083453,Hammock; Frances H,27,0,30,3
1649902308201,MATH 20C,B04,083454,Hammock; Frances H,30,0,30,0
1649902314224,MATH 20D,A01,084128,Staff,29,0,30,1
1649902314224,MATH 20D,A02,084129,Staff,30,0,30,0
1649902314224,MATH 20D,A03,084130,Staff,29,0,30,1
1649902314224,MATH 20D,B01,084133,Staff,25,0,30,5
1649902314224,MATH 20D,B02,084134,Staff,27,0,30,3
1649902314224,MATH 20D,B03,084135,Staff,30,0,30,0
1649902320247,MATH 20E,A01,084138,Staff,24,0,30,6
1649902320247,MATH 20E,A02,084139,Staff,24,0,30,6
1649902320247,MATH 20E,A03,084140,Staff,24,0,30,6
1649902320247,MATH 20E,A04,084141,Staff,27,0,30,3
1649902326282,MATH 102,A01,084143,Harel; Guershon,20,0,30,10
1649902326282,MATH 102,A02,084144,Harel; Guershon,22,0,30,8
1649902332305,MATH 103B,A01,083456,Staff,0,8,30,30
1649902332305,MATH 103B,A02,083457,Staff,0,6,30,30
1649902338329,MATH 109,A01,084146,Salehi Golsefidy; Alireza,29,0,30,1
1649902338329,MATH 109,A02,084147,Salehi Golsefidy; Alireza,23,0,30,7
1649902344353,MATH 120A,A01,085445,Eggers; John Dietrich,20,0,35,15
1649902344353,MATH 120A,A02,085446,Eggers; John Dietrich,28,0,35,7
1649902350470,MATH 142B,A01,084149,Verstraete; Jacques Allan,0,6,30,30
1649902350470,MATH 142B,A02,084150,Verstraete; Jacques Allan,0,5,30,30
1649902356498,MATH 170A,A01,083459,Nie; Jiawang,0,1,30,30
1649902356498,MATH 170A,A02,083460,Nie; Jiawang,5,0,30,25
1649902356498,MATH 170A,A03,083461,Nie; Jiawang,19,0,30,11
1649902362526,MATH 193B,A01,083463,Staff,6,0,30,24
1649902362526,MATH 193B,A02,083464,Staff,12,0,30,18
1649902362526,MATH 193B,A03,083465,Staff,21,0,30,9
1649902368587,COGS 2,A01,083966,Boyle; Mary E. T.,19,0,30,11
1649902374609,COGS 9,A01,083968,Staff,43,0,60,17
1649902380633,COGS 14B,A01,083970,Staff,34,0,50,16
1649902386668,COGS 17,A01,092679,Staff,68,0,75,7
1649902392691,COGS 100,A01,083972,Staff,25,0,60,35
1649902404743,COGS 101C,A01,083976,Staff,20,0,30,10
1649902410769,COGS 102A,A01,083978,Johnson; Christine M.,18,0,30,12
1649902416792,COGS 107B,A01,083980,Staff,9,0,50,41
1649902422818,COGS 115,A01,083982,Staff,13,0,30,17
1649902428841,COGS 118B,A01,083367,Staff,0,10,40,40
1649902434869,COGS 172,A01,083984,Provenzano; Emily Kara,17,0,30,13
1649902440893,COGS 177,A00,083368,Staff,1,15,30,29
1649902446920,COGS 186,A01,083986,Staff,22,0,40,18
1649902452953,COGS 187A,A01,083988,Boyle; Mary E. T.,24,0,60,36
1649902458979,CSE 8A,A50,084003,Miranda; Gregory Joseph,2,0,15,13
1649902465001,CSE 11,A01,084005,Miranda; Gregory Joseph,29,0,55,26
1649902471024,CSE 20,A01,084007,Staff,9,0,20,11
1649902477050,CSE 21,A01,084009,Staff,15,0,50,35
1649902483078,CSE 30,A01,083370,Cao; Yingjun,0,11,40,40
1649902489104,CSE 100,A01,083372,Cao; Yingjun,0,15,40,40
1649902495131,CSE 101,A01,084011,Staff,1,45,40,39
1649902501157,CSE 141,A01,083374,Eldon; John,1,49,75,74
1649902507191,CSE 141L,A01,083376,Eldon; John,1,53,75,74
1649902513223,CSE 175,A01,084013,Kumar; Rakesh,22,0,25,3
1649902519258,CSE 190,A00,092508,Dubnov; Shlomo,15,0,15,0
1649902525285,ECE 5,A01,084049,Morris; Karcher William,16,0,20,4
1649902531313,ECE 100,A01,084051,Baghdadchi; Saharnaz,4,0,20,16
1649902531313,ECE 100,A02,091916,Baghdadchi; Saharnaz,18,0,20,2
1649902537338,ECE 101,A01,084053,Baghdadchi; Saharnaz,8,0,37,29
1649902537338,ECE 101,A02,084054,Baghdadchi; Saharnaz,37,0,37,0
1649902543364,ECE 107,A01,083390,Staff,29,0,40,11
1649902549387,ECE 148,A01,084056,Silberman; Jack,7,0,12,5
1649902555410,ECE 180,A00,083391,Abi Samra; Nicholas Camill,25,0,30,5
1649902555410,ECE 180,B00,083392,Abi Samra; Nicholas Camill,22,0,30,8
1649902561433,MATH 10B,A01,084110,Staff,10,0,30,20
1649902561433,MATH 10B,A02,084111,Staff,29,0,30,1
1649902561433,MATH 10B,A03,084112,Staff,28,0,30,2
1649902567458,MATH 10C,A01,083443,Staff,10,0,30,20
1649902567458,MATH 10C,A02,083444,Staff,17,0,30,13
1649902567458,MATH 10C,B01,084114,Staff,25,0,30,5
1649902567458,MATH 10C,B02,084115,Staff,30,0,30,0
1649902573481,MATH 18,A01,084117,Harel; Guershon,27,0,30,3
1649902573481,MATH 18,A02,084119,Harel; Guershon,29,0,30,1
1649902573481,MATH 18,A03,084120,Harel; Guershon,30,0,30,0
1649902573481,MATH 18,A04,084121,Harel; Guershon,29,0,30,1
1649902579508,MATH 20B,A01,084124,Um; Ko Woon,31,0,35,4
1649902579508,MATH 20B,B01,084126,Um; Ko Woon,33,0,35,2
1649902585534,MATH 20C,A01,083446,Hammock; Frances H,19,0,30,11
1649902585534,MATH 20C,A02,083447,Hammock; Frances H,28,0,30,2
1649902585534,MATH 20C,A03,083448,Hammock; Frances H,30,0,30,0
1649902585534,MATH 20C,A04,083449,Hammock; Frances H,30,0,30,0
1649902585534,MATH 20C,B01,083451,Hammock; Frances H,26,0,30,4
1649902585534,MATH 20C,B02,083452,Hammock; Frances H,29,0,30,1
1649902585534,MATH 20C,B03,083453,Hammock; Frances H,27,0,30,3
1649902585534,MATH 20C,B04,083454,Hammock; Frances H,30,0,30,0
1649902591563,MATH 20D,A01,084128,Staff,29,0,30,1
1649902591563,MATH 20D,A02,084129,Staff,30,0,30,0
1649902591563,MATH 20D,A03,084130,Staff,29,0,30,1
1649902591563,MATH 20D,B01,084133,Staff,25,0,30,5
1649902591563,MATH 20D,B02,084134,Staff,27,0,30,3
1649902591563,MATH 20D,B03,084135,Staff,30,0,30,0
1649902597588,MATH 20E,A01,084138,Staff,24,0,30,6
1649902597588,MATH 20E,A02,084139,Staff,24,0,30,6
1649902597588,MATH 20E,A03,084140,Staff,24,0,30,6
1649902597588,MATH 20E,A04,084141,Staff,27,0,30,3
1649902603610,MATH 102,A01,084143,Harel; Guershon,20,0,30,10
1649902603610,MATH 102,A02,084144,Harel; Guershon,22,0,30,8
1649902609634,MATH 103B,A01,083456,Staff,0,8,30,30
1649902609634,MATH 103B,A02,083457,Staff,0,7,30,30
1649902615658,MATH 109,A01,084146,Salehi Golsefidy; Alireza,29,0,30,1
1649902615658,MATH 109,A02,084147,Salehi Golsefidy; Alireza,23,0,30,7
1649902621686,MATH 120A,A01,085445,Eggers; John Dietrich,20,0,35,15
1649902621686,MATH 120A,A02,085446,Eggers; John Dietrich,28,0,35,7
1649902627714,MATH 142B,A01,084149,Verstraete; Jacques Allan,0,6,30,30
1649902627714,MATH 142B,A02,084150,Verstraete; Jacques Allan,0,5,30,30
1649902633737,MATH 170A,A01,083459,Nie; Jiawang,0,1,30,30
1649902633737,MATH 170A,A02,083460,Nie; Jiawang,5,0,30,25
1649902633737,MATH 170A,A03,083461,Nie; Jiawang,19,0,30,11
1649902639760,MATH 193B,A01,083463,Staff,6,0,30,24
1649902639760,MATH 193B,A02,083464,Staff,12,0,30,18
1649902639760,MATH 193B,A03,083465,Staff,21,0,30,9
1649902645823,COGS 2,A01,083966,Boyle; Mary E. T.,19,0,30,11
1649902651845,COGS 9,A01,083968,Staff,43,0,60,17
1649902657868,COGS 14B,A01,083970,Staff,34,0,50,16
1649902663898,COGS 17,A01,092679,Staff,68,0,75,7
1649902669921,COGS 100,A01,083972,Staff,24,0,60,36
1649902681983,COGS 101C,A01,083976,Staff,20,0,30,10
1649902688011,COGS 102A,A01,083978,Johnson; Christine M.,18,0,30,12
1649902694034,COGS 107B,A01,083980,Staff,9,0,50,41
1649902700058,COGS 115,A01,083982,Staff,13,0,30,17
1649902706082,COGS 118B,A01,083367,Staff,0,10,40,40
1649902712110,COGS 172,A01,083984,Provenzano; Emily Kara,17,0,30,13
1649902718136,COGS 177,A00,083368,Staff,1,15,30,29
1649902724159,COGS 186,A01,083986,Staff,22,0,40,18
1649902730193,COGS 187A,A01,083988,Boyle; Mary E. T.,24,0,60,36
1649902736215,CSE 8A,A50,084003,Miranda; Gregory Joseph,2,0,15,13
1649902742242,CSE 11,A01,084005,Miranda; Gregory Joseph,29,0,55,26
1649902748266,CSE 20,A01,084007,Staff,9,0,20,11
1649902754288,CSE 21,A01,084009,Staff,15,0,50,35
1649902760315,CSE 30,A01,083370,Cao; Yingjun,0,11,40,40
1649902766350,CSE 100,A01,083372,Cao; Yingjun,0,15,40,40
1649902772375,CSE 101,A01,084011,Staff,1,45,40,39
1649902778398,CSE 141,A01,083374,Eldon; John,1,49,75,74
1649902784435,CSE 141L,A01,083376,Eldon; John,1,53,75,74
1649902790463,CSE 175,A01,084013,Kumar; Rakesh,22,0,25,3
1649902796492,CSE 190,A00,092508,Dubnov; Shlomo,15,0,15,0
1649902802516,ECE 5,A01,084049,Morris; Karcher William,16,0,20,4
1649902808545,ECE 100,A01,084051,Baghdadchi; Saharnaz,4,0,20,16
1649902808545,ECE 100,A02,091916,Baghdadchi; Saharnaz,18,0,20,2
1649902814571,ECE 101,A01,084053,Baghdadchi; Saharnaz,8,0,37,29
1649902814571,ECE 101,A02,084054,Baghdadchi; Saharnaz,37,0,37,0
1649902820596,ECE 107,A01,083390,Staff,29,0,40,11
1649902826627,ECE 148,A01,084056,Silberman; Jack,7,0,12,5
1649902832653,ECE 180,A00,083391,Abi Samra; Nicholas Camill,25,0,30,5
1649902832653,ECE 180,B00,083392,Abi Samra; Nicholas Camill,22,0,30,8
1649902838677,MATH 10B,A01,084110,Staff,10,0,30,20
1649902838677,MATH 10B,A02,084111,Staff,29,0,30,1
1649902838677,MATH 10B,A03,084112,Staff,28,0,30,2
1649902844714,MATH 10C,A01,083443,Staff,10,0,30,20
1649902844714,MATH 10C,A02,083444,Staff,17,0,30,13
1649902844714,MATH 10C,B01,084114,Staff,25,0,30,5
1649902844714,MATH 10C,B02,084115,Staff,30,0,30,0
1649902850749,MATH 18,A01,084117,Harel; Guershon,27,0,30,3
1649902850749,MATH 18,A02,084119,Harel; Guershon,29,0,30,1
1649902850749,MATH 18,A03,084120,Harel; Guershon,30,0,30,0
1649902850749,MATH 18,A04,084121,Harel; Guershon,29,0,30,1
1649902856777,MATH 20B,A01,084124,Um; Ko Woon,31,0,35,4
1649902856777,MATH 20B,B01,084126,Um; Ko Woon,33,0,35,2
1649902862800,MATH 20C,A01,083446,Hammock; Frances H,19,0,30,11
1649902862800,MATH 20C,A02,083447,Hammock; Frances H,28,0,30,2
1649902862800,MATH 20C,A03,083448,Hammock; Frances H,30,0,30,0
1649902862800,MATH 20C,A04,083449,Hammock; Frances H,30,0,30,0
1649902862800,MATH 20C,B01,083451,Hammock; Frances H,26,0,30,4
1649902862800,MATH 20C,B02,083452,Hammock; Frances H,29,0,30,1
1649902862800,MATH 20C,B03,083453,Hammock; Frances H,27,0,30,3
1649902862800,MATH 20C,B04,083454,Hammock; Frances H,30,0,30,0
1649902868828,MATH 20D,A01,084128,Staff,29,0,30,1
1649902868828,MATH 20D,A02,084129,Staff,30,0,30,0
1649902868828,MATH 20D,A03,084130,Staff,29,0,30,1
1649902868828,MATH 20D,B01,084133,Staff,25,0,30,5
1649902868828,MATH 20D,B02,084134,Staff,27,0,30,3
1649902868828,MATH 20D,B03,084135,Staff,30,0,30,0
1649902874859,MATH 20E,A01,084138,Staff,24,0,30,6
1649902874859,MATH 20E,A02,084139,Staff,24,0,30,6
1649902874859,MATH 20E,A03,084140,Staff,24,0,30,6
1649902874859,MATH 20E,A04,084141,Staff,27,0,30,3
1649902880887,MATH 102,A01,084143,Harel; Guershon,20,0,30,10
1649902880887,MATH 102,A02,084144,Harel; Guershon,22,0,30,8
1649902886914,MATH 103B,A01,083456,Staff,0,8,30,30
1649902886914,MATH 103B,A02,083457,Staff,0,7,30,30
1649902892938,MATH 109,A01,084146,Salehi Golsefidy; Alireza,29,0,30,1
1649902892938,MATH 109,A02,084147,Salehi Golsefidy; Alireza,23,0,30,7
1649902898966,MATH 120A,A01,085445,Eggers; John Dietrich,20,0,35,15
1649902898966,MATH 120A,A02,085446,Eggers; John Dietrich,28,0,35,7
1649902904995,MATH 142B,A01,084149,Verstraete; Jacques Allan,0,6,30,30
1649902904995,MATH 142B,A02,084150,Verstraete; Jacques Allan,0,5,30,30
1649902911023,MATH 170A,A01,083459,Nie; Jiawang,0,1,30,30
1649902911023,MATH 170A,A02,083460,Nie; Jiawang,5,0,30,25
1649902911023,MATH 170A,A03,083461,Nie; Jiawang,19,0,30,11
1649902917046,MATH 193B,A01,083463,Staff,6,0,30,24
1649902917046,MATH 193B,A02,083464,Staff,12,0,30,18
1649902917046,MATH 193B,A03,083465,Staff,21,0,30,9
1649902923097,COGS 2,A01,083966,Boyle; Mary E. T.,19,0,30,11
1649902929122,COGS 9,A01,083968,Staff,43,0,60,17
1649902935153,COGS 14B,A01,083970,Staff,34,0,50,16
1649902941266,COGS 17,A01,092679,Staff,68,0,75,7
1649902947292,COGS 100,A01,083972,Staff,24,0,60,36
1649902959346,COGS 101C,A01,083976,Staff,20,0,30,10
1649902965376,COGS 102A,A01,083978,Johnson; Christine M.,18,0,30,12
1649902971399,COGS 107B,A01,083980,Staff,8,0,50,42
1649902977423,COGS 115,A01,083982,Staff,13,0,30,17
1649902983451,COGS 118B,A01,083367,Staff,0,10,40,40
1649902989477,COGS 172,A01,083984,Provenzano; Emily Kara,17,0,30,13
1649902995499,COGS 177,A00,083368,Staff,1,16,30,29
1649903001526,COGS 186,A01,083986,Staff,22,0,40,18
1649903007552,COGS 187A,A01,083988,Boyle; Mary E. T.,24,0,60,36
1649903013582,CSE 8A,A50,084003,Miranda; Gregory Joseph,2,0,15,13
1649903019605,CSE 11,A01,084005,Miranda; Gregory Joseph,29,0,55,26
1649903025632,CSE 20,A01,084007,Staff,9,0,20,11
1649903031660,CSE 21,A01,084009,Staff,15,0,50,35
1649903037687,CSE 30,A01,083370,Cao; Yingjun,0,12,40,40
1649903043719,CSE 100,A01,083372,Cao; Yingjun,0,15,40,40
1649903049753,CSE 101,A01,084011,Staff,1,45,40,39
1649903055779,CSE 141,A01,083374,Eldon; John,1,49,75,74
1649903061810,CSE 141L,A01,083376,Eldon; John,1,53,75,74
1649903067836,CSE 175,A01,084013,Kumar; Rakesh,22,0,25,3
1649903073860,CSE 190,A00,092508,Dubnov; Shlomo,15,0,15,0
1649903079886,ECE 5,A01,084049,Morris; Karcher William,16,0,20,4
1649903085917,ECE 100,A01,084051,Baghdadchi; Saharnaz,4,0,20,16
1649903085917,ECE 100,A02,091916,Baghdadchi; Saharnaz,18,0,20,2
1649903091944,ECE 101,A01,084053,Baghdadchi; Saharnaz,8,0,37,29
1649903091944,ECE 101,A02,084054,Baghdadchi; Saharnaz,37,0,37,0
1649903097966,ECE 107,A01,083390,Staff,29,0,40,11
1649903103994,ECE 148,A01,084056,Silberman; Jack,7,0,12,5
1649903110021,ECE 180,A00,083391,Abi Samra; Nicholas Camill,25,0,30,5
1649903110021,ECE 180,B00,083392,Abi Samra; Nicholas Camill,22,0,30,8
1649903116047,MATH 10B,A01,084110,Staff,10,0,30,20
1649903116047,MATH 10B,A02,084111,Staff,29,0,30,1
1649903116047,MATH 10B,A03,084112,Staff,28,0,30,2
1649903122073,MATH 10C,A01,083443,Staff,10,0,30,20
1649903122073,MATH 10C,A02,083444,Staff,17,0,30,13
1649903122073,MATH 10C,B01,084114,Staff,25,0,30,5
1649903122073,MATH 10C,B02,084115,Staff,29,0,30,1
1649903128101,MATH 18,A01,084117,Harel; Guershon,27,0,30,3
1649903128101,MATH 18,A02,084119,Harel; Guershon,29,0,30,1
1649903128101,MATH 18,A03,084120,Harel; Guershon,30,0,30,0
1649903128101,MATH 18,A04,084121,Harel; Guershon,29,0,30,1
1649903134130,MATH 20B,A01,084124,Um; Ko Woon,31,0,35,4
1649903134130,MATH 20B,B01,084126,Um; Ko Woon,33,0,35,2
1649903140161,MATH 20C,A01,083446,Hammock; Frances H,18,0,30,12
1649903140161,MATH 20C,A02,083447,Hammock; Frances H,28,0,30,2
1649903140161,MATH 20C,A03,083448,Hammock; Frances H,30,0,30,0
1649903140161,MATH 20C,A04,083449,Hammock; Frances H,30,0,30,0
1649903140161,MATH 20C,B01,083451,Hammock; Frances H,26,0,30,4
1649903140161,MATH 20C,B02,083452,Hammock; Frances H,29,0,30,1
1649903140161,MATH 20C,B03,083453,Hammock; Frances H,27,0,30,3
1649903140161,MATH 20C,B04,083454,Hammock; Frances H,30,0,30,0
1649903146185,MATH 20D,A01,084128,Staff,29,0,30,1
1649903146185,MATH 20D,A02,084129,Staff,30,0,30,0
1649903146185,MATH 20D,A03,084130,Staff,29,0,30,1
1649903146185,MATH 20D,B01,084133,Staff,25,0,30,5
1649903146185,MATH 20D,B02,084134,Staff,27,0,30,3
1649903146185,MATH 20D,B03,084135,Staff,30,0,30,0
1649903152214,MATH 20E,A01,084138,Staff,24,0,30,6
1649903152214,MATH 20E,A02,084139,Staff,24,0,30,6
1649903152214,MATH 20E,A03,084140,Staff,24,0,30,6
1649903152214,MATH 20E,A04,084141,Staff,27,0,30,3
1649903158248,MATH 102,A01,084143,Harel; Guershon,20,0,30,10
1649903158248,MATH 102,A02,084144,Harel; Guershon,22,0,30,8
1649903164270,MATH 103B,A01,083456,Staff,0,8,30,30
1649903164270,MATH 103B,A02,083457,Staff,0,7,30,30
1649903170293,MATH 109,A01,084146,Salehi Golsefidy; Alireza,29,0,30,1
1649903170293,MATH 109,A02,084147,Salehi Golsefidy; Alireza,23,0,30,7
1649903176324,MATH 120A,A01,085445,Eggers; John Dietrich,20,0,35,15
1649903176324,MATH 120A,A02,085446,Eggers; John Dietrich,28,0,35,7
1649903182348,MATH 142B,A01,084149,Verstraete; Jacques Allan,0,6,30,30
1649903182348,MATH 142B,A02,084150,Verstraete; Jacques Allan,0,5,30,30
1649903188376,MATH 170A,A01,083459,Nie; Jiawang,0,1,30,30
1649903188376,MATH 170A,A02,083460,Nie; Jiawang,6,0,30,24
1649903188376,MATH 170A,A03,083461,Nie; Jiawang,19,0,30,11
1649903194406,MATH 193B,A01,083463,Staff,6,0,30,24
1649903194406,MATH 193B,A02,083464,Staff,12,0,30,18
1649903194406,MATH 193B,A03,083465,Staff,21,0,30,9
1649903200466,COGS 2,A01,083966,Boyle; Mary E. T.,19,0,30,11
1649903206490,COGS 9,A01,083968,Staff,43,0,60,17
1649903212515,COGS 14B,A01,083970,Staff,34,0,50,16
1649903218541,COGS 17,A01,092679,Staff,68,0,75,7
1649903224567,COGS 100,A01,083972,Staff,24,0,60,36
1649903236617,COGS 101C,A01,083976,Staff,20,0,30,10
1649903242649,COGS 102A,A01,083978,Johnson; Christine M.,18,0,30,12
1649903248676,COGS 107B,A01,083980,Staff,8,0,50,42
1649903254701,COGS 115,A01,083982,Staff,13,0,30,17
1649903260730,COGS 118B,A01,083367,Staff,0,10,40,40
1649903266754,COGS 172,A01,083984,Provenzano; Emily Kara,17,0,30,13
1649903272781,COGS 177,A00,083368,Staff,1,16,30,29
1649903278804,COGS 186,A01,083986,Staff,22,0,40,18
1649903284827,COGS 187A,A01,083988,Boyle; Mary E. T.,24,0,60,36
1649903290855,CSE 8A,A50,084003,Miranda; Gregory Joseph,2,0,15,13
1649903296881,CSE 11,A01,084005,Miranda; Gregory Joseph,28,0,55,27
1649903302904,CSE 20,A01,084007,Staff,9,0,20,11
1649903308927,CSE 21,A01,084009,Staff,15,0,50,35
1649903314951,CSE 30,A01,083370,Cao; Yingjun,0,12,40,40
1649903320977,CSE 100,A01,083372,Cao; Yingjun,0,15,40,40
1649903327001,CSE 101,A01,084011,Staff,1,45,40,39
1649903333022,CSE 141,A01,083374,Eldon; John,1,49,75,74
1649903339049,CSE 141L,A01,083376,Eldon; John,1,53,75,74
1649903345072,CSE 175,A01,084013,Kumar; Rakesh,22,0,25,3
1649903351100,CSE 190,A00,092508,Dubnov; Shlomo,15,0,15,0
1649903357128,ECE 5,A01,084049,Morris; Karcher William,16,0,20,4
1649903363164,ECE 100,A01,084051,Baghdadchi; Saharnaz,4,0,20,16
1649903363164,ECE 100,A02,091916,Baghdadchi; Saharnaz,18,0,20,2
1649903369187,ECE 101,A01,084053,Baghdadchi; Saharnaz,8,0,37,29
1649903369187,ECE 101,A02,084054,Baghdadchi; Saharnaz,37,0,37,0
1649903375216,ECE 107,A01,083390,Staff,29,0,40,11
1649903381242,ECE 148,A01,084056,Silberman; Jack,7,0,12,5
1649903387266,ECE 180,A00,083391,Abi Samra; Nicholas Camill,25,0,30,5
1649903387266,ECE 180,B00,083392,Abi Samra; Nicholas Camill,22,0,30,8
1649903393288,MATH 10B,A01,084110,Staff,10,0,30,20
1649903393288,MATH 10B,A02,084111,Staff,29,0,30,1
1649903393288,MATH 10B,A03,084112,Staff,28,0,30,2
1649903399316,MATH 10C,A01,083443,Staff,10,0,30,20
1649903399316,MATH 10C,A02,083444,Staff,17,0,30,13
1649903399316,MATH 10C,B01,084114,Staff,25,0,30,5
1649903399316,MATH 10C,B02,084115,Staff,29,0,30,1
1649903405350,MATH 18,A01,084117,Harel; Guershon,27,0,30,3
1649903405350,MATH 18,A02,084119,Harel; Guershon,29,0,30,1
1649903405350,MATH 18,A03,084120,Harel; Guershon,30,0,30,0
1649903405350,MATH 18,A04,084121,Harel; Guershon,29,0,30,1
1649903411377,MATH 20B,A01,084124,Um; Ko Woon,31,0,35,4
1649903411377,MATH 20B,B01,084126,Um; Ko Woon,33,0,35,2
1649903417409,MATH 20C,A01,083446,Hammock; Frances H,18,0,30,12
1649903417409,MATH 20C,A02,083447,Hammock; Frances H,28,0,30,2
1649903417409,MATH 20C,A03,083448,Hammock; Frances H,30,0,30,0
1649903417409,MATH 20C,A04,083449,Hammock; Frances H,30,0,30,0
1649903417409,MATH 20C,B01,083451,Hammock; Frances H,26,0,30,4
1649903417409,MATH 20C,B02,083452,Hammock; Frances H,29,0,30,1
1649903417409,MATH 20C,B03,083453,Hammock; Frances H,27,0,30,3
1649903417409,MATH 20C,B04,083454,Hammock; Frances H,30,0,30,0
1649903423437,MATH 20D,A01,084128,Staff,28,0,30,2
1649903423437,MATH 20D,A02,084129,Staff,30,0,30,0
1649903423437,MATH 20D,A03,084130,Staff,29,0,30,1
1649903423437,MATH 20D,B01,084133,Staff,25,0,30,5
1649903423437,MATH 20D,B02,084134,Staff,27,0,30,3
1649903423437,MATH 20D,B03,084135,Staff,30,0,30,0
1649903429460,MATH 20E,A01,084138,Staff,24,0,30,6
1649903429460,MATH 20E,A02,084139,Staff,24,0,30,6
1649903429460,MATH 20E,A03,084140,Staff,24,0,30,6
1649903429460,MATH 20E,A04,084141,Staff,27,0,30,3
1649903435487,MATH 102,A01,084143,Harel; Guershon,20,0,30,10
1649903435487,MATH 102,A02,084144,Harel; Guershon,22,0,30,8
1649903441510,MATH 103B,A01,083456,Staff,0,8,30,30
1649903441510,MATH 103B,A02,083457,Staff,0,7,30,30
1649903447532,MATH 109,A01,084146,Salehi Golsefidy; Alireza,29,0,30,1
1649903447532,MATH 109,A02,084147,Salehi Golsefidy; Alireza,23,0,30,7
1649903453555,MATH 120A,A01,085445,Eggers; John Dietrich,20,0,35,15
1649903453555,MATH 120A,A02,085446,Eggers; John Dietrich,28,0,35,7
1649903459581,MATH 142B,A01,084149,Verstraete; Jacques Allan,0,6,30,30
1649903459581,MATH 142B,A02,084150,Verstraete; Jacques Allan,0,6,30,30
1649903465605,MATH 170A,A01,083459,Nie; Jiawang,0,1,30,30
1649903465605,MATH 170A,A02,083460,Nie; Jiawang,6,0,30,24
1649903465605,MATH 170A,A03,083461,Nie; Jiawang,19,0,30,11
1649903471629,MATH 193B,A01,083463,Staff,6,0,30,24
1649903471629,MATH 193B,A02,083464,Staff,12,0,30,18
1649903471629,MATH 193B,A03,083465,Staff,21,0,30,9
1649903477685,COGS 2,A01,083966,Boyle; Mary E. T.,19,0,30,11
1649903483711,COGS 9,A01,083968,Staff,43,0,60,17
1649903489734,COGS 14B,A01,083970,Staff,34,0,50,16
1649903495756,COGS 17,A01,092679,Staff,68,0,75,7
1649903501780,COGS 100,A01,083972,Staff,24,0,60,36
1649903513828,COGS 101C,A01,083976,Staff,20,0,30,10
1649903519856,COGS 102A,A01,083978,Johnson; Christine M.,18,0,30,12
1649903525888,COGS 107B,A01,083980,Staff,8,0,50,42
1649903531911,COGS 115,A01,083982,Staff,13,0,30,17
1649903538033,COGS 118B,A01,083367,Staff,0,10,40,40
1649903544066,COGS 172,A01,083984,Provenzano; Emily Kara,17,0,30,13
1649903550093,COGS 177,A00,083368,Staff,1,16,30,29
1649903556119,COGS 186,A01,083986,Staff,22,0,40,18
1649903562148,COGS 187A,A01,083988,Boyle; Mary E. T.,24,0,60,36
1649903568179,CSE 8A,A50,084003,Miranda; Gregory Joseph,2,0,15,13
1649903574206,CSE 11,A01,084005,Miranda; Gregory Joseph,28,0,55,27
1649903580239,CSE 20,A01,084007,Staff,9,0,20,11
1649903586266,CSE 21,A01,084009,Staff,15,0,50,35
1649903592289,CSE 30,A01,083370,Cao; Yingjun,0,12,40,40
1649903598312,CSE 100,A01,083372,Cao; Yingjun,0,15,40,40
1649903604334,CSE 101,A01,084011,Staff,1,45,40,39
1649903610355,CSE 141,A01,083374,Eldon; John,1,49,75,74
1649903616381,CSE 141L,A01,083376,Eldon; John,1,53,75,74
1649903622402,CSE 175,A01,084013,Kumar; Rakesh,22,0,25,3
1649903628431,CSE 190,A00,092508,Dubnov; Shlomo,15,0,15,0
1649903634455,ECE 5,A01,084049,Morris; Karcher William,16,0,20,4
1649903640479,ECE 100,A01,084051,Baghdadchi; Saharnaz,4,0,20,16
1649903640479,ECE 100,A02,091916,Baghdadchi; Saharnaz,18,0,20,2
1649903646502,ECE 101,A01,084053,Baghdadchi; Saharnaz,8,0,37,29
1649903646502,ECE 101,A02,084054,Baghdadchi; Saharnaz,37,0,37,0
1649903652526,ECE 107,A01,083390,Staff,29,0,40,11
1649903658548,ECE 148,A01,084056,Silberman; Jack,7,0,12,5
1649903664570,ECE 180,A00,083391,Abi Samra; Nicholas Camill,25,0,30,5
1649903664570,ECE 180,B00,083392,Abi Samra; Nicholas Camill,22,0,30,8
1649903670609,MATH 10B,A01,084110,Staff,10,0,30,20
1649903670609,MATH 10B,A02,084111,Staff,29,0,30,1
1649903670609,MATH 10B,A03,084112,Staff,28,0,30,2
1649903676633,MATH 10C,A01,083443,Staff,10,0,30,20
1649903676633,MATH 10C,A02,083444,Staff,17,0,30,13
1649903676633,MATH 10C,B01,084114,Staff,25,0,30,5
1649903676633,MATH 10C,B02,084115,Staff,29,0,30,1
1649903682659,MATH 18,A01,084117,Harel; Guershon,27,0,30,3
1649903682659,MATH 18,A02,084119,Harel; Guershon,29,0,30,1
1649903682659,MATH 18,A03,084120,Harel; Guershon,30,0,30,0
1649903682659,MATH 18,A04,084121,Harel; Guershon,29,0,30,1
1649903688683,MATH 20B,A01,084124,Um; Ko Woon,31,0,35,4
1649903688683,MATH 20B,B01,084126,Um; Ko Woon,33,0,35,2
1649903694707,MATH 20C,A01,083446,Hammock; Frances H,18,0,30,12
1649903694707,MATH 20C,A02,083447,Hammock; Frances H,28,0,30,2
1649903694707,MATH 20C,A03,083448,Hammock; Frances H,30,0,30,0
1649903694707,MATH 20C,A04,083449,Hammock; Frances H,30,0,30,0
1649903694707,MATH 20C,B01,083451,Hammock; Frances H,26,0,30,4
1649903694707,MATH 20C,B02,083452,Hammock; Frances H,29,0,30,1
1649903694707,MATH 20C,B03,083453,Hammock; Frances H,27,0,30,3
1649903694707,MATH 20C,B04,083454,Hammock; Frances H,30,0,30,0
1649903700732,MATH 20D,A01,084128,Staff,28,0,30,2
1649903700732,MATH 20D,A02,084129,Staff,30,0,30,0
1649903700732,MATH 20D,A03,084130,Staff,29,0,30,1
1649903700732,MATH 20D,B01,084133,Staff,25,0,30,5
1649903700732,MATH 20D,B02,084134,Staff,27,0,30,3
1649903700732,MATH 20D,B03,084135,Staff,30,0,30,0
1649903706755,MATH 20E,A01,084138,Staff,24,0,30,6
1649903706755,MATH 20E,A02,084139,Staff,24,0,30,6
1649903706755,MATH 20E,A03,084140,Staff,24,0,30,6
1649903706755,MATH 20E,A04,084141,Staff,27,0,30,3
1649903712783,MATH 102,A01,084143,Harel; Guershon,20,0,30,10
1649903712783,MATH 102,A02,084144,Harel; Guershon,22,0,30,8
1649903718808,MATH 103B,A01,083456,Staff,0,8,30,30
1649903718808,MATH 103B,A02,083457,Staff,0,7,30,30
1649903724830,MATH 109,A01,084146,Salehi Golsefidy; Alireza,29,0,30,1
1649903724830,MATH 109,A02,084147,Salehi Golsefidy; Alireza,22,0,30,8
1649903730855,MATH 120A,A01,085445,Eggers; John Dietrich,20,0,35,15
1649903730855,MATH 120A,A02,085446,Eggers; John Dietrich,28,0,35,7
1649903736879,MATH 142B,A01,084149,Verstraete; Jacques Allan,0,6,30,30
1649903736879,MATH 142B,A02,084150,Verstraete; Jacques Allan,0,6,30,30
1649903742909,MATH 170A,A01,083459,Nie; Jiawang,0,1,30,30
1649903742909,MATH 170A,A02,083460,Nie; Jiawang,6,0,30,24
1649903742909,MATH 170A,A03,083461,Nie; Jiawang,19,0,30,11
1649903748937,MATH 193B,A01,083463,Staff,6,0,30,24
1649903748937,MATH 193B,A02,083464,Staff,12,0,30,18
1649903748937,MATH 193B,A03,083465,Staff,21,0,30,9
1649903754985,COGS 2,A01,083966,Boyle; Mary E. T.,19,0,30,11
1649903761009,COGS 9,A01,083968,Staff,43,0,60,17
1649903767036,COGS 14B,A01,083970,Staff,34,0,50,16
1649903773059,COGS 17,A01,092679,Staff,68,0,75,7
1649903779084,COGS 100,A01,083972,Staff,24,0,60,36
1649903791136,COGS 101C,A01,083976,Staff,20,0,30,10
1649903797162,COGS 102A,A01,083978,Johnson; Christine M.,18,0,30,12
1649903803186,COGS 107B,A01,083980,Staff,8,0,50,42
1649903809229,COGS 115,A01,083982,Staff,13,0,30,17
1649903815252,COGS 118B,A01,083367,Staff,0,10,40,40
1649903821279,COGS 172,A01,083984,Provenzano; Emily Kara,17,0,30,13
1649903827305,COGS 177,A00,083368,Staff,1,16,30,29
1649903833327,COGS 186,A01,083986,Staff,22,0,40,18
1649903839353,COGS 187A,A01,083988,Boyle; Mary E. T.,24,0,60,36
1649903845381,CSE 8A,A50,084003,Miranda; Gregory Joseph,1,0,15,14
1649903851404,CSE 11,A01,084005,Miranda; Gregory Joseph,27,0,55,28
1649903857431,CSE 20,A01,084007,Staff,9,0,20,11
1649903863457,CSE 21,A01,084009,Staff,15,0,50,35
1649903869480,CSE 30,A01,083370,Cao; Yingjun,0,13,40,40
1649903875503,CSE 100,A01,083372,Cao; Yingjun,0,16,40,40
1649903881529,CSE 101,A01,084011,Staff,1,45,40,39
1649903887555,CSE 141,A01,083374,Eldon; John,1,49,75,74
1649903893581,CSE 141L,A01,083376,Eldon; John,1,53,75,74
1649903899604,CSE 175,A01,084013,Kumar; Rakesh,22,0,25,3
1649903905628,CSE 190,A00,092508,Dubnov; Shlomo,15,0,15,0
1649903911674,ECE 5,A01,084049,Morris; Karcher William,16,0,20,4
1649903917698,ECE 100,A01,084051,Baghdadchi; Saharnaz,4,0,20,16
1649903917698,ECE 100,A02,091916,Baghdadchi; Saharnaz,18,0,20,2
1649903923722,ECE 101,A01,084053,Baghdadchi; Saharnaz,8,0,37,29
1649903923722,ECE 101,A02,084054,Baghdadchi; Saharnaz,37,0,37,0
1649903929749,ECE 107,A01,083390,Staff,29,0,40,11
1649903935771,ECE 148,A01,084056,Silberman; Jack,7,0,12,5
1649903941798,ECE 180,A00,083391,Abi Samra; Nicholas Camill,25,0,30,5
1649903941798,ECE 180,B00,083392,Abi Samra; Nicholas Camill,22,0,30,8
1649903947826,MATH 10B,A01,084110,Staff,10,0,30,20
1649903947826,MATH 10B,A02,084111,Staff,29,0,30,1
1649903947826,MATH 10B,A03,084112,Staff,28,0,30,2
1649903953849,MATH 10C,A01,083443,Staff,10,0,30,20
1649903953849,MATH 10C,A02,083444,Staff,17,0,30,13
1649903953849,MATH 10C,B01,084114,Staff,25,0,30,5
1649903953849,MATH 10C,B02,084115,Staff,29,0,30,1
1649903959873,MATH 18,A01,084117,Harel; Guershon,27,0,30,3
1649903959873,MATH 18,A02,084119,Harel; Guershon,29,0,30,1
1649903959873,MATH 18,A03,084120,Harel; Guershon,30,0,30,0
1649903959873,MATH 18,A04,084121,Harel; Guershon,29,0,30,1
1649903965900,MATH 20B,A01,084124,Um; Ko Woon,31,0,35,4
1649903965900,MATH 20B,B01,084126,Um; Ko Woon,33,0,35,2
1649903971937,MATH 20C,A01,083446,Hammock; Frances H,18,0,30,12
1649903971937,MATH 20C,A02,083447,Hammock; Frances H,28,0,30,2
1649903971937,MATH 20C,A03,083448,Hammock; Frances H,30,0,30,0
1649903971937,MATH 20C,A04,083449,Hammock; Frances H,30,0,30,0
1649903971937,MATH 20C,B01,083451,Hammock; Frances H,26,0,30,4
1649903971937,MATH 20C,B02,083452,Hammock; Frances H,29,0,30,1
1649903971937,MATH 20C,B03,083453,Hammock; Frances H,27,0,30,3
1649903971937,MATH 20C,B04,083454,Hammock; Frances H,30,0,30,0
1649903977963,MATH 20D,A01,084128,Staff,28,0,30,2
1649903977963,MATH 20D,A02,084129,Staff,30,0,30,0
1649903977963,MATH 20D,A03,084130,Staff,29,0,30,1
1649903977963,MATH 20D,B01,084133,Staff,24,0,30,6
1649903977963,MATH 20D,B02,084134,Staff,27,0,30,3
1649903977963,MATH 20D,B03,084135,Staff,30,0,30,0
1649903983990,MATH 20E,A01,084138,Staff,24,0,30,6
1649903983990,MATH 20E,A02,084139,Staff,24,0,30,6
1649903983990,MATH 20E,A03,084140,Staff,24,0,30,6
1649903983990,MATH 20E,A04,084141,Staff,27,0,30,3
1649903990024,MATH 102,A01,084143,Harel; Guershon,20,0,30,10
1649903990024,MATH 102,A02,084144,Harel; Guershon,22,0,30,8
1649903996051,MATH 103B,A01,083456,Staff,0,8,30,30
1649903996051,MATH 103B,A02,083457,Staff,0,7,30,30
1649904002075,MATH 109,A01,084146,Salehi Golsefidy; Alireza,29,0,30,1
1649904002075,MATH 109,A02,084147,Salehi Golsefidy; Alireza,22,0,30,8
1649904008102,MATH 120A,A01,085445,Eggers; John Dietrich,20,0,35,15
1649904008102,MATH 120A,A02,085446,Eggers; John Dietrich,28,0,35,7
1649904014137,MATH 142B,A01,084149,Verstraete; Jacques Allan,0,6,30,30
1649904014137,MATH 142B,A02,084150,Verstraete; Jacques Allan,0,6,30,30
1649904020165,MATH 170A,A01,083459,Nie; Jiawang,0,1,30,30
1649904020165,MATH 170A,A02,083460,Nie; Jiawang,6,0,30,24
1649904020165,MATH 170A,A03,083461,Nie; Jiawang,19,0,30,11
1649904026187,MATH 193B,A01,083463,Staff,6,0,30,24
1649904026187,MATH 193B,A02,083464,Staff,12,0,30,18
1649904026187,MATH 193B,A03,083465,Staff,21,0,30,9
1649904032237,COGS 2,A01,083966,Boyle; Mary E. T.,19,0,30,11
1649904038263,COGS 9,A01,083968,Staff,43,0,60,17
1649904044290,COGS 14B,A01,083970,Staff,34,0,50,16
1649904050318,COGS 17,A01,092679,Staff,68,0,75,7
1649904056344,COGS 100,A01,083972,Staff,24,0,60,36
1649904068397,COGS 101C,A01,083976,Staff,20,0,30,10
1649904074422,COGS 102A,A01,083978,Johnson; Christine M.,18,0,30,12
1649904080447,COGS 107B,A01,083980,Staff,8,0,50,42
1649904086471,COGS 115,A01,083982,Staff,13,0,30,17
1649904092496,COGS 118B,A01,083367,Staff,0,10,40,40
1649904098527,COGS 172,A01,083984,Provenzano; Emily Kara,17,0,30,13
1649904104554,COGS 177,A00,083368,Staff,1,16,30,29
1649904110582,COGS 186,A01,083986,Staff,22,0,40,18
1649904116605,COGS 187A,A01,083988,Boyle; Mary E. T.,24,0,60,36
1649904122627,CSE 8A,A50,084003,Miranda; Gregory Joseph,1,0,15,14
1649904128651,CSE 11,A01,084005,Miranda; Gregory Joseph,27,0,55,28
1649904134782,CSE 20,A01,084007,Staff,9,0,20,11
1649904140804,CSE 21,A01,084009,Staff,15,0,50,35
1649904146832,CSE 30,A01,083370,Cao; Yingjun,0,13,40,40
1649904152861,CSE 100,A01,083372,Cao; Yingjun,0,16,40,40
1649904158888,CSE 101,A01,084011,Staff,1,46,40,39
1649904164920,CSE 141,A01,083374,Eldon; John,1,49,75,74
1649904170945,CSE 141L,A01,083376,Eldon; John,1,53,75,74
1649904176974,CSE 175,A01,084013,Kumar; Rakesh,22,0,25,3
1649904182999,CSE 190,A00,092508,Dubnov; Shlomo,15,0,15,0
1649904189025,ECE 5,A01,084049,Morris; Karcher William,16,0,20,4
1649904195048,ECE 100,A01,084051,Baghdadchi; Saharnaz,4,0,20,16
1649904195048,ECE 100,A02,091916,Baghdadchi; Saharnaz,18,0,20,2
1649904201071,ECE 101,A01,084053,Baghdadchi; Saharnaz,8,0,37,29
1649904201071,ECE 101,A02,084054,Baghdadchi; Saharnaz,37,0,37,0
1649904207097,ECE 107,A01,083390,Staff,29,0,40,11
1649904213120,ECE 148,A01,084056,Silberman; Jack,7,0,12,5
1649904219154,ECE 180,A00,083391,Abi Samra; Nicholas Camill,25,0,30,5
1649904219154,ECE 180,B00,083392,Abi Samra; Nicholas Camill,22,0,30,8
1649904225180,MATH 10B,A01,084110,Staff,10,0,30,20
1649904225180,MATH 10B,A02,084111,Staff,29,0,30,1
1649904225180,MATH 10B,A03,084112,Staff,28,0,30,2
1649904231209,MATH 10C,A01,083443,Staff,10,0,30,20
1649904231209,MATH 10C,A02,083444,Staff,17,0,30,13
1649904231209,MATH 10C,B01,084114,Staff,25,0,30,5
1649904231209,MATH 10C,B02,084115,Staff,29,0,30,1
1649904237236,MATH 18,A01,084117,Harel; Guershon,27,0,30,3
1649904237236,MATH 18,A02,084119,Harel; Guershon,29,0,30,1
1649904237236,MATH 18,A03,084120,Harel; Guershon,30,0,30,0
1649904237236,MATH 18,A04,084121,Harel; Guershon,29,0,30,1
1649904243260,MATH 20B,A01,084124,Um; Ko Woon,31,0,35,4
1649904243260,MATH 20B,B01,084126,Um; Ko Woon,33,0,35,2
1649904249292,MATH 20C,A01,083446,Hammock; Frances H,18,0,30,12
1649904249292,MATH 20C,A02,083447,Hammock; Frances H,28,0,30,2
1649904249292,MATH 20C,A03,083448,Hammock; Frances H,30,0,30,0
1649904249292,MATH 20C,A04,083449,Hammock; Frances H,30,0,30,0
1649904249292,MATH 20C,B01,083451,Hammock; Frances H,26,0,30,4
1649904249292,MATH 20C,B02,083452,Hammock; Frances H,29,0,30,1
1649904249292,MATH 20C,B03,083453,Hammock; Frances H,27,0,30,3
1649904249292,MATH 20C,B04,083454,Hammock; Frances H,30,0,30,0
1649904255321,MATH 20D,A01,084128,Staff,27,0,30,3
1649904255321,MATH 20D,A02,084129,Staff,30,0,30,0
1649904255321,MATH 20D,A03,084130,Staff,29,0,30,1
1649904255321,MATH 20D,B01,084133,Staff,24,0,30,6
1649904255321,MATH 20D,B02,084134,Staff,27,0,30,3
1649904255321,MATH 20D,B03,084135,Staff,30,0,30,0
1649904261345,MATH 20E,A01,084138,Staff,24,0,30,6
1649904261345,MATH 20E,A02,084139,Staff,24,0,30,6
1649904261345,MATH 20E,A03,084140,Staff,24,0,30,6
1649904261345,MATH 20E,A04,084141,Staff,27,0,30,3
1649904267377,MATH 102,A01,084143,Harel; Guershon,20,0,30,10
1649904267377,MATH 102,A02,084144,Harel; Guershon,22,0,30,8
1649904273407,MATH 103B,A01,083456,Staff,0,8,30,30
1649904273407,MATH 103B,A02,083457,Staff,0,7,30,30
1649904279432,MATH 109,A01,084146,Salehi Golsefidy; Alireza,29,0,30,1
1649904279432,MATH 109,A02,084147,Salehi Golsefidy; Alireza,22,0,30,8
1649904285461,MATH 120A,A01,085445,Eggers; John Dietrich,20,0,35,15
1649904285461,MATH 120A,A02,085446,Eggers; John Dietrich,28,0,35,7
1649904291488,MATH 142B,A01,084149,Verstraete; Jacques Allan,0,6,30,30
1649904291488,MATH 142B,A02,084150,Verstraete; Jacques Allan,0,6,30,30
1649904297512,MATH 170A,A01,083459,Nie; Jiawang,0,1,30,30
1649904297512,MATH 170A,A02,083460,Nie; Jiawang,6,0,30,24
1649904297512,MATH 170A,A03,083461,Nie; Jiawang,19,0,30,11
1649904303551,MATH 193B,A01,083463,Staff,6,0,30,24
1649904303551,MATH 193B,A02,083464,Staff,12,0,30,18
1649904303551,MATH 193B,A03,083465,Staff,21,0,30,9
1649904309602,COGS 2,A01,083966,Boyle; Mary E. T.,19,0,30,11
1649904315637,COGS 9,A01,083968,Staff,43,0,60,17
1649904321663,COGS 14B,A01,083970,Staff,34,0,50,16
1649904327687,COGS 17,A01,092679,Staff,68,0,75,7
1649904333712,COGS 100,A01,083972,Staff,24,0,60,36
1649904345760,COGS 101C,A01,083976,Staff,20,0,30,10
1649904351786,COGS 102A,A01,083978,Johnson; Christine M.,18,0,30,12
1649904357812,COGS 107B,A01,083980,Staff,7,0,50,43
1649904363834,COGS 115,A01,083982,Staff,13,0,30,17
1649904369861,COGS 118B,A01,083367,Staff,0,10,40,40
1649904375882,COGS 172,A01,083984,Provenzano; Emily Kara,17,0,30,13
1649904381909,COGS 177,A00,083368,Staff,1,16,30,29
1649904387935,COGS 186,A01,083986,Staff,22,0,40,18
1649904393959,COGS 187A,A01,083988,Boyle; Mary E. T.,24,0,60,36
1649904399983,CSE 8A,A50,084003,Miranda; Gregory Joseph,1,0,15,14
1649904406008,CSE 11,A01,084005,Miranda; Gregory Joseph,27,0,55,28
1649904412035,CSE 20,A01,084007,Staff,9,0,20,11
1649904418057,CSE 21,A01,084009,Staff,15,0,50,35
1649904424084,CSE 30,A01,083370,Cao; Yingjun,0,13,40,40
1649904430107,CSE 100,A01,083372,Cao; Yingjun,0,16,40,40
1649904436132,CSE 101,A01,084011,Staff,1,46,40,39
1649904442168,CSE 141,A01,083374,Eldon; John,1,49,75,74
1649904448203,CSE 141L,A01,083376,Eldon; John,1,53,75,74
1649904454232,CSE 175,A01,084013,Kumar; Rakesh,22,0,25,3
1649904460257,CSE 190,A00,092508,Dubnov; Shlomo,15,0,15,0
1649904466284,ECE 5,A01,084049,Morris; Karcher William,16,0,20,4
1649904472318,ECE 100,A01,084051,Baghdadchi; Saharnaz,4,0,20,16
1649904472318,ECE 100,A02,091916,Baghdadchi; Saharnaz,18,0,20,2
1649904478345,ECE 101,A01,084053,Baghdadchi; Saharnaz,8,0,37,29
1649904478345,ECE 101,A02,084054,Baghdadchi; Saharnaz,37,0,37,0
1649904484369,ECE 107,A01,083390,Staff,29,0,40,11
1649904490392,ECE 148,A01,084056,Silberman; Jack,7,0,12,5
1649904496421,ECE 180,A00,083391,Abi Samra; Nicholas Camill,25,0,30,5
1649904496421,ECE 180,B00,083392,Abi Samra; Nicholas Camill,22,0,30,8
1649904502453,MATH 10B,A01,084110,Staff,10,0,30,20
1649904502453,MATH 10B,A02,084111,Staff,29,0,30,1
1649904502453,MATH 10B,A03,084112,Staff,28,0,30,2
1649904508478,MATH 10C,A01,083443,Staff,10,0,30,20
1649904508478,MATH 10C,A02,083444,Staff,17,0,30,13
1649904508478,MATH 10C,B01,084114,Staff,25,0,30,5
1649904508478,MATH 10C,B02,084115,Staff,29,0,30,1
1649904514504,MATH 18,A01,084117,Harel; Guershon,27,0,30,3
1649904514504,MATH 18,A02,084119,Harel; Guershon,29,0,30,1
1649904514504,MATH 18,A03,084120,Harel; Guershon,30,0,30,0
1649904514504,MATH 18,A04,084121,Harel; Guershon,29,0,30,1
1649904520528,MATH 20B,A01,084124,Um; Ko Woon,31,0,35,4
1649904520528,MATH 20B,B01,084126,Um; Ko Woon,33,0,35,2
1649904526566,MATH 20C,A01,083446,Hammock; Frances H,18,0,30,12
1649904526566,MATH 20C,A02,083447,Hammock; Frances H,28,0,30,2
1649904526566,MATH 20C,A03,083448,Hammock; Frances H,30,0,30,0
1649904526566,MATH 20C,A04,083449,Hammock; Frances H,30,0,30,0
1649904526566,MATH 20C,B01,083451,Hammock; Frances H,26,0,30,4
1649904526566,MATH 20C,B02,083452,Hammock; Frances H,29,0,30,1
1649904526566,MATH 20C,B03,083453,Hammock; Frances H,27,0,30,3
1649904526566,MATH 20C,B04,083454,Hammock; Frances H,30,0,30,0
1649904532590,MATH 20D,A01,084128,Staff,27,0,30,3
1649904532590,MATH 20D,A02,084129,Staff,30,0,30,0
1649904532590,MATH 20D,A03,084130,Staff,29,0,30,1
1649904532590,MATH 20D,B01,084133,Staff,24,0,30,6
1649904532590,MATH 20D,B02,084134,Staff,27,0,30,3
1649904532590,MATH 20D,B03,084135,Staff,30,0,30,0
1649904538617,MATH 20E,A01,084138,Staff,24,0,30,6
1649904538617,MATH 20E,A02,084139,Staff,24,0,30,6
1649904538617,MATH 20E,A03,084140,Staff,24,0,30,6
1649904538617,MATH 20E,A04,084141,Staff,27,0,30,3
1649904544640,MATH 102,A01,084143,Harel; Guershon,20,0,30,10
1649904544640,MATH 102,A02,084144,Harel; Guershon,22,0,30,8
1649904550662,MATH 103B,A01,083456,Staff,0,8,30,30
1649904550662,MATH 103B,A02,083457,Staff,0,7,30,30
1649904556688,MATH 109,A01,084146,Salehi Golsefidy; Alireza,29,0,30,1
1649904556688,MATH 109,A02,084147,Salehi Golsefidy; Alireza,22,0,30,8
1649904562714,MATH 120A,A01,085445,Eggers; John Dietrich,20,0,35,15
1649904562714,MATH 120A,A02,085446,Eggers; John Dietrich,28,0,35,7
1649904568742,MATH 142B,A01,084149,Verstraete; Jacques Allan,0,6,30,30
1649904568742,MATH 142B,A02,084150,Verstraete; Jacques Allan,0,6,30,30
1649904574764,MATH 170A,A01,083459,Nie; Jiawang,0,1,30,30
1649904574764,MATH 170A,A02,083460,Nie; Jiawang,5,0,30,25
1649904574764,MATH 170A,A03,083461,Nie; Jiawang,19,0,30,11
1649904580790,MATH 193B,A01,083463,Staff,6,0,30,24
1649904580790,MATH 193B,A02,083464,Staff,12,0,30,18
1649904580790,MATH 193B,A03,083465,Staff,21,0,30,9
1649904586857,COGS 2,A01,083966,Boyle; Mary E. T.,19,0,30,11
1649904592881,COGS 9,A01,083968,Staff,43,0,60,17
1649904598931,COGS 14B,A01,083970,Staff,34,0,50,16
1649904604954,COGS 17,A01,092679,Staff,68,0,75,7
1649904610979,COGS 100,A01,083972,Staff,24,0,60,36
1649904623040,COGS 101C,A01,083976,Staff,20,0,30,10
1649904629063,COGS 102A,A01,083978,Johnson; Christine M.,18,0,30,12
1649904635090,COGS 107B,A01,083980,Staff,7,0,50,43
1649904641117,COGS 115,A01,083982,Staff,13,0,30,17
1649904647141,COGS 118B,A01,083367,Staff,0,10,40,40
1649904653167,COGS 172,A01,083984,Provenzano; Emily Kara,17,0,30,13
1649904659198,COGS 177,A00,083368,Staff,1,16,30,29
1649904665231,COGS 186,A01,083986,Staff,22,0,40,18
1649904671257,COGS 187A,A01,083988,Boyle; Mary E. T.,24,0,60,36
1649904677285,CSE 8A,A50,084003,Miranda; Gregory Joseph,2,0,15,13
1649904683308,CSE 11,A01,084005,Miranda; Gregory Joseph,27,0,55,28
1649904689335,CSE 20,A01,084007,Staff,9,0,20,11
1649904695360,CSE 21,A01,084009,Staff,15,0,50,35
1649904701387,CSE 30,A01,083370,Cao; Yingjun,0,13,40,40
1649904707414,CSE 100,A01,083372,Cao; Yingjun,0,16,40,40
1649904713437,CSE 101,A01,084011,Staff,1,46,40,39
1649904719463,CSE 141,A01,083374,Eldon; John,1,49,75,74
1649904725488,CSE 141L,A01,083376,Eldon; John,1,53,75,74
1649904731601,CSE 175,A01,084013,Kumar; Rakesh,22,0,25,3
1649904737628,CSE 190,A00,092508,Dubnov; Shlomo,15,0,15,0
1649904743663,ECE 5,A01,084049,Morris; Karcher William,16,0,20,4
1649904749685,ECE 100,A01,084051,Baghdadchi; Saharnaz,3,0,20,17
1649904749685,ECE 100,A02,091916,Baghdadchi; Saharnaz,18,0,20,2
1649904755716,ECE 101,A01,084053,Baghdadchi; Saharnaz,7,0,37,30
1649904755716,ECE 101,A02,084054,Baghdadchi; Saharnaz,37,0,37,0
1649904761742,ECE 107,A01,083390,Staff,28,0,40,12
1649904767774,ECE 148,A01,084056,Silberman; Jack,7,0,12,5
1649904773805,ECE 180,A00,083391,Abi Samra; Nicholas Camill,25,0,30,5
1649904773805,ECE 180,B00,083392,Abi Samra; Nicholas Camill,22,0,30,8
1649904779828,MATH 10B,A01,084110,Staff,10,0,30,20
1649904779828,MATH 10B,A02,084111,Staff,29,0,30,1
1649904779828,MATH 10B,A03,084112,Staff,28,0,30,2
1649904785852,MATH 10C,A01,083443,Staff,10,0,30,20
1649904785852,MATH 10C,A02,083444,Staff,17,0,30,13
1649904785852,MATH 10C,B01,084114,Staff,25,0,30,5
1649904785852,MATH 10C,B02,084115,Staff,29,0,30,1
1649904791877,MATH 18,A01,084117,Harel; Guershon,27,0,30,3
1649904791877,MATH 18,A02,084119,Harel; Guershon,29,0,30,1
1649904791877,MATH 18,A03,084120,Harel; Guershon,30,0,30,0
1649904791877,MATH 18,A04,084121,Harel; Guershon,29,0,30,1
1649904797905,MATH 20B,A01,084124,Um; Ko Woon,31,0,35,4
1649904797905,MATH 20B,B01,084126,Um; Ko Woon,33,0,35,2
1649904803929,MATH 20C,A01,083446,Hammock; Frances H,18,0,30,12
1649904803929,MATH 20C,A02,083447,Hammock; Frances H,28,0,30,2
1649904803929,MATH 20C,A03,083448,Hammock; Frances H,30,0,30,0
1649904803929,MATH 20C,A04,083449,Hammock; Frances H,30,0,30,0
1649904803929,MATH 20C,B01,083451,Hammock; Frances H,26,0,30,4
1649904803929,MATH 20C,B02,083452,Hammock; Frances H,29,0,30,1
1649904803929,MATH 20C,B03,083453,Hammock; Frances H,27,0,30,3
1649904803929,MATH 20C,B04,083454,Hammock; Frances H,30,0,30,0
1649904809959,MATH 20D,A01,084128,Staff,27,0,30,3
1649904809959,MATH 20D,A02,084129,Staff,30,0,30,0
1649904809959,MATH 20D,A03,084130,Staff,29,0,30,1
1649904809959,MATH 20D,B01,084133,Staff,24,0,30,6
1649904809959,MATH 20D,B02,084134,Staff,27,0,30,3
1649904809959,MATH 20D,B03,084135,Staff,30,0,30,0
1649904815992,MATH 20E,A01,084138,Staff,24,0,30,6
1649904815992,MATH 20E,A02,084139,Staff,24,0,30,6
1649904815992,MATH 20E,A03,084140,Staff,24,0,30,6
1649904815992,MATH 20E,A04,084141,Staff,27,0,30,3
1649904822019,MATH 102,A01,084143,Harel; Guershon,20,0,30,10
1649904822019,MATH 102,A02,084144,Harel; Guershon,22,0,30,8
1649904828048,MATH 103B,A01,083456,Staff,0,8,30,30
1649904828048,MATH 103B,A02,083457,Staff,0,7,30,30
1649904834078,MATH 109,A01,084146,Salehi Golsefidy; Alireza,29,0,30,1
1649904834078,MATH 109,A02,084147,Salehi Golsefidy; Alireza,22,0,30,8
1649904840103,MATH 120A,A01,085445,Eggers; John Dietrich,20,0,35,15
1649904840103,MATH 120A,A02,085446,Eggers; John Dietrich,28,0,35,7
1649904846125,MATH 142B,A01,084149,Verstraete; Jacques Allan,0,7,30,30
1649904846125,MATH 142B,A02,084150,Verstraete; Jacques Allan,0,6,30,30
1649904852147,MATH 170A,A01,083459,Nie; Jiawang,0,1,30,30
1649904852147,MATH 170A,A02,083460,Nie; Jiawang,5,0,30,25
1649904852147,MATH 170A,A03,083461,Nie; Jiawang,19,0,30,11
1649904858169,MATH 193B,A01,083463,Staff,6,0,30,24
1649904858169,MATH 193B,A02,083464,Staff,12,0,30,18
1649904858169,MATH 193B,A03,083465,Staff,20,0,30,10
1649904864216,COGS 2,A01,083966,Boyle; Mary E. T.,19,0,30,11
1649904870239,COGS 9,A01,083968,Staff,43,0,60,17
1649904876265,COGS 14B,A01,083970,Staff,33,0,50,17
1649904882292,COGS 17,A01,092679,Staff,68,0,75,7
1649904888314,COGS 100,A01,083972,Staff,23,0,60,37
1649904900366,COGS 101C,A01,083976,Staff,20,0,30,10
1649904906398,COGS 102A,A01,083978,Johnson; Christine M.,18,0,30,12
1649904912421,COGS 107B,A01,083980,Staff,7,0,50,43
1649904918444,COGS 115,A01,083982,Staff,13,0,30,17
1649904924471,COGS 118B,A01,083367,Staff,0,10,40,40
1649904930494,COGS 172,A01,083984,Provenzano; Emily Kara,17,0,30,13
1649904936519,COGS 177,A00,083368,Staff,1,16,30,29
1649904942545,COGS 186,A01,083986,Staff,22,0,40,18
1649904948569,COGS 187A,A01,083988,Boyle; Mary E. T.,24,0,60,36
1649904954593,CSE 8A,A50,084003,Miranda; Gregory Joseph,2,0,15,13
1649904960618,CSE 11,A01,084005,Miranda; Gregory Joseph,27,0,55,28
1649904966650,CSE 20,A01,084007,Staff,9,0,20,11
1649904972677,CSE 21,A01,084009,Staff,15,0,50,35
1649904978704,CSE 30,A01,083370,Cao; Yingjun,0,13,40,40
1649904984726,CSE 100,A01,083372,Cao; Yingjun,0,16,40,40
1649904990756,CSE 101,A01,084011,Staff,1,46,40,39
1649904996789,CSE 141,A01,083374,Eldon; John,1,49,75,74
1649905002820,CSE 141L,A01,083376,Eldon; John,1,53,75,74
1649905008849,CSE 175,A01,084013,Kumar; Rakesh,22,0,25,3
1649905014872,CSE 190,A00,092508,Dubnov; Shlomo,15,0,15,0
1649905020902,ECE 5,A01,084049,Morris; Karcher William,16,0,20,4
1649905026950,ECE 100,A01,084051,Baghdadchi; Saharnaz,2,0,20,18
1649905026950,ECE 100,A02,091916,Baghdadchi; Saharnaz,18,0,20,2
1649905032980,ECE 101,A01,084053,Baghdadchi; Saharnaz,7,0,37,30
1649905032980,ECE 101,A02,084054,Baghdadchi; Saharnaz,37,0,37,0
1649905039008,ECE 107,A01,083390,Staff,29,0,40,11
1649905045055,ECE 148,A01,084056,Silberman; Jack,7,0,12,5
1649905051082,ECE 180,A00,083391,Abi Samra; Nicholas Camill,25,0,30,5
1649905051082,ECE 180,B00,083392,Abi Samra; Nicholas Camill,22,0,30,8
1649905057109,MATH 10B,A01,084110,Staff,10,0,30,20
1649905057109,MATH 10B,A02,084111,Staff,29,0,30,1
1649905057109,MATH 10B,A03,084112,Staff,28,0,30,2
1649905063130,MATH 10C,A01,083443,Staff,9,0,30,21
1649905063130,MATH 10C,A02,083444,Staff,17,0,30,13
1649905063130,MATH 10C,B01,084114,Staff,25,0,30,5
1649905063130,MATH 10C,B02,084115,Staff,29,0,30,1
1649905069157,MATH 18,A01,084117,Harel; Guershon,27,0,30,3
1649905069157,MATH 18,A02,084119,Harel; Guershon,29,0,30,1
1649905069157,MATH 18,A03,084120,Harel; Guershon,30,0,30,0
1649905069157,MATH 18,A04,084121,Harel; Guershon,29,0,30,1
1649905075189,MATH 20B,A01,084124,Um; Ko Woon,31,0,35,4
1649905075189,MATH 20B,B01,084126,Um; Ko Woon,33,0,35,2
1649905081214,MATH 20C,A01,083446,Hammock; Frances H,18,0,30,12
1649905081214,MATH 20C,A02,083447,Hammock; Frances H,28,0,30,2
1649905081214,MATH 20C,A03,083448,Hammock; Frances H,30,0,30,0
1649905081214,MATH 20C,A04,083449,Hammock; Frances H,30,0,30,0
1649905081214,MATH 20C,B01,083451,Hammock; Frances H,26,0,30,4
1649905081214,MATH 20C,B02,083452,Hammock; Frances H,29,0,30,1
1649905081214,MATH 20C,B03,083453,Hammock; Frances H,27,0,30,3
1649905081214,MATH 20C,B04,083454,Hammock; Frances H,30,0,30,0
1649905087238,MATH 20D,A01,084128,Staff,27,0,30,3
1649905087238,MATH 20D,A02,084129,Staff,30,0,30,0
1649905087238,MATH 20D,A03,084130,Staff,29,0,30,1
1649905087238,MATH 20D,B01,084133,Staff,24,0,30,6
1649905087238,MATH 20D,B02,084134,Staff,27,0,30,3
1649905087238,MATH 20D,B03,084135,Staff,30,0,30,0
1649905093264,MATH 20E,A01,084138,Staff,24,0,30,6
1649905093264,MATH 20E,A02,084139,Staff,24,0,30,6
1649905093264,MATH 20E,A03,084140,Staff,24,0,30,6
1649905093264,MATH 20E,A04,084141,Staff,27,0,30,3
1649905099286,MATH 102,A01,084143,Harel; Guershon,20,0,30,10
1649905099286,MATH 102,A02,084144,Harel; Guershon,22,0,30,8
1649905105316,MATH 103B,A01,083456,Staff,0,8,30,30
1649905105316,MATH 103B,A02,083457,Staff,0,7,30,30
1649905111343,MATH 109,A01,084146,Salehi Golsefidy; Alireza,29,0,30,1
1649905111343,MATH 109,A02,084147,Salehi Golsefidy; Alireza,22,0,30,8
1649905117371,MATH 120A,A01,085445,Eggers; John Dietrich,20,0,35,15
1649905117371,MATH 120A,A02,085446,Eggers; John Dietrich,28,0,35,7
1649905123405,MATH 142B,A01,084149,Verstraete; Jacques Allan,0,7,30,30
1649905123405,MATH 142B,A02,084150,Verstraete; Jacques Allan,0,6,30,30
1649905129433,MATH 170A,A01,083459,Nie; Jiawang,0,1,30,30
1649905129433,MATH 170A,A02,083460,Nie; Jiawang,5,0,30,25
1649905129433,MATH 170A,A03,083461,Nie; Jiawang,19,0,30,11
1649905135460,MATH 193B,A01,083463,Staff,6,0,30,24
1649905135460,MATH 193B,A02,083464,Staff,12,0,30,18
1649905135460,MATH 193B,A03,083465,Staff,20,0,30,10
1649905141523,COGS 2,A01,083966,Boyle; Mary E. T.,19,0,30,11
1649905147545,COGS 9,A01,083968,Staff,43,0,60,17
1649905153574,COGS 14B,A01,083970,Staff,33,0,50,17
1649905159597,COGS 17,A01,092679,Staff,68,0,75,7
1649905165618,COGS 100,A01,083972,Staff,23,0,60,37
1649905177673,COGS 101C,A01,083976,Staff,20,0,30,10
1649905183698,COGS 102A,A01,083978,Johnson; Christine M.,18,0,30,12
1649905189724,COGS 107B,A01,083980,Staff,7,0,50,43
1649905195747,COGS 115,A01,083982,Staff,13,0,30,17
1649905201770,COGS 118B,A01,083367,Staff,0,10,40,40
1649905217888,COGS 172,A01,083984,Provenzano; Emily Kara,17,0,30,13
1649905223911,COGS 177,A00,083368,Staff,1,16,30,29
1649905229938,COGS 186,A01,083986,Staff,22,0,40,18
1649905235965,COGS 187A,A01,083988,Boyle; Mary E. T.,24,0,60,36
1649905241988,CSE 8A,A50,084003,Miranda; Gregory Joseph,2,0,15,13
1649905248012,CSE 11,A01,084005,Miranda; Gregory Joseph,27,0,55,28
1649905254035,CSE 20,A01,084007,Staff,9,0,20,11
1649905260057,CSE 21,A01,084009,Staff,15,0,50,35
1649905266080,CSE 30,A01,083370,Cao; Yingjun,0,13,40,40
1649905272103,CSE 100,A01,083372,Cao; Yingjun,0,17,40,40
1649905278126,CSE 101,A01,084011,Staff,1,46,40,39
1649905284150,CSE 141,A01,083374,Eldon; John,1,49,75,74
1649905290176,CSE 141L,A01,083376,Eldon; John,1,53,75,74
1649905296200,CSE 175,A01,084013,Kumar; Rakesh,22,0,25,3
1649905302232,CSE 190,A00,092508,Dubnov; Shlomo,15,0,15,0
1649905308256,ECE 5,A01,084049,Morris; Karcher William,16,0,20,4
1649905314277,ECE 100,A01,084051,Baghdadchi; Saharnaz,2,0,20,18
1649905314277,ECE 100,A02,091916,Baghdadchi; Saharnaz,18,0,20,2
1649905320301,ECE 101,A01,084053,Baghdadchi; Saharnaz,7,0,37,30
1649905320301,ECE 101,A02,084054,Baghdadchi; Saharnaz,37,0,37,0
1649905326345,ECE 107,A01,083390,Staff,29,0,40,11
1649905332370,ECE 148,A01,084056,Silberman; Jack,7,0,12,5
1649905338480,ECE 180,A00,083391,Abi Samra; Nicholas Camill,25,0,30,5
1649905338480,ECE 180,B00,083392,Abi Samra; Nicholas Camill,22,0,30,8
1649905344502,MATH 10B,A01,084110,Staff,10,0,30,20
1649905344502,MATH 10B,A02,084111,Staff,29,0,30,1
1649905344502,MATH 10B,A03,084112,Staff,28,0,30,2
1649905350532,MATH 10C,A01,083443,Staff,9,0,30,21
1649905350532,MATH 10C,A02,083444,Staff,17,0,30,13
1649905350532,MATH 10C,B01,084114,Staff,25,0,30,5
1649905350532,MATH 10C,B02,084115,Staff,29,0,30,1
1649905356556,MATH 18,A01,084117,Harel; Guershon,27,0,30,3
1649905356556,MATH 18,A02,084119,Harel; Guershon,29,0,30,1
1649905356556,MATH 18,A03,084120,Harel; Guershon,30,0,30,0
1649905356556,MATH 18,A04,084121,Harel; Guershon,29,0,30,1
1649905362579,MATH 20B,A01,084124,Um; Ko Woon,31,0,35,4
1649905362579,MATH 20B,B01,084126,Um; Ko Woon,33,0,35,2
1649905368615,MATH 20C,A01,083446,Hammock; Frances H,18,0,30,12
1649905368615,MATH 20C,A02,083447,Hammock; Frances H,28,0,30,2
1649905368615,MATH 20C,A03,083448,Hammock; Frances H,30,0,30,0
1649905368615,MATH 20C,A04,083449,Hammock; Frances H,30,0,30,0
1649905368615,MATH 20C,B01,083451,Hammock; Frances H,26,0,30,4
1649905368615,MATH 20C,B02,083452,Hammock; Frances H,29,0,30,1
1649905368615,MATH 20C,B03,083453,Hammock; Frances H,27,0,30,3
1649905368615,MATH 20C,B04,083454,Hammock; Frances H,30,0,30,0
1649905374639,MATH 20D,A01,084128,Staff,26,0,30,4
1649905374639,MATH 20D,A02,084129,Staff,30,0,30,0
1649905374639,MATH 20D,A03,084130,Staff,29,0,30,1
1649905374639,MATH 20D,B01,084133,Staff,24,0,30,6
1649905374639,MATH 20D,B02,084134,Staff,27,0,30,3
1649905374639,MATH 20D,B03,084135,Staff,30,0,30,0
1649905380663,MATH 20E,A01,084138,Staff,24,0,30,6
1649905380663,MATH 20E,A02,084139,Staff,24,0,30,6
1649905380663,MATH 20E,A03,084140,Staff,24,0,30,6
1649905380663,MATH 20E,A04,084141,Staff,27,0,30,3
1649905386686,MATH 102,A01,084143,Harel; Guershon,20,0,30,10
1649905386686,MATH 102,A02,084144,Harel; Guershon,22,0,30,8
1649905392708,MATH 103B,A01,083456,Staff,0,8,30,30
1649905392708,MATH 103B,A02,083457,Staff,0,8,30,30
1649905398732,MATH 109,A01,084146,Salehi Golsefidy; Alireza,29,0,30,1
1649905398732,MATH 109,A02,084147,Salehi Golsefidy; Alireza,22,0,30,8
1649905404759,MATH 120A,A01,085445,Eggers; John Dietrich,20,0,35,15
1649905404759,MATH 120A,A02,085446,Eggers; John Dietrich,28,0,35,7
1649905410790,MATH 142B,A01,084149,Verstraete; Jacques Allan,0,7,30,30
1649905410790,MATH 142B,A02,084150,Verstraete; Jacques Allan,0,6,30,30
1649905416816,MATH 170A,A01,083459,Nie; Jiawang,0,1,30,30
1649905416816,MATH 170A,A02,083460,Nie; Jiawang,5,0,30,25
1649905416816,MATH 170A,A03,083461,Nie; Jiawang,19,0,30,11
1649905422837,MATH 193B,A01,083463,Staff,6,0,30,24
1649905422837,MATH 193B,A02,083464,Staff,12,0,30,18
1649905422837,MATH 193B,A03,083465,Staff,20,0,30,10
1649905428890,COGS 2,A01,083966,Boyle; Mary E. T.,19,0,30,11
1649905434914,COGS 9,A01,083968,Staff,43,0,60,17
1649905440936,COGS 14B,A01,083970,Staff,32,0,50,18
1649905446959,COGS 17,A01,092679,Staff,68,0,75,7
1649905452982,COGS 100,A01,083972,Staff,23,0,60,37
1649905465028,COGS 101C,A01,083976,Staff,20,0,30,10
1649905471051,COGS 102A,A01,083978,Johnson; Christine M.,18,0,30,12
1649905477076,COGS 107B,A01,083980,Staff,7,0,50,43
1649905483103,COGS 115,A01,083982,Staff,13,0,30,17
1649905489127,COGS 118B,A01,083367,Staff,0,10,40,40
1649905495171,COGS 172,A01,083984,Provenzano; Emily Kara,17,0,30,13
1649905501195,COGS 177,A00,083368,Staff,1,16,30,29
1649905507230,COGS 186,A01,083986,Staff,22,0,40,18
1649905513256,COGS 187A,A01,083988,Boyle; Mary E. T.,24,0,60,36
1649905519279,CSE 8A,A50,084003,Miranda; Gregory Joseph,2,0,15,13
1649905525304,CSE 11,A01,084005,Miranda; Gregory Joseph,27,0,55,28
1649905531327,CSE 20,A01,084007,Staff,9,0,20,11
1649905537360,CSE 21,A01,084009,Staff,15,0,50,35
1649905543383,CSE 30,A01,083370,Cao; Yingjun,0,13,40,40
1649905549407,CSE 100,A01,083372,Cao; Yingjun,0,17,40,40
1649905555429,CSE 101,A01,084011,Staff,1,46,40,39
1649905561454,CSE 141,A01,083374,Eldon; John,1,49,75,74
1649905567477,CSE 141L,A01,083376,Eldon; John,1,53,75,74
1649905573499,CSE 175,A01,084013,Kumar; Rakesh,22,0,25,3
1649905579522,CSE 190,A00,092508,Dubnov; Shlomo,15,0,15,0
1649905585548,ECE 5,A01,084049,Morris; Karcher William,16,0,20,4
1649905591575,ECE 100,A01,084051,Baghdadchi; Saharnaz,2,0,20,18
1649905591575,ECE 100,A02,091916,Baghdadchi; Saharnaz,17,0,20,3
1649905597598,ECE 101,A01,084053,Baghdadchi; Saharnaz,7,0,37,30
1649905597598,ECE 101,A02,084054,Baghdadchi; Saharnaz,37,0,37,0
1649905603621,ECE 107,A01,083390,Staff,29,0,40,11
1649905609653,ECE 148,A01,084056,Silberman; Jack,7,0,12,5
1649905615677,ECE 180,A00,083391,Abi Samra; Nicholas Camill,25,0,30,5
1649905615677,ECE 180,B00,083392,Abi Samra; Nicholas Camill,22,0,30,8
1649905621706,MATH 10B,A01,084110,Staff,10,0,30,20
1649905621706,MATH 10B,A02,084111,Staff,29,0,30,1
1649905621706,MATH 10B,A03,084112,Staff,28,0,30,2
1649905627730,MATH 10C,A01,083443,Staff,9,0,30,21
1649905627730,MATH 10C,A02,083444,Staff,17,0,30,13
1649905627730,MATH 10C,B01,084114,Staff,25,0,30,5
1649905627730,MATH 10C,B02,084115,Staff,29,0,30,1
1649905633754,MATH 18,A01,084117,Harel; Guershon,27,0,30,3
1649905633754,MATH 18,A02,084119,Harel; Guershon,29,0,30,1
1649905633754,MATH 18,A03,084120,Harel; Guershon,30,0,30,0
1649905633754,MATH 18,A04,084121,Harel; Guershon,29,0,30,1
1649905639777,MATH 20B,A01,084124,Um; Ko Woon,31,0,35,4
1649905639777,MATH 20B,B01,084126,Um; Ko Woon,33,0,35,2
1649905645804,MATH 20C,A01,083446,Hammock; Frances H,18,0,30,12
1649905645804,MATH 20C,A02,083447,Hammock; Frances H,28,0,30,2
1649905645804,MATH 20C,A03,083448,Hammock; Frances H,30,0,30,0
1649905645804,MATH 20C,A04,083449,Hammock; Frances H,30,0,30,0
1649905645804,MATH 20C,B01,083451,Hammock; Frances H,26,0,30,4
1649905645804,MATH 20C,B02,083452,Hammock; Frances H,29,0,30,1
1649905645804,MATH 20C,B03,083453,Hammock; Frances H,27,0,30,3
1649905645804,MATH 20C,B04,083454,Hammock; Frances H,30,0,30,0
1649905651838,MATH 20D,A01,084128,Staff,26,0,30,4
1649905651838,MATH 20D,A02,084129,Staff,30,0,30,0
1649905651838,MATH 20D,A03,084130,Staff,29,0,30,1
1649905651838,MATH 20D,B01,084133,Staff,24,0,30,6
1649905651838,MATH 20D,B02,084134,Staff,27,0,30,3
1649905651838,MATH 20D,B03,084135,Staff,30,0,30,0
1649905657865,MATH 20E,A01,084138,Staff,24,0,30,6
1649905657865,MATH 20E,A02,084139,Staff,24,0,30,6
1649905657865,MATH 20E,A03,084140,Staff,24,0,30,6
1649905657865,MATH 20E,A04,084141,Staff,27,0,30,3
1649905663889,MATH 102,A01,084143,Harel; Guershon,20,0,30,10
1649905663889,MATH 102,A02,084144,Harel; Guershon,22,0,30,8
1649905669912,MATH 103B,A01,083456,Staff,0,8,30,30
1649905669912,MATH 103B,A02,083457,Staff,0,8,30,30
1649905675940,MATH 109,A01,084146,Salehi Golsefidy; Alireza,29,0,30,1
1649905675940,MATH 109,A02,084147,Salehi Golsefidy; Alireza,22,0,30,8
1649905681991,MATH 120A,A01,085445,Eggers; John Dietrich,20,0,35,15
1649905681991,MATH 120A,A02,085446,Eggers; John Dietrich,28,0,35,7
1649905688016,MATH 142B,A01,084149,Verstraete; Jacques Allan,0,7,30,30
1649905688016,MATH 142B,A02,084150,Verstraete; Jacques Allan,0,6,30,30
1649905694046,MATH 170A,A01,083459,Nie; Jiawang,0,1,30,30
1649905694046,MATH 170A,A02,083460,Nie; Jiawang,4,0,30,26
1649905694046,MATH 170A,A03,083461,Nie; Jiawang,19,0,30,11
1649905700071,MATH 193B,A01,083463,Staff,6,0,30,24
1649905700071,MATH 193B,A02,083464,Staff,12,0,30,18
1649905700071,MATH 193B,A03,083465,Staff,20,0,30,10
1649905706127,COGS 2,A01,083966,Boyle; Mary E. T.,19,0,30,11
1649905712157,COGS 9,A01,083968,Staff,43,0,60,17
1649905718182,COGS 14B,A01,083970,Staff,32,0,50,18
1649905724205,COGS 17,A01,092679,Staff,68,0,75,7
1649905730231,COGS 100,A01,083972,Staff,22,0,60,38
1649905742282,COGS 101C,A01,083976,Staff,20,0,30,10
1649905748308,COGS 102A,A01,083978,Johnson; Christine M.,18,0,30,12
1649905754330,COGS 107B,A01,083980,Staff,7,0,50,43
1649905760361,COGS 115,A01,083982,Staff,13,0,30,17
1649905766386,COGS 118B,A01,083367,Staff,0,10,40,40
1649905772413,COGS 172,A01,083984,Provenzano; Emily Kara,17,0,30,13
1649905778436,COGS 177,A00,083368,Staff,1,16,30,29
1649905784462,COGS 186,A01,083986,Staff,22,0,40,18
1649905790484,COGS 187A,A01,083988,Boyle; Mary E. T.,24,0,60,36
1649905796507,CSE 8A,A50,084003,Miranda; Gregory Joseph,2,0,15,13
1649905802536,CSE 11,A01,084005,Miranda; Gregory Joseph,26,0,55,29
1649905808562,CSE 20,A01,084007,Staff,9,0,20,11
1649905814584,CSE 21,A01,084009,Staff,15,0,50,35
1649905820610,CSE 30,A01,083370,Cao; Yingjun,0,13,40,40
1649905826633,CSE 100,A01,083372,Cao; Yingjun,0,17,40,40
1649905832656,CSE 101,A01,084011,Staff,1,46,40,39
1649905838683,CSE 141,A01,083374,Eldon; John,1,49,75,74
1649905844704,CSE 141L,A01,083376,Eldon; John,1,53,75,74
1649905850728,CSE 175,A01,084013,Kumar; Rakesh,22,0,25,3
1649905856751,CSE 190,A00,092508,Dubnov; Shlomo,15,0,15,0
1649905862774,ECE 5,A01,084049,Morris; Karcher William,16,0,20,4
1649905868797,ECE 100,A01,084051,Baghdadchi; Saharnaz,2,0,20,18
1649905868797,ECE 100,A02,091916,Baghdadchi; Saharnaz,17,0,20,3
1649905874820,ECE 101,A01,084053,Baghdadchi; Saharnaz,7,0,37,30
1649905874820,ECE 101,A02,084054,Baghdadchi; Saharnaz,37,0,37,0
1649905880847,ECE 107,A01,083390,Staff,29,0,40,11
1649905886873,ECE 148,A01,084056,Silberman; Jack,7,0,12,5
1649905892900,ECE 180,A00,083391,Abi Samra; Nicholas Camill,25,0,30,5
1649905892900,ECE 180,B00,083392,Abi Samra; Nicholas Camill,22,0,30,8
1649905898922,MATH 10B,A01,084110,Staff,10,0,30,20
1649905898922,MATH 10B,A02,084111,Staff,29,0,30,1
1649905898922,MATH 10B,A03,084112,Staff,28,0,30,2
1649905904963,MATH 10C,A01,083443,Staff,9,0,30,21
1649905904963,MATH 10C,A02,083444,Staff,17,0,30,13
1649905904963,MATH 10C,B01,084114,Staff,25,0,30,5
1649905904963,MATH 10C,B02,084115,Staff,29,0,30,1
1649905910989,MATH 18,A01,084117,Harel; Guershon,27,0,30,3
1649905910989,MATH 18,A02,084119,Harel; Guershon,29,0,30,1
1649905910989,MATH 18,A03,084120,Harel; Guershon,30,0,30,0
1649905910989,MATH 18,A04,084121,Harel; Guershon,29,0,30,1
1649905917017,MATH 20B,A01,084124,Um; Ko Woon,31,0,35,4
1649905917017,MATH 20B,B01,084126,Um; Ko Woon,33,0,35,2
1649905923046,MATH 20C,A01,083446,Hammock; Frances H,18,0,30,12
1649905923046,MATH 20C,A02,083447,Hammock; Frances H,28,0,30,2
1649905923046,MATH 20C,A03,083448,Hammock; Frances H,30,0,30,0
1649905923046,MATH 20C,A04,083449,Hammock; Frances H,30,0,30,0
1649905923046,MATH 20C,B01,083451,Hammock; Frances H,26,0,30,4
1649905923046,MATH 20C,B02,083452,Hammock; Frances H,29,0,30,1
1649905923046,MATH 20C,B03,083453,Hammock; Frances H,27,0,30,3
1649905923046,MATH 20C,B04,083454,Hammock; Frances H,30,0,30,0
1649905929070,MATH 20D,A01,084128,Staff,26,0,30,4
1649905929070,MATH 20D,A02,084129,Staff,30,0,30,0
1649905929070,MATH 20D,A03,084130,Staff,29,0,30,1
1649905929070,MATH 20D,B01,084133,Staff,24,0,30,6
1649905929070,MATH 20D,B02,084134,Staff,27,0,30,3
1649905929070,MATH 20D,B03,084135,Staff,30,0,30,0
1649905935183,MATH 20E,A01,084138,Staff,24,0,30,6
1649905935183,MATH 20E,A02,084139,Staff,24,0,30,6
1649905935183,MATH 20E,A03,084140,Staff,24,0,30,6
1649905935183,MATH 20E,A04,084141,Staff,27,0,30,3
1649905941210,MATH 102,A01,084143,Harel; Guershon,20,0,30,10
1649905941210,MATH 102,A02,084144,Harel; Guershon,22,0,30,8
1649905947231,MATH 103B,A01,083456,Staff,0,8,30,30
1649905947231,MATH 103B,A02,083457,Staff,0,8,30,30
1649905953268,MATH 109,A01,084146,Salehi Golsefidy; Alireza,29,0,30,1
1649905953268,MATH 109,A02,084147,Salehi Golsefidy; Alireza,22,0,30,8
1649905959294,MATH 120A,A01,085445,Eggers; John Dietrich,20,0,35,15
1649905959294,MATH 120A,A02,085446,Eggers; John Dietrich,28,0,35,7
1649905965316,MATH 142B,A01,084149,Verstraete; Jacques Allan,0,7,30,30
1649905965316,MATH 142B,A02,084150,Verstraete; Jacques Allan,0,6,30,30
1649905971338,MATH 170A,A01,083459,Nie; Jiawang,0,1,30,30
1649905971338,MATH 170A,A02,083460,Nie; Jiawang,3,0,30,27
1649905971338,MATH 170A,A03,083461,Nie; Jiawang,19,0,30,11
1649905977362,MATH 193B,A01,083463,Staff,6,0,30,24
1649905977362,MATH 193B,A02,083464,Staff,12,0,30,18
1649905977362,MATH 193B,A03,083465,Staff,20,0,30,10
1649905983424,COGS 2,A01,083966,Boyle; Mary E. T.,19,0,30,11
1649905989451,COGS 9,A01,083968,Staff,43,0,60,17
1649905995484,COGS 14B,A01,083970,Staff,32,0,50,18
1649906001506,COGS 17,A01,092679,Staff,68,0,75,7
1649906007534,COGS 100,A01,083972,Staff,22,0,60,38
1649906019588,COGS 101C,A01,083976,Staff,20,0,30,10
1649906025615,COGS 102A,A01,083978,Johnson; Christine M.,18,0,30,12
1649906031638,COGS 107B,A01,083980,Staff,7,0,50,43
1649906037662,COGS 115,A01,083982,Staff,13,0,30,17
1649906043697,COGS 118B,A01,083367,Staff,0,10,40,40
1649906049734,COGS 172,A01,083984,Provenzano; Emily Kara,17,0,30,13
1649906055760,COGS 177,A00,083368,Staff,1,16,30,29
1649906061784,COGS 186,A01,083986,Staff,22,0,40,18
1649906067808,COGS 187A,A01,083988,Boyle; Mary E. T.,24,0,60,36
1649906073836,CSE 8A,A50,084003,Miranda; Gregory Joseph,2,0,15,13
1649906079860,CSE 11,A01,084005,Miranda; Gregory Joseph,26,0,55,29
1649906085886,CSE 20,A01,084007,Staff,9,0,20,11
1649906091913,CSE 21,A01,084009,Staff,15,0,50,35
1649906097940,CSE 30,A01,083370,Cao; Yingjun,0,13,40,40
1649906103962,CSE 100,A01,083372,Cao; Yingjun,0,18,40,40
1649906109986,CSE 101,A01,084011,Staff,1,46,40,39
1649906116010,CSE 141,A01,083374,Eldon; John,1,49,75,74
1649906122035,CSE 141L,A01,083376,Eldon; John,1,53,75,74
1649906128061,CSE 175,A01,084013,Kumar; Rakesh,22,0,25,3
1649906134097,CSE 190,A00,092508,Dubnov; Shlomo,15,0,15,0
1649906140120,ECE 5,A01,084049,Morris; Karcher William,16,0,20,4
1649906146142,ECE 100,A01,084051,Baghdadchi; Saharnaz,2,0,20,18
1649906146142,ECE 100,A02,091916,Baghdadchi; Saharnaz,17,0,20,3
1649906152169,ECE 101,A01,084053,Baghdadchi; Saharnaz,6,0,37,31
1649906152169,ECE 101,A02,084054,Baghdadchi; Saharnaz,36,0,37,1
1649906158199,ECE 107,A01,083390,Staff,29,0,40,11
1649906164225,ECE 148,A01,084056,Silberman; Jack,7,0,12,5
1649906170264,ECE 180,A00,083391,Abi Samra; Nicholas Camill,25,0,30,5
1649906170264,ECE 180,B00,083392,Abi Samra; Nicholas Camill,22,0,30,8
1649906176290,MATH 10B,A01,084110,Staff,10,0,30,20
1649906176290,MATH 10B,A02,084111,Staff,29,0,30,1
1649906176290,MATH 10B,A03,084112,Staff,28,0,30,2
1649906182336,MATH 10C,A01,083443,Staff,9,0,30,21
1649906182336,MATH 10C,A02,083444,Staff,17,0,30,13
1649906182336,MATH 10C,B01,084114,Staff,25,0,30,5
1649906182336,MATH 10C,B02,084115,Staff,29,0,30,1
1649906188360,MATH 18,A01,084117,Harel; Guershon,27,0,30,3
1649906188360,MATH 18,A02,084119,Harel; Guershon,29,0,30,1
1649906188360,MATH 18,A03,084120,Harel; Guershon,30,0,30,0
1649906188360,MATH 18,A04,084121,Harel; Guershon,29,0,30,1
1649906194388,MATH 20B,A01,084124,Um; Ko Woon,31,0,35,4
1649906194388,MATH 20B,B01,084126,Um; Ko Woon,33,0,35,2
1649906200416,MATH 20C,A01,083446,Hammock; Frances H,18,0,30,12
1649906200416,MATH 20C,A02,083447,Hammock; Frances H,28,0,30,2
1649906200416,MATH 20C,A03,083448,Hammock; Frances H,30,0,30,0
1649906200416,MATH 20C,A04,083449,Hammock; Frances H,30,0,30,0
1649906200416,MATH 20C,B01,083451,Hammock; Frances H,26,0,30,4
1649906200416,MATH 20C,B02,083452,Hammock; Frances H,29,0,30,1
1649906200416,MATH 20C,B03,083453,Hammock; Frances H,27,0,30,3
1649906200416,MATH 20C,B04,083454,Hammock; Frances H,30,0,30,0
1649906206456,MATH 20D,A01,084128,Staff,26,0,30,4
1649906206456,MATH 20D,A02,084129,Staff,30,0,30,0
1649906206456,MATH 20D,A03,084130,Staff,29,0,30,1
1649906206456,MATH 20D,B01,084133,Staff,24,0,30,6
1649906206456,MATH 20D,B02,084134,Staff,27,0,30,3
1649906206456,MATH 20D,B03,084135,Staff,30,0,30,0
1649906212484,MATH 20E,A01,084138,Staff,24,0,30,6
1649906212484,MATH 20E,A02,084139,Staff,24,0,30,6
1649906212484,MATH 20E,A03,084140,Staff,24,0,30,6
1649906212484,MATH 20E,A04,084141,Staff,27,0,30,3
1649906218511,MATH 102,A01,084143,Harel; Guershon,20,0,30,10
1649906218511,MATH 102,A02,084144,Harel; Guershon,22,0,30,8
1649906224534,MATH 103B,A01,083456,Staff,0,8,30,30
1649906224534,MATH 103B,A02,083457,Staff,0,8,30,30
1649906230557,MATH 109,A01,084146,Salehi Golsefidy; Alireza,29,0,30,1
1649906230557,MATH 109,A02,084147,Salehi Golsefidy; Alireza,22,0,30,8
1649906236580,MATH 120A,A01,085445,Eggers; John Dietrich,20,0,35,15
1649906236580,MATH 120A,A02,085446,Eggers; John Dietrich,28,0,35,7
1649906242608,MATH 142B,A01,084149,Verstraete; Jacques Allan,0,8,30,30
1649906242608,MATH 142B,A02,084150,Verstraete; Jacques Allan,0,6,30,30
1649906248648,MATH 170A,A01,083459,Nie; Jiawang,0,1,30,30
1649906248648,MATH 170A,A02,083460,Nie; Jiawang,3,0,30,27
1649906248648,MATH 170A,A03,083461,Nie; Jiawang,19,0,30,11
1649906254688,MATH 193B,A01,083463,Staff,4,0,30,26
1649906254688,MATH 193B,A02,083464,Staff,11,0,30,19
1649906254688,MATH 193B,A03,083465,Staff,20,0,30,10
1649906260737,COGS 2,A01,083966,Boyle; Mary E. T.,19,0,30,11
1649906266763,COGS 9,A01,083968,Staff,43,0,60,17
1649906272795,COGS 14B,A01,083970,Staff,32,0,50,18
1649906278818,COGS 17,A01,092679,Staff,68,0,75,7
1649906284841,COGS 100,A01,083972,Staff,22,0,60,38
1649906296890,COGS 101C,A01,083976,Staff,20,0,30,10
1649906302916,COGS 102A,A01,083978,Johnson; Christine M.,18,0,30,12
1649906308939,COGS 107B,A01,083980,Staff,7,0,50,43
1649906314961,COGS 115,A01,083982,Staff,13,0,30,17
1649906320983,COGS 118B,A01,083367,Staff,0,10,40,40
1649906327006,COGS 172,A01,083984,Provenzano; Emily Kara,17,0,30,13
1649906333039,COGS 177,A00,083368,Staff,1,16,30,29
1649906339062,COGS 186,A01,083986,Staff,22,0,40,18
1649906345083,COGS 187A,A01,083988,Boyle; Mary E. T.,24,0,60,36
1649906351114,CSE 8A,A50,084003,Miranda; Gregory Joseph,2,0,15,13
1649906357141,CSE 11,A01,084005,Miranda; Gregory Joseph,26,0,55,29
1649906363166,CSE 20,A01,084007,Staff,9,0,20,11
1649906369191,CSE 21,A01,084009,Staff,15,0,50,35
1649906375215,CSE 30,A01,083370,Cao; Yingjun,0,13,40,40
1649906381244,CSE 100,A01,083372,Cao; Yingjun,0,18,40,40
1649906387270,CSE 101,A01,084011,Staff,1,46,40,39
1649906393297,CSE 141,A01,083374,Eldon; John,1,49,75,74
1649906399320,CSE 141L,A01,083376,Eldon; John,1,53,75,74
1649906405344,CSE 175,A01,084013,Kumar; Rakesh,22,0,25,3
1649906411373,CSE 190,A00,092508,Dubnov; Shlomo,15,0,15,0
1649906417397,ECE 5,A01,084049,Morris; Karcher William,16,0,20,4
1649906423420,ECE 100,A01,084051,Baghdadchi; Saharnaz,2,0,20,18
1649906423420,ECE 100,A02,091916,Baghdadchi; Saharnaz,17,0,20,3
1649906429447,ECE 101,A01,084053,Baghdadchi; Saharnaz,6,0,37,31
1649906429447,ECE 101,A02,084054,Baghdadchi; Saharnaz,36,0,37,1
1649906435477,ECE 107,A01,083390,Staff,29,0,40,11
1649906441502,ECE 148,A01,084056,Silberman; Jack,7,0,12,5
1649906447527,ECE 180,A00,083391,Abi Samra; Nicholas Camill,25,0,30,5
1649906447527,ECE 180,B00,083392,Abi Samra; Nicholas Camill,22,0,30,8
1649906453548,MATH 10B,A01,084110,Staff,10,0,30,20
1649906453548,MATH 10B,A02,084111,Staff,29,0,30,1
1649906453548,MATH 10B,A03,084112,Staff,28,0,30,2
1649906459571,MATH 10C,A01,083443,Staff,9,0,30,21
1649906459571,MATH 10C,A02,083444,Staff,17,0,30,13
1649906459571,MATH 10C,B01,084114,Staff,25,0,30,5
1649906459571,MATH 10C,B02,084115,Staff,29,0,30,1
1649906465594,MATH 18,A01,084117,Harel; Guershon,27,0,30,3
1649906465594,MATH 18,A02,084119,Harel; Guershon,29,0,30,1
1649906465594,MATH 18,A03,084120,Harel; Guershon,30,0,30,0
1649906465594,MATH 18,A04,084121,Harel; Guershon,29,0,30,1
1649906471617,MATH 20B,A01,084124,Um; Ko Woon,31,0,35,4
1649906471617,MATH 20B,B01,084126,Um; Ko Woon,33,0,35,2
1649906477642,MATH 20C,A01,083446,Hammock; Frances H,18,0,30,12
1649906477642,MATH 20C,A02,083447,Hammock; Frances H,28,0,30,2
1649906477642,MATH 20C,A03,083448,Hammock; Frances H,30,0,30,0
1649906477642,MATH 20C,A04,083449,Hammock; Frances H,30,0,30,0
1649906477642,MATH 20C,B01,083451,Hammock; Frances H,26,0,30,4
1649906477642,MATH 20C,B02,083452,Hammock; Frances H,29,0,30,1
1649906477642,MATH 20C,B03,083453,Hammock; Frances H,27,0,30,3
1649906477642,MATH 20C,B04,083454,Hammock; Frances H,30,0,30,0
1649906483667,MATH 20D,A01,084128,Staff,26,0,30,4
1649906483667,MATH 20D,A02,084129,Staff,30,0,30,0
1649906483667,MATH 20D,A03,084130,Staff,29,0,30,1
1649906483667,MATH 20D,B01,084133,Staff,24,0,30,6
1649906483667,MATH 20D,B02,084134,Staff,27,0,30,3
1649906483667,MATH 20D,B03,084135,Staff,30,0,30,0
1649906489689,MATH 20E,A01,084138,Staff,24,0,30,6
1649906489689,MATH 20E,A02,084139,Staff,24,0,30,6
1649906489689,MATH 20E,A03,084140,Staff,24,0,30,6
1649906489689,MATH 20E,A04,084141,Staff,27,0,30,3
1649906495711,MATH 102,A01,084143,Harel; Guershon,20,0,30,10
1649906495711,MATH 102,A02,084144,Harel; Guershon,22,0,30,8
1649906501736,MATH 103B,A01,083456,Staff,0,8,30,30
1649906501736,MATH 103B,A02,083457,Staff,0,8,30,30
1649906507763,MATH 109,A01,084146,Salehi Golsefidy; Alireza,29,0,30,1
1649906507763,MATH 109,A02,084147,Salehi Golsefidy; Alireza,22,0,30,8
1649906513787,MATH 120A,A01,085445,Eggers; John Dietrich,19,0,35,16
1649906513787,MATH 120A,A02,085446,Eggers; John Dietrich,28,0,35,7
1649906519810,MATH 142B,A01,084149,Verstraete; Jacques Allan,0,8,30,30
1649906519810,MATH 142B,A02,084150,Verstraete; Jacques Allan,0,7,30,30
1649906525845,MATH 170A,A01,083459,Nie; Jiawang,0,2,30,30
1649906525845,MATH 170A,A02,083460,Nie; Jiawang,3,0,30,27
1649906525845,MATH 170A,A03,083461,Nie; Jiawang,17,0,30,13
1649906531961,MATH 193B,A01,083463,Staff,4,0,30,26
1649906531961,MATH 193B,A02,083464,Staff,11,0,30,19
1649906531961,MATH 193B,A03,083465,Staff,20,0,30,10
1649906538015,COGS 2,A01,083966,Boyle; Mary E. T.,19,0,30,11
1649906544049,COGS 9,A01,083968,Staff,43,0,60,17
1649906550074,COGS 14B,A01,083970,Staff,32,0,50,18
1649906556100,COGS 17,A01,092679,Staff,68,0,75,7
1649906562123,COGS 100,A01,083972,Staff,19,0,60,41
1649906574180,COGS 101C,A01,083976,Staff,20,0,30,10
1649906580202,COGS 102A,A01,083978,Johnson; Christine M.,18,0,30,12
1649906586225,COGS 107B,A01,083980,Staff,7,0,50,43
1649906592248,COGS 115,A01,083982,Staff,13,0,30,17
1649906598274,COGS 118B,A01,083367,Staff,0,10,40,40
1649906604297,COGS 172,A01,083984,Provenzano; Emily Kara,17,0,30,13
1649906610322,COGS 177,A00,083368,Staff,1,16,30,29
1649906616346,COGS 186,A01,083986,Staff,22,0,40,18
1649906622378,COGS 187A,A01,083988,Boyle; Mary E. T.,24,0,60,36
1649906628399,CSE 8A,A50,084003,Miranda; Gregory Joseph,2,0,15,13
1649906634425,CSE 11,A01,084005,Miranda; Gregory Joseph,26,0,55,29
1649906640455,CSE 20,A01,084007,Staff,9,0,20,11
1649906646478,CSE 21,A01,084009,Staff,15,0,50,35
1649906652504,CSE 30,A01,083370,Cao; Yingjun,0,13,40,40
1649906658527,CSE 100,A01,083372,Cao; Yingjun,0,18,40,40
1649906664554,CSE 101,A01,084011,Staff,1,46,40,39
1649906670585,CSE 141,A01,083374,Eldon; John,1,49,75,74
1649906676607,CSE 141L,A01,083376,Eldon; John,1,53,75,74
1649906682633,CSE 175,A01,084013,Kumar; Rakesh,22,0,25,3
1649906688657,CSE 190,A00,092508,Dubnov; Shlomo,15,0,15,0
1649906694685,ECE 5,A01,084049,Morris; Karcher William,16,0,20,4
1649906700708,ECE 100,A01,084051,Baghdadchi; Saharnaz,2,0,20,18
1649906700708,ECE 100,A02,091916,Baghdadchi; Saharnaz,17,0,20,3
1649906706731,ECE 101,A01,084053,Baghdadchi; Saharnaz,6,0,37,31
1649906706731,ECE 101,A02,084054,Baghdadchi; Saharnaz,36,0,37,1
1649906712802,ECE 107,A01,083390,Staff,29,0,40,11
1649906718831,ECE 148,A01,084056,Silberman; Jack,7,0,12,5
1649906724858,ECE 180,A00,083391,Abi Samra; Nicholas Camill,25,0,30,5
1649906724858,ECE 180,B00,083392,Abi Samra; Nicholas Camill,22,0,30,8
1649906730885,MATH 10B,A01,084110,Staff,10,0,30,20
1649906730885,MATH 10B,A02,084111,Staff,29,0,30,1
1649906730885,MATH 10B,A03,084112,Staff,28,0,30,2
1649906736912,MATH 10C,A01,083443,Staff,9,0,30,21
1649906736912,MATH 10C,A02,083444,Staff,17,0,30,13
1649906736912,MATH 10C,B01,084114,Staff,25,0,30,5
1649906736912,MATH 10C,B02,084115,Staff,29,0,30,1
1649906742934,MATH 18,A01,084117,Harel; Guershon,27,0,30,3
1649906742934,MATH 18,A02,084119,Harel; Guershon,29,0,30,1
1649906742934,MATH 18,A03,084120,Harel; Guershon,30,0,30,0
1649906742934,MATH 18,A04,084121,Harel; Guershon,29,0,30,1
1649906748958,MATH 20B,A01,084124,Um; Ko Woon,31,0,35,4
1649906748958,MATH 20B,B01,084126,Um; Ko Woon,33,0,35,2
1649906754981,MATH 20C,A01,083446,Hammock; Frances H,18,0,30,12
1649906754981,MATH 20C,A02,083447,Hammock; Frances H,28,0,30,2
1649906754981,MATH 20C,A03,083448,Hammock; Frances H,30,0,30,0
1649906754981,MATH 20C,A04,083449,Hammock; Frances H,30,0,30,0
1649906754981,MATH 20C,B01,083451,Hammock; Frances H,26,0,30,4
1649906754981,MATH 20C,B02,083452,Hammock; Frances H,29,0,30,1
1649906754981,MATH 20C,B03,083453,Hammock; Frances H,27,0,30,3
1649906754981,MATH 20C,B04,083454,Hammock; Frances H,30,0,30,0
1649906761007,MATH 20D,A01,084128,Staff,26,0,30,4
1649906761007,MATH 20D,A02,084129,Staff,30,0,30,0
1649906761007,MATH 20D,A03,084130,Staff,29,0,30,1
1649906761007,MATH 20D,B01,084133,Staff,24,0,30,6
1649906761007,MATH 20D,B02,084134,Staff,27,0,30,3
1649906761007,MATH 20D,B03,084135,Staff,30,0,30,0
1649906767035,MATH 20E,A01,084138,Staff,24,0,30,6
1649906767035,MATH 20E,A02,084139,Staff,24,0,30,6
1649906767035,MATH 20E,A03,084140,Staff,24,0,30,6
1649906767035,MATH 20E,A04,084141,Staff,27,0,30,3
1649906773062,MATH 102,A01,084143,Harel; Guershon,19,0,30,11
1649906773062,MATH 102,A02,084144,Harel; Guershon,22,0,30,8
1649906779084,MATH 103B,A01,083456,Staff,0,8,30,30
1649906779084,MATH 103B,A02,083457,Staff,0,8,30,30
1649906785108,MATH 109,A01,084146,Salehi Golsefidy; Alireza,29,0,30,1
1649906785108,MATH 109,A02,084147,Salehi Golsefidy; Alireza,22,0,30,8
1649906791137,MATH 120A,A01,085445,Eggers; John Dietrich,20,0,35,15
1649906791137,MATH 120A,A02,085446,Eggers; John Dietrich,28,0,35,7
1649906797163,MATH 142B,A01,084149,Verstraete; Jacques Allan,0,8,30,30
1649906797163,MATH 142B,A02,084150,Verstraete; Jacques Allan,0,7,30,30
1649906803189,MATH 170A,A01,083459,Nie; Jiawang,0,1,30,30
1649906803189,MATH 170A,A02,083460,Nie; Jiawang,2,0,30,28
1649906803189,MATH 170A,A03,083461,Nie; Jiawang,18,0,30,12
1649906809219,MATH 193B,A01,083463,Staff,4,0,30,26
1649906809219,MATH 193B,A02,083464,Staff,11,0,30,19
1649906809219,MATH 193B,A03,083465,Staff,20,0,30,10
1649906815272,COGS 2,A01,083966,Boyle; Mary E. T.,19,0,30,11
1649906821298,COGS 9,A01,083968,Staff,43,0,60,17
1649906827325,COGS 14B,A01,083970,Staff,32,0,50,18
1649906833351,COGS 17,A01,092679,Staff,68,0,75,7
1649906839377,COGS 100,A01,083972,Staff,19,0,60,41
1649906851428,COGS 101C,A01,083976,Staff,20,0,30,10
1649906857452,COGS 102A,A01,083978,Johnson; Christine M.,18,0,30,12
1649906863475,COGS 107B,A01,083980,Staff,7,0,50,43
1649906869515,COGS 115,A01,083982,Staff,13,0,30,17
1649906875548,COGS 118B,A01,083367,Staff,0,10,40,40
1649906881574,COGS 172,A01,083984,Provenzano; Emily Kara,17,0,30,13
1649906887596,COGS 177,A00,083368,Staff,1,16,30,29
1649906893622,COGS 186,A01,083986,Staff,22,0,40,18
1649906899648,COGS 187A,A01,083988,Boyle; Mary E. T.,24,0,60,36
1649906905685,CSE 8A,A50,084003,Miranda; Gregory Joseph,2,0,15,13
1649906911718,CSE 11,A01,084005,Miranda; Gregory Joseph,25,0,55,30
1649906917741,CSE 20,A01,084007,Staff,9,0,20,11
1649906923771,CSE 21,A01,084009,Staff,15,0,50,35
1649906929794,CSE 30,A01,083370,Cao; Yingjun,0,15,40,40
1649906935828,CSE 100,A01,083372,Cao; Yingjun,0,19,40,40
1649906941852,CSE 101,A01,084011,Staff,1,46,40,39
1649906947875,CSE 141,A01,083374,Eldon; John,1,49,75,74
1649906953904,CSE 141L,A01,083376,Eldon; John,1,53,75,74
1649906959925,CSE 175,A01,084013,Kumar; Rakesh,22,0,25,3
1649906965952,CSE 190,A00,092508,Dubnov; Shlomo,15,0,15,0
1649906971974,ECE 5,A01,084049,Morris; Karcher William,16,0,20,4
1649906978026,ECE 100,A01,084051,Baghdadchi; Saharnaz,2,0,20,18
1649906978026,ECE 100,A02,091916,Baghdadchi; Saharnaz,17,0,20,3
1649906984048,ECE 101,A01,084053,Baghdadchi; Saharnaz,6,0,37,31
1649906984048,ECE 101,A02,084054,Baghdadchi; Saharnaz,36,0,37,1
1649906990076,ECE 107,A01,083390,Staff,29,0,40,11
1649906996098,ECE 148,A01,084056,Silberman; Jack,7,0,12,5
1649907002126,ECE 180,A00,083391,Abi Samra; Nicholas Camill,25,0,30,5
1649907002126,ECE 180,B00,083392,Abi Samra; Nicholas Camill,22,0,30,8
1649907008148,MATH 10B,A01,084110,Staff,10,0,30,20
1649907008148,MATH 10B,A02,084111,Staff,29,0,30,1
1649907008148,MATH 10B,A03,084112,Staff,28,0,30,2
1649907014174,MATH 10C,A01,083443,Staff,9,0,30,21
1649907014174,MATH 10C,A02,083444,Staff,17,0,30,13
1649907014174,MATH 10C,B01,084114,Staff,25,0,30,5
1649907014174,MATH 10C,B02,084115,Staff,29,0,30,1
1649907020198,MATH 18,A01,084117,Harel; Guershon,27,0,30,3
1649907020198,MATH 18,A02,084119,Harel; Guershon,29,0,30,1
1649907020198,MATH 18,A03,084120,Harel; Guershon,30,0,30,0
1649907020198,MATH 18,A04,084121,Harel; Guershon,29,0,30,1
1649907026223,MATH 20B,A01,084124,Um; Ko Woon,31,0,35,4
1649907026223,MATH 20B,B01,084126,Um; Ko Woon,33,0,35,2
1649907032251,MATH 20C,A01,083446,Hammock; Frances H,18,0,30,12
1649907032251,MATH 20C,A02,083447,Hammock; Frances H,28,0,30,2
1649907032251,MATH 20C,A03,083448,Hammock; Frances H,30,0,30,0
1649907032251,MATH 20C,A04,083449,Hammock; Frances H,30,0,30,0
1649907032251,MATH 20C,B01,083451,Hammock; Frances H,26,0,30,4
1649907032251,MATH 20C,B02,083452,Hammock; Frances H,29,0,30,1
1649907032251,MATH 20C,B03,083453,Hammock; Frances H,27,0,30,3
1649907032251,MATH 20C,B04,083454,Hammock; Frances H,30,0,30,0
1649907038282,MATH 20D,A01,084128,Staff,26,0,30,4
1649907038282,MATH 20D,A02,084129,Staff,30,0,30,0
1649907038282,MATH 20D,A03,084130,Staff,29,0,30,1
1649907038282,MATH 20D,B01,084133,Staff,24,0,30,6
1649907038282,MATH 20D,B02,084134,Staff,27,0,30,3
1649907038282,MATH 20D,B03,084135,Staff,30,0,30,0
1649907044310,MATH 20E,A01,084138,Staff,24,0,30,6
1649907044310,MATH 20E,A02,084139,Staff,24,0,30,6
1649907044310,MATH 20E,A03,084140,Staff,24,0,30,6
1649907044310,MATH 20E,A04,084141,Staff,27,0,30,3
1649907050334,MATH 102,A01,084143,Harel; Guershon,19,0,30,11
1649907050334,MATH 102,A02,084144,Harel; Guershon,22,0,30,8
1649907056361,MATH 103B,A01,083456,Staff,0,8,30,30
1649907056361,MATH 103B,A02,083457,Staff,0,8,30,30
1649907062386,MATH 109,A01,084146,Salehi Golsefidy; Alireza,29,0,30,1
1649907062386,MATH 109,A02,084147,Salehi Golsefidy; Alireza,22,0,30,8
1649907068422,MATH 120A,A01,085445,Eggers; John Dietrich,20,0,35,15
1649907068422,MATH 120A,A02,085446,Eggers; John Dietrich,28,0,35,7
1649907074445,MATH 142B,A01,084149,Verstraete; Jacques Allan,0,8,30,30
1649907074445,MATH 142B,A02,084150,Verstraete; Jacques Allan,0,7,30,30
1649907080479,MATH 170A,A01,083459,Nie; Jiawang,0,1,30,30
1649907080479,MATH 170A,A02,083460,Nie; Jiawang,1,0,30,29
1649907080479,MATH 170A,A03,083461,Nie; Jiawang,17,0,30,13
1649907086505,MATH 193B,A01,083463,Staff,3,0,30,27
1649907086505,MATH 193B,A02,083464,Staff,11,0,30,19
1649907086505,MATH 193B,A03,083465,Staff,20,0,30,10
1649907092560,COGS 2,A01,083966,Boyle; Mary E. T.,19,0,30,11
1649907098583,COGS 9,A01,083968,Staff,43,0,60,17
1649907104608,COGS 14B,A01,083970,Staff,32,0,50,18
1649907110637,COGS 17,A01,092679,Staff,68,0,75,7
1649907116661,COGS 100,A01,083972,Staff,19,0,60,41
1649907128817,COGS 101C,A01,083976,Staff,20,0,30,10
1649907134842,COGS 102A,A01,083978,Johnson; Christine M.,18,0,30,12
1649907140868,COGS 107B,A01,083980,Staff,7,0,50,43
1649907146894,COGS 115,A01,083982,Staff,13,0,30,17
1649907152917,COGS 118B,A01,083367,Staff,0,10,40,40
1649907158943,COGS 172,A01,083984,Provenzano; Emily Kara,17,0,30,13
1649907164967,COGS 177,A00,083368,Staff,1,16,30,29
1649907170991,COGS 186,A01,083986,Staff,22,0,40,18
1649907177028,COGS 187A,A01,083988,Boyle; Mary E. T.,24,0,60,36
1649907183057,CSE 8A,A50,084003,Miranda; Gregory Joseph,2,0,15,13
1649907189079,CSE 11,A01,084005,Miranda; Gregory Joseph,24,0,55,31
1649907195102,CSE 20,A01,084007,Staff,9,0,20,11
1649907201135,CSE 21,A01,084009,Staff,15,0,50,35
1649907207158,CSE 30,A01,083370,Cao; Yingjun,0,15,40,40
1649907213182,CSE 100,A01,083372,Cao; Yingjun,0,20,40,40
1649907219206,CSE 101,A01,084011,Staff,1,46,40,39
1649907225232,CSE 141,A01,083374,Eldon; John,1,49,75,74
1649907231255,CSE 141L,A01,083376,Eldon; John,1,53,75,74
1649907237278,CSE 175,A01,084013,Kumar; Rakesh,22,0,25,3
1649907243301,CSE 190,A00,092508,Dubnov; Shlomo,15,0,15,0
1649907249328,ECE 5,A01,084049,Morris; Karcher William,16,0,20,4
1649907255349,ECE 100,A01,084051,Baghdadchi; Saharnaz,2,0,20,18
1649907255349,ECE 100,A02,091916,Baghdadchi; Saharnaz,17,0,20,3
1649907261377,ECE 101,A01,084053,Baghdadchi; Saharnaz,6,0,37,31
1649907261377,ECE 101,A02,084054,Baghdadchi; Saharnaz,36,0,37,1
1649907267400,ECE 107,A01,083390,Staff,29,0,40,11
1649907273426,ECE 148,A01,084056,Silberman; Jack,7,0,12,5
1649907279453,ECE 180,A00,083391,Abi Samra; Nicholas Camill,25,0,30,5
1649907279453,ECE 180,B00,083392,Abi Samra; Nicholas Camill,22,0,30,8
1649907285488,MATH 10B,A01,084110,Staff,10,0,30,20
1649907285488,MATH 10B,A02,084111,Staff,29,0,30,1
1649907285488,MATH 10B,A03,084112,Staff,28,0,30,2
1649907291510,MATH 10C,A01,083443,Staff,9,0,30,21
1649907291510,MATH 10C,A02,083444,Staff,17,0,30,13
1649907291510,MATH 10C,B01,084114,Staff,25,0,30,5
1649907291510,MATH 10C,B02,084115,Staff,29,0,30,1
1649907297534,MATH 18,A01,084117,Harel; Guershon,27,0,30,3
1649907297534,MATH 18,A02,084119,Harel; Guershon,29,0,30,1
1649907297534,MATH 18,A03,084120,Harel; Guershon,30,0,30,0
1649907297534,MATH 18,A04,084121,Harel; Guershon,29,0,30,1
1649907303565,MATH 20B,A01,084124,Um; Ko Woon,31,0,35,4
1649907303565,MATH 20B,B01,084126,Um; Ko Woon,33,0,35,2
1649907309595,MATH 20C,A01,083446,Hammock; Frances H,18,0,30,12
1649907309595,MATH 20C,A02,083447,Hammock; Frances H,28,0,30,2
1649907309595,MATH 20C,A03,083448,Hammock; Frances H,30,0,30,0
1649907309595,MATH 20C,A04,083449,Hammock; Frances H,30,0,30,0
1649907309595,MATH 20C,B01,083451,Hammock; Frances H,26,0,30,4
1649907309595,MATH 20C,B02,083452,Hammock; Frances H,28,0,30,2
1649907309595,MATH 20C,B03,083453,Hammock; Frances H,27,0,30,3
1649907309595,MATH 20C,B04,083454,Hammock; Frances H,30,0,30,0
1649907315620,MATH 20D,A01,084128,Staff,26,0,30,4
1649907315620,MATH 20D,A02,084129,Staff,30,0,30,0
1649907315620,MATH 20D,A03,084130,Staff,29,0,30,1
1649907315620,MATH 20D,B01,084133,Staff,23,0,30,7
1649907315620,MATH 20D,B02,084134,Staff,27,0,30,3
1649907315620,MATH 20D,B03,084135,Staff,30,0,30,0
1649907321649,MATH 20E,A01,084138,Staff,24,0,30,6
1649907321649,MATH 20E,A02,084139,Staff,24,0,30,6
1649907321649,MATH 20E,A03,084140,Staff,24,0,30,6
1649907321649,MATH 20E,A04,084141,Staff,27,0,30,3
1649907327675,MATH 102,A01,084143,Harel; Guershon,19,0,30,11
1649907327675,MATH 102,A02,084144,Harel; Guershon,22,0,30,8
1649907333713,MATH 103B,A01,083456,Staff,0,8,30,30
1649907333713,MATH 103B,A02,083457,Staff,0,8,30,30
1649907339737,MATH 109,A01,084146,Salehi Golsefidy; Alireza,29,0,30,1
1649907339737,MATH 109,A02,084147,Salehi Golsefidy; Alireza,22,0,30,8
1649907345761,MATH 120A,A01,085445,Eggers; John Dietrich,20,0,35,15
1649907345761,MATH 120A,A02,085446,Eggers; John Dietrich,28,0,35,7
1649907351792,MATH 142B,A01,084149,Verstraete; Jacques Allan,0,8,30,30
1649907351792,MATH 142B,A02,084150,Verstraete; Jacques Allan,0,7,30,30
1649907357813,MATH 170A,A01,083459,Nie; Jiawang,0,1,30,30
1649907357813,MATH 170A,A02,083460,Nie; Jiawang,0,0,30,30
1649907357813,MATH 170A,A03,083461,Nie; Jiawang,17,0,30,13
1649907363837,MATH 193B,A01,083463,Staff,3,0,30,27
1649907363837,MATH 193B,A02,083464,Staff,11,0,30,19
1649907363837,MATH 193B,A03,083465,Staff,20,0,30,10
1649907369890,COGS 2,A01,083966,Boyle; Mary E. T.,19,0,30,11
1649907375912,COGS 9,A01,083968,Staff,43,0,60,17
1649907381935,COGS 14B,A01,083970,Staff,32,0,50,18
1649907387958,COGS 17,A01,092679,Staff,68,0,75,7
1649907393983,COGS 100,A01,083972,Staff,19,0,60,41
1649907406030,COGS 101C,A01,083976,Staff,20,0,30,10
1649907412052,COGS 102A,A01,083978,Johnson; Christine M.,18,0,30,12
1649907418075,COGS 107B,A01,083980,Staff,7,0,50,43
1649907424109,COGS 115,A01,083982,Staff,13,0,30,17
1649907430134,COGS 118B,A01,083367,Staff,0,10,40,40
1649907436158,COGS 172,A01,083984,Provenzano; Emily Kara,17,0,30,13
1649907442182,COGS 177,A00,083368,Staff,1,16,30,29
1649907448205,COGS 186,A01,083986,Staff,22,0,40,18
1649907454227,COGS 187A,A01,083988,Boyle; Mary E. T.,24,0,60,36
1649907460252,CSE 8A,A50,084003,Miranda; Gregory Joseph,2,0,15,13
1649907466280,CSE 11,A01,084005,Miranda; Gregory Joseph,24,0,55,31
1649907472303,CSE 20,A01,084007,Staff,9,0,20,11
1649907478330,CSE 21,A01,084009,Staff,15,0,50,35
1649907484353,CSE 30,A01,083370,Cao; Yingjun,0,15,40,40
1649907490379,CSE 100,A01,083372,Cao; Yingjun,0,20,40,40
1649907496403,CSE 101,A01,084011,Staff,1,46,40,39
1649907502430,CSE 141,A01,083374,Eldon; John,1,49,75,74
1649907508463,CSE 141L,A01,083376,Eldon; John,1,53,75,74
1649907514490,CSE 175,A01,084013,Kumar; Rakesh,22,0,25,3
1649907520513,CSE 190,A00,092508,Dubnov; Shlomo,15,0,15,0
1649907526536,ECE 5,A01,084049,Morris; Karcher William,16,0,20,4
1649907532564,ECE 100,A01,084051,Baghdadchi; Saharnaz,2,0,20,18
1649907532564,ECE 100,A02,091916,Baghdadchi; Saharnaz,17,0,20,3
1649907538594,ECE 101,A01,084053,Baghdadchi; Saharnaz,6,0,37,31
1649907538594,ECE 101,A02,084054,Baghdadchi; Saharnaz,36,0,37,1
1649907544619,ECE 107,A01,083390,Staff,29,0,40,11
1649907550642,ECE 148,A01,084056,Silberman; Jack,7,0,12,5
1649907556665,ECE 180,A00,083391,Abi Samra; Nicholas Camill,25,0,30,5
1649907556665,ECE 180,B00,083392,Abi Samra; Nicholas Camill,22,0,30,8
1649907562697,MATH 10B,A01,084110,Staff,10,0,30,20
1649907562697,MATH 10B,A02,084111,Staff,29,0,30,1
1649907562697,MATH 10B,A03,084112,Staff,28,0,30,2
1649907568720,MATH 10C,A01,083443,Staff,9,0,30,21
1649907568720,MATH 10C,A02,083444,Staff,17,0,30,13
1649907568720,MATH 10C,B01,084114,Staff,25,0,30,5
1649907568720,MATH 10C,B02,084115,Staff,29,0,30,1
1649907574742,MATH 18,A01,084117,Harel; Guershon,27,0,30,3
1649907574742,MATH 18,A02,084119,Harel; Guershon,29,0,30,1
1649907574742,MATH 18,A03,084120,Harel; Guershon,30,0,30,0
1649907574742,MATH 18,A04,084121,Harel; Guershon,29,0,30,1
1649907580767,MATH 20B,A01,084124,Um; Ko Woon,31,0,35,4
1649907580767,MATH 20B,B01,084126,Um; Ko Woon,33,0,35,2
1649907586798,MATH 20C,A01,083446,Hammock; Frances H,18,0,30,12
1649907586798,MATH 20C,A02,083447,Hammock; Frances H,28,0,30,2
1649907586798,MATH 20C,A03,083448,Hammock; Frances H,30,0,30,0
1649907586798,MATH 20C,A04,083449,Hammock; Frances H,30,0,30,0
1649907586798,MATH 20C,B01,083451,Hammock; Frances H,26,0,30,4
1649907586798,MATH 20C,B02,083452,Hammock; Frances H,27,0,30,3
1649907586798,MATH 20C,B03,083453,Hammock; Frances H,27,0,30,3
1649907586798,MATH 20C,B04,083454,Hammock; Frances H,30,0,30,0
1649907592822,MATH 20D,A01,084128,Staff,26,0,30,4
1649907592822,MATH 20D,A02,084129,Staff,30,0,30,0
1649907592822,MATH 20D,A03,084130,Staff,29,0,30,1
1649907592822,MATH 20D,B01,084133,Staff,23,0,30,7
1649907592822,MATH 20D,B02,084134,Staff,27,0,30,3
1649907592822,MATH 20D,B03,084135,Staff,30,0,30,0
1649907598850,MATH 20E,A01,084138,Staff,24,0,30,6
1649907598850,MATH 20E,A02,084139,Staff,24,0,30,6
1649907598850,MATH 20E,A03,084140,Staff,24,0,30,6
1649907598850,MATH 20E,A04,084141,Staff,27,0,30,3
1649907604878,MATH 102,A01,084143,Harel; Guershon,19,0,30,11
1649907604878,MATH 102,A02,084144,Harel; Guershon,22,0,30,8
1649907610901,MATH 103B,A01,083456,Staff,0,8,30,30
1649907610901,MATH 103B,A02,083457,Staff,0,9,30,30
1649907616931,MATH 109,A01,084146,Salehi Golsefidy; Alireza,29,0,30,1
1649907616931,MATH 109,A02,084147,Salehi Golsefidy; Alireza,22,0,30,8
1649907622957,MATH 120A,A01,085445,Eggers; John Dietrich,20,0,35,15
1649907622957,MATH 120A,A02,085446,Eggers; John Dietrich,28,0,35,7
1649907628984,MATH 142B,A01,084149,Verstraete; Jacques Allan,0,8,30,30
1649907628984,MATH 142B,A02,084150,Verstraete; Jacques Allan,0,7,30,30
1649907635007,MATH 170A,A01,083459,Nie; Jiawang,0,1,30,30
1649907635007,MATH 170A,A02,083460,Nie; Jiawang,0,0,30,30
1649907635007,MATH 170A,A03,083461,Nie; Jiawang,17,0,30,13
1649907641030,MATH 193B,A01,083463,Staff,3,0,30,27
1649907641030,MATH 193B,A02,083464,Staff,11,0,30,19
1649907641030,MATH 193B,A03,083465,Staff,20,0,30,10
1649907647089,COGS 2,A01,083966,Boyle; Mary E. T.,19,0,30,11
1649907653112,COGS 9,A01,083968,Staff,43,0,60,17
1649907659138,COGS 14B,A01,083970,Staff,31,0,50,19
1649907665167,COGS 17,A01,092679,Staff,68,0,75,7
1649907671189,COGS 100,A01,083972,Staff,19,0,60,41
1649907683238,COGS 101C,A01,083976,Staff,20,0,30,10
1649907689266,COGS 102A,A01,083978,Johnson; Christine M.,18,0,30,12
1649907695295,COGS 107B,A01,083980,Staff,7,0,50,43
1649907701318,COGS 115,A01,083982,Staff,13,0,30,17
1649907707344,COGS 118B,A01,083367,Staff,0,10,40,40
1649907713367,COGS 172,A01,083984,Provenzano; Emily Kara,17,0,30,13
1649907719482,COGS 177,A00,083368,Staff,1,16,30,29
1649907725513,COGS 186,A01,083986,Staff,22,0,40,18
1649907731537,COGS 187A,A01,083988,Boyle; Mary E. T.,24,0,60,36
1649907737567,CSE 8A,A50,084003,Miranda; Gregory Joseph,2,0,15,13
1649907743594,CSE 11,A01,084005,Miranda; Gregory Joseph,24,0,55,31
1649907749624,CSE 20,A01,084007,Staff,9,0,20,11
1649907755674,CSE 21,A01,084009,Staff,15,0,50,35
1649907761703,CSE 30,A01,083370,Cao; Yingjun,0,15,40,40
1649907767739,CSE 100,A01,083372,Cao; Yingjun,0,21,40,40
1649907773762,CSE 101,A01,084011,Staff,1,47,40,39
1649907779787,CSE 141,A01,083374,Eldon; John,1,50,75,74
1649907785847,CSE 141L,A01,083376,Eldon; John,1,54,75,74
1649907791870,CSE 175,A01,084013,Kumar; Rakesh,22,0,25,3
1649907797893,CSE 190,A00,092508,Dubnov; Shlomo,15,0,15,0
1649907803915,ECE 5,A01,084049,Morris; Karcher William,16,0,20,4
1649907809940,ECE 100,A01,084051,Baghdadchi; Saharnaz,2,0,20,18
1649907809940,ECE 100,A02,091916,Baghdadchi; Saharnaz,17,0,20,3
1649907815964,ECE 101,A01,084053,Baghdadchi; Saharnaz,6,0,37,31
1649907815964,ECE 101,A02,084054,Baghdadchi; Saharnaz,36,0,37,1
1649907821987,ECE 107,A01,083390,Staff,29,0,40,11
1649907828023,ECE 148,A01,084056,Silberman; Jack,7,0,12,5
1649907834063,ECE 180,A00,083391,Abi Samra; Nicholas Camill,25,0,30,5
1649907834063,ECE 180,B00,083392,Abi Samra; Nicholas Camill,22,0,30,8
1649907840091,MATH 10B,A01,084110,Staff,9,0,30,21
1649907840091,MATH 10B,A02,084111,Staff,29,0,30,1
1649907840091,MATH 10B,A03,084112,Staff,28,0,30,2
1649907846113,MATH 10C,A01,083443,Staff,9,0,30,21
1649907846113,MATH 10C,A02,083444,Staff,17,0,30,13
1649907846113,MATH 10C,B01,084114,Staff,25,0,30,5
1649907846113,MATH 10C,B02,084115,Staff,29,0,30,1
1649907852140,MATH 18,A01,084117,Harel; Guershon,27,0,30,3
1649907852140,MATH 18,A02,084119,Harel; Guershon,29,0,30,1
1649907852140,MATH 18,A03,084120,Harel; Guershon,30,0,30,0
1649907852140,MATH 18,A04,084121,Harel; Guershon,29,0,30,1
1649907858163,MATH 20B,A01,084124,Um; Ko Woon,31,0,35,4
1649907858163,MATH 20B,B01,084126,Um; Ko Woon,33,0,35,2
1649907864189,MATH 20C,A01,083446,Hammock; Frances H,18,0,30,12
1649907864189,MATH 20C,A02,083447,Hammock; Frances H,28,0,30,2
1649907864189,MATH 20C,A03,083448,Hammock; Frances H,30,0,30,0
1649907864189,MATH 20C,A04,083449,Hammock; Frances H,30,0,30,0
1649907864189,MATH 20C,B01,083451,Hammock; Frances H,26,0,30,4
1649907864189,MATH 20C,B02,083452,Hammock; Frances H,27,0,30,3
1649907864189,MATH 20C,B03,083453,Hammock; Frances H,27,0,30,3
1649907864189,MATH 20C,B04,083454,Hammock; Frances H,30,0,30,0
1649907870212,MATH 20D,A01,084128,Staff,26,0,30,4
1649907870212,MATH 20D,A02,084129,Staff,30,0,30,0
1649907870212,MATH 20D,A03,084130,Staff,29,0,30,1
1649907870212,MATH 20D,B01,084133,Staff,23,0,30,7
1649907870212,MATH 20D,B02,084134,Staff,27,0,30,3
1649907870212,MATH 20D,B03,084135,Staff,30,0,30,0
1649907876234,MATH 20E,A01,084138,Staff,24,0,30,6
1649907876234,MATH 20E,A02,084139,Staff,24,0,30,6
1649907876234,MATH 20E,A03,084140,Staff,24,0,30,6
1649907876234,MATH 20E,A04,084141,Staff,27,0,30,3
1649907882258,MATH 102,A01,084143,Harel; Guershon,19,0,30,11
1649907882258,MATH 102,A02,084144,Harel; Guershon,22,0,30,8
1649907888289,MATH 103B,A01,083456,Staff,0,8,30,30
1649907888289,MATH 103B,A02,083457,Staff,0,9,30,30
1649907894317,MATH 109,A01,084146,Salehi Golsefidy; Alireza,29,0,30,1
1649907894317,MATH 109,A02,084147,Salehi Golsefidy; Alireza,22,0,30,8
1649907900339,MATH 120A,A01,085445,Eggers; John Dietrich,20,0,35,15
1649907900339,MATH 120A,A02,085446,Eggers; John Dietrich,28,0,35,7
1649907906362,MATH 142B,A01,084149,Verstraete; Jacques Allan,0,8,30,30
1649907906362,MATH 142B,A02,084150,Verstraete; Jacques Allan,0,7,30,30
1649907912392,MATH 170A,A01,083459,Nie; Jiawang,0,1,30,30
1649907912392,MATH 170A,A02,083460,Nie; Jiawang,0,0,30,30
1649907912392,MATH 170A,A03,083461,Nie; Jiawang,16,0,30,14
1649907918423,MATH 193B,A01,083463,Staff,3,0,30,27
1649907918423,MATH 193B,A02,083464,Staff,11,0,30,19
1649907918423,MATH 193B,A03,083465,Staff,20,0,30,10
1649907924476,COGS 2,A01,083966,Boyle; Mary E. T.,19,0,30,11
1649907930515,COGS 9,A01,083968,Staff,43,0,60,17
1649907936539,COGS 14B,A01,083970,Staff,30,0,50,20
1649907942561,COGS 17,A01,092679,Staff,67,0,75,8
1649907948586,COGS 100,A01,083972,Staff,16,0,60,44
1649907960634,COGS 101C,A01,083976,Staff,19,0,30,11
1649907966659,COGS 102A,A01,083978,Johnson; Christine M.,18,0,30,12
1649907972683,COGS 107B,A01,083980,Staff,7,0,50,43
1649907978705,COGS 115,A01,083982,Staff,13,0,30,17
1649907984728,COGS 118B,A01,083367,Staff,0,10,40,40
1649907990760,COGS 172,A01,083984,Provenzano; Emily Kara,17,0,30,13
1649907996795,COGS 177,A00,083368,Staff,1,16,30,29
1649908002822,COGS 186,A01,083986,Staff,22,0,40,18
1649908008844,COGS 187A,A01,083988,Boyle; Mary E. T.,24,0,60,36
1649908014883,CSE 8A,A50,084003,Miranda; Gregory Joseph,2,0,15,13
1649908020910,CSE 11,A01,084005,Miranda; Gregory Joseph,24,0,55,31
1649908026933,CSE 20,A01,084007,Staff,9,0,20,11
1649908032968,CSE 21,A01,084009,Staff,15,0,50,35
1649908038996,CSE 30,A01,083370,Cao; Yingjun,0,15,40,40
1649908045023,CSE 100,A01,083372,Cao; Yingjun,0,21,40,40
1649908051049,CSE 101,A01,084011,Staff,1,47,40,39
1649908057075,CSE 141,A01,083374,Eldon; John,1,50,75,74
1649908063099,CSE 141L,A01,083376,Eldon; John,1,54,75,74
1649908069123,CSE 175,A01,084013,Kumar; Rakesh,22,0,25,3
1649908075146,CSE 190,A00,092508,Dubnov; Shlomo,15,0,15,0
1649908081257,ECE 5,A01,084049,Morris; Karcher William,16,0,20,4
1649908087282,ECE 100,A01,084051,Baghdadchi; Saharnaz,2,0,20,18
1649908087282,ECE 100,A02,091916,Baghdadchi; Saharnaz,17,0,20,3
1649908093314,ECE 101,A01,084053,Baghdadchi; Saharnaz,6,0,37,31
1649908093314,ECE 101,A02,084054,Baghdadchi; Saharnaz,36,0,37,1
1649908099343,ECE 107,A01,083390,Staff,29,0,40,11
1649908105365,ECE 148,A01,084056,Silberman; Jack,7,0,12,5
1649908111389,ECE 180,A00,083391,Abi Samra; Nicholas Camill,25,0,30,5
1649908111389,ECE 180,B00,083392,Abi Samra; Nicholas Camill,22,0,30,8
1649908117412,MATH 10B,A01,084110,Staff,9,0,30,21
1649908117412,MATH 10B,A02,084111,Staff,29,0,30,1
1649908117412,MATH 10B,A03,084112,Staff,28,0,30,2
1649908123451,MATH 10C,A01,083443,Staff,9,0,30,21
1649908123451,MATH 10C,A02,083444,Staff,17,0,30,13
1649908123451,MATH 10C,B01,084114,Staff,25,0,30,5
1649908123451,MATH 10C,B02,084115,Staff,29,0,30,1
1649908129475,MATH 18,A01,084117,Harel; Guershon,27,0,30,3
1649908129475,MATH 18,A02,084119,Harel; Guershon,29,0,30,1
1649908129475,MATH 18,A03,084120,Harel; Guershon,30,0,30,0
1649908129475,MATH 18,A04,084121,Harel; Guershon,29,0,30,1
1649908135498,MATH 20B,A01,084124,Um; Ko Woon,31,0,35,4
1649908135498,MATH 20B,B01,084126,Um; Ko Woon,32,0,35,3
1649908141521,MATH 20C,A01,083446,Hammock; Frances H,18,0,30,12
1649908141521,MATH 20C,A02,083447,Hammock; Frances H,28,0,30,2
1649908141521,MATH 20C,A03,083448,Hammock; Frances H,30,0,30,0
1649908141521,MATH 20C,A04,083449,Hammock; Frances H,30,0,30,0
1649908141521,MATH 20C,B01,083451,Hammock; Frances H,26,0,30,4
1649908141521,MATH 20C,B02,083452,Hammock; Frances H,27,0,30,3
1649908141521,MATH 20C,B03,083453,Hammock; Frances H,27,0,30,3
1649908141521,MATH 20C,B04,083454,Hammock; Frances H,30,0,30,0
1649908147553,MATH 20D,A01,084128,Staff,26,0,30,4
1649908147553,MATH 20D,A02,084129,Staff,30,0,30,0
1649908147553,MATH 20D,A03,084130,Staff,29,0,30,1
1649908147553,MATH 20D,B01,084133,Staff,23,0,30,7
1649908147553,MATH 20D,B02,084134,Staff,27,0,30,3
1649908147553,MATH 20D,B03,084135,Staff,30,0,30,0
1649908153578,MATH 20E,A01,084138,Staff,24,0,30,6
1649908153578,MATH 20E,A02,084139,Staff,23,0,30,7
1649908153578,MATH 20E,A03,084140,Staff,24,0,30,6
1649908153578,MATH 20E,A04,084141,Staff,27,0,30,3
1649908159601,MATH 102,A01,084143,Harel; Guershon,19,0,30,11
1649908159601,MATH 102,A02,084144,Harel; Guershon,22,0,30,8
1649908165628,MATH 103B,A01,083456,Staff,0,8,30,30
1649908165628,MATH 103B,A02,083457,Staff,0,9,30,30
1649908171650,MATH 109,A01,084146,Salehi Golsefidy; Alireza,29,0,30,1
1649908171650,MATH 109,A02,084147,Salehi Golsefidy; Alireza,22,0,30,8
1649908177677,MATH 120A,A01,085445,Eggers; John Dietrich,20,0,35,15
1649908177677,MATH 120A,A02,085446,Eggers; John Dietrich,28,0,35,7
1649908183704,MATH 142B,A01,084149,Verstraete; Jacques Allan,0,8,30,30
1649908183704,MATH 142B,A02,084150,Verstraete; Jacques Allan,0,7,30,30
1649908189731,MATH 170A,A01,083459,Nie; Jiawang,0,1,30,30
1649908189731,MATH 170A,A02,083460,Nie; Jiawang,0,0,30,30
1649908189731,MATH 170A,A03,083461,Nie; Jiawang,16,0,30,14
1649908195755,MATH 193B,A01,083463,Staff,3,0,30,27
1649908195755,MATH 193B,A02,083464,Staff,11,0,30,19
1649908195755,MATH 193B,A03,083465,Staff,20,0,30,10
1649908201805,COGS 2,A01,083966,Boyle; Mary E. T.,19,0,30,11
1649908207832,COGS 9,A01,083968,Staff,43,0,60,17
1649908213854,COGS 14B,A01,083970,Staff,30,0,50,20
1649908219876,COGS 17,A01,092679,Staff,67,0,75,8
1649908225918,COGS 100,A01,083972,Staff,16,0,60,44
1649908237964,COGS 101C,A01,083976,Staff,19,0,30,11
1649908243986,COGS 102A,A01,083978,Johnson; Christine M.,18,0,30,12
1649908250010,COGS 107B,A01,083980,Staff,7,0,50,43
1649908256038,COGS 115,A01,083982,Staff,13,0,30,17
1649908262065,COGS 118B,A01,083367,Staff,0,10,40,40
1649908268088,COGS 172,A01,083984,Provenzano; Emily Kara,17,0,30,13
1649908274111,COGS 177,A00,083368,Staff,1,16,30,29
1649908280136,COGS 186,A01,083986,Staff,22,0,40,18
1649908286160,COGS 187A,A01,083988,Boyle; Mary E. T.,24,0,60,36
1649908292184,CSE 8A,A50,084003,Miranda; Gregory Joseph,2,0,15,13
1649908298206,CSE 11,A01,084005,Miranda; Gregory Joseph,24,0,55,31
1649908304230,CSE 20,A01,084007,Staff,9,0,20,11
1649908310252,CSE 21,A01,084009,Staff,14,0,50,36
1649908316374,CSE 30,A01,083370,Cao; Yingjun,0,15,40,40
1649908322424,CSE 100,A01,083372,Cao; Yingjun,0,21,40,40
1649908328454,CSE 101,A01,084011,Staff,1,47,40,39
1649908334482,CSE 141,A01,083374,Eldon; John,1,50,75,74
1649908340506,CSE 141L,A01,083376,Eldon; John,1,54,75,74
1649908346532,CSE 175,A01,084013,Kumar; Rakesh,22,0,25,3
1649908352554,CSE 190,A00,092508,Dubnov; Shlomo,15,0,15,0
1649908358581,ECE 5,A01,084049,Morris; Karcher William,16,0,20,4
1649908364604,ECE 100,A01,084051,Baghdadchi; Saharnaz,2,0,20,18
1649908364604,ECE 100,A02,091916,Baghdadchi; Saharnaz,17,0,20,3
1649908370627,ECE 101,A01,084053,Baghdadchi; Saharnaz,6,0,37,31
1649908370627,ECE 101,A02,084054,Baghdadchi; Saharnaz,36,0,37,1
1649908376657,ECE 107,A01,083390,Staff,29,0,40,11
1649908382679,ECE 148,A01,084056,Silberman; Jack,7,0,12,5
1649908388702,ECE 180,A00,083391,Abi Samra; Nicholas Camill,25,0,30,5
1649908388702,ECE 180,B00,083392,Abi Samra; Nicholas Camill,22,0,30,8
1649908394729,MATH 10B,A01,084110,Staff,9,0,30,21
1649908394729,MATH 10B,A02,084111,Staff,29,0,30,1
1649908394729,MATH 10B,A03,084112,Staff,28,0,30,2
1649908400752,MATH 10C,A01,083443,Staff,9,0,30,21
1649908400752,MATH 10C,A02,083444,Staff,17,0,30,13
1649908400752,MATH 10C,B01,084114,Staff,25,0,30,5
1649908400752,MATH 10C,B02,084115,Staff,29,0,30,1
1649908406784,MATH 18,A01,084117,Harel; Guershon,27,0,30,3
1649908406784,MATH 18,A02,084119,Harel; Guershon,29,0,30,1
1649908406784,MATH 18,A03,084120,Harel; Guershon,30,0,30,0
1649908406784,MATH 18,A04,084121,Harel; Guershon,29,0,30,1
1649908412815,MATH 20B,A01,084124,Um; Ko Woon,31,0,35,4
1649908412815,MATH 20B,B01,084126,Um; Ko Woon,32,0,35,3
1649908418844,MATH 20C,A01,083446,Hammock; Frances H,18,0,30,12
1649908418844,MATH 20C,A02,083447,Hammock; Frances H,28,0,30,2
1649908418844,MATH 20C,A03,083448,Hammock; Frances H,30,0,30,0
1649908418844,MATH 20C,A04,083449,Hammock; Frances H,30,0,30,0
1649908418844,MATH 20C,B01,083451,Hammock; Frances H,26,0,30,4
1649908418844,MATH 20C,B02,083452,Hammock; Frances H,27,0,30,3
1649908418844,MATH 20C,B03,083453,Hammock; Frances H,27,0,30,3
1649908418844,MATH 20C,B04,083454,Hammock; Frances H,30,0,30,0
1649908424869,MATH 20D,A01,084128,Staff,26,0,30,4
1649908424869,MATH 20D,A02,084129,Staff,30,0,30,0
1649908424869,MATH 20D,A03,084130,Staff,29,0,30,1
1649908424869,MATH 20D,B01,084133,Staff,23,0,30,7
1649908424869,MATH 20D,B02,084134,Staff,27,0,30,3
1649908424869,MATH 20D,B03,084135,Staff,30,0,30,0
1649908430900,MATH 20E,A01,084138,Staff,24,0,30,6
1649908430900,MATH 20E,A02,084139,Staff,23,0,30,7
1649908430900,MATH 20E,A03,084140,Staff,24,0,30,6
1649908430900,MATH 20E,A04,084141,Staff,27,0,30,3
1649908436926,MATH 102,A01,084143,Harel; Guershon,19,0,30,11
1649908436926,MATH 102,A02,084144,Harel; Guershon,22,0,30,8
1649908442950,MATH 103B,A01,083456,Staff,0,8,30,30
1649908442950,MATH 103B,A02,083457,Staff,0,9,30,30
1649908448974,MATH 109,A01,084146,Salehi Golsefidy; Alireza,29,0,30,1
1649908448974,MATH 109,A02,084147,Salehi Golsefidy; Alireza,22,0,30,8
1649908454999,MATH 120A,A01,085445,Eggers; John Dietrich,20,0,35,15
1649908454999,MATH 120A,A02,085446,Eggers; John Dietrich,28,0,35,7
1649908461027,MATH 142B,A01,084149,Verstraete; Jacques Allan,0,8,30,30
1649908461027,MATH 142B,A02,084150,Verstraete; Jacques Allan,0,7,30,30
1649908467050,MATH 170A,A01,083459,Nie; Jiawang,0,1,30,30
1649908467050,MATH 170A,A02,083460,Nie; Jiawang,0,0,30,30
1649908467050,MATH 170A,A03,083461,Nie; Jiawang,16,0,30,14
1649908473072,MATH 193B,A01,083463,Staff,3,0,30,27
1649908473072,MATH 193B,A02,083464,Staff,11,0,30,19
1649908473072,MATH 193B,A03,083465,Staff,20,0,30,10
1649908479136,COGS 2,A01,083966,Boyle; Mary E. T.,19,0,30,11
1649908485160,COGS 9,A01,083968,Staff,43,0,60,17
1649908491183,COGS 14B,A01,083970,Staff,30,0,50,20
1649908497205,COGS 17,A01,092679,Staff,67,0,75,8
1649908503228,COGS 100,A01,083972,Staff,15,0,60,45
1649908515272,COGS 101C,A01,083976,Staff,19,0,30,11
1649908521300,COGS 102A,A01,083978,Johnson; Christine M.,18,0,30,12
1649908527329,COGS 107B,A01,083980,Staff,7,0,50,43
1649908533351,COGS 115,A01,083982,Staff,14,0,30,16
1649908539375,COGS 118B,A01,083367,Staff,0,10,40,40
1649908545402,COGS 172,A01,083984,Provenzano; Emily Kara,17,0,30,13
1649908551428,COGS 177,A00,083368,Staff,1,16,30,29
1649908557452,COGS 186,A01,083986,Staff,22,0,40,18
1649908563480,COGS 187A,A01,083988,Boyle; Mary E. T.,24,0,60,36
1649908569503,CSE 8A,A50,084003,Miranda; Gregory Joseph,2,0,15,13
1649908575530,CSE 11,A01,084005,Miranda; Gregory Joseph,23,0,55,32
1649908581553,CSE 20,A01,084007,Staff,9,0,20,11
1649908587590,CSE 21,A01,084009,Staff,14,0,50,36
1649908593615,CSE 30,A01,083370,Cao; Yingjun,0,15,40,40
1649908599640,CSE 100,A01,083372,Cao; Yingjun,0,21,40,40
1649908605665,CSE 101,A01,084011,Staff,1,47,40,39
1649908611699,CSE 141,A01,083374,Eldon; John,1,50,75,74
1649908617723,CSE 141L,A01,083376,Eldon; John,1,54,75,74
1649908623750,CSE 175,A01,084013,Kumar; Rakesh,22,0,25,3
1649908629773,CSE 190,A00,092508,Dubnov; Shlomo,15,0,15,0
1649908635797,ECE 5,A01,084049,Morris; Karcher William,16,0,20,4
1649908641821,ECE 100,A01,084051,Baghdadchi; Saharnaz,2,0,20,18
1649908641821,ECE 100,A02,091916,Baghdadchi; Saharnaz,17,0,20,3
1649908647848,ECE 101,A01,084053,Baghdadchi; Saharnaz,6,0,37,31
1649908647848,ECE 101,A02,084054,Baghdadchi; Saharnaz,36,0,37,1
1649908653875,ECE 107,A01,083390,Staff,29,0,40,11
1649908659902,ECE 148,A01,084056,Silberman; Jack,7,0,12,5
1649908665942,ECE 180,A00,083391,Abi Samra; Nicholas Camill,25,0,30,5
1649908665942,ECE 180,B00,083392,Abi Samra; Nicholas Camill,22,0,30,8
1649908671980,MATH 10B,A01,084110,Staff,9,0,30,21
1649908671980,MATH 10B,A02,084111,Staff,29,0,30,1
1649908671980,MATH 10B,A03,084112,Staff,28,0,30,2
1649908678006,MATH 10C,A01,083443,Staff,9,0,30,21
1649908678006,MATH 10C,A02,083444,Staff,17,0,30,13
1649908678006,MATH 10C,B01,084114,Staff,25,0,30,5
1649908678006,MATH 10C,B02,084115,Staff,29,0,30,1
1649908684030,MATH 18,A01,084117,Harel; Guershon,27,0,30,3
1649908684030,MATH 18,A02,084119,Harel; Guershon,29,0,30,1
1649908684030,MATH 18,A03,084120,Harel; Guershon,30,0,30,0
1649908684030,MATH 18,A04,084121,Harel; Guershon,29,0,30,1
1649908690054,MATH 20B,A01,084124,Um; Ko Woon,31,0,35,4
1649908690054,MATH 20B,B01,084126,Um; Ko Woon,32,0,35,3
1649908696083,MATH 20C,A01,083446,Hammock; Frances H,18,0,30,12
1649908696083,MATH 20C,A02,083447,Hammock; Frances H,28,0,30,2
1649908696083,MATH 20C,A03,083448,Hammock; Frances H,30,0,30,0
1649908696083,MATH 20C,A04,083449,Hammock; Frances H,30,0,30,0
1649908696083,MATH 20C,B01,083451,Hammock; Frances H,26,0,30,4
1649908696083,MATH 20C,B02,083452,Hammock; Frances H,27,0,30,3
1649908696083,MATH 20C,B03,083453,Hammock; Frances H,27,0,30,3
1649908696083,MATH 20C,B04,083454,Hammock; Frances H,30,0,30,0
1649908702111,MATH 20D,A01,084128,Staff,26,0,30,4
1649908702111,MATH 20D,A02,084129,Staff,30,0,30,0
1649908702111,MATH 20D,A03,084130,Staff,29,0,30,1
1649908702111,MATH 20D,B01,084133,Staff,23,0,30,7
1649908702111,MATH 20D,B02,084134,Staff,27,0,30,3
1649908702111,MATH 20D,B03,084135,Staff,30,0,30,0
1649908708136,MATH 20E,A01,084138,Staff,24,0,30,6
1649908708136,MATH 20E,A02,084139,Staff,23,0,30,7
1649908708136,MATH 20E,A03,084140,Staff,24,0,30,6
1649908708136,MATH 20E,A04,084141,Staff,27,0,30,3
1649908714160,MATH 102,A01,084143,Harel; Guershon,19,0,30,11
1649908714160,MATH 102,A02,084144,Harel; Guershon,22,0,30,8
1649908720187,MATH 103B,A01,083456,Staff,0,8,30,30
1649908720187,MATH 103B,A02,083457,Staff,0,9,30,30
1649908726219,MATH 109,A01,084146,Salehi Golsefidy; Alireza,29,0,30,1
1649908726219,MATH 109,A02,084147,Salehi Golsefidy; Alireza,22,0,30,8
1649908732244,MATH 120A,A01,085445,Eggers; John Dietrich,20,0,35,15
1649908732244,MATH 120A,A02,085446,Eggers; John Dietrich,28,0,35,7
1649908738267,MATH 142B,A01,084149,Verstraete; Jacques Allan,0,8,30,30
1649908738267,MATH 142B,A02,084150,Verstraete; Jacques Allan,0,7,30,30
1649908744296,MATH 170A,A01,083459,Nie; Jiawang,0,1,30,30
1649908744296,MATH 170A,A02,083460,Nie; Jiawang,0,0,30,30
1649908744296,MATH 170A,A03,083461,Nie; Jiawang,14,0,30,16
1649908750319,MATH 193B,A01,083463,Staff,3,0,30,27
1649908750319,MATH 193B,A02,083464,Staff,11,0,30,19
1649908750319,MATH 193B,A03,083465,Staff,20,0,30,10
1649908756387,COGS 2,A01,083966,Boyle; Mary E. T.,19,0,30,11
1649908762419,COGS 9,A01,083968,Staff,43,0,60,17
1649908768463,COGS 14B,A01,083970,Staff,30,0,50,20
1649908774486,COGS 17,A01,092679,Staff,67,0,75,8
1649908780518,COGS 100,A01,083972,Staff,15,0,60,45
1649908792564,COGS 101C,A01,083976,Staff,19,0,30,11
1649908798592,COGS 102A,A01,083978,Johnson; Christine M.,17,0,30,13
1649908804615,COGS 107B,A01,083980,Staff,7,0,50,43
1649908810639,COGS 115,A01,083982,Staff,14,0,30,16
1649908816666,COGS 118B,A01,083367,Staff,0,10,40,40
1649908822693,COGS 172,A01,083984,Provenzano; Emily Kara,17,0,30,13
1649908828715,COGS 177,A00,083368,Staff,1,17,30,29
1649908834738,COGS 186,A01,083986,Staff,22,0,40,18
1649908840765,COGS 187A,A01,083988,Boyle; Mary E. T.,24,0,60,36
1649908846793,CSE 8A,A50,084003,Miranda; Gregory Joseph,2,0,15,13
1649908852829,CSE 11,A01,084005,Miranda; Gregory Joseph,23,0,55,32
1649908858857,CSE 20,A01,084007,Staff,9,0,20,11
1649908864890,CSE 21,A01,084009,Staff,14,0,50,36
1649908870918,CSE 30,A01,083370,Cao; Yingjun,0,15,40,40
1649908876945,CSE 100,A01,083372,Cao; Yingjun,0,21,40,40
1649908882971,CSE 101,A01,084011,Staff,1,47,40,39
1649908888998,CSE 141,A01,083374,Eldon; John,1,50,75,74
1649908895024,CSE 141L,A01,083376,Eldon; John,1,54,75,74
1649908901048,CSE 175,A01,084013,Kumar; Rakesh,22,0,25,3
1649908907072,CSE 190,A00,092508,Dubnov; Shlomo,15,0,15,0
1649908913191,ECE 5,A01,084049,Morris; Karcher William,16,0,20,4
1649908919225,ECE 100,A01,084051,Baghdadchi; Saharnaz,2,0,20,18
1649908919225,ECE 100,A02,091916,Baghdadchi; Saharnaz,17,0,20,3
1649908925250,ECE 101,A01,084053,Baghdadchi; Saharnaz,5,0,37,32
1649908925250,ECE 101,A02,084054,Baghdadchi; Saharnaz,36,0,37,1
1649908931278,ECE 107,A01,083390,Staff,29,0,40,11
1649908937303,ECE 148,A01,084056,Silberman; Jack,7,0,12,5
1649908943327,ECE 180,A00,083391,Abi Samra; Nicholas Camill,25,0,30,5
1649908943327,ECE 180,B00,083392,Abi Samra; Nicholas Camill,22,0,30,8
1649908949358,MATH 10B,A01,084110,Staff,9,0,30,21
1649908949358,MATH 10B,A02,084111,Staff,29,0,30,1
1649908949358,MATH 10B,A03,084112,Staff,28,0,30,2
1649908955387,MATH 10C,A01,083443,Staff,9,0,30,21
1649908955387,MATH 10C,A02,083444,Staff,17,0,30,13
1649908955387,MATH 10C,B01,084114,Staff,25,0,30,5
1649908955387,MATH 10C,B02,084115,Staff,29,0,30,1
1649908961412,MATH 18,A01,084117,Harel; Guershon,27,0,30,3
1649908961412,MATH 18,A02,084119,Harel; Guershon,29,0,30,1
1649908961412,MATH 18,A03,084120,Harel; Guershon,30,0,30,0
1649908961412,MATH 18,A04,084121,Harel; Guershon,29,0,30,1
1649908967441,MATH 20B,A01,084124,Um; Ko Woon,31,0,35,4
1649908967441,MATH 20B,B01,084126,Um; Ko Woon,32,0,35,3
1649908973466,MATH 20C,A01,083446,Hammock; Frances H,18,0,30,12
1649908973466,MATH 20C,A02,083447,Hammock; Frances H,28,0,30,2
1649908973466,MATH 20C,A03,083448,Hammock; Frances H,30,0,30,0
1649908973466,MATH 20C,A04,083449,Hammock; Frances H,30,0,30,0
1649908973466,MATH 20C,B01,083451,Hammock; Frances H,26,0,30,4
1649908973466,MATH 20C,B02,083452,Hammock; Frances H,27,0,30,3
1649908973466,MATH 20C,B03,083453,Hammock; Frances H,27,0,30,3
1649908973466,MATH 20C,B04,083454,Hammock; Frances H,30,0,30,0
1649908979492,MATH 20D,A01,084128,Staff,26,0,30,4
1649908979492,MATH 20D,A02,084129,Staff,30,0,30,0
1649908979492,MATH 20D,A03,084130,Staff,29,0,30,1
1649908979492,MATH 20D,B01,084133,Staff,23,0,30,7
1649908979492,MATH 20D,B02,084134,Staff,27,0,30,3
1649908979492,MATH 20D,B03,084135,Staff,30,0,30,0
1649908985524,MATH 20E,A01,084138,Staff,24,0,30,6
1649908985524,MATH 20E,A02,084139,Staff,23,0,30,7
1649908985524,MATH 20E,A03,084140,Staff,24,0,30,6
1649908985524,MATH 20E,A04,084141,Staff,27,0,30,3
1649908991551,MATH 102,A01,084143,Harel; Guershon,19,0,30,11
1649908991551,MATH 102,A02,084144,Harel; Guershon,22,0,30,8
1649908997574,MATH 103B,A01,083456,Staff,0,8,30,30
1649908997574,MATH 103B,A02,083457,Staff,0,9,30,30
1649909003601,MATH 109,A01,084146,Salehi Golsefidy; Alireza,29,0,30,1
1649909003601,MATH 109,A02,084147,Salehi Golsefidy; Alireza,22,0,30,8
1649909009629,MATH 120A,A01,085445,Eggers; John Dietrich,20,0,35,15
1649909009629,MATH 120A,A02,085446,Eggers; John Dietrich,28,0,35,7
1649909015666,MATH 142B,A01,084149,Verstraete; Jacques Allan,0,8,30,30
1649909015666,MATH 142B,A02,084150,Verstraete; Jacques Allan,0,7,30,30
1649909021690,MATH 170A,A01,083459,Nie; Jiawang,0,1,30,30
1649909021690,MATH 170A,A02,083460,Nie; Jiawang,0,0,30,30
1649909021690,MATH 170A,A03,083461,Nie; Jiawang,14,0,30,16
1649909027715,MATH 193B,A01,083463,Staff,3,0,30,27
1649909027715,MATH 193B,A02,083464,Staff,11,0,30,19
1649909027715,MATH 193B,A03,083465,Staff,20,0,30,10
1649909033766,COGS 2,A01,083966,Boyle; Mary E. T.,19,0,30,11
1649909039791,COGS 9,A01,083968,Staff,43,0,60,17
1649909045826,COGS 14B,A01,083970,Staff,30,0,50,20
1649909051852,COGS 17,A01,092679,Staff,67,0,75,8
1649909057875,COGS 100,A01,083972,Staff,14,0,60,46
1649909069942,COGS 101C,A01,083976,Staff,19,0,30,11
1649909075972,COGS 102A,A01,083978,Johnson; Christine M.,17,0,30,13
1649909082001,COGS 107B,A01,083980,Staff,7,0,50,43
1649909088031,COGS 115,A01,083982,Staff,14,0,30,16
1649909094061,COGS 118B,A01,083367,Staff,0,10,40,40
1649909100084,COGS 172,A01,083984,Provenzano; Emily Kara,17,0,30,13
1649909106126,COGS 177,A00,083368,Staff,1,17,30,29
1649909112147,COGS 186,A01,083986,Staff,22,0,40,18
1649909118178,COGS 187A,A01,083988,Boyle; Mary E. T.,24,0,60,36
1649909124200,CSE 8A,A50,084003,Miranda; Gregory Joseph,2,0,15,13
1649909130228,CSE 11,A01,084005,Miranda; Gregory Joseph,23,0,55,32
1649909136252,CSE 20,A01,084007,Staff,9,0,20,11
1649909142275,CSE 21,A01,084009,Staff,14,0,50,36
1649909148303,CSE 30,A01,083370,Cao; Yingjun,0,15,40,40
1649909154325,CSE 100,A01,083372,Cao; Yingjun,0,21,40,40
1649909160353,CSE 101,A01,084011,Staff,1,47,40,39
1649909166375,CSE 141,A01,083374,Eldon; John,1,50,75,74
1649909172399,CSE 141L,A01,083376,Eldon; John,1,54,75,74
1649909178421,CSE 175,A01,084013,Kumar; Rakesh,22,0,25,3
1649909184453,CSE 190,A00,092508,Dubnov; Shlomo,15,0,15,0
1649909190481,ECE 5,A01,084049,Morris; Karcher William,16,0,20,4
1649909196504,ECE 100,A01,084051,Baghdadchi; Saharnaz,2,0,20,18
1649909196504,ECE 100,A02,091916,Baghdadchi; Saharnaz,17,0,20,3
1649909202531,ECE 101,A01,084053,Baghdadchi; Saharnaz,5,0,37,32
1649909202531,ECE 101,A02,084054,Baghdadchi; Saharnaz,36,0,37,1
1649909208555,ECE 107,A01,083390,Staff,29,0,40,11
1649909214578,ECE 148,A01,084056,Silberman; Jack,7,0,12,5
1649909220601,ECE 180,A00,083391,Abi Samra; Nicholas Camill,25,0,30,5
1649909220601,ECE 180,B00,083392,Abi Samra; Nicholas Camill,22,0,30,8
1649909226628,MATH 10B,A01,084110,Staff,9,0,30,21
1649909226628,MATH 10B,A02,084111,Staff,29,0,30,1
1649909226628,MATH 10B,A03,084112,Staff,28,0,30,2
1649909232655,MATH 10C,A01,083443,Staff,9,0,30,21
1649909232655,MATH 10C,A02,083444,Staff,17,0,30,13
1649909232655,MATH 10C,B01,084114,Staff,25,0,30,5
1649909232655,MATH 10C,B02,084115,Staff,29,0,30,1
1649909238679,MATH 18,A01,084117,Harel; Guershon,27,0,30,3
1649909238679,MATH 18,A02,084119,Harel; Guershon,29,0,30,1
1649909238679,MATH 18,A03,084120,Harel; Guershon,30,0,30,0
1649909238679,MATH 18,A04,084121,Harel; Guershon,29,0,30,1
1649909244701,MATH 20B,A01,084124,Um; Ko Woon,31,0,35,4
1649909244701,MATH 20B,B01,084126,Um; Ko Woon,32,0,35,3
1649909250725,MATH 20C,A01,083446,Hammock; Frances H,18,0,30,12
1649909250725,MATH 20C,A02,083447,Hammock; Frances H,28,0,30,2
1649909250725,MATH 20C,A03,083448,Hammock; Frances H,30,0,30,0
1649909250725,MATH 20C,A04,083449,Hammock; Frances H,30,0,30,0
1649909250725,MATH 20C,B01,083451,Hammock; Frances H,26,0,30,4
1649909250725,MATH 20C,B02,083452,Hammock; Frances H,27,0,30,3
1649909250725,MATH 20C,B03,083453,Hammock; Frances H,27,0,30,3
1649909250725,MATH 20C,B04,083454,Hammock; Frances H,30,0,30,0
1649909256749,MATH 20D,A01,084128,Staff,26,0,30,4
1649909256749,MATH 20D,A02,084129,Staff,30,0,30,0
1649909256749,MATH 20D,A03,084130,Staff,29,0,30,1
1649909256749,MATH 20D,B01,084133,Staff,23,0,30,7
1649909256749,MATH 20D,B02,084134,Staff,27,0,30,3
1649909256749,MATH 20D,B03,084135,Staff,30,0,30,0
1649909262776,MATH 20E,A01,084138,Staff,24,0,30,6
1649909262776,MATH 20E,A02,084139,Staff,23,0,30,7
1649909262776,MATH 20E,A03,084140,Staff,24,0,30,6
1649909262776,MATH 20E,A04,084141,Staff,27,0,30,3
1649909268804,MATH 102,A01,084143,Harel; Guershon,19,0,30,11
1649909268804,MATH 102,A02,084144,Harel; Guershon,22,0,30,8
1649909274828,MATH 103B,A01,083456,Staff,0,8,30,30
1649909274828,MATH 103B,A02,083457,Staff,0,9,30,30
1649909280853,MATH 109,A01,084146,Salehi Golsefidy; Alireza,29,0,30,1
1649909280853,MATH 109,A02,084147,Salehi Golsefidy; Alireza,22,0,30,8
1649909286880,MATH 120A,A01,085445,Eggers; John Dietrich,20,0,35,15
1649909286880,MATH 120A,A02,085446,Eggers; John Dietrich,28,0,35,7
1649909292904,MATH 142B,A01,084149,Verstraete; Jacques Allan,0,8,30,30
1649909292904,MATH 142B,A02,084150,Verstraete; Jacques Allan,0,8,30,30
1649909298930,MATH 170A,A01,083459,Nie; Jiawang,0,1,30,30
1649909298930,MATH 170A,A02,083460,Nie; Jiawang,0,0,30,30
1649909298930,MATH 170A,A03,083461,Nie; Jiawang,14,0,30,16
1649909304955,MATH 193B,A01,083463,Staff,3,0,30,27
1649909304955,MATH 193B,A02,083464,Staff,11,0,30,19
1649909304955,MATH 193B,A03,083465,Staff,20,0,30,10
1649909311010,COGS 2,A01,083966,Boyle; Mary E. T.,19,0,30,11
1649909317034,COGS 9,A01,083968,Staff,43,0,60,17
1649909323058,COGS 14B,A01,083970,Staff,30,0,50,20
1649909329082,COGS 17,A01,092679,Staff,67,0,75,8
1649909335109,COGS 100,A01,083972,Staff,14,0,60,46
1649909347159,COGS 101C,A01,083976,Staff,19,0,30,11
1649909353180,COGS 102A,A01,083978,Johnson; Christine M.,17,0,30,13
1649909359203,COGS 107B,A01,083980,Staff,7,0,50,43
1649909365235,COGS 115,A01,083982,Staff,14,0,30,16
1649909371261,COGS 118B,A01,083367,Staff,0,10,40,40
1649909377285,COGS 172,A01,083984,Provenzano; Emily Kara,17,0,30,13
1649909383307,COGS 177,A00,083368,Staff,1,17,30,29
1649909389330,COGS 186,A01,083986,Staff,22,0,40,18
1649909395357,COGS 187A,A01,083988,Boyle; Mary E. T.,24,0,60,36
1649909401381,CSE 8A,A50,084003,Miranda; Gregory Joseph,2,0,15,13
1649909407403,CSE 11,A01,084005,Miranda; Gregory Joseph,23,0,55,32
1649909413433,CSE 20,A01,084007,Staff,9,0,20,11
1649909419466,CSE 21,A01,084009,Staff,14,0,50,36
1649909425489,CSE 30,A01,083370,Cao; Yingjun,0,15,40,40
1649909431513,CSE 100,A01,083372,Cao; Yingjun,0,21,40,40
1649909437537,CSE 101,A01,084011,Staff,1,46,40,39
1649909443561,CSE 141,A01,083374,Eldon; John,1,50,75,74
1649909449584,CSE 141L,A01,083376,Eldon; John,1,54,75,74
1649909455614,CSE 175,A01,084013,Kumar; Rakesh,22,0,25,3
1649909461638,CSE 190,A00,092508,Dubnov; Shlomo,15,0,15,0
1649909467659,ECE 5,A01,084049,Morris; Karcher William,16,0,20,4
1649909473682,ECE 100,A01,084051,Baghdadchi; Saharnaz,1,0,20,19
1649909473682,ECE 100,A02,091916,Baghdadchi; Saharnaz,17,0,20,3
1649909479710,ECE 101,A01,084053,Baghdadchi; Saharnaz,5,0,37,32
1649909479710,ECE 101,A02,084054,Baghdadchi; Saharnaz,36,0,37,1
1649909485733,ECE 107,A01,083390,Staff,29,0,40,11
1649909491757,ECE 148,A01,084056,Silberman; Jack,7,0,12,5
1649909497784,ECE 180,A00,083391,Abi Samra; Nicholas Camill,25,0,30,5
1649909497784,ECE 180,B00,083392,Abi Samra; Nicholas Camill,22,0,30,8
1649909503807,MATH 10B,A01,084110,Staff,9,0,30,21
1649909503807,MATH 10B,A02,084111,Staff,29,0,30,1
1649909503807,MATH 10B,A03,084112,Staff,28,0,30,2
1649909509923,MATH 10C,A01,083443,Staff,9,0,30,21
1649909509923,MATH 10C,A02,083444,Staff,17,0,30,13
1649909509923,MATH 10C,B01,084114,Staff,25,0,30,5
1649909509923,MATH 10C,B02,084115,Staff,29,0,30,1
1649909515946,MATH 18,A01,084117,Harel; Guershon,27,0,30,3
1649909515946,MATH 18,A02,084119,Harel; Guershon,29,0,30,1
1649909515946,MATH 18,A03,084120,Harel; Guershon,30,0,30,0
1649909515946,MATH 18,A04,084121,Harel; Guershon,29,0,30,1
1649909521976,MATH 20B,A01,084124,Um; Ko Woon,31,0,35,4
1649909521976,MATH 20B,B01,084126,Um; Ko Woon,32,0,35,3
1649909528000,MATH 20C,A01,083446,Hammock; Frances H,18,0,30,12
1649909528000,MATH 20C,A02,083447,Hammock; Frances H,28,0,30,2
1649909528000,MATH 20C,A03,083448,Hammock; Frances H,30,0,30,0
1649909528000,MATH 20C,A04,083449,Hammock; Frances H,30,0,30,0
1649909528000,MATH 20C,B01,083451,Hammock; Frances H,26,0,30,4
1649909528000,MATH 20C,B02,083452,Hammock; Frances H,27,0,30,3
1649909528000,MATH 20C,B03,083453,Hammock; Frances H,27,0,30,3
1649909528000,MATH 20C,B04,083454,Hammock; Frances H,30,0,30,0
1649909534024,MATH 20D,A01,084128,Staff,26,0,30,4
1649909534024,MATH 20D,A02,084129,Staff,30,0,30,0
1649909534024,MATH 20D,A03,084130,Staff,29,0,30,1
1649909534024,MATH 20D,B01,084133,Staff,23,0,30,7
1649909534024,MATH 20D,B02,084134,Staff,27,0,30,3
1649909534024,MATH 20D,B03,084135,Staff,30,0,30,0
1649909540053,MATH 20E,A01,084138,Staff,24,0,30,6
1649909540053,MATH 20E,A02,084139,Staff,23,0,30,7
1649909540053,MATH 20E,A03,084140,Staff,24,0,30,6
1649909540053,MATH 20E,A04,084141,Staff,27,0,30,3
1649909546076,MATH 102,A01,084143,Harel; Guershon,19,0,30,11
1649909546076,MATH 102,A02,084144,Harel; Guershon,22,0,30,8
1649909552113,MATH 103B,A01,083456,Staff,0,8,30,30
1649909552113,MATH 103B,A02,083457,Staff,0,9,30,30
1649909558140,MATH 109,A01,084146,Salehi Golsefidy; Alireza,29,0,30,1
1649909558140,MATH 109,A02,084147,Salehi Golsefidy; Alireza,22,0,30,8
1649909564163,MATH 120A,A01,085445,Eggers; John Dietrich,20,0,35,15
1649909564163,MATH 120A,A02,085446,Eggers; John Dietrich,28,0,35,7
1649909570205,MATH 142B,A01,084149,Verstraete; Jacques Allan,0,8,30,30
1649909570205,MATH 142B,A02,084150,Verstraete; Jacques Allan,1,8,30,29
1649909576229,MATH 170A,A01,083459,Nie; Jiawang,0,1,30,30
1649909576229,MATH 170A,A02,083460,Nie; Jiawang,0,0,30,30
1649909576229,MATH 170A,A03,083461,Nie; Jiawang,14,0,30,16
1649909582251,MATH 193B,A01,083463,Staff,3,0,30,27
1649909582251,MATH 193B,A02,083464,Staff,11,0,30,19
1649909582251,MATH 193B,A03,083465,Staff,20,0,30,10
1649909588330,COGS 2,A01,083966,Boyle; Mary E. T.,19,0,30,11
1649909594354,COGS 9,A01,083968,Staff,43,0,60,17
1649909600380,COGS 14B,A01,083970,Staff,30,0,50,20
1649909606407,COGS 17,A01,092679,Staff,67,0,75,8
1649909612430,COGS 100,A01,083972,Staff,14,0,60,46
1649909624475,COGS 101C,A01,083976,Staff,19,0,30,11
1649909630500,COGS 102A,A01,083978,Johnson; Christine M.,17,0,30,13
1649909636528,COGS 107B,A01,083980,Staff,6,0,50,44
1649909642554,COGS 115,A01,083982,Staff,14,0,30,16
1649909648576,COGS 118B,A01,083367,Staff,0,10,40,40
1649909654599,COGS 172,A01,083984,Provenzano; Emily Kara,17,0,30,13
1649909660622,COGS 177,A00,083368,Staff,1,17,30,29
1649909666645,COGS 186,A01,083986,Staff,22,0,40,18
1649909672672,COGS 187A,A01,083988,Boyle; Mary E. T.,24,0,60,36
1649909678699,CSE 8A,A50,084003,Miranda; Gregory Joseph,2,0,15,13
1649909684722,CSE 11,A01,084005,Miranda; Gregory Joseph,23,0,55,32
1649909690745,CSE 20,A01,084007,Staff,9,0,20,11
1649909696774,CSE 21,A01,084009,Staff,14,0,50,36
1649909702797,CSE 30,A01,083370,Cao; Yingjun,0,15,40,40
1649909708821,CSE 100,A01,083372,Cao; Yingjun,0,21,40,40
1649909714852,CSE 101,A01,084011,Staff,1,46,40,39
1649909720875,CSE 141,A01,083374,Eldon; John,1,50,75,74
1649909726898,CSE 141L,A01,083376,Eldon; John,1,54,75,74
1649909732922,CSE 175,A01,084013,Kumar; Rakesh,22,0,25,3
1649909738946,CSE 190,A00,092508,Dubnov; Shlomo,15,0,15,0
1649909744982,ECE 5,A01,084049,Morris; Karcher William,15,0,20,5
1649909751011,ECE 100,A01,084051,Baghdadchi; Saharnaz,1,0,20,19
1649909751011,ECE 100,A02,091916,Baghdadchi; Saharnaz,17,0,20,3
1649909757034,ECE 101,A01,084053,Baghdadchi; Saharnaz,5,0,37,32
1649909757034,ECE 101,A02,084054,Baghdadchi; Saharnaz,35,0,37,2
1649909763065,ECE 107,A01,083390,Staff,29,0,40,11
1649909769092,ECE 148,A01,084056,Silberman; Jack,7,0,12,5
1649909775115,ECE 180,A00,083391,Abi Samra; Nicholas Camill,25,0,30,5
1649909775115,ECE 180,B00,083392,Abi Samra; Nicholas Camill,22,0,30,8
1649909781139,MATH 10B,A01,084110,Staff,8,0,30,22
1649909781139,MATH 10B,A02,084111,Staff,29,0,30,1
1649909781139,MATH 10B,A03,084112,Staff,28,0,30,2
1649909787162,MATH 10C,A01,083443,Staff,9,0,30,21
1649909787162,MATH 10C,A02,083444,Staff,17,0,30,13
1649909787162,MATH 10C,B01,084114,Staff,25,0,30,5
1649909787162,MATH 10C,B02,084115,Staff,29,0,30,1
1649909793185,MATH 18,A01,084117,Harel; Guershon,27,0,30,3
1649909793185,MATH 18,A02,084119,Harel; Guershon,29,0,30,1
1649909793185,MATH 18,A03,084120,Harel; Guershon,30,0,30,0
1649909793185,MATH 18,A04,084121,Harel; Guershon,29,0,30,1
1649909799211,MATH 20B,A01,084124,Um; Ko Woon,31,0,35,4
1649909799211,MATH 20B,B01,084126,Um; Ko Woon,32,0,35,3
1649909805239,MATH 20C,A01,083446,Hammock; Frances H,18,0,30,12
1649909805239,MATH 20C,A02,083447,Hammock; Frances H,28,0,30,2
1649909805239,MATH 20C,A03,083448,Hammock; Frances H,30,0,30,0
1649909805239,MATH 20C,A04,083449,Hammock; Frances H,30,0,30,0
1649909805239,MATH 20C,B01,083451,Hammock; Frances H,26,0,30,4
1649909805239,MATH 20C,B02,083452,Hammock; Frances H,27,0,30,3
1649909805239,MATH 20C,B03,083453,Hammock; Frances H,27,0,30,3
1649909805239,MATH 20C,B04,083454,Hammock; Frances H,30,0,30,0
1649909811265,MATH 20D,A01,084128,Staff,26,0,30,4
1649909811265,MATH 20D,A02,084129,Staff,30,0,30,0
1649909811265,MATH 20D,A03,084130,Staff,29,0,30,1
1649909811265,MATH 20D,B01,084133,Staff,23,0,30,7
1649909811265,MATH 20D,B02,084134,Staff,27,0,30,3
1649909811265,MATH 20D,B03,084135,Staff,30,0,30,0
1649909817295,MATH 20E,A01,084138,Staff,24,0,30,6
1649909817295,MATH 20E,A02,084139,Staff,23,0,30,7
1649909817295,MATH 20E,A03,084140,Staff,24,0,30,6
1649909817295,MATH 20E,A04,084141,Staff,27,0,30,3
1649909823323,MATH 102,A01,084143,Harel; Guershon,19,0,30,11
1649909823323,MATH 102,A02,084144,Harel; Guershon,22,0,30,8
1649909829356,MATH 103B,A01,083456,Staff,0,8,30,30
1649909829356,MATH 103B,A02,083457,Staff,0,9,30,30
1649909835388,MATH 109,A01,084146,Salehi Golsefidy; Alireza,29,0,30,1
1649909835388,MATH 109,A02,084147,Salehi Golsefidy; Alireza,22,0,30,8
1649909841410,MATH 120A,A01,085445,Eggers; John Dietrich,20,0,35,15
1649909841410,MATH 120A,A02,085446,Eggers; John Dietrich,28,0,35,7
1649909847432,MATH 142B,A01,084149,Verstraete; Jacques Allan,0,9,30,30
1649909847432,MATH 142B,A02,084150,Verstraete; Jacques Allan,1,8,30,29
1649909853460,MATH 170A,A01,083459,Nie; Jiawang,0,1,30,30
1649909853460,MATH 170A,A02,083460,Nie; Jiawang,0,0,30,30
1649909853460,MATH 170A,A03,083461,Nie; Jiawang,14,0,30,16
1649909859489,MATH 193B,A01,083463,Staff,3,0,30,27
1649909859489,MATH 193B,A02,083464,Staff,11,0,30,19
1649909859489,MATH 193B,A03,083465,Staff,20,0,30,10
1649909865550,COGS 2,A01,083966,Boyle; Mary E. T.,19,0,30,11
1649909871573,COGS 9,A01,083968,Staff,43,0,60,17
1649909877598,COGS 14B,A01,083970,Staff,30,0,50,20
1649909883627,COGS 17,A01,092679,Staff,67,0,75,8
1649909889653,COGS 100,A01,083972,Staff,14,0,60,46
1649909901699,COGS 101C,A01,083976,Staff,19,0,30,11
1649909907722,COGS 102A,A01,083978,Johnson; Christine M.,17,0,30,13
1649909913751,COGS 107B,A01,083980,Staff,6,0,50,44
1649909919776,COGS 115,A01,083982,Staff,14,0,30,16
1649909925804,COGS 118B,A01,083367,Staff,0,10,40,40
1649909931838,COGS 172,A01,083984,Provenzano; Emily Kara,17,0,30,13
1649909937874,COGS 177,A00,083368,Staff,1,17,30,29
1649909943902,COGS 186,A01,083986,Staff,22,0,40,18
1649909949936,COGS 187A,A01,083988,Boyle; Mary E. T.,24,0,60,36
1649909955964,CSE 8A,A50,084003,Miranda; Gregory Joseph,2,0,15,13
1649909961995,CSE 11,A01,084005,Miranda; Gregory Joseph,23,0,55,32
1649909968024,CSE 20,A01,084007,Staff,9,0,20,11
1649909974052,CSE 21,A01,084009,Staff,14,0,50,36
1649909980075,CSE 30,A01,083370,Cao; Yingjun,0,15,40,40
1649909986098,CSE 100,A01,083372,Cao; Yingjun,0,21,40,40
1649909992125,CSE 101,A01,084011,Staff,1,46,40,39
1649909998152,CSE 141,A01,083374,Eldon; John,1,50,75,74
1649910004188,CSE 141L,A01,083376,Eldon; John,1,54,75,74
1649910010210,CSE 175,A01,084013,Kumar; Rakesh,22,0,25,3
1649910016233,CSE 190,A00,092508,Dubnov; Shlomo,15,0,15,0
1649910022260,ECE 5,A01,084049,Morris; Karcher William,15,0,20,5
1649910028288,ECE 100,A01,084051,Baghdadchi; Saharnaz,1,0,20,19
1649910028288,ECE 100,A02,091916,Baghdadchi; Saharnaz,17,0,20,3
1649910034313,ECE 101,A01,084053,Baghdadchi; Saharnaz,5,0,37,32
1649910034313,ECE 101,A02,084054,Baghdadchi; Saharnaz,35,0,37,2
1649910040336,ECE 107,A01,083390,Staff,29,0,40,11
1649910046365,ECE 148,A01,084056,Silberman; Jack,7,0,12,5
1649910052390,ECE 180,A00,083391,Abi Samra; Nicholas Camill,25,0,30,5
1649910052390,ECE 180,B00,083392,Abi Samra; Nicholas Camill,22,0,30,8
1649910058414,MATH 10B,A01,084110,Staff,8,0,30,22
1649910058414,MATH 10B,A02,084111,Staff,29,0,30,1
1649910058414,MATH 10B,A03,084112,Staff,28,0,30,2
1649910064438,MATH 10C,A01,083443,Staff,9,0,30,21
1649910064438,MATH 10C,A02,083444,Staff,17,0,30,13
1649910064438,MATH 10C,B01,084114,Staff,25,0,30,5
1649910064438,MATH 10C,B02,084115,Staff,29,0,30,1
1649910070462,MATH 18,A01,084117,Harel; Guershon,27,0,30,3
1649910070462,MATH 18,A02,084119,Harel; Guershon,29,0,30,1
1649910070462,MATH 18,A03,084120,Harel; Guershon,30,0,30,0
1649910070462,MATH 18,A04,084121,Harel; Guershon,29,0,30,1
1649910076491,MATH 20B,A01,084124,Um; Ko Woon,31,0,35,4
1649910076491,MATH 20B,B01,084126,Um; Ko Woon,32,0,35,3
1649910082515,MATH 20C,A01,083446,Hammock; Frances H,18,0,30,12
1649910082515,MATH 20C,A02,083447,Hammock; Frances H,28,0,30,2
1649910082515,MATH 20C,A03,083448,Hammock; Frances H,30,0,30,0
1649910082515,MATH 20C,A04,083449,Hammock; Frances H,30,0,30,0
1649910082515,MATH 20C,B01,083451,Hammock; Frances H,26,0,30,4
1649910082515,MATH 20C,B02,083452,Hammock; Frances H,27,0,30,3
1649910082515,MATH 20C,B03,083453,Hammock; Frances H,27,0,30,3
1649910082515,MATH 20C,B04,083454,Hammock; Frances H,30,0,30,0
1649910088542,MATH 20D,A01,084128,Staff,26,0,30,4
1649910088542,MATH 20D,A02,084129,Staff,30,0,30,0
1649910088542,MATH 20D,A03,084130,Staff,29,0,30,1
1649910088542,MATH 20D,B01,084133,Staff,23,0,30,7
1649910088542,MATH 20D,B02,084134,Staff,27,0,30,3
1649910088542,MATH 20D,B03,084135,Staff,30,0,30,0
1649910094566,MATH 20E,A01,084138,Staff,24,0,30,6
1649910094566,MATH 20E,A02,084139,Staff,23,0,30,7
1649910094566,MATH 20E,A03,084140,Staff,24,0,30,6
1649910094566,MATH 20E,A04,084141,Staff,27,0,30,3
1649910100590,MATH 102,A01,084143,Harel; Guershon,19,0,30,11
1649910100590,MATH 102,A02,084144,Harel; Guershon,22,0,30,8
1649910106711,MATH 103B,A01,083456,Staff,0,8,30,30
1649910106711,MATH 103B,A02,083457,Staff,0,9,30,30
1649910112738,MATH 109,A01,084146,Salehi Golsefidy; Alireza,29,0,30,1
1649910112738,MATH 109,A02,084147,Salehi Golsefidy; Alireza,22,0,30,8
1649910118762,MATH 120A,A01,085445,Eggers; John Dietrich,20,0,35,15
1649910118762,MATH 120A,A02,085446,Eggers; John Dietrich,28,0,35,7
1649910124788,MATH 142B,A01,084149,Verstraete; Jacques Allan,0,10,30,30
1649910124788,MATH 142B,A02,084150,Verstraete; Jacques Allan,1,8,30,29
1649910130815,MATH 170A,A01,083459,Nie; Jiawang,0,1,30,30
1649910130815,MATH 170A,A02,083460,Nie; Jiawang,0,0,30,30
1649910130815,MATH 170A,A03,083461,Nie; Jiawang,14,0,30,16
1649910136846,MATH 193B,A01,083463,Staff,3,0,30,27
1649910136846,MATH 193B,A02,083464,Staff,11,0,30,19
1649910136846,MATH 193B,A03,083465,Staff,20,0,30,10
1649910142902,COGS 2,A01,083966,Boyle; Mary E. T.,19,0,30,11
1649910148929,COGS 9,A01,083968,Staff,43,0,60,17
1649910154952,COGS 14B,A01,083970,Staff,30,0,50,20
1649910160973,COGS 17,A01,092679,Staff,67,0,75,8
1649910166999,COGS 100,A01,083972,Staff,14,0,60,46
1649910179046,COGS 101C,A01,083976,Staff,19,0,30,11
1649910185078,COGS 102A,A01,083978,Johnson; Christine M.,17,0,30,13
1649910191105,COGS 107B,A01,083980,Staff,6,0,50,44
1649910197129,COGS 115,A01,083982,Staff,14,0,30,16
1649910203151,COGS 118B,A01,083367,Staff,0,10,40,40
1649910209177,COGS 172,A01,083984,Provenzano; Emily Kara,17,0,30,13
1649910215209,COGS 177,A00,083368,Staff,1,17,30,29
1649910221234,COGS 186,A01,083986,Staff,22,0,40,18
1649910227257,COGS 187A,A01,083988,Boyle; Mary E. T.,24,0,60,36
1649910233279,CSE 8A,A50,084003,Miranda; Gregory Joseph,2,0,15,13
1649910239305,CSE 11,A01,084005,Miranda; Gregory Joseph,23,0,55,32
1649910245340,CSE 20,A01,084007,Staff,9,0,20,11
1649910251373,CSE 21,A01,084009,Staff,14,0,50,36
1649910257397,CSE 30,A01,083370,Cao; Yingjun,0,15,40,40
1649910263419,CSE 100,A01,083372,Cao; Yingjun,0,21,40,40
1649910269441,CSE 101,A01,084011,Staff,1,46,40,39
1649910275479,CSE 141,A01,083374,Eldon; John,1,50,75,74
1649910281503,CSE 141L,A01,083376,Eldon; John,1,54,75,74
1649910287527,CSE 175,A01,084013,Kumar; Rakesh,22,0,25,3
1649910293550,CSE 190,A00,092508,Dubnov; Shlomo,15,0,15,0
1649910299587,ECE 5,A01,084049,Morris; Karcher William,15,0,20,5
1649910305611,ECE 100,A01,084051,Baghdadchi; Saharnaz,1,0,20,19
1649910305611,ECE 100,A02,091916,Baghdadchi; Saharnaz,17,0,20,3
1649910311638,ECE 101,A01,084053,Baghdadchi; Saharnaz,5,0,37,32
1649910311638,ECE 101,A02,084054,Baghdadchi; Saharnaz,35,0,37,2
1649910317662,ECE 107,A01,083390,Staff,29,0,40,11
1649910323689,ECE 148,A01,084056,Silberman; Jack,7,0,12,5
1649910329721,ECE 180,A00,083391,Abi Samra; Nicholas Camill,25,0,30,5
1649910329721,ECE 180,B00,083392,Abi Samra; Nicholas Camill,22,0,30,8
1649910335754,MATH 10B,A01,084110,Staff,8,0,30,22
1649910335754,MATH 10B,A02,084111,Staff,29,0,30,1
1649910335754,MATH 10B,A03,084112,Staff,28,0,30,2
1649910341787,MATH 10C,A01,083443,Staff,9,0,30,21
1649910341787,MATH 10C,A02,083444,Staff,17,0,30,13
1649910341787,MATH 10C,B01,084114,Staff,25,0,30,5
1649910341787,MATH 10C,B02,084115,Staff,29,0,30,1
1649910347826,MATH 18,A01,084117,Harel; Guershon,27,0,30,3
1649910347826,MATH 18,A02,084119,Harel; Guershon,29,0,30,1
1649910347826,MATH 18,A03,084120,Harel; Guershon,30,0,30,0
1649910347826,MATH 18,A04,084121,Harel; Guershon,29,0,30,1
1649910353851,MATH 20B,A01,084124,Um; Ko Woon,31,0,35,4
1649910353851,MATH 20B,B01,084126,Um; Ko Woon,32,0,35,3
1649910359879,MATH 20C,A01,083446,Hammock; Frances H,18,0,30,12
1649910359879,MATH 20C,A02,083447,Hammock; Frances H,28,0,30,2
1649910359879,MATH 20C,A03,083448,Hammock; Frances H,30,0,30,0
1649910359879,MATH 20C,A04,083449,Hammock; Frances H,30,0,30,0
1649910359879,MATH 20C,B01,083451,Hammock; Frances H,26,0,30,4
1649910359879,MATH 20C,B02,083452,Hammock; Frances H,27,0,30,3
1649910359879,MATH 20C,B03,083453,Hammock; Frances H,27,0,30,3
1649910359879,MATH 20C,B04,083454,Hammock; Frances H,30,0,30,0
1649910365911,MATH 20D,A01,084128,Staff,26,0,30,4
1649910365911,MATH 20D,A02,084129,Staff,30,0,30,0
1649910365911,MATH 20D,A03,084130,Staff,29,0,30,1
1649910365911,MATH 20D,B01,084133,Staff,22,0,30,8
1649910365911,MATH 20D,B02,084134,Staff,27,0,30,3
1649910365911,MATH 20D,B03,084135,Staff,30,0,30,0
1649910371938,MATH 20E,A01,084138,Staff,24,0,30,6
1649910371938,MATH 20E,A02,084139,Staff,23,0,30,7
1649910371938,MATH 20E,A03,084140,Staff,24,0,30,6
1649910371938,MATH 20E,A04,084141,Staff,27,0,30,3
1649910377970,MATH 102,A01,084143,Harel; Guershon,19,0,30,11
1649910377970,MATH 102,A02,084144,Harel; Guershon,22,0,30,8
1649910397653,MATH 103B,A01,083456,Staff,0,8,30,30
1649910397653,MATH 103B,A02,083457,Staff,0,9,30,30
1649910403676,MATH 109,A01,084146,Salehi Golsefidy; Alireza,29,0,30,1
1649910403676,MATH 109,A02,084147,Salehi Golsefidy; Alireza,22,0,30,8
1649910409702,MATH 120A,A01,085445,Eggers; John Dietrich,20,0,35,15
1649910409702,MATH 120A,A02,085446,Eggers; John Dietrich,28,0,35,7
1649910415728,MATH 142B,A01,084149,Verstraete; Jacques Allan,0,10,30,30
1649910415728,MATH 142B,A02,084150,Verstraete; Jacques Allan,1,8,30,29
1649910421763,MATH 170A,A01,083459,Nie; Jiawang,0,1,30,30
1649910421763,MATH 170A,A02,083460,Nie; Jiawang,0,0,30,30
1649910421763,MATH 170A,A03,083461,Nie; Jiawang,14,0,30,16
1649910427798,MATH 193B,A01,083463,Staff,3,0,30,27
1649910427798,MATH 193B,A02,083464,Staff,11,0,30,19
1649910427798,MATH 193B,A03,083465,Staff,20,0,30,10
1649910433856,COGS 2,A01,083966,Boyle; Mary E. T.,19,0,30,11
1649910439879,COGS 9,A01,083968,Staff,43,0,60,17
1649910445906,COGS 14B,A01,083970,Staff,30,0,50,20
1649910451933,COGS 17,A01,092679,Staff,67,0,75,8
1649910457960,COGS 100,A01,083972,Staff,14,0,60,46
1649910470007,COGS 101C,A01,083976,Staff,19,0,30,11
1649910476031,COGS 102A,A01,083978,Johnson; Christine M.,17,0,30,13
1649910482061,COGS 107B,A01,083980,Staff,6,0,50,44
1649910488084,COGS 115,A01,083982,Staff,14,0,30,16
1649910494107,COGS 118B,A01,083367,Staff,0,10,40,40
1649910500131,COGS 172,A01,083984,Provenzano; Emily Kara,17,0,30,13
1649910506161,COGS 177,A00,083368,Staff,1,17,30,29
1649910512185,COGS 186,A01,083986,Staff,22,0,40,18
1649910518208,COGS 187A,A01,083988,Boyle; Mary E. T.,24,0,60,36
1649910524248,CSE 8A,A50,084003,Miranda; Gregory Joseph,1,0,15,14
1649910530279,CSE 11,A01,084005,Miranda; Gregory Joseph,23,0,55,32
1649910536301,CSE 20,A01,084007,Staff,9,0,20,11
1649910542340,CSE 21,A01,084009,Staff,14,0,50,36
1649910548363,CSE 30,A01,083370,Cao; Yingjun,0,15,40,40
1649910554398,CSE 100,A01,083372,Cao; Yingjun,0,21,40,40
1649910560429,CSE 101,A01,084011,Staff,1,46,40,39
1649910566452,CSE 141,A01,083374,Eldon; John,1,50,75,74
1649910572482,CSE 141L,A01,083376,Eldon; John,1,54,75,74
1649910578509,CSE 175,A01,084013,Kumar; Rakesh,22,0,25,3
1649910584536,CSE 190,A00,092508,Dubnov; Shlomo,15,0,15,0
1649910590561,ECE 5,A01,084049,Morris; Karcher William,15,0,20,5
1649910596584,ECE 100,A01,084051,Baghdadchi; Saharnaz,1,0,20,19
1649910596584,ECE 100,A02,091916,Baghdadchi; Saharnaz,17,0,20,3
1649910602612,ECE 101,A01,084053,Baghdadchi; Saharnaz,5,0,37,32
1649910602612,ECE 101,A02,084054,Baghdadchi; Saharnaz,35,0,37,2
1649910608648,ECE 107,A01,083390,Staff,29,0,40,11
1649910614671,ECE 148,A01,084056,Silberman; Jack,7,0,12,5
1649910620694,ECE 180,A00,083391,Abi Samra; Nicholas Camill,25,0,30,5
1649910620694,ECE 180,B00,083392,Abi Samra; Nicholas Camill,22,0,30,8
1649910626720,MATH 10B,A01,084110,Staff,8,0,30,22
1649910626720,MATH 10B,A02,084111,Staff,29,0,30,1
1649910626720,MATH 10B,A03,084112,Staff,28,0,30,2
1649910632746,MATH 10C,A01,083443,Staff,9,0,30,21
1649910632746,MATH 10C,A02,083444,Staff,17,0,30,13
1649910632746,MATH 10C,B01,084114,Staff,25,0,30,5
1649910632746,MATH 10C,B02,084115,Staff,29,0,30,1
1649910638785,MATH 18,A01,084117,Harel; Guershon,27,0,30,3
1649910638785,MATH 18,A02,084119,Harel; Guershon,29,0,30,1
1649910638785,MATH 18,A03,084120,Harel; Guershon,30,0,30,0
1649910638785,MATH 18,A04,084121,Harel; Guershon,29,0,30,1
1649910644827,MATH 20B,A01,084124,Um; Ko Woon,31,0,35,4
1649910644827,MATH 20B,B01,084126,Um; Ko Woon,32,0,35,3
1649910650852,MATH 20C,A01,083446,Hammock; Frances H,18,0,30,12
1649910650852,MATH 20C,A02,083447,Hammock; Frances H,28,0,30,2
1649910650852,MATH 20C,A03,083448,Hammock; Frances H,30,0,30,0
1649910650852,MATH 20C,A04,083449,Hammock; Frances H,30,0,30,0
1649910650852,MATH 20C,B01,083451,Hammock; Frances H,26,0,30,4
1649910650852,MATH 20C,B02,083452,Hammock; Frances H,27,0,30,3
1649910650852,MATH 20C,B03,083453,Hammock; Frances H,27,0,30,3
1649910650852,MATH 20C,B04,083454,Hammock; Frances H,30,0,30,0
1649910656874,MATH 20D,A01,084128,Staff,26,0,30,4
1649910656874,MATH 20D,A02,084129,Staff,30,0,30,0
1649910656874,MATH 20D,A03,084130,Staff,29,0,30,1
1649910656874,MATH 20D,B01,084133,Staff,22,0,30,8
1649910656874,MATH 20D,B02,084134,Staff,27,0,30,3
1649910656874,MATH 20D,B03,084135,Staff,30,0,30,0
1649910662900,MATH 20E,A01,084138,Staff,24,0,30,6
1649910662900,MATH 20E,A02,084139,Staff,23,0,30,7
1649910662900,MATH 20E,A03,084140,Staff,24,0,30,6
1649910662900,MATH 20E,A04,084141,Staff,27,0,30,3
1649910668942,MATH 102,A01,084143,Harel; Guershon,19,0,30,11
1649910668942,MATH 102,A02,084144,Harel; Guershon,22,0,30,8
1649910674965,MATH 103B,A01,083456,Staff,0,8,30,30
1649910674965,MATH 103B,A02,083457,Staff,0,9,30,30
1649910680991,MATH 109,A01,084146,Salehi Golsefidy; Alireza,29,0,30,1
1649910680991,MATH 109,A02,084147,Salehi Golsefidy; Alireza,22,0,30,8
1649910687019,MATH 120A,A01,085445,Eggers; John Dietrich,20,0,35,15
1649910687019,MATH 120A,A02,085446,Eggers; John Dietrich,28,0,35,7
1649910693046,MATH 142B,A01,084149,Verstraete; Jacques Allan,0,10,30,30
1649910693046,MATH 142B,A02,084150,Verstraete; Jacques Allan,1,8,30,29
1649910699068,MATH 170A,A01,083459,Nie; Jiawang,0,1,30,30
1649910699068,MATH 170A,A02,083460,Nie; Jiawang,0,0,30,30
1649910699068,MATH 170A,A03,083461,Nie; Jiawang,14,0,30,16
1649910705090,MATH 193B,A01,083463,Staff,3,0,30,27
1649910705090,MATH 193B,A02,083464,Staff,11,0,30,19
1649910705090,MATH 193B,A03,083465,Staff,20,0,30,10
1649910711235,COGS 2,A01,083966,Boyle; Mary E. T.,19,0,30,11
1649910717261,COGS 9,A01,083968,Staff,43,0,60,17
1649910723288,COGS 14B,A01,083970,Staff,29,0,50,21
1649910729317,COGS 17,A01,092679,Staff,67,0,75,8
1649910735343,COGS 100,A01,083972,Staff,15,0,60,45
1649910747393,COGS 101C,A01,083976,Staff,19,0,30,11
1649910753430,COGS 102A,A01,083978,Johnson; Christine M.,17,0,30,13
1649910759463,COGS 107B,A01,083980,Staff,6,0,50,44
1649910765486,COGS 115,A01,083982,Staff,14,0,30,16
1649910771508,COGS 118B,A01,083367,Staff,0,10,40,40
1649910777538,COGS 172,A01,083984,Provenzano; Emily Kara,17,0,30,13
1649910783569,COGS 177,A00,083368,Staff,1,17,30,29
1649910789596,COGS 186,A01,083986,Staff,22,0,40,18
1649910795619,COGS 187A,A01,083988,Boyle; Mary E. T.,24,0,60,36
1649910801645,CSE 8A,A50,084003,Miranda; Gregory Joseph,1,0,15,14
1649910807670,CSE 11,A01,084005,Miranda; Gregory Joseph,23,0,55,32
1649910813693,CSE 20,A01,084007,Staff,9,0,20,11
1649910819715,CSE 21,A01,084009,Staff,14,0,50,36
1649910825738,CSE 30,A01,083370,Cao; Yingjun,0,15,40,40
1649910831761,CSE 100,A01,083372,Cao; Yingjun,0,21,40,40
1649910837792,CSE 101,A01,084011,Staff,1,46,40,39
1649910843819,CSE 141,A01,083374,Eldon; John,1,50,75,74
1649910849842,CSE 141L,A01,083376,Eldon; John,1,54,75,74
1649910855865,CSE 175,A01,084013,Kumar; Rakesh,22,0,25,3
1649910861889,CSE 190,A00,092508,Dubnov; Shlomo,15,0,15,0
1649910867912,ECE 5,A01,084049,Morris; Karcher William,15,0,20,5
1649910873939,ECE 100,A01,084051,Baghdadchi; Saharnaz,1,0,20,19
1649910873939,ECE 100,A02,091916,Baghdadchi; Saharnaz,17,0,20,3
1649910879964,ECE 101,A01,084053,Baghdadchi; Saharnaz,5,0,37,32
1649910879964,ECE 101,A02,084054,Baghdadchi; Saharnaz,35,0,37,2
1649910885987,ECE 107,A01,083390,Staff,29,0,40,11
1649910892012,ECE 148,A01,084056,Silberman; Jack,7,0,12,5
1649910898054,ECE 180,A00,083391,Abi Samra; Nicholas Camill,25,0,30,5
1649910898054,ECE 180,B00,083392,Abi Samra; Nicholas Camill,22,0,30,8
1649910904076,MATH 10B,A01,084110,Staff,8,0,30,22
1649910904076,MATH 10B,A02,084111,Staff,29,0,30,1
1649910904076,MATH 10B,A03,084112,Staff,28,0,30,2
1649910910103,MATH 10C,A01,083443,Staff,9,0,30,21
1649910910103,MATH 10C,A02,083444,Staff,17,0,30,13
1649910910103,MATH 10C,B01,084114,Staff,25,0,30,5
1649910910103,MATH 10C,B02,084115,Staff,29,0,30,1
1649910916127,MATH 18,A01,084117,Harel; Guershon,27,0,30,3
1649910916127,MATH 18,A02,084119,Harel; Guershon,29,0,30,1
1649910916127,MATH 18,A03,084120,Harel; Guershon,30,0,30,0
1649910916127,MATH 18,A04,084121,Harel; Guershon,29,0,30,1
1649910922157,MATH 20B,A01,084124,Um; Ko Woon,31,0,35,4
1649910922157,MATH 20B,B01,084126,Um; Ko Woon,32,0,35,3
1649910928185,MATH 20C,A01,083446,Hammock; Frances H,18,0,30,12
1649910928185,MATH 20C,A02,083447,Hammock; Frances H,28,0,30,2
1649910928185,MATH 20C,A03,083448,Hammock; Frances H,30,0,30,0
1649910928185,MATH 20C,A04,083449,Hammock; Frances H,30,0,30,0
1649910928185,MATH 20C,B01,083451,Hammock; Frances H,26,0,30,4
1649910928185,MATH 20C,B02,083452,Hammock; Frances H,27,0,30,3
1649910928185,MATH 20C,B03,083453,Hammock; Frances H,27,0,30,3
1649910928185,MATH 20C,B04,083454,Hammock; Frances H,30,0,30,0
1649910934209,MATH 20D,A01,084128,Staff,26,0,30,4
1649910934209,MATH 20D,A02,084129,Staff,30,0,30,0
1649910934209,MATH 20D,A03,084130,Staff,29,0,30,1
1649910934209,MATH 20D,B01,084133,Staff,22,0,30,8
1649910934209,MATH 20D,B02,084134,Staff,27,0,30,3
1649910934209,MATH 20D,B03,084135,Staff,30,0,30,0
1649910940230,MATH 20E,A01,084138,Staff,24,0,30,6
1649910940230,MATH 20E,A02,084139,Staff,23,0,30,7
1649910940230,MATH 20E,A03,084140,Staff,24,0,30,6
1649910940230,MATH 20E,A04,084141,Staff,27,0,30,3
1649910946258,MATH 102,A01,084143,Harel; Guershon,19,0,30,11
1649910946258,MATH 102,A02,084144,Harel; Guershon,22,0,30,8
1649910952282,MATH 103B,A01,083456,Staff,0,8,30,30
1649910952282,MATH 103B,A02,083457,Staff,0,9,30,30
1649910958309,MATH 109,A01,084146,Salehi Golsefidy; Alireza,29,0,30,1
1649910958309,MATH 109,A02,084147,Salehi Golsefidy; Alireza,22,0,30,8
1649910964333,MATH 120A,A01,085445,Eggers; John Dietrich,20,0,35,15
1649910964333,MATH 120A,A02,085446,Eggers; John Dietrich,28,0,35,7
1649910970370,MATH 142B,A01,084149,Verstraete; Jacques Allan,0,10,30,30
1649910970370,MATH 142B,A02,084150,Verstraete; Jacques Allan,1,8,30,29
1649910976394,MATH 170A,A01,083459,Nie; Jiawang,0,1,30,30
1649910976394,MATH 170A,A02,083460,Nie; Jiawang,0,0,30,30
1649910976394,MATH 170A,A03,083461,Nie; Jiawang,14,0,30,16
1649910982416,MATH 193B,A01,083463,Staff,3,0,30,27
1649910982416,MATH 193B,A02,083464,Staff,11,0,30,19
1649910982416,MATH 193B,A03,083465,Staff,20,0,30,10
1649910988475,COGS 2,A01,083966,Boyle; Mary E. T.,19,0,30,11
1649910994499,COGS 9,A01,083968,Staff,43,0,60,17
1649911000521,COGS 14B,A01,083970,Staff,29,0,50,21
1649911006554,COGS 17,A01,092679,Staff,67,0,75,8
1649911012593,COGS 100,A01,083972,Staff,15,0,60,45
1649911024641,COGS 101C,A01,083976,Staff,19,0,30,11
1649911030666,COGS 102A,A01,083978,Johnson; Christine M.,17,0,30,13
1649911036689,COGS 107B,A01,083980,Staff,6,0,50,44
1649911042714,COGS 115,A01,083982,Staff,14,0,30,16
1649911048749,COGS 118B,A01,083367,Staff,0,11,40,40
1649911054773,COGS 172,A01,083984,Provenzano; Emily Kara,17,0,30,13
1649911060799,COGS 177,A00,083368,Staff,1,17,30,29
1649911066826,COGS 186,A01,083986,Staff,22,0,40,18
1649911072850,COGS 187A,A01,083988,Boyle; Mary E. T.,24,0,60,36
1649911078882,CSE 8A,A50,084003,Miranda; Gregory Joseph,1,0,15,14
1649911084906,CSE 11,A01,084005,Miranda; Gregory Joseph,23,0,55,32
1649911090927,CSE 20,A01,084007,Staff,9,0,20,11
1649911096953,CSE 21,A01,084009,Staff,14,0,50,36
1649911102985,CSE 30,A01,083370,Cao; Yingjun,0,15,40,40
1649911109012,CSE 100,A01,083372,Cao; Yingjun,0,21,40,40
1649911115035,CSE 101,A01,084011,Staff,1,46,40,39
1649911121066,CSE 141,A01,083374,Eldon; John,1,50,75,74
1649911127095,CSE 141L,A01,083376,Eldon; John,1,54,75,74
1649911133117,CSE 175,A01,084013,Kumar; Rakesh,22,0,25,3
1649911139143,CSE 190,A00,092508,Dubnov; Shlomo,15,0,15,0
1649911145166,ECE 5,A01,084049,Morris; Karcher William,15,0,20,5
1649911151188,ECE 100,A01,084051,Baghdadchi; Saharnaz,1,0,20,19
1649911151188,ECE 100,A02,091916,Baghdadchi; Saharnaz,17,0,20,3
1649911157219,ECE 101,A01,084053,Baghdadchi; Saharnaz,5,0,37,32
1649911157219,ECE 101,A02,084054,Baghdadchi; Saharnaz,35,0,37,2
1649911163253,ECE 107,A01,083390,Staff,29,0,40,11
1649911169276,ECE 148,A01,084056,Silberman; Jack,7,0,12,5
1649911175302,ECE 180,A00,083391,Abi Samra; Nicholas Camill,25,0,30,5
1649911175302,ECE 180,B00,083392,Abi Samra; Nicholas Camill,22,0,30,8
1649911181327,MATH 10B,A01,084110,Staff,8,0,30,22
1649911181327,MATH 10B,A02,084111,Staff,29,0,30,1
1649911181327,MATH 10B,A03,084112,Staff,28,0,30,2
1649911187357,MATH 10C,A01,083443,Staff,9,0,30,21
1649911187357,MATH 10C,A02,083444,Staff,17,0,30,13
1649911187357,MATH 10C,B01,084114,Staff,25,0,30,5
1649911187357,MATH 10C,B02,084115,Staff,29,0,30,1
1649911193380,MATH 18,A01,084117,Harel; Guershon,27,0,30,3
1649911193380,MATH 18,A02,084119,Harel; Guershon,29,0,30,1
1649911193380,MATH 18,A03,084120,Harel; Guershon,30,0,30,0
1649911193380,MATH 18,A04,084121,Harel; Guershon,29,0,30,1
1649911199405,MATH 20B,A01,084124,Um; Ko Woon,31,0,35,4
1649911199405,MATH 20B,B01,084126,Um; Ko Woon,32,0,35,3
1649911205434,MATH 20C,A01,083446,Hammock; Frances H,18,0,30,12
1649911205434,MATH 20C,A02,083447,Hammock; Frances H,28,0,30,2
1649911205434,MATH 20C,A03,083448,Hammock; Frances H,30,0,30,0
1649911205434,MATH 20C,A04,083449,Hammock; Frances H,30,0,30,0
1649911205434,MATH 20C,B01,083451,Hammock; Frances H,25,0,30,5
1649911205434,MATH 20C,B02,083452,Hammock; Frances H,27,0,30,3
1649911205434,MATH 20C,B03,083453,Hammock; Frances H,27,0,30,3
1649911205434,MATH 20C,B04,083454,Hammock; Frances H,30,0,30,0
1649911211461,MATH 20D,A01,084128,Staff,26,0,30,4
1649911211461,MATH 20D,A02,084129,Staff,30,0,30,0
1649911211461,MATH 20D,A03,084130,Staff,29,0,30,1
1649911211461,MATH 20D,B01,084133,Staff,22,0,30,8
1649911211461,MATH 20D,B02,084134,Staff,27,0,30,3
1649911211461,MATH 20D,B03,084135,Staff,30,0,30,0
1649911217484,MATH 20E,A01,084138,Staff,24,0,30,6
1649911217484,MATH 20E,A02,084139,Staff,23,0,30,7
1649911217484,MATH 20E,A03,084140,Staff,24,0,30,6
1649911217484,MATH 20E,A04,084141,Staff,27,0,30,3
1649911223514,MATH 102,A01,084143,Harel; Guershon,19,0,30,11
1649911223514,MATH 102,A02,084144,Harel; Guershon,22,0,30,8
1649911229537,MATH 103B,A01,083456,Staff,0,8,30,30
1649911229537,MATH 103B,A02,083457,Staff,0,9,30,30
1649911235561,MATH 109,A01,084146,Salehi Golsefidy; Alireza,29,0,30,1
1649911235561,MATH 109,A02,084147,Salehi Golsefidy; Alireza,22,0,30,8
1649911241596,MATH 120A,A01,085445,Eggers; John Dietrich,20,0,35,15
1649911241596,MATH 120A,A02,085446,Eggers; John Dietrich,28,0,35,7
1649911247623,MATH 142B,A01,084149,Verstraete; Jacques Allan,0,10,30,30
1649911247623,MATH 142B,A02,084150,Verstraete; Jacques Allan,1,8,30,29
1649911253646,MATH 170A,A01,083459,Nie; Jiawang,0,1,30,30
1649911253646,MATH 170A,A02,083460,Nie; Jiawang,0,0,30,30
1649911253646,MATH 170A,A03,083461,Nie; Jiawang,14,0,30,16
1649911259669,MATH 193B,A01,083463,Staff,3,0,30,27
1649911259669,MATH 193B,A02,083464,Staff,11,0,30,19
1649911259669,MATH 193B,A03,083465,Staff,20,0,30,10
1649911265728,COGS 2,A01,083966,Boyle; Mary E. T.,19,0,30,11
1649911271764,COGS 9,A01,083968,Staff,43,0,60,17
1649911277786,COGS 14B,A01,083970,Staff,29,0,50,21
1649911283810,COGS 17,A01,092679,Staff,67,0,75,8
1649911289841,COGS 100,A01,083972,Staff,15,0,60,45
1649911301897,COGS 101C,A01,083976,Staff,19,0,30,11
1649911308011,COGS 102A,A01,083978,Johnson; Christine M.,17,0,30,13
1649911314035,COGS 107B,A01,083980,Staff,6,0,50,44
1649911320064,COGS 115,A01,083982,Staff,14,0,30,16
1649911326094,COGS 118B,A01,083367,Staff,0,11,40,40
1649911332119,COGS 172,A01,083984,Provenzano; Emily Kara,17,0,30,13
1649911338145,COGS 177,A00,083368,Staff,1,17,30,29
1649911344168,COGS 186,A01,083986,Staff,22,0,40,18
1649911350190,COGS 187A,A01,083988,Boyle; Mary E. T.,24,0,60,36
1649911356217,CSE 8A,A50,084003,Miranda; Gregory Joseph,0,0,15,15
1649911362239,CSE 11,A01,084005,Miranda; Gregory Joseph,23,0,55,32
1649911368263,CSE 20,A01,084007,Staff,9,0,20,11
1649911374292,CSE 21,A01,084009,Staff,14,0,50,36
1649911380315,CSE 30,A01,083370,Cao; Yingjun,0,15,40,40
1649911386343,CSE 100,A01,083372,Cao; Yingjun,0,22,40,40
1649911392369,CSE 101,A01,084011,Staff,1,46,40,39
1649911398392,CSE 141,A01,083374,Eldon; John,1,50,75,74
1649911404431,CSE 141L,A01,083376,Eldon; John,1,54,75,74
1649911410455,CSE 175,A01,084013,Kumar; Rakesh,22,0,25,3
1649911416483,CSE 190,A00,092508,Dubnov; Shlomo,15,0,15,0
1649911422510,ECE 5,A01,084049,Morris; Karcher William,15,0,20,5
1649911428538,ECE 100,A01,084051,Baghdadchi; Saharnaz,1,0,20,19
1649911428538,ECE 100,A02,091916,Baghdadchi; Saharnaz,17,0,20,3
1649911434563,ECE 101,A01,084053,Baghdadchi; Saharnaz,5,0,37,32
1649911434563,ECE 101,A02,084054,Baghdadchi; Saharnaz,35,0,37,2
1649911440601,ECE 107,A01,083390,Staff,29,0,40,11
1649911446622,ECE 148,A01,084056,Silberman; Jack,7,0,12,5
1649911452647,ECE 180,A00,083391,Abi Samra; Nicholas Camill,25,0,30,5
1649911452647,ECE 180,B00,083392,Abi Samra; Nicholas Camill,22,0,30,8
1649911458670,MATH 10B,A01,084110,Staff,8,0,30,22
1649911458670,MATH 10B,A02,084111,Staff,29,0,30,1
1649911458670,MATH 10B,A03,084112,Staff,28,0,30,2
1649911464693,MATH 10C,A01,083443,Staff,9,0,30,21
1649911464693,MATH 10C,A02,083444,Staff,17,0,30,13
1649911464693,MATH 10C,B01,084114,Staff,25,0,30,5
1649911464693,MATH 10C,B02,084115,Staff,29,0,30,1
1649911470717,MATH 18,A01,084117,Harel; Guershon,27,0,30,3
1649911470717,MATH 18,A02,084119,Harel; Guershon,29,0,30,1
1649911470717,MATH 18,A03,084120,Harel; Guershon,30,0,30,0
1649911470717,MATH 18,A04,084121,Harel; Guershon,29,0,30,1
1649911476743,MATH 20B,A01,084124,Um; Ko Woon,31,0,35,4
1649911476743,MATH 20B,B01,084126,Um; Ko Woon,32,0,35,3
1649911482780,MATH 20C,A01,083446,Hammock; Frances H,18,0,30,12
1649911482780,MATH 20C,A02,083447,Hammock; Frances H,28,0,30,2
1649911482780,MATH 20C,A03,083448,Hammock; Frances H,30,0,30,0
1649911482780,MATH 20C,A04,083449,Hammock; Frances H,30,0,30,0
1649911482780,MATH 20C,B01,083451,Hammock; Frances H,25,0,30,5
1649911482780,MATH 20C,B02,083452,Hammock; Frances H,27,0,30,3
1649911482780,MATH 20C,B03,083453,Hammock; Frances H,27,0,30,3
1649911482780,MATH 20C,B04,083454,Hammock; Frances H,30,0,30,0
1649911488809,MATH 20D,A01,084128,Staff,26,0,30,4
1649911488809,MATH 20D,A02,084129,Staff,30,0,30,0
1649911488809,MATH 20D,A03,084130,Staff,29,0,30,1
1649911488809,MATH 20D,B01,084133,Staff,22,0,30,8
1649911488809,MATH 20D,B02,084134,Staff,27,0,30,3
1649911488809,MATH 20D,B03,084135,Staff,30,0,30,0
1649911494834,MATH 20E,A01,084138,Staff,24,0,30,6
1649911494834,MATH 20E,A02,084139,Staff,23,0,30,7
1649911494834,MATH 20E,A03,084140,Staff,24,0,30,6
1649911494834,MATH 20E,A04,084141,Staff,27,0,30,3
1649911500857,MATH 102,A01,084143,Harel; Guershon,19,0,30,11
1649911500857,MATH 102,A02,084144,Harel; Guershon,22,0,30,8
1649911506893,MATH 103B,A01,083456,Staff,0,8,30,30
1649911506893,MATH 103B,A02,083457,Staff,0,9,30,30
1649911512915,MATH 109,A01,084146,Salehi Golsefidy; Alireza,29,0,30,1
1649911512915,MATH 109,A02,084147,Salehi Golsefidy; Alireza,22,0,30,8
1649911518939,MATH 120A,A01,085445,Eggers; John Dietrich,20,0,35,15
1649911518939,MATH 120A,A02,085446,Eggers; John Dietrich,28,0,35,7
1649911524973,MATH 142B,A01,084149,Verstraete; Jacques Allan,0,10,30,30
1649911524973,MATH 142B,A02,084150,Verstraete; Jacques Allan,1,8,30,29
1649911531000,MATH 170A,A01,083459,Nie; Jiawang,0,2,30,30
1649911531000,MATH 170A,A02,083460,Nie; Jiawang,0,0,30,30
1649911531000,MATH 170A,A03,083461,Nie; Jiawang,14,0,30,16
1649911537026,MATH 193B,A01,083463,Staff,3,0,30,27
1649911537026,MATH 193B,A02,083464,Staff,11,0,30,19
1649911537026,MATH 193B,A03,083465,Staff,20,0,30,10
1649911543084,COGS 2,A01,083966,Boyle; Mary E. T.,19,0,30,11
1649911549116,COGS 9,A01,083968,Staff,43,0,60,17
1649911555139,COGS 14B,A01,083970,Staff,29,0,50,21
1649911561163,COGS 17,A01,092679,Staff,67,0,75,8
1649911567185,COGS 100,A01,083972,Staff,15,0,60,45
1649911579240,COGS 101C,A01,083976,Staff,19,0,30,11
1649911585263,COGS 102A,A01,083978,Johnson; Christine M.,17,0,30,13
1649911591287,COGS 107B,A01,083980,Staff,6,0,50,44
1649911597310,COGS 115,A01,083982,Staff,15,0,30,15
1649911603335,COGS 118B,A01,083367,Staff,0,11,40,40
1649911609359,COGS 172,A01,083984,Provenzano; Emily Kara,17,0,30,13
1649911615396,COGS 177,A00,083368,Staff,1,17,30,29
1649911621420,COGS 186,A01,083986,Staff,22,0,40,18
1649911627443,COGS 187A,A01,083988,Boyle; Mary E. T.,24,0,60,36
1649911633473,CSE 8A,A50,084003,Miranda; Gregory Joseph,0,0,15,15
1649911639497,CSE 11,A01,084005,Miranda; Gregory Joseph,23,0,55,32
1649911645521,CSE 20,A01,084007,Staff,9,0,20,11
1649911651545,CSE 21,A01,084009,Staff,14,0,50,36
1649911657570,CSE 30,A01,083370,Cao; Yingjun,0,15,40,40
1649911663593,CSE 100,A01,083372,Cao; Yingjun,0,22,40,40
1649911669618,CSE 101,A01,084011,Staff,1,46,40,39
1649911675646,CSE 141,A01,083374,Eldon; John,1,50,75,74
1649911681671,CSE 141L,A01,083376,Eldon; John,1,54,75,74
1649911687704,CSE 175,A01,084013,Kumar; Rakesh,22,0,25,3
1649911693735,CSE 190,A00,092508,Dubnov; Shlomo,15,0,15,0
1649911699758,ECE 5,A01,084049,Morris; Karcher William,15,0,20,5
1649911705784,ECE 100,A01,084051,Baghdadchi; Saharnaz,1,0,20,19
1649911705784,ECE 100,A02,091916,Baghdadchi; Saharnaz,16,0,20,4
1649911711808,ECE 101,A01,084053,Baghdadchi; Saharnaz,5,0,37,32
1649911711808,ECE 101,A02,084054,Baghdadchi; Saharnaz,34,0,37,3
1649911717846,ECE 107,A01,083390,Staff,29,0,40,11
1649911723880,ECE 148,A01,084056,Silberman; Jack,7,0,12,5
1649911729907,ECE 180,A00,083391,Abi Samra; Nicholas Camill,25,0,30,5
1649911729907,ECE 180,B00,083392,Abi Samra; Nicholas Camill,22,0,30,8
1649911735933,MATH 10B,A01,084110,Staff,8,0,30,22
1649911735933,MATH 10B,A02,084111,Staff,29,0,30,1
1649911735933,MATH 10B,A03,084112,Staff,28,0,30,2
1649911741960,MATH 10C,A01,083443,Staff,9,0,30,21
1649911741960,MATH 10C,A02,083444,Staff,17,0,30,13
1649911741960,MATH 10C,B01,084114,Staff,25,0,30,5
1649911741960,MATH 10C,B02,084115,Staff,29,0,30,1
1649911747984,MATH 18,A01,084117,Harel; Guershon,27,0,30,3
1649911747984,MATH 18,A02,084119,Harel; Guershon,29,0,30,1
1649911747984,MATH 18,A03,084120,Harel; Guershon,30,0,30,0
1649911747984,MATH 18,A04,084121,Harel; Guershon,29,0,30,1
1649911754007,MATH 20B,A01,084124,Um; Ko Woon,31,0,35,4
1649911754007,MATH 20B,B01,084126,Um; Ko Woon,32,0,35,3
1649911760036,MATH 20C,A01,083446,Hammock; Frances H,18,0,30,12
1649911760036,MATH 20C,A02,083447,Hammock; Frances H,28,0,30,2
1649911760036,MATH 20C,A03,083448,Hammock; Frances H,30,0,30,0
1649911760036,MATH 20C,A04,083449,Hammock; Frances H,30,0,30,0
1649911760036,MATH 20C,B01,083451,Hammock; Frances H,25,0,30,5
1649911760036,MATH 20C,B02,083452,Hammock; Frances H,27,0,30,3
1649911760036,MATH 20C,B03,083453,Hammock; Frances H,26,0,30,4
1649911760036,MATH 20C,B04,083454,Hammock; Frances H,30,0,30,0
1649911766063,MATH 20D,A01,084128,Staff,26,0,30,4
1649911766063,MATH 20D,A02,084129,Staff,30,0,30,0
1649911766063,MATH 20D,A03,084130,Staff,29,0,30,1
1649911766063,MATH 20D,B01,084133,Staff,22,0,30,8
1649911766063,MATH 20D,B02,084134,Staff,27,0,30,3
1649911766063,MATH 20D,B03,084135,Staff,30,0,30,0
1649911772088,MATH 20E,A01,084138,Staff,24,0,30,6
1649911772088,MATH 20E,A02,084139,Staff,23,0,30,7
1649911772088,MATH 20E,A03,084140,Staff,24,0,30,6
1649911772088,MATH 20E,A04,084141,Staff,27,0,30,3
1649911778111,MATH 102,A01,084143,Harel; Guershon,19,0,30,11
1649911778111,MATH 102,A02,084144,Harel; Guershon,22,0,30,8
1649911784140,MATH 103B,A01,083456,Staff,0,8,30,30
1649911784140,MATH 103B,A02,083457,Staff,0,9,30,30
1649911790175,MATH 109,A01,084146,Salehi Golsefidy; Alireza,29,0,30,1
1649911790175,MATH 109,A02,084147,Salehi Golsefidy; Alireza,22,0,30,8
1649911796206,MATH 120A,A01,085445,Eggers; John Dietrich,20,0,35,15
1649911796206,MATH 120A,A02,085446,Eggers; John Dietrich,28,0,35,7
1649911802230,MATH 142B,A01,084149,Verstraete; Jacques Allan,0,10,30,30
1649911802230,MATH 142B,A02,084150,Verstraete; Jacques Allan,1,8,30,29
1649911808256,MATH 170A,A01,083459,Nie; Jiawang,0,2,30,30
1649911808256,MATH 170A,A02,083460,Nie; Jiawang,0,0,30,30
1649911808256,MATH 170A,A03,083461,Nie; Jiawang,14,0,30,16
1649911814281,MATH 193B,A01,083463,Staff,3,0,30,27
1649911814281,MATH 193B,A02,083464,Staff,11,0,30,19
1649911814281,MATH 193B,A03,083465,Staff,20,0,30,10
1649911820332,COGS 2,A01,083966,Boyle; Mary E. T.,19,0,30,11
1649911826356,COGS 9,A01,083968,Staff,43,0,60,17
1649911832379,COGS 14B,A01,083970,Staff,29,0,50,21
1649911838402,COGS 17,A01,092679,Staff,67,0,75,8
1649911844425,COGS 100,A01,083972,Staff,15,0,60,45
1649911856478,COGS 101C,A01,083976,Staff,19,0,30,11
1649911862506,COGS 102A,A01,083978,Johnson; Christine M.,17,0,30,13
1649911868529,COGS 107B,A01,083980,Staff,6,0,50,44
1649911874551,COGS 115,A01,083982,Staff,15,0,30,15
1649911880598,COGS 118B,A01,083367,Staff,0,11,40,40
1649911886622,COGS 172,A01,083984,Provenzano; Emily Kara,17,0,30,13
1649911892644,COGS 177,A00,083368,Staff,1,18,30,29
1649911898673,COGS 186,A01,083986,Staff,22,0,40,18
1649911904808,COGS 187A,A01,083988,Boyle; Mary E. T.,24,0,60,36
1649911910844,CSE 8A,A50,084003,Miranda; Gregory Joseph,0,0,15,15
1649911916868,CSE 11,A01,084005,Miranda; Gregory Joseph,23,0,55,32
1649911922891,CSE 20,A01,084007,Staff,9,0,20,11
1649911928915,CSE 21,A01,084009,Staff,13,0,50,37
1649911934949,CSE 30,A01,083370,Cao; Yingjun,0,16,40,40
1649911940975,CSE 100,A01,083372,Cao; Yingjun,0,22,40,40
1649911947012,CSE 101,A01,084011,Staff,1,46,40,39
1649911953036,CSE 141,A01,083374,Eldon; John,1,50,75,74
1649911959069,CSE 141L,A01,083376,Eldon; John,1,54,75,74
1649911965111,CSE 175,A01,084013,Kumar; Rakesh,22,0,25,3
1649911971137,CSE 190,A00,092508,Dubnov; Shlomo,15,0,15,0
1649911977163,ECE 5,A01,084049,Morris; Karcher William,15,0,20,5
1649911983186,ECE 100,A01,084051,Baghdadchi; Saharnaz,1,0,20,19
1649911983186,ECE 100,A02,091916,Baghdadchi; Saharnaz,16,0,20,4
1649911989210,ECE 101,A01,084053,Baghdadchi; Saharnaz,5,0,37,32
1649911989210,ECE 101,A02,084054,Baghdadchi; Saharnaz,34,0,37,3
1649911995234,ECE 107,A01,083390,Staff,29,0,40,11
1649912001260,ECE 148,A01,084056,Silberman; Jack,7,0,12,5
1649912007287,ECE 180,A00,083391,Abi Samra; Nicholas Camill,25,0,30,5
1649912007287,ECE 180,B00,083392,Abi Samra; Nicholas Camill,22,0,30,8
1649912013310,MATH 10B,A01,084110,Staff,8,0,30,22
1649912013310,MATH 10B,A02,084111,Staff,29,0,30,1
1649912013310,MATH 10B,A03,084112,Staff,28,0,30,2
1649912019332,MATH 10C,A01,083443,Staff,9,0,30,21
1649912019332,MATH 10C,A02,083444,Staff,17,0,30,13
1649912019332,MATH 10C,B01,084114,Staff,25,0,30,5
1649912019332,MATH 10C,B02,084115,Staff,29,0,30,1
1649912025354,MATH 18,A01,084117,Harel; Guershon,27,0,30,3
1649912025354,MATH 18,A02,084119,Harel; Guershon,29,0,30,1
1649912025354,MATH 18,A03,084120,Harel; Guershon,30,0,30,0
1649912025354,MATH 18,A04,084121,Harel; Guershon,29,0,30,1
1649912031392,MATH 20B,A01,084124,Um; Ko Woon,31,0,35,4
1649912031392,MATH 20B,B01,084126,Um; Ko Woon,32,0,35,3
1649912037418,MATH 20C,A01,083446,Hammock; Frances H,18,0,30,12
1649912037418,MATH 20C,A02,083447,Hammock; Frances H,28,0,30,2
1649912037418,MATH 20C,A03,083448,Hammock; Frances H,30,0,30,0
1649912037418,MATH 20C,A04,083449,Hammock; Frances H,30,0,30,0
1649912037418,MATH 20C,B01,083451,Hammock; Frances H,25,0,30,5
1649912037418,MATH 20C,B02,083452,Hammock; Frances H,27,0,30,3
1649912037418,MATH 20C,B03,083453,Hammock; Frances H,26,0,30,4
1649912037418,MATH 20C,B04,083454,Hammock; Frances H,30,0,30,0
1649912043451,MATH 20D,A01,084128,Staff,26,0,30,4
1649912043451,MATH 20D,A02,084129,Staff,30,0,30,0
1649912043451,MATH 20D,A03,084130,Staff,29,0,30,1
1649912043451,MATH 20D,B01,084133,Staff,22,0,30,8
1649912043451,MATH 20D,B02,084134,Staff,27,0,30,3
1649912043451,MATH 20D,B03,084135,Staff,30,0,30,0
1649912049489,MATH 20E,A01,084138,Staff,24,0,30,6
1649912049489,MATH 20E,A02,084139,Staff,23,0,30,7
1649912049489,MATH 20E,A03,084140,Staff,24,0,30,6
1649912049489,MATH 20E,A04,084141,Staff,27,0,30,3
1649912055514,MATH 102,A01,084143,Harel; Guershon,19,0,30,11
1649912055514,MATH 102,A02,084144,Harel; Guershon,22,0,30,8
1649912061540,MATH 103B,A01,083456,Staff,0,8,30,30
1649912061540,MATH 103B,A02,083457,Staff,0,9,30,30
1649912067563,MATH 109,A01,084146,Salehi Golsefidy; Alireza,29,0,30,1
1649912067563,MATH 109,A02,084147,Salehi Golsefidy; Alireza,22,0,30,8
1649912073600,MATH 120A,A01,085445,Eggers; John Dietrich,20,0,35,15
1649912073600,MATH 120A,A02,085446,Eggers; John Dietrich,28,0,35,7
1649912079639,MATH 142B,A01,084149,Verstraete; Jacques Allan,0,10,30,30
1649912079639,MATH 142B,A02,084150,Verstraete; Jacques Allan,1,8,30,29
1649912085670,MATH 170A,A01,083459,Nie; Jiawang,0,2,30,30
1649912085670,MATH 170A,A02,083460,Nie; Jiawang,0,0,30,30
1649912085670,MATH 170A,A03,083461,Nie; Jiawang,14,0,30,16
1649912091694,MATH 193B,A01,083463,Staff,3,0,30,27
1649912091694,MATH 193B,A02,083464,Staff,11,0,30,19
1649912091694,MATH 193B,A03,083465,Staff,20,0,30,10
1649912097761,COGS 2,A01,083966,Boyle; Mary E. T.,19,0,30,11
1649912103784,COGS 9,A01,083968,Staff,43,0,60,17
1649912109810,COGS 14B,A01,083970,Staff,29,0,50,21
1649912115835,COGS 17,A01,092679,Staff,67,0,75,8
1649912121858,COGS 100,A01,083972,Staff,15,0,60,45
1649912133913,COGS 101C,A01,083976,Staff,19,0,30,11
1649912139948,COGS 102A,A01,083978,Johnson; Christine M.,17,0,30,13
1649912145971,COGS 107B,A01,083980,Staff,6,0,50,44
1649912152002,COGS 115,A01,083982,Staff,15,0,30,15
1649912158027,COGS 118B,A01,083367,Staff,0,11,40,40
1649912164052,COGS 172,A01,083984,Provenzano; Emily Kara,17,0,30,13
1649912170076,COGS 177,A00,083368,Staff,1,18,30,29
1649912176108,COGS 186,A01,083986,Staff,22,0,40,18
1649912182132,COGS 187A,A01,083988,Boyle; Mary E. T.,24,0,60,36
1649912188159,CSE 8A,A50,084003,Miranda; Gregory Joseph,0,0,15,15
1649912194186,CSE 11,A01,084005,Miranda; Gregory Joseph,24,0,55,31
1649912200210,CSE 20,A01,084007,Staff,10,0,20,10
1649912206244,CSE 21,A01,084009,Staff,13,0,50,37
1649912212271,CSE 30,A01,083370,Cao; Yingjun,0,16,40,40
1649912218294,CSE 100,A01,083372,Cao; Yingjun,0,22,40,40
1649912224328,CSE 101,A01,084011,Staff,1,46,40,39
1649912230363,CSE 141,A01,083374,Eldon; John,1,50,75,74
1649912236392,CSE 141L,A01,083376,Eldon; John,1,54,75,74
1649912242419,CSE 175,A01,084013,Kumar; Rakesh,22,0,25,3
1649912248450,CSE 190,A00,092508,Dubnov; Shlomo,15,0,15,0
1649912254476,ECE 5,A01,084049,Morris; Karcher William,15,0,20,5
1649912260504,ECE 100,A01,084051,Baghdadchi; Saharnaz,1,0,20,19
1649912260504,ECE 100,A02,091916,Baghdadchi; Saharnaz,16,0,20,4
1649912266530,ECE 101,A01,084053,Baghdadchi; Saharnaz,5,0,37,32
1649912266530,ECE 101,A02,084054,Baghdadchi; Saharnaz,34,0,37,3
1649912272555,ECE 107,A01,083390,Staff,29,0,40,11
1649912278579,ECE 148,A01,084056,Silberman; Jack,7,0,12,5
1649912284606,ECE 180,A00,083391,Abi Samra; Nicholas Camill,25,0,30,5
1649912284606,ECE 180,B00,083392,Abi Samra; Nicholas Camill,22,0,30,8
1649912290634,MATH 10B,A01,084110,Staff,8,0,30,22
1649912290634,MATH 10B,A02,084111,Staff,29,0,30,1
1649912290634,MATH 10B,A03,084112,Staff,28,0,30,2
1649912296673,MATH 10C,A01,083443,Staff,9,0,30,21
1649912296673,MATH 10C,A02,083444,Staff,17,0,30,13
1649912296673,MATH 10C,B01,084114,Staff,25,0,30,5
1649912296673,MATH 10C,B02,084115,Staff,29,0,30,1
1649912302697,MATH 18,A01,084117,Harel; Guershon,27,0,30,3
1649912302697,MATH 18,A02,084119,Harel; Guershon,29,0,30,1
1649912302697,MATH 18,A03,084120,Harel; Guershon,30,0,30,0
1649912302697,MATH 18,A04,084121,Harel; Guershon,29,0,30,1
1649912308721,MATH 20B,A01,084124,Um; Ko Woon,31,0,35,4
1649912308721,MATH 20B,B01,084126,Um; Ko Woon,32,0,35,3
1649912314754,MATH 20C,A01,083446,Hammock; Frances H,18,0,30,12
1649912314754,MATH 20C,A02,083447,Hammock; Frances H,28,0,30,2
1649912314754,MATH 20C,A03,083448,Hammock; Frances H,30,0,30,0
1649912314754,MATH 20C,A04,083449,Hammock; Frances H,30,0,30,0
1649912314754,MATH 20C,B01,083451,Hammock; Frances H,25,0,30,5
1649912314754,MATH 20C,B02,083452,Hammock; Frances H,27,0,30,3
1649912314754,MATH 20C,B03,083453,Hammock; Frances H,26,0,30,4
1649912314754,MATH 20C,B04,083454,Hammock; Frances H,30,0,30,0
1649912320781,MATH 20D,A01,084128,Staff,26,0,30,4
1649912320781,MATH 20D,A02,084129,Staff,30,0,30,0
1649912320781,MATH 20D,A03,084130,Staff,29,0,30,1
1649912320781,MATH 20D,B01,084133,Staff,22,0,30,8
1649912320781,MATH 20D,B02,084134,Staff,27,0,30,3
1649912320781,MATH 20D,B03,084135,Staff,30,0,30,0
1649912326807,MATH 20E,A01,084138,Staff,24,0,30,6
1649912326807,MATH 20E,A02,084139,Staff,23,0,30,7
1649912326807,MATH 20E,A03,084140,Staff,24,0,30,6
1649912326807,MATH 20E,A04,084141,Staff,26,0,30,4
1649912332836,MATH 102,A01,084143,Harel; Guershon,19,0,30,11
1649912332836,MATH 102,A02,084144,Harel; Guershon,22,0,30,8
1649912338862,MATH 103B,A01,083456,Staff,0,8,30,30
1649912338862,MATH 103B,A02,083457,Staff,0,9,30,30
1649912344889,MATH 109,A01,084146,Salehi Golsefidy; Alireza,29,0,30,1
1649912344889,MATH 109,A02,084147,Salehi Golsefidy; Alireza,22,0,30,8
1649912350913,MATH 120A,A01,085445,Eggers; John Dietrich,20,0,35,15
1649912350913,MATH 120A,A02,085446,Eggers; John Dietrich,28,0,35,7
1649912356936,MATH 142B,A01,084149,Verstraete; Jacques Allan,0,10,30,30
1649912356936,MATH 142B,A02,084150,Verstraete; Jacques Allan,1,8,30,29
1649912362960,MATH 170A,A01,083459,Nie; Jiawang,0,2,30,30
1649912362960,MATH 170A,A02,083460,Nie; Jiawang,0,0,30,30
1649912362960,MATH 170A,A03,083461,Nie; Jiawang,14,0,30,16
1649912368983,MATH 193B,A01,083463,Staff,3,0,30,27
1649912368983,MATH 193B,A02,083464,Staff,11,0,30,19
1649912368983,MATH 193B,A03,083465,Staff,20,0,30,10
1649912375045,COGS 2,A01,083966,Boyle; Mary E. T.,19,0,30,11
1649912381070,COGS 9,A01,083968,Staff,43,0,60,17
1649912387095,COGS 14B,A01,083970,Staff,29,0,50,21
1649912393118,COGS 17,A01,092679,Staff,67,0,75,8
1649912399151,COGS 100,A01,083972,Staff,15,0,60,45
1649912411204,COGS 101C,A01,083976,Staff,19,0,30,11
1649912417228,COGS 102A,A01,083978,Johnson; Christine M.,17,0,30,13
1649912423260,COGS 107B,A01,083980,Staff,6,0,50,44
1649912429282,COGS 115,A01,083982,Staff,15,0,30,15
1649912435317,COGS 118B,A01,083367,Staff,0,11,40,40
1649912441341,COGS 172,A01,083984,Provenzano; Emily Kara,17,0,30,13
1649912447364,COGS 177,A00,083368,Staff,1,18,30,29
1649912453389,COGS 186,A01,083986,Staff,22,0,40,18
1649912459414,COGS 187A,A01,083988,Boyle; Mary E. T.,24,0,60,36
1649912465456,CSE 8A,A50,084003,Miranda; Gregory Joseph,0,0,15,15
1649912471484,CSE 11,A01,084005,Miranda; Gregory Joseph,24,0,55,31
1649912477506,CSE 20,A01,084007,Staff,10,0,20,10
1649912483531,CSE 21,A01,084009,Staff,13,0,50,37
1649912489557,CSE 30,A01,083370,Cao; Yingjun,0,16,40,40
1649912495679,CSE 100,A01,083372,Cao; Yingjun,0,22,40,40
1649912501712,CSE 101,A01,084011,Staff,1,46,40,39
1649912507735,CSE 141,A01,083374,Eldon; John,1,50,75,74
1649912513761,CSE 141L,A01,083376,Eldon; John,1,55,75,74
1649912519788,CSE 175,A01,084013,Kumar; Rakesh,22,0,25,3
1649912525817,CSE 190,A00,092508,Dubnov; Shlomo,15,0,15,0
1649912531842,ECE 5,A01,084049,Morris; Karcher William,15,0,20,5
1649912537865,ECE 100,A01,084051,Baghdadchi; Saharnaz,1,0,20,19
1649912537865,ECE 100,A02,091916,Baghdadchi; Saharnaz,16,0,20,4
1649912543894,ECE 101,A01,084053,Baghdadchi; Saharnaz,5,0,37,32
1649912543894,ECE 101,A02,084054,Baghdadchi; Saharnaz,34,0,37,3
1649912549927,ECE 107,A01,083390,Staff,29,0,40,11
1649912555953,ECE 148,A01,084056,Silberman; Jack,7,0,12,5
1649912561975,ECE 180,A00,083391,Abi Samra; Nicholas Camill,25,0,30,5
1649912561975,ECE 180,B00,083392,Abi Samra; Nicholas Camill,22,0,30,8
1649912568013,MATH 10B,A01,084110,Staff,8,0,30,22
1649912568013,MATH 10B,A02,084111,Staff,29,0,30,1
1649912568013,MATH 10B,A03,084112,Staff,28,0,30,2
1649912574038,MATH 10C,A01,083443,Staff,9,0,30,21
1649912574038,MATH 10C,A02,083444,Staff,17,0,30,13
1649912574038,MATH 10C,B01,084114,Staff,25,0,30,5
1649912574038,MATH 10C,B02,084115,Staff,29,0,30,1
1649912580062,MATH 18,A01,084117,Harel; Guershon,27,0,30,3
1649912580062,MATH 18,A02,084119,Harel; Guershon,29,0,30,1
1649912580062,MATH 18,A03,084120,Harel; Guershon,30,0,30,0
1649912580062,MATH 18,A04,084121,Harel; Guershon,29,0,30,1
1649912586091,MATH 20B,A01,084124,Um; Ko Woon,31,0,35,4
1649912586091,MATH 20B,B01,084126,Um; Ko Woon,32,0,35,3
1649912592117,MATH 20C,A01,083446,Hammock; Frances H,18,0,30,12
1649912592117,MATH 20C,A02,083447,Hammock; Frances H,28,0,30,2
1649912592117,MATH 20C,A03,083448,Hammock; Frances H,30,0,30,0
1649912592117,MATH 20C,A04,083449,Hammock; Frances H,30,0,30,0
1649912592117,MATH 20C,B01,083451,Hammock; Frances H,25,0,30,5
1649912592117,MATH 20C,B02,083452,Hammock; Frances H,27,0,30,3
1649912592117,MATH 20C,B03,083453,Hammock; Frances H,26,0,30,4
1649912592117,MATH 20C,B04,083454,Hammock; Frances H,30,0,30,0
1649912598148,MATH 20D,A01,084128,Staff,26,0,30,4
1649912598148,MATH 20D,A02,084129,Staff,30,0,30,0
1649912598148,MATH 20D,A03,084130,Staff,29,0,30,1
1649912598148,MATH 20D,B01,084133,Staff,22,0,30,8
1649912598148,MATH 20D,B02,084134,Staff,27,0,30,3
1649912598148,MATH 20D,B03,084135,Staff,30,0,30,0
1649912604172,MATH 20E,A01,084138,Staff,24,0,30,6
1649912604172,MATH 20E,A02,084139,Staff,23,0,30,7
1649912604172,MATH 20E,A03,084140,Staff,24,0,30,6
1649912604172,MATH 20E,A04,084141,Staff,26,0,30,4
1649912610194,MATH 102,A01,084143,Harel; Guershon,19,0,30,11
1649912610194,MATH 102,A02,084144,Harel; Guershon,22,0,30,8
1649912616217,MATH 103B,A01,083456,Staff,0,8,30,30
1649912616217,MATH 103B,A02,083457,Staff,0,9,30,30
1649912622244,MATH 109,A01,084146,Salehi Golsefidy; Alireza,29,0,30,1
1649912622244,MATH 109,A02,084147,Salehi Golsefidy; Alireza,22,0,30,8
1649912628271,MATH 120A,A01,085445,Eggers; John Dietrich,20,0,35,15
1649912628271,MATH 120A,A02,085446,Eggers; John Dietrich,28,0,35,7
1649912634300,MATH 142B,A01,084149,Verstraete; Jacques Allan,0,10,30,30
1649912634300,MATH 142B,A02,084150,Verstraete; Jacques Allan,1,8,30,29
1649912640325,MATH 170A,A01,083459,Nie; Jiawang,0,2,30,30
1649912640325,MATH 170A,A02,083460,Nie; Jiawang,0,0,30,30
1649912640325,MATH 170A,A03,083461,Nie; Jiawang,14,0,30,16
1649912646352,MATH 193B,A01,083463,Staff,3,0,30,27
1649912646352,MATH 193B,A02,083464,Staff,11,0,30,19
1649912646352,MATH 193B,A03,083465,Staff,20,0,30,10
1649912652401,COGS 2,A01,083966,Boyle; Mary E. T.,19,0,30,11
1649912658429,COGS 9,A01,083968,Staff,43,0,60,17
1649912664454,COGS 14B,A01,083970,Staff,29,0,50,21
1649912670477,COGS 17,A01,092679,Staff,67,0,75,8
1649912676501,COGS 100,A01,083972,Staff,15,0,60,45
1649912688554,COGS 101C,A01,083976,Staff,19,0,30,11
1649912694578,COGS 102A,A01,083978,Johnson; Christine M.,17,0,30,13
1649912700607,COGS 107B,A01,083980,Staff,6,0,50,44
1649912706632,COGS 115,A01,083982,Staff,15,0,30,15
1649912712658,COGS 118B,A01,083367,Staff,0,11,40,40
1649912718687,COGS 172,A01,083984,Provenzano; Emily Kara,17,0,30,13
1649912724713,COGS 177,A00,083368,Staff,1,18,30,29
1649912730741,COGS 186,A01,083986,Staff,22,0,40,18
1649912736768,COGS 187A,A01,083988,Boyle; Mary E. T.,24,0,60,36
1649912742797,CSE 8A,A50,084003,Miranda; Gregory Joseph,0,0,15,15
1649912748828,CSE 11,A01,084005,Miranda; Gregory Joseph,24,0,55,31
1649912754858,CSE 20,A01,084007,Staff,10,0,20,10
1649912760882,CSE 21,A01,084009,Staff,13,0,50,37
1649912766905,CSE 30,A01,083370,Cao; Yingjun,0,16,40,40
1649912772928,CSE 100,A01,083372,Cao; Yingjun,0,22,40,40
1649912778952,CSE 101,A01,084011,Staff,1,46,40,39
1649912784975,CSE 141,A01,083374,Eldon; John,1,50,75,74
1649912791015,CSE 141L,A01,083376,Eldon; John,1,55,75,74
1649912797038,CSE 175,A01,084013,Kumar; Rakesh,22,0,25,3
1649912803062,CSE 190,A00,092508,Dubnov; Shlomo,15,0,15,0
1649912809086,ECE 5,A01,084049,Morris; Karcher William,15,0,20,5
1649912815113,ECE 100,A01,084051,Baghdadchi; Saharnaz,1,0,20,19
1649912815113,ECE 100,A02,091916,Baghdadchi; Saharnaz,16,0,20,4
1649912821137,ECE 101,A01,084053,Baghdadchi; Saharnaz,5,0,37,32
1649912821137,ECE 101,A02,084054,Baghdadchi; Saharnaz,34,0,37,3
1649912827163,ECE 107,A01,083390,Staff,29,0,40,11
1649912833195,ECE 148,A01,084056,Silberman; Jack,7,0,12,5
1649912839218,ECE 180,A00,083391,Abi Samra; Nicholas Camill,25,0,30,5
1649912839218,ECE 180,B00,083392,Abi Samra; Nicholas Camill,22,0,30,8
1649912845244,MATH 10B,A01,084110,Staff,8,0,30,22
1649912845244,MATH 10B,A02,084111,Staff,29,0,30,1
1649912845244,MATH 10B,A03,084112,Staff,28,0,30,2
1649912851268,MATH 10C,A01,083443,Staff,9,0,30,21
1649912851268,MATH 10C,A02,083444,Staff,17,0,30,13
1649912851268,MATH 10C,B01,084114,Staff,25,0,30,5
1649912851268,MATH 10C,B02,084115,Staff,29,0,30,1
1649912857295,MATH 18,A01,084117,Harel; Guershon,27,0,30,3
1649912857295,MATH 18,A02,084119,Harel; Guershon,29,0,30,1
1649912857295,MATH 18,A03,084120,Harel; Guershon,30,0,30,0
1649912857295,MATH 18,A04,084121,Harel; Guershon,29,0,30,1
1649912863321,MATH 20B,A01,084124,Um; Ko Woon,31,0,35,4
1649912863321,MATH 20B,B01,084126,Um; Ko Woon,32,0,35,3
1649912869344,MATH 20C,A01,083446,Hammock; Frances H,18,0,30,12
1649912869344,MATH 20C,A02,083447,Hammock; Frances H,28,0,30,2
1649912869344,MATH 20C,A03,083448,Hammock; Frances H,30,0,30,0
1649912869344,MATH 20C,A04,083449,Hammock; Frances H,30,0,30,0
1649912869344,MATH 20C,B01,083451,Hammock; Frances H,25,0,30,5
1649912869344,MATH 20C,B02,083452,Hammock; Frances H,27,0,30,3
1649912869344,MATH 20C,B03,083453,Hammock; Frances H,26,0,30,4
1649912869344,MATH 20C,B04,083454,Hammock; Frances H,30,0,30,0
1649912875367,MATH 20D,A01,084128,Staff,26,0,30,4
1649912875367,MATH 20D,A02,084129,Staff,30,0,30,0
1649912875367,MATH 20D,A03,084130,Staff,29,0,30,1
1649912875367,MATH 20D,B01,084133,Staff,22,0,30,8
1649912875367,MATH 20D,B02,084134,Staff,27,0,30,3
1649912875367,MATH 20D,B03,084135,Staff,30,0,30,0
1649912881394,MATH 20E,A01,084138,Staff,24,0,30,6
1649912881394,MATH 20E,A02,084139,Staff,23,0,30,7
1649912881394,MATH 20E,A03,084140,Staff,24,0,30,6
1649912881394,MATH 20E,A04,084141,Staff,26,0,30,4
1649912887421,MATH 102,A01,084143,Harel; Guershon,19,0,30,11
1649912887421,MATH 102,A02,084144,Harel; Guershon,22,0,30,8
1649912893443,MATH 103B,A01,083456,Staff,0,8,30,30
1649912893443,MATH 103B,A02,083457,Staff,0,9,30,30
1649912899481,MATH 109,A01,084146,Salehi Golsefidy; Alireza,29,0,30,1
1649912899481,MATH 109,A02,084147,Salehi Golsefidy; Alireza,22,0,30,8
1649912905504,MATH 120A,A01,085445,Eggers; John Dietrich,20,0,35,15
1649912905504,MATH 120A,A02,085446,Eggers; John Dietrich,28,0,35,7
1649912911535,MATH 142B,A01,084149,Verstraete; Jacques Allan,0,10,30,30
1649912911535,MATH 142B,A02,084150,Verstraete; Jacques Allan,1,8,30,29
1649912917560,MATH 170A,A01,083459,Nie; Jiawang,0,2,30,30
1649912917560,MATH 170A,A02,083460,Nie; Jiawang,0,0,30,30
1649912917560,MATH 170A,A03,083461,Nie; Jiawang,14,0,30,16
1649912923590,MATH 193B,A01,083463,Staff,3,0,30,27
1649912923590,MATH 193B,A02,083464,Staff,11,0,30,19
1649912923590,MATH 193B,A03,083465,Staff,20,0,30,10
1649912929652,COGS 2,A01,083966,Boyle; Mary E. T.,18,0,30,12
1649912935677,COGS 9,A01,083968,Staff,43,0,60,17
1649912941706,COGS 14B,A01,083970,Staff,29,0,50,21
1649912947731,COGS 17,A01,092679,Staff,67,0,75,8
1649912953764,COGS 100,A01,083972,Staff,15,0,60,45
1649912965820,COGS 101C,A01,083976,Staff,19,0,30,11
1649912971844,COGS 102A,A01,083978,Johnson; Christine M.,17,0,30,13
1649912977869,COGS 107B,A01,083980,Staff,6,0,50,44
1649912983893,COGS 115,A01,083982,Staff,15,0,30,15
1649912989926,COGS 118B,A01,083367,Staff,0,11,40,40
1649912995953,COGS 172,A01,083984,Provenzano; Emily Kara,17,0,30,13
1649913001980,COGS 177,A00,083368,Staff,1,18,30,29
1649913008003,COGS 186,A01,083986,Staff,22,0,40,18
1649913014029,COGS 187A,A01,083988,Boyle; Mary E. T.,24,0,60,36
1649913020053,CSE 8A,A50,084003,Miranda; Gregory Joseph,0,0,15,15
1649913026076,CSE 11,A01,084005,Miranda; Gregory Joseph,24,0,55,31
1649913032099,CSE 20,A01,084007,Staff,10,0,20,10
1649913038137,CSE 21,A01,084009,Staff,13,0,50,37
1649913044163,CSE 30,A01,083370,Cao; Yingjun,0,16,40,40
1649913050188,CSE 100,A01,083372,Cao; Yingjun,0,22,40,40
1649913056238,CSE 101,A01,084011,Staff,1,47,40,39
1649913062260,CSE 141,A01,083374,Eldon; John,1,50,75,74
1649913068283,CSE 141L,A01,083376,Eldon; John,1,55,75,74
1649913074305,CSE 175,A01,084013,Kumar; Rakesh,22,0,25,3
1649913080327,CSE 190,A00,092508,Dubnov; Shlomo,15,0,15,0
1649913086355,ECE 5,A01,084049,Morris; Karcher William,15,0,20,5
1649913092481,ECE 100,A01,084051,Baghdadchi; Saharnaz,1,0,20,19
1649913092481,ECE 100,A02,091916,Baghdadchi; Saharnaz,16,0,20,4
1649913098504,ECE 101,A01,084053,Baghdadchi; Saharnaz,5,0,37,32
1649913098504,ECE 101,A02,084054,Baghdadchi; Saharnaz,34,0,37,3
1649913104530,ECE 107,A01,083390,Staff,29,0,40,11
1649913110554,ECE 148,A01,084056,Silberman; Jack,7,0,12,5
1649913116590,ECE 180,A00,083391,Abi Samra; Nicholas Camill,25,0,30,5
1649913116590,ECE 180,B00,083392,Abi Samra; Nicholas Camill,22,0,30,8
1649913122623,MATH 10B,A01,084110,Staff,8,0,30,22
1649913122623,MATH 10B,A02,084111,Staff,29,0,30,1
1649913122623,MATH 10B,A03,084112,Staff,28,0,30,2
1649913128650,MATH 10C,A01,083443,Staff,9,0,30,21
1649913128650,MATH 10C,A02,083444,Staff,17,0,30,13
1649913128650,MATH 10C,B01,084114,Staff,25,0,30,5
1649913128650,MATH 10C,B02,084115,Staff,29,0,30,1
1649913134688,MATH 18,A01,084117,Harel; Guershon,27,0,30,3
1649913134688,MATH 18,A02,084119,Harel; Guershon,29,0,30,1
1649913134688,MATH 18,A03,084120,Harel; Guershon,30,0,30,0
1649913134688,MATH 18,A04,084121,Harel; Guershon,29,0,30,1
1649913140715,MATH 20B,A01,084124,Um; Ko Woon,31,0,35,4
1649913140715,MATH 20B,B01,084126,Um; Ko Woon,32,0,35,3
1649913146740,MATH 20C,A01,083446,Hammock; Frances H,18,0,30,12
1649913146740,MATH 20C,A02,083447,Hammock; Frances H,28,0,30,2
1649913146740,MATH 20C,A03,083448,Hammock; Frances H,30,0,30,0
1649913146740,MATH 20C,A04,083449,Hammock; Frances H,30,0,30,0
1649913146740,MATH 20C,B01,083451,Hammock; Frances H,25,0,30,5
1649913146740,MATH 20C,B02,083452,Hammock; Frances H,27,0,30,3
1649913146740,MATH 20C,B03,083453,Hammock; Frances H,26,0,30,4
1649913146740,MATH 20C,B04,083454,Hammock; Frances H,30,0,30,0
1649913152764,MATH 20D,A01,084128,Staff,26,0,30,4
1649913152764,MATH 20D,A02,084129,Staff,30,0,30,0
1649913152764,MATH 20D,A03,084130,Staff,29,0,30,1
1649913152764,MATH 20D,B01,084133,Staff,22,0,30,8
1649913152764,MATH 20D,B02,084134,Staff,27,0,30,3
1649913152764,MATH 20D,B03,084135,Staff,30,0,30,0
1649913158796,MATH 20E,A01,084138,Staff,24,0,30,6
1649913158796,MATH 20E,A02,084139,Staff,23,0,30,7
1649913158796,MATH 20E,A03,084140,Staff,24,0,30,6
1649913158796,MATH 20E,A04,084141,Staff,26,0,30,4
1649913164829,MATH 102,A01,084143,Harel; Guershon,19,0,30,11
1649913164829,MATH 102,A02,084144,Harel; Guershon,22,0,30,8
1649913170860,MATH 103B,A01,083456,Staff,0,9,30,30
1649913170860,MATH 103B,A02,083457,Staff,0,9,30,30
1649913176882,MATH 109,A01,084146,Salehi Golsefidy; Alireza,29,0,30,1
1649913176882,MATH 109,A02,084147,Salehi Golsefidy; Alireza,22,0,30,8
1649913182905,MATH 120A,A01,085445,Eggers; John Dietrich,20,0,35,15
1649913182905,MATH 120A,A02,085446,Eggers; John Dietrich,28,0,35,7
1649913188932,MATH 142B,A01,084149,Verstraete; Jacques Allan,0,10,30,30
1649913188932,MATH 142B,A02,084150,Verstraete; Jacques Allan,1,8,30,29
1649913194958,MATH 170A,A01,083459,Nie; Jiawang,0,2,30,30
1649913194958,MATH 170A,A02,083460,Nie; Jiawang,0,0,30,30
1649913194958,MATH 170A,A03,083461,Nie; Jiawang,14,0,30,16
1649913200986,MATH 193B,A01,083463,Staff,3,0,30,27
1649913200986,MATH 193B,A02,083464,Staff,11,0,30,19
1649913200986,MATH 193B,A03,083465,Staff,20,0,30,10
1649913207045,COGS 2,A01,083966,Boyle; Mary E. T.,18,0,30,12
1649913213067,COGS 9,A01,083968,Staff,43,0,60,17
1649913219098,COGS 14B,A01,083970,Staff,29,0,50,21
1649913225134,COGS 17,A01,092679,Staff,67,0,75,8
1649913231158,COGS 100,A01,083972,Staff,15,0,60,45
1649913243217,COGS 101C,A01,083976,Staff,19,0,30,11
1649913249243,COGS 102A,A01,083978,Johnson; Christine M.,17,0,30,13
1649913255268,COGS 107B,A01,083980,Staff,5,0,50,45
1649913261301,COGS 115,A01,083982,Staff,15,0,30,15
1649913267330,COGS 118B,A01,083367,Staff,0,11,40,40
1649913273367,COGS 172,A01,083984,Provenzano; Emily Kara,17,0,30,13
1649913279405,COGS 177,A00,083368,Staff,1,18,30,29
1649913285451,COGS 186,A01,083986,Staff,22,0,40,18
1649913291484,COGS 187A,A01,083988,Boyle; Mary E. T.,24,0,60,36
1649913297527,CSE 8A,A50,084003,Miranda; Gregory Joseph,0,0,15,15
1649913303551,CSE 11,A01,084005,Miranda; Gregory Joseph,24,0,55,31
1649913309575,CSE 20,A01,084007,Staff,10,0,20,10
1649913315599,CSE 21,A01,084009,Staff,12,0,50,38
1649913321623,CSE 30,A01,083370,Cao; Yingjun,0,17,40,40
1649913327648,CSE 100,A01,083372,Cao; Yingjun,0,22,40,40
1649913333675,CSE 101,A01,084011,Staff,1,47,40,39
1649913339698,CSE 141,A01,083374,Eldon; John,1,50,75,74
1649913345723,CSE 141L,A01,083376,Eldon; John,1,55,75,74
1649913351746,CSE 175,A01,084013,Kumar; Rakesh,22,0,25,3
1649913357770,CSE 190,A00,092508,Dubnov; Shlomo,15,0,15,0
1649913363793,ECE 5,A01,084049,Morris; Karcher William,15,0,20,5
1649913369816,ECE 100,A01,084051,Baghdadchi; Saharnaz,1,0,20,19
1649913369816,ECE 100,A02,091916,Baghdadchi; Saharnaz,16,0,20,4
1649913375842,ECE 101,A01,084053,Baghdadchi; Saharnaz,5,0,37,32
1649913375842,ECE 101,A02,084054,Baghdadchi; Saharnaz,34,0,37,3
1649913381864,ECE 107,A01,083390,Staff,29,0,40,11
1649913387889,ECE 148,A01,084056,Silberman; Jack,7,0,12,5
1649913393912,ECE 180,A00,083391,Abi Samra; Nicholas Camill,25,0,30,5
1649913393912,ECE 180,B00,083392,Abi Samra; Nicholas Camill,22,0,30,8
1649913399936,MATH 10B,A01,084110,Staff,8,0,30,22
1649913399936,MATH 10B,A02,084111,Staff,29,0,30,1
1649913399936,MATH 10B,A03,084112,Staff,28,0,30,2
1649913405963,MATH 10C,A01,083443,Staff,9,0,30,21
1649913405963,MATH 10C,A02,083444,Staff,17,0,30,13
1649913405963,MATH 10C,B01,084114,Staff,25,0,30,5
1649913405963,MATH 10C,B02,084115,Staff,29,0,30,1
1649913411987,MATH 18,A01,084117,Harel; Guershon,27,0,30,3
1649913411987,MATH 18,A02,084119,Harel; Guershon,29,0,30,1
1649913411987,MATH 18,A03,084120,Harel; Guershon,30,0,30,0
1649913411987,MATH 18,A04,084121,Harel; Guershon,29,0,30,1
1649913418013,MATH 20B,A01,084124,Um; Ko Woon,31,0,35,4
1649913418013,MATH 20B,B01,084126,Um; Ko Woon,32,0,35,3
1649913424041,MATH 20C,A01,083446,Hammock; Frances H,18,0,30,12
1649913424041,MATH 20C,A02,083447,Hammock; Frances H,28,0,30,2
1649913424041,MATH 20C,A03,083448,Hammock; Frances H,30,0,30,0
1649913424041,MATH 20C,A04,083449,Hammock; Frances H,30,0,30,0
1649913424041,MATH 20C,B01,083451,Hammock; Frances H,25,0,30,5
1649913424041,MATH 20C,B02,083452,Hammock; Frances H,27,0,30,3
1649913424041,MATH 20C,B03,083453,Hammock; Frances H,26,0,30,4
1649913424041,MATH 20C,B04,083454,Hammock; Frances H,30,0,30,0
1649913430072,MATH 20D,A01,084128,Staff,26,0,30,4
1649913430072,MATH 20D,A02,084129,Staff,30,0,30,0
1649913430072,MATH 20D,A03,084130,Staff,29,0,30,1
1649913430072,MATH 20D,B01,084133,Staff,22,0,30,8
1649913430072,MATH 20D,B02,084134,Staff,27,0,30,3
1649913430072,MATH 20D,B03,084135,Staff,30,0,30,0
1649913436109,MATH 20E,A01,084138,Staff,24,0,30,6
1649913436109,MATH 20E,A02,084139,Staff,23,0,30,7
1649913436109,MATH 20E,A03,084140,Staff,24,0,30,6
1649913436109,MATH 20E,A04,084141,Staff,26,0,30,4
1649913442133,MATH 102,A01,084143,Harel; Guershon,19,0,30,11
1649913442133,MATH 102,A02,084144,Harel; Guershon,22,0,30,8
1649913448160,MATH 103B,A01,083456,Staff,0,9,30,30
1649913448160,MATH 103B,A02,083457,Staff,0,9,30,30
1649913454188,MATH 109,A01,084146,Salehi Golsefidy; Alireza,29,0,30,1
1649913454188,MATH 109,A02,084147,Salehi Golsefidy; Alireza,22,0,30,8
1649913460217,MATH 120A,A01,085445,Eggers; John Dietrich,20,0,35,15
1649913460217,MATH 120A,A02,085446,Eggers; John Dietrich,28,0,35,7
1649913466242,MATH 142B,A01,084149,Verstraete; Jacques Allan,0,10,30,30
1649913466242,MATH 142B,A02,084150,Verstraete; Jacques Allan,1,8,30,29
1649913472273,MATH 170A,A01,083459,Nie; Jiawang,0,2,30,30
1649913472273,MATH 170A,A02,083460,Nie; Jiawang,0,0,30,30
1649913472273,MATH 170A,A03,083461,Nie; Jiawang,14,0,30,16
1649913478300,MATH 193B,A01,083463,Staff,3,0,30,27
1649913478300,MATH 193B,A02,083464,Staff,11,0,30,19
1649913478300,MATH 193B,A03,083465,Staff,20,0,30,10
1649913484355,COGS 2,A01,083966,Boyle; Mary E. T.,18,0,30,12
1649913490382,COGS 9,A01,083968,Staff,43,0,60,17
1649913496407,COGS 14B,A01,083970,Staff,29,0,50,21
1649913502430,COGS 17,A01,092679,Staff,67,0,75,8
1649913508454,COGS 100,A01,083972,Staff,15,0,60,45
1649913520508,COGS 101C,A01,083976,Staff,19,0,30,11
1649913526530,COGS 102A,A01,083978,Johnson; Christine M.,17,0,30,13
1649913532557,COGS 107B,A01,083980,Staff,5,0,50,45
1649913538585,COGS 115,A01,083982,Staff,15,0,30,15
1649913544610,COGS 118B,A01,083367,Staff,0,11,40,40
1649913550638,COGS 172,A01,083984,Provenzano; Emily Kara,17,0,30,13
1649913556666,COGS 177,A00,083368,Staff,1,18,30,29
1649913562689,COGS 186,A01,083986,Staff,22,0,40,18
1649913568712,COGS 187A,A01,083988,Boyle; Mary E. T.,24,0,60,36
1649913574738,CSE 8A,A50,084003,Miranda; Gregory Joseph,0,0,15,15
1649913580762,CSE 11,A01,084005,Miranda; Gregory Joseph,24,0,55,31
1649913586785,CSE 20,A01,084007,Staff,10,0,20,10
1649913592821,CSE 21,A01,084009,Staff,12,0,50,38
1649913598843,CSE 30,A01,083370,Cao; Yingjun,0,17,40,40
1649913604868,CSE 100,A01,083372,Cao; Yingjun,0,22,40,40
1649913610891,CSE 101,A01,084011,Staff,1,47,40,39
1649913616928,CSE 141,A01,083374,Eldon; John,1,50,75,74
1649913622954,CSE 141L,A01,083376,Eldon; John,1,55,75,74
1649913628987,CSE 175,A01,084013,Kumar; Rakesh,22,0,25,3
1649913635025,CSE 190,A00,092508,Dubnov; Shlomo,15,0,15,0
1649913641046,ECE 5,A01,084049,Morris; Karcher William,15,0,20,5
1649913647073,ECE 100,A01,084051,Baghdadchi; Saharnaz,1,0,20,19
1649913647073,ECE 100,A02,091916,Baghdadchi; Saharnaz,16,0,20,4
1649913653098,ECE 101,A01,084053,Baghdadchi; Saharnaz,5,0,37,32
1649913653098,ECE 101,A02,084054,Baghdadchi; Saharnaz,34,0,37,3
1649913659124,ECE 107,A01,083390,Staff,29,0,40,11
1649913665146,ECE 148,A01,084056,Silberman; Jack,7,0,12,5
1649913671168,ECE 180,A00,083391,Abi Samra; Nicholas Camill,25,0,30,5
1649913671168,ECE 180,B00,083392,Abi Samra; Nicholas Camill,22,0,30,8
1649913677204,MATH 10B,A01,084110,Staff,8,0,30,22
1649913677204,MATH 10B,A02,084111,Staff,29,0,30,1
1649913677204,MATH 10B,A03,084112,Staff,28,0,30,2
1649913683230,MATH 10C,A01,083443,Staff,9,0,30,21
1649913683230,MATH 10C,A02,083444,Staff,17,0,30,13
1649913683230,MATH 10C,B01,084114,Staff,25,0,30,5
1649913683230,MATH 10C,B02,084115,Staff,29,0,30,1
1649913689341,MATH 18,A01,084117,Harel; Guershon,27,0,30,3
1649913689341,MATH 18,A02,084119,Harel; Guershon,29,0,30,1
1649913689341,MATH 18,A03,084120,Harel; Guershon,30,0,30,0
1649913689341,MATH 18,A04,084121,Harel; Guershon,29,0,30,1
1649913695364,MATH 20B,A01,084124,Um; Ko Woon,31,0,35,4
1649913695364,MATH 20B,B01,084126,Um; Ko Woon,32,0,35,3
1649913701388,MATH 20C,A01,083446,Hammock; Frances H,18,0,30,12
1649913701388,MATH 20C,A02,083447,Hammock; Frances H,28,0,30,2
1649913701388,MATH 20C,A03,083448,Hammock; Frances H,30,0,30,0
1649913701388,MATH 20C,A04,083449,Hammock; Frances H,30,0,30,0
1649913701388,MATH 20C,B01,083451,Hammock; Frances H,25,0,30,5
1649913701388,MATH 20C,B02,083452,Hammock; Frances H,27,0,30,3
1649913701388,MATH 20C,B03,083453,Hammock; Frances H,26,0,30,4
1649913701388,MATH 20C,B04,083454,Hammock; Frances H,30,0,30,0
1649913707416,MATH 20D,A01,084128,Staff,26,0,30,4
1649913707416,MATH 20D,A02,084129,Staff,30,0,30,0
1649913707416,MATH 20D,A03,084130,Staff,29,0,30,1
1649913707416,MATH 20D,B01,084133,Staff,22,0,30,8
1649913707416,MATH 20D,B02,084134,Staff,27,0,30,3
1649913707416,MATH 20D,B03,084135,Staff,30,0,30,0
1649913713442,MATH 20E,A01,084138,Staff,24,0,30,6
1649913713442,MATH 20E,A02,084139,Staff,23,0,30,7
1649913713442,MATH 20E,A03,084140,Staff,24,0,30,6
1649913713442,MATH 20E,A04,084141,Staff,26,0,30,4
1649913719469,MATH 102,A01,084143,Harel; Guershon,18,0,30,12
1649913719469,MATH 102,A02,084144,Harel; Guershon,22,0,30,8
1649913725492,MATH 103B,A01,083456,Staff,0,9,30,30
1649913725492,MATH 103B,A02,083457,Staff,0,9,30,30
1649913731525,MATH 109,A01,084146,Salehi Golsefidy; Alireza,29,0,30,1
1649913731525,MATH 109,A02,084147,Salehi Golsefidy; Alireza,22,0,30,8
1649913737550,MATH 120A,A01,085445,Eggers; John Dietrich,20,0,35,15
1649913737550,MATH 120A,A02,085446,Eggers; John Dietrich,28,0,35,7
1649913743573,MATH 142B,A01,084149,Verstraete; Jacques Allan,0,10,30,30
1649913743573,MATH 142B,A02,084150,Verstraete; Jacques Allan,1,8,30,29
1649913749596,MATH 170A,A01,083459,Nie; Jiawang,0,2,30,30
1649913749596,MATH 170A,A02,083460,Nie; Jiawang,0,0,30,30
1649913749596,MATH 170A,A03,083461,Nie; Jiawang,14,0,30,16
1649913755618,MATH 193B,A01,083463,Staff,3,0,30,27
1649913755618,MATH 193B,A02,083464,Staff,11,0,30,19
1649913755618,MATH 193B,A03,083465,Staff,20,0,30,10
1649913761681,COGS 2,A01,083966,Boyle; Mary E. T.,18,0,30,12
1649913767708,COGS 9,A01,083968,Staff,43,0,60,17
1649913773734,COGS 14B,A01,083970,Staff,29,0,50,21
1649913779757,COGS 17,A01,092679,Staff,67,0,75,8
1649913785780,COGS 100,A01,083972,Staff,15,0,60,45
1649913797824,COGS 101C,A01,083976,Staff,19,0,30,11
1649913803850,COGS 102A,A01,083978,Johnson; Christine M.,17,0,30,13
1649913809873,COGS 107B,A01,083980,Staff,5,0,50,45
1649913815894,COGS 115,A01,083982,Staff,15,0,30,15
1649913821917,COGS 118B,A01,083367,Staff,0,11,40,40
1649913827940,COGS 172,A01,083984,Provenzano; Emily Kara,17,0,30,13
1649913833963,COGS 177,A00,083368,Staff,1,18,30,29
1649913839996,COGS 186,A01,083986,Staff,22,0,40,18
1649913846021,COGS 187A,A01,083988,Boyle; Mary E. T.,24,0,60,36
1649913852050,CSE 8A,A50,084003,Miranda; Gregory Joseph,0,0,15,15
1649913858079,CSE 11,A01,084005,Miranda; Gregory Joseph,24,0,55,31
1649913864105,CSE 20,A01,084007,Staff,10,0,20,10
1649913870127,CSE 21,A01,084009,Staff,12,0,50,38
1649913876150,CSE 30,A01,083370,Cao; Yingjun,0,18,40,40
1649913882172,CSE 100,A01,083372,Cao; Yingjun,0,22,40,40
1649913888197,CSE 101,A01,084011,Staff,1,47,40,39
1649913894229,CSE 141,A01,083374,Eldon; John,1,50,75,74
1649913900254,CSE 141L,A01,083376,Eldon; John,1,55,75,74
1649913906276,CSE 175,A01,084013,Kumar; Rakesh,22,0,25,3
1649913912300,CSE 190,A00,092508,Dubnov; Shlomo,15,0,15,0
1649913918328,ECE 5,A01,084049,Morris; Karcher William,15,0,20,5
1649913924350,ECE 100,A01,084051,Baghdadchi; Saharnaz,1,0,20,19
1649913924350,ECE 100,A02,091916,Baghdadchi; Saharnaz,16,0,20,4
1649913930377,ECE 101,A01,084053,Baghdadchi; Saharnaz,5,0,37,32
1649913930377,ECE 101,A02,084054,Baghdadchi; Saharnaz,34,0,37,3
1649913936400,ECE 107,A01,083390,Staff,29,0,40,11
1649913942423,ECE 148,A01,084056,Silberman; Jack,7,0,12,5
1649913948456,ECE 180,A00,083391,Abi Samra; Nicholas Camill,25,0,30,5
1649913948456,ECE 180,B00,083392,Abi Samra; Nicholas Camill,22,0,30,8
1649913954484,MATH 10B,A01,084110,Staff,8,0,30,22
1649913954484,MATH 10B,A02,084111,Staff,29,0,30,1
1649913954484,MATH 10B,A03,084112,Staff,28,0,30,2
1649913960513,MATH 10C,A01,083443,Staff,9,0,30,21
1649913960513,MATH 10C,A02,083444,Staff,17,0,30,13
1649913960513,MATH 10C,B01,084114,Staff,25,0,30,5
1649913960513,MATH 10C,B02,084115,Staff,29,0,30,1
1649913966537,MATH 18,A01,084117,Harel; Guershon,27,0,30,3
1649913966537,MATH 18,A02,084119,Harel; Guershon,29,0,30,1
1649913966537,MATH 18,A03,084120,Harel; Guershon,30,0,30,0
1649913966537,MATH 18,A04,084121,Harel; Guershon,29,0,30,1
1649913972559,MATH 20B,A01,084124,Um; Ko Woon,31,0,35,4
1649913972559,MATH 20B,B01,084126,Um; Ko Woon,32,0,35,3
1649913978587,MATH 20C,A01,083446,Hammock; Frances H,18,0,30,12
1649913978587,MATH 20C,A02,083447,Hammock; Frances H,28,0,30,2
1649913978587,MATH 20C,A03,083448,Hammock; Frances H,30,0,30,0
1649913978587,MATH 20C,A04,083449,Hammock; Frances H,30,0,30,0
1649913978587,MATH 20C,B01,083451,Hammock; Frances H,25,0,30,5
1649913978587,MATH 20C,B02,083452,Hammock; Frances H,27,0,30,3
1649913978587,MATH 20C,B03,083453,Hammock; Frances H,26,0,30,4
1649913978587,MATH 20C,B04,083454,Hammock; Frances H,30,0,30,0
1649913984610,MATH 20D,A01,084128,Staff,26,0,30,4
1649913984610,MATH 20D,A02,084129,Staff,30,0,30,0
1649913984610,MATH 20D,A03,084130,Staff,29,0,30,1
1649913984610,MATH 20D,B01,084133,Staff,22,0,30,8
1649913984610,MATH 20D,B02,084134,Staff,27,0,30,3
1649913984610,MATH 20D,B03,084135,Staff,30,0,30,0
1649913990637,MATH 20E,A01,084138,Staff,24,0,30,6
1649913990637,MATH 20E,A02,084139,Staff,22,0,30,8
1649913990637,MATH 20E,A03,084140,Staff,24,0,30,6
1649913990637,MATH 20E,A04,084141,Staff,26,0,30,4
1649913996667,MATH 102,A01,084143,Harel; Guershon,18,0,30,12
1649913996667,MATH 102,A02,084144,Harel; Guershon,22,0,30,8
1649914002693,MATH 103B,A01,083456,Staff,0,9,30,30
1649914002693,MATH 103B,A02,083457,Staff,0,9,30,30
1649914008716,MATH 109,A01,084146,Salehi Golsefidy; Alireza,29,0,30,1
1649914008716,MATH 109,A02,084147,Salehi Golsefidy; Alireza,22,0,30,8
1649914014741,MATH 120A,A01,085445,Eggers; John Dietrich,20,0,35,15
1649914014741,MATH 120A,A02,085446,Eggers; John Dietrich,28,0,35,7
1649914020769,MATH 142B,A01,084149,Verstraete; Jacques Allan,0,10,30,30
1649914020769,MATH 142B,A02,084150,Verstraete; Jacques Allan,0,7,30,30
1649914026801,MATH 170A,A01,083459,Nie; Jiawang,0,2,30,30
1649914026801,MATH 170A,A02,083460,Nie; Jiawang,0,0,30,30
1649914026801,MATH 170A,A03,083461,Nie; Jiawang,13,0,30,17
1649914032828,MATH 193B,A01,083463,Staff,3,0,30,27
1649914032828,MATH 193B,A02,083464,Staff,11,0,30,19
1649914032828,MATH 193B,A03,083465,Staff,20,0,30,10
1649914038890,COGS 2,A01,083966,Boyle; Mary E. T.,18,0,30,12
1649914044913,COGS 9,A01,083968,Staff,43,0,60,17
1649914050943,COGS 14B,A01,083970,Staff,29,0,50,21
1649914056966,COGS 17,A01,092679,Staff,67,0,75,8
1649914062989,COGS 100,A01,083972,Staff,15,0,60,45
1649914075039,COGS 101C,A01,083976,Staff,19,0,30,11
1649914081062,COGS 102A,A01,083978,Johnson; Christine M.,17,0,30,13
1649914087085,COGS 107B,A01,083980,Staff,5,0,50,45
1649914093111,COGS 115,A01,083982,Staff,15,0,30,15
1649914099141,COGS 118B,A01,083367,Staff,0,11,40,40
1649914105165,COGS 172,A01,083984,Provenzano; Emily Kara,17,0,30,13
1649914111195,COGS 177,A00,083368,Staff,0,17,30,30
1649914117226,COGS 186,A01,083986,Staff,22,0,40,18
1649914123251,COGS 187A,A01,083988,Boyle; Mary E. T.,24,0,60,36
1649914129275,CSE 8A,A50,084003,Miranda; Gregory Joseph,0,0,15,15
1649914135297,CSE 11,A01,084005,Miranda; Gregory Joseph,24,0,55,31
1649914141329,CSE 20,A01,084007,Staff,10,0,20,10
1649914147352,CSE 21,A01,084009,Staff,12,0,50,38
1649914153376,CSE 30,A01,083370,Cao; Yingjun,0,18,40,40
1649914159400,CSE 100,A01,083372,Cao; Yingjun,0,22,40,40
1649914165423,CSE 101,A01,084011,Staff,0,46,40,40
1649914171447,CSE 141,A01,083374,Eldon; John,0,49,75,75
1649914177471,CSE 141L,A01,083376,Eldon; John,0,54,75,75
1649914183498,CSE 175,A01,084013,Kumar; Rakesh,22,0,25,3
1649914189521,CSE 190,A00,092508,Dubnov; Shlomo,15,0,15,0
1649914195552,ECE 5,A01,084049,Morris; Karcher William,15,0,20,5
1649914201588,ECE 100,A01,084051,Baghdadchi; Saharnaz,1,0,20,19
1649914201588,ECE 100,A02,091916,Baghdadchi; Saharnaz,16,0,20,4
1649914207615,ECE 101,A01,084053,Baghdadchi; Saharnaz,5,0,37,32
1649914207615,ECE 101,A02,084054,Baghdadchi; Saharnaz,34,0,37,3
1649914213642,ECE 107,A01,083390,Staff,29,0,40,11
1649914219664,ECE 148,A01,084056,Silberman; Jack,7,0,12,5
1649914225700,ECE 180,A00,083391,Abi Samra; Nicholas Camill,25,0,30,5
1649914225700,ECE 180,B00,083392,Abi Samra; Nicholas Camill,22,0,30,8
1649914231724,MATH 10B,A01,084110,Staff,8,0,30,22
1649914231724,MATH 10B,A02,084111,Staff,29,0,30,1
1649914231724,MATH 10B,A03,084112,Staff,28,0,30,2
1649914237749,MATH 10C,A01,083443,Staff,9,0,30,21
1649914237749,MATH 10C,A02,083444,Staff,17,0,30,13
1649914237749,MATH 10C,B01,084114,Staff,25,0,30,5
1649914237749,MATH 10C,B02,084115,Staff,29,0,30,1
1649914243778,MATH 18,A01,084117,Harel; Guershon,27,0,30,3
1649914243778,MATH 18,A02,084119,Harel; Guershon,29,0,30,1
1649914243778,MATH 18,A03,084120,Harel; Guershon,30,0,30,0
1649914243778,MATH 18,A04,084121,Harel; Guershon,29,0,30,1
1649914249807,MATH 20B,A01,084124,Um; Ko Woon,31,0,35,4
1649914249807,MATH 20B,B01,084126,Um; Ko Woon,32,0,35,3
1649914255844,MATH 20C,A01,083446,Hammock; Frances H,18,0,30,12
1649914255844,MATH 20C,A02,083447,Hammock; Frances H,28,0,30,2
1649914255844,MATH 20C,A03,083448,Hammock; Frances H,30,0,30,0
1649914255844,MATH 20C,A04,083449,Hammock; Frances H,30,0,30,0
1649914255844,MATH 20C,B01,083451,Hammock; Frances H,25,0,30,5
1649914255844,MATH 20C,B02,083452,Hammock; Frances H,27,0,30,3
1649914255844,MATH 20C,B03,083453,Hammock; Frances H,26,0,30,4
1649914255844,MATH 20C,B04,083454,Hammock; Frances H,30,0,30,0
1649914261869,MATH 20D,A01,084128,Staff,26,0,30,4
1649914261869,MATH 20D,A02,084129,Staff,30,0,30,0
1649914261869,MATH 20D,A03,084130,Staff,29,0,30,1
1649914261869,MATH 20D,B01,084133,Staff,22,0,30,8
1649914261869,MATH 20D,B02,084134,Staff,27,0,30,3
1649914261869,MATH 20D,B03,084135,Staff,30,0,30,0
1649914267892,MATH 20E,A01,084138,Staff,24,0,30,6
1649914267892,MATH 20E,A02,084139,Staff,22,0,30,8
1649914267892,MATH 20E,A03,084140,Staff,24,0,30,6
1649914267892,MATH 20E,A04,084141,Staff,26,0,30,4
1649914273917,MATH 102,A01,084143,Harel; Guershon,18,0,30,12
1649914273917,MATH 102,A02,084144,Harel; Guershon,22,0,30,8
1649914279945,MATH 103B,A01,083456,Staff,0,9,30,30
1649914279945,MATH 103B,A02,083457,Staff,0,9,30,30
1649914286058,MATH 109,A01,084146,Salehi Golsefidy; Alireza,29,0,30,1
1649914286058,MATH 109,A02,084147,Salehi Golsefidy; Alireza,22,0,30,8
1649914292082,MATH 120A,A01,085445,Eggers; John Dietrich,20,0,35,15
1649914292082,MATH 120A,A02,085446,Eggers; John Dietrich,28,0,35,7
1649914298105,MATH 142B,A01,084149,Verstraete; Jacques Allan,0,10,30,30
1649914298105,MATH 142B,A02,084150,Verstraete; Jacques Allan,0,7,30,30
1649914304137,MATH 170A,A01,083459,Nie; Jiawang,0,2,30,30
1649914304137,MATH 170A,A02,083460,Nie; Jiawang,0,0,30,30
1649914304137,MATH 170A,A03,083461,Nie; Jiawang,13,0,30,17
1649914310170,MATH 193B,A01,083463,Staff,3,0,30,27
1649914310170,MATH 193B,A02,083464,Staff,11,0,30,19
1649914310170,MATH 193B,A03,083465,Staff,20,0,30,10
1649914316235,COGS 2,A01,083966,Boyle; Mary E. T.,18,0,30,12
1649914322263,COGS 9,A01,083968,Staff,43,0,60,17
1649914328290,COGS 14B,A01,083970,Staff,29,0,50,21
1649914334316,COGS 17,A01,092679,Staff,67,0,75,8
1649914340340,COGS 100,A01,083972,Staff,15,0,60,45
1649914352390,COGS 101C,A01,083976,Staff,19,0,30,11
1649914358420,COGS 102A,A01,083978,Johnson; Christine M.,17,0,30,13
1649914364455,COGS 107B,A01,083980,Staff,5,0,50,45
1649914370481,COGS 115,A01,083982,Staff,15,0,30,15
1649914376532,COGS 118B,A01,083367,Staff,0,11,40,40
1649914382557,COGS 172,A01,083984,Provenzano; Emily Kara,17,0,30,13
1649914388579,COGS 177,A00,083368,Staff,0,17,30,30
1649914394606,COGS 186,A01,083986,Staff,22,0,40,18
1649914400632,COGS 187A,A01,083988,Boyle; Mary E. T.,24,0,60,36
1649914406656,CSE 8A,A50,084003,Miranda; Gregory Joseph,0,0,15,15
1649914412683,CSE 11,A01,084005,Miranda; Gregory Joseph,24,0,55,31
1649914418708,CSE 20,A01,084007,Staff,10,0,20,10
1649914424731,CSE 21,A01,084009,Staff,12,0,50,38
1649914430754,CSE 30,A01,083370,Cao; Yingjun,0,18,40,40
1649914436784,CSE 100,A01,083372,Cao; Yingjun,0,22,40,40
1649914442809,CSE 101,A01,084011,Staff,0,46,40,40
1649914448842,CSE 141,A01,083374,Eldon; John,0,49,75,75
1649914454875,CSE 141L,A01,083376,Eldon; John,0,54,75,75
1649914460899,CSE 175,A01,084013,Kumar; Rakesh,22,0,25,3
1649914466922,CSE 190,A00,092508,Dubnov; Shlomo,15,0,15,0
1649914472945,ECE 5,A01,084049,Morris; Karcher William,15,0,20,5
1649914478970,ECE 100,A01,084051,Baghdadchi; Saharnaz,1,0,20,19
1649914478970,ECE 100,A02,091916,Baghdadchi; Saharnaz,16,0,20,4
1649914484993,ECE 101,A01,084053,Baghdadchi; Saharnaz,6,0,37,31
1649914484993,ECE 101,A02,084054,Baghdadchi; Saharnaz,33,0,37,4
1649914491016,ECE 107,A01,083390,Staff,29,0,40,11
1649914497040,ECE 148,A01,084056,Silberman; Jack,7,0,12,5
1649914503062,ECE 180,A00,083391,Abi Samra; Nicholas Camill,25,0,30,5
1649914503062,ECE 180,B00,083392,Abi Samra; Nicholas Camill,22,0,30,8
1649914509094,MATH 10B,A01,084110,Staff,8,0,30,22
1649914509094,MATH 10B,A02,084111,Staff,29,0,30,1
1649914509094,MATH 10B,A03,084112,Staff,28,0,30,2
1649914515125,MATH 10C,A01,083443,Staff,9,0,30,21
1649914515125,MATH 10C,A02,083444,Staff,17,0,30,13
1649914515125,MATH 10C,B01,084114,Staff,25,0,30,5
1649914515125,MATH 10C,B02,084115,Staff,29,0,30,1
1649914521147,MATH 18,A01,084117,Harel; Guershon,27,0,30,3
1649914521147,MATH 18,A02,084119,Harel; Guershon,29,0,30,1
1649914521147,MATH 18,A03,084120,Harel; Guershon,30,0,30,0
1649914521147,MATH 18,A04,084121,Harel; Guershon,29,0,30,1
1649914527170,MATH 20B,A01,084124,Um; Ko Woon,31,0,35,4
1649914527170,MATH 20B,B01,084126,Um; Ko Woon,32,0,35,3
1649914533198,MATH 20C,A01,083446,Hammock; Frances H,18,0,30,12
1649914533198,MATH 20C,A02,083447,Hammock; Frances H,28,0,30,2
1649914533198,MATH 20C,A03,083448,Hammock; Frances H,30,0,30,0
1649914533198,MATH 20C,A04,083449,Hammock; Frances H,30,0,30,0
1649914533198,MATH 20C,B01,083451,Hammock; Frances H,25,0,30,5
1649914533198,MATH 20C,B02,083452,Hammock; Frances H,27,0,30,3
1649914533198,MATH 20C,B03,083453,Hammock; Frances H,26,0,30,4
1649914533198,MATH 20C,B04,083454,Hammock; Frances H,30,0,30,0
1649914539220,MATH 20D,A01,084128,Staff,26,0,30,4
1649914539220,MATH 20D,A02,084129,Staff,30,0,30,0
1649914539220,MATH 20D,A03,084130,Staff,29,0,30,1
1649914539220,MATH 20D,B01,084133,Staff,22,0,30,8
1649914539220,MATH 20D,B02,084134,Staff,27,0,30,3
1649914539220,MATH 20D,B03,084135,Staff,30,0,30,0
1649914545245,MATH 20E,A01,084138,Staff,24,0,30,6
1649914545245,MATH 20E,A02,084139,Staff,22,0,30,8
1649914545245,MATH 20E,A03,084140,Staff,24,0,30,6
1649914545245,MATH 20E,A04,084141,Staff,26,0,30,4
1649914551268,MATH 102,A01,084143,Harel; Guershon,18,0,30,12
1649914551268,MATH 102,A02,084144,Harel; Guershon,22,0,30,8
1649914557292,MATH 103B,A01,083456,Staff,0,9,30,30
1649914557292,MATH 103B,A02,083457,Staff,0,9,30,30
1649914563328,MATH 109,A01,084146,Salehi Golsefidy; Alireza,29,0,30,1
1649914563328,MATH 109,A02,084147,Salehi Golsefidy; Alireza,22,0,30,8
1649914569352,MATH 120A,A01,085445,Eggers; John Dietrich,20,0,35,15
1649914569352,MATH 120A,A02,085446,Eggers; John Dietrich,28,0,35,7
1649914575375,MATH 142B,A01,084149,Verstraete; Jacques Allan,0,10,30,30
1649914575375,MATH 142B,A02,084150,Verstraete; Jacques Allan,0,8,30,30
1649914581398,MATH 170A,A01,083459,Nie; Jiawang,0,2,30,30
1649914581398,MATH 170A,A02,083460,Nie; Jiawang,0,0,30,30
1649914581398,MATH 170A,A03,083461,Nie; Jiawang,13,0,30,17
1649914587421,MATH 193B,A01,083463,Staff,3,0,30,27
1649914587421,MATH 193B,A02,083464,Staff,11,0,30,19
1649914587421,MATH 193B,A03,083465,Staff,20,0,30,10
1649914593479,COGS 2,A01,083966,Boyle; Mary E. T.,18,0,30,12
1649914599501,COGS 9,A01,083968,Staff,43,0,60,17
1649914605536,COGS 14B,A01,083970,Staff,29,0,50,21
1649914611562,COGS 17,A01,092679,Staff,67,0,75,8
1649914617588,COGS 100,A01,083972,Staff,15,0,60,45
1649914629640,COGS 101C,A01,083976,Staff,19,0,30,11
1649914635669,COGS 102A,A01,083978,Johnson; Christine M.,17,0,30,13
1649914641692,COGS 107B,A01,083980,Staff,5,0,50,45
1649914647718,COGS 115,A01,083982,Staff,15,0,30,15
1649914653747,COGS 118B,A01,083367,Staff,0,11,40,40
1649914659771,COGS 172,A01,083984,Provenzano; Emily Kara,17,0,30,13
1649914665795,COGS 177,A00,083368,Staff,0,17,30,30
1649914671822,COGS 186,A01,083986,Staff,22,0,40,18
1649914677858,COGS 187A,A01,083988,Boyle; Mary E. T.,24,0,60,36
1649914683881,CSE 8A,A50,084003,Miranda; Gregory Joseph,0,0,15,15
1649914689906,CSE 11,A01,084005,Miranda; Gregory Joseph,23,0,55,32
1649914695932,CSE 20,A01,084007,Staff,10,0,20,10
1649914701956,CSE 21,A01,084009,Staff,12,0,50,38
1649914707982,CSE 30,A01,083370,Cao; Yingjun,0,18,40,40
1649914714005,CSE 100,A01,083372,Cao; Yingjun,0,22,40,40
1649914720032,CSE 101,A01,084011,Staff,0,46,40,40
1649914726058,CSE 141,A01,083374,Eldon; John,0,49,75,75
1649914732091,CSE 141L,A01,083376,Eldon; John,0,54,75,75
1649914738113,CSE 175,A01,084013,Kumar; Rakesh,22,0,25,3
1649914744141,CSE 190,A00,092508,Dubnov; Shlomo,15,0,15,0
1649914750171,ECE 5,A01,084049,Morris; Karcher William,15,0,20,5
1649914756194,ECE 100,A01,084051,Baghdadchi; Saharnaz,1,0,20,19
1649914756194,ECE 100,A02,091916,Baghdadchi; Saharnaz,16,0,20,4
1649914762223,ECE 101,A01,084053,Baghdadchi; Saharnaz,6,0,37,31
1649914762223,ECE 101,A02,084054,Baghdadchi; Saharnaz,33,0,37,4
1649914768250,ECE 107,A01,083390,Staff,29,0,40,11
1649914774273,ECE 148,A01,084056,Silberman; Jack,7,0,12,5
1649914780299,ECE 180,A00,083391,Abi Samra; Nicholas Camill,25,0,30,5
1649914780299,ECE 180,B00,083392,Abi Samra; Nicholas Camill,22,0,30,8
1649914786323,MATH 10B,A01,084110,Staff,8,0,30,22
1649914786323,MATH 10B,A02,084111,Staff,29,0,30,1
1649914786323,MATH 10B,A03,084112,Staff,28,0,30,2
1649914792347,MATH 10C,A01,083443,Staff,9,0,30,21
1649914792347,MATH 10C,A02,083444,Staff,17,0,30,13
1649914792347,MATH 10C,B01,084114,Staff,25,0,30,5
1649914792347,MATH 10C,B02,084115,Staff,29,0,30,1
1649914798374,MATH 18,A01,084117,Harel; Guershon,27,0,30,3
1649914798374,MATH 18,A02,084119,Harel; Guershon,29,0,30,1
1649914798374,MATH 18,A03,084120,Harel; Guershon,30,0,30,0
1649914798374,MATH 18,A04,084121,Harel; Guershon,29,0,30,1
1649914804398,MATH 20B,A01,084124,Um; Ko Woon,31,0,35,4
1649914804398,MATH 20B,B01,084126,Um; Ko Woon,32,0,35,3
1649914810427,MATH 20C,A01,083446,Hammock; Frances H,18,0,30,12
1649914810427,MATH 20C,A02,083447,Hammock; Frances H,28,0,30,2
1649914810427,MATH 20C,A03,083448,Hammock; Frances H,30,0,30,0
1649914810427,MATH 20C,A04,083449,Hammock; Frances H,30,0,30,0
1649914810427,MATH 20C,B01,083451,Hammock; Frances H,25,0,30,5
1649914810427,MATH 20C,B02,083452,Hammock; Frances H,27,0,30,3
1649914810427,MATH 20C,B03,083453,Hammock; Frances H,26,0,30,4
1649914810427,MATH 20C,B04,083454,Hammock; Frances H,30,0,30,0
1649914816455,MATH 20D,A01,084128,Staff,26,0,30,4
1649914816455,MATH 20D,A02,084129,Staff,30,0,30,0
1649914816455,MATH 20D,A03,084130,Staff,29,0,30,1
1649914816455,MATH 20D,B01,084133,Staff,22,0,30,8
1649914816455,MATH 20D,B02,084134,Staff,27,0,30,3
1649914816455,MATH 20D,B03,084135,Staff,30,0,30,0
1649914822482,MATH 20E,A01,084138,Staff,23,0,30,7
1649914822482,MATH 20E,A02,084139,Staff,22,0,30,8
1649914822482,MATH 20E,A03,084140,Staff,24,0,30,6
1649914822482,MATH 20E,A04,084141,Staff,26,0,30,4
1649914828506,MATH 102,A01,084143,Harel; Guershon,18,0,30,12
1649914828506,MATH 102,A02,084144,Harel; Guershon,22,0,30,8
1649914834528,MATH 103B,A01,083456,Staff,0,9,30,30
1649914834528,MATH 103B,A02,083457,Staff,0,9,30,30
1649914840558,MATH 109,A01,084146,Salehi Golsefidy; Alireza,29,0,30,1
1649914840558,MATH 109,A02,084147,Salehi Golsefidy; Alireza,22,0,30,8
1649914846581,MATH 120A,A01,085445,Eggers; John Dietrich,20,0,35,15
1649914846581,MATH 120A,A02,085446,Eggers; John Dietrich,28,0,35,7
1649914852606,MATH 142B,A01,084149,Verstraete; Jacques Allan,0,10,30,30
1649914852606,MATH 142B,A02,084150,Verstraete; Jacques Allan,0,8,30,30
1649914858628,MATH 170A,A01,083459,Nie; Jiawang,0,2,30,30
1649914858628,MATH 170A,A02,083460,Nie; Jiawang,0,0,30,30
1649914858628,MATH 170A,A03,083461,Nie; Jiawang,13,0,30,17
1649914864654,MATH 193B,A01,083463,Staff,3,0,30,27
1649914864654,MATH 193B,A02,083464,Staff,11,0,30,19
1649914864654,MATH 193B,A03,083465,Staff,20,0,30,10
1649914870719,COGS 2,A01,083966,Boyle; Mary E. T.,18,0,30,12
1649914876811,COGS 9,A01,083968,Staff,43,0,60,17
1649914882836,COGS 14B,A01,083970,Staff,29,0,50,21
1649914888860,COGS 17,A01,092679,Staff,67,0,75,8
1649914894893,COGS 100,A01,083972,Staff,15,0,60,45
1649914906955,COGS 101C,A01,083976,Staff,19,0,30,11
1649914912979,COGS 102A,A01,083978,Johnson; Christine M.,17,0,30,13
1649914919003,COGS 107B,A01,083980,Staff,5,0,50,45
1649914925027,COGS 115,A01,083982,Staff,15,0,30,15
1649914931053,COGS 118B,A01,083367,Staff,0,11,40,40
1649914937076,COGS 172,A01,083984,Provenzano; Emily Kara,17,0,30,13
1649914943106,COGS 177,A00,083368,Staff,0,17,30,30
1649914949136,COGS 186,A01,083986,Staff,22,0,40,18
1649914955163,COGS 187A,A01,083988,Boyle; Mary E. T.,24,0,60,36
1649914961185,CSE 8A,A50,084003,Miranda; Gregory Joseph,0,0,15,15
1649914967212,CSE 11,A01,084005,Miranda; Gregory Joseph,23,0,55,32
1649914973243,CSE 20,A01,084007,Staff,10,0,20,10
1649914979268,CSE 21,A01,084009,Staff,12,0,50,38
1649914985361,CSE 30,A01,083370,Cao; Yingjun,0,18,40,40
1649914991408,CSE 100,A01,083372,Cao; Yingjun,0,22,40,40
1649914997438,CSE 101,A01,084011,Staff,0,46,40,40
1649915003462,CSE 141,A01,083374,Eldon; John,0,49,75,75
1649915009491,CSE 141L,A01,083376,Eldon; John,0,54,75,75
1649915015518,CSE 175,A01,084013,Kumar; Rakesh,22,0,25,3
1649915021550,CSE 190,A00,092508,Dubnov; Shlomo,15,0,15,0
1649915027575,ECE 5,A01,084049,Morris; Karcher William,15,0,20,5
1649915033600,ECE 100,A01,084051,Baghdadchi; Saharnaz,1,0,20,19
1649915033600,ECE 100,A02,091916,Baghdadchi; Saharnaz,16,0,20,4
1649915039627,ECE 101,A01,084053,Baghdadchi; Saharnaz,6,0,37,31
1649915039627,ECE 101,A02,084054,Baghdadchi; Saharnaz,33,0,37,4
1649915045652,ECE 107,A01,083390,Staff,29,0,40,11
1649915051676,ECE 148,A01,084056,Silberman; Jack,7,0,12,5
1649915057700,ECE 180,A00,083391,Abi Samra; Nicholas Camill,25,0,30,5
1649915057700,ECE 180,B00,083392,Abi Samra; Nicholas Camill,22,0,30,8
1649915063724,MATH 10B,A01,084110,Staff,8,0,30,22
1649915063724,MATH 10B,A02,084111,Staff,29,0,30,1
1649915063724,MATH 10B,A03,084112,Staff,28,0,30,2
1649915069749,MATH 10C,A01,083443,Staff,9,0,30,21
1649915069749,MATH 10C,A02,083444,Staff,17,0,30,13
1649915069749,MATH 10C,B01,084114,Staff,25,0,30,5
1649915069749,MATH 10C,B02,084115,Staff,29,0,30,1
1649915075774,MATH 18,A01,084117,Harel; Guershon,27,0,30,3
1649915075774,MATH 18,A02,084119,Harel; Guershon,29,0,30,1
1649915075774,MATH 18,A03,084120,Harel; Guershon,30,0,30,0
1649915075774,MATH 18,A04,084121,Harel; Guershon,29,0,30,1
1649915081796,MATH 20B,A01,084124,Um; Ko Woon,31,0,35,4
1649915081796,MATH 20B,B01,084126,Um; Ko Woon,32,0,35,3
1649915087822,MATH 20C,A01,083446,Hammock; Frances H,17,0,30,13
1649915087822,MATH 20C,A02,083447,Hammock; Frances H,28,0,30,2
1649915087822,MATH 20C,A03,083448,Hammock; Frances H,30,0,30,0
1649915087822,MATH 20C,A04,083449,Hammock; Frances H,30,0,30,0
1649915087822,MATH 20C,B01,083451,Hammock; Frances H,25,0,30,5
1649915087822,MATH 20C,B02,083452,Hammock; Frances H,27,0,30,3
1649915087822,MATH 20C,B03,083453,Hammock; Frances H,26,0,30,4
1649915087822,MATH 20C,B04,083454,Hammock; Frances H,30,0,30,0
1649915093850,MATH 20D,A01,084128,Staff,26,0,30,4
1649915093850,MATH 20D,A02,084129,Staff,30,0,30,0
1649915093850,MATH 20D,A03,084130,Staff,29,0,30,1
1649915093850,MATH 20D,B01,084133,Staff,22,0,30,8
1649915093850,MATH 20D,B02,084134,Staff,27,0,30,3
1649915093850,MATH 20D,B03,084135,Staff,30,0,30,0
1649915099873,MATH 20E,A01,084138,Staff,23,0,30,7
1649915099873,MATH 20E,A02,084139,Staff,22,0,30,8
1649915099873,MATH 20E,A03,084140,Staff,24,0,30,6
1649915099873,MATH 20E,A04,084141,Staff,26,0,30,4
1649915105902,MATH 102,A01,084143,Harel; Guershon,18,0,30,12
1649915105902,MATH 102,A02,084144,Harel; Guershon,22,0,30,8
1649915111929,MATH 103B,A01,083456,Staff,0,9,30,30
1649915111929,MATH 103B,A02,083457,Staff,0,9,30,30
1649915117956,MATH 109,A01,084146,Salehi Golsefidy; Alireza,29,0,30,1
1649915117956,MATH 109,A02,084147,Salehi Golsefidy; Alireza,22,0,30,8
1649915123980,MATH 120A,A01,085445,Eggers; John Dietrich,20,0,35,15
1649915123980,MATH 120A,A02,085446,Eggers; John Dietrich,28,0,35,7
1649915130004,MATH 142B,A01,084149,Verstraete; Jacques Allan,0,10,30,30
1649915130004,MATH 142B,A02,084150,Verstraete; Jacques Allan,0,8,30,30
1649915136032,MATH 170A,A01,083459,Nie; Jiawang,0,2,30,30
1649915136032,MATH 170A,A02,083460,Nie; Jiawang,0,0,30,30
1649915136032,MATH 170A,A03,083461,Nie; Jiawang,12,0,30,18
1649915142055,MATH 193B,A01,083463,Staff,3,0,30,27
1649915142055,MATH 193B,A02,083464,Staff,11,0,30,19
1649915142055,MATH 193B,A03,083465,Staff,20,0,30,10
1649915148115,COGS 2,A01,083966,Boyle; Mary E. T.,18,0,30,12
1649915154136,COGS 9,A01,083968,Staff,43,0,60,17
1649915160162,COGS 14B,A01,083970,Staff,29,0,50,21
1649915166187,COGS 17,A01,092679,Staff,67,0,75,8
1649915172212,COGS 100,A01,083972,Staff,14,0,60,46
1649915184260,COGS 101C,A01,083976,Staff,19,0,30,11
1649915190284,COGS 102A,A01,083978,Johnson; Christine M.,17,0,30,13
1649915196306,COGS 107B,A01,083980,Staff,5,0,50,45
1649915202329,COGS 115,A01,083982,Staff,15,0,30,15
1649915208356,COGS 118B,A01,083367,Staff,0,11,40,40
1649915214384,COGS 172,A01,083984,Provenzano; Emily Kara,17,0,30,13
1649915220408,COGS 177,A00,083368,Staff,0,17,30,30
1649915226429,COGS 186,A01,083986,Staff,22,0,40,18
1649915232451,COGS 187A,A01,083988,Boyle; Mary E. T.,24,0,60,36
1649915238473,CSE 8A,A50,084003,Miranda; Gregory Joseph,0,0,15,15
1649915244505,CSE 11,A01,084005,Miranda; Gregory Joseph,23,0,55,32
1649915250529,CSE 20,A01,084007,Staff,10,0,20,10
1649915256551,CSE 21,A01,084009,Staff,12,0,50,38
1649915262573,CSE 30,A01,083370,Cao; Yingjun,0,18,40,40
1649915268599,CSE 100,A01,083372,Cao; Yingjun,0,22,40,40
1649915274624,CSE 101,A01,084011,Staff,0,46,40,40
1649915280647,CSE 141,A01,083374,Eldon; John,0,49,75,75
1649915286670,CSE 141L,A01,083376,Eldon; John,0,54,75,75
1649915292694,CSE 175,A01,084013,Kumar; Rakesh,22,0,25,3
1649915298719,CSE 190,A00,092508,Dubnov; Shlomo,15,0,15,0
1649915304744,ECE 5,A01,084049,Morris; Karcher William,15,0,20,5
1649915310771,ECE 100,A01,084051,Baghdadchi; Saharnaz,1,0,20,19
1649915310771,ECE 100,A02,091916,Baghdadchi; Saharnaz,16,0,20,4
1649915316798,ECE 101,A01,084053,Baghdadchi; Saharnaz,5,0,37,32
1649915316798,ECE 101,A02,084054,Baghdadchi; Saharnaz,33,0,37,4
1649915322820,ECE 107,A01,083390,Staff,29,0,40,11
1649915328847,ECE 148,A01,084056,Silberman; Jack,7,0,12,5
1649915334869,ECE 180,A00,083391,Abi Samra; Nicholas Camill,25,0,30,5
1649915334869,ECE 180,B00,083392,Abi Samra; Nicholas Camill,22,0,30,8
1649915340895,MATH 10B,A01,084110,Staff,8,0,30,22
1649915340895,MATH 10B,A02,084111,Staff,29,0,30,1
1649915340895,MATH 10B,A03,084112,Staff,28,0,30,2
1649915346922,MATH 10C,A01,083443,Staff,9,0,30,21
1649915346922,MATH 10C,A02,083444,Staff,17,0,30,13
1649915346922,MATH 10C,B01,084114,Staff,25,0,30,5
1649915346922,MATH 10C,B02,084115,Staff,29,0,30,1
1649915352946,MATH 18,A01,084117,Harel; Guershon,27,0,30,3
1649915352946,MATH 18,A02,084119,Harel; Guershon,29,0,30,1
1649915352946,MATH 18,A03,084120,Harel; Guershon,30,0,30,0
1649915352946,MATH 18,A04,084121,Harel; Guershon,29,0,30,1
1649915358971,MATH 20B,A01,084124,Um; Ko Woon,31,0,35,4
1649915358971,MATH 20B,B01,084126,Um; Ko Woon,32,0,35,3
1649915365000,MATH 20C,A01,083446,Hammock; Frances H,17,0,30,13
1649915365000,MATH 20C,A02,083447,Hammock; Frances H,28,0,30,2
1649915365000,MATH 20C,A03,083448,Hammock; Frances H,30,0,30,0
1649915365000,MATH 20C,A04,083449,Hammock; Frances H,30,0,30,0
1649915365000,MATH 20C,B01,083451,Hammock; Frances H,25,0,30,5
1649915365000,MATH 20C,B02,083452,Hammock; Frances H,27,0,30,3
1649915365000,MATH 20C,B03,083453,Hammock; Frances H,26,0,30,4
1649915365000,MATH 20C,B04,083454,Hammock; Frances H,30,0,30,0
1649915371028,MATH 20D,A01,084128,Staff,26,0,30,4
1649915371028,MATH 20D,A02,084129,Staff,30,0,30,0
1649915371028,MATH 20D,A03,084130,Staff,29,0,30,1
1649915371028,MATH 20D,B01,084133,Staff,22,0,30,8
1649915371028,MATH 20D,B02,084134,Staff,27,0,30,3
1649915371028,MATH 20D,B03,084135,Staff,30,0,30,0
1649915377051,MATH 20E,A01,084138,Staff,23,0,30,7
1649915377051,MATH 20E,A02,084139,Staff,22,0,30,8
1649915377051,MATH 20E,A03,084140,Staff,23,0,30,7
1649915377051,MATH 20E,A04,084141,Staff,26,0,30,4
1649915383076,MATH 102,A01,084143,Harel; Guershon,18,0,30,12
1649915383076,MATH 102,A02,084144,Harel; Guershon,22,0,30,8
1649915389099,MATH 103B,A01,083456,Staff,0,8,30,30
1649915389099,MATH 103B,A02,083457,Staff,0,9,30,30
1649915395123,MATH 109,A01,084146,Salehi Golsefidy; Alireza,29,0,30,1
1649915395123,MATH 109,A02,084147,Salehi Golsefidy; Alireza,22,0,30,8
1649915401145,MATH 120A,A01,085445,Eggers; John Dietrich,20,0,35,15
1649915401145,MATH 120A,A02,085446,Eggers; John Dietrich,28,0,35,7
1649915407169,MATH 142B,A01,084149,Verstraete; Jacques Allan,0,10,30,30
1649915407169,MATH 142B,A02,084150,Verstraete; Jacques Allan,0,8,30,30
1649915413192,MATH 170A,A01,083459,Nie; Jiawang,0,2,30,30
1649915413192,MATH 170A,A02,083460,Nie; Jiawang,0,0,30,30
1649915413192,MATH 170A,A03,083461,Nie; Jiawang,11,0,30,19
1649915419215,MATH 193B,A01,083463,Staff,3,0,30,27
1649915419215,MATH 193B,A02,083464,Staff,11,0,30,19
1649915419215,MATH 193B,A03,083465,Staff,20,0,30,10
1649915425276,COGS 2,A01,083966,Boyle; Mary E. T.,18,0,30,12
1649915431299,COGS 9,A01,083968,Staff,43,0,60,17
1649915437322,COGS 14B,A01,083970,Staff,29,0,50,21
1649915443345,COGS 17,A01,092679,Staff,67,0,75,8
1649915449371,COGS 100,A01,083972,Staff,14,0,60,46
1649915461424,COGS 101C,A01,083976,Staff,19,0,30,11
1649915467451,COGS 102A,A01,083978,Johnson; Christine M.,17,0,30,13
1649915473561,COGS 107B,A01,083980,Staff,5,0,50,45
1649915479588,COGS 115,A01,083982,Staff,15,0,30,15
1649915485614,COGS 118B,A01,083367,Staff,0,11,40,40
1649915491640,COGS 172,A01,083984,Provenzano; Emily Kara,17,0,30,13
1649915497662,COGS 177,A00,083368,Staff,0,17,30,30
1649915503687,COGS 186,A01,083986,Staff,22,0,40,18
1649915509710,COGS 187A,A01,083988,Boyle; Mary E. T.,24,0,60,36
1649915515736,CSE 8A,A50,084003,Miranda; Gregory Joseph,0,0,15,15
1649915521760,CSE 11,A01,084005,Miranda; Gregory Joseph,23,0,55,32
1649915527786,CSE 20,A01,084007,Staff,10,0,20,10
1649915533810,CSE 21,A01,084009,Staff,12,0,50,38
1649915539836,CSE 30,A01,083370,Cao; Yingjun,0,18,40,40
1649915545862,CSE 100,A01,083372,Cao; Yingjun,0,22,40,40
1649915551885,CSE 101,A01,084011,Staff,0,46,40,40
1649915557909,CSE 141,A01,083374,Eldon; John,0,49,75,75
1649915563932,CSE 141L,A01,083376,Eldon; John,0,54,75,75
1649915569954,CSE 175,A01,084013,Kumar; Rakesh,22,0,25,3
1649915575980,CSE 190,A00,092508,Dubnov; Shlomo,15,0,15,0
1649915582004,ECE 5,A01,084049,Morris; Karcher William,15,0,20,5
1649915588039,ECE 100,A01,084051,Baghdadchi; Saharnaz,1,0,20,19
1649915588039,ECE 100,A02,091916,Baghdadchi; Saharnaz,16,0,20,4
1649915594063,ECE 101,A01,084053,Baghdadchi; Saharnaz,5,0,37,32
1649915594063,ECE 101,A02,084054,Baghdadchi; Saharnaz,33,0,37,4
1649915600090,ECE 107,A01,083390,Staff,29,0,40,11
1649915606117,ECE 148,A01,084056,Silberman; Jack,7,0,12,5
1649915612144,ECE 180,A00,083391,Abi Samra; Nicholas Camill,25,0,30,5
1649915612144,ECE 180,B00,083392,Abi Samra; Nicholas Camill,22,0,30,8
1649915618170,MATH 10B,A01,084110,Staff,8,0,30,22
1649915618170,MATH 10B,A02,084111,Staff,29,0,30,1
1649915618170,MATH 10B,A03,084112,Staff,28,0,30,2
1649915624193,MATH 10C,A01,083443,Staff,9,0,30,21
1649915624193,MATH 10C,A02,083444,Staff,17,0,30,13
1649915624193,MATH 10C,B01,084114,Staff,25,0,30,5
1649915624193,MATH 10C,B02,084115,Staff,29,0,30,1
1649915630221,MATH 18,A01,084117,Harel; Guershon,27,0,30,3
1649915630221,MATH 18,A02,084119,Harel; Guershon,29,0,30,1
1649915630221,MATH 18,A03,084120,Harel; Guershon,30,0,30,0
1649915630221,MATH 18,A04,084121,Harel; Guershon,29,0,30,1
1649915636244,MATH 20B,A01,084124,Um; Ko Woon,31,0,35,4
1649915636244,MATH 20B,B01,084126,Um; Ko Woon,32,0,35,3
1649915642273,MATH 20C,A01,083446,Hammock; Frances H,17,0,30,13
1649915642273,MATH 20C,A02,083447,Hammock; Frances H,28,0,30,2
1649915642273,MATH 20C,A03,083448,Hammock; Frances H,30,0,30,0
1649915642273,MATH 20C,A04,083449,Hammock; Frances H,30,0,30,0
1649915642273,MATH 20C,B01,083451,Hammock; Frances H,25,0,30,5
1649915642273,MATH 20C,B02,083452,Hammock; Frances H,27,0,30,3
1649915642273,MATH 20C,B03,083453,Hammock; Frances H,26,0,30,4
1649915642273,MATH 20C,B04,083454,Hammock; Frances H,30,0,30,0
1649915648297,MATH 20D,A01,084128,Staff,26,0,30,4
1649915648297,MATH 20D,A02,084129,Staff,30,0,30,0
1649915648297,MATH 20D,A03,084130,Staff,29,0,30,1
1649915648297,MATH 20D,B01,084133,Staff,22,0,30,8
1649915648297,MATH 20D,B02,084134,Staff,27,0,30,3
1649915648297,MATH 20D,B03,084135,Staff,30,0,30,0
1649915654323,MATH 20E,A01,084138,Staff,23,0,30,7
1649915654323,MATH 20E,A02,084139,Staff,22,0,30,8
1649915654323,MATH 20E,A03,084140,Staff,23,0,30,7
1649915654323,MATH 20E,A04,084141,Staff,26,0,30,4
1649915660346,MATH 102,A01,084143,Harel; Guershon,18,0,30,12
1649915660346,MATH 102,A02,084144,Harel; Guershon,22,0,30,8
1649915666378,MATH 103B,A01,083456,Staff,0,8,30,30
1649915666378,MATH 103B,A02,083457,Staff,0,9,30,30
1649915672402,MATH 109,A01,084146,Salehi Golsefidy; Alireza,29,0,30,1
1649915672402,MATH 109,A02,084147,Salehi Golsefidy; Alireza,22,0,30,8
1649915678425,MATH 120A,A01,085445,Eggers; John Dietrich,20,0,35,15
1649915678425,MATH 120A,A02,085446,Eggers; John Dietrich,28,0,35,7
1649915684447,MATH 142B,A01,084149,Verstraete; Jacques Allan,0,10,30,30
1649915684447,MATH 142B,A02,084150,Verstraete; Jacques Allan,0,8,30,30
1649915690472,MATH 170A,A01,083459,Nie; Jiawang,0,2,30,30
1649915690472,MATH 170A,A02,083460,Nie; Jiawang,0,0,30,30
1649915690472,MATH 170A,A03,083461,Nie; Jiawang,11,0,30,19
1649915696499,MATH 193B,A01,083463,Staff,3,0,30,27
1649915696499,MATH 193B,A02,083464,Staff,11,0,30,19
1649915696499,MATH 193B,A03,083465,Staff,20,0,30,10
1649915702561,COGS 2,A01,083966,Boyle; Mary E. T.,18,0,30,12
1649915708583,COGS 9,A01,083968,Staff,43,0,60,17
1649915714609,COGS 14B,A01,083970,Staff,29,0,50,21
1649915720636,COGS 17,A01,092679,Staff,67,0,75,8
1649915726663,COGS 100,A01,083972,Staff,14,0,60,46
1649915738713,COGS 101C,A01,083976,Staff,19,0,30,11
1649915744736,COGS 102A,A01,083978,Johnson; Christine M.,17,0,30,13
1649915750762,COGS 107B,A01,083980,Staff,5,0,50,45
1649915756799,COGS 115,A01,083982,Staff,15,0,30,15
1649915762822,COGS 118B,A01,083367,Staff,0,11,40,40
1649915768845,COGS 172,A01,083984,Provenzano; Emily Kara,17,0,30,13
1649915774867,COGS 177,A00,083368,Staff,0,17,30,30
1649915780890,COGS 186,A01,083986,Staff,22,0,40,18
1649915786913,COGS 187A,A01,083988,Boyle; Mary E. T.,24,0,60,36
1649915792937,CSE 8A,A50,084003,Miranda; Gregory Joseph,0,0,15,15
1649915798960,CSE 11,A01,084005,Miranda; Gregory Joseph,23,0,55,32
1649915804986,CSE 20,A01,084007,Staff,10,0,20,10
1649915811009,CSE 21,A01,084009,Staff,12,0,50,38
1649915817032,CSE 30,A01,083370,Cao; Yingjun,0,19,40,40
1649915823054,CSE 100,A01,083372,Cao; Yingjun,0,22,40,40
1649915829078,CSE 101,A01,084011,Staff,0,46,40,40
1649915835101,CSE 141,A01,083374,Eldon; John,0,49,75,75
1649915841127,CSE 141L,A01,083376,Eldon; John,0,54,75,75
1649915847149,CSE 175,A01,084013,Kumar; Rakesh,22,0,25,3
1649915853174,CSE 190,A00,092508,Dubnov; Shlomo,15,0,15,0
1649915859200,ECE 5,A01,084049,Morris; Karcher William,15,0,20,5
1649915865235,ECE 100,A01,084051,Baghdadchi; Saharnaz,1,0,20,19
1649915865235,ECE 100,A02,091916,Baghdadchi; Saharnaz,16,0,20,4
1649915871261,ECE 101,A01,084053,Baghdadchi; Saharnaz,5,0,37,32
1649915871261,ECE 101,A02,084054,Baghdadchi; Saharnaz,33,0,37,4
1649915877288,ECE 107,A01,083390,Staff,29,0,40,11
1649915883310,ECE 148,A01,084056,Silberman; Jack,7,0,12,5
1649915889335,ECE 180,A00,083391,Abi Samra; Nicholas Camill,25,0,30,5
1649915889335,ECE 180,B00,083392,Abi Samra; Nicholas Camill,22,0,30,8
1649915895361,MATH 10B,A01,084110,Staff,8,0,30,22
1649915895361,MATH 10B,A02,084111,Staff,29,0,30,1
1649915895361,MATH 10B,A03,084112,Staff,28,0,30,2
1649915901384,MATH 10C,A01,083443,Staff,9,0,30,21
1649915901384,MATH 10C,A02,083444,Staff,17,0,30,13
1649915901384,MATH 10C,B01,084114,Staff,25,0,30,5
1649915901384,MATH 10C,B02,084115,Staff,29,0,30,1
1649915907406,MATH 18,A01,084117,Harel; Guershon,27,0,30,3
1649915907406,MATH 18,A02,084119,Harel; Guershon,29,0,30,1
1649915907406,MATH 18,A03,084120,Harel; Guershon,30,0,30,0
1649915907406,MATH 18,A04,084121,Harel; Guershon,29,0,30,1
1649915913435,MATH 20B,A01,084124,Um; Ko Woon,31,0,35,4
1649915913435,MATH 20B,B01,084126,Um; Ko Woon,32,0,35,3
1649915919465,MATH 20C,A01,083446,Hammock; Frances H,17,0,30,13
1649915919465,MATH 20C,A02,083447,Hammock; Frances H,28,0,30,2
1649915919465,MATH 20C,A03,083448,Hammock; Frances H,30,0,30,0
1649915919465,MATH 20C,A04,083449,Hammock; Frances H,30,0,30,0
1649915919465,MATH 20C,B01,083451,Hammock; Frances H,25,0,30,5
1649915919465,MATH 20C,B02,083452,Hammock; Frances H,27,0,30,3
1649915919465,MATH 20C,B03,083453,Hammock; Frances H,26,0,30,4
1649915919465,MATH 20C,B04,083454,Hammock; Frances H,30,0,30,0
1649915925493,MATH 20D,A01,084128,Staff,26,0,30,4
1649915925493,MATH 20D,A02,084129,Staff,30,0,30,0
1649915925493,MATH 20D,A03,084130,Staff,29,0,30,1
1649915925493,MATH 20D,B01,084133,Staff,22,0,30,8
1649915925493,MATH 20D,B02,084134,Staff,27,0,30,3
1649915925493,MATH 20D,B03,084135,Staff,30,0,30,0
1649915931527,MATH 20E,A01,084138,Staff,23,0,30,7
1649915931527,MATH 20E,A02,084139,Staff,22,0,30,8
1649915931527,MATH 20E,A03,084140,Staff,23,0,30,7
1649915931527,MATH 20E,A04,084141,Staff,26,0,30,4
1649915937558,MATH 102,A01,084143,Harel; Guershon,18,0,30,12
1649915937558,MATH 102,A02,084144,Harel; Guershon,22,0,30,8
1649915943586,MATH 103B,A01,083456,Staff,0,8,30,30
1649915943586,MATH 103B,A02,083457,Staff,0,9,30,30
1649915949613,MATH 109,A01,084146,Salehi Golsefidy; Alireza,29,0,30,1
1649915949613,MATH 109,A02,084147,Salehi Golsefidy; Alireza,22,0,30,8
1649915955642,MATH 120A,A01,085445,Eggers; John Dietrich,20,0,35,15
1649915955642,MATH 120A,A02,085446,Eggers; John Dietrich,28,0,35,7
1649915961664,MATH 142B,A01,084149,Verstraete; Jacques Allan,0,10,30,30
1649915961664,MATH 142B,A02,084150,Verstraete; Jacques Allan,0,8,30,30
1649915967702,MATH 170A,A01,083459,Nie; Jiawang,0,2,30,30
1649915967702,MATH 170A,A02,083460,Nie; Jiawang,0,0,30,30
1649915967702,MATH 170A,A03,083461,Nie; Jiawang,11,0,30,19
1649915973729,MATH 193B,A01,083463,Staff,3,0,30,27
1649915973729,MATH 193B,A02,083464,Staff,11,0,30,19
1649915973729,MATH 193B,A03,083465,Staff,20,0,30,10
1649915979789,COGS 2,A01,083966,Boyle; Mary E. T.,18,0,30,12
1649915985811,COGS 9,A01,083968,Staff,43,0,60,17
1649915991865,COGS 14B,A01,083970,Staff,29,0,50,21
1649915997891,COGS 17,A01,092679,Staff,67,0,75,8
1649916003917,COGS 100,A01,083972,Staff,14,0,60,46
1649916015967,COGS 101C,A01,083976,Staff,19,0,30,11
1649916021996,COGS 102A,A01,083978,Johnson; Christine M.,17,0,30,13
1649916028019,COGS 107B,A01,083980,Staff,5,0,50,45
1649916044694,COGS 115,A01,083982,Staff,15,0,30,15
1649916050717,COGS 118B,A01,083367,Staff,0,11,40,40
1649916056742,COGS 172,A01,083984,Provenzano; Emily Kara,17,0,30,13
1649916062772,COGS 177,A00,083368,Staff,0,17,30,30
1649916068796,COGS 186,A01,083986,Staff,22,0,40,18
1649916074820,COGS 187A,A01,083988,Boyle; Mary E. T.,24,0,60,36
1649916080936,CSE 8A,A50,084003,Miranda; Gregory Joseph,0,0,15,15
1649916086968,CSE 11,A01,084005,Miranda; Gregory Joseph,23,0,55,32
1649916092991,CSE 20,A01,084007,Staff,10,0,20,10
1649916099024,CSE 21,A01,084009,Staff,11,0,50,39
1649916105048,CSE 30,A01,083370,Cao; Yingjun,0,19,40,40
1649916111081,CSE 100,A01,083372,Cao; Yingjun,0,22,40,40
1649916117109,CSE 101,A01,084011,Staff,0,46,40,40
1649916123135,CSE 141,A01,083374,Eldon; John,0,49,75,75
1649916129164,CSE 141L,A01,083376,Eldon; John,0,54,75,75
1649916135188,CSE 175,A01,084013,Kumar; Rakesh,22,0,25,3
1649916141213,CSE 190,A00,092508,Dubnov; Shlomo,15,0,15,0
1649916147241,ECE 5,A01,084049,Morris; Karcher William,15,0,20,5
1649916153265,ECE 100,A01,084051,Baghdadchi; Saharnaz,1,0,20,19
1649916153265,ECE 100,A02,091916,Baghdadchi; Saharnaz,16,0,20,4
1649916159286,ECE 101,A01,084053,Baghdadchi; Saharnaz,5,0,37,32
1649916159286,ECE 101,A02,084054,Baghdadchi; Saharnaz,33,0,37,4
1649916165313,ECE 107,A01,083390,Staff,29,0,40,11
1649916171338,ECE 148,A01,084056,Silberman; Jack,7,0,12,5
1649916177360,ECE 180,A00,083391,Abi Samra; Nicholas Camill,25,0,30,5
1649916177360,ECE 180,B00,083392,Abi Samra; Nicholas Camill,22,0,30,8
1649916183388,MATH 10B,A01,084110,Staff,8,0,30,22
1649916183388,MATH 10B,A02,084111,Staff,29,0,30,1
1649916183388,MATH 10B,A03,084112,Staff,28,0,30,2
1649916189414,MATH 10C,A01,083443,Staff,9,0,30,21
1649916189414,MATH 10C,A02,083444,Staff,17,0,30,13
1649916189414,MATH 10C,B01,084114,Staff,25,0,30,5
1649916189414,MATH 10C,B02,084115,Staff,29,0,30,1
1649916195438,MATH 18,A01,084117,Harel; Guershon,27,0,30,3
1649916195438,MATH 18,A02,084119,Harel; Guershon,29,0,30,1
1649916195438,MATH 18,A03,084120,Harel; Guershon,30,0,30,0
1649916195438,MATH 18,A04,084121,Harel; Guershon,29,0,30,1
1649916201468,MATH 20B,A01,084124,Um; Ko Woon,31,0,35,4
1649916201468,MATH 20B,B01,084126,Um; Ko Woon,32,0,35,3
1649916207494,MATH 20C,A01,083446,Hammock; Frances H,17,0,30,13
1649916207494,MATH 20C,A02,083447,Hammock; Frances H,28,0,30,2
1649916207494,MATH 20C,A03,083448,Hammock; Frances H,30,0,30,0
1649916207494,MATH 20C,A04,083449,Hammock; Frances H,30,0,30,0
1649916207494,MATH 20C,B01,083451,Hammock; Frances H,25,0,30,5
1649916207494,MATH 20C,B02,083452,Hammock; Frances H,27,0,30,3
1649916207494,MATH 20C,B03,083453,Hammock; Frances H,26,0,30,4
1649916207494,MATH 20C,B04,083454,Hammock; Frances H,30,0,30,0
1649916213522,MATH 20D,A01,084128,Staff,26,0,30,4
1649916213522,MATH 20D,A02,084129,Staff,30,0,30,0
1649916213522,MATH 20D,A03,084130,Staff,29,0,30,1
1649916213522,MATH 20D,B01,084133,Staff,22,0,30,8
1649916213522,MATH 20D,B02,084134,Staff,27,0,30,3
1649916213522,MATH 20D,B03,084135,Staff,30,0,30,0
1649916219551,MATH 20E,A01,084138,Staff,23,0,30,7
1649916219551,MATH 20E,A02,084139,Staff,22,0,30,8
1649916219551,MATH 20E,A03,084140,Staff,23,0,30,7
1649916219551,MATH 20E,A04,084141,Staff,26,0,30,4
1649916225576,MATH 102,A01,084143,Harel; Guershon,18,0,30,12
1649916225576,MATH 102,A02,084144,Harel; Guershon,22,0,30,8
1649916231614,MATH 103B,A01,083456,Staff,0,8,30,30
1649916231614,MATH 103B,A02,083457,Staff,0,9,30,30
1649916237641,MATH 109,A01,084146,Salehi Golsefidy; Alireza,29,0,30,1
1649916237641,MATH 109,A02,084147,Salehi Golsefidy; Alireza,22,0,30,8
1649916243672,MATH 120A,A01,085445,Eggers; John Dietrich,20,0,35,15
1649916243672,MATH 120A,A02,085446,Eggers; John Dietrich,28,0,35,7
1649916249698,MATH 142B,A01,084149,Verstraete; Jacques Allan,0,10,30,30
1649916249698,MATH 142B,A02,084150,Verstraete; Jacques Allan,0,8,30,30
1649916255727,MATH 170A,A01,083459,Nie; Jiawang,0,2,30,30
1649916255727,MATH 170A,A02,083460,Nie; Jiawang,0,0,30,30
1649916255727,MATH 170A,A03,083461,Nie; Jiawang,11,0,30,19
1649916261757,MATH 193B,A01,083463,Staff,3,0,30,27
1649916261757,MATH 193B,A02,083464,Staff,10,0,30,20
1649916261757,MATH 193B,A03,083465,Staff,19,0,30,11
1649916267809,COGS 2,A01,083966,Boyle; Mary E. T.,18,0,30,12
1649916273833,COGS 9,A01,083968,Staff,43,0,60,17
1649916279857,COGS 14B,A01,083970,Staff,29,0,50,21
1649916285879,COGS 17,A01,092679,Staff,67,0,75,8
1649916291912,COGS 100,A01,083972,Staff,14,0,60,46
1649916303970,COGS 101C,A01,083976,Staff,19,0,30,11
1649916310005,COGS 102A,A01,083978,Johnson; Christine M.,17,0,30,13
1649916316030,COGS 107B,A01,083980,Staff,5,0,50,45
1649916322056,COGS 115,A01,083982,Staff,15,0,30,15
1649916328085,COGS 118B,A01,083367,Staff,0,11,40,40
1649916334112,COGS 172,A01,083984,Provenzano; Emily Kara,17,0,30,13
1649916340140,COGS 177,A00,083368,Staff,0,17,30,30
1649916346163,COGS 186,A01,083986,Staff,22,0,40,18
1649916352189,COGS 187A,A01,083988,Boyle; Mary E. T.,24,0,60,36
1649916358212,CSE 8A,A50,084003,Miranda; Gregory Joseph,0,0,15,15
1649916364236,CSE 11,A01,084005,Miranda; Gregory Joseph,23,0,55,32
1649916370259,CSE 20,A01,084007,Staff,10,0,20,10
1649916376284,CSE 21,A01,084009,Staff,11,0,50,39
1649916382312,CSE 30,A01,083370,Cao; Yingjun,0,19,40,40
1649916388335,CSE 100,A01,083372,Cao; Yingjun,0,22,40,40
1649916394359,CSE 101,A01,084011,Staff,0,46,40,40
1649916400387,CSE 141,A01,083374,Eldon; John,0,49,75,75
1649916406411,CSE 141L,A01,083376,Eldon; John,0,54,75,75
1649916412434,CSE 175,A01,084013,Kumar; Rakesh,22,0,25,3
1649916418460,CSE 190,A00,092508,Dubnov; Shlomo,15,0,15,0
1649916424486,ECE 5,A01,084049,Morris; Karcher William,15,0,20,5
1649916430509,ECE 100,A01,084051,Baghdadchi; Saharnaz,1,0,20,19
1649916430509,ECE 100,A02,091916,Baghdadchi; Saharnaz,16,0,20,4
1649916436549,ECE 101,A01,084053,Baghdadchi; Saharnaz,5,0,37,32
1649916436549,ECE 101,A02,084054,Baghdadchi; Saharnaz,33,0,37,4
1649916442573,ECE 107,A01,083390,Staff,29,0,40,11
1649916448606,ECE 148,A01,084056,Silberman; Jack,7,0,12,5
1649916454634,ECE 180,A00,083391,Abi Samra; Nicholas Camill,25,0,30,5
1649916454634,ECE 180,B00,083392,Abi Samra; Nicholas Camill,22,0,30,8
1649916460658,MATH 10B,A01,084110,Staff,8,0,30,22
1649916460658,MATH 10B,A02,084111,Staff,29,0,30,1
1649916460658,MATH 10B,A03,084112,Staff,28,0,30,2
1649916466685,MATH 10C,A01,083443,Staff,9,0,30,21
1649916466685,MATH 10C,A02,083444,Staff,17,0,30,13
1649916466685,MATH 10C,B01,084114,Staff,25,0,30,5
1649916466685,MATH 10C,B02,084115,Staff,29,0,30,1
1649916472712,MATH 18,A01,084117,Harel; Guershon,27,0,30,3
1649916472712,MATH 18,A02,084119,Harel; Guershon,29,0,30,1
1649916472712,MATH 18,A03,084120,Harel; Guershon,30,0,30,0
1649916472712,MATH 18,A04,084121,Harel; Guershon,29,0,30,1
1649916478735,MATH 20B,A01,084124,Um; Ko Woon,31,0,35,4
1649916478735,MATH 20B,B01,084126,Um; Ko Woon,32,0,35,3
1649916484763,MATH 20C,A01,083446,Hammock; Frances H,17,0,30,13
1649916484763,MATH 20C,A02,083447,Hammock; Frances H,28,0,30,2
1649916484763,MATH 20C,A03,083448,Hammock; Frances H,30,0,30,0
1649916484763,MATH 20C,A04,083449,Hammock; Frances H,30,0,30,0
1649916484763,MATH 20C,B01,083451,Hammock; Frances H,25,0,30,5
1649916484763,MATH 20C,B02,083452,Hammock; Frances H,27,0,30,3
1649916484763,MATH 20C,B03,083453,Hammock; Frances H,26,0,30,4
1649916484763,MATH 20C,B04,083454,Hammock; Frances H,30,0,30,0
1649916490788,MATH 20D,A01,084128,Staff,26,0,30,4
1649916490788,MATH 20D,A02,084129,Staff,30,0,30,0
1649916490788,MATH 20D,A03,084130,Staff,29,0,30,1
1649916490788,MATH 20D,B01,084133,Staff,22,0,30,8
1649916490788,MATH 20D,B02,084134,Staff,27,0,30,3
1649916490788,MATH 20D,B03,084135,Staff,30,0,30,0
1649916496847,MATH 20E,A01,084138,Staff,23,0,30,7
1649916496847,MATH 20E,A02,084139,Staff,22,0,30,8
1649916496847,MATH 20E,A03,084140,Staff,23,0,30,7
1649916496847,MATH 20E,A04,084141,Staff,26,0,30,4
1649916502874,MATH 102,A01,084143,Harel; Guershon,18,0,30,12
1649916502874,MATH 102,A02,084144,Harel; Guershon,22,0,30,8
1649916508902,MATH 103B,A01,083456,Staff,0,8,30,30
1649916508902,MATH 103B,A02,083457,Staff,0,9,30,30
1649916514930,MATH 109,A01,084146,Salehi Golsefidy; Alireza,29,0,30,1
1649916514930,MATH 109,A02,084147,Salehi Golsefidy; Alireza,22,0,30,8
1649916520955,MATH 120A,A01,085445,Eggers; John Dietrich,20,0,35,15
1649916520955,MATH 120A,A02,085446,Eggers; John Dietrich,28,0,35,7
1649916526982,MATH 142B,A01,084149,Verstraete; Jacques Allan,0,10,30,30
1649916526982,MATH 142B,A02,084150,Verstraete; Jacques Allan,0,8,30,30
1649916533004,MATH 170A,A01,083459,Nie; Jiawang,0,2,30,30
1649916533004,MATH 170A,A02,083460,Nie; Jiawang,0,0,30,30
1649916533004,MATH 170A,A03,083461,Nie; Jiawang,11,0,30,19
1649916539033,MATH 193B,A01,083463,Staff,3,0,30,27
1649916539033,MATH 193B,A02,083464,Staff,10,0,30,20
1649916539033,MATH 193B,A03,083465,Staff,19,0,30,11
1649916545091,COGS 2,A01,083966,Boyle; Mary E. T.,18,0,30,12
1649916551117,COGS 9,A01,083968,Staff,43,0,60,17
1649916557144,COGS 14B,A01,083970,Staff,29,0,50,21
1649916563170,COGS 17,A01,092679,Staff,67,0,75,8
1649916569198,COGS 100,A01,083972,Staff,14,0,60,46
1649916581252,COGS 101C,A01,083976,Staff,19,0,30,11
1649916587282,COGS 102A,A01,083978,Johnson; Christine M.,17,0,30,13
1649916593311,COGS 107B,A01,083980,Staff,5,0,50,45
1649916599335,COGS 115,A01,083982,Staff,15,0,30,15
1649916605361,COGS 118B,A01,083367,Staff,0,11,40,40
1649916611384,COGS 172,A01,083984,Provenzano; Emily Kara,17,0,30,13
1649916617418,COGS 177,A00,083368,Staff,0,17,30,30
1649916623439,COGS 186,A01,083986,Staff,22,0,40,18
1649916629463,COGS 187A,A01,083988,Boyle; Mary E. T.,24,0,60,36
1649916635489,CSE 8A,A50,084003,Miranda; Gregory Joseph,0,0,15,15
1649916641516,CSE 11,A01,084005,Miranda; Gregory Joseph,23,0,55,32
1649916647539,CSE 20,A01,084007,Staff,10,0,20,10
1649916653563,CSE 21,A01,084009,Staff,11,0,50,39
1649916659591,CSE 30,A01,083370,Cao; Yingjun,0,19,40,40
1649916665614,CSE 100,A01,083372,Cao; Yingjun,0,22,40,40
1649916671640,CSE 101,A01,084011,Staff,0,46,40,40
1649916677757,CSE 141,A01,083374,Eldon; John,0,49,75,75
1649916683781,CSE 141L,A01,083376,Eldon; John,0,54,75,75
1649916689804,CSE 175,A01,084013,Kumar; Rakesh,22,0,25,3
1649916695830,CSE 190,A00,092508,Dubnov; Shlomo,15,0,15,0
1649916701857,ECE 5,A01,084049,Morris; Karcher William,15,0,20,5
1649916707887,ECE 100,A01,084051,Baghdadchi; Saharnaz,1,0,20,19
1649916707887,ECE 100,A02,091916,Baghdadchi; Saharnaz,16,0,20,4
1649916713916,ECE 101,A01,084053,Baghdadchi; Saharnaz,5,0,37,32
1649916713916,ECE 101,A02,084054,Baghdadchi; Saharnaz,33,0,37,4
1649916719940,ECE 107,A01,083390,Staff,29,0,40,11
1649916725962,ECE 148,A01,084056,Silberman; Jack,7,0,12,5
1649916731984,ECE 180,A00,083391,Abi Samra; Nicholas Camill,25,0,30,5
1649916731984,ECE 180,B00,083392,Abi Samra; Nicholas Camill,22,0,30,8
1649916738008,MATH 10B,A01,084110,Staff,8,0,30,22
1649916738008,MATH 10B,A02,084111,Staff,29,0,30,1
1649916738008,MATH 10B,A03,084112,Staff,28,0,30,2
1649916744034,MATH 10C,A01,083443,Staff,9,0,30,21
1649916744034,MATH 10C,A02,083444,Staff,17,0,30,13
1649916744034,MATH 10C,B01,084114,Staff,25,0,30,5
1649916744034,MATH 10C,B02,084115,Staff,29,0,30,1
1649916750057,MATH 18,A01,084117,Harel; Guershon,27,0,30,3
1649916750057,MATH 18,A02,084119,Harel; Guershon,29,0,30,1
1649916750057,MATH 18,A03,084120,Harel; Guershon,30,0,30,0
1649916750057,MATH 18,A04,084121,Harel; Guershon,29,0,30,1
1649916756085,MATH 20B,A01,084124,Um; Ko Woon,31,0,35,4
1649916756085,MATH 20B,B01,084126,Um; Ko Woon,32,0,35,3
1649916762118,MATH 20C,A01,083446,Hammock; Frances H,17,0,30,13
1649916762118,MATH 20C,A02,083447,Hammock; Frances H,28,0,30,2
1649916762118,MATH 20C,A03,083448,Hammock; Frances H,30,0,30,0
1649916762118,MATH 20C,A04,083449,Hammock; Frances H,30,0,30,0
1649916762118,MATH 20C,B01,083451,Hammock; Frances H,25,0,30,5
1649916762118,MATH 20C,B02,083452,Hammock; Frances H,27,0,30,3
1649916762118,MATH 20C,B03,083453,Hammock; Frances H,26,0,30,4
1649916762118,MATH 20C,B04,083454,Hammock; Frances H,30,0,30,0
1649916768149,MATH 20D,A01,084128,Staff,26,0,30,4
1649916768149,MATH 20D,A02,084129,Staff,30,0,30,0
1649916768149,MATH 20D,A03,084130,Staff,29,0,30,1
1649916768149,MATH 20D,B01,084133,Staff,22,0,30,8
1649916768149,MATH 20D,B02,084134,Staff,27,0,30,3
1649916768149,MATH 20D,B03,084135,Staff,30,0,30,0
1649916774172,MATH 20E,A01,084138,Staff,23,0,30,7
1649916774172,MATH 20E,A02,084139,Staff,22,0,30,8
1649916774172,MATH 20E,A03,084140,Staff,23,0,30,7
1649916774172,MATH 20E,A04,084141,Staff,26,0,30,4
1649916780197,MATH 102,A01,084143,Harel; Guershon,17,0,30,13
1649916780197,MATH 102,A02,084144,Harel; Guershon,22,0,30,8
1649916786219,MATH 103B,A01,083456,Staff,0,8,30,30
1649916786219,MATH 103B,A02,083457,Staff,0,9,30,30
1649916792252,MATH 109,A01,084146,Salehi Golsefidy; Alireza,29,0,30,1
1649916792252,MATH 109,A02,084147,Salehi Golsefidy; Alireza,22,0,30,8
1649916798276,MATH 120A,A01,085445,Eggers; John Dietrich,20,0,35,15
1649916798276,MATH 120A,A02,085446,Eggers; John Dietrich,28,0,35,7
1649916804305,MATH 142B,A01,084149,Verstraete; Jacques Allan,0,10,30,30
1649916804305,MATH 142B,A02,084150,Verstraete; Jacques Allan,0,8,30,30
1649916810339,MATH 170A,A01,083459,Nie; Jiawang,0,2,30,30
1649916810339,MATH 170A,A02,083460,Nie; Jiawang,0,0,30,30
1649916810339,MATH 170A,A03,083461,Nie; Jiawang,10,0,30,20
1649916816365,MATH 193B,A01,083463,Staff,3,0,30,27
1649916816365,MATH 193B,A02,083464,Staff,10,0,30,20
1649916816365,MATH 193B,A03,083465,Staff,19,0,30,11
1649916822431,COGS 2,A01,083966,Boyle; Mary E. T.,18,0,30,12
1649916828455,COGS 9,A01,083968,Staff,43,0,60,17
1649916834483,COGS 14B,A01,083970,Staff,29,0,50,21
1649916840508,COGS 17,A01,092679,Staff,67,0,75,8
1649916846535,COGS 100,A01,083972,Staff,14,0,60,46
1649916858583,COGS 101C,A01,083976,Staff,19,0,30,11
1649916864607,COGS 102A,A01,083978,Johnson; Christine M.,17,0,30,13
1649916870630,COGS 107B,A01,083980,Staff,5,0,50,45
1649916876654,COGS 115,A01,083982,Staff,15,0,30,15
1649916882684,COGS 118B,A01,083367,Staff,0,11,40,40
1649916888717,COGS 172,A01,083984,Provenzano; Emily Kara,17,0,30,13
1649916894749,COGS 177,A00,083368,Staff,0,17,30,30
1649916900775,COGS 186,A01,083986,Staff,22,0,40,18
1649916906798,COGS 187A,A01,083988,Boyle; Mary E. T.,24,0,60,36
1649916912844,CSE 8A,A50,084003,Miranda; Gregory Joseph,0,0,15,15
1649916918871,CSE 11,A01,084005,Miranda; Gregory Joseph,23,0,55,32
1649916924899,CSE 20,A01,084007,Staff,10,0,20,10
1649916930922,CSE 21,A01,084009,Staff,11,0,50,39
1649916936945,CSE 30,A01,083370,Cao; Yingjun,0,19,40,40
1649916942971,CSE 100,A01,083372,Cao; Yingjun,0,22,40,40
1649916948995,CSE 101,A01,084011,Staff,0,46,40,40
1649916955034,CSE 141,A01,083374,Eldon; John,0,49,75,75
1649916961057,CSE 141L,A01,083376,Eldon; John,0,54,75,75
1649916967085,CSE 175,A01,084013,Kumar; Rakesh,22,0,25,3
1649916973108,CSE 190,A00,092508,Dubnov; Shlomo,15,0,15,0
1649916979132,ECE 5,A01,084049,Morris; Karcher William,15,0,20,5
1649916985156,ECE 100,A01,084051,Baghdadchi; Saharnaz,1,0,20,19
1649916985156,ECE 100,A02,091916,Baghdadchi; Saharnaz,16,0,20,4
1649916991183,ECE 101,A01,084053,Baghdadchi; Saharnaz,5,0,37,32
1649916991183,ECE 101,A02,084054,Baghdadchi; Saharnaz,33,0,37,4
1649916997215,ECE 107,A01,083390,Staff,29,0,40,11
1649917003240,ECE 148,A01,084056,Silberman; Jack,7,0,12,5
1649917009267,ECE 180,A00,083391,Abi Samra; Nicholas Camill,25,0,30,5
1649917009267,ECE 180,B00,083392,Abi Samra; Nicholas Camill,22,0,30,8
1649917015290,MATH 10B,A01,084110,Staff,8,0,30,22
1649917015290,MATH 10B,A02,084111,Staff,29,0,30,1
1649917015290,MATH 10B,A03,084112,Staff,28,0,30,2
1649917021319,MATH 10C,A01,083443,Staff,9,0,30,21
1649917021319,MATH 10C,A02,083444,Staff,17,0,30,13
1649917021319,MATH 10C,B01,084114,Staff,25,0,30,5
1649917021319,MATH 10C,B02,084115,Staff,29,0,30,1
1649917027342,MATH 18,A01,084117,Harel; Guershon,27,0,30,3
1649917027342,MATH 18,A02,084119,Harel; Guershon,29,0,30,1
1649917027342,MATH 18,A03,084120,Harel; Guershon,30,0,30,0
1649917027342,MATH 18,A04,084121,Harel; Guershon,29,0,30,1
1649917033369,MATH 20B,A01,084124,Um; Ko Woon,31,0,35,4
1649917033369,MATH 20B,B01,084126,Um; Ko Woon,32,0,35,3
1649917039399,MATH 20C,A01,083446,Hammock; Frances H,17,0,30,13
1649917039399,MATH 20C,A02,083447,Hammock; Frances H,28,0,30,2
1649917039399,MATH 20C,A03,083448,Hammock; Frances H,30,0,30,0
1649917039399,MATH 20C,A04,083449,Hammock; Frances H,30,0,30,0
1649917039399,MATH 20C,B01,083451,Hammock; Frances H,25,0,30,5
1649917039399,MATH 20C,B02,083452,Hammock; Frances H,27,0,30,3
1649917039399,MATH 20C,B03,083453,Hammock; Frances H,26,0,30,4
1649917039399,MATH 20C,B04,083454,Hammock; Frances H,30,0,30,0
1649917045429,MATH 20D,A01,084128,Staff,26,0,30,4
1649917045429,MATH 20D,A02,084129,Staff,30,0,30,0
1649917045429,MATH 20D,A03,084130,Staff,29,0,30,1
1649917045429,MATH 20D,B01,084133,Staff,22,0,30,8
1649917045429,MATH 20D,B02,084134,Staff,27,0,30,3
1649917045429,MATH 20D,B03,084135,Staff,30,0,30,0
1649917051455,MATH 20E,A01,084138,Staff,23,0,30,7
1649917051455,MATH 20E,A02,084139,Staff,22,0,30,8
1649917051455,MATH 20E,A03,084140,Staff,23,0,30,7
1649917051455,MATH 20E,A04,084141,Staff,25,0,30,5
1649917057481,MATH 102,A01,084143,Harel; Guershon,17,0,30,13
1649917057481,MATH 102,A02,084144,Harel; Guershon,22,0,30,8
1649917063506,MATH 103B,A01,083456,Staff,0,8,30,30
1649917063506,MATH 103B,A02,083457,Staff,0,9,30,30
1649917069530,MATH 109,A01,084146,Salehi Golsefidy; Alireza,29,0,30,1
1649917069530,MATH 109,A02,084147,Salehi Golsefidy; Alireza,22,0,30,8
1649917075555,MATH 120A,A01,085445,Eggers; John Dietrich,20,0,35,15
1649917075555,MATH 120A,A02,085446,Eggers; John Dietrich,28,0,35,7
1649917081578,MATH 142B,A01,084149,Verstraete; Jacques Allan,0,10,30,30
1649917081578,MATH 142B,A02,084150,Verstraete; Jacques Allan,0,8,30,30
1649917087602,MATH 170A,A01,083459,Nie; Jiawang,0,2,30,30
1649917087602,MATH 170A,A02,083460,Nie; Jiawang,0,0,30,30
1649917087602,MATH 170A,A03,083461,Nie; Jiawang,10,0,30,20
1649917093628,MATH 193B,A01,083463,Staff,3,0,30,27
1649917093628,MATH 193B,A02,083464,Staff,10,0,30,20
1649917093628,MATH 193B,A03,083465,Staff,19,0,30,11
1649917099697,COGS 2,A01,083966,Boyle; Mary E. T.,18,0,30,12
1649917105724,COGS 9,A01,083968,Staff,43,0,60,17
1649917111749,COGS 14B,A01,083970,Staff,29,0,50,21
1649917117787,COGS 17,A01,092679,Staff,67,0,75,8
1649917123816,COGS 100,A01,083972,Staff,14,0,60,46
1649917135869,COGS 101C,A01,083976,Staff,19,0,30,11
1649917141894,COGS 102A,A01,083978,Johnson; Christine M.,17,0,30,13
1649917147924,COGS 107B,A01,083980,Staff,5,0,50,45
1649917153951,COGS 115,A01,083982,Staff,15,0,30,15
1649917159974,COGS 118B,A01,083367,Staff,0,11,40,40
1649917165997,COGS 172,A01,083984,Provenzano; Emily Kara,17,0,30,13
1649917172022,COGS 177,A00,083368,Staff,0,17,30,30
1649917178045,COGS 186,A01,083986,Staff,22,0,40,18
1649917184069,COGS 187A,A01,083988,Boyle; Mary E. T.,24,0,60,36
1649917190100,CSE 8A,A50,084003,Miranda; Gregory Joseph,0,0,15,15
1649917196124,CSE 11,A01,084005,Miranda; Gregory Joseph,23,0,55,32
1649917202150,CSE 20,A01,084007,Staff,10,0,20,10
1649917208177,CSE 21,A01,084009,Staff,11,0,50,39
1649917214199,CSE 30,A01,083370,Cao; Yingjun,0,20,40,40
1649917220226,CSE 100,A01,083372,Cao; Yingjun,0,22,40,40
1649917226248,CSE 101,A01,084011,Staff,0,46,40,40
1649917232273,CSE 141,A01,083374,Eldon; John,0,49,75,75
1649917238296,CSE 141L,A01,083376,Eldon; John,0,54,75,75
1649917244318,CSE 175,A01,084013,Kumar; Rakesh,22,0,25,3
1649917250347,CSE 190,A00,092508,Dubnov; Shlomo,15,0,15,0
1649917256371,ECE 5,A01,084049,Morris; Karcher William,15,0,20,5
1649917262399,ECE 100,A01,084051,Baghdadchi; Saharnaz,1,0,20,19
1649917262399,ECE 100,A02,091916,Baghdadchi; Saharnaz,16,0,20,4
1649917268428,ECE 101,A01,084053,Baghdadchi; Saharnaz,5,0,37,32
1649917268428,ECE 101,A02,084054,Baghdadchi; Saharnaz,33,0,37,4
1649917274547,ECE 107,A01,083390,Staff,29,0,40,11
1649917280569,ECE 148,A01,084056,Silberman; Jack,7,0,12,5
1649917286596,ECE 180,A00,083391,Abi Samra; Nicholas Camill,25,0,30,5
1649917286596,ECE 180,B00,083392,Abi Samra; Nicholas Camill,22,0,30,8
1649917292620,MATH 10B,A01,084110,Staff,8,0,30,22
1649917292620,MATH 10B,A02,084111,Staff,29,0,30,1
1649917292620,MATH 10B,A03,084112,Staff,28,0,30,2
1649917298644,MATH 10C,A01,083443,Staff,9,0,30,21
1649917298644,MATH 10C,A02,083444,Staff,17,0,30,13
1649917298644,MATH 10C,B01,084114,Staff,25,0,30,5
1649917298644,MATH 10C,B02,084115,Staff,29,0,30,1
1649917304669,MATH 18,A01,084117,Harel; Guershon,27,0,30,3
1649917304669,MATH 18,A02,084119,Harel; Guershon,29,0,30,1
1649917304669,MATH 18,A03,084120,Harel; Guershon,30,0,30,0
1649917304669,MATH 18,A04,084121,Harel; Guershon,29,0,30,1
1649917310716,MATH 20B,A01,084124,Um; Ko Woon,31,0,35,4
1649917310716,MATH 20B,B01,084126,Um; Ko Woon,32,0,35,3
1649917316741,MATH 20C,A01,083446,Hammock; Frances H,17,0,30,13
1649917316741,MATH 20C,A02,083447,Hammock; Frances H,28,0,30,2
1649917316741,MATH 20C,A03,083448,Hammock; Frances H,30,0,30,0
1649917316741,MATH 20C,A04,083449,Hammock; Frances H,30,0,30,0
1649917316741,MATH 20C,B01,083451,Hammock; Frances H,25,0,30,5
1649917316741,MATH 20C,B02,083452,Hammock; Frances H,27,0,30,3
1649917316741,MATH 20C,B03,083453,Hammock; Frances H,26,0,30,4
1649917316741,MATH 20C,B04,083454,Hammock; Frances H,30,0,30,0
1649917322764,MATH 20D,A01,084128,Staff,26,0,30,4
1649917322764,MATH 20D,A02,084129,Staff,30,0,30,0
1649917322764,MATH 20D,A03,084130,Staff,29,0,30,1
1649917322764,MATH 20D,B01,084133,Staff,22,0,30,8
1649917322764,MATH 20D,B02,084134,Staff,27,0,30,3
1649917322764,MATH 20D,B03,084135,Staff,30,0,30,0
1649917328792,MATH 20E,A01,084138,Staff,23,0,30,7
1649917328792,MATH 20E,A02,084139,Staff,22,0,30,8
1649917328792,MATH 20E,A03,084140,Staff,23,0,30,7
1649917328792,MATH 20E,A04,084141,Staff,25,0,30,5
1649917334819,MATH 102,A01,084143,Harel; Guershon,17,0,30,13
1649917334819,MATH 102,A02,084144,Harel; Guershon,22,0,30,8
1649917340842,MATH 103B,A01,083456,Staff,0,8,30,30
1649917340842,MATH 103B,A02,083457,Staff,0,9,30,30
1649917346870,MATH 109,A01,084146,Salehi Golsefidy; Alireza,29,0,30,1
1649917346870,MATH 109,A02,084147,Salehi Golsefidy; Alireza,22,0,30,8
1649917352893,MATH 120A,A01,085445,Eggers; John Dietrich,20,0,35,15
1649917352893,MATH 120A,A02,085446,Eggers; John Dietrich,28,0,35,7
1649917358916,MATH 142B,A01,084149,Verstraete; Jacques Allan,0,10,30,30
1649917358916,MATH 142B,A02,084150,Verstraete; Jacques Allan,0,8,30,30
1649917364939,MATH 170A,A01,083459,Nie; Jiawang,0,2,30,30
1649917364939,MATH 170A,A02,083460,Nie; Jiawang,0,0,30,30
1649917364939,MATH 170A,A03,083461,Nie; Jiawang,10,0,30,20
1649917370967,MATH 193B,A01,083463,Staff,3,0,30,27
1649917370967,MATH 193B,A02,083464,Staff,10,0,30,20
1649917370967,MATH 193B,A03,083465,Staff,19,0,30,11
1649917377030,COGS 2,A01,083966,Boyle; Mary E. T.,18,0,30,12
1649917383053,COGS 9,A01,083968,Staff,43,0,60,17
1649917389076,COGS 14B,A01,083970,Staff,29,0,50,21
1649917395105,COGS 17,A01,092679,Staff,67,0,75,8
1649917401134,COGS 100,A01,083972,Staff,14,0,60,46
1649917413183,COGS 101C,A01,083976,Staff,19,0,30,11
1649917419205,COGS 102A,A01,083978,Johnson; Christine M.,17,0,30,13
1649917425231,COGS 107B,A01,083980,Staff,5,0,50,45
1649917431252,COGS 115,A01,083982,Staff,15,0,30,15
1649917437275,COGS 118B,A01,083367,Staff,0,11,40,40
1649917443299,COGS 172,A01,083984,Provenzano; Emily Kara,17,0,30,13
1649917449322,COGS 177,A00,083368,Staff,0,17,30,30
1649917455345,COGS 186,A01,083986,Staff,22,0,40,18
1649917461380,COGS 187A,A01,083988,Boyle; Mary E. T.,24,0,60,36
1649917467405,CSE 8A,A50,084003,Miranda; Gregory Joseph,0,0,15,15
1649917473430,CSE 11,A01,084005,Miranda; Gregory Joseph,23,0,55,32
1649917479456,CSE 20,A01,084007,Staff,10,0,20,10
1649917485481,CSE 21,A01,084009,Staff,11,0,50,39
1649917491524,CSE 30,A01,083370,Cao; Yingjun,0,20,40,40
1649917497555,CSE 100,A01,083372,Cao; Yingjun,0,22,40,40
1649917503598,CSE 101,A01,084011,Staff,0,46,40,40
1649917509625,CSE 141,A01,083374,Eldon; John,0,49,75,75
1649917515648,CSE 141L,A01,083376,Eldon; John,0,54,75,75
1649917521673,CSE 175,A01,084013,Kumar; Rakesh,22,0,25,3
1649917527698,CSE 190,A00,092508,Dubnov; Shlomo,15,0,15,0
1649917533724,ECE 5,A01,084049,Morris; Karcher William,15,0,20,5
1649917539760,ECE 100,A01,084051,Baghdadchi; Saharnaz,1,0,20,19
1649917539760,ECE 100,A02,091916,Baghdadchi; Saharnaz,16,0,20,4
1649917545788,ECE 101,A01,084053,Baghdadchi; Saharnaz,5,0,37,32
1649917545788,ECE 101,A02,084054,Baghdadchi; Saharnaz,33,0,37,4
1649917551816,ECE 107,A01,083390,Staff,29,0,40,11
1649917557840,ECE 148,A01,084056,Silberman; Jack,7,0,12,5
1649917563864,ECE 180,A00,083391,Abi Samra; Nicholas Camill,25,0,30,5
1649917563864,ECE 180,B00,083392,Abi Samra; Nicholas Camill,22,0,30,8
1649917569886,MATH 10B,A01,084110,Staff,8,0,30,22
1649917569886,MATH 10B,A02,084111,Staff,29,0,30,1
1649917569886,MATH 10B,A03,084112,Staff,28,0,30,2
1649917575913,MATH 10C,A01,083443,Staff,9,0,30,21
1649917575913,MATH 10C,A02,083444,Staff,17,0,30,13
1649917575913,MATH 10C,B01,084114,Staff,25,0,30,5
1649917575913,MATH 10C,B02,084115,Staff,29,0,30,1
1649917581936,MATH 18,A01,084117,Harel; Guershon,27,0,30,3
1649917581936,MATH 18,A02,084119,Harel; Guershon,29,0,30,1
1649917581936,MATH 18,A03,084120,Harel; Guershon,30,0,30,0
1649917581936,MATH 18,A04,084121,Harel; Guershon,29,0,30,1
1649917587961,MATH 20B,A01,084124,Um; Ko Woon,31,0,35,4
1649917587961,MATH 20B,B01,084126,Um; Ko Woon,32,0,35,3
1649917593990,MATH 20C,A01,083446,Hammock; Frances H,17,0,30,13
1649917593990,MATH 20C,A02,083447,Hammock; Frances H,28,0,30,2
1649917593990,MATH 20C,A03,083448,Hammock; Frances H,30,0,30,0
1649917593990,MATH 20C,A04,083449,Hammock; Frances H,30,0,30,0
1649917593990,MATH 20C,B01,083451,Hammock; Frances H,25,0,30,5
1649917593990,MATH 20C,B02,083452,Hammock; Frances H,27,0,30,3
1649917593990,MATH 20C,B03,083453,Hammock; Frances H,26,0,30,4
1649917593990,MATH 20C,B04,083454,Hammock; Frances H,30,0,30,0
1649917600015,MATH 20D,A01,084128,Staff,26,0,30,4
1649917600015,MATH 20D,A02,084129,Staff,30,0,30,0
1649917600015,MATH 20D,A03,084130,Staff,29,0,30,1
1649917600015,MATH 20D,B01,084133,Staff,22,0,30,8
1649917600015,MATH 20D,B02,084134,Staff,27,0,30,3
1649917600015,MATH 20D,B03,084135,Staff,30,0,30,0
1649917606041,MATH 20E,A01,084138,Staff,23,0,30,7
1649917606041,MATH 20E,A02,084139,Staff,22,0,30,8
1649917606041,MATH 20E,A03,084140,Staff,23,0,30,7
1649917606041,MATH 20E,A04,084141,Staff,25,0,30,5
1649917612065,MATH 102,A01,084143,Harel; Guershon,17,0,30,13
1649917612065,MATH 102,A02,084144,Harel; Guershon,22,0,30,8
1649917618092,MATH 103B,A01,083456,Staff,0,8,30,30
1649917618092,MATH 103B,A02,083457,Staff,0,9,30,30
1649917624116,MATH 109,A01,084146,Salehi Golsefidy; Alireza,29,0,30,1
1649917624116,MATH 109,A02,084147,Salehi Golsefidy; Alireza,22,0,30,8
1649917630139,MATH 120A,A01,085445,Eggers; John Dietrich,20,0,35,15
1649917630139,MATH 120A,A02,085446,Eggers; John Dietrich,28,0,35,7
1649917636168,MATH 142B,A01,084149,Verstraete; Jacques Allan,0,10,30,30
1649917636168,MATH 142B,A02,084150,Verstraete; Jacques Allan,0,8,30,30
1649917642195,MATH 170A,A01,083459,Nie; Jiawang,0,2,30,30
1649917642195,MATH 170A,A02,083460,Nie; Jiawang,0,0,30,30
1649917642195,MATH 170A,A03,083461,Nie; Jiawang,10,0,30,20
1649917648219,MATH 193B,A01,083463,Staff,3,0,30,27
1649917648219,MATH 193B,A02,083464,Staff,10,0,30,20
1649917648219,MATH 193B,A03,083465,Staff,19,0,30,11
1649917654270,COGS 2,A01,083966,Boyle; Mary E. T.,18,0,30,12
1649917660307,COGS 9,A01,083968,Staff,43,0,60,17
1649917666340,COGS 14B,A01,083970,Staff,29,0,50,21
1649917672365,COGS 17,A01,092679,Staff,67,0,75,8
1649917678393,COGS 100,A01,083972,Staff,14,0,60,46
1649917690445,COGS 101C,A01,083976,Staff,19,0,30,11
1649917696469,COGS 102A,A01,083978,Johnson; Christine M.,17,0,30,13
1649917702502,COGS 107B,A01,083980,Staff,5,0,50,45
1649917708530,COGS 115,A01,083982,Staff,15,0,30,15
1649917714553,COGS 118B,A01,083367,Staff,0,11,40,40
1649917720580,COGS 172,A01,083984,Provenzano; Emily Kara,17,0,30,13
1649917726604,COGS 177,A00,083368,Staff,0,17,30,30
1649917732628,COGS 186,A01,083986,Staff,22,0,40,18
1649917738657,COGS 187A,A01,083988,Boyle; Mary E. T.,24,0,60,36
1649917744684,CSE 8A,A50,084003,Miranda; Gregory Joseph,0,0,15,15
1649917750716,CSE 11,A01,084005,Miranda; Gregory Joseph,23,0,55,32
1649917756748,CSE 20,A01,084007,Staff,9,0,20,11
1649917762777,CSE 21,A01,084009,Staff,11,0,50,39
1649917768804,CSE 30,A01,083370,Cao; Yingjun,0,20,40,40
1649917774828,CSE 100,A01,083372,Cao; Yingjun,0,22,40,40
1649917780851,CSE 101,A01,084011,Staff,0,46,40,40
1649917786875,CSE 141,A01,083374,Eldon; John,0,49,75,75
1649917792897,CSE 141L,A01,083376,Eldon; John,0,54,75,75
1649917798919,CSE 175,A01,084013,Kumar; Rakesh,22,0,25,3
1649917804944,CSE 190,A00,092508,Dubnov; Shlomo,15,0,15,0
1649917810971,ECE 5,A01,084049,Morris; Karcher William,15,0,20,5
1649917816995,ECE 100,A01,084051,Baghdadchi; Saharnaz,1,0,20,19
1649917816995,ECE 100,A02,091916,Baghdadchi; Saharnaz,16,0,20,4
1649917823030,ECE 101,A01,084053,Baghdadchi; Saharnaz,5,0,37,32
1649917823030,ECE 101,A02,084054,Baghdadchi; Saharnaz,33,0,37,4
1649917829070,ECE 107,A01,083390,Staff,29,0,40,11
1649917835098,ECE 148,A01,084056,Silberman; Jack,7,0,12,5
1649917841124,ECE 180,A00,083391,Abi Samra; Nicholas Camill,25,0,30,5
1649917841124,ECE 180,B00,083392,Abi Samra; Nicholas Camill,22,0,30,8
1649917847153,MATH 10B,A01,084110,Staff,8,0,30,22
1649917847153,MATH 10B,A02,084111,Staff,29,0,30,1
1649917847153,MATH 10B,A03,084112,Staff,28,0,30,2
1649917853180,MATH 10C,A01,083443,Staff,9,0,30,21
1649917853180,MATH 10C,A02,083444,Staff,17,0,30,13
1649917853180,MATH 10C,B01,084114,Staff,25,0,30,5
1649917853180,MATH 10C,B02,084115,Staff,29,0,30,1
1649917859204,MATH 18,A01,084117,Harel; Guershon,27,0,30,3
1649917859204,MATH 18,A02,084119,Harel; Guershon,29,0,30,1
1649917859204,MATH 18,A03,084120,Harel; Guershon,30,0,30,0
1649917859204,MATH 18,A04,084121,Harel; Guershon,29,0,30,1
1649917865245,MATH 20B,A01,084124,Um; Ko Woon,31,0,35,4
1649917865245,MATH 20B,B01,084126,Um; Ko Woon,32,0,35,3
1649917871379,MATH 20C,A01,083446,Hammock; Frances H,17,0,30,13
1649917871379,MATH 20C,A02,083447,Hammock; Frances H,28,0,30,2
1649917871379,MATH 20C,A03,083448,Hammock; Frances H,30,0,30,0
1649917871379,MATH 20C,A04,083449,Hammock; Frances H,30,0,30,0
1649917871379,MATH 20C,B01,083451,Hammock; Frances H,25,0,30,5
1649917871379,MATH 20C,B02,083452,Hammock; Frances H,27,0,30,3
1649917871379,MATH 20C,B03,083453,Hammock; Frances H,26,0,30,4
1649917871379,MATH 20C,B04,083454,Hammock; Frances H,30,0,30,0
1649917877404,MATH 20D,A01,084128,Staff,26,0,30,4
1649917877404,MATH 20D,A02,084129,Staff,30,0,30,0
1649917877404,MATH 20D,A03,084130,Staff,29,0,30,1
1649917877404,MATH 20D,B01,084133,Staff,22,0,30,8
1649917877404,MATH 20D,B02,084134,Staff,27,0,30,3
1649917877404,MATH 20D,B03,084135,Staff,30,0,30,0
1649917883438,MATH 20E,A01,084138,Staff,23,0,30,7
1649917883438,MATH 20E,A02,084139,Staff,22,0,30,8
1649917883438,MATH 20E,A03,084140,Staff,23,0,30,7
1649917883438,MATH 20E,A04,084141,Staff,25,0,30,5
1649917889463,MATH 102,A01,084143,Harel; Guershon,17,0,30,13
1649917889463,MATH 102,A02,084144,Harel; Guershon,22,0,30,8
1649917895490,MATH 103B,A01,083456,Staff,0,8,30,30
1649917895490,MATH 103B,A02,083457,Staff,0,9,30,30
1649917901514,MATH 109,A01,084146,Salehi Golsefidy; Alireza,29,0,30,1
1649917901514,MATH 109,A02,084147,Salehi Golsefidy; Alireza,22,0,30,8
1649917907539,MATH 120A,A01,085445,Eggers; John Dietrich,20,0,35,15
1649917907539,MATH 120A,A02,085446,Eggers; John Dietrich,28,0,35,7
1649917913562,MATH 142B,A01,084149,Verstraete; Jacques Allan,0,10,30,30
1649917913562,MATH 142B,A02,084150,Verstraete; Jacques Allan,0,8,30,30
1649917919586,MATH 170A,A01,083459,Nie; Jiawang,0,2,30,30
1649917919586,MATH 170A,A02,083460,Nie; Jiawang,0,0,30,30
1649917919586,MATH 170A,A03,083461,Nie; Jiawang,10,0,30,20
1649917925609,MATH 193B,A01,083463,Staff,3,0,30,27
1649917925609,MATH 193B,A02,083464,Staff,10,0,30,20
1649917925609,MATH 193B,A03,083465,Staff,19,0,30,11
1649917931669,COGS 2,A01,083966,Boyle; Mary E. T.,18,0,30,12
1649917937693,COGS 9,A01,083968,Staff,43,0,60,17
1649917943731,COGS 14B,A01,083970,Staff,29,0,50,21
1649917949756,COGS 17,A01,092679,Staff,67,0,75,8
1649917955780,COGS 100,A01,083972,Staff,14,0,60,46
1649917967828,COGS 101C,A01,083976,Staff,19,0,30,11
1649917973853,COGS 102A,A01,083978,Johnson; Christine M.,17,0,30,13
1649917979876,COGS 107B,A01,083980,Staff,5,0,50,45
1649917985903,COGS 115,A01,083982,Staff,15,0,30,15
1649917991930,COGS 118B,A01,083367,Staff,0,11,40,40
1649917997954,COGS 172,A01,083984,Provenzano; Emily Kara,17,0,30,13
1649918003978,COGS 177,A00,083368,Staff,0,17,30,30
1649918010005,COGS 186,A01,083986,Staff,22,0,40,18
1649918016029,COGS 187A,A01,083988,Boyle; Mary E. T.,24,0,60,36
1649918022056,CSE 8A,A50,084003,Miranda; Gregory Joseph,0,0,15,15
1649918028082,CSE 11,A01,084005,Miranda; Gregory Joseph,23,0,55,32
1649918034107,CSE 20,A01,084007,Staff,9,0,20,11
1649918040131,CSE 21,A01,084009,Staff,11,0,50,39
1649918046169,CSE 30,A01,083370,Cao; Yingjun,0,20,40,40
1649918052192,CSE 100,A01,083372,Cao; Yingjun,0,22,40,40
1649918058215,CSE 101,A01,084011,Staff,0,46,40,40
1649918064249,CSE 141,A01,083374,Eldon; John,0,49,75,75
1649918070273,CSE 141L,A01,083376,Eldon; John,0,54,75,75
1649918076296,CSE 175,A01,084013,Kumar; Rakesh,22,0,25,3
1649918082321,CSE 190,A00,092508,Dubnov; Shlomo,15,0,15,0
1649918088346,ECE 5,A01,084049,Morris; Karcher William,15,0,20,5
1649918094373,ECE 100,A01,084051,Baghdadchi; Saharnaz,1,0,20,19
1649918094373,ECE 100,A02,091916,Baghdadchi; Saharnaz,16,0,20,4
1649918100400,ECE 101,A01,084053,Baghdadchi; Saharnaz,5,0,37,32
1649918100400,ECE 101,A02,084054,Baghdadchi; Saharnaz,33,0,37,4
1649918106433,ECE 107,A01,083390,Staff,29,0,40,11
1649918112460,ECE 148,A01,084056,Silberman; Jack,7,0,12,5
1649918118485,ECE 180,A00,083391,Abi Samra; Nicholas Camill,25,0,30,5
1649918118485,ECE 180,B00,083392,Abi Samra; Nicholas Camill,22,0,30,8
1649918124515,MATH 10B,A01,084110,Staff,8,0,30,22
1649918124515,MATH 10B,A02,084111,Staff,29,0,30,1
1649918124515,MATH 10B,A03,084112,Staff,28,0,30,2
1649918130551,MATH 10C,A01,083443,Staff,9,0,30,21
1649918130551,MATH 10C,A02,083444,Staff,17,0,30,13
1649918130551,MATH 10C,B01,084114,Staff,25,0,30,5
1649918130551,MATH 10C,B02,084115,Staff,29,0,30,1
1649918136580,MATH 18,A01,084117,Harel; Guershon,27,0,30,3
1649918136580,MATH 18,A02,084119,Harel; Guershon,29,0,30,1
1649918136580,MATH 18,A03,084120,Harel; Guershon,30,0,30,0
1649918136580,MATH 18,A04,084121,Harel; Guershon,29,0,30,1
1649918142615,MATH 20B,A01,084124,Um; Ko Woon,31,0,35,4
1649918142615,MATH 20B,B01,084126,Um; Ko Woon,32,0,35,3
1649918148719,MATH 20C,A01,083446,Hammock; Frances H,17,0,30,13
1649918148719,MATH 20C,A02,083447,Hammock; Frances H,28,0,30,2
1649918148719,MATH 20C,A03,083448,Hammock; Frances H,30,0,30,0
1649918148719,MATH 20C,A04,083449,Hammock; Frances H,30,0,30,0
1649918148719,MATH 20C,B01,083451,Hammock; Frances H,25,0,30,5
1649918148719,MATH 20C,B02,083452,Hammock; Frances H,27,0,30,3
1649918148719,MATH 20C,B03,083453,Hammock; Frances H,26,0,30,4
1649918148719,MATH 20C,B04,083454,Hammock; Frances H,30,0,30,0
1649918154742,MATH 20D,A01,084128,Staff,26,0,30,4
1649918154742,MATH 20D,A02,084129,Staff,30,0,30,0
1649918154742,MATH 20D,A03,084130,Staff,29,0,30,1
1649918154742,MATH 20D,B01,084133,Staff,22,0,30,8
1649918154742,MATH 20D,B02,084134,Staff,27,0,30,3
1649918154742,MATH 20D,B03,084135,Staff,30,0,30,0
1649918160766,MATH 20E,A01,084138,Staff,23,0,30,7
1649918160766,MATH 20E,A02,084139,Staff,22,0,30,8
1649918160766,MATH 20E,A03,084140,Staff,23,0,30,7
1649918160766,MATH 20E,A04,084141,Staff,24,0,30,6
1649918166797,MATH 102,A01,084143,Harel; Guershon,17,0,30,13
1649918166797,MATH 102,A02,084144,Harel; Guershon,22,0,30,8
1649918172827,MATH 103B,A01,083456,Staff,0,8,30,30
1649918172827,MATH 103B,A02,083457,Staff,0,9,30,30
1649918178850,MATH 109,A01,084146,Salehi Golsefidy; Alireza,29,0,30,1
1649918178850,MATH 109,A02,084147,Salehi Golsefidy; Alireza,22,0,30,8
1649918184892,MATH 120A,A01,085445,Eggers; John Dietrich,20,0,35,15
1649918184892,MATH 120A,A02,085446,Eggers; John Dietrich,28,0,35,7
1649918190925,MATH 142B,A01,084149,Verstraete; Jacques Allan,0,10,30,30
1649918190925,MATH 142B,A02,084150,Verstraete; Jacques Allan,0,9,30,30
1649918196952,MATH 170A,A01,083459,Nie; Jiawang,0,2,30,30
1649918196952,MATH 170A,A02,083460,Nie; Jiawang,0,0,30,30
1649918196952,MATH 170A,A03,083461,Nie; Jiawang,10,0,30,20
1649918202976,MATH 193B,A01,083463,Staff,3,0,30,27
1649918202976,MATH 193B,A02,083464,Staff,10,0,30,20
1649918202976,MATH 193B,A03,083465,Staff,19,0,30,11
1649918209023,COGS 2,A01,083966,Boyle; Mary E. T.,18,0,30,12
1649918215046,COGS 9,A01,083968,Staff,43,0,60,17
1649918221077,COGS 14B,A01,083970,Staff,29,0,50,21
1649918227101,COGS 17,A01,092679,Staff,67,0,75,8
1649918233129,COGS 100,A01,083972,Staff,14,0,60,46
1649918245178,COGS 101C,A01,083976,Staff,19,0,30,11
1649918251205,COGS 102A,A01,083978,Johnson; Christine M.,17,0,30,13
1649918257232,COGS 107B,A01,083980,Staff,5,0,50,45
1649918263256,COGS 115,A01,083982,Staff,15,0,30,15
1649918269279,COGS 118B,A01,083367,Staff,0,11,40,40
1649918275304,COGS 172,A01,083984,Provenzano; Emily Kara,17,0,30,13
1649918281327,COGS 177,A00,083368,Staff,0,17,30,30
1649918287352,COGS 186,A01,083986,Staff,22,0,40,18
1649918293377,COGS 187A,A01,083988,Boyle; Mary E. T.,24,0,60,36
1649918299400,CSE 8A,A50,084003,Miranda; Gregory Joseph,0,0,15,15
1649918305424,CSE 11,A01,084005,Miranda; Gregory Joseph,23,0,55,32
1649918311448,CSE 20,A01,084007,Staff,9,0,20,11
1649918317481,CSE 21,A01,084009,Staff,11,0,50,39
1649918323507,CSE 30,A01,083370,Cao; Yingjun,0,20,40,40
1649918329541,CSE 100,A01,083372,Cao; Yingjun,0,23,40,40
1649918335570,CSE 101,A01,084011,Staff,0,46,40,40
1649918341598,CSE 141,A01,083374,Eldon; John,0,49,75,75
1649918347622,CSE 141L,A01,083376,Eldon; John,0,54,75,75
1649918353644,CSE 175,A01,084013,Kumar; Rakesh,22,0,25,3
1649918359677,CSE 190,A00,092508,Dubnov; Shlomo,15,0,15,0
1649918365705,ECE 5,A01,084049,Morris; Karcher William,15,0,20,5
1649918371733,ECE 100,A01,084051,Baghdadchi; Saharnaz,1,0,20,19
1649918371733,ECE 100,A02,091916,Baghdadchi; Saharnaz,16,0,20,4
1649918377762,ECE 101,A01,084053,Baghdadchi; Saharnaz,5,0,37,32
1649918377762,ECE 101,A02,084054,Baghdadchi; Saharnaz,33,0,37,4
1649918383789,ECE 107,A01,083390,Staff,29,0,40,11
1649918389823,ECE 148,A01,084056,Silberman; Jack,7,0,12,5
1649918395854,ECE 180,A00,083391,Abi Samra; Nicholas Camill,25,0,30,5
1649918395854,ECE 180,B00,083392,Abi Samra; Nicholas Camill,22,0,30,8
1649918401881,MATH 10B,A01,084110,Staff,8,0,30,22
1649918401881,MATH 10B,A02,084111,Staff,29,0,30,1
1649918401881,MATH 10B,A03,084112,Staff,28,0,30,2
1649918407911,MATH 10C,A01,083443,Staff,9,0,30,21
1649918407911,MATH 10C,A02,083444,Staff,17,0,30,13
1649918407911,MATH 10C,B01,084114,Staff,25,0,30,5
1649918407911,MATH 10C,B02,084115,Staff,29,0,30,1
1649918413938,MATH 18,A01,084117,Harel; Guershon,27,0,30,3
1649918413938,MATH 18,A02,084119,Harel; Guershon,29,0,30,1
1649918413938,MATH 18,A03,084120,Harel; Guershon,30,0,30,0
1649918413938,MATH 18,A04,084121,Harel; Guershon,29,0,30,1
1649918419974,MATH 20B,A01,084124,Um; Ko Woon,31,0,35,4
1649918419974,MATH 20B,B01,084126,Um; Ko Woon,32,0,35,3
1649918426016,MATH 20C,A01,083446,Hammock; Frances H,17,0,30,13
1649918426016,MATH 20C,A02,083447,Hammock; Frances H,28,0,30,2
1649918426016,MATH 20C,A03,083448,Hammock; Frances H,30,0,30,0
1649918426016,MATH 20C,A04,083449,Hammock; Frances H,30,0,30,0
1649918426016,MATH 20C,B01,083451,Hammock; Frances H,25,0,30,5
1649918426016,MATH 20C,B02,083452,Hammock; Frances H,27,0,30,3
1649918426016,MATH 20C,B03,083453,Hammock; Frances H,26,0,30,4
1649918426016,MATH 20C,B04,083454,Hammock; Frances H,30,0,30,0
1649918432048,MATH 20D,A01,084128,Staff,26,0,30,4
1649918432048,MATH 20D,A02,084129,Staff,30,0,30,0
1649918432048,MATH 20D,A03,084130,Staff,29,0,30,1
1649918432048,MATH 20D,B01,084133,Staff,22,0,30,8
1649918432048,MATH 20D,B02,084134,Staff,27,0,30,3
1649918432048,MATH 20D,B03,084135,Staff,30,0,30,0
1649918438078,MATH 20E,A01,084138,Staff,23,0,30,7
1649918438078,MATH 20E,A02,084139,Staff,22,0,30,8
1649918438078,MATH 20E,A03,084140,Staff,23,0,30,7
1649918438078,MATH 20E,A04,084141,Staff,24,0,30,6
1649918444105,MATH 102,A01,084143,Harel; Guershon,17,0,30,13
1649918444105,MATH 102,A02,084144,Harel; Guershon,22,0,30,8
1649918450144,MATH 103B,A01,083456,Staff,0,8,30,30
1649918450144,MATH 103B,A02,083457,Staff,0,9,30,30
1649918456172,MATH 109,A01,084146,Salehi Golsefidy; Alireza,29,0,30,1
1649918456172,MATH 109,A02,084147,Salehi Golsefidy; Alireza,22,0,30,8
1649918462202,MATH 120A,A01,085445,Eggers; John Dietrich,20,0,35,15
1649918462202,MATH 120A,A02,085446,Eggers; John Dietrich,28,0,35,7
1649918468320,MATH 142B,A01,084149,Verstraete; Jacques Allan,0,10,30,30
1649918468320,MATH 142B,A02,084150,Verstraete; Jacques Allan,0,9,30,30
1649918474349,MATH 170A,A01,083459,Nie; Jiawang,0,2,30,30
1649918474349,MATH 170A,A02,083460,Nie; Jiawang,0,0,30,30
1649918474349,MATH 170A,A03,083461,Nie; Jiawang,10,0,30,20
1649918480377,MATH 193B,A01,083463,Staff,3,0,30,27
1649918480377,MATH 193B,A02,083464,Staff,10,0,30,20
1649918480377,MATH 193B,A03,083465,Staff,19,0,30,11
1649918486441,COGS 2,A01,083966,Boyle; Mary E. T.,18,0,30,12
1649918492468,COGS 9,A01,083968,Staff,43,0,60,17
1649918498495,COGS 14B,A01,083970,Staff,29,0,50,21
1649918504521,COGS 17,A01,092679,Staff,67,0,75,8
1649918510557,COGS 100,A01,083972,Staff,13,0,60,47
1649918522605,COGS 101C,A01,083976,Staff,19,0,30,11
1649918528628,COGS 102A,A01,083978,Johnson; Christine M.,17,0,30,13
1649918534656,COGS 107B,A01,083980,Staff,4,0,50,46
1649918540682,COGS 115,A01,083982,Staff,15,0,30,15
1649918546706,COGS 118B,A01,083367,Staff,0,11,40,40
1649918552729,COGS 172,A01,083984,Provenzano; Emily Kara,17,0,30,13
1649918558755,COGS 177,A00,083368,Staff,0,17,30,30
1649918564781,COGS 186,A01,083986,Staff,22,0,40,18
1649918570805,COGS 187A,A01,083988,Boyle; Mary E. T.,24,0,60,36
1649918576828,CSE 8A,A50,084003,Miranda; Gregory Joseph,0,0,15,15
1649918582857,CSE 11,A01,084005,Miranda; Gregory Joseph,23,0,55,32
1649918588882,CSE 20,A01,084007,Staff,9,0,20,11
1649918594909,CSE 21,A01,084009,Staff,11,0,50,39
1649918600933,CSE 30,A01,083370,Cao; Yingjun,0,20,40,40
1649918606964,CSE 100,A01,083372,Cao; Yingjun,0,23,40,40
1649918612992,CSE 101,A01,084011,Staff,0,46,40,40
1649918619019,CSE 141,A01,083374,Eldon; John,0,49,75,75
1649918625056,CSE 141L,A01,083376,Eldon; John,0,54,75,75
1649918631083,CSE 175,A01,084013,Kumar; Rakesh,22,0,25,3
1649918637106,CSE 190,A00,092508,Dubnov; Shlomo,15,0,15,0
1649918643129,ECE 5,A01,084049,Morris; Karcher William,15,0,20,5
1649918649151,ECE 100,A01,084051,Baghdadchi; Saharnaz,1,0,20,19
1649918649151,ECE 100,A02,091916,Baghdadchi; Saharnaz,16,0,20,4
1649918655180,ECE 101,A01,084053,Baghdadchi; Saharnaz,5,0,37,32
1649918655180,ECE 101,A02,084054,Baghdadchi; Saharnaz,33,0,37,4
1649918661202,ECE 107,A01,083390,Staff,29,0,40,11
1649918667225,ECE 148,A01,084056,Silberman; Jack,7,0,12,5
1649918673251,ECE 180,A00,083391,Abi Samra; Nicholas Camill,25,0,30,5
1649918673251,ECE 180,B00,083392,Abi Samra; Nicholas Camill,22,0,30,8
1649918679273,MATH 10B,A01,084110,Staff,8,0,30,22
1649918679273,MATH 10B,A02,084111,Staff,29,0,30,1
1649918679273,MATH 10B,A03,084112,Staff,28,0,30,2
1649918685300,MATH 10C,A01,083443,Staff,9,0,30,21
1649918685300,MATH 10C,A02,083444,Staff,17,0,30,13
1649918685300,MATH 10C,B01,084114,Staff,25,0,30,5
1649918685300,MATH 10C,B02,084115,Staff,29,0,30,1
1649918691323,MATH 18,A01,084117,Harel; Guershon,27,0,30,3
1649918691323,MATH 18,A02,084119,Harel; Guershon,29,0,30,1
1649918691323,MATH 18,A03,084120,Harel; Guershon,30,0,30,0
1649918691323,MATH 18,A04,084121,Harel; Guershon,29,0,30,1
1649918697351,MATH 20B,A01,084124,Um; Ko Woon,31,0,35,4
1649918697351,MATH 20B,B01,084126,Um; Ko Woon,32,0,35,3
1649918703376,MATH 20C,A01,083446,Hammock; Frances H,17,0,30,13
1649918703376,MATH 20C,A02,083447,Hammock; Frances H,28,0,30,2
1649918703376,MATH 20C,A03,083448,Hammock; Frances H,30,0,30,0
1649918703376,MATH 20C,A04,083449,Hammock; Frances H,30,0,30,0
1649918703376,MATH 20C,B01,083451,Hammock; Frances H,25,0,30,5
1649918703376,MATH 20C,B02,083452,Hammock; Frances H,27,0,30,3
1649918703376,MATH 20C,B03,083453,Hammock; Frances H,26,0,30,4
1649918703376,MATH 20C,B04,083454,Hammock; Frances H,30,0,30,0
1649918709399,MATH 20D,A01,084128,Staff,26,0,30,4
1649918709399,MATH 20D,A02,084129,Staff,30,0,30,0
1649918709399,MATH 20D,A03,084130,Staff,29,0,30,1
1649918709399,MATH 20D,B01,084133,Staff,22,0,30,8
1649918709399,MATH 20D,B02,084134,Staff,27,0,30,3
1649918709399,MATH 20D,B03,084135,Staff,30,0,30,0
1649918715426,MATH 20E,A01,084138,Staff,23,0,30,7
1649918715426,MATH 20E,A02,084139,Staff,22,0,30,8
1649918715426,MATH 20E,A03,084140,Staff,23,0,30,7
1649918715426,MATH 20E,A04,084141,Staff,25,0,30,5
1649918721448,MATH 102,A01,084143,Harel; Guershon,17,0,30,13
1649918721448,MATH 102,A02,084144,Harel; Guershon,22,0,30,8
1649918727472,MATH 103B,A01,083456,Staff,0,8,30,30
1649918727472,MATH 103B,A02,083457,Staff,0,9,30,30
1649918733498,MATH 109,A01,084146,Salehi Golsefidy; Alireza,29,0,30,1
1649918733498,MATH 109,A02,084147,Salehi Golsefidy; Alireza,22,0,30,8
1649918739529,MATH 120A,A01,085445,Eggers; John Dietrich,20,0,35,15
1649918739529,MATH 120A,A02,085446,Eggers; John Dietrich,28,0,35,7
1649918745557,MATH 142B,A01,084149,Verstraete; Jacques Allan,0,10,30,30
1649918745557,MATH 142B,A02,084150,Verstraete; Jacques Allan,0,9,30,30
1649918751580,MATH 170A,A01,083459,Nie; Jiawang,0,2,30,30
1649918751580,MATH 170A,A02,083460,Nie; Jiawang,0,0,30,30
1649918751580,MATH 170A,A03,083461,Nie; Jiawang,9,0,30,21
1649918757607,MATH 193B,A01,083463,Staff,3,0,30,27
1649918757607,MATH 193B,A02,083464,Staff,10,0,30,20
1649918757607,MATH 193B,A03,083465,Staff,19,0,30,11
1649918763655,COGS 2,A01,083966,Boyle; Mary E. T.,18,0,30,12
1649918769757,COGS 9,A01,083968,Staff,43,0,60,17
1649918775780,COGS 14B,A01,083970,Staff,29,0,50,21
1649918781809,COGS 17,A01,092679,Staff,67,0,75,8
1649918787833,COGS 100,A01,083972,Staff,12,0,60,48
1649918799882,COGS 101C,A01,083976,Staff,19,0,30,11
1649918805905,COGS 102A,A01,083978,Johnson; Christine M.,17,0,30,13
1649918811927,COGS 107B,A01,083980,Staff,4,0,50,46
1649918817954,COGS 115,A01,083982,Staff,15,0,30,15
1649918823980,COGS 118B,A01,083367,Staff,0,11,40,40
1649918830008,COGS 172,A01,083984,Provenzano; Emily Kara,17,0,30,13
1649918836031,COGS 177,A00,083368,Staff,0,17,30,30
1649918842054,COGS 186,A01,083986,Staff,22,0,40,18
1649918848080,COGS 187A,A01,083988,Boyle; Mary E. T.,24,0,60,36
1649918854107,CSE 8A,A50,084003,Miranda; Gregory Joseph,0,0,15,15
1649918860130,CSE 11,A01,084005,Miranda; Gregory Joseph,23,0,55,32
1649918866155,CSE 20,A01,084007,Staff,9,0,20,11
1649918872188,CSE 21,A01,084009,Staff,11,0,50,39
1649918878211,CSE 30,A01,083370,Cao; Yingjun,0,20,40,40
1649918884235,CSE 100,A01,083372,Cao; Yingjun,0,23,40,40
1649918890259,CSE 101,A01,084011,Staff,0,46,40,40
1649918896281,CSE 141,A01,083374,Eldon; John,0,49,75,75
1649918902311,CSE 141L,A01,083376,Eldon; John,0,54,75,75
1649918908344,CSE 175,A01,084013,Kumar; Rakesh,22,0,25,3
1649918914371,CSE 190,A00,092508,Dubnov; Shlomo,15,0,15,0
1649918920398,ECE 5,A01,084049,Morris; Karcher William,15,0,20,5
1649918926421,ECE 100,A01,084051,Baghdadchi; Saharnaz,1,0,20,19
1649918926421,ECE 100,A02,091916,Baghdadchi; Saharnaz,16,0,20,4
1649918932445,ECE 101,A01,084053,Baghdadchi; Saharnaz,5,0,37,32
1649918932445,ECE 101,A02,084054,Baghdadchi; Saharnaz,33,0,37,4
1649918938468,ECE 107,A01,083390,Staff,29,0,40,11
1649918944491,ECE 148,A01,084056,Silberman; Jack,7,0,12,5
1649918950518,ECE 180,A00,083391,Abi Samra; Nicholas Camill,25,0,30,5
1649918950518,ECE 180,B00,083392,Abi Samra; Nicholas Camill,22,0,30,8
1649918956540,MATH 10B,A01,084110,Staff,8,0,30,22
1649918956540,MATH 10B,A02,084111,Staff,29,0,30,1
1649918956540,MATH 10B,A03,084112,Staff,28,0,30,2
1649918962567,MATH 10C,A01,083443,Staff,9,0,30,21
1649918962567,MATH 10C,A02,083444,Staff,17,0,30,13
1649918962567,MATH 10C,B01,084114,Staff,25,0,30,5
1649918962567,MATH 10C,B02,084115,Staff,29,0,30,1
1649918968612,MATH 18,A01,084117,Harel; Guershon,27,0,30,3
1649918968612,MATH 18,A02,084119,Harel; Guershon,29,0,30,1
1649918968612,MATH 18,A03,084120,Harel; Guershon,30,0,30,0
1649918968612,MATH 18,A04,084121,Harel; Guershon,29,0,30,1
1649918974645,MATH 20B,A01,084124,Um; Ko Woon,31,0,35,4
1649918974645,MATH 20B,B01,084126,Um; Ko Woon,32,0,35,3
1649918980678,MATH 20C,A01,083446,Hammock; Frances H,17,0,30,13
1649918980678,MATH 20C,A02,083447,Hammock; Frances H,28,0,30,2
1649918980678,MATH 20C,A03,083448,Hammock; Frances H,30,0,30,0
1649918980678,MATH 20C,A04,083449,Hammock; Frances H,30,0,30,0
1649918980678,MATH 20C,B01,083451,Hammock; Frances H,25,0,30,5
1649918980678,MATH 20C,B02,083452,Hammock; Frances H,27,0,30,3
1649918980678,MATH 20C,B03,083453,Hammock; Frances H,26,0,30,4
1649918980678,MATH 20C,B04,083454,Hammock; Frances H,30,0,30,0
1649918986712,MATH 20D,A01,084128,Staff,26,0,30,4
1649918986712,MATH 20D,A02,084129,Staff,30,0,30,0
1649918986712,MATH 20D,A03,084130,Staff,29,0,30,1
1649918986712,MATH 20D,B01,084133,Staff,22,0,30,8
1649918986712,MATH 20D,B02,084134,Staff,27,0,30,3
1649918986712,MATH 20D,B03,084135,Staff,30,0,30,0
1649918992736,MATH 20E,A01,084138,Staff,23,0,30,7
1649918992736,MATH 20E,A02,084139,Staff,22,0,30,8
1649918992736,MATH 20E,A03,084140,Staff,23,0,30,7
1649918992736,MATH 20E,A04,084141,Staff,25,0,30,5
1649918998763,MATH 102,A01,084143,Harel; Guershon,17,0,30,13
1649918998763,MATH 102,A02,084144,Harel; Guershon,22,0,30,8
1649919004790,MATH 103B,A01,083456,Staff,0,8,30,30
1649919004790,MATH 103B,A02,083457,Staff,0,9,30,30
1649919010811,MATH 109,A01,084146,Salehi Golsefidy; Alireza,29,0,30,1
1649919010811,MATH 109,A02,084147,Salehi Golsefidy; Alireza,22,0,30,8
1649919016836,MATH 120A,A01,085445,Eggers; John Dietrich,20,0,35,15
1649919016836,MATH 120A,A02,085446,Eggers; John Dietrich,28,0,35,7
1649919022862,MATH 142B,A01,084149,Verstraete; Jacques Allan,0,10,30,30
1649919022862,MATH 142B,A02,084150,Verstraete; Jacques Allan,0,9,30,30
1649919028890,MATH 170A,A01,083459,Nie; Jiawang,0,2,30,30
1649919028890,MATH 170A,A02,083460,Nie; Jiawang,0,0,30,30
1649919028890,MATH 170A,A03,083461,Nie; Jiawang,9,0,30,21
1649919034912,MATH 193B,A01,083463,Staff,3,0,30,27
1649919034912,MATH 193B,A02,083464,Staff,10,0,30,20
1649919034912,MATH 193B,A03,083465,Staff,19,0,30,11
1649919040972,COGS 2,A01,083966,Boyle; Mary E. T.,18,0,30,12
1649919046996,COGS 9,A01,083968,Staff,43,0,60,17
1649919053023,COGS 14B,A01,083970,Staff,29,0,50,21
1649919059138,COGS 17,A01,092679,Staff,67,0,75,8
1649919065165,COGS 100,A01,083972,Staff,12,0,60,48
1649919077229,COGS 101C,A01,083976,Staff,19,0,30,11
1649919083260,COGS 102A,A01,083978,Johnson; Christine M.,17,0,30,13
1649919089282,COGS 107B,A01,083980,Staff,4,0,50,46
1649919095305,COGS 115,A01,083982,Staff,15,0,30,15
1649919101335,COGS 118B,A01,083367,Staff,0,11,40,40
1649919107358,COGS 172,A01,083984,Provenzano; Emily Kara,17,0,30,13
1649919113385,COGS 177,A00,083368,Staff,0,17,30,30
1649919119409,COGS 186,A01,083986,Staff,22,0,40,18
1649919125441,COGS 187A,A01,083988,Boyle; Mary E. T.,24,0,60,36
1649919131462,CSE 8A,A50,084003,Miranda; Gregory Joseph,0,0,15,15
1649919137487,CSE 11,A01,084005,Miranda; Gregory Joseph,23,0,55,32
1649919143523,CSE 20,A01,084007,Staff,9,0,20,11
1649919149552,CSE 21,A01,084009,Staff,11,0,50,39
1649919155575,CSE 30,A01,083370,Cao; Yingjun,0,20,40,40
1649919161604,CSE 100,A01,083372,Cao; Yingjun,0,23,40,40
1649919167638,CSE 101,A01,084011,Staff,0,46,40,40
1649919173665,CSE 141,A01,083374,Eldon; John,0,49,75,75
1649919179695,CSE 141L,A01,083376,Eldon; John,0,54,75,75
1649919185727,CSE 175,A01,084013,Kumar; Rakesh,22,0,25,3
1649919191753,CSE 190,A00,092508,Dubnov; Shlomo,15,0,15,0
1649919197777,ECE 5,A01,084049,Morris; Karcher William,15,0,20,5
1649919203807,ECE 100,A01,084051,Baghdadchi; Saharnaz,1,0,20,19
1649919203807,ECE 100,A02,091916,Baghdadchi; Saharnaz,16,0,20,4
1649919209832,ECE 101,A01,084053,Baghdadchi; Saharnaz,5,0,37,32
1649919209832,ECE 101,A02,084054,Baghdadchi; Saharnaz,33,0,37,4
1649919215856,ECE 107,A01,083390,Staff,29,0,40,11
1649919221882,ECE 148,A01,084056,Silberman; Jack,7,0,12,5
1649919227904,ECE 180,A00,083391,Abi Samra; Nicholas Camill,25,0,30,5
1649919227904,ECE 180,B00,083392,Abi Samra; Nicholas Camill,22,0,30,8
1649919233929,MATH 10B,A01,084110,Staff,8,0,30,22
1649919233929,MATH 10B,A02,084111,Staff,29,0,30,1
1649919233929,MATH 10B,A03,084112,Staff,28,0,30,2
1649919239952,MATH 10C,A01,083443,Staff,9,0,30,21
1649919239952,MATH 10C,A02,083444,Staff,17,0,30,13
1649919239952,MATH 10C,B01,084114,Staff,25,0,30,5
1649919239952,MATH 10C,B02,084115,Staff,29,0,30,1
1649919245977,MATH 18,A01,084117,Harel; Guershon,27,0,30,3
1649919245977,MATH 18,A02,084119,Harel; Guershon,29,0,30,1
1649919245977,MATH 18,A03,084120,Harel; Guershon,30,0,30,0
1649919245977,MATH 18,A04,084121,Harel; Guershon,29,0,30,1
1649919252000,MATH 20B,A01,084124,Um; Ko Woon,31,0,35,4
1649919252000,MATH 20B,B01,084126,Um; Ko Woon,32,0,35,3
1649919258035,MATH 20C,A01,083446,Hammock; Frances H,17,0,30,13
1649919258035,MATH 20C,A02,083447,Hammock; Frances H,28,0,30,2
1649919258035,MATH 20C,A03,083448,Hammock; Frances H,30,0,30,0
1649919258035,MATH 20C,A04,083449,Hammock; Frances H,30,0,30,0
1649919258035,MATH 20C,B01,083451,Hammock; Frances H,25,0,30,5
1649919258035,MATH 20C,B02,083452,Hammock; Frances H,27,0,30,3
1649919258035,MATH 20C,B03,083453,Hammock; Frances H,26,0,30,4
1649919258035,MATH 20C,B04,083454,Hammock; Frances H,30,0,30,0
1649919264056,MATH 20D,A01,084128,Staff,26,0,30,4
1649919264056,MATH 20D,A02,084129,Staff,30,0,30,0
1649919264056,MATH 20D,A03,084130,Staff,29,0,30,1
1649919264056,MATH 20D,B01,084133,Staff,22,0,30,8
1649919264056,MATH 20D,B02,084134,Staff,27,0,30,3
1649919264056,MATH 20D,B03,084135,Staff,30,0,30,0
1649919270090,MATH 20E,A01,084138,Staff,23,0,30,7
1649919270090,MATH 20E,A02,084139,Staff,22,0,30,8
1649919270090,MATH 20E,A03,084140,Staff,23,0,30,7
1649919270090,MATH 20E,A04,084141,Staff,25,0,30,5
1649919276115,MATH 102,A01,084143,Harel; Guershon,17,0,30,13
1649919276115,MATH 102,A02,084144,Harel; Guershon,22,0,30,8
1649919282137,MATH 103B,A01,083456,Staff,0,8,30,30
1649919282137,MATH 103B,A02,083457,Staff,0,9,30,30
1649919288162,MATH 109,A01,084146,Salehi Golsefidy; Alireza,28,0,30,2
1649919288162,MATH 109,A02,084147,Salehi Golsefidy; Alireza,22,0,30,8
1649919294186,MATH 120A,A01,085445,Eggers; John Dietrich,20,0,35,15
1649919294186,MATH 120A,A02,085446,Eggers; John Dietrich,28,0,35,7
1649919300215,MATH 142B,A01,084149,Verstraete; Jacques Allan,0,10,30,30
1649919300215,MATH 142B,A02,084150,Verstraete; Jacques Allan,0,9,30,30
1649919306238,MATH 170A,A01,083459,Nie; Jiawang,0,2,30,30
1649919306238,MATH 170A,A02,083460,Nie; Jiawang,0,0,30,30
1649919306238,MATH 170A,A03,083461,Nie; Jiawang,9,0,30,21
1649919312266,MATH 193B,A01,083463,Staff,3,0,30,27
1649919312266,MATH 193B,A02,083464,Staff,10,0,30,20
1649919312266,MATH 193B,A03,083465,Staff,19,0,30,11
1649919318326,COGS 2,A01,083966,Boyle; Mary E. T.,18,0,30,12
1649919324351,COGS 9,A01,083968,Staff,43,0,60,17
1649919330377,COGS 14B,A01,083970,Staff,29,0,50,21
1649919336400,COGS 17,A01,092679,Staff,67,0,75,8
1649919342426,COGS 100,A01,083972,Staff,12,0,60,48
1649919354476,COGS 101C,A01,083976,Staff,19,0,30,11
1649919360499,COGS 102A,A01,083978,Johnson; Christine M.,17,0,30,13
1649919366524,COGS 107B,A01,083980,Staff,4,0,50,46
1649919372554,COGS 115,A01,083982,Staff,14,0,30,16
1649919378577,COGS 118B,A01,083367,Staff,0,11,40,40
1649919384605,COGS 172,A01,083984,Provenzano; Emily Kara,17,0,30,13
1649919390629,COGS 177,A00,083368,Staff,0,17,30,30
1649919396652,COGS 186,A01,083986,Staff,22,0,40,18
1649919402675,COGS 187A,A01,083988,Boyle; Mary E. T.,24,0,60,36
1649919408697,CSE 8A,A50,084003,Miranda; Gregory Joseph,0,0,15,15
1649919414721,CSE 11,A01,084005,Miranda; Gregory Joseph,23,0,55,32
1649919420745,CSE 20,A01,084007,Staff,9,0,20,11
1649919426772,CSE 21,A01,084009,Staff,11,0,50,39
1649919432793,CSE 30,A01,083370,Cao; Yingjun,0,20,40,40
1649919438816,CSE 100,A01,083372,Cao; Yingjun,0,23,40,40
1649919444842,CSE 101,A01,084011,Staff,0,46,40,40
1649919450870,CSE 141,A01,083374,Eldon; John,0,49,75,75
1649919456891,CSE 141L,A01,083376,Eldon; John,0,54,75,75
1649919462914,CSE 175,A01,084013,Kumar; Rakesh,22,0,25,3
1649919468937,CSE 190,A00,092508,Dubnov; Shlomo,15,0,15,0
1649919474960,ECE 5,A01,084049,Morris; Karcher William,15,0,20,5
1649919480984,ECE 100,A01,084051,Baghdadchi; Saharnaz,1,0,20,19
1649919480984,ECE 100,A02,091916,Baghdadchi; Saharnaz,16,0,20,4
1649919487012,ECE 101,A01,084053,Baghdadchi; Saharnaz,5,0,37,32
1649919487012,ECE 101,A02,084054,Baghdadchi; Saharnaz,33,0,37,4
1649919493036,ECE 107,A01,083390,Staff,29,0,40,11
1649919499070,ECE 148,A01,084056,Silberman; Jack,7,0,12,5
1649919505113,ECE 180,A00,083391,Abi Samra; Nicholas Camill,25,0,30,5
1649919505113,ECE 180,B00,083392,Abi Samra; Nicholas Camill,22,0,30,8
1649919511139,MATH 10B,A01,084110,Staff,8,0,30,22
1649919511139,MATH 10B,A02,084111,Staff,29,0,30,1
1649919511139,MATH 10B,A03,084112,Staff,28,0,30,2
1649919517162,MATH 10C,A01,083443,Staff,9,0,30,21
1649919517162,MATH 10C,A02,083444,Staff,17,0,30,13
1649919517162,MATH 10C,B01,084114,Staff,25,0,30,5
1649919517162,MATH 10C,B02,084115,Staff,29,0,30,1
1649919523184,MATH 18,A01,084117,Harel; Guershon,27,0,30,3
1649919523184,MATH 18,A02,084119,Harel; Guershon,29,0,30,1
1649919523184,MATH 18,A03,084120,Harel; Guershon,30,0,30,0
1649919523184,MATH 18,A04,084121,Harel; Guershon,29,0,30,1
1649919529212,MATH 20B,A01,084124,Um; Ko Woon,31,0,35,4
1649919529212,MATH 20B,B01,084126,Um; Ko Woon,32,0,35,3
1649919535238,MATH 20C,A01,083446,Hammock; Frances H,17,0,30,13
1649919535238,MATH 20C,A02,083447,Hammock; Frances H,28,0,30,2
1649919535238,MATH 20C,A03,083448,Hammock; Frances H,30,0,30,0
1649919535238,MATH 20C,A04,083449,Hammock; Frances H,30,0,30,0
1649919535238,MATH 20C,B01,083451,Hammock; Frances H,25,0,30,5
1649919535238,MATH 20C,B02,083452,Hammock; Frances H,27,0,30,3
1649919535238,MATH 20C,B03,083453,Hammock; Frances H,26,0,30,4
1649919535238,MATH 20C,B04,083454,Hammock; Frances H,30,0,30,0
1649919541265,MATH 20D,A01,084128,Staff,26,0,30,4
1649919541265,MATH 20D,A02,084129,Staff,30,0,30,0
1649919541265,MATH 20D,A03,084130,Staff,29,0,30,1
1649919541265,MATH 20D,B01,084133,Staff,21,0,30,9
1649919541265,MATH 20D,B02,084134,Staff,27,0,30,3
1649919541265,MATH 20D,B03,084135,Staff,30,0,30,0
1649919547296,MATH 20E,A01,084138,Staff,23,0,30,7
1649919547296,MATH 20E,A02,084139,Staff,22,0,30,8
1649919547296,MATH 20E,A03,084140,Staff,23,0,30,7
1649919547296,MATH 20E,A04,084141,Staff,25,0,30,5
1649919553323,MATH 102,A01,084143,Harel; Guershon,17,0,30,13
1649919553323,MATH 102,A02,084144,Harel; Guershon,22,0,30,8
1649919559359,MATH 103B,A01,083456,Staff,0,8,30,30
1649919559359,MATH 103B,A02,083457,Staff,0,9,30,30
1649919565383,MATH 109,A01,084146,Salehi Golsefidy; Alireza,28,0,30,2
1649919565383,MATH 109,A02,084147,Salehi Golsefidy; Alireza,22,0,30,8
1649919571408,MATH 120A,A01,085445,Eggers; John Dietrich,20,0,35,15
1649919571408,MATH 120A,A02,085446,Eggers; John Dietrich,28,0,35,7
1649919577432,MATH 142B,A01,084149,Verstraete; Jacques Allan,0,10,30,30
1649919577432,MATH 142B,A02,084150,Verstraete; Jacques Allan,0,9,30,30
1649919583462,MATH 170A,A01,083459,Nie; Jiawang,0,2,30,30
1649919583462,MATH 170A,A02,083460,Nie; Jiawang,0,0,30,30
1649919583462,MATH 170A,A03,083461,Nie; Jiawang,9,0,30,21
1649919589488,MATH 193B,A01,083463,Staff,3,0,30,27
1649919589488,MATH 193B,A02,083464,Staff,10,0,30,20
1649919589488,MATH 193B,A03,083465,Staff,19,0,30,11
1649919595556,COGS 2,A01,083966,Boyle; Mary E. T.,18,0,30,12
1649919601583,COGS 9,A01,083968,Staff,43,0,60,17
1649919607609,COGS 14B,A01,083970,Staff,29,0,50,21
1649919613631,COGS 17,A01,092679,Staff,67,0,75,8
1649919619658,COGS 100,A01,083972,Staff,12,0,60,48
1649919631704,COGS 101C,A01,083976,Staff,19,0,30,11
1649919637740,COGS 102A,A01,083978,Johnson; Christine M.,17,0,30,13
1649919643769,COGS 107B,A01,083980,Staff,4,0,50,46
1649919649793,COGS 115,A01,083982,Staff,14,0,30,16
1649919655941,COGS 118B,A01,083367,Staff,0,11,40,40
1649919661969,COGS 172,A01,083984,Provenzano; Emily Kara,17,0,30,13
1649919667994,COGS 177,A00,083368,Staff,0,17,30,30
1649919674018,COGS 186,A01,083986,Staff,22,0,40,18
1649919680042,COGS 187A,A01,083988,Boyle; Mary E. T.,24,0,60,36
1649919686078,CSE 8A,A50,084003,Miranda; Gregory Joseph,0,0,15,15
1649919692105,CSE 11,A01,084005,Miranda; Gregory Joseph,23,0,55,32
1649919698134,CSE 20,A01,084007,Staff,9,0,20,11
1649919704159,CSE 21,A01,084009,Staff,11,0,50,39
1649919710182,CSE 30,A01,083370,Cao; Yingjun,0,20,40,40
1649919716297,CSE 100,A01,083372,Cao; Yingjun,0,23,40,40
1649919722325,CSE 101,A01,084011,Staff,0,46,40,40
1649919728353,CSE 141,A01,083374,Eldon; John,0,49,75,75
1649919734382,CSE 141L,A01,083376,Eldon; John,0,54,75,75
1649919740418,CSE 175,A01,084013,Kumar; Rakesh,22,0,25,3
1649919746453,CSE 190,A00,092508,Dubnov; Shlomo,15,0,15,0
1649919752481,ECE 5,A01,084049,Morris; Karcher William,15,0,20,5
1649919758513,ECE 100,A01,084051,Baghdadchi; Saharnaz,1,0,20,19
1649919758513,ECE 100,A02,091916,Baghdadchi; Saharnaz,16,0,20,4
1649919764538,ECE 101,A01,084053,Baghdadchi; Saharnaz,5,0,37,32
1649919764538,ECE 101,A02,084054,Baghdadchi; Saharnaz,33,0,37,4
1649919770570,ECE 107,A01,083390,Staff,29,0,40,11
1649919776599,ECE 148,A01,084056,Silberman; Jack,7,0,12,5
1649919782623,ECE 180,A00,083391,Abi Samra; Nicholas Camill,25,0,30,5
1649919782623,ECE 180,B00,083392,Abi Samra; Nicholas Camill,22,0,30,8
1649919788649,MATH 10B,A01,084110,Staff,8,0,30,22
1649919788649,MATH 10B,A02,084111,Staff,29,0,30,1
1649919788649,MATH 10B,A03,084112,Staff,28,0,30,2
1649919794678,MATH 10C,A01,083443,Staff,9,0,30,21
1649919794678,MATH 10C,A02,083444,Staff,17,0,30,13
1649919794678,MATH 10C,B01,084114,Staff,25,0,30,5
1649919794678,MATH 10C,B02,084115,Staff,29,0,30,1
1649919800703,MATH 18,A01,084117,Harel; Guershon,27,0,30,3
1649919800703,MATH 18,A02,084119,Harel; Guershon,29,0,30,1
1649919800703,MATH 18,A03,084120,Harel; Guershon,30,0,30,0
1649919800703,MATH 18,A04,084121,Harel; Guershon,29,0,30,1
1649919806731,MATH 20B,A01,084124,Um; Ko Woon,31,0,35,4
1649919806731,MATH 20B,B01,084126,Um; Ko Woon,32,0,35,3
1649919812759,MATH 20C,A01,083446,Hammock; Frances H,17,0,30,13
1649919812759,MATH 20C,A02,083447,Hammock; Frances H,28,0,30,2
1649919812759,MATH 20C,A03,083448,Hammock; Frances H,30,0,30,0
1649919812759,MATH 20C,A04,083449,Hammock; Frances H,30,0,30,0
1649919812759,MATH 20C,B01,083451,Hammock; Frances H,25,0,30,5
1649919812759,MATH 20C,B02,083452,Hammock; Frances H,27,0,30,3
1649919812759,MATH 20C,B03,083453,Hammock; Frances H,26,0,30,4
1649919812759,MATH 20C,B04,083454,Hammock; Frances H,30,0,30,0
1649919818783,MATH 20D,A01,084128,Staff,26,0,30,4
1649919818783,MATH 20D,A02,084129,Staff,30,0,30,0
1649919818783,MATH 20D,A03,084130,Staff,29,0,30,1
1649919818783,MATH 20D,B01,084133,Staff,21,0,30,9
1649919818783,MATH 20D,B02,084134,Staff,27,0,30,3
1649919818783,MATH 20D,B03,084135,Staff,30,0,30,0
1649919824812,MATH 20E,A01,084138,Staff,23,0,30,7
1649919824812,MATH 20E,A02,084139,Staff,22,0,30,8
1649919824812,MATH 20E,A03,084140,Staff,23,0,30,7
1649919824812,MATH 20E,A04,084141,Staff,25,0,30,5
1649919830840,MATH 102,A01,084143,Harel; Guershon,17,0,30,13
1649919830840,MATH 102,A02,084144,Harel; Guershon,22,0,30,8
1649919836868,MATH 103B,A01,083456,Staff,0,8,30,30
1649919836868,MATH 103B,A02,083457,Staff,0,9,30,30
1649919842897,MATH 109,A01,084146,Salehi Golsefidy; Alireza,28,0,30,2
1649919842897,MATH 109,A02,084147,Salehi Golsefidy; Alireza,22,0,30,8
1649919848920,MATH 120A,A01,085445,Eggers; John Dietrich,20,0,35,15
1649919848920,MATH 120A,A02,085446,Eggers; John Dietrich,28,0,35,7
1649919854955,MATH 142B,A01,084149,Verstraete; Jacques Allan,0,10,30,30
1649919854955,MATH 142B,A02,084150,Verstraete; Jacques Allan,0,9,30,30
1649919860983,MATH 170A,A01,083459,Nie; Jiawang,0,2,30,30
1649919860983,MATH 170A,A02,083460,Nie; Jiawang,0,0,30,30
1649919860983,MATH 170A,A03,083461,Nie; Jiawang,9,0,30,21
1649919867007,MATH 193B,A01,083463,Staff,3,0,30,27
1649919867007,MATH 193B,A02,083464,Staff,10,0,30,20
1649919867007,MATH 193B,A03,083465,Staff,19,0,30,11
1649919873069,COGS 2,A01,083966,Boyle; Mary E. T.,18,0,30,12
1649919879093,COGS 9,A01,083968,Staff,43,0,60,17
1649919885120,COGS 14B,A01,083970,Staff,29,0,50,21
1649919891147,COGS 17,A01,092679,Staff,67,0,75,8
1649919897175,COGS 100,A01,083972,Staff,12,0,60,48
1649919909224,COGS 101C,A01,083976,Staff,19,0,30,11
1649919915247,COGS 102A,A01,083978,Johnson; Christine M.,17,0,30,13
1649919921274,COGS 107B,A01,083980,Staff,4,0,50,46
1649919927302,COGS 115,A01,083982,Staff,14,0,30,16
1649919933330,COGS 118B,A01,083367,Staff,0,11,40,40
1649919939356,COGS 172,A01,083984,Provenzano; Emily Kara,17,0,30,13
1649919945380,COGS 177,A00,083368,Staff,0,17,30,30
1649919951410,COGS 186,A01,083986,Staff,22,0,40,18
1649919957437,COGS 187A,A01,083988,Boyle; Mary E. T.,24,0,60,36
1649919963473,CSE 8A,A50,084003,Miranda; Gregory Joseph,0,0,15,15
1649919969498,CSE 11,A01,084005,Miranda; Gregory Joseph,23,0,55,32
1649919975525,CSE 20,A01,084007,Staff,9,0,20,11
1649919981549,CSE 21,A01,084009,Staff,11,0,50,39
1649919987572,CSE 30,A01,083370,Cao; Yingjun,0,20,40,40
1649919993597,CSE 100,A01,083372,Cao; Yingjun,0,23,40,40
1649919999620,CSE 101,A01,084011,Staff,0,46,40,40
1649920005644,CSE 141,A01,083374,Eldon; John,0,49,75,75
1649920011681,CSE 141L,A01,083376,Eldon; John,0,54,75,75
1649920017712,CSE 175,A01,084013,Kumar; Rakesh,22,0,25,3
1649920023737,CSE 190,A00,092508,Dubnov; Shlomo,15,0,15,0
1649920029765,ECE 5,A01,084049,Morris; Karcher William,15,0,20,5
1649920035793,ECE 100,A01,084051,Baghdadchi; Saharnaz,1,0,20,19
1649920035793,ECE 100,A02,091916,Baghdadchi; Saharnaz,16,0,20,4
1649920041821,ECE 101,A01,084053,Baghdadchi; Saharnaz,5,0,37,32
1649920041821,ECE 101,A02,084054,Baghdadchi; Saharnaz,33,0,37,4
1649920047845,ECE 107,A01,083390,Staff,29,0,40,11
1649920053866,ECE 148,A01,084056,Silberman; Jack,7,0,12,5
1649920059891,ECE 180,A00,083391,Abi Samra; Nicholas Camill,25,0,30,5
1649920059891,ECE 180,B00,083392,Abi Samra; Nicholas Camill,22,0,30,8
1649920065914,MATH 10B,A01,084110,Staff,8,0,30,22
1649920065914,MATH 10B,A02,084111,Staff,29,0,30,1
1649920065914,MATH 10B,A03,084112,Staff,28,0,30,2
1649920071938,MATH 10C,A01,083443,Staff,9,0,30,21
1649920071938,MATH 10C,A02,083444,Staff,16,0,30,14
1649920071938,MATH 10C,B01,084114,Staff,25,0,30,5
1649920071938,MATH 10C,B02,084115,Staff,29,0,30,1
1649920077961,MATH 18,A01,084117,Harel; Guershon,27,0,30,3
1649920077961,MATH 18,A02,084119,Harel; Guershon,29,0,30,1
1649920077961,MATH 18,A03,084120,Harel; Guershon,30,0,30,0
1649920077961,MATH 18,A04,084121,Harel; Guershon,29,0,30,1
1649920083985,MATH 20B,A01,084124,Um; Ko Woon,31,0,35,4
1649920083985,MATH 20B,B01,084126,Um; Ko Woon,32,0,35,3
1649920090011,MATH 20C,A01,083446,Hammock; Frances H,17,0,30,13
1649920090011,MATH 20C,A02,083447,Hammock; Frances H,28,0,30,2
1649920090011,MATH 20C,A03,083448,Hammock; Frances H,30,0,30,0
1649920090011,MATH 20C,A04,083449,Hammock; Frances H,30,0,30,0
1649920090011,MATH 20C,B01,083451,Hammock; Frances H,25,0,30,5
1649920090011,MATH 20C,B02,083452,Hammock; Frances H,27,0,30,3
1649920090011,MATH 20C,B03,083453,Hammock; Frances H,26,0,30,4
1649920090011,MATH 20C,B04,083454,Hammock; Frances H,30,0,30,0
1649920096036,MATH 20D,A01,084128,Staff,26,0,30,4
1649920096036,MATH 20D,A02,084129,Staff,30,0,30,0
1649920096036,MATH 20D,A03,084130,Staff,29,0,30,1
1649920096036,MATH 20D,B01,084133,Staff,21,0,30,9
1649920096036,MATH 20D,B02,084134,Staff,27,0,30,3
1649920096036,MATH 20D,B03,084135,Staff,30,0,30,0
1649920102064,MATH 20E,A01,084138,Staff,23,0,30,7
1649920102064,MATH 20E,A02,084139,Staff,22,0,30,8
1649920102064,MATH 20E,A03,084140,Staff,23,0,30,7
1649920102064,MATH 20E,A04,084141,Staff,25,0,30,5
1649920108089,MATH 102,A01,084143,Harel; Guershon,17,0,30,13
1649920108089,MATH 102,A02,084144,Harel; Guershon,22,0,30,8
1649920114122,MATH 103B,A01,083456,Staff,0,8,30,30
1649920114122,MATH 103B,A02,083457,Staff,0,9,30,30
1649920120150,MATH 109,A01,084146,Salehi Golsefidy; Alireza,28,0,30,2
1649920120150,MATH 109,A02,084147,Salehi Golsefidy; Alireza,22,0,30,8
1649920126174,MATH 120A,A01,085445,Eggers; John Dietrich,20,0,35,15
1649920126174,MATH 120A,A02,085446,Eggers; John Dietrich,28,0,35,7
1649920132199,MATH 142B,A01,084149,Verstraete; Jacques Allan,0,10,30,30
1649920132199,MATH 142B,A02,084150,Verstraete; Jacques Allan,0,9,30,30
1649920138223,MATH 170A,A01,083459,Nie; Jiawang,0,2,30,30
1649920138223,MATH 170A,A02,083460,Nie; Jiawang,0,0,30,30
1649920138223,MATH 170A,A03,083461,Nie; Jiawang,9,0,30,21
1649920144246,MATH 193B,A01,083463,Staff,3,0,30,27
1649920144246,MATH 193B,A02,083464,Staff,10,0,30,20
1649920144246,MATH 193B,A03,083465,Staff,19,0,30,11
1649920150300,COGS 2,A01,083966,Boyle; Mary E. T.,18,0,30,12
1649920156323,COGS 9,A01,083968,Staff,43,0,60,17
1649920162352,COGS 14B,A01,083970,Staff,29,0,50,21
1649920168374,COGS 17,A01,092679,Staff,67,0,75,8
1649920174404,COGS 100,A01,083972,Staff,12,0,60,48
1649920186456,COGS 101C,A01,083976,Staff,19,0,30,11
1649920192479,COGS 102A,A01,083978,Johnson; Christine M.,17,0,30,13
1649920198508,COGS 107B,A01,083980,Staff,4,0,50,46
1649920204535,COGS 115,A01,083982,Staff,14,0,30,16
1649920210562,COGS 118B,A01,083367,Staff,0,11,40,40
1649920216586,COGS 172,A01,083984,Provenzano; Emily Kara,17,0,30,13
1649920222623,COGS 177,A00,083368,Staff,0,17,30,30
1649920228648,COGS 186,A01,083986,Staff,22,0,40,18
1649920234674,COGS 187A,A01,083988,Boyle; Mary E. T.,24,0,60,36
1649920240699,CSE 8A,A50,084003,Miranda; Gregory Joseph,0,0,15,15
1649920246727,CSE 11,A01,084005,Miranda; Gregory Joseph,23,0,55,32
1649920252836,CSE 20,A01,084007,Staff,9,0,20,11
1649920258861,CSE 21,A01,084009,Staff,11,0,50,39
1649920264885,CSE 30,A01,083370,Cao; Yingjun,0,20,40,40
1649920270917,CSE 100,A01,083372,Cao; Yingjun,0,23,40,40
1649920276948,CSE 101,A01,084011,Staff,0,46,40,40
1649920282974,CSE 141,A01,083374,Eldon; John,0,49,75,75
1649920289003,CSE 141L,A01,083376,Eldon; John,0,54,75,75
1649920295032,CSE 175,A01,084013,Kumar; Rakesh,22,0,25,3
1649920301067,CSE 190,A00,092508,Dubnov; Shlomo,15,0,15,0
1649920307092,ECE 5,A01,084049,Morris; Karcher William,15,0,20,5
1649920313127,ECE 100,A01,084051,Baghdadchi; Saharnaz,1,0,20,19
1649920313127,ECE 100,A02,091916,Baghdadchi; Saharnaz,16,0,20,4
1649920319153,ECE 101,A01,084053,Baghdadchi; Saharnaz,5,0,37,32
1649920319153,ECE 101,A02,084054,Baghdadchi; Saharnaz,33,0,37,4
1649920325177,ECE 107,A01,083390,Staff,29,0,40,11
1649920331206,ECE 148,A01,084056,Silberman; Jack,7,0,12,5
1649920337236,ECE 180,A00,083391,Abi Samra; Nicholas Camill,25,0,30,5
1649920337236,ECE 180,B00,083392,Abi Samra; Nicholas Camill,22,0,30,8
1649920343283,MATH 10B,A01,084110,Staff,8,0,30,22
1649920343283,MATH 10B,A02,084111,Staff,29,0,30,1
1649920343283,MATH 10B,A03,084112,Staff,28,0,30,2
1649920349343,MATH 10C,A01,083443,Staff,9,0,30,21
1649920349343,MATH 10C,A02,083444,Staff,16,0,30,14
1649920349343,MATH 10C,B01,084114,Staff,25,0,30,5
1649920349343,MATH 10C,B02,084115,Staff,29,0,30,1
1649920355367,MATH 18,A01,084117,Harel; Guershon,27,0,30,3
1649920355367,MATH 18,A02,084119,Harel; Guershon,29,0,30,1
1649920355367,MATH 18,A03,084120,Harel; Guershon,30,0,30,0
1649920355367,MATH 18,A04,084121,Harel; Guershon,29,0,30,1
1649920361392,MATH 20B,A01,084124,Um; Ko Woon,31,0,35,4
1649920361392,MATH 20B,B01,084126,Um; Ko Woon,32,0,35,3
1649920367432,MATH 20C,A01,083446,Hammock; Frances H,17,0,30,13
1649920367432,MATH 20C,A02,083447,Hammock; Frances H,28,0,30,2
1649920367432,MATH 20C,A03,083448,Hammock; Frances H,30,0,30,0
1649920367432,MATH 20C,A04,083449,Hammock; Frances H,30,0,30,0
1649920367432,MATH 20C,B01,083451,Hammock; Frances H,25,0,30,5
1649920367432,MATH 20C,B02,083452,Hammock; Frances H,27,0,30,3
1649920367432,MATH 20C,B03,083453,Hammock; Frances H,26,0,30,4
1649920367432,MATH 20C,B04,083454,Hammock; Frances H,30,0,30,0
1649920373463,MATH 20D,A01,084128,Staff,26,0,30,4
1649920373463,MATH 20D,A02,084129,Staff,30,0,30,0
1649920373463,MATH 20D,A03,084130,Staff,29,0,30,1
1649920373463,MATH 20D,B01,084133,Staff,21,0,30,9
1649920373463,MATH 20D,B02,084134,Staff,27,0,30,3
1649920373463,MATH 20D,B03,084135,Staff,30,0,30,0
1649920379486,MATH 20E,A01,084138,Staff,23,0,30,7
1649920379486,MATH 20E,A02,084139,Staff,22,0,30,8
1649920379486,MATH 20E,A03,084140,Staff,23,0,30,7
1649920379486,MATH 20E,A04,084141,Staff,25,0,30,5
1649920385515,MATH 102,A01,084143,Harel; Guershon,17,0,30,13
1649920385515,MATH 102,A02,084144,Harel; Guershon,22,0,30,8
1649920391541,MATH 103B,A01,083456,Staff,0,8,30,30
1649920391541,MATH 103B,A02,083457,Staff,0,9,30,30
1649920397566,MATH 109,A01,084146,Salehi Golsefidy; Alireza,28,0,30,2
1649920397566,MATH 109,A02,084147,Salehi Golsefidy; Alireza,22,0,30,8
1649920403591,MATH 120A,A01,085445,Eggers; John Dietrich,20,0,35,15
1649920403591,MATH 120A,A02,085446,Eggers; John Dietrich,28,0,35,7
1649920409614,MATH 142B,A01,084149,Verstraete; Jacques Allan,0,10,30,30
1649920409614,MATH 142B,A02,084150,Verstraete; Jacques Allan,0,9,30,30
1649920415640,MATH 170A,A01,083459,Nie; Jiawang,0,2,30,30
1649920415640,MATH 170A,A02,083460,Nie; Jiawang,0,0,30,30
1649920415640,MATH 170A,A03,083461,Nie; Jiawang,9,0,30,21
1649920421671,MATH 193B,A01,083463,Staff,3,0,30,27
1649920421671,MATH 193B,A02,083464,Staff,10,0,30,20
1649920421671,MATH 193B,A03,083465,Staff,19,0,30,11
1649920427732,COGS 2,A01,083966,Boyle; Mary E. T.,18,0,30,12
1649920433766,COGS 9,A01,083968,Staff,43,0,60,17
1649920439793,COGS 14B,A01,083970,Staff,29,0,50,21
1649920445817,COGS 17,A01,092679,Staff,67,0,75,8
1649920451842,COGS 100,A01,083972,Staff,12,0,60,48
1649920463919,COGS 101C,A01,083976,Staff,19,0,30,11
1649920469955,COGS 102A,A01,083978,Johnson; Christine M.,17,0,30,13
1649920475983,COGS 107B,A01,083980,Staff,4,0,50,46
1649920482008,COGS 115,A01,083982,Staff,14,0,30,16
1649920488032,COGS 118B,A01,083367,Staff,0,11,40,40
1649920494056,COGS 172,A01,083984,Provenzano; Emily Kara,17,0,30,13
1649920500078,COGS 177,A00,083368,Staff,0,17,30,30
1649920506102,COGS 186,A01,083986,Staff,22,0,40,18
1649920512129,COGS 187A,A01,083988,Boyle; Mary E. T.,24,0,60,36
1649920518158,CSE 8A,A50,084003,Miranda; Gregory Joseph,0,0,15,15
1649920524188,CSE 11,A01,084005,Miranda; Gregory Joseph,23,0,55,32
1649920530211,CSE 20,A01,084007,Staff,9,0,20,11
1649920536251,CSE 21,A01,084009,Staff,11,0,50,39
1649920542280,CSE 30,A01,083370,Cao; Yingjun,0,20,40,40
1649920548305,CSE 100,A01,083372,Cao; Yingjun,0,23,40,40
1649920554336,CSE 101,A01,084011,Staff,0,46,40,40
1649920560359,CSE 141,A01,083374,Eldon; John,0,49,75,75
1649920566383,CSE 141L,A01,083376,Eldon; John,0,54,75,75
1649920572407,CSE 175,A01,084013,Kumar; Rakesh,22,0,25,3
1649920578432,CSE 190,A00,092508,Dubnov; Shlomo,15,0,15,0
1649920584460,ECE 5,A01,084049,Morris; Karcher William,15,0,20,5
1649920590499,ECE 100,A01,084051,Baghdadchi; Saharnaz,1,0,20,19
1649920590499,ECE 100,A02,091916,Baghdadchi; Saharnaz,16,0,20,4
1649920596525,ECE 101,A01,084053,Baghdadchi; Saharnaz,5,0,37,32
1649920596525,ECE 101,A02,084054,Baghdadchi; Saharnaz,33,0,37,4
1649920602552,ECE 107,A01,083390,Staff,29,0,40,11
1649920608575,ECE 148,A01,084056,Silberman; Jack,7,0,12,5
1649920614602,ECE 180,A00,083391,Abi Samra; Nicholas Camill,25,0,30,5
1649920614602,ECE 180,B00,083392,Abi Samra; Nicholas Camill,22,0,30,8
1649920620630,MATH 10B,A01,084110,Staff,8,0,30,22
1649920620630,MATH 10B,A02,084111,Staff,29,0,30,1
1649920620630,MATH 10B,A03,084112,Staff,28,0,30,2
1649920626656,MATH 10C,A01,083443,Staff,9,0,30,21
1649920626656,MATH 10C,A02,083444,Staff,16,0,30,14
1649920626656,MATH 10C,B01,084114,Staff,25,0,30,5
1649920626656,MATH 10C,B02,084115,Staff,29,0,30,1
1649920632681,MATH 18,A01,084117,Harel; Guershon,27,0,30,3
1649920632681,MATH 18,A02,084119,Harel; Guershon,29,0,30,1
1649920632681,MATH 18,A03,084120,Harel; Guershon,30,0,30,0
1649920632681,MATH 18,A04,084121,Harel; Guershon,29,0,30,1
1649920638712,MATH 20B,A01,084124,Um; Ko Woon,31,0,35,4
1649920638712,MATH 20B,B01,084126,Um; Ko Woon,32,0,35,3
1649920644745,MATH 20C,A01,083446,Hammock; Frances H,17,0,30,13
1649920644745,MATH 20C,A02,083447,Hammock; Frances H,28,0,30,2
1649920644745,MATH 20C,A03,083448,Hammock; Frances H,30,0,30,0
1649920644745,MATH 20C,A04,083449,Hammock; Frances H,30,0,30,0
1649920644745,MATH 20C,B01,083451,Hammock; Frances H,25,0,30,5
1649920644745,MATH 20C,B02,083452,Hammock; Frances H,27,0,30,3
1649920644745,MATH 20C,B03,083453,Hammock; Frances H,26,0,30,4
1649920644745,MATH 20C,B04,083454,Hammock; Frances H,30,0,30,0
1649920650768,MATH 20D,A01,084128,Staff,26,0,30,4
1649920650768,MATH 20D,A02,084129,Staff,30,0,30,0
1649920650768,MATH 20D,A03,084130,Staff,29,0,30,1
1649920650768,MATH 20D,B01,084133,Staff,21,0,30,9
1649920650768,MATH 20D,B02,084134,Staff,27,0,30,3
1649920650768,MATH 20D,B03,084135,Staff,30,0,30,0
1649920656803,MATH 20E,A01,084138,Staff,23,0,30,7
1649920656803,MATH 20E,A02,084139,Staff,22,0,30,8
1649920656803,MATH 20E,A03,084140,Staff,23,0,30,7
1649920656803,MATH 20E,A04,084141,Staff,25,0,30,5
1649920662830,MATH 102,A01,084143,Harel; Guershon,17,0,30,13
1649920662830,MATH 102,A02,084144,Harel; Guershon,22,0,30,8
1649920668859,MATH 103B,A01,083456,Staff,0,8,30,30
1649920668859,MATH 103B,A02,083457,Staff,0,9,30,30
1649920674883,MATH 109,A01,084146,Salehi Golsefidy; Alireza,28,0,30,2
1649920674883,MATH 109,A02,084147,Salehi Golsefidy; Alireza,22,0,30,8
1649920680914,MATH 120A,A01,085445,Eggers; John Dietrich,20,0,35,15
1649920680914,MATH 120A,A02,085446,Eggers; John Dietrich,28,0,35,7
1649920686943,MATH 142B,A01,084149,Verstraete; Jacques Allan,0,10,30,30
1649920686943,MATH 142B,A02,084150,Verstraete; Jacques Allan,0,9,30,30
1649920692966,MATH 170A,A01,083459,Nie; Jiawang,0,2,30,30
1649920692966,MATH 170A,A02,083460,Nie; Jiawang,0,0,30,30
1649920692966,MATH 170A,A03,083461,Nie; Jiawang,9,0,30,21
1649920698991,MATH 193B,A01,083463,Staff,3,0,30,27
1649920698991,MATH 193B,A02,083464,Staff,10,0,30,20
1649920698991,MATH 193B,A03,083465,Staff,19,0,30,11
1649920705054,COGS 2,A01,083966,Boyle; Mary E. T.,18,0,30,12
1649920711078,COGS 9,A01,083968,Staff,43,0,60,17
1649920717110,COGS 14B,A01,083970,Staff,29,0,50,21
1649920723135,COGS 17,A01,092679,Staff,67,0,75,8
1649920729157,COGS 100,A01,083972,Staff,12,0,60,48
1649920741211,COGS 101C,A01,083976,Staff,19,0,30,11
1649920747236,COGS 102A,A01,083978,Johnson; Christine M.,17,0,30,13
1649920753262,COGS 107B,A01,083980,Staff,4,0,50,46
1649920759285,COGS 115,A01,083982,Staff,14,0,30,16
1649920765308,COGS 118B,A01,083367,Staff,0,11,40,40
1649920771333,COGS 172,A01,083984,Provenzano; Emily Kara,17,0,30,13
1649920777360,COGS 177,A00,083368,Staff,0,17,30,30
1649920783391,COGS 186,A01,083986,Staff,22,0,40,18
1649920789418,COGS 187A,A01,083988,Boyle; Mary E. T.,24,0,60,36
1649920795443,CSE 8A,A50,084003,Miranda; Gregory Joseph,0,0,15,15
1649920801466,CSE 11,A01,084005,Miranda; Gregory Joseph,23,0,55,32
1649920807491,CSE 20,A01,084007,Staff,9,0,20,11
1649920813514,CSE 21,A01,084009,Staff,11,0,50,39
1649920819542,CSE 30,A01,083370,Cao; Yingjun,0,20,40,40
1649920825568,CSE 100,A01,083372,Cao; Yingjun,0,23,40,40
1649920831596,CSE 101,A01,084011,Staff,0,46,40,40
1649920837620,CSE 141,A01,083374,Eldon; John,0,49,75,75
1649920843644,CSE 141L,A01,083376,Eldon; John,0,54,75,75
1649920849763,CSE 175,A01,084013,Kumar; Rakesh,22,0,25,3
1649920855786,CSE 190,A00,092508,Dubnov; Shlomo,15,0,15,0
1649920861809,ECE 5,A01,084049,Morris; Karcher William,15,0,20,5
1649920867834,ECE 100,A01,084051,Baghdadchi; Saharnaz,1,0,20,19
1649920867834,ECE 100,A02,091916,Baghdadchi; Saharnaz,16,0,20,4
1649920873857,ECE 101,A01,084053,Baghdadchi; Saharnaz,5,0,37,32
1649920873857,ECE 101,A02,084054,Baghdadchi; Saharnaz,33,0,37,4
1649920879881,ECE 107,A01,083390,Staff,29,0,40,11
1649920885905,ECE 148,A01,084056,Silberman; Jack,7,0,12,5
1649920891928,ECE 180,A00,083391,Abi Samra; Nicholas Camill,25,0,30,5
1649920891928,ECE 180,B00,083392,Abi Samra; Nicholas Camill,22,0,30,8
1649920897952,MATH 10B,A01,084110,Staff,8,0,30,22
1649920897952,MATH 10B,A02,084111,Staff,29,0,30,1
1649920897952,MATH 10B,A03,084112,Staff,28,0,30,2
1649920903976,MATH 10C,A01,083443,Staff,9,0,30,21
1649920903976,MATH 10C,A02,083444,Staff,16,0,30,14
1649920903976,MATH 10C,B01,084114,Staff,25,0,30,5
1649920903976,MATH 10C,B02,084115,Staff,29,0,30,1
1649920910001,MATH 18,A01,084117,Harel; Guershon,27,0,30,3
1649920910001,MATH 18,A02,084119,Harel; Guershon,29,0,30,1
1649920910001,MATH 18,A03,084120,Harel; Guershon,30,0,30,0
1649920910001,MATH 18,A04,084121,Harel; Guershon,29,0,30,1
1649920916030,MATH 20B,A01,084124,Um; Ko Woon,31,0,35,4
1649920916030,MATH 20B,B01,084126,Um; Ko Woon,32,0,35,3
1649920922062,MATH 20C,A01,083446,Hammock; Frances H,17,0,30,13
1649920922062,MATH 20C,A02,083447,Hammock; Frances H,28,0,30,2
1649920922062,MATH 20C,A03,083448,Hammock; Frances H,30,0,30,0
1649920922062,MATH 20C,A04,083449,Hammock; Frances H,30,0,30,0
1649920922062,MATH 20C,B01,083451,Hammock; Frances H,25,0,30,5
1649920922062,MATH 20C,B02,083452,Hammock; Frances H,27,0,30,3
1649920922062,MATH 20C,B03,083453,Hammock; Frances H,26,0,30,4
1649920922062,MATH 20C,B04,083454,Hammock; Frances H,30,0,30,0
1649920928087,MATH 20D,A01,084128,Staff,26,0,30,4
1649920928087,MATH 20D,A02,084129,Staff,30,0,30,0
1649920928087,MATH 20D,A03,084130,Staff,29,0,30,1
1649920928087,MATH 20D,B01,084133,Staff,21,0,30,9
1649920928087,MATH 20D,B02,084134,Staff,27,0,30,3
1649920928087,MATH 20D,B03,084135,Staff,30,0,30,0
1649920934116,MATH 20E,A01,084138,Staff,23,0,30,7
1649920934116,MATH 20E,A02,084139,Staff,22,0,30,8
1649920934116,MATH 20E,A03,084140,Staff,23,0,30,7
1649920934116,MATH 20E,A04,084141,Staff,25,0,30,5
1649920940144,MATH 102,A01,084143,Harel; Guershon,17,0,30,13
1649920940144,MATH 102,A02,084144,Harel; Guershon,22,0,30,8
1649920946172,MATH 103B,A01,083456,Staff,0,8,30,30
1649920946172,MATH 103B,A02,083457,Staff,0,9,30,30
1649920952202,MATH 109,A01,084146,Salehi Golsefidy; Alireza,28,0,30,2
1649920952202,MATH 109,A02,084147,Salehi Golsefidy; Alireza,22,0,30,8
1649920958235,MATH 120A,A01,085445,Eggers; John Dietrich,20,0,35,15
1649920958235,MATH 120A,A02,085446,Eggers; John Dietrich,28,0,35,7
1649920964264,MATH 142B,A01,084149,Verstraete; Jacques Allan,0,10,30,30
1649920964264,MATH 142B,A02,084150,Verstraete; Jacques Allan,0,9,30,30
1649920970297,MATH 170A,A01,083459,Nie; Jiawang,0,2,30,30
1649920970297,MATH 170A,A02,083460,Nie; Jiawang,0,0,30,30
1649920970297,MATH 170A,A03,083461,Nie; Jiawang,9,0,30,21
1649920976325,MATH 193B,A01,083463,Staff,3,0,30,27
1649920976325,MATH 193B,A02,083464,Staff,10,0,30,20
1649920976325,MATH 193B,A03,083465,Staff,19,0,30,11
1649920982380,COGS 2,A01,083966,Boyle; Mary E. T.,18,0,30,12
1649920988403,COGS 9,A01,083968,Staff,43,0,60,17
1649920994426,COGS 14B,A01,083970,Staff,29,0,50,21
1649921000454,COGS 17,A01,092679,Staff,67,0,75,8
1649921006476,COGS 100,A01,083972,Staff,12,0,60,48
1649921018523,COGS 101C,A01,083976,Staff,19,0,30,11
1649921024551,COGS 102A,A01,083978,Johnson; Christine M.,17,0,30,13
1649921030575,COGS 107B,A01,083980,Staff,4,0,50,46
1649921036608,COGS 115,A01,083982,Staff,14,0,30,16
1649921042636,COGS 118B,A01,083367,Staff,0,11,40,40
1649921048664,COGS 172,A01,083984,Provenzano; Emily Kara,17,0,30,13
1649921054689,COGS 177,A00,083368,Staff,0,17,30,30
1649921060721,COGS 186,A01,083986,Staff,22,0,40,18
1649921066744,COGS 187A,A01,083988,Boyle; Mary E. T.,24,0,60,36
1649921072770,CSE 8A,A50,084003,Miranda; Gregory Joseph,0,0,15,15
1649921078793,CSE 11,A01,084005,Miranda; Gregory Joseph,23,0,55,32
1649921084818,CSE 20,A01,084007,Staff,9,0,20,11
1649921090849,CSE 21,A01,084009,Staff,10,0,50,40
1649921096876,CSE 30,A01,083370,Cao; Yingjun,0,20,40,40
1649921102900,CSE 100,A01,083372,Cao; Yingjun,0,23,40,40
1649921108930,CSE 101,A01,084011,Staff,0,46,40,40
1649921114956,CSE 141,A01,083374,Eldon; John,0,49,75,75
1649921120982,CSE 141L,A01,083376,Eldon; John,0,54,75,75
1649921127004,CSE 175,A01,084013,Kumar; Rakesh,22,0,25,3
1649921133033,CSE 190,A00,092508,Dubnov; Shlomo,15,0,15,0
1649921139055,ECE 5,A01,084049,Morris; Karcher William,15,0,20,5
1649921145078,ECE 100,A01,084051,Baghdadchi; Saharnaz,1,0,20,19
1649921145078,ECE 100,A02,091916,Baghdadchi; Saharnaz,16,0,20,4
1649921151110,ECE 101,A01,084053,Baghdadchi; Saharnaz,5,0,37,32
1649921151110,ECE 101,A02,084054,Baghdadchi; Saharnaz,33,0,37,4
1649921157133,ECE 107,A01,083390,Staff,29,0,40,11
1649921163156,ECE 148,A01,084056,Silberman; Jack,7,0,12,5
1649921169186,ECE 180,A00,083391,Abi Samra; Nicholas Camill,25,0,30,5
1649921169186,ECE 180,B00,083392,Abi Samra; Nicholas Camill,22,0,30,8
1649921175216,MATH 10B,A01,084110,Staff,8,0,30,22
1649921175216,MATH 10B,A02,084111,Staff,29,0,30,1
1649921175216,MATH 10B,A03,084112,Staff,28,0,30,2
1649921181242,MATH 10C,A01,083443,Staff,9,0,30,21
1649921181242,MATH 10C,A02,083444,Staff,16,0,30,14
1649921181242,MATH 10C,B01,084114,Staff,25,0,30,5
1649921181242,MATH 10C,B02,084115,Staff,29,0,30,1
1649921187266,MATH 18,A01,084117,Harel; Guershon,27,0,30,3
1649921187266,MATH 18,A02,084119,Harel; Guershon,29,0,30,1
1649921187266,MATH 18,A03,084120,Harel; Guershon,30,0,30,0
1649921187266,MATH 18,A04,084121,Harel; Guershon,29,0,30,1
1649921193292,MATH 20B,A01,084124,Um; Ko Woon,31,0,35,4
1649921193292,MATH 20B,B01,084126,Um; Ko Woon,32,0,35,3
1649921199323,MATH 20C,A01,083446,Hammock; Frances H,17,0,30,13
1649921199323,MATH 20C,A02,083447,Hammock; Frances H,28,0,30,2
1649921199323,MATH 20C,A03,083448,Hammock; Frances H,30,0,30,0
1649921199323,MATH 20C,A04,083449,Hammock; Frances H,30,0,30,0
1649921199323,MATH 20C,B01,083451,Hammock; Frances H,25,0,30,5
1649921199323,MATH 20C,B02,083452,Hammock; Frances H,27,0,30,3
1649921199323,MATH 20C,B03,083453,Hammock; Frances H,26,0,30,4
1649921199323,MATH 20C,B04,083454,Hammock; Frances H,30,0,30,0
1649921205351,MATH 20D,A01,084128,Staff,26,0,30,4
1649921205351,MATH 20D,A02,084129,Staff,30,0,30,0
1649921205351,MATH 20D,A03,084130,Staff,29,0,30,1
1649921205351,MATH 20D,B01,084133,Staff,21,0,30,9
1649921205351,MATH 20D,B02,084134,Staff,27,0,30,3
1649921205351,MATH 20D,B03,084135,Staff,30,0,30,0
1649921211378,MATH 20E,A01,084138,Staff,23,0,30,7
1649921211378,MATH 20E,A02,084139,Staff,22,0,30,8
1649921211378,MATH 20E,A03,084140,Staff,23,0,30,7
1649921211378,MATH 20E,A04,084141,Staff,25,0,30,5
1649921217407,MATH 102,A01,084143,Harel; Guershon,17,0,30,13
1649921217407,MATH 102,A02,084144,Harel; Guershon,22,0,30,8
1649921223433,MATH 103B,A01,083456,Staff,0,8,30,30
1649921223433,MATH 103B,A02,083457,Staff,0,9,30,30
1649921229459,MATH 109,A01,084146,Salehi Golsefidy; Alireza,28,0,30,2
1649921229459,MATH 109,A02,084147,Salehi Golsefidy; Alireza,22,0,30,8
1649921235484,MATH 120A,A01,085445,Eggers; John Dietrich,20,0,35,15
1649921235484,MATH 120A,A02,085446,Eggers; John Dietrich,28,0,35,7
1649921241512,MATH 142B,A01,084149,Verstraete; Jacques Allan,0,10,30,30
1649921241512,MATH 142B,A02,084150,Verstraete; Jacques Allan,0,9,30,30
1649921247537,MATH 170A,A01,083459,Nie; Jiawang,0,2,30,30
1649921247537,MATH 170A,A02,083460,Nie; Jiawang,0,0,30,30
1649921247537,MATH 170A,A03,083461,Nie; Jiawang,9,0,30,21
1649921253561,MATH 193B,A01,083463,Staff,3,0,30,27
1649921253561,MATH 193B,A02,083464,Staff,10,0,30,20
1649921253561,MATH 193B,A03,083465,Staff,19,0,30,11
1649921259613,COGS 2,A01,083966,Boyle; Mary E. T.,18,0,30,12
1649921265637,COGS 9,A01,083968,Staff,43,0,60,17
1649921271665,COGS 14B,A01,083970,Staff,29,0,50,21
1649921277690,COGS 17,A01,092679,Staff,67,0,75,8
1649921283713,COGS 100,A01,083972,Staff,12,0,60,48
1649921295762,COGS 101C,A01,083976,Staff,19,0,30,11
1649921301791,COGS 102A,A01,083978,Johnson; Christine M.,17,0,30,13
1649921307819,COGS 107B,A01,083980,Staff,4,0,50,46
1649921313848,COGS 115,A01,083982,Staff,14,0,30,16
1649921319878,COGS 118B,A01,083367,Staff,0,11,40,40
1649921325904,COGS 172,A01,083984,Provenzano; Emily Kara,17,0,30,13
1649921331928,COGS 177,A00,083368,Staff,0,17,30,30
1649921337952,COGS 186,A01,083986,Staff,22,0,40,18
1649921343979,COGS 187A,A01,083988,Boyle; Mary E. T.,24,0,60,36
1649921350018,CSE 8A,A50,084003,Miranda; Gregory Joseph,0,0,15,15
1649921356046,CSE 11,A01,084005,Miranda; Gregory Joseph,23,0,55,32
1649921362070,CSE 20,A01,084007,Staff,9,0,20,11
1649921368094,CSE 21,A01,084009,Staff,10,0,50,40
1649921374118,CSE 30,A01,083370,Cao; Yingjun,0,20,40,40
1649921380145,CSE 100,A01,083372,Cao; Yingjun,0,23,40,40
1649921386168,CSE 101,A01,084011,Staff,0,46,40,40
1649921392193,CSE 141,A01,083374,Eldon; John,0,49,75,75
1649921398229,CSE 141L,A01,083376,Eldon; John,0,54,75,75
1649921404255,CSE 175,A01,084013,Kumar; Rakesh,22,0,25,3
1649921410280,CSE 190,A00,092508,Dubnov; Shlomo,15,0,15,0
1649921416304,ECE 5,A01,084049,Morris; Karcher William,15,0,20,5
1649921422329,ECE 100,A01,084051,Baghdadchi; Saharnaz,1,0,20,19
1649921422329,ECE 100,A02,091916,Baghdadchi; Saharnaz,16,0,20,4
1649921428355,ECE 101,A01,084053,Baghdadchi; Saharnaz,5,0,37,32
1649921428355,ECE 101,A02,084054,Baghdadchi; Saharnaz,33,0,37,4
1649921434383,ECE 107,A01,083390,Staff,29,0,40,11
1649921440412,ECE 148,A01,084056,Silberman; Jack,7,0,12,5
1649921446525,ECE 180,A00,083391,Abi Samra; Nicholas Camill,25,0,30,5
1649921446525,ECE 180,B00,083392,Abi Samra; Nicholas Camill,22,0,30,8
1649921452549,MATH 10B,A01,084110,Staff,8,0,30,22
1649921452549,MATH 10B,A02,084111,Staff,29,0,30,1
1649921452549,MATH 10B,A03,084112,Staff,28,0,30,2
1649921458579,MATH 10C,A01,083443,Staff,9,0,30,21
1649921458579,MATH 10C,A02,083444,Staff,16,0,30,14
1649921458579,MATH 10C,B01,084114,Staff,25,0,30,5
1649921458579,MATH 10C,B02,084115,Staff,29,0,30,1
1649921464603,MATH 18,A01,084117,Harel; Guershon,27,0,30,3
1649921464603,MATH 18,A02,084119,Harel; Guershon,29,0,30,1
1649921464603,MATH 18,A03,084120,Harel; Guershon,30,0,30,0
1649921464603,MATH 18,A04,084121,Harel; Guershon,29,0,30,1
1649921470628,MATH 20B,A01,084124,Um; Ko Woon,31,0,35,4
1649921470628,MATH 20B,B01,084126,Um; Ko Woon,32,0,35,3
1649921476653,MATH 20C,A01,083446,Hammock; Frances H,17,0,30,13
1649921476653,MATH 20C,A02,083447,Hammock; Frances H,28,0,30,2
1649921476653,MATH 20C,A03,083448,Hammock; Frances H,30,0,30,0
1649921476653,MATH 20C,A04,083449,Hammock; Frances H,30,0,30,0
1649921476653,MATH 20C,B01,083451,Hammock; Frances H,25,0,30,5
1649921476653,MATH 20C,B02,083452,Hammock; Frances H,27,0,30,3
1649921476653,MATH 20C,B03,083453,Hammock; Frances H,26,0,30,4
1649921476653,MATH 20C,B04,083454,Hammock; Frances H,30,0,30,0
1649921482678,MATH 20D,A01,084128,Staff,26,0,30,4
1649921482678,MATH 20D,A02,084129,Staff,30,0,30,0
1649921482678,MATH 20D,A03,084130,Staff,29,0,30,1
1649921482678,MATH 20D,B01,084133,Staff,21,0,30,9
1649921482678,MATH 20D,B02,084134,Staff,27,0,30,3
1649921482678,MATH 20D,B03,084135,Staff,30,0,30,0
1649921488706,MATH 20E,A01,084138,Staff,23,0,30,7
1649921488706,MATH 20E,A02,084139,Staff,22,0,30,8
1649921488706,MATH 20E,A03,084140,Staff,23,0,30,7
1649921488706,MATH 20E,A04,084141,Staff,25,0,30,5
1649921494736,MATH 102,A01,084143,Harel; Guershon,17,0,30,13
1649921494736,MATH 102,A02,084144,Harel; Guershon,22,0,30,8
1649921500759,MATH 103B,A01,083456,Staff,0,8,30,30
1649921500759,MATH 103B,A02,083457,Staff,0,9,30,30
1649921506788,MATH 109,A01,084146,Salehi Golsefidy; Alireza,28,0,30,2
1649921506788,MATH 109,A02,084147,Salehi Golsefidy; Alireza,22,0,30,8
1649921512811,MATH 120A,A01,085445,Eggers; John Dietrich,20,0,35,15
1649921512811,MATH 120A,A02,085446,Eggers; John Dietrich,28,0,35,7
1649921518836,MATH 142B,A01,084149,Verstraete; Jacques Allan,0,10,30,30
1649921518836,MATH 142B,A02,084150,Verstraete; Jacques Allan,0,9,30,30
1649921524858,MATH 170A,A01,083459,Nie; Jiawang,0,2,30,30
1649921524858,MATH 170A,A02,083460,Nie; Jiawang,0,0,30,30
1649921524858,MATH 170A,A03,083461,Nie; Jiawang,9,0,30,21
1649921530885,MATH 193B,A01,083463,Staff,3,0,30,27
1649921530885,MATH 193B,A02,083464,Staff,10,0,30,20
1649921530885,MATH 193B,A03,083465,Staff,19,0,30,11
1649921536943,COGS 2,A01,083966,Boyle; Mary E. T.,18,0,30,12
1649921542970,COGS 9,A01,083968,Staff,43,0,60,17
1649921548997,COGS 14B,A01,083970,Staff,29,0,50,21
1649921555020,COGS 17,A01,092679,Staff,67,0,75,8
1649921561044,COGS 100,A01,083972,Staff,12,0,60,48
1649921573106,COGS 101C,A01,083976,Staff,19,0,30,11
1649921579131,COGS 102A,A01,083978,Johnson; Christine M.,17,0,30,13
1649921585155,COGS 107B,A01,083980,Staff,4,0,50,46
1649921591180,COGS 115,A01,083982,Staff,14,0,30,16
1649921597223,COGS 118B,A01,083367,Staff,0,11,40,40
1649921603255,COGS 172,A01,083984,Provenzano; Emily Kara,17,0,30,13
1649921609278,COGS 177,A00,083368,Staff,0,17,30,30
1649921615308,COGS 186,A01,083986,Staff,22,0,40,18
1649921621333,COGS 187A,A01,083988,Boyle; Mary E. T.,24,0,60,36
1649921627362,CSE 8A,A50,084003,Miranda; Gregory Joseph,0,0,15,15
1649921633390,CSE 11,A01,084005,Miranda; Gregory Joseph,23,0,55,32
1649921639416,CSE 20,A01,084007,Staff,9,0,20,11
1649921645447,CSE 21,A01,084009,Staff,10,0,50,40
1649921651470,CSE 30,A01,083370,Cao; Yingjun,0,20,40,40
1649921657494,CSE 100,A01,083372,Cao; Yingjun,0,23,40,40
1649921663521,CSE 101,A01,084011,Staff,0,46,40,40
1649921669544,CSE 141,A01,083374,Eldon; John,0,49,75,75
1649921675578,CSE 141L,A01,083376,Eldon; John,0,54,75,75
1649921681604,CSE 175,A01,084013,Kumar; Rakesh,22,0,25,3
1649921687634,CSE 190,A00,092508,Dubnov; Shlomo,15,0,15,0
1649921693662,ECE 5,A01,084049,Morris; Karcher William,15,0,20,5
1649921699687,ECE 100,A01,084051,Baghdadchi; Saharnaz,1,0,20,19
1649921699687,ECE 100,A02,091916,Baghdadchi; Saharnaz,16,0,20,4
1649921705720,ECE 101,A01,084053,Baghdadchi; Saharnaz,5,0,37,32
1649921705720,ECE 101,A02,084054,Baghdadchi; Saharnaz,33,0,37,4
1649921711749,ECE 107,A01,083390,Staff,29,0,40,11
1649921717775,ECE 148,A01,084056,Silberman; Jack,7,0,12,5
1649921723804,ECE 180,A00,083391,Abi Samra; Nicholas Camill,25,0,30,5
1649921723804,ECE 180,B00,083392,Abi Samra; Nicholas Camill,22,0,30,8
1649921729831,MATH 10B,A01,084110,Staff,8,0,30,22
1649921729831,MATH 10B,A02,084111,Staff,29,0,30,1
1649921729831,MATH 10B,A03,084112,Staff,28,0,30,2
1649921735855,MATH 10C,A01,083443,Staff,9,0,30,21
1649921735855,MATH 10C,A02,083444,Staff,16,0,30,14
1649921735855,MATH 10C,B01,084114,Staff,25,0,30,5
1649921735855,MATH 10C,B02,084115,Staff,29,0,30,1
1649921741890,MATH 18,A01,084117,Harel; Guershon,27,0,30,3
1649921741890,MATH 18,A02,084119,Harel; Guershon,29,0,30,1
1649921741890,MATH 18,A03,084120,Harel; Guershon,30,0,30,0
1649921741890,MATH 18,A04,084121,Harel; Guershon,29,0,30,1
1649921747919,MATH 20B,A01,084124,Um; Ko Woon,31,0,35,4
1649921747919,MATH 20B,B01,084126,Um; Ko Woon,32,0,35,3
1649921753951,MATH 20C,A01,083446,Hammock; Frances H,17,0,30,13
1649921753951,MATH 20C,A02,083447,Hammock; Frances H,28,0,30,2
1649921753951,MATH 20C,A03,083448,Hammock; Frances H,30,0,30,0
1649921753951,MATH 20C,A04,083449,Hammock; Frances H,30,0,30,0
1649921753951,MATH 20C,B01,083451,Hammock; Frances H,25,0,30,5
1649921753951,MATH 20C,B02,083452,Hammock; Frances H,27,0,30,3
1649921753951,MATH 20C,B03,083453,Hammock; Frances H,26,0,30,4
1649921753951,MATH 20C,B04,083454,Hammock; Frances H,30,0,30,0
1649921759976,MATH 20D,A01,084128,Staff,26,0,30,4
1649921759976,MATH 20D,A02,084129,Staff,30,0,30,0
1649921759976,MATH 20D,A03,084130,Staff,29,0,30,1
1649921759976,MATH 20D,B01,084133,Staff,21,0,30,9
1649921759976,MATH 20D,B02,084134,Staff,27,0,30,3
1649921759976,MATH 20D,B03,084135,Staff,30,0,30,0
1649921766001,MATH 20E,A01,084138,Staff,23,0,30,7
1649921766001,MATH 20E,A02,084139,Staff,22,0,30,8
1649921766001,MATH 20E,A03,084140,Staff,23,0,30,7
1649921766001,MATH 20E,A04,084141,Staff,25,0,30,5
1649921772029,MATH 102,A01,084143,Harel; Guershon,17,0,30,13
1649921772029,MATH 102,A02,084144,Harel; Guershon,22,0,30,8
1649921778052,MATH 103B,A01,083456,Staff,0,8,30,30
1649921778052,MATH 103B,A02,083457,Staff,0,9,30,30
1649921784079,MATH 109,A01,084146,Salehi Golsefidy; Alireza,28,0,30,2
1649921784079,MATH 109,A02,084147,Salehi Golsefidy; Alireza,22,0,30,8
1649921790103,MATH 120A,A01,085445,Eggers; John Dietrich,20,0,35,15
1649921790103,MATH 120A,A02,085446,Eggers; John Dietrich,28,0,35,7
1649921796132,MATH 142B,A01,084149,Verstraete; Jacques Allan,0,10,30,30
1649921796132,MATH 142B,A02,084150,Verstraete; Jacques Allan,0,9,30,30
1649921802165,MATH 170A,A01,083459,Nie; Jiawang,0,2,30,30
1649921802165,MATH 170A,A02,083460,Nie; Jiawang,0,0,30,30
1649921802165,MATH 170A,A03,083461,Nie; Jiawang,9,0,30,21
1649921808192,MATH 193B,A01,083463,Staff,3,0,30,27
1649921808192,MATH 193B,A02,083464,Staff,10,0,30,20
1649921808192,MATH 193B,A03,083465,Staff,19,0,30,11
1649921814256,COGS 2,A01,083966,Boyle; Mary E. T.,18,0,30,12
1649921820289,COGS 9,A01,083968,Staff,43,0,60,17
1649921826317,COGS 14B,A01,083970,Staff,29,0,50,21
1649921832341,COGS 17,A01,092679,Staff,67,0,75,8
1649921838369,COGS 100,A01,083972,Staff,12,0,60,48
1649921850424,COGS 101C,A01,083976,Staff,19,0,30,11
1649921856449,COGS 102A,A01,083978,Johnson; Christine M.,17,0,30,13
1649921862474,COGS 107B,A01,083980,Staff,4,0,50,46
1649921868501,COGS 115,A01,083982,Staff,14,0,30,16
1649921874534,COGS 118B,A01,083367,Staff,0,11,40,40
1649921880561,COGS 172,A01,083984,Provenzano; Emily Kara,17,0,30,13
1649921886593,COGS 177,A00,083368,Staff,0,17,30,30
1649921892633,COGS 186,A01,083986,Staff,22,0,40,18
1649921898657,COGS 187A,A01,083988,Boyle; Mary E. T.,24,0,60,36
1649921904685,CSE 8A,A50,084003,Miranda; Gregory Joseph,0,0,15,15
1649921910723,CSE 11,A01,084005,Miranda; Gregory Joseph,23,0,55,32
1649921916753,CSE 20,A01,084007,Staff,9,0,20,11
1649921922781,CSE 21,A01,084009,Staff,10,0,50,40
1649921928808,CSE 30,A01,083370,Cao; Yingjun,0,20,40,40
1649921934835,CSE 100,A01,083372,Cao; Yingjun,0,23,40,40
1649921940861,CSE 101,A01,084011,Staff,0,46,40,40
1649921946892,CSE 141,A01,083374,Eldon; John,0,50,75,75
1649921952917,CSE 141L,A01,083376,Eldon; John,0,55,75,75
1649921958947,CSE 175,A01,084013,Kumar; Rakesh,22,0,25,3
1649921964972,CSE 190,A00,092508,Dubnov; Shlomo,15,0,15,0
1649921970996,ECE 5,A01,084049,Morris; Karcher William,15,0,20,5
1649921977031,ECE 100,A01,084051,Baghdadchi; Saharnaz,1,0,20,19
1649921977031,ECE 100,A02,091916,Baghdadchi; Saharnaz,16,0,20,4
1649921983064,ECE 101,A01,084053,Baghdadchi; Saharnaz,5,0,37,32
1649921983064,ECE 101,A02,084054,Baghdadchi; Saharnaz,33,0,37,4
1649921989093,ECE 107,A01,083390,Staff,29,0,40,11
1649921995118,ECE 148,A01,084056,Silberman; Jack,7,0,12,5
1649922001144,ECE 180,A00,083391,Abi Samra; Nicholas Camill,25,0,30,5
1649922001144,ECE 180,B00,083392,Abi Samra; Nicholas Camill,22,0,30,8
1649922007169,MATH 10B,A01,084110,Staff,8,0,30,22
1649922007169,MATH 10B,A02,084111,Staff,29,0,30,1
1649922007169,MATH 10B,A03,084112,Staff,28,0,30,2
1649922013195,MATH 10C,A01,083443,Staff,9,0,30,21
1649922013195,MATH 10C,A02,083444,Staff,16,0,30,14
1649922013195,MATH 10C,B01,084114,Staff,25,0,30,5
1649922013195,MATH 10C,B02,084115,Staff,29,0,30,1
1649922019228,MATH 18,A01,084117,Harel; Guershon,27,0,30,3
1649922019228,MATH 18,A02,084119,Harel; Guershon,29,0,30,1
1649922019228,MATH 18,A03,084120,Harel; Guershon,30,0,30,0
1649922019228,MATH 18,A04,084121,Harel; Guershon,29,0,30,1
1649922025259,MATH 20B,A01,084124,Um; Ko Woon,31,0,35,4
1649922025259,MATH 20B,B01,084126,Um; Ko Woon,32,0,35,3
1649922031286,MATH 20C,A01,083446,Hammock; Frances H,17,0,30,13
1649922031286,MATH 20C,A02,083447,Hammock; Frances H,28,0,30,2
1649922031286,MATH 20C,A03,083448,Hammock; Frances H,30,0,30,0
1649922031286,MATH 20C,A04,083449,Hammock; Frances H,30,0,30,0
1649922031286,MATH 20C,B01,083451,Hammock; Frances H,25,0,30,5
1649922031286,MATH 20C,B02,083452,Hammock; Frances H,27,0,30,3
1649922031286,MATH 20C,B03,083453,Hammock; Frances H,26,0,30,4
1649922031286,MATH 20C,B04,083454,Hammock; Frances H,30,0,30,0
1649922037313,MATH 20D,A01,084128,Staff,26,0,30,4
1649922037313,MATH 20D,A02,084129,Staff,30,0,30,0
1649922037313,MATH 20D,A03,084130,Staff,29,0,30,1
1649922037313,MATH 20D,B01,084133,Staff,21,0,30,9
1649922037313,MATH 20D,B02,084134,Staff,27,0,30,3
1649922037313,MATH 20D,B03,084135,Staff,30,0,30,0
1649922043433,MATH 20E,A01,084138,Staff,22,0,30,8
1649922043433,MATH 20E,A02,084139,Staff,22,0,30,8
1649922043433,MATH 20E,A03,084140,Staff,23,0,30,7
1649922043433,MATH 20E,A04,084141,Staff,25,0,30,5
1649922049459,MATH 102,A01,084143,Harel; Guershon,17,0,30,13
1649922049459,MATH 102,A02,084144,Harel; Guershon,22,0,30,8
1649922055483,MATH 103B,A01,083456,Staff,0,8,30,30
1649922055483,MATH 103B,A02,083457,Staff,0,9,30,30
1649922061516,MATH 109,A01,084146,Salehi Golsefidy; Alireza,28,0,30,2
1649922061516,MATH 109,A02,084147,Salehi Golsefidy; Alireza,22,0,30,8
1649922067551,MATH 120A,A01,085445,Eggers; John Dietrich,20,0,35,15
1649922067551,MATH 120A,A02,085446,Eggers; John Dietrich,28,0,35,7
1649922073583,MATH 142B,A01,084149,Verstraete; Jacques Allan,0,10,30,30
1649922073583,MATH 142B,A02,084150,Verstraete; Jacques Allan,0,9,30,30
1649922079609,MATH 170A,A01,083459,Nie; Jiawang,0,2,30,30
1649922079609,MATH 170A,A02,083460,Nie; Jiawang,0,0,30,30
1649922079609,MATH 170A,A03,083461,Nie; Jiawang,9,0,30,21
1649922085639,MATH 193B,A01,083463,Staff,3,0,30,27
1649922085639,MATH 193B,A02,083464,Staff,10,0,30,20
1649922085639,MATH 193B,A03,083465,Staff,19,0,30,11
1649922091699,COGS 2,A01,083966,Boyle; Mary E. T.,18,0,30,12
1649922097727,COGS 9,A01,083968,Staff,43,0,60,17
1649922103752,COGS 14B,A01,083970,Staff,29,0,50,21
1649922109776,COGS 17,A01,092679,Staff,67,0,75,8
1649922115804,COGS 100,A01,083972,Staff,12,0,60,48
1649922127861,COGS 101C,A01,083976,Staff,19,0,30,11
1649922133885,COGS 102A,A01,083978,Johnson; Christine M.,17,0,30,13
1649922139913,COGS 107B,A01,083980,Staff,4,0,50,46
1649922145944,COGS 115,A01,083982,Staff,14,0,30,16
1649922151968,COGS 118B,A01,083367,Staff,0,11,40,40
1649922157998,COGS 172,A01,083984,Provenzano; Emily Kara,17,0,30,13
1649922164023,COGS 177,A00,083368,Staff,0,17,30,30
1649922170052,COGS 186,A01,083986,Staff,21,0,40,19
1649922176080,COGS 187A,A01,083988,Boyle; Mary E. T.,24,0,60,36
1649922182107,CSE 8A,A50,084003,Miranda; Gregory Joseph,0,0,15,15
1649922188131,CSE 11,A01,084005,Miranda; Gregory Joseph,23,0,55,32
1649922194164,CSE 20,A01,084007,Staff,9,0,20,11
1649922200192,CSE 21,A01,084009,Staff,10,0,50,40
1649922206218,CSE 30,A01,083370,Cao; Yingjun,0,20,40,40
1649922212245,CSE 100,A01,083372,Cao; Yingjun,0,23,40,40
1649922218299,CSE 101,A01,084011,Staff,0,47,40,40
1649922224324,CSE 141,A01,083374,Eldon; John,0,50,75,75
1649922230354,CSE 141L,A01,083376,Eldon; John,0,55,75,75
1649922236385,CSE 175,A01,084013,Kumar; Rakesh,22,0,25,3
1649922242418,CSE 190,A00,092508,Dubnov; Shlomo,15,0,15,0
1649922248444,ECE 5,A01,084049,Morris; Karcher William,15,0,20,5
1649922254473,ECE 100,A01,084051,Baghdadchi; Saharnaz,1,0,20,19
1649922254473,ECE 100,A02,091916,Baghdadchi; Saharnaz,16,0,20,4
1649922260505,ECE 101,A01,084053,Baghdadchi; Saharnaz,5,0,37,32
1649922260505,ECE 101,A02,084054,Baghdadchi; Saharnaz,33,0,37,4
1649922266530,ECE 107,A01,083390,Staff,28,0,40,12
1649922272560,ECE 148,A01,084056,Silberman; Jack,7,0,12,5
1649922278593,ECE 180,A00,083391,Abi Samra; Nicholas Camill,25,0,30,5
1649922278593,ECE 180,B00,083392,Abi Samra; Nicholas Camill,22,0,30,8
1649922284617,MATH 10B,A01,084110,Staff,8,0,30,22
1649922284617,MATH 10B,A02,084111,Staff,29,0,30,1
1649922284617,MATH 10B,A03,084112,Staff,28,0,30,2
1649922290648,MATH 10C,A01,083443,Staff,9,0,30,21
1649922290648,MATH 10C,A02,083444,Staff,16,0,30,14
1649922290648,MATH 10C,B01,084114,Staff,25,0,30,5
1649922290648,MATH 10C,B02,084115,Staff,29,0,30,1
1649922296673,MATH 18,A01,084117,Harel; Guershon,27,0,30,3
1649922296673,MATH 18,A02,084119,Harel; Guershon,29,0,30,1
1649922296673,MATH 18,A03,084120,Harel; Guershon,30,0,30,0
1649922296673,MATH 18,A04,084121,Harel; Guershon,29,0,30,1
1649922302704,MATH 20B,A01,084124,Um; Ko Woon,31,0,35,4
1649922302704,MATH 20B,B01,084126,Um; Ko Woon,32,0,35,3
1649922308731,MATH 20C,A01,083446,Hammock; Frances H,17,0,30,13
1649922308731,MATH 20C,A02,083447,Hammock; Frances H,28,0,30,2
1649922308731,MATH 20C,A03,083448,Hammock; Frances H,30,0,30,0
1649922308731,MATH 20C,A04,083449,Hammock; Frances H,30,0,30,0
1649922308731,MATH 20C,B01,083451,Hammock; Frances H,25,0,30,5
1649922308731,MATH 20C,B02,083452,Hammock; Frances H,27,0,30,3
1649922308731,MATH 20C,B03,083453,Hammock; Frances H,26,0,30,4
1649922308731,MATH 20C,B04,083454,Hammock; Frances H,30,0,30,0
1649922314763,MATH 20D,A01,084128,Staff,26,0,30,4
1649922314763,MATH 20D,A02,084129,Staff,30,0,30,0
1649922314763,MATH 20D,A03,084130,Staff,29,0,30,1
1649922314763,MATH 20D,B01,084133,Staff,21,0,30,9
1649922314763,MATH 20D,B02,084134,Staff,27,0,30,3
1649922314763,MATH 20D,B03,084135,Staff,30,0,30,0
1649922320787,MATH 20E,A01,084138,Staff,22,0,30,8
1649922320787,MATH 20E,A02,084139,Staff,22,0,30,8
1649922320787,MATH 20E,A03,084140,Staff,23,0,30,7
1649922320787,MATH 20E,A04,084141,Staff,25,0,30,5
1649922326813,MATH 102,A01,084143,Harel; Guershon,17,0,30,13
1649922326813,MATH 102,A02,084144,Harel; Guershon,22,0,30,8
1649922332839,MATH 103B,A01,083456,Staff,0,8,30,30
1649922332839,MATH 103B,A02,083457,Staff,0,9,30,30
1649922338864,MATH 109,A01,084146,Salehi Golsefidy; Alireza,28,0,30,2
1649922338864,MATH 109,A02,084147,Salehi Golsefidy; Alireza,22,0,30,8
1649922344890,MATH 120A,A01,085445,Eggers; John Dietrich,20,0,35,15
1649922344890,MATH 120A,A02,085446,Eggers; John Dietrich,28,0,35,7
1649922350914,MATH 142B,A01,084149,Verstraete; Jacques Allan,0,10,30,30
1649922350914,MATH 142B,A02,084150,Verstraete; Jacques Allan,0,9,30,30
1649922356939,MATH 170A,A01,083459,Nie; Jiawang,0,2,30,30
1649922356939,MATH 170A,A02,083460,Nie; Jiawang,0,0,30,30
1649922356939,MATH 170A,A03,083461,Nie; Jiawang,9,0,30,21
1649922362964,MATH 193B,A01,083463,Staff,3,0,30,27
1649922362964,MATH 193B,A02,083464,Staff,10,0,30,20
1649922362964,MATH 193B,A03,083465,Staff,19,0,30,11
1649922369026,COGS 2,A01,083966,Boyle; Mary E. T.,18,0,30,12
1649922375054,COGS 9,A01,083968,Staff,43,0,60,17
1649922381082,COGS 14B,A01,083970,Staff,29,0,50,21
1649922387109,COGS 17,A01,092679,Staff,67,0,75,8
1649922393133,COGS 100,A01,083972,Staff,12,0,60,48
1649922405184,COGS 101C,A01,083976,Staff,19,0,30,11
1649922411206,COGS 102A,A01,083978,Johnson; Christine M.,17,0,30,13
1649922417229,COGS 107B,A01,083980,Staff,4,0,50,46
1649922423258,COGS 115,A01,083982,Staff,14,0,30,16
1649922429284,COGS 118B,A01,083367,Staff,0,11,40,40
1649922435310,COGS 172,A01,083984,Provenzano; Emily Kara,17,0,30,13
1649922441338,COGS 177,A00,083368,Staff,0,17,30,30
1649922447367,COGS 186,A01,083986,Staff,21,0,40,19
1649922453390,COGS 187A,A01,083988,Boyle; Mary E. T.,24,0,60,36
1649922459422,CSE 8A,A50,084003,Miranda; Gregory Joseph,0,0,15,15
1649922465458,CSE 11,A01,084005,Miranda; Gregory Joseph,23,0,55,32
1649922471484,CSE 20,A01,084007,Staff,9,0,20,11
1649922477512,CSE 21,A01,084009,Staff,10,0,50,40
1649922483540,CSE 30,A01,083370,Cao; Yingjun,0,20,40,40
1649922489565,CSE 100,A01,083372,Cao; Yingjun,0,23,40,40
1649922495589,CSE 101,A01,084011,Staff,0,47,40,40
1649922501613,CSE 141,A01,083374,Eldon; John,0,50,75,75
1649922507638,CSE 141L,A01,083376,Eldon; John,0,55,75,75
1649922513662,CSE 175,A01,084013,Kumar; Rakesh,22,0,25,3
1649922519687,CSE 190,A00,092508,Dubnov; Shlomo,15,0,15,0
1649922525715,ECE 5,A01,084049,Morris; Karcher William,15,0,20,5
1649922531748,ECE 100,A01,084051,Baghdadchi; Saharnaz,1,0,20,19
1649922531748,ECE 100,A02,091916,Baghdadchi; Saharnaz,16,0,20,4
1649922537774,ECE 101,A01,084053,Baghdadchi; Saharnaz,5,0,37,32
1649922537774,ECE 101,A02,084054,Baghdadchi; Saharnaz,33,0,37,4
1649922543811,ECE 107,A01,083390,Staff,28,0,40,12
1649922549842,ECE 148,A01,084056,Silberman; Jack,7,0,12,5
1649922555868,ECE 180,A00,083391,Abi Samra; Nicholas Camill,25,0,30,5
1649922555868,ECE 180,B00,083392,Abi Samra; Nicholas Camill,22,0,30,8
1649922561894,MATH 10B,A01,084110,Staff,8,0,30,22
1649922561894,MATH 10B,A02,084111,Staff,29,0,30,1
1649922561894,MATH 10B,A03,084112,Staff,28,0,30,2
1649922567924,MATH 10C,A01,083443,Staff,9,0,30,21
1649922567924,MATH 10C,A02,083444,Staff,16,0,30,14
1649922567924,MATH 10C,B01,084114,Staff,25,0,30,5
1649922567924,MATH 10C,B02,084115,Staff,29,0,30,1
1649922573949,MATH 18,A01,084117,Harel; Guershon,27,0,30,3
1649922573949,MATH 18,A02,084119,Harel; Guershon,29,0,30,1
1649922573949,MATH 18,A03,084120,Harel; Guershon,30,0,30,0
1649922573949,MATH 18,A04,084121,Harel; Guershon,29,0,30,1
1649922579978,MATH 20B,A01,084124,Um; Ko Woon,31,0,35,4
1649922579978,MATH 20B,B01,084126,Um; Ko Woon,32,0,35,3
1649922586004,MATH 20C,A01,083446,Hammock; Frances H,17,0,30,13
1649922586004,MATH 20C,A02,083447,Hammock; Frances H,28,0,30,2
1649922586004,MATH 20C,A03,083448,Hammock; Frances H,30,0,30,0
1649922586004,MATH 20C,A04,083449,Hammock; Frances H,30,0,30,0
1649922586004,MATH 20C,B01,083451,Hammock; Frances H,25,0,30,5
1649922586004,MATH 20C,B02,083452,Hammock; Frances H,27,0,30,3
1649922586004,MATH 20C,B03,083453,Hammock; Frances H,26,0,30,4
1649922586004,MATH 20C,B04,083454,Hammock; Frances H,30,0,30,0
1649922592038,MATH 20D,A01,084128,Staff,26,0,30,4
1649922592038,MATH 20D,A02,084129,Staff,30,0,30,0
1649922592038,MATH 20D,A03,084130,Staff,29,0,30,1
1649922592038,MATH 20D,B01,084133,Staff,21,0,30,9
1649922592038,MATH 20D,B02,084134,Staff,27,0,30,3
1649922592038,MATH 20D,B03,084135,Staff,30,0,30,0
1649922598067,MATH 20E,A01,084138,Staff,22,0,30,8
1649922598067,MATH 20E,A02,084139,Staff,22,0,30,8
1649922598067,MATH 20E,A03,084140,Staff,23,0,30,7
1649922598067,MATH 20E,A04,084141,Staff,25,0,30,5
1649922604091,MATH 102,A01,084143,Harel; Guershon,17,0,30,13
1649922604091,MATH 102,A02,084144,Harel; Guershon,22,0,30,8
1649922610119,MATH 103B,A01,083456,Staff,0,8,30,30
1649922610119,MATH 103B,A02,083457,Staff,0,9,30,30
1649922616146,MATH 109,A01,084146,Salehi Golsefidy; Alireza,28,0,30,2
1649922616146,MATH 109,A02,084147,Salehi Golsefidy; Alireza,22,0,30,8
1649922622185,MATH 120A,A01,085445,Eggers; John Dietrich,20,0,35,15
1649922622185,MATH 120A,A02,085446,Eggers; John Dietrich,28,0,35,7
1649922628208,MATH 142B,A01,084149,Verstraete; Jacques Allan,0,10,30,30
1649922628208,MATH 142B,A02,084150,Verstraete; Jacques Allan,0,9,30,30
1649922634234,MATH 170A,A01,083459,Nie; Jiawang,0,2,30,30
1649922634234,MATH 170A,A02,083460,Nie; Jiawang,0,0,30,30
1649922634234,MATH 170A,A03,083461,Nie; Jiawang,9,0,30,21
1649922640360,MATH 193B,A01,083463,Staff,3,0,30,27
1649922640360,MATH 193B,A02,083464,Staff,10,0,30,20
1649922640360,MATH 193B,A03,083465,Staff,19,0,30,11
1649922646422,COGS 2,A01,083966,Boyle; Mary E. T.,18,0,30,12
1649922652447,COGS 9,A01,083968,Staff,43,0,60,17
1649922658476,COGS 14B,A01,083970,Staff,29,0,50,21
1649922664500,COGS 17,A01,092679,Staff,67,0,75,8
1649922670525,COGS 100,A01,083972,Staff,12,0,60,48
1649922682579,COGS 101C,A01,083976,Staff,19,0,30,11
1649922688605,COGS 102A,A01,083978,Johnson; Christine M.,17,0,30,13
1649922694630,COGS 107B,A01,083980,Staff,4,0,50,46
1649922700656,COGS 115,A01,083982,Staff,14,0,30,16
1649922706683,COGS 118B,A01,083367,Staff,0,11,40,40
1649922712709,COGS 172,A01,083984,Provenzano; Emily Kara,17,0,30,13
1649922718745,COGS 177,A00,083368,Staff,0,17,30,30
1649922724773,COGS 186,A01,083986,Staff,21,0,40,19
1649922730802,COGS 187A,A01,083988,Boyle; Mary E. T.,24,0,60,36
1649922736834,CSE 8A,A50,084003,Miranda; Gregory Joseph,0,0,15,15
1649922742860,CSE 11,A01,084005,Miranda; Gregory Joseph,23,0,55,32
1649922748884,CSE 20,A01,084007,Staff,9,0,20,11
1649922754909,CSE 21,A01,084009,Staff,10,0,50,40
1649922760935,CSE 30,A01,083370,Cao; Yingjun,0,20,40,40
1649922766962,CSE 100,A01,083372,Cao; Yingjun,0,23,40,40
1649922772985,CSE 101,A01,084011,Staff,0,47,40,40
1649922779011,CSE 141,A01,083374,Eldon; John,0,50,75,75
1649922785035,CSE 141L,A01,083376,Eldon; John,0,55,75,75
1649922791062,CSE 175,A01,084013,Kumar; Rakesh,22,0,25,3
1649922797093,CSE 190,A00,092508,Dubnov; Shlomo,15,0,15,0
1649922803118,ECE 5,A01,084049,Morris; Karcher William,15,0,20,5
1649922809144,ECE 100,A01,084051,Baghdadchi; Saharnaz,1,0,20,19
1649922809144,ECE 100,A02,091916,Baghdadchi; Saharnaz,16,0,20,4
1649922815175,ECE 101,A01,084053,Baghdadchi; Saharnaz,5,0,37,32
1649922815175,ECE 101,A02,084054,Baghdadchi; Saharnaz,33,0,37,4
1649922821207,ECE 107,A01,083390,Staff,28,0,40,12
1649922827238,ECE 148,A01,084056,Silberman; Jack,7,0,12,5
1649922833262,ECE 180,A00,083391,Abi Samra; Nicholas Camill,25,0,30,5
1649922833262,ECE 180,B00,083392,Abi Samra; Nicholas Camill,22,0,30,8
1649922839296,MATH 10B,A01,084110,Staff,8,0,30,22
1649922839296,MATH 10B,A02,084111,Staff,29,0,30,1
1649922839296,MATH 10B,A03,084112,Staff,28,0,30,2
1649922845329,MATH 10C,A01,083443,Staff,9,0,30,21
1649922845329,MATH 10C,A02,083444,Staff,16,0,30,14
1649922845329,MATH 10C,B01,084114,Staff,25,0,30,5
1649922845329,MATH 10C,B02,084115,Staff,29,0,30,1
1649922851355,MATH 18,A01,084117,Harel; Guershon,27,0,30,3
1649922851355,MATH 18,A02,084119,Harel; Guershon,29,0,30,1
1649922851355,MATH 18,A03,084120,Harel; Guershon,30,0,30,0
1649922851355,MATH 18,A04,084121,Harel; Guershon,29,0,30,1
1649922857387,MATH 20B,A01,084124,Um; Ko Woon,31,0,35,4
1649922857387,MATH 20B,B01,084126,Um; Ko Woon,32,0,35,3
1649922863424,MATH 20C,A01,083446,Hammock; Frances H,17,0,30,13
1649922863424,MATH 20C,A02,083447,Hammock; Frances H,28,0,30,2
1649922863424,MATH 20C,A03,083448,Hammock; Frances H,30,0,30,0
1649922863424,MATH 20C,A04,083449,Hammock; Frances H,30,0,30,0
1649922863424,MATH 20C,B01,083451,Hammock; Frances H,25,0,30,5
1649922863424,MATH 20C,B02,083452,Hammock; Frances H,27,0,30,3
1649922863424,MATH 20C,B03,083453,Hammock; Frances H,26,0,30,4
1649922863424,MATH 20C,B04,083454,Hammock; Frances H,30,0,30,0
1649922869452,MATH 20D,A01,084128,Staff,26,0,30,4
1649922869452,MATH 20D,A02,084129,Staff,30,0,30,0
1649922869452,MATH 20D,A03,084130,Staff,29,0,30,1
1649922869452,MATH 20D,B01,084133,Staff,21,0,30,9
1649922869452,MATH 20D,B02,084134,Staff,27,0,30,3
1649922869452,MATH 20D,B03,084135,Staff,30,0,30,0
1649922875480,MATH 20E,A01,084138,Staff,22,0,30,8
1649922875480,MATH 20E,A02,084139,Staff,22,0,30,8
1649922875480,MATH 20E,A03,084140,Staff,23,0,30,7
1649922875480,MATH 20E,A04,084141,Staff,25,0,30,5
1649922881509,MATH 102,A01,084143,Harel; Guershon,17,0,30,13
1649922881509,MATH 102,A02,084144,Harel; Guershon,22,0,30,8
1649922887540,MATH 103B,A01,083456,Staff,0,8,30,30
1649922887540,MATH 103B,A02,083457,Staff,0,9,30,30
1649922893570,MATH 109,A01,084146,Salehi Golsefidy; Alireza,28,0,30,2
1649922893570,MATH 109,A02,084147,Salehi Golsefidy; Alireza,22,0,30,8
1649922899598,MATH 120A,A01,085445,Eggers; John Dietrich,20,0,35,15
1649922899598,MATH 120A,A02,085446,Eggers; John Dietrich,28,0,35,7
1649922905632,MATH 142B,A01,084149,Verstraete; Jacques Allan,0,10,30,30
1649922905632,MATH 142B,A02,084150,Verstraete; Jacques Allan,0,9,30,30
1649922911663,MATH 170A,A01,083459,Nie; Jiawang,0,2,30,30
1649922911663,MATH 170A,A02,083460,Nie; Jiawang,0,0,30,30
1649922911663,MATH 170A,A03,083461,Nie; Jiawang,9,0,30,21
1649922917696,MATH 193B,A01,083463,Staff,3,0,30,27
1649922917696,MATH 193B,A02,083464,Staff,10,0,30,20
1649922917696,MATH 193B,A03,083465,Staff,19,0,30,11
1649922923765,COGS 2,A01,083966,Boyle; Mary E. T.,18,0,30,12
1649922929793,COGS 9,A01,083968,Staff,43,0,60,17
1649922935822,COGS 14B,A01,083970,Staff,29,0,50,21
1649922941853,COGS 17,A01,092679,Staff,67,0,75,8
1649922947879,COGS 100,A01,083972,Staff,12,0,60,48
1649922959936,COGS 101C,A01,083976,Staff,19,0,30,11
1649922965961,COGS 102A,A01,083978,Johnson; Christine M.,17,0,30,13
1649922971985,COGS 107B,A01,083980,Staff,4,0,50,46
1649922978012,COGS 115,A01,083982,Staff,14,0,30,16
1649922984038,COGS 118B,A01,083367,Staff,0,11,40,40
1649922990075,COGS 172,A01,083984,Provenzano; Emily Kara,17,0,30,13
1649922996104,COGS 177,A00,083368,Staff,0,17,30,30
1649923002129,COGS 186,A01,083986,Staff,21,0,40,19
1649923008152,COGS 187A,A01,083988,Boyle; Mary E. T.,24,0,60,36
1649923014179,CSE 8A,A50,084003,Miranda; Gregory Joseph,0,0,15,15
1649923020207,CSE 11,A01,084005,Miranda; Gregory Joseph,23,0,55,32
1649923026234,CSE 20,A01,084007,Staff,9,0,20,11
1649923032264,CSE 21,A01,084009,Staff,10,0,50,40
1649923038289,CSE 30,A01,083370,Cao; Yingjun,0,20,40,40
1649923044316,CSE 100,A01,083372,Cao; Yingjun,0,23,40,40
1649923050341,CSE 101,A01,084011,Staff,0,47,40,40
1649923056365,CSE 141,A01,083374,Eldon; John,0,50,75,75
1649923062406,CSE 141L,A01,083376,Eldon; John,0,55,75,75
1649923068428,CSE 175,A01,084013,Kumar; Rakesh,22,0,25,3
1649923074457,CSE 190,A00,092508,Dubnov; Shlomo,15,0,15,0
1649923080480,ECE 5,A01,084049,Morris; Karcher William,15,0,20,5
1649923086513,ECE 100,A01,084051,Baghdadchi; Saharnaz,1,0,20,19
1649923086513,ECE 100,A02,091916,Baghdadchi; Saharnaz,16,0,20,4
1649923092542,ECE 101,A01,084053,Baghdadchi; Saharnaz,5,0,37,32
1649923092542,ECE 101,A02,084054,Baghdadchi; Saharnaz,33,0,37,4
1649923098567,ECE 107,A01,083390,Staff,28,0,40,12
1649923104591,ECE 148,A01,084056,Silberman; Jack,7,0,12,5
1649923110617,ECE 180,A00,083391,Abi Samra; Nicholas Camill,25,0,30,5
1649923110617,ECE 180,B00,083392,Abi Samra; Nicholas Camill,22,0,30,8
1649923116643,MATH 10B,A01,084110,Staff,8,0,30,22
1649923116643,MATH 10B,A02,084111,Staff,29,0,30,1
1649923116643,MATH 10B,A03,084112,Staff,28,0,30,2
1649923122669,MATH 10C,A01,083443,Staff,9,0,30,21
1649923122669,MATH 10C,A02,083444,Staff,16,0,30,14
1649923122669,MATH 10C,B01,084114,Staff,25,0,30,5
1649923122669,MATH 10C,B02,084115,Staff,29,0,30,1
1649923128701,MATH 18,A01,084117,Harel; Guershon,27,0,30,3
1649923128701,MATH 18,A02,084119,Harel; Guershon,29,0,30,1
1649923128701,MATH 18,A03,084120,Harel; Guershon,30,0,30,0
1649923128701,MATH 18,A04,084121,Harel; Guershon,29,0,30,1
1649923134728,MATH 20B,A01,084124,Um; Ko Woon,31,0,35,4
1649923134728,MATH 20B,B01,084126,Um; Ko Woon,32,0,35,3
1649923140761,MATH 20C,A01,083446,Hammock; Frances H,17,0,30,13
1649923140761,MATH 20C,A02,083447,Hammock; Frances H,28,0,30,2
1649923140761,MATH 20C,A03,083448,Hammock; Frances H,30,0,30,0
1649923140761,MATH 20C,A04,083449,Hammock; Frances H,30,0,30,0
1649923140761,MATH 20C,B01,083451,Hammock; Frances H,25,0,30,5
1649923140761,MATH 20C,B02,083452,Hammock; Frances H,27,0,30,3
1649923140761,MATH 20C,B03,083453,Hammock; Frances H,26,0,30,4
1649923140761,MATH 20C,B04,083454,Hammock; Frances H,30,0,30,0
1649923146792,MATH 20D,A01,084128,Staff,26,0,30,4
1649923146792,MATH 20D,A02,084129,Staff,30,0,30,0
1649923146792,MATH 20D,A03,084130,Staff,29,0,30,1
1649923146792,MATH 20D,B01,084133,Staff,21,0,30,9
1649923146792,MATH 20D,B02,084134,Staff,27,0,30,3
1649923146792,MATH 20D,B03,084135,Staff,30,0,30,0
1649923152816,MATH 20E,A01,084138,Staff,22,0,30,8
1649923152816,MATH 20E,A02,084139,Staff,22,0,30,8
1649923152816,MATH 20E,A03,084140,Staff,23,0,30,7
1649923152816,MATH 20E,A04,084141,Staff,25,0,30,5
1649923158841,MATH 102,A01,084143,Harel; Guershon,17,0,30,13
1649923158841,MATH 102,A02,084144,Harel; Guershon,22,0,30,8
1649923164866,MATH 103B,A01,083456,Staff,0,8,30,30
1649923164866,MATH 103B,A02,083457,Staff,0,9,30,30
1649923170896,MATH 109,A01,084146,Salehi Golsefidy; Alireza,28,0,30,2
1649923170896,MATH 109,A02,084147,Salehi Golsefidy; Alireza,22,0,30,8
1649923176922,MATH 120A,A01,085445,Eggers; John Dietrich,20,0,35,15
1649923176922,MATH 120A,A02,085446,Eggers; John Dietrich,28,0,35,7
1649923182947,MATH 142B,A01,084149,Verstraete; Jacques Allan,0,10,30,30
1649923182947,MATH 142B,A02,084150,Verstraete; Jacques Allan,0,9,30,30
1649923188973,MATH 170A,A01,083459,Nie; Jiawang,0,2,30,30
1649923188973,MATH 170A,A02,083460,Nie; Jiawang,0,0,30,30
1649923188973,MATH 170A,A03,083461,Nie; Jiawang,9,0,30,21
1649923195001,MATH 193B,A01,083463,Staff,3,0,30,27
1649923195001,MATH 193B,A02,083464,Staff,10,0,30,20
1649923195001,MATH 193B,A03,083465,Staff,19,0,30,11
1649923201072,COGS 2,A01,083966,Boyle; Mary E. T.,18,0,30,12
1649923207096,COGS 9,A01,083968,Staff,43,0,60,17
1649923213121,COGS 14B,A01,083970,Staff,29,0,50,21
1649923219147,COGS 17,A01,092679,Staff,67,0,75,8
1649923225173,COGS 100,A01,083972,Staff,12,0,60,48
1649923237295,COGS 101C,A01,083976,Staff,19,0,30,11
1649923243322,COGS 102A,A01,083978,Johnson; Christine M.,17,0,30,13
1649923249348,COGS 107B,A01,083980,Staff,4,0,50,46
1649923255373,COGS 115,A01,083982,Staff,14,0,30,16
1649923261407,COGS 118B,A01,083367,Staff,0,11,40,40
1649923267431,COGS 172,A01,083984,Provenzano; Emily Kara,17,0,30,13
1649923273455,COGS 177,A00,083368,Staff,0,17,30,30
1649923279483,COGS 186,A01,083986,Staff,21,0,40,19
1649923285513,COGS 187A,A01,083988,Boyle; Mary E. T.,24,0,60,36
1649923291548,CSE 8A,A50,084003,Miranda; Gregory Joseph,0,0,15,15
1649923297571,CSE 11,A01,084005,Miranda; Gregory Joseph,23,0,55,32
1649923303597,CSE 20,A01,084007,Staff,9,0,20,11
1649923309622,CSE 21,A01,084009,Staff,10,0,50,40
1649923315651,CSE 30,A01,083370,Cao; Yingjun,0,20,40,40
1649923321679,CSE 100,A01,083372,Cao; Yingjun,0,23,40,40
1649923327704,CSE 101,A01,084011,Staff,0,47,40,40
1649923333731,CSE 141,A01,083374,Eldon; John,0,50,75,75
1649923339756,CSE 141L,A01,083376,Eldon; John,0,55,75,75
1649923345794,CSE 175,A01,084013,Kumar; Rakesh,22,0,25,3
1649923351819,CSE 190,A00,092508,Dubnov; Shlomo,15,0,15,0
1649923357844,ECE 5,A01,084049,Morris; Karcher William,15,0,20,5
1649923363875,ECE 100,A01,084051,Baghdadchi; Saharnaz,1,0,20,19
1649923363875,ECE 100,A02,091916,Baghdadchi; Saharnaz,16,0,20,4
1649923369905,ECE 101,A01,084053,Baghdadchi; Saharnaz,5,0,37,32
1649923369905,ECE 101,A02,084054,Baghdadchi; Saharnaz,33,0,37,4
1649923375934,ECE 107,A01,083390,Staff,28,0,40,12
1649923381959,ECE 148,A01,084056,Silberman; Jack,7,0,12,5
1649923387984,ECE 180,A00,083391,Abi Samra; Nicholas Camill,25,0,30,5
1649923387984,ECE 180,B00,083392,Abi Samra; Nicholas Camill,22,0,30,8
1649923394014,MATH 10B,A01,084110,Staff,8,0,30,22
1649923394014,MATH 10B,A02,084111,Staff,29,0,30,1
1649923394014,MATH 10B,A03,084112,Staff,28,0,30,2
1649923400042,MATH 10C,A01,083443,Staff,9,0,30,21
1649923400042,MATH 10C,A02,083444,Staff,16,0,30,14
1649923400042,MATH 10C,B01,084114,Staff,25,0,30,5
1649923400042,MATH 10C,B02,084115,Staff,29,0,30,1
1649923406073,MATH 18,A01,084117,Harel; Guershon,27,0,30,3
1649923406073,MATH 18,A02,084119,Harel; Guershon,29,0,30,1
1649923406073,MATH 18,A03,084120,Harel; Guershon,30,0,30,0
1649923406073,MATH 18,A04,084121,Harel; Guershon,29,0,30,1
1649923412102,MATH 20B,A01,084124,Um; Ko Woon,31,0,35,4
1649923412102,MATH 20B,B01,084126,Um; Ko Woon,32,0,35,3
1649923418133,MATH 20C,A01,083446,Hammock; Frances H,17,0,30,13
1649923418133,MATH 20C,A02,083447,Hammock; Frances H,28,0,30,2
1649923418133,MATH 20C,A03,083448,Hammock; Frances H,30,0,30,0
1649923418133,MATH 20C,A04,083449,Hammock; Frances H,30,0,30,0
1649923418133,MATH 20C,B01,083451,Hammock; Frances H,25,0,30,5
1649923418133,MATH 20C,B02,083452,Hammock; Frances H,27,0,30,3
1649923418133,MATH 20C,B03,083453,Hammock; Frances H,26,0,30,4
1649923418133,MATH 20C,B04,083454,Hammock; Frances H,30,0,30,0
1649923424162,MATH 20D,A01,084128,Staff,26,0,30,4
1649923424162,MATH 20D,A02,084129,Staff,30,0,30,0
1649923424162,MATH 20D,A03,084130,Staff,29,0,30,1
1649923424162,MATH 20D,B01,084133,Staff,21,0,30,9
1649923424162,MATH 20D,B02,084134,Staff,27,0,30,3
1649923424162,MATH 20D,B03,084135,Staff,30,0,30,0
1649923430187,MATH 20E,A01,084138,Staff,22,0,30,8
1649923430187,MATH 20E,A02,084139,Staff,22,0,30,8
1649923430187,MATH 20E,A03,084140,Staff,23,0,30,7
1649923430187,MATH 20E,A04,084141,Staff,25,0,30,5
1649923436215,MATH 102,A01,084143,Harel; Guershon,17,0,30,13
1649923436215,MATH 102,A02,084144,Harel; Guershon,22,0,30,8
1649923442239,MATH 103B,A01,083456,Staff,0,8,30,30
1649923442239,MATH 103B,A02,083457,Staff,0,9,30,30
1649923448264,MATH 109,A01,084146,Salehi Golsefidy; Alireza,28,0,30,2
1649923448264,MATH 109,A02,084147,Salehi Golsefidy; Alireza,22,0,30,8
1649923454293,MATH 120A,A01,085445,Eggers; John Dietrich,20,0,35,15
1649923454293,MATH 120A,A02,085446,Eggers; John Dietrich,28,0,35,7
1649923460321,MATH 142B,A01,084149,Verstraete; Jacques Allan,0,10,30,30
1649923460321,MATH 142B,A02,084150,Verstraete; Jacques Allan,0,9,30,30
1649923466348,MATH 170A,A01,083459,Nie; Jiawang,0,2,30,30
1649923466348,MATH 170A,A02,083460,Nie; Jiawang,0,0,30,30
1649923466348,MATH 170A,A03,083461,Nie; Jiawang,9,0,30,21
1649923472374,MATH 193B,A01,083463,Staff,3,0,30,27
1649923472374,MATH 193B,A02,083464,Staff,10,0,30,20
1649923472374,MATH 193B,A03,083465,Staff,19,0,30,11
1649923478437,COGS 2,A01,083966,Boyle; Mary E. T.,18,0,30,12
1649923484462,COGS 9,A01,083968,Staff,43,0,60,17
1649923490487,COGS 14B,A01,083970,Staff,29,0,50,21
1649923496510,COGS 17,A01,092679,Staff,67,0,75,8
1649923502535,COGS 100,A01,083972,Staff,12,0,60,48
1649923514588,COGS 101C,A01,083976,Staff,19,0,30,11
1649923520611,COGS 102A,A01,083978,Johnson; Christine M.,17,0,30,13
1649923526634,COGS 107B,A01,083980,Staff,4,0,50,46
1649923532658,COGS 115,A01,083982,Staff,14,0,30,16
1649923538682,COGS 118B,A01,083367,Staff,0,11,40,40
1649923544708,COGS 172,A01,083984,Provenzano; Emily Kara,17,0,30,13
1649923550736,COGS 177,A00,083368,Staff,0,17,30,30
1649923556759,COGS 186,A01,083986,Staff,21,0,40,19
1649923562788,COGS 187A,A01,083988,Boyle; Mary E. T.,24,0,60,36
1649923568811,CSE 8A,A50,084003,Miranda; Gregory Joseph,0,0,15,15
1649923574836,CSE 11,A01,084005,Miranda; Gregory Joseph,23,0,55,32
1649923580863,CSE 20,A01,084007,Staff,9,0,20,11
1649923586890,CSE 21,A01,084009,Staff,10,0,50,40
1649923592915,CSE 30,A01,083370,Cao; Yingjun,0,20,40,40
1649923598941,CSE 100,A01,083372,Cao; Yingjun,0,23,40,40
1649923604973,CSE 101,A01,084011,Staff,0,47,40,40
1649923610998,CSE 141,A01,083374,Eldon; John,0,50,75,75
1649923617029,CSE 141L,A01,083376,Eldon; John,0,55,75,75
1649923623054,CSE 175,A01,084013,Kumar; Rakesh,22,0,25,3
1649923629083,CSE 190,A00,092508,Dubnov; Shlomo,15,0,15,0
1649923635112,ECE 5,A01,084049,Morris; Karcher William,15,0,20,5
1649923641138,ECE 100,A01,084051,Baghdadchi; Saharnaz,1,0,20,19
1649923641138,ECE 100,A02,091916,Baghdadchi; Saharnaz,16,0,20,4
1649923647165,ECE 101,A01,084053,Baghdadchi; Saharnaz,5,0,37,32
1649923647165,ECE 101,A02,084054,Baghdadchi; Saharnaz,33,0,37,4
1649923653193,ECE 107,A01,083390,Staff,28,0,40,12
1649923659219,ECE 148,A01,084056,Silberman; Jack,7,0,12,5
1649923665242,ECE 180,A00,083391,Abi Samra; Nicholas Camill,25,0,30,5
1649923665242,ECE 180,B00,083392,Abi Samra; Nicholas Camill,22,0,30,8
1649923671272,MATH 10B,A01,084110,Staff,8,0,30,22
1649923671272,MATH 10B,A02,084111,Staff,29,0,30,1
1649923671272,MATH 10B,A03,084112,Staff,28,0,30,2
1649923677300,MATH 10C,A01,083443,Staff,9,0,30,21
1649923677300,MATH 10C,A02,083444,Staff,16,0,30,14
1649923677300,MATH 10C,B01,084114,Staff,25,0,30,5
1649923677300,MATH 10C,B02,084115,Staff,29,0,30,1
1649923683325,MATH 18,A01,084117,Harel; Guershon,27,0,30,3
1649923683325,MATH 18,A02,084119,Harel; Guershon,29,0,30,1
1649923683325,MATH 18,A03,084120,Harel; Guershon,30,0,30,0
1649923683325,MATH 18,A04,084121,Harel; Guershon,29,0,30,1
1649923689349,MATH 20B,A01,084124,Um; Ko Woon,31,0,35,4
1649923689349,MATH 20B,B01,084126,Um; Ko Woon,32,0,35,3
1649923695373,MATH 20C,A01,083446,Hammock; Frances H,17,0,30,13
1649923695373,MATH 20C,A02,083447,Hammock; Frances H,28,0,30,2
1649923695373,MATH 20C,A03,083448,Hammock; Frances H,30,0,30,0
1649923695373,MATH 20C,A04,083449,Hammock; Frances H,30,0,30,0
1649923695373,MATH 20C,B01,083451,Hammock; Frances H,25,0,30,5
1649923695373,MATH 20C,B02,083452,Hammock; Frances H,27,0,30,3
1649923695373,MATH 20C,B03,083453,Hammock; Frances H,26,0,30,4
1649923695373,MATH 20C,B04,083454,Hammock; Frances H,30,0,30,0
1649923701397,MATH 20D,A01,084128,Staff,26,0,30,4
1649923701397,MATH 20D,A02,084129,Staff,30,0,30,0
1649923701397,MATH 20D,A03,084130,Staff,29,0,30,1
1649923701397,MATH 20D,B01,084133,Staff,21,0,30,9
1649923701397,MATH 20D,B02,084134,Staff,27,0,30,3
1649923701397,MATH 20D,B03,084135,Staff,30,0,30,0
1649923707427,MATH 20E,A01,084138,Staff,22,0,30,8
1649923707427,MATH 20E,A02,084139,Staff,22,0,30,8
1649923707427,MATH 20E,A03,084140,Staff,23,0,30,7
1649923707427,MATH 20E,A04,084141,Staff,25,0,30,5
1649923713453,MATH 102,A01,084143,Harel; Guershon,17,0,30,13
1649923713453,MATH 102,A02,084144,Harel; Guershon,22,0,30,8
1649923719480,MATH 103B,A01,083456,Staff,0,8,30,30
1649923719480,MATH 103B,A02,083457,Staff,0,9,30,30
1649923725508,MATH 109,A01,084146,Salehi Golsefidy; Alireza,28,0,30,2
1649923725508,MATH 109,A02,084147,Salehi Golsefidy; Alireza,22,0,30,8
1649923731532,MATH 120A,A01,085445,Eggers; John Dietrich,20,0,35,15
1649923731532,MATH 120A,A02,085446,Eggers; John Dietrich,28,0,35,7
1649923737562,MATH 142B,A01,084149,Verstraete; Jacques Allan,0,10,30,30
1649923737562,MATH 142B,A02,084150,Verstraete; Jacques Allan,0,9,30,30
1649923743587,MATH 170A,A01,083459,Nie; Jiawang,0,2,30,30
1649923743587,MATH 170A,A02,083460,Nie; Jiawang,0,0,30,30
1649923743587,MATH 170A,A03,083461,Nie; Jiawang,9,0,30,21
1649923749610,MATH 193B,A01,083463,Staff,3,0,30,27
1649923749610,MATH 193B,A02,083464,Staff,10,0,30,20
1649923749610,MATH 193B,A03,083465,Staff,19,0,30,11
1649923755683,COGS 2,A01,083966,Boyle; Mary E. T.,18,0,30,12
1649923761710,COGS 9,A01,083968,Staff,43,0,60,17
1649923767734,COGS 14B,A01,083970,Staff,29,0,50,21
1649923773760,COGS 17,A01,092679,Staff,67,0,75,8
1649923779784,COGS 100,A01,083972,Staff,11,0,60,49
1649923791837,COGS 101C,A01,083976,Staff,19,0,30,11
1649923797862,COGS 102A,A01,083978,Johnson; Christine M.,17,0,30,13
1649923803890,COGS 107B,A01,083980,Staff,3,0,50,47
1649923809914,COGS 115,A01,083982,Staff,14,0,30,16
1649923815937,COGS 118B,A01,083367,Staff,0,11,40,40
1649923821961,COGS 172,A01,083984,Provenzano; Emily Kara,17,0,30,13
1649923828075,COGS 177,A00,083368,Staff,0,17,30,30
1649923834100,COGS 186,A01,083986,Staff,21,0,40,19
1649923840129,COGS 187A,A01,083988,Boyle; Mary E. T.,24,0,60,36
1649923846153,CSE 8A,A50,084003,Miranda; Gregory Joseph,0,0,15,15
1649923852180,CSE 11,A01,084005,Miranda; Gregory Joseph,23,0,55,32
1649923858249,CSE 20,A01,084007,Staff,9,0,20,11
1649923864272,CSE 21,A01,084009,Staff,10,0,50,40
1649923870304,CSE 30,A01,083370,Cao; Yingjun,0,20,40,40
1649923876333,CSE 100,A01,083372,Cao; Yingjun,0,23,40,40
1649923882358,CSE 101,A01,084011,Staff,0,47,40,40
1649923888388,CSE 141,A01,083374,Eldon; John,0,50,75,75
1649923894416,CSE 141L,A01,083376,Eldon; John,0,55,75,75
1649923900448,CSE 175,A01,084013,Kumar; Rakesh,22,0,25,3
1649923906473,CSE 190,A00,092508,Dubnov; Shlomo,15,0,15,0
1649923912498,ECE 5,A01,084049,Morris; Karcher William,15,0,20,5
1649923918524,ECE 100,A01,084051,Baghdadchi; Saharnaz,1,0,20,19
1649923918524,ECE 100,A02,091916,Baghdadchi; Saharnaz,16,0,20,4
1649923924557,ECE 101,A01,084053,Baghdadchi; Saharnaz,5,0,37,32
1649923924557,ECE 101,A02,084054,Baghdadchi; Saharnaz,33,0,37,4
1649923930587,ECE 107,A01,083390,Staff,28,0,40,12
1649923936611,ECE 148,A01,084056,Silberman; Jack,7,0,12,5
1649923942640,ECE 180,A00,083391,Abi Samra; Nicholas Camill,25,0,30,5
1649923942640,ECE 180,B00,083392,Abi Samra; Nicholas Camill,22,0,30,8
1649923948673,MATH 10B,A01,084110,Staff,8,0,30,22
1649923948673,MATH 10B,A02,084111,Staff,29,0,30,1
1649923948673,MATH 10B,A03,084112,Staff,28,0,30,2
1649923954702,MATH 10C,A01,083443,Staff,9,0,30,21
1649923954702,MATH 10C,A02,083444,Staff,16,0,30,14
1649923954702,MATH 10C,B01,084114,Staff,25,0,30,5
1649923954702,MATH 10C,B02,084115,Staff,29,0,30,1
1649923960729,MATH 18,A01,084117,Harel; Guershon,27,0,30,3
1649923960729,MATH 18,A02,084119,Harel; Guershon,29,0,30,1
1649923960729,MATH 18,A03,084120,Harel; Guershon,30,0,30,0
1649923960729,MATH 18,A04,084121,Harel; Guershon,29,0,30,1
1649923966760,MATH 20B,A01,084124,Um; Ko Woon,31,0,35,4
1649923966760,MATH 20B,B01,084126,Um; Ko Woon,32,0,35,3
1649923972787,MATH 20C,A01,083446,Hammock; Frances H,17,0,30,13
1649923972787,MATH 20C,A02,083447,Hammock; Frances H,28,0,30,2
1649923972787,MATH 20C,A03,083448,Hammock; Frances H,30,0,30,0
1649923972787,MATH 20C,A04,083449,Hammock; Frances H,30,0,30,0
1649923972787,MATH 20C,B01,083451,Hammock; Frances H,25,0,30,5
1649923972787,MATH 20C,B02,083452,Hammock; Frances H,27,0,30,3
1649923972787,MATH 20C,B03,083453,Hammock; Frances H,26,0,30,4
1649923972787,MATH 20C,B04,083454,Hammock; Frances H,30,0,30,0
1649923978821,MATH 20D,A01,084128,Staff,26,0,30,4
1649923978821,MATH 20D,A02,084129,Staff,30,0,30,0
1649923978821,MATH 20D,A03,084130,Staff,29,0,30,1
1649923978821,MATH 20D,B01,084133,Staff,21,0,30,9
1649923978821,MATH 20D,B02,084134,Staff,27,0,30,3
1649923978821,MATH 20D,B03,084135,Staff,30,0,30,0
1649923984847,MATH 20E,A01,084138,Staff,22,0,30,8
1649923984847,MATH 20E,A02,084139,Staff,22,0,30,8
1649923984847,MATH 20E,A03,084140,Staff,23,0,30,7
1649923984847,MATH 20E,A04,084141,Staff,25,0,30,5
1649923990871,MATH 102,A01,084143,Harel; Guershon,17,0,30,13
1649923990871,MATH 102,A02,084144,Harel; Guershon,22,0,30,8
1649923996898,MATH 103B,A01,083456,Staff,0,8,30,30
1649923996898,MATH 103B,A02,083457,Staff,0,9,30,30
1649924002926,MATH 109,A01,084146,Salehi Golsefidy; Alireza,28,0,30,2
1649924002926,MATH 109,A02,084147,Salehi Golsefidy; Alireza,22,0,30,8
1649924008952,MATH 120A,A01,085445,Eggers; John Dietrich,20,0,35,15
1649924008952,MATH 120A,A02,085446,Eggers; John Dietrich,28,0,35,7
1649924014983,MATH 142B,A01,084149,Verstraete; Jacques Allan,0,10,30,30
1649924014983,MATH 142B,A02,084150,Verstraete; Jacques Allan,0,9,30,30
1649924021015,MATH 170A,A01,083459,Nie; Jiawang,0,2,30,30
1649924021015,MATH 170A,A02,083460,Nie; Jiawang,0,0,30,30
1649924021015,MATH 170A,A03,083461,Nie; Jiawang,9,0,30,21
1649924027046,MATH 193B,A01,083463,Staff,3,0,30,27
1649924027046,MATH 193B,A02,083464,Staff,10,0,30,20
1649924027046,MATH 193B,A03,083465,Staff,19,0,30,11
1649924033104,COGS 2,A01,083966,Boyle; Mary E. T.,18,0,30,12
1649924039128,COGS 9,A01,083968,Staff,43,0,60,17
1649924045153,COGS 14B,A01,083970,Staff,29,0,50,21
1649924051176,COGS 17,A01,092679,Staff,67,0,75,8
1649924057200,COGS 100,A01,083972,Staff,11,0,60,49
1649924069260,COGS 101C,A01,083976,Staff,19,0,30,11
1649924075292,COGS 102A,A01,083978,Johnson; Christine M.,17,0,30,13
1649924081320,COGS 107B,A01,083980,Staff,3,0,50,47
1649924087346,COGS 115,A01,083982,Staff,14,0,30,16
1649924093370,COGS 118B,A01,083367,Staff,0,11,40,40
1649924099393,COGS 172,A01,083984,Provenzano; Emily Kara,17,0,30,13
1649924105421,COGS 177,A00,083368,Staff,0,17,30,30
1649924111443,COGS 186,A01,083986,Staff,21,0,40,19
1649924117473,COGS 187A,A01,083988,Boyle; Mary E. T.,24,0,60,36
1649924123497,CSE 8A,A50,084003,Miranda; Gregory Joseph,0,0,15,15
1649924129525,CSE 11,A01,084005,Miranda; Gregory Joseph,23,0,55,32
1649924135561,CSE 20,A01,084007,Staff,9,0,20,11
1649924141585,CSE 21,A01,084009,Staff,10,0,50,40
1649924147613,CSE 30,A01,083370,Cao; Yingjun,0,20,40,40
1649924153637,CSE 100,A01,083372,Cao; Yingjun,0,23,40,40
1649924159671,CSE 101,A01,084011,Staff,0,48,40,40
1649924165694,CSE 141,A01,083374,Eldon; John,0,51,75,75
1649924171719,CSE 141L,A01,083376,Eldon; John,0,56,75,75
1649924177744,CSE 175,A01,084013,Kumar; Rakesh,22,0,25,3
1649924183767,CSE 190,A00,092508,Dubnov; Shlomo,15,0,15,0
1649924189796,ECE 5,A01,084049,Morris; Karcher William,15,0,20,5
1649924195821,ECE 100,A01,084051,Baghdadchi; Saharnaz,1,0,20,19
1649924195821,ECE 100,A02,091916,Baghdadchi; Saharnaz,16,0,20,4
1649924201858,ECE 101,A01,084053,Baghdadchi; Saharnaz,5,0,37,32
1649924201858,ECE 101,A02,084054,Baghdadchi; Saharnaz,33,0,37,4
1649924207889,ECE 107,A01,083390,Staff,28,0,40,12
1649924213914,ECE 148,A01,084056,Silberman; Jack,7,0,12,5
1649924219939,ECE 180,A00,083391,Abi Samra; Nicholas Camill,25,0,30,5
1649924219939,ECE 180,B00,083392,Abi Samra; Nicholas Camill,22,0,30,8
1649924225963,MATH 10B,A01,084110,Staff,8,0,30,22
1649924225963,MATH 10B,A02,084111,Staff,29,0,30,1
1649924225963,MATH 10B,A03,084112,Staff,28,0,30,2
1649924231994,MATH 10C,A01,083443,Staff,9,0,30,21
1649924231994,MATH 10C,A02,083444,Staff,16,0,30,14
1649924231994,MATH 10C,B01,084114,Staff,25,0,30,5
1649924231994,MATH 10C,B02,084115,Staff,29,0,30,1
1649924238019,MATH 18,A01,084117,Harel; Guershon,27,0,30,3
1649924238019,MATH 18,A02,084119,Harel; Guershon,29,0,30,1
1649924238019,MATH 18,A03,084120,Harel; Guershon,30,0,30,0
1649924238019,MATH 18,A04,084121,Harel; Guershon,29,0,30,1
1649924244047,MATH 20B,A01,084124,Um; Ko Woon,31,0,35,4
1649924244047,MATH 20B,B01,084126,Um; Ko Woon,32,0,35,3
1649924250078,MATH 20C,A01,083446,Hammock; Frances H,17,0,30,13
1649924250078,MATH 20C,A02,083447,Hammock; Frances H,28,0,30,2
1649924250078,MATH 20C,A03,083448,Hammock; Frances H,30,0,30,0
1649924250078,MATH 20C,A04,083449,Hammock; Frances H,30,0,30,0
1649924250078,MATH 20C,B01,083451,Hammock; Frances H,25,0,30,5
1649924250078,MATH 20C,B02,083452,Hammock; Frances H,27,0,30,3
1649924250078,MATH 20C,B03,083453,Hammock; Frances H,26,0,30,4
1649924250078,MATH 20C,B04,083454,Hammock; Frances H,30,0,30,0
1649924256107,MATH 20D,A01,084128,Staff,26,0,30,4
1649924256107,MATH 20D,A02,084129,Staff,30,0,30,0
1649924256107,MATH 20D,A03,084130,Staff,29,0,30,1
1649924256107,MATH 20D,B01,084133,Staff,21,0,30,9
1649924256107,MATH 20D,B02,084134,Staff,27,0,30,3
1649924256107,MATH 20D,B03,084135,Staff,30,0,30,0
1649924262131,MATH 20E,A01,084138,Staff,22,0,30,8
1649924262131,MATH 20E,A02,084139,Staff,22,0,30,8
1649924262131,MATH 20E,A03,084140,Staff,23,0,30,7
1649924262131,MATH 20E,A04,084141,Staff,25,0,30,5
1649924268158,MATH 102,A01,084143,Harel; Guershon,17,0,30,13
1649924268158,MATH 102,A02,084144,Harel; Guershon,22,0,30,8
1649924274180,MATH 103B,A01,083456,Staff,0,8,30,30
1649924274180,MATH 103B,A02,083457,Staff,0,9,30,30
1649924280209,MATH 109,A01,084146,Salehi Golsefidy; Alireza,28,0,30,2
1649924280209,MATH 109,A02,084147,Salehi Golsefidy; Alireza,22,0,30,8
1649924286231,MATH 120A,A01,085445,Eggers; John Dietrich,20,0,35,15
1649924286231,MATH 120A,A02,085446,Eggers; John Dietrich,28,0,35,7
1649924292255,MATH 142B,A01,084149,Verstraete; Jacques Allan,0,10,30,30
1649924292255,MATH 142B,A02,084150,Verstraete; Jacques Allan,0,9,30,30
1649924298287,MATH 170A,A01,083459,Nie; Jiawang,0,2,30,30
1649924298287,MATH 170A,A02,083460,Nie; Jiawang,0,0,30,30
1649924298287,MATH 170A,A03,083461,Nie; Jiawang,9,0,30,21
1649924304311,MATH 193B,A01,083463,Staff,3,0,30,27
1649924304311,MATH 193B,A02,083464,Staff,10,0,30,20
1649924304311,MATH 193B,A03,083465,Staff,19,0,30,11
1649924310366,COGS 2,A01,083966,Boyle; Mary E. T.,18,0,30,12
1649924316388,COGS 9,A01,083968,Staff,43,0,60,17
1649924322415,COGS 14B,A01,083970,Staff,29,0,50,21
1649924328441,COGS 17,A01,092679,Staff,67,0,75,8
1649924334465,COGS 100,A01,083972,Staff,10,0,60,50
1649924346531,COGS 101C,A01,083976,Staff,19,0,30,11
1649924352559,COGS 102A,A01,083978,Johnson; Christine M.,17,0,30,13
1649924358584,COGS 107B,A01,083980,Staff,3,0,50,47
1649924364608,COGS 115,A01,083982,Staff,14,0,30,16
1649924370631,COGS 118B,A01,083367,Staff,0,11,40,40
1649924376659,COGS 172,A01,083984,Provenzano; Emily Kara,17,0,30,13
1649924382688,COGS 177,A00,083368,Staff,0,17,30,30
1649924388718,COGS 186,A01,083986,Staff,21,0,40,19
1649924394742,COGS 187A,A01,083988,Boyle; Mary E. T.,24,0,60,36
1649924400767,CSE 8A,A50,084003,Miranda; Gregory Joseph,0,0,15,15
1649924406789,CSE 11,A01,084005,Miranda; Gregory Joseph,23,0,55,32
1649924412812,CSE 20,A01,084007,Staff,9,0,20,11
1649924418836,CSE 21,A01,084009,Staff,10,0,50,40
1649924424960,CSE 30,A01,083370,Cao; Yingjun,0,20,40,40
1649924430984,CSE 100,A01,083372,Cao; Yingjun,0,23,40,40
1649924437016,CSE 101,A01,084011,Staff,0,48,40,40
1649924443041,CSE 141,A01,083374,Eldon; John,0,51,75,75
1649924449072,CSE 141L,A01,083376,Eldon; John,0,56,75,75
1649924455099,CSE 175,A01,084013,Kumar; Rakesh,22,0,25,3
1649924461129,CSE 190,A00,092508,Dubnov; Shlomo,15,0,15,0
1649924467158,ECE 5,A01,084049,Morris; Karcher William,15,0,20,5
1649924473184,ECE 100,A01,084051,Baghdadchi; Saharnaz,1,0,20,19
1649924473184,ECE 100,A02,091916,Baghdadchi; Saharnaz,16,0,20,4
1649924479212,ECE 101,A01,084053,Baghdadchi; Saharnaz,5,0,37,32
1649924479212,ECE 101,A02,084054,Baghdadchi; Saharnaz,33,0,37,4
1649924485235,ECE 107,A01,083390,Staff,28,0,40,12
1649924491258,ECE 148,A01,084056,Silberman; Jack,7,0,12,5
1649924497283,ECE 180,A00,083391,Abi Samra; Nicholas Camill,25,0,30,5
1649924497283,ECE 180,B00,083392,Abi Samra; Nicholas Camill,22,0,30,8
1649924503308,MATH 10B,A01,084110,Staff,8,0,30,22
1649924503308,MATH 10B,A02,084111,Staff,29,0,30,1
1649924503308,MATH 10B,A03,084112,Staff,28,0,30,2
1649924509334,MATH 10C,A01,083443,Staff,9,0,30,21
1649924509334,MATH 10C,A02,083444,Staff,16,0,30,14
1649924509334,MATH 10C,B01,084114,Staff,25,0,30,5
1649924509334,MATH 10C,B02,084115,Staff,29,0,30,1
1649924515362,MATH 18,A01,084117,Harel; Guershon,27,0,30,3
1649924515362,MATH 18,A02,084119,Harel; Guershon,29,0,30,1
1649924515362,MATH 18,A03,084120,Harel; Guershon,30,0,30,0
1649924515362,MATH 18,A04,084121,Harel; Guershon,29,0,30,1
1649924521390,MATH 20B,A01,084124,Um; Ko Woon,31,0,35,4
1649924521390,MATH 20B,B01,084126,Um; Ko Woon,32,0,35,3
1649924527416,MATH 20C,A01,083446,Hammock; Frances H,17,0,30,13
1649924527416,MATH 20C,A02,083447,Hammock; Frances H,28,0,30,2
1649924527416,MATH 20C,A03,083448,Hammock; Frances H,30,0,30,0
1649924527416,MATH 20C,A04,083449,Hammock; Frances H,30,0,30,0
1649924527416,MATH 20C,B01,083451,Hammock; Frances H,25,0,30,5
1649924527416,MATH 20C,B02,083452,Hammock; Frances H,27,0,30,3
1649924527416,MATH 20C,B03,083453,Hammock; Frances H,26,0,30,4
1649924527416,MATH 20C,B04,083454,Hammock; Frances H,30,0,30,0
1649924533445,MATH 20D,A01,084128,Staff,26,0,30,4
1649924533445,MATH 20D,A02,084129,Staff,30,0,30,0
1649924533445,MATH 20D,A03,084130,Staff,29,0,30,1
1649924533445,MATH 20D,B01,084133,Staff,21,0,30,9
1649924533445,MATH 20D,B02,084134,Staff,27,0,30,3
1649924533445,MATH 20D,B03,084135,Staff,30,0,30,0
1649924539469,MATH 20E,A01,084138,Staff,22,0,30,8
1649924539469,MATH 20E,A02,084139,Staff,22,0,30,8
1649924539469,MATH 20E,A03,084140,Staff,23,0,30,7
1649924539469,MATH 20E,A04,084141,Staff,25,0,30,5
1649924545493,MATH 102,A01,084143,Harel; Guershon,17,0,30,13
1649924545493,MATH 102,A02,084144,Harel; Guershon,22,0,30,8
1649924551517,MATH 103B,A01,083456,Staff,0,8,30,30
1649924551517,MATH 103B,A02,083457,Staff,0,9,30,30
1649924557545,MATH 109,A01,084146,Salehi Golsefidy; Alireza,28,0,30,2
1649924557545,MATH 109,A02,084147,Salehi Golsefidy; Alireza,22,0,30,8
1649924563569,MATH 120A,A01,085445,Eggers; John Dietrich,20,0,35,15
1649924563569,MATH 120A,A02,085446,Eggers; John Dietrich,28,0,35,7
1649924569594,MATH 142B,A01,084149,Verstraete; Jacques Allan,0,10,30,30
1649924569594,MATH 142B,A02,084150,Verstraete; Jacques Allan,0,9,30,30
1649924575619,MATH 170A,A01,083459,Nie; Jiawang,0,2,30,30
1649924575619,MATH 170A,A02,083460,Nie; Jiawang,0,0,30,30
1649924575619,MATH 170A,A03,083461,Nie; Jiawang,9,0,30,21
1649924581647,MATH 193B,A01,083463,Staff,3,0,30,27
1649924581647,MATH 193B,A02,083464,Staff,10,0,30,20
1649924581647,MATH 193B,A03,083465,Staff,19,0,30,11
1649924587709,COGS 2,A01,083966,Boyle; Mary E. T.,18,0,30,12
1649924593738,COGS 9,A01,083968,Staff,43,0,60,17
1649924599763,COGS 14B,A01,083970,Staff,29,0,50,21
1649924605786,COGS 17,A01,092679,Staff,67,0,75,8
1649924611813,COGS 100,A01,083972,Staff,10,0,60,50
1649924623859,COGS 101C,A01,083976,Staff,19,0,30,11
1649924629887,COGS 102A,A01,083978,Johnson; Christine M.,17,0,30,13
1649924635913,COGS 107B,A01,083980,Staff,3,0,50,47
1649924641940,COGS 115,A01,083982,Staff,14,0,30,16
1649924647975,COGS 118B,A01,083367,Staff,0,11,40,40
1649924653998,COGS 172,A01,083984,Provenzano; Emily Kara,17,0,30,13
1649924660022,COGS 177,A00,083368,Staff,0,17,30,30
1649924666048,COGS 186,A01,083986,Staff,21,0,40,19
1649924672076,COGS 187A,A01,083988,Boyle; Mary E. T.,24,0,60,36
1649924678103,CSE 8A,A50,084003,Miranda; Gregory Joseph,0,0,15,15
1649924684130,CSE 11,A01,084005,Miranda; Gregory Joseph,23,0,55,32
1649924690154,CSE 20,A01,084007,Staff,9,0,20,11
1649924696178,CSE 21,A01,084009,Staff,10,0,50,40
1649924702202,CSE 30,A01,083370,Cao; Yingjun,0,20,40,40
1649924708230,CSE 100,A01,083372,Cao; Yingjun,0,23,40,40
1649924714254,CSE 101,A01,084011,Staff,0,48,40,40
1649924720277,CSE 141,A01,083374,Eldon; John,0,51,75,75
1649924726304,CSE 141L,A01,083376,Eldon; John,0,56,75,75
1649924732333,CSE 175,A01,084013,Kumar; Rakesh,22,0,25,3
1649924738359,CSE 190,A00,092508,Dubnov; Shlomo,15,0,15,0
1649924744379,ECE 5,A01,084049,Morris; Karcher William,15,0,20,5
1649924750402,ECE 100,A01,084051,Baghdadchi; Saharnaz,1,0,20,19
1649924750402,ECE 100,A02,091916,Baghdadchi; Saharnaz,16,0,20,4
1649924756427,ECE 101,A01,084053,Baghdadchi; Saharnaz,5,0,37,32
1649924756427,ECE 101,A02,084054,Baghdadchi; Saharnaz,33,0,37,4
1649924762451,ECE 107,A01,083390,Staff,28,0,40,12
1649924768479,ECE 148,A01,084056,Silberman; Jack,7,0,12,5
1649924774507,ECE 180,A00,083391,Abi Samra; Nicholas Camill,25,0,30,5
1649924774507,ECE 180,B00,083392,Abi Samra; Nicholas Camill,22,0,30,8
1649924780531,MATH 10B,A01,084110,Staff,8,0,30,22
1649924780531,MATH 10B,A02,084111,Staff,29,0,30,1
1649924780531,MATH 10B,A03,084112,Staff,28,0,30,2
1649924786554,MATH 10C,A01,083443,Staff,9,0,30,21
1649924786554,MATH 10C,A02,083444,Staff,16,0,30,14
1649924786554,MATH 10C,B01,084114,Staff,25,0,30,5
1649924786554,MATH 10C,B02,084115,Staff,29,0,30,1
1649924792584,MATH 18,A01,084117,Harel; Guershon,27,0,30,3
1649924792584,MATH 18,A02,084119,Harel; Guershon,29,0,30,1
1649924792584,MATH 18,A03,084120,Harel; Guershon,30,0,30,0
1649924792584,MATH 18,A04,084121,Harel; Guershon,29,0,30,1
1649924798615,MATH 20B,A01,084124,Um; Ko Woon,31,0,35,4
1649924798615,MATH 20B,B01,084126,Um; Ko Woon,32,0,35,3
1649924804647,MATH 20C,A01,083446,Hammock; Frances H,17,0,30,13
1649924804647,MATH 20C,A02,083447,Hammock; Frances H,28,0,30,2
1649924804647,MATH 20C,A03,083448,Hammock; Frances H,30,0,30,0
1649924804647,MATH 20C,A04,083449,Hammock; Frances H,30,0,30,0
1649924804647,MATH 20C,B01,083451,Hammock; Frances H,25,0,30,5
1649924804647,MATH 20C,B02,083452,Hammock; Frances H,27,0,30,3
1649924804647,MATH 20C,B03,083453,Hammock; Frances H,26,0,30,4
1649924804647,MATH 20C,B04,083454,Hammock; Frances H,30,0,30,0
1649924810670,MATH 20D,A01,084128,Staff,26,0,30,4
1649924810670,MATH 20D,A02,084129,Staff,30,0,30,0
1649924810670,MATH 20D,A03,084130,Staff,29,0,30,1
1649924810670,MATH 20D,B01,084133,Staff,21,0,30,9
1649924810670,MATH 20D,B02,084134,Staff,27,0,30,3
1649924810670,MATH 20D,B03,084135,Staff,30,0,30,0
1649924816694,MATH 20E,A01,084138,Staff,22,0,30,8
1649924816694,MATH 20E,A02,084139,Staff,22,0,30,8
1649924816694,MATH 20E,A03,084140,Staff,23,0,30,7
1649924816694,MATH 20E,A04,084141,Staff,25,0,30,5
1649924822716,MATH 102,A01,084143,Harel; Guershon,17,0,30,13
1649924822716,MATH 102,A02,084144,Harel; Guershon,22,0,30,8
1649924828746,MATH 103B,A01,083456,Staff,0,8,30,30
1649924828746,MATH 103B,A02,083457,Staff,0,9,30,30
1649924834772,MATH 109,A01,084146,Salehi Golsefidy; Alireza,28,0,30,2
1649924834772,MATH 109,A02,084147,Salehi Golsefidy; Alireza,22,0,30,8
1649924840799,MATH 120A,A01,085445,Eggers; John Dietrich,20,0,35,15
1649924840799,MATH 120A,A02,085446,Eggers; John Dietrich,28,0,35,7
1649924846824,MATH 142B,A01,084149,Verstraete; Jacques Allan,0,10,30,30
1649924846824,MATH 142B,A02,084150,Verstraete; Jacques Allan,0,9,30,30
1649924852848,MATH 170A,A01,083459,Nie; Jiawang,0,2,30,30
1649924852848,MATH 170A,A02,083460,Nie; Jiawang,0,0,30,30
1649924852848,MATH 170A,A03,083461,Nie; Jiawang,9,0,30,21
1649924858871,MATH 193B,A01,083463,Staff,3,0,30,27
1649924858871,MATH 193B,A02,083464,Staff,10,0,30,20
1649924858871,MATH 193B,A03,083465,Staff,19,0,30,11
1649924864925,COGS 2,A01,083966,Boyle; Mary E. T.,18,0,30,12
1649924870947,COGS 9,A01,083968,Staff,43,0,60,17
1649924876970,COGS 14B,A01,083970,Staff,28,0,50,22
1649924882995,COGS 17,A01,092679,Staff,67,0,75,8
1649924889023,COGS 100,A01,083972,Staff,10,0,60,50
1649924901082,COGS 101C,A01,083976,Staff,19,0,30,11
1649924907107,COGS 102A,A01,083978,Johnson; Christine M.,17,0,30,13
1649924913134,COGS 107B,A01,083980,Staff,3,0,50,47
1649924919157,COGS 115,A01,083982,Staff,14,0,30,16
1649924925183,COGS 118B,A01,083367,Staff,0,11,40,40
1649924931211,COGS 172,A01,083984,Provenzano; Emily Kara,17,0,30,13
1649924937234,COGS 177,A00,083368,Staff,0,17,30,30
1649924943257,COGS 186,A01,083986,Staff,21,0,40,19
1649924949282,COGS 187A,A01,083988,Boyle; Mary E. T.,24,0,60,36
1649924955304,CSE 8A,A50,084003,Miranda; Gregory Joseph,0,0,15,15
1649924961328,CSE 11,A01,084005,Miranda; Gregory Joseph,23,0,55,32
1649924967354,CSE 20,A01,084007,Staff,9,0,20,11
1649924973380,CSE 21,A01,084009,Staff,10,0,50,40
1649924979416,CSE 30,A01,083370,Cao; Yingjun,0,20,40,40
1649924985440,CSE 100,A01,083372,Cao; Yingjun,0,23,40,40
1649924991466,CSE 101,A01,084011,Staff,0,48,40,40
1649924997489,CSE 141,A01,083374,Eldon; John,0,51,75,75
1649925003518,CSE 141L,A01,083376,Eldon; John,0,56,75,75
1649925009543,CSE 175,A01,084013,Kumar; Rakesh,22,0,25,3
1649925015567,CSE 190,A00,092508,Dubnov; Shlomo,15,0,15,0
1649925021679,ECE 5,A01,084049,Morris; Karcher William,15,0,20,5
1649925027703,ECE 100,A01,084051,Baghdadchi; Saharnaz,1,0,20,19
1649925027703,ECE 100,A02,091916,Baghdadchi; Saharnaz,16,0,20,4
1649925033730,ECE 101,A01,084053,Baghdadchi; Saharnaz,5,0,37,32
1649925033730,ECE 101,A02,084054,Baghdadchi; Saharnaz,33,0,37,4
1649925039758,ECE 107,A01,083390,Staff,28,0,40,12
1649925045784,ECE 148,A01,084056,Silberman; Jack,7,0,12,5
1649925051811,ECE 180,A00,083391,Abi Samra; Nicholas Camill,25,0,30,5
1649925051811,ECE 180,B00,083392,Abi Samra; Nicholas Camill,22,0,30,8
1649925057839,MATH 10B,A01,084110,Staff,8,0,30,22
1649925057839,MATH 10B,A02,084111,Staff,29,0,30,1
1649925057839,MATH 10B,A03,084112,Staff,28,0,30,2
1649925063863,MATH 10C,A01,083443,Staff,9,0,30,21
1649925063863,MATH 10C,A02,083444,Staff,16,0,30,14
1649925063863,MATH 10C,B01,084114,Staff,25,0,30,5
1649925063863,MATH 10C,B02,084115,Staff,29,0,30,1
1649925069895,MATH 18,A01,084117,Harel; Guershon,27,0,30,3
1649925069895,MATH 18,A02,084119,Harel; Guershon,29,0,30,1
1649925069895,MATH 18,A03,084120,Harel; Guershon,30,0,30,0
1649925069895,MATH 18,A04,084121,Harel; Guershon,29,0,30,1
1649925075921,MATH 20B,A01,084124,Um; Ko Woon,31,0,35,4
1649925075921,MATH 20B,B01,084126,Um; Ko Woon,32,0,35,3
1649925081944,MATH 20C,A01,083446,Hammock; Frances H,17,0,30,13
1649925081944,MATH 20C,A02,083447,Hammock; Frances H,28,0,30,2
1649925081944,MATH 20C,A03,083448,Hammock; Frances H,30,0,30,0
1649925081944,MATH 20C,A04,083449,Hammock; Frances H,30,0,30,0
1649925081944,MATH 20C,B01,083451,Hammock; Frances H,25,0,30,5
1649925081944,MATH 20C,B02,083452,Hammock; Frances H,27,0,30,3
1649925081944,MATH 20C,B03,083453,Hammock; Frances H,26,0,30,4
1649925081944,MATH 20C,B04,083454,Hammock; Frances H,30,0,30,0
1649925087969,MATH 20D,A01,084128,Staff,26,0,30,4
1649925087969,MATH 20D,A02,084129,Staff,30,0,30,0
1649925087969,MATH 20D,A03,084130,Staff,29,0,30,1
1649925087969,MATH 20D,B01,084133,Staff,21,0,30,9
1649925087969,MATH 20D,B02,084134,Staff,27,0,30,3
1649925087969,MATH 20D,B03,084135,Staff,30,0,30,0
1649925093993,MATH 20E,A01,084138,Staff,22,0,30,8
1649925093993,MATH 20E,A02,084139,Staff,22,0,30,8
1649925093993,MATH 20E,A03,084140,Staff,23,0,30,7
1649925093993,MATH 20E,A04,084141,Staff,25,0,30,5
1649925100023,MATH 102,A01,084143,Harel; Guershon,17,0,30,13
1649925100023,MATH 102,A02,084144,Harel; Guershon,22,0,30,8
1649925106050,MATH 103B,A01,083456,Staff,0,8,30,30
1649925106050,MATH 103B,A02,083457,Staff,0,9,30,30
1649925112075,MATH 109,A01,084146,Salehi Golsefidy; Alireza,28,0,30,2
1649925112075,MATH 109,A02,084147,Salehi Golsefidy; Alireza,22,0,30,8
1649925118098,MATH 120A,A01,085445,Eggers; John Dietrich,20,0,35,15
1649925118098,MATH 120A,A02,085446,Eggers; John Dietrich,28,0,35,7
1649925124127,MATH 142B,A01,084149,Verstraete; Jacques Allan,0,10,30,30
1649925124127,MATH 142B,A02,084150,Verstraete; Jacques Allan,0,9,30,30
1649925130153,MATH 170A,A01,083459,Nie; Jiawang,0,2,30,30
1649925130153,MATH 170A,A02,083460,Nie; Jiawang,0,0,30,30
1649925130153,MATH 170A,A03,083461,Nie; Jiawang,9,0,30,21
1649925136181,MATH 193B,A01,083463,Staff,3,0,30,27
1649925136181,MATH 193B,A02,083464,Staff,10,0,30,20
1649925136181,MATH 193B,A03,083465,Staff,19,0,30,11
1649925142247,COGS 2,A01,083966,Boyle; Mary E. T.,18,0,30,12
1649925148279,COGS 9,A01,083968,Staff,43,0,60,17
1649925154306,COGS 14B,A01,083970,Staff,28,0,50,22
1649925160335,COGS 17,A01,092679,Staff,67,0,75,8
1649925166359,COGS 100,A01,083972,Staff,10,0,60,50
1649925178405,COGS 101C,A01,083976,Staff,19,0,30,11
1649925184429,COGS 102A,A01,083978,Johnson; Christine M.,17,0,30,13
1649925190456,COGS 107B,A01,083980,Staff,3,0,50,47
1649925196479,COGS 115,A01,083982,Staff,14,0,30,16
1649925202506,COGS 118B,A01,083367,Staff,0,11,40,40
1649925208529,COGS 172,A01,083984,Provenzano; Emily Kara,17,0,30,13
1649925214555,COGS 177,A00,083368,Staff,0,17,30,30
1649925220583,COGS 186,A01,083986,Staff,21,0,40,19
1649925226609,COGS 187A,A01,083988,Boyle; Mary E. T.,24,0,60,36
1649925232637,CSE 8A,A50,084003,Miranda; Gregory Joseph,0,0,15,15
1649925238663,CSE 11,A01,084005,Miranda; Gregory Joseph,23,0,55,32
1649925244687,CSE 20,A01,084007,Staff,9,0,20,11
1649925250710,CSE 21,A01,084009,Staff,10,0,50,40
1649925256738,CSE 30,A01,083370,Cao; Yingjun,0,20,40,40
1649925262761,CSE 100,A01,083372,Cao; Yingjun,0,23,40,40
1649925268789,CSE 101,A01,084011,Staff,0,48,40,40
1649925274817,CSE 141,A01,083374,Eldon; John,0,51,75,75
1649925280843,CSE 141L,A01,083376,Eldon; John,0,56,75,75
1649925286869,CSE 175,A01,084013,Kumar; Rakesh,22,0,25,3
1649925292894,CSE 190,A00,092508,Dubnov; Shlomo,15,0,15,0
1649925298918,ECE 5,A01,084049,Morris; Karcher William,15,0,20,5
1649925304942,ECE 100,A01,084051,Baghdadchi; Saharnaz,1,0,20,19
1649925304942,ECE 100,A02,091916,Baghdadchi; Saharnaz,16,0,20,4
1649925310966,ECE 101,A01,084053,Baghdadchi; Saharnaz,5,0,37,32
1649925310966,ECE 101,A02,084054,Baghdadchi; Saharnaz,33,0,37,4
1649925316989,ECE 107,A01,083390,Staff,28,0,40,12
1649925323029,ECE 148,A01,084056,Silberman; Jack,7,0,12,5
1649925329052,ECE 180,A00,083391,Abi Samra; Nicholas Camill,25,0,30,5
1649925329052,ECE 180,B00,083392,Abi Samra; Nicholas Camill,22,0,30,8
1649925335079,MATH 10B,A01,084110,Staff,8,0,30,22
1649925335079,MATH 10B,A02,084111,Staff,29,0,30,1
1649925335079,MATH 10B,A03,084112,Staff,28,0,30,2
1649925341106,MATH 10C,A01,083443,Staff,9,0,30,21
1649925341106,MATH 10C,A02,083444,Staff,16,0,30,14
1649925341106,MATH 10C,B01,084114,Staff,25,0,30,5
1649925341106,MATH 10C,B02,084115,Staff,29,0,30,1
1649925347130,MATH 18,A01,084117,Harel; Guershon,27,0,30,3
1649925347130,MATH 18,A02,084119,Harel; Guershon,29,0,30,1
1649925347130,MATH 18,A03,084120,Harel; Guershon,30,0,30,0
1649925347130,MATH 18,A04,084121,Harel; Guershon,29,0,30,1
1649925353158,MATH 20B,A01,084124,Um; Ko Woon,31,0,35,4
1649925353158,MATH 20B,B01,084126,Um; Ko Woon,32,0,35,3
1649925359189,MATH 20C,A01,083446,Hammock; Frances H,17,0,30,13
1649925359189,MATH 20C,A02,083447,Hammock; Frances H,28,0,30,2
1649925359189,MATH 20C,A03,083448,Hammock; Frances H,30,0,30,0
1649925359189,MATH 20C,A04,083449,Hammock; Frances H,30,0,30,0
1649925359189,MATH 20C,B01,083451,Hammock; Frances H,25,0,30,5
1649925359189,MATH 20C,B02,083452,Hammock; Frances H,27,0,30,3
1649925359189,MATH 20C,B03,083453,Hammock; Frances H,26,0,30,4
1649925359189,MATH 20C,B04,083454,Hammock; Frances H,30,0,30,0
1649925365220,MATH 20D,A01,084128,Staff,26,0,30,4
1649925365220,MATH 20D,A02,084129,Staff,30,0,30,0
1649925365220,MATH 20D,A03,084130,Staff,29,0,30,1
1649925365220,MATH 20D,B01,084133,Staff,21,0,30,9
1649925365220,MATH 20D,B02,084134,Staff,27,0,30,3
1649925365220,MATH 20D,B03,084135,Staff,30,0,30,0
1649925371247,MATH 20E,A01,084138,Staff,22,0,30,8
1649925371247,MATH 20E,A02,084139,Staff,22,0,30,8
1649925371247,MATH 20E,A03,084140,Staff,23,0,30,7
1649925371247,MATH 20E,A04,084141,Staff,25,0,30,5
1649925377278,MATH 102,A01,084143,Harel; Guershon,17,0,30,13
1649925377278,MATH 102,A02,084144,Harel; Guershon,22,0,30,8
1649925383307,MATH 103B,A01,083456,Staff,0,8,30,30
1649925383307,MATH 103B,A02,083457,Staff,0,9,30,30
1649925389336,MATH 109,A01,084146,Salehi Golsefidy; Alireza,28,0,30,2
1649925389336,MATH 109,A02,084147,Salehi Golsefidy; Alireza,22,0,30,8
1649925395360,MATH 120A,A01,085445,Eggers; John Dietrich,20,0,35,15
1649925395360,MATH 120A,A02,085446,Eggers; John Dietrich,28,0,35,7
1649925401384,MATH 142B,A01,084149,Verstraete; Jacques Allan,0,10,30,30
1649925401384,MATH 142B,A02,084150,Verstraete; Jacques Allan,0,9,30,30
1649925407412,MATH 170A,A01,083459,Nie; Jiawang,0,2,30,30
1649925407412,MATH 170A,A02,083460,Nie; Jiawang,0,0,30,30
1649925407412,MATH 170A,A03,083461,Nie; Jiawang,9,0,30,21
1649925413440,MATH 193B,A01,083463,Staff,3,0,30,27
1649925413440,MATH 193B,A02,083464,Staff,10,0,30,20
1649925413440,MATH 193B,A03,083465,Staff,19,0,30,11
1649925419499,COGS 2,A01,083966,Boyle; Mary E. T.,18,0,30,12
1649925425522,COGS 9,A01,083968,Staff,43,0,60,17
1649925431550,COGS 14B,A01,083970,Staff,28,0,50,22
1649925437583,COGS 17,A01,092679,Staff,67,0,75,8
1649925443614,COGS 100,A01,083972,Staff,10,0,60,50
1649925455663,COGS 101C,A01,083976,Staff,19,0,30,11
1649925461686,COGS 102A,A01,083978,Johnson; Christine M.,17,0,30,13
1649925467717,COGS 107B,A01,083980,Staff,3,0,50,47
1649925473743,COGS 115,A01,083982,Staff,14,0,30,16
1649925479771,COGS 118B,A01,083367,Staff,0,11,40,40
1649925485798,COGS 172,A01,083984,Provenzano; Emily Kara,17,0,30,13
1649925491827,COGS 177,A00,083368,Staff,0,17,30,30
1649925497851,COGS 186,A01,083986,Staff,21,0,40,19
1649925503880,COGS 187A,A01,083988,Boyle; Mary E. T.,24,0,60,36
1649925509904,CSE 8A,A50,084003,Miranda; Gregory Joseph,0,0,15,15
1649925515928,CSE 11,A01,084005,Miranda; Gregory Joseph,23,0,55,32
1649925521956,CSE 20,A01,084007,Staff,9,0,20,11
1649925527981,CSE 21,A01,084009,Staff,10,0,50,40
1649925534015,CSE 30,A01,083370,Cao; Yingjun,0,20,40,40
1649925540039,CSE 100,A01,083372,Cao; Yingjun,0,23,40,40
1649925546078,CSE 101,A01,084011,Staff,0,48,40,40
1649925552102,CSE 141,A01,083374,Eldon; John,0,51,75,75
1649925558126,CSE 141L,A01,083376,Eldon; John,0,56,75,75
1649925564169,CSE 175,A01,084013,Kumar; Rakesh,22,0,25,3
1649925570195,CSE 190,A00,092508,Dubnov; Shlomo,15,0,15,0
1649925576231,ECE 5,A01,084049,Morris; Karcher William,15,0,20,5
1649925582268,ECE 100,A01,084051,Baghdadchi; Saharnaz,1,0,20,19
1649925582268,ECE 100,A02,091916,Baghdadchi; Saharnaz,16,0,20,4
1649925588292,ECE 101,A01,084053,Baghdadchi; Saharnaz,5,0,37,32
1649925588292,ECE 101,A02,084054,Baghdadchi; Saharnaz,33,0,37,4
1649925594317,ECE 107,A01,083390,Staff,28,0,40,12
1649925600347,ECE 148,A01,084056,Silberman; Jack,7,0,12,5
1649925606370,ECE 180,A00,083391,Abi Samra; Nicholas Camill,25,0,30,5
1649925606370,ECE 180,B00,083392,Abi Samra; Nicholas Camill,22,0,30,8
1649925612396,MATH 10B,A01,084110,Staff,8,0,30,22
1649925612396,MATH 10B,A02,084111,Staff,29,0,30,1
1649925612396,MATH 10B,A03,084112,Staff,28,0,30,2
1649925618494,MATH 10C,A01,083443,Staff,9,0,30,21
1649925618494,MATH 10C,A02,083444,Staff,16,0,30,14
1649925618494,MATH 10C,B01,084114,Staff,25,0,30,5
1649925618494,MATH 10C,B02,084115,Staff,29,0,30,1
1649925624535,MATH 18,A01,084117,Harel; Guershon,27,0,30,3
1649925624535,MATH 18,A02,084119,Harel; Guershon,29,0,30,1
1649925624535,MATH 18,A03,084120,Harel; Guershon,30,0,30,0
1649925624535,MATH 18,A04,084121,Harel; Guershon,29,0,30,1
1649925630558,MATH 20B,A01,084124,Um; Ko Woon,31,0,35,4
1649925630558,MATH 20B,B01,084126,Um; Ko Woon,32,0,35,3
1649925636586,MATH 20C,A01,083446,Hammock; Frances H,17,0,30,13
1649925636586,MATH 20C,A02,083447,Hammock; Frances H,28,0,30,2
1649925636586,MATH 20C,A03,083448,Hammock; Frances H,30,0,30,0
1649925636586,MATH 20C,A04,083449,Hammock; Frances H,30,0,30,0
1649925636586,MATH 20C,B01,083451,Hammock; Frances H,25,0,30,5
1649925636586,MATH 20C,B02,083452,Hammock; Frances H,27,0,30,3
1649925636586,MATH 20C,B03,083453,Hammock; Frances H,26,0,30,4
1649925636586,MATH 20C,B04,083454,Hammock; Frances H,30,0,30,0
1649925642616,MATH 20D,A01,084128,Staff,26,0,30,4
1649925642616,MATH 20D,A02,084129,Staff,30,0,30,0
1649925642616,MATH 20D,A03,084130,Staff,29,0,30,1
1649925642616,MATH 20D,B01,084133,Staff,21,0,30,9
1649925642616,MATH 20D,B02,084134,Staff,27,0,30,3
1649925642616,MATH 20D,B03,084135,Staff,30,0,30,0
1649925648645,MATH 20E,A01,084138,Staff,22,0,30,8
1649925648645,MATH 20E,A02,084139,Staff,22,0,30,8
1649925648645,MATH 20E,A03,084140,Staff,23,0,30,7
1649925648645,MATH 20E,A04,084141,Staff,25,0,30,5
1649925654673,MATH 102,A01,084143,Harel; Guershon,17,0,30,13
1649925654673,MATH 102,A02,084144,Harel; Guershon,22,0,30,8
1649925660700,MATH 103B,A01,083456,Staff,0,8,30,30
1649925660700,MATH 103B,A02,083457,Staff,0,9,30,30
1649925666727,MATH 109,A01,084146,Salehi Golsefidy; Alireza,28,0,30,2
1649925666727,MATH 109,A02,084147,Salehi Golsefidy; Alireza,22,0,30,8
1649925672751,MATH 120A,A01,085445,Eggers; John Dietrich,20,0,35,15
1649925672751,MATH 120A,A02,085446,Eggers; John Dietrich,28,0,35,7
1649925678775,MATH 142B,A01,084149,Verstraete; Jacques Allan,0,10,30,30
1649925678775,MATH 142B,A02,084150,Verstraete; Jacques Allan,0,9,30,30
1649925684799,MATH 170A,A01,083459,Nie; Jiawang,0,2,30,30
1649925684799,MATH 170A,A02,083460,Nie; Jiawang,0,0,30,30
1649925684799,MATH 170A,A03,083461,Nie; Jiawang,8,0,30,22
1649925690823,MATH 193B,A01,083463,Staff,3,0,30,27
1649925690823,MATH 193B,A02,083464,Staff,10,0,30,20
1649925690823,MATH 193B,A03,083465,Staff,19,0,30,11
1649925696893,COGS 2,A01,083966,Boyle; Mary E. T.,18,0,30,12
1649925702932,COGS 9,A01,083968,Staff,43,0,60,17
1649925708962,COGS 14B,A01,083970,Staff,28,0,50,22
1649925714984,COGS 17,A01,092679,Staff,67,0,75,8
1649925721009,COGS 100,A01,083972,Staff,10,0,60,50
1649925733075,COGS 101C,A01,083976,Staff,19,0,30,11
1649925739104,COGS 102A,A01,083978,Johnson; Christine M.,17,0,30,13
1649925745131,COGS 107B,A01,083980,Staff,3,0,50,47
1649925751155,COGS 115,A01,083982,Staff,14,0,30,16
1649925757179,COGS 118B,A01,083367,Staff,0,11,40,40
1649925763209,COGS 172,A01,083984,Provenzano; Emily Kara,17,0,30,13
1649925769232,COGS 177,A00,083368,Staff,0,17,30,30
1649925775260,COGS 186,A01,083986,Staff,21,0,40,19
1649925781287,COGS 187A,A01,083988,Boyle; Mary E. T.,24,0,60,36
1649925787320,CSE 8A,A50,084003,Miranda; Gregory Joseph,0,0,15,15
1649925793345,CSE 11,A01,084005,Miranda; Gregory Joseph,23,0,55,32
1649925799370,CSE 20,A01,084007,Staff,9,0,20,11
1649925805396,CSE 21,A01,084009,Staff,10,0,50,40
1649925811421,CSE 30,A01,083370,Cao; Yingjun,0,20,40,40
1649925817448,CSE 100,A01,083372,Cao; Yingjun,0,23,40,40
1649925823471,CSE 101,A01,084011,Staff,0,48,40,40
1649925829498,CSE 141,A01,083374,Eldon; John,0,51,75,75
1649925835521,CSE 141L,A01,083376,Eldon; John,0,56,75,75
1649925841544,CSE 175,A01,084013,Kumar; Rakesh,22,0,25,3
1649925847569,CSE 190,A00,092508,Dubnov; Shlomo,15,0,15,0
1649925853597,ECE 5,A01,084049,Morris; Karcher William,15,0,20,5
1649925859626,ECE 100,A01,084051,Baghdadchi; Saharnaz,1,0,20,19
1649925859626,ECE 100,A02,091916,Baghdadchi; Saharnaz,16,0,20,4
1649925865652,ECE 101,A01,084053,Baghdadchi; Saharnaz,5,0,37,32
1649925865652,ECE 101,A02,084054,Baghdadchi; Saharnaz,33,0,37,4
1649925871677,ECE 107,A01,083390,Staff,28,0,40,12
1649925877702,ECE 148,A01,084056,Silberman; Jack,7,0,12,5
1649925883727,ECE 180,A00,083391,Abi Samra; Nicholas Camill,25,0,30,5
1649925883727,ECE 180,B00,083392,Abi Samra; Nicholas Camill,22,0,30,8
1649925889751,MATH 10B,A01,084110,Staff,8,0,30,22
1649925889751,MATH 10B,A02,084111,Staff,29,0,30,1
1649925889751,MATH 10B,A03,084112,Staff,28,0,30,2
1649925895776,MATH 10C,A01,083443,Staff,9,0,30,21
1649925895776,MATH 10C,A02,083444,Staff,16,0,30,14
1649925895776,MATH 10C,B01,084114,Staff,25,0,30,5
1649925895776,MATH 10C,B02,084115,Staff,29,0,30,1
1649925901803,MATH 18,A01,084117,Harel; Guershon,27,0,30,3
1649925901803,MATH 18,A02,084119,Harel; Guershon,29,0,30,1
1649925901803,MATH 18,A03,084120,Harel; Guershon,30,0,30,0
1649925901803,MATH 18,A04,084121,Harel; Guershon,29,0,30,1
1649925907833,MATH 20B,A01,084124,Um; Ko Woon,31,0,35,4
1649925907833,MATH 20B,B01,084126,Um; Ko Woon,32,0,35,3
1649925913858,MATH 20C,A01,083446,Hammock; Frances H,17,0,30,13
1649925913858,MATH 20C,A02,083447,Hammock; Frances H,28,0,30,2
1649925913858,MATH 20C,A03,083448,Hammock; Frances H,30,0,30,0
1649925913858,MATH 20C,A04,083449,Hammock; Frances H,30,0,30,0
1649925913858,MATH 20C,B01,083451,Hammock; Frances H,25,0,30,5
1649925913858,MATH 20C,B02,083452,Hammock; Frances H,27,0,30,3
1649925913858,MATH 20C,B03,083453,Hammock; Frances H,26,0,30,4
1649925913858,MATH 20C,B04,083454,Hammock; Frances H,30,0,30,0
1649925919884,MATH 20D,A01,084128,Staff,26,0,30,4
1649925919884,MATH 20D,A02,084129,Staff,30,0,30,0
1649925919884,MATH 20D,A03,084130,Staff,29,0,30,1
1649925919884,MATH 20D,B01,084133,Staff,21,0,30,9
1649925919884,MATH 20D,B02,084134,Staff,27,0,30,3
1649925919884,MATH 20D,B03,084135,Staff,30,0,30,0
1649925925912,MATH 20E,A01,084138,Staff,22,0,30,8
1649925925912,MATH 20E,A02,084139,Staff,22,0,30,8
1649925925912,MATH 20E,A03,084140,Staff,23,0,30,7
1649925925912,MATH 20E,A04,084141,Staff,25,0,30,5
1649925931939,MATH 102,A01,084143,Harel; Guershon,17,0,30,13
1649925931939,MATH 102,A02,084144,Harel; Guershon,22,0,30,8
1649925937964,MATH 103B,A01,083456,Staff,0,8,30,30
1649925937964,MATH 103B,A02,083457,Staff,0,9,30,30
1649925943988,MATH 109,A01,084146,Salehi Golsefidy; Alireza,28,0,30,2
1649925943988,MATH 109,A02,084147,Salehi Golsefidy; Alireza,22,0,30,8
1649925950012,MATH 120A,A01,085445,Eggers; John Dietrich,20,0,35,15
1649925950012,MATH 120A,A02,085446,Eggers; John Dietrich,28,0,35,7
1649925956037,MATH 142B,A01,084149,Verstraete; Jacques Allan,0,10,30,30
1649925956037,MATH 142B,A02,084150,Verstraete; Jacques Allan,0,9,30,30
1649925962061,MATH 170A,A01,083459,Nie; Jiawang,0,2,30,30
1649925962061,MATH 170A,A02,083460,Nie; Jiawang,0,0,30,30
1649925962061,MATH 170A,A03,083461,Nie; Jiawang,8,0,30,22
1649925968085,MATH 193B,A01,083463,Staff,3,0,30,27
1649925968085,MATH 193B,A02,083464,Staff,10,0,30,20
1649925968085,MATH 193B,A03,083465,Staff,19,0,30,11
1649925974150,COGS 2,A01,083966,Boyle; Mary E. T.,18,0,30,12
1649925980179,COGS 9,A01,083968,Staff,43,0,60,17
1649925986205,COGS 14B,A01,083970,Staff,28,0,50,22
1649925992231,COGS 17,A01,092679,Staff,67,0,75,8
1649925998255,COGS 100,A01,083972,Staff,10,0,60,50
1649926010309,COGS 101C,A01,083976,Staff,19,0,30,11
1649926016334,COGS 102A,A01,083978,Johnson; Christine M.,17,0,30,13
1649926022357,COGS 107B,A01,083980,Staff,3,0,50,47
1649926028382,COGS 115,A01,083982,Staff,14,0,30,16
1649926034406,COGS 118B,A01,083367,Staff,0,11,40,40
1649926040434,COGS 172,A01,083984,Provenzano; Emily Kara,17,0,30,13
1649926046458,COGS 177,A00,083368,Staff,0,17,30,30
1649926052482,COGS 186,A01,083986,Staff,21,0,40,19
1649926058507,COGS 187A,A01,083988,Boyle; Mary E. T.,24,0,60,36
1649926064530,CSE 8A,A50,084003,Miranda; Gregory Joseph,0,0,15,15
1649926070564,CSE 11,A01,084005,Miranda; Gregory Joseph,23,0,55,32
1649926076591,CSE 20,A01,084007,Staff,9,0,20,11
1649926082615,CSE 21,A01,084009,Staff,10,0,50,40
1649926088639,CSE 30,A01,083370,Cao; Yingjun,0,20,40,40
1649926094665,CSE 100,A01,083372,Cao; Yingjun,0,23,40,40
1649926100689,CSE 101,A01,084011,Staff,0,48,40,40
1649926106716,CSE 141,A01,083374,Eldon; John,0,51,75,75
1649926112741,CSE 141L,A01,083376,Eldon; John,0,56,75,75
1649926118774,CSE 175,A01,084013,Kumar; Rakesh,22,0,25,3
1649926124797,CSE 190,A00,092508,Dubnov; Shlomo,15,0,15,0
1649926130820,ECE 5,A01,084049,Morris; Karcher William,15,0,20,5
1649926136849,ECE 100,A01,084051,Baghdadchi; Saharnaz,1,0,20,19
1649926136849,ECE 100,A02,091916,Baghdadchi; Saharnaz,16,0,20,4
1649926142874,ECE 101,A01,084053,Baghdadchi; Saharnaz,4,0,37,33
1649926142874,ECE 101,A02,084054,Baghdadchi; Saharnaz,33,0,37,4
1649926148901,ECE 107,A01,083390,Staff,28,0,40,12
1649926154926,ECE 148,A01,084056,Silberman; Jack,7,0,12,5
1649926160954,ECE 180,A00,083391,Abi Samra; Nicholas Camill,25,0,30,5
1649926160954,ECE 180,B00,083392,Abi Samra; Nicholas Camill,22,0,30,8
1649926166989,MATH 10B,A01,084110,Staff,8,0,30,22
1649926166989,MATH 10B,A02,084111,Staff,29,0,30,1
1649926166989,MATH 10B,A03,084112,Staff,28,0,30,2
1649926173017,MATH 10C,A01,083443,Staff,9,0,30,21
1649926173017,MATH 10C,A02,083444,Staff,16,0,30,14
1649926173017,MATH 10C,B01,084114,Staff,25,0,30,5
1649926173017,MATH 10C,B02,084115,Staff,29,0,30,1
1649926179040,MATH 18,A01,084117,Harel; Guershon,27,0,30,3
1649926179040,MATH 18,A02,084119,Harel; Guershon,29,0,30,1
1649926179040,MATH 18,A03,084120,Harel; Guershon,30,0,30,0
1649926179040,MATH 18,A04,084121,Harel; Guershon,29,0,30,1
1649926185064,MATH 20B,A01,084124,Um; Ko Woon,31,0,35,4
1649926185064,MATH 20B,B01,084126,Um; Ko Woon,32,0,35,3
1649926191101,MATH 20C,A01,083446,Hammock; Frances H,17,0,30,13
1649926191101,MATH 20C,A02,083447,Hammock; Frances H,28,0,30,2
1649926191101,MATH 20C,A03,083448,Hammock; Frances H,30,0,30,0
1649926191101,MATH 20C,A04,083449,Hammock; Frances H,30,0,30,0
1649926191101,MATH 20C,B01,083451,Hammock; Frances H,25,0,30,5
1649926191101,MATH 20C,B02,083452,Hammock; Frances H,27,0,30,3
1649926191101,MATH 20C,B03,083453,Hammock; Frances H,26,0,30,4
1649926191101,MATH 20C,B04,083454,Hammock; Frances H,30,0,30,0
1649926197126,MATH 20D,A01,084128,Staff,26,0,30,4
1649926197126,MATH 20D,A02,084129,Staff,30,0,30,0
1649926197126,MATH 20D,A03,084130,Staff,29,0,30,1
1649926197126,MATH 20D,B01,084133,Staff,21,0,30,9
1649926197126,MATH 20D,B02,084134,Staff,27,0,30,3
1649926197126,MATH 20D,B03,084135,Staff,30,0,30,0
1649926203150,MATH 20E,A01,084138,Staff,22,0,30,8
1649926203150,MATH 20E,A02,084139,Staff,22,0,30,8
1649926203150,MATH 20E,A03,084140,Staff,23,0,30,7
1649926203150,MATH 20E,A04,084141,Staff,25,0,30,5
1649926209173,MATH 102,A01,084143,Harel; Guershon,16,0,30,14
1649926209173,MATH 102,A02,084144,Harel; Guershon,22,0,30,8
1649926215285,MATH 103B,A01,083456,Staff,0,8,30,30
1649926215285,MATH 103B,A02,083457,Staff,0,9,30,30
1649926221310,MATH 109,A01,084146,Salehi Golsefidy; Alireza,28,0,30,2
1649926221310,MATH 109,A02,084147,Salehi Golsefidy; Alireza,22,0,30,8
1649926227333,MATH 120A,A01,085445,Eggers; John Dietrich,20,0,35,15
1649926227333,MATH 120A,A02,085446,Eggers; John Dietrich,28,0,35,7
1649926233360,MATH 142B,A01,084149,Verstraete; Jacques Allan,0,10,30,30
1649926233360,MATH 142B,A02,084150,Verstraete; Jacques Allan,0,9,30,30
1649926239389,MATH 170A,A01,083459,Nie; Jiawang,0,2,30,30
1649926239389,MATH 170A,A02,083460,Nie; Jiawang,0,0,30,30
1649926239389,MATH 170A,A03,083461,Nie; Jiawang,8,0,30,22
1649926245425,MATH 193B,A01,083463,Staff,3,0,30,27
1649926245425,MATH 193B,A02,083464,Staff,10,0,30,20
1649926245425,MATH 193B,A03,083465,Staff,19,0,30,11
1649926251478,COGS 2,A01,083966,Boyle; Mary E. T.,18,0,30,12
1649926257503,COGS 9,A01,083968,Staff,43,0,60,17
1649926263604,COGS 14B,A01,083970,Staff,28,0,50,22
1649926269630,COGS 17,A01,092679,Staff,67,0,75,8
1649926275655,COGS 100,A01,083972,Staff,10,0,60,50
1649926287704,COGS 101C,A01,083976,Staff,19,0,30,11
1649926293728,COGS 102A,A01,083978,Johnson; Christine M.,17,0,30,13
1649926299753,COGS 107B,A01,083980,Staff,3,0,50,47
1649926305776,COGS 115,A01,083982,Staff,14,0,30,16
1649926311806,COGS 118B,A01,083367,Staff,0,11,40,40
1649926317832,COGS 172,A01,083984,Provenzano; Emily Kara,17,0,30,13
1649926323861,COGS 177,A00,083368,Staff,0,17,30,30
1649926329885,COGS 186,A01,083986,Staff,21,0,40,19
1649926335909,COGS 187A,A01,083988,Boyle; Mary E. T.,24,0,60,36
1649926341933,CSE 8A,A50,084003,Miranda; Gregory Joseph,0,0,15,15
1649926347964,CSE 11,A01,084005,Miranda; Gregory Joseph,23,0,55,32
1649926353994,CSE 20,A01,084007,Staff,9,0,20,11
1649926360021,CSE 21,A01,084009,Staff,10,0,50,40
1649926366049,CSE 30,A01,083370,Cao; Yingjun,0,20,40,40
1649926372077,CSE 100,A01,083372,Cao; Yingjun,0,23,40,40
1649926378100,CSE 101,A01,084011,Staff,0,48,40,40
1649926384126,CSE 141,A01,083374,Eldon; John,0,51,75,75
1649926390155,CSE 141L,A01,083376,Eldon; John,0,56,75,75
1649926396182,CSE 175,A01,084013,Kumar; Rakesh,22,0,25,3
1649926402206,CSE 190,A00,092508,Dubnov; Shlomo,15,0,15,0
1649926408233,ECE 5,A01,084049,Morris; Karcher William,15,0,20,5
1649926414262,ECE 100,A01,084051,Baghdadchi; Saharnaz,1,0,20,19
1649926414262,ECE 100,A02,091916,Baghdadchi; Saharnaz,16,0,20,4
1649926420287,ECE 101,A01,084053,Baghdadchi; Saharnaz,4,0,37,33
1649926420287,ECE 101,A02,084054,Baghdadchi; Saharnaz,33,0,37,4
1649926426311,ECE 107,A01,083390,Staff,28,0,40,12
1649926432340,ECE 148,A01,084056,Silberman; Jack,7,0,12,5
1649926438364,ECE 180,A00,083391,Abi Samra; Nicholas Camill,25,0,30,5
1649926438364,ECE 180,B00,083392,Abi Samra; Nicholas Camill,22,0,30,8
1649926444393,MATH 10B,A01,084110,Staff,8,0,30,22
1649926444393,MATH 10B,A02,084111,Staff,29,0,30,1
1649926444393,MATH 10B,A03,084112,Staff,28,0,30,2
1649926450418,MATH 10C,A01,083443,Staff,9,0,30,21
1649926450418,MATH 10C,A02,083444,Staff,16,0,30,14
1649926450418,MATH 10C,B01,084114,Staff,25,0,30,5
1649926450418,MATH 10C,B02,084115,Staff,29,0,30,1
1649926456443,MATH 18,A01,084117,Harel; Guershon,27,0,30,3
1649926456443,MATH 18,A02,084119,Harel; Guershon,29,0,30,1
1649926456443,MATH 18,A03,084120,Harel; Guershon,30,0,30,0
1649926456443,MATH 18,A04,084121,Harel; Guershon,29,0,30,1
1649926462468,MATH 20B,A01,084124,Um; Ko Woon,31,0,35,4
1649926462468,MATH 20B,B01,084126,Um; Ko Woon,32,0,35,3
1649926468499,MATH 20C,A01,083446,Hammock; Frances H,17,0,30,13
1649926468499,MATH 20C,A02,083447,Hammock; Frances H,28,0,30,2
1649926468499,MATH 20C,A03,083448,Hammock; Frances H,30,0,30,0
1649926468499,MATH 20C,A04,083449,Hammock; Frances H,30,0,30,0
1649926468499,MATH 20C,B01,083451,Hammock; Frances H,25,0,30,5
1649926468499,MATH 20C,B02,083452,Hammock; Frances H,27,0,30,3
1649926468499,MATH 20C,B03,083453,Hammock; Frances H,26,0,30,4
1649926468499,MATH 20C,B04,083454,Hammock; Frances H,30,0,30,0
1649926474536,MATH 20D,A01,084128,Staff,26,0,30,4
1649926474536,MATH 20D,A02,084129,Staff,30,0,30,0
1649926474536,MATH 20D,A03,084130,Staff,29,0,30,1
1649926474536,MATH 20D,B01,084133,Staff,21,0,30,9
1649926474536,MATH 20D,B02,084134,Staff,27,0,30,3
1649926474536,MATH 20D,B03,084135,Staff,30,0,30,0
1649926480565,MATH 20E,A01,084138,Staff,22,0,30,8
1649926480565,MATH 20E,A02,084139,Staff,22,0,30,8
1649926480565,MATH 20E,A03,084140,Staff,23,0,30,7
1649926480565,MATH 20E,A04,084141,Staff,25,0,30,5
1649926486589,MATH 102,A01,084143,Harel; Guershon,16,0,30,14
1649926486589,MATH 102,A02,084144,Harel; Guershon,22,0,30,8
1649926492618,MATH 103B,A01,083456,Staff,0,8,30,30
1649926492618,MATH 103B,A02,083457,Staff,0,9,30,30
1649926498646,MATH 109,A01,084146,Salehi Golsefidy; Alireza,28,0,30,2
1649926498646,MATH 109,A02,084147,Salehi Golsefidy; Alireza,22,0,30,8
1649926504674,MATH 120A,A01,085445,Eggers; John Dietrich,20,0,35,15
1649926504674,MATH 120A,A02,085446,Eggers; John Dietrich,28,0,35,7
1649926510703,MATH 142B,A01,084149,Verstraete; Jacques Allan,0,10,30,30
1649926510703,MATH 142B,A02,084150,Verstraete; Jacques Allan,0,9,30,30
1649926516727,MATH 170A,A01,083459,Nie; Jiawang,0,2,30,30
1649926516727,MATH 170A,A02,083460,Nie; Jiawang,0,0,30,30
1649926516727,MATH 170A,A03,083461,Nie; Jiawang,8,0,30,22
1649926522754,MATH 193B,A01,083463,Staff,3,0,30,27
1649926522754,MATH 193B,A02,083464,Staff,10,0,30,20
1649926522754,MATH 193B,A03,083465,Staff,19,0,30,11
1649926528816,COGS 2,A01,083966,Boyle; Mary E. T.,18,0,30,12
1649926534841,COGS 9,A01,083968,Staff,43,0,60,17
1649926540865,COGS 14B,A01,083970,Staff,28,0,50,22
1649926546889,COGS 17,A01,092679,Staff,67,0,75,8
1649926552913,COGS 100,A01,083972,Staff,10,0,60,50
1649926564967,COGS 101C,A01,083976,Staff,19,0,30,11
1649926570990,COGS 102A,A01,083978,Johnson; Christine M.,17,0,30,13
1649926577014,COGS 107B,A01,083980,Staff,3,0,50,47
1649926583040,COGS 115,A01,083982,Staff,14,0,30,16
1649926589069,COGS 118B,A01,083367,Staff,0,11,40,40
1649926595094,COGS 172,A01,083984,Provenzano; Emily Kara,17,0,30,13
1649926601129,COGS 177,A00,083368,Staff,0,17,30,30
1649926607153,COGS 186,A01,083986,Staff,21,0,40,19
1649926613178,COGS 187A,A01,083988,Boyle; Mary E. T.,24,0,60,36
1649926619202,CSE 8A,A50,084003,Miranda; Gregory Joseph,0,0,15,15
1649926625231,CSE 11,A01,084005,Miranda; Gregory Joseph,23,0,55,32
1649926631255,CSE 20,A01,084007,Staff,9,0,20,11
1649926637284,CSE 21,A01,084009,Staff,10,0,50,40
1649926643306,CSE 30,A01,083370,Cao; Yingjun,0,20,40,40
1649926649329,CSE 100,A01,083372,Cao; Yingjun,0,23,40,40
1649926655358,CSE 101,A01,084011,Staff,0,48,40,40
1649926661383,CSE 141,A01,083374,Eldon; John,0,51,75,75
1649926667408,CSE 141L,A01,083376,Eldon; John,0,56,75,75
1649926673436,CSE 175,A01,084013,Kumar; Rakesh,22,0,25,3
1649926679460,CSE 190,A00,092508,Dubnov; Shlomo,15,0,15,0
1649926685485,ECE 5,A01,084049,Morris; Karcher William,15,0,20,5
1649926691512,ECE 100,A01,084051,Baghdadchi; Saharnaz,1,0,20,19
1649926691512,ECE 100,A02,091916,Baghdadchi; Saharnaz,16,0,20,4
1649926697536,ECE 101,A01,084053,Baghdadchi; Saharnaz,4,0,37,33
1649926697536,ECE 101,A02,084054,Baghdadchi; Saharnaz,33,0,37,4
1649926703561,ECE 107,A01,083390,Staff,28,0,40,12
1649926709592,ECE 148,A01,084056,Silberman; Jack,7,0,12,5
1649926715620,ECE 180,A00,083391,Abi Samra; Nicholas Camill,25,0,30,5
1649926715620,ECE 180,B00,083392,Abi Samra; Nicholas Camill,22,0,30,8
1649926721643,MATH 10B,A01,084110,Staff,8,0,30,22
1649926721643,MATH 10B,A02,084111,Staff,29,0,30,1
1649926721643,MATH 10B,A03,084112,Staff,28,0,30,2
1649926727667,MATH 10C,A01,083443,Staff,9,0,30,21
1649926727667,MATH 10C,A02,083444,Staff,16,0,30,14
1649926727667,MATH 10C,B01,084114,Staff,25,0,30,5
1649926727667,MATH 10C,B02,084115,Staff,29,0,30,1
1649926733691,MATH 18,A01,084117,Harel; Guershon,27,0,30,3
1649926733691,MATH 18,A02,084119,Harel; Guershon,29,0,30,1
1649926733691,MATH 18,A03,084120,Harel; Guershon,30,0,30,0
1649926733691,MATH 18,A04,084121,Harel; Guershon,29,0,30,1
1649926739721,MATH 20B,A01,084124,Um; Ko Woon,31,0,35,4
1649926739721,MATH 20B,B01,084126,Um; Ko Woon,32,0,35,3
1649926745748,MATH 20C,A01,083446,Hammock; Frances H,17,0,30,13
1649926745748,MATH 20C,A02,083447,Hammock; Frances H,28,0,30,2
1649926745748,MATH 20C,A03,083448,Hammock; Frances H,30,0,30,0
1649926745748,MATH 20C,A04,083449,Hammock; Frances H,30,0,30,0
1649926745748,MATH 20C,B01,083451,Hammock; Frances H,25,0,30,5
1649926745748,MATH 20C,B02,083452,Hammock; Frances H,27,0,30,3
1649926745748,MATH 20C,B03,083453,Hammock; Frances H,26,0,30,4
1649926745748,MATH 20C,B04,083454,Hammock; Frances H,30,0,30,0
1649926751777,MATH 20D,A01,084128,Staff,26,0,30,4
1649926751777,MATH 20D,A02,084129,Staff,30,0,30,0
1649926751777,MATH 20D,A03,084130,Staff,29,0,30,1
1649926751777,MATH 20D,B01,084133,Staff,21,0,30,9
1649926751777,MATH 20D,B02,084134,Staff,27,0,30,3
1649926751777,MATH 20D,B03,084135,Staff,30,0,30,0
1649926757800,MATH 20E,A01,084138,Staff,22,0,30,8
1649926757800,MATH 20E,A02,084139,Staff,22,0,30,8
1649926757800,MATH 20E,A03,084140,Staff,23,0,30,7
1649926757800,MATH 20E,A04,084141,Staff,25,0,30,5
1649926763829,MATH 102,A01,084143,Harel; Guershon,16,0,30,14
1649926763829,MATH 102,A02,084144,Harel; Guershon,22,0,30,8
1649926769853,MATH 103B,A01,083456,Staff,0,8,30,30
1649926769853,MATH 103B,A02,083457,Staff,0,9,30,30
1649926775876,MATH 109,A01,084146,Salehi Golsefidy; Alireza,28,0,30,2
1649926775876,MATH 109,A02,084147,Salehi Golsefidy; Alireza,22,0,30,8
1649926781899,MATH 120A,A01,085445,Eggers; John Dietrich,20,0,35,15
1649926781899,MATH 120A,A02,085446,Eggers; John Dietrich,28,0,35,7
1649926787923,MATH 142B,A01,084149,Verstraete; Jacques Allan,0,10,30,30
1649926787923,MATH 142B,A02,084150,Verstraete; Jacques Allan,0,9,30,30
1649926793951,MATH 170A,A01,083459,Nie; Jiawang,0,2,30,30
1649926793951,MATH 170A,A02,083460,Nie; Jiawang,0,0,30,30
1649926793951,MATH 170A,A03,083461,Nie; Jiawang,8,0,30,22
1649926799979,MATH 193B,A01,083463,Staff,3,0,30,27
1649926799979,MATH 193B,A02,083464,Staff,10,0,30,20
1649926799979,MATH 193B,A03,083465,Staff,19,0,30,11
1649926806132,COGS 2,A01,083966,Boyle; Mary E. T.,18,0,30,12
1649926812159,COGS 9,A01,083968,Staff,42,0,60,18
1649926818187,COGS 14B,A01,083970,Staff,28,0,50,22
1649926824210,COGS 17,A01,092679,Staff,67,0,75,8
1649926830233,COGS 100,A01,083972,Staff,10,0,60,50
1649926842279,COGS 101C,A01,083976,Staff,19,0,30,11
1649926848304,COGS 102A,A01,083978,Johnson; Christine M.,17,0,30,13
1649926854330,COGS 107B,A01,083980,Staff,3,0,50,47
1649926860353,COGS 115,A01,083982,Staff,14,0,30,16
1649926866385,COGS 118B,A01,083367,Staff,0,11,40,40
1649926872415,COGS 172,A01,083984,Provenzano; Emily Kara,17,0,30,13
1649926878443,COGS 177,A00,083368,Staff,0,17,30,30
1649926884469,COGS 186,A01,083986,Staff,21,0,40,19
1649926890493,COGS 187A,A01,083988,Boyle; Mary E. T.,24,0,60,36
1649926896519,CSE 8A,A50,084003,Miranda; Gregory Joseph,0,0,15,15
1649926902549,CSE 11,A01,084005,Miranda; Gregory Joseph,23,0,55,32
1649926908575,CSE 20,A01,084007,Staff,9,0,20,11
1649926914605,CSE 21,A01,084009,Staff,10,0,50,40
1649926920635,CSE 30,A01,083370,Cao; Yingjun,0,20,40,40
1649926926661,CSE 100,A01,083372,Cao; Yingjun,0,23,40,40
1649926932690,CSE 101,A01,084011,Staff,0,48,40,40
1649926938721,CSE 141,A01,083374,Eldon; John,0,51,75,75
1649926944745,CSE 141L,A01,083376,Eldon; John,0,56,75,75
1649926950773,CSE 175,A01,084013,Kumar; Rakesh,22,0,25,3
1649926956802,CSE 190,A00,092508,Dubnov; Shlomo,15,0,15,0
1649926962828,ECE 5,A01,084049,Morris; Karcher William,15,0,20,5
1649926968854,ECE 100,A01,084051,Baghdadchi; Saharnaz,1,0,20,19
1649926968854,ECE 100,A02,091916,Baghdadchi; Saharnaz,16,0,20,4
1649926974881,ECE 101,A01,084053,Baghdadchi; Saharnaz,5,0,37,32
1649926974881,ECE 101,A02,084054,Baghdadchi; Saharnaz,33,0,37,4
1649926980907,ECE 107,A01,083390,Staff,28,0,40,12
1649926986931,ECE 148,A01,084056,Silberman; Jack,7,0,12,5
1649926992960,ECE 180,A00,083391,Abi Samra; Nicholas Camill,25,0,30,5
1649926992960,ECE 180,B00,083392,Abi Samra; Nicholas Camill,22,0,30,8
1649926998986,MATH 10B,A01,084110,Staff,8,0,30,22
1649926998986,MATH 10B,A02,084111,Staff,29,0,30,1
1649926998986,MATH 10B,A03,084112,Staff,28,0,30,2
1649927005014,MATH 10C,A01,083443,Staff,9,0,30,21
1649927005014,MATH 10C,A02,083444,Staff,16,0,30,14
1649927005014,MATH 10C,B01,084114,Staff,25,0,30,5
1649927005014,MATH 10C,B02,084115,Staff,29,0,30,1
1649927011043,MATH 18,A01,084117,Harel; Guershon,27,0,30,3
1649927011043,MATH 18,A02,084119,Harel; Guershon,29,0,30,1
1649927011043,MATH 18,A03,084120,Harel; Guershon,30,0,30,0
1649927011043,MATH 18,A04,084121,Harel; Guershon,29,0,30,1
1649927017073,MATH 20B,A01,084124,Um; Ko Woon,31,0,35,4
1649927017073,MATH 20B,B01,084126,Um; Ko Woon,32,0,35,3
1649927023099,MATH 20C,A01,083446,Hammock; Frances H,17,0,30,13
1649927023099,MATH 20C,A02,083447,Hammock; Frances H,28,0,30,2
1649927023099,MATH 20C,A03,083448,Hammock; Frances H,30,0,30,0
1649927023099,MATH 20C,A04,083449,Hammock; Frances H,30,0,30,0
1649927023099,MATH 20C,B01,083451,Hammock; Frances H,25,0,30,5
1649927023099,MATH 20C,B02,083452,Hammock; Frances H,27,0,30,3
1649927023099,MATH 20C,B03,083453,Hammock; Frances H,26,0,30,4
1649927023099,MATH 20C,B04,083454,Hammock; Frances H,30,0,30,0
1649927029128,MATH 20D,A01,084128,Staff,26,0,30,4
1649927029128,MATH 20D,A02,084129,Staff,30,0,30,0
1649927029128,MATH 20D,A03,084130,Staff,29,0,30,1
1649927029128,MATH 20D,B01,084133,Staff,21,0,30,9
1649927029128,MATH 20D,B02,084134,Staff,27,0,30,3
1649927029128,MATH 20D,B03,084135,Staff,30,0,30,0
1649927035157,MATH 20E,A01,084138,Staff,22,0,30,8
1649927035157,MATH 20E,A02,084139,Staff,22,0,30,8
1649927035157,MATH 20E,A03,084140,Staff,23,0,30,7
1649927035157,MATH 20E,A04,084141,Staff,25,0,30,5
1649927041182,MATH 102,A01,084143,Harel; Guershon,16,0,30,14
1649927041182,MATH 102,A02,084144,Harel; Guershon,22,0,30,8
1649927047206,MATH 103B,A01,083456,Staff,0,8,30,30
1649927047206,MATH 103B,A02,083457,Staff,0,9,30,30
1649927053233,MATH 109,A01,084146,Salehi Golsefidy; Alireza,28,0,30,2
1649927053233,MATH 109,A02,084147,Salehi Golsefidy; Alireza,22,0,30,8
1649927059257,MATH 120A,A01,085445,Eggers; John Dietrich,20,0,35,15
1649927059257,MATH 120A,A02,085446,Eggers; John Dietrich,28,0,35,7
1649927065279,MATH 142B,A01,084149,Verstraete; Jacques Allan,0,10,30,30
1649927065279,MATH 142B,A02,084150,Verstraete; Jacques Allan,0,9,30,30
1649927071307,MATH 170A,A01,083459,Nie; Jiawang,0,2,30,30
1649927071307,MATH 170A,A02,083460,Nie; Jiawang,0,0,30,30
1649927071307,MATH 170A,A03,083461,Nie; Jiawang,7,0,30,23
1649927077330,MATH 193B,A01,083463,Staff,3,0,30,27
1649927077330,MATH 193B,A02,083464,Staff,10,0,30,20
1649927077330,MATH 193B,A03,083465,Staff,19,0,30,11
1649927083409,COGS 2,A01,083966,Boyle; Mary E. T.,18,0,30,12
1649927089433,COGS 9,A01,083968,Staff,42,0,60,18
1649927095458,COGS 14B,A01,083970,Staff,28,0,50,22
1649927101480,COGS 17,A01,092679,Staff,67,0,75,8
1649927107505,COGS 100,A01,083972,Staff,10,0,60,50
1649927119564,COGS 101C,A01,083976,Staff,19,0,30,11
1649927125597,COGS 102A,A01,083978,Johnson; Christine M.,17,0,30,13
1649927131624,COGS 107B,A01,083980,Staff,3,0,50,47
1649927137652,COGS 115,A01,083982,Staff,14,0,30,16
1649927143678,COGS 118B,A01,083367,Staff,0,11,40,40
1649927149708,COGS 172,A01,083984,Provenzano; Emily Kara,17,0,30,13
1649927155731,COGS 177,A00,083368,Staff,0,17,30,30
1649927161756,COGS 186,A01,083986,Staff,21,0,40,19
1649927167783,COGS 187A,A01,083988,Boyle; Mary E. T.,24,0,60,36
1649927173808,CSE 8A,A50,084003,Miranda; Gregory Joseph,0,0,15,15
1649927179830,CSE 11,A01,084005,Miranda; Gregory Joseph,23,0,55,32
1649927185854,CSE 20,A01,084007,Staff,9,0,20,11
1649927191878,CSE 21,A01,084009,Staff,10,0,50,40
1649927197903,CSE 30,A01,083370,Cao; Yingjun,0,20,40,40
1649927203932,CSE 100,A01,083372,Cao; Yingjun,0,23,40,40
1649927209957,CSE 101,A01,084011,Staff,0,48,40,40
1649927215982,CSE 141,A01,083374,Eldon; John,0,51,75,75
1649927222005,CSE 141L,A01,083376,Eldon; John,0,56,75,75
1649927228032,CSE 175,A01,084013,Kumar; Rakesh,22,0,25,3
1649927234059,CSE 190,A00,092508,Dubnov; Shlomo,15,0,15,0
1649927240090,ECE 5,A01,084049,Morris; Karcher William,15,0,20,5
1649927246117,ECE 100,A01,084051,Baghdadchi; Saharnaz,1,0,20,19
1649927246117,ECE 100,A02,091916,Baghdadchi; Saharnaz,16,0,20,4
1649927252141,ECE 101,A01,084053,Baghdadchi; Saharnaz,5,0,37,32
1649927252141,ECE 101,A02,084054,Baghdadchi; Saharnaz,33,0,37,4
1649927258167,ECE 107,A01,083390,Staff,28,0,40,12
1649927264195,ECE 148,A01,084056,Silberman; Jack,7,0,12,5
1649927270224,ECE 180,A00,083391,Abi Samra; Nicholas Camill,25,0,30,5
1649927270224,ECE 180,B00,083392,Abi Samra; Nicholas Camill,22,0,30,8
1649927276248,MATH 10B,A01,084110,Staff,8,0,30,22
1649927276248,MATH 10B,A02,084111,Staff,29,0,30,1
1649927276248,MATH 10B,A03,084112,Staff,28,0,30,2
1649927282272,MATH 10C,A01,083443,Staff,9,0,30,21
1649927282272,MATH 10C,A02,083444,Staff,16,0,30,14
1649927282272,MATH 10C,B01,084114,Staff,25,0,30,5
1649927282272,MATH 10C,B02,084115,Staff,29,0,30,1
1649927288299,MATH 18,A01,084117,Harel; Guershon,27,0,30,3
1649927288299,MATH 18,A02,084119,Harel; Guershon,29,0,30,1
1649927288299,MATH 18,A03,084120,Harel; Guershon,30,0,30,0
1649927288299,MATH 18,A04,084121,Harel; Guershon,29,0,30,1
1649927294323,MATH 20B,A01,084124,Um; Ko Woon,31,0,35,4
1649927294323,MATH 20B,B01,084126,Um; Ko Woon,32,0,35,3
1649927300346,MATH 20C,A01,083446,Hammock; Frances H,17,0,30,13
1649927300346,MATH 20C,A02,083447,Hammock; Frances H,28,0,30,2
1649927300346,MATH 20C,A03,083448,Hammock; Frances H,30,0,30,0
1649927300346,MATH 20C,A04,083449,Hammock; Frances H,30,0,30,0
1649927300346,MATH 20C,B01,083451,Hammock; Frances H,25,0,30,5
1649927300346,MATH 20C,B02,083452,Hammock; Frances H,27,0,30,3
1649927300346,MATH 20C,B03,083453,Hammock; Frances H,26,0,30,4
1649927300346,MATH 20C,B04,083454,Hammock; Frances H,30,0,30,0
1649927306377,MATH 20D,A01,084128,Staff,26,0,30,4
1649927306377,MATH 20D,A02,084129,Staff,30,0,30,0
1649927306377,MATH 20D,A03,084130,Staff,29,0,30,1
1649927306377,MATH 20D,B01,084133,Staff,21,0,30,9
1649927306377,MATH 20D,B02,084134,Staff,27,0,30,3
1649927306377,MATH 20D,B03,084135,Staff,30,0,30,0
1649927312404,MATH 20E,A01,084138,Staff,22,0,30,8
1649927312404,MATH 20E,A02,084139,Staff,22,0,30,8
1649927312404,MATH 20E,A03,084140,Staff,23,0,30,7
1649927312404,MATH 20E,A04,084141,Staff,25,0,30,5
1649927318426,MATH 102,A01,084143,Harel; Guershon,16,0,30,14
1649927318426,MATH 102,A02,084144,Harel; Guershon,22,0,30,8
1649927324450,MATH 103B,A01,083456,Staff,0,8,30,30
1649927324450,MATH 103B,A02,083457,Staff,0,9,30,30
1649927330474,MATH 109,A01,084146,Salehi Golsefidy; Alireza,28,0,30,2
1649927330474,MATH 109,A02,084147,Salehi Golsefidy; Alireza,22,0,30,8
1649927336499,MATH 120A,A01,085445,Eggers; John Dietrich,20,0,35,15
1649927336499,MATH 120A,A02,085446,Eggers; John Dietrich,28,0,35,7
1649927342526,MATH 142B,A01,084149,Verstraete; Jacques Allan,0,10,30,30
1649927342526,MATH 142B,A02,084150,Verstraete; Jacques Allan,0,9,30,30
1649927348552,MATH 170A,A01,083459,Nie; Jiawang,0,2,30,30
1649927348552,MATH 170A,A02,083460,Nie; Jiawang,0,0,30,30
1649927348552,MATH 170A,A03,083461,Nie; Jiawang,7,0,30,23
1649927354579,MATH 193B,A01,083463,Staff,3,0,30,27
1649927354579,MATH 193B,A02,083464,Staff,10,0,30,20
1649927354579,MATH 193B,A03,083465,Staff,19,0,30,11
1649927360633,COGS 2,A01,083966,Boyle; Mary E. T.,18,0,30,12
1649927366659,COGS 9,A01,083968,Staff,42,0,60,18
1649927372692,COGS 14B,A01,083970,Staff,28,0,50,22
1649927378721,COGS 17,A01,092679,Staff,67,0,75,8
1649927384747,COGS 100,A01,083972,Staff,10,0,60,50
1649927396800,COGS 101C,A01,083976,Staff,19,0,30,11
1649927402935,COGS 102A,A01,083978,Johnson; Christine M.,17,0,30,13
1649927408958,COGS 107B,A01,083980,Staff,3,0,50,47
1649927414988,COGS 115,A01,083982,Staff,14,0,30,16
1649927421012,COGS 118B,A01,083367,Staff,0,11,40,40
1649927427036,COGS 172,A01,083984,Provenzano; Emily Kara,17,0,30,13
1649927433058,COGS 177,A00,083368,Staff,0,17,30,30
1649927439080,COGS 186,A01,083986,Staff,21,0,40,19
1649927445101,COGS 187A,A01,083988,Boyle; Mary E. T.,24,0,60,36
1649927451124,CSE 8A,A50,084003,Miranda; Gregory Joseph,0,1,15,15
1649927457147,CSE 11,A01,084005,Miranda; Gregory Joseph,22,0,55,33
1649927463176,CSE 20,A01,084007,Staff,9,0,20,11
1649927469203,CSE 21,A01,084009,Staff,10,0,50,40
1649927475230,CSE 30,A01,083370,Cao; Yingjun,0,20,40,40
1649927481258,CSE 100,A01,083372,Cao; Yingjun,0,23,40,40
1649927487285,CSE 101,A01,084011,Staff,0,48,40,40
1649927493308,CSE 141,A01,083374,Eldon; John,0,51,75,75
1649927499331,CSE 141L,A01,083376,Eldon; John,0,56,75,75
1649927505354,CSE 175,A01,084013,Kumar; Rakesh,22,0,25,3
1649927511376,CSE 190,A00,092508,Dubnov; Shlomo,15,0,15,0
1649927517400,ECE 5,A01,084049,Morris; Karcher William,15,0,20,5
1649927523422,ECE 100,A01,084051,Baghdadchi; Saharnaz,1,0,20,19
1649927523422,ECE 100,A02,091916,Baghdadchi; Saharnaz,16,0,20,4
1649927529450,ECE 101,A01,084053,Baghdadchi; Saharnaz,5,0,37,32
1649927529450,ECE 101,A02,084054,Baghdadchi; Saharnaz,33,0,37,4
1649927535482,ECE 107,A01,083390,Staff,28,0,40,12
1649927541510,ECE 148,A01,084056,Silberman; Jack,7,0,12,5
1649927547537,ECE 180,A00,083391,Abi Samra; Nicholas Camill,25,0,30,5
1649927547537,ECE 180,B00,083392,Abi Samra; Nicholas Camill,22,0,30,8
1649927553560,MATH 10B,A01,084110,Staff,8,0,30,22
1649927553560,MATH 10B,A02,084111,Staff,29,0,30,1
1649927553560,MATH 10B,A03,084112,Staff,28,0,30,2
1649927559594,MATH 10C,A01,083443,Staff,9,0,30,21
1649927559594,MATH 10C,A02,083444,Staff,16,0,30,14
1649927559594,MATH 10C,B01,084114,Staff,25,0,30,5
1649927559594,MATH 10C,B02,084115,Staff,29,0,30,1
1649927565619,MATH 18,A01,084117,Harel; Guershon,27,0,30,3
1649927565619,MATH 18,A02,084119,Harel; Guershon,29,0,30,1
1649927565619,MATH 18,A03,084120,Harel; Guershon,30,0,30,0
1649927565619,MATH 18,A04,084121,Harel; Guershon,29,0,30,1
1649927571657,MATH 20B,A01,084124,Um; Ko Woon,31,0,35,4
1649927571657,MATH 20B,B01,084126,Um; Ko Woon,32,0,35,3
1649927577681,MATH 20C,A01,083446,Hammock; Frances H,17,0,30,13
1649927577681,MATH 20C,A02,083447,Hammock; Frances H,28,0,30,2
1649927577681,MATH 20C,A03,083448,Hammock; Frances H,30,0,30,0
1649927577681,MATH 20C,A04,083449,Hammock; Frances H,30,0,30,0
1649927577681,MATH 20C,B01,083451,Hammock; Frances H,25,0,30,5
1649927577681,MATH 20C,B02,083452,Hammock; Frances H,27,0,30,3
1649927577681,MATH 20C,B03,083453,Hammock; Frances H,26,0,30,4
1649927577681,MATH 20C,B04,083454,Hammock; Frances H,30,0,30,0
1649927583706,MATH 20D,A01,084128,Staff,26,0,30,4
1649927583706,MATH 20D,A02,084129,Staff,30,0,30,0
1649927583706,MATH 20D,A03,084130,Staff,29,0,30,1
1649927583706,MATH 20D,B01,084133,Staff,21,0,30,9
1649927583706,MATH 20D,B02,084134,Staff,27,0,30,3
1649927583706,MATH 20D,B03,084135,Staff,30,0,30,0
1649927589808,MATH 20E,A01,084138,Staff,22,0,30,8
1649927589808,MATH 20E,A02,084139,Staff,22,0,30,8
1649927589808,MATH 20E,A03,084140,Staff,23,0,30,7
1649927589808,MATH 20E,A04,084141,Staff,25,0,30,5
1649927595844,MATH 102,A01,084143,Harel; Guershon,16,0,30,14
1649927595844,MATH 102,A02,084144,Harel; Guershon,22,0,30,8
1649927601872,MATH 103B,A01,083456,Staff,0,8,30,30
1649927601872,MATH 103B,A02,083457,Staff,0,9,30,30
1649927607895,MATH 109,A01,084146,Salehi Golsefidy; Alireza,28,0,30,2
1649927607895,MATH 109,A02,084147,Salehi Golsefidy; Alireza,22,0,30,8
1649927613919,MATH 120A,A01,085445,Eggers; John Dietrich,20,0,35,15
1649927613919,MATH 120A,A02,085446,Eggers; John Dietrich,28,0,35,7
1649927619943,MATH 142B,A01,084149,Verstraete; Jacques Allan,0,10,30,30
1649927619943,MATH 142B,A02,084150,Verstraete; Jacques Allan,0,9,30,30
1649927625966,MATH 170A,A01,083459,Nie; Jiawang,0,2,30,30
1649927625966,MATH 170A,A02,083460,Nie; Jiawang,0,0,30,30
1649927625966,MATH 170A,A03,083461,Nie; Jiawang,7,0,30,23
1649927632002,MATH 193B,A01,083463,Staff,3,0,30,27
1649927632002,MATH 193B,A02,083464,Staff,10,0,30,20
1649927632002,MATH 193B,A03,083465,Staff,19,0,30,11
1649927638066,COGS 2,A01,083966,Boyle; Mary E. T.,18,0,30,12
1649927644090,COGS 9,A01,083968,Staff,42,0,60,18
1649927650117,COGS 14B,A01,083970,Staff,28,0,50,22
1649927656147,COGS 17,A01,092679,Staff,67,0,75,8
1649927662170,COGS 100,A01,083972,Staff,10,0,60,50
1649927674218,COGS 101C,A01,083976,Staff,19,0,30,11
1649927680241,COGS 102A,A01,083978,Johnson; Christine M.,17,0,30,13
1649927686269,COGS 107B,A01,083980,Staff,3,0,50,47
1649927692295,COGS 115,A01,083982,Staff,14,0,30,16
1649927698317,COGS 118B,A01,083367,Staff,0,11,40,40
1649927704340,COGS 172,A01,083984,Provenzano; Emily Kara,17,0,30,13
1649927710367,COGS 177,A00,083368,Staff,0,17,30,30
1649927716394,COGS 186,A01,083986,Staff,21,0,40,19
1649927722416,COGS 187A,A01,083988,Boyle; Mary E. T.,24,0,60,36
1649927728439,CSE 8A,A50,084003,Miranda; Gregory Joseph,0,1,15,15
1649927734463,CSE 11,A01,084005,Miranda; Gregory Joseph,22,0,55,33
1649927740489,CSE 20,A01,084007,Staff,9,0,20,11
1649927746514,CSE 21,A01,084009,Staff,10,0,50,40
1649927752537,CSE 30,A01,083370,Cao; Yingjun,0,20,40,40
1649927758564,CSE 100,A01,083372,Cao; Yingjun,0,23,40,40
1649927764587,CSE 101,A01,084011,Staff,0,48,40,40
1649927770614,CSE 141,A01,083374,Eldon; John,0,51,75,75
1649927776641,CSE 141L,A01,083376,Eldon; John,0,56,75,75
1649927782667,CSE 175,A01,084013,Kumar; Rakesh,22,0,25,3
1649927788690,CSE 190,A00,092508,Dubnov; Shlomo,15,0,15,0
1649927794713,ECE 5,A01,084049,Morris; Karcher William,15,0,20,5
1649927800736,ECE 100,A01,084051,Baghdadchi; Saharnaz,1,0,20,19
1649927800736,ECE 100,A02,091916,Baghdadchi; Saharnaz,16,0,20,4
1649927806760,ECE 101,A01,084053,Baghdadchi; Saharnaz,5,0,37,32
1649927806760,ECE 101,A02,084054,Baghdadchi; Saharnaz,33,0,37,4
1649927812785,ECE 107,A01,083390,Staff,28,0,40,12
1649927818808,ECE 148,A01,084056,Silberman; Jack,7,0,12,5
1649927824836,ECE 180,A00,083391,Abi Samra; Nicholas Camill,25,0,30,5
1649927824836,ECE 180,B00,083392,Abi Samra; Nicholas Camill,22,0,30,8
1649927830865,MATH 10B,A01,084110,Staff,8,0,30,22
1649927830865,MATH 10B,A02,084111,Staff,29,0,30,1
1649927830865,MATH 10B,A03,084112,Staff,28,0,30,2
1649927836889,MATH 10C,A01,083443,Staff,9,0,30,21
1649927836889,MATH 10C,A02,083444,Staff,16,0,30,14
1649927836889,MATH 10C,B01,084114,Staff,25,0,30,5
1649927836889,MATH 10C,B02,084115,Staff,29,0,30,1
1649927842913,MATH 18,A01,084117,Harel; Guershon,27,0,30,3
1649927842913,MATH 18,A02,084119,Harel; Guershon,29,0,30,1
1649927842913,MATH 18,A03,084120,Harel; Guershon,30,0,30,0
1649927842913,MATH 18,A04,084121,Harel; Guershon,29,0,30,1
1649927848936,MATH 20B,A01,084124,Um; Ko Woon,31,0,35,4
1649927848936,MATH 20B,B01,084126,Um; Ko Woon,32,0,35,3
1649927854965,MATH 20C,A01,083446,Hammock; Frances H,17,0,30,13
1649927854965,MATH 20C,A02,083447,Hammock; Frances H,28,0,30,2
1649927854965,MATH 20C,A03,083448,Hammock; Frances H,30,0,30,0
1649927854965,MATH 20C,A04,083449,Hammock; Frances H,30,0,30,0
1649927854965,MATH 20C,B01,083451,Hammock; Frances H,25,0,30,5
1649927854965,MATH 20C,B02,083452,Hammock; Frances H,27,0,30,3
1649927854965,MATH 20C,B03,083453,Hammock; Frances H,26,0,30,4
1649927854965,MATH 20C,B04,083454,Hammock; Frances H,30,0,30,0
1649927860988,MATH 20D,A01,084128,Staff,26,0,30,4
1649927860988,MATH 20D,A02,084129,Staff,30,0,30,0
1649927860988,MATH 20D,A03,084130,Staff,29,0,30,1
1649927860988,MATH 20D,B01,084133,Staff,21,0,30,9
1649927860988,MATH 20D,B02,084134,Staff,27,0,30,3
1649927860988,MATH 20D,B03,084135,Staff,30,0,30,0
1649927867015,MATH 20E,A01,084138,Staff,22,0,30,8
1649927867015,MATH 20E,A02,084139,Staff,22,0,30,8
1649927867015,MATH 20E,A03,084140,Staff,23,0,30,7
1649927867015,MATH 20E,A04,084141,Staff,25,0,30,5
1649927873043,MATH 102,A01,084143,Harel; Guershon,16,0,30,14
1649927873043,MATH 102,A02,084144,Harel; Guershon,22,0,30,8
1649927879085,MATH 103B,A01,083456,Staff,0,8,30,30
1649927879085,MATH 103B,A02,083457,Staff,0,9,30,30
1649927885109,MATH 109,A01,084146,Salehi Golsefidy; Alireza,28,0,30,2
1649927885109,MATH 109,A02,084147,Salehi Golsefidy; Alireza,22,0,30,8
1649927891149,MATH 120A,A01,085445,Eggers; John Dietrich,20,0,35,15
1649927891149,MATH 120A,A02,085446,Eggers; John Dietrich,28,0,35,7
1649927897174,MATH 142B,A01,084149,Verstraete; Jacques Allan,0,10,30,30
1649927897174,MATH 142B,A02,084150,Verstraete; Jacques Allan,0,9,30,30
1649927903202,MATH 170A,A01,083459,Nie; Jiawang,0,2,30,30
1649927903202,MATH 170A,A02,083460,Nie; Jiawang,0,0,30,30
1649927903202,MATH 170A,A03,083461,Nie; Jiawang,7,0,30,23
1649927909229,MATH 193B,A01,083463,Staff,3,0,30,27
1649927909229,MATH 193B,A02,083464,Staff,10,0,30,20
1649927909229,MATH 193B,A03,083465,Staff,19,0,30,11
1649927915293,COGS 2,A01,083966,Boyle; Mary E. T.,18,0,30,12
1649927921317,COGS 9,A01,083968,Staff,42,0,60,18
1649927927343,COGS 14B,A01,083970,Staff,28,0,50,22
1649927933368,COGS 17,A01,092679,Staff,67,0,75,8
1649927939402,COGS 100,A01,083972,Staff,10,0,60,50
1649927951458,COGS 101C,A01,083976,Staff,19,0,30,11
1649927957482,COGS 102A,A01,083978,Johnson; Christine M.,17,0,30,13
1649927963508,COGS 107B,A01,083980,Staff,3,0,50,47
1649927969530,COGS 115,A01,083982,Staff,14,0,30,16
1649927975563,COGS 118B,A01,083367,Staff,0,11,40,40
1649927981597,COGS 172,A01,083984,Provenzano; Emily Kara,17,0,30,13
1649927987620,COGS 177,A00,083368,Staff,0,17,30,30
1649927993641,COGS 186,A01,083986,Staff,21,0,40,19
1649927999759,COGS 187A,A01,083988,Boyle; Mary E. T.,24,0,60,36
1649928005782,CSE 8A,A50,084003,Miranda; Gregory Joseph,0,0,15,15
1649928011809,CSE 11,A01,084005,Miranda; Gregory Joseph,22,0,55,33
1649928017833,CSE 20,A01,084007,Staff,9,0,20,11
1649928023861,CSE 21,A01,084009,Staff,10,0,50,40
1649928029884,CSE 30,A01,083370,Cao; Yingjun,0,20,40,40
1649928035909,CSE 100,A01,083372,Cao; Yingjun,0,23,40,40
1649928041936,CSE 101,A01,084011,Staff,0,48,40,40
1649928047965,CSE 141,A01,083374,Eldon; John,0,51,75,75
1649928053989,CSE 141L,A01,083376,Eldon; John,0,56,75,75
1649928060012,CSE 175,A01,084013,Kumar; Rakesh,22,0,25,3
1649928066035,CSE 190,A00,092508,Dubnov; Shlomo,15,0,15,0
1649928072058,ECE 5,A01,084049,Morris; Karcher William,15,0,20,5
1649928078081,ECE 100,A01,084051,Baghdadchi; Saharnaz,1,0,20,19
1649928078081,ECE 100,A02,091916,Baghdadchi; Saharnaz,16,0,20,4
1649928084108,ECE 101,A01,084053,Baghdadchi; Saharnaz,5,0,37,32
1649928084108,ECE 101,A02,084054,Baghdadchi; Saharnaz,33,0,37,4
1649928090135,ECE 107,A01,083390,Staff,28,0,40,12
1649928096174,ECE 148,A01,084056,Silberman; Jack,7,0,12,5
1649928102200,ECE 180,A00,083391,Abi Samra; Nicholas Camill,25,0,30,5
1649928102200,ECE 180,B00,083392,Abi Samra; Nicholas Camill,22,0,30,8
1649928108226,MATH 10B,A01,084110,Staff,8,0,30,22
1649928108226,MATH 10B,A02,084111,Staff,29,0,30,1
1649928108226,MATH 10B,A03,084112,Staff,28,0,30,2
1649928114249,MATH 10C,A01,083443,Staff,9,0,30,21
1649928114249,MATH 10C,A02,083444,Staff,16,0,30,14
1649928114249,MATH 10C,B01,084114,Staff,25,0,30,5
1649928114249,MATH 10C,B02,084115,Staff,29,0,30,1
1649928120281,MATH 18,A01,084117,Harel; Guershon,27,0,30,3
1649928120281,MATH 18,A02,084119,Harel; Guershon,29,0,30,1
1649928120281,MATH 18,A03,084120,Harel; Guershon,30,0,30,0
1649928120281,MATH 18,A04,084121,Harel; Guershon,29,0,30,1
1649928126304,MATH 20B,A01,084124,Um; Ko Woon,31,0,35,4
1649928126304,MATH 20B,B01,084126,Um; Ko Woon,32,0,35,3
1649928132337,MATH 20C,A01,083446,Hammock; Frances H,17,0,30,13
1649928132337,MATH 20C,A02,083447,Hammock; Frances H,28,0,30,2
1649928132337,MATH 20C,A03,083448,Hammock; Frances H,30,0,30,0
1649928132337,MATH 20C,A04,083449,Hammock; Frances H,30,0,30,0
1649928132337,MATH 20C,B01,083451,Hammock; Frances H,25,0,30,5
1649928132337,MATH 20C,B02,083452,Hammock; Frances H,27,0,30,3
1649928132337,MATH 20C,B03,083453,Hammock; Frances H,26,0,30,4
1649928132337,MATH 20C,B04,083454,Hammock; Frances H,30,0,30,0
1649928138363,MATH 20D,A01,084128,Staff,26,0,30,4
1649928138363,MATH 20D,A02,084129,Staff,30,0,30,0
1649928138363,MATH 20D,A03,084130,Staff,29,0,30,1
1649928138363,MATH 20D,B01,084133,Staff,21,0,30,9
1649928138363,MATH 20D,B02,084134,Staff,27,0,30,3
1649928138363,MATH 20D,B03,084135,Staff,30,0,30,0
1649928144389,MATH 20E,A01,084138,Staff,22,0,30,8
1649928144389,MATH 20E,A02,084139,Staff,22,0,30,8
1649928144389,MATH 20E,A03,084140,Staff,23,0,30,7
1649928144389,MATH 20E,A04,084141,Staff,25,0,30,5
1649928150422,MATH 102,A01,084143,Harel; Guershon,16,0,30,14
1649928150422,MATH 102,A02,084144,Harel; Guershon,22,0,30,8
1649928156446,MATH 103B,A01,083456,Staff,0,8,30,30
1649928156446,MATH 103B,A02,083457,Staff,0,9,30,30
1649928162471,MATH 109,A01,084146,Salehi Golsefidy; Alireza,28,0,30,2
1649928162471,MATH 109,A02,084147,Salehi Golsefidy; Alireza,22,0,30,8
1649928168496,MATH 120A,A01,085445,Eggers; John Dietrich,20,0,35,15
1649928168496,MATH 120A,A02,085446,Eggers; John Dietrich,28,0,35,7
1649928174522,MATH 142B,A01,084149,Verstraete; Jacques Allan,0,10,30,30
1649928174522,MATH 142B,A02,084150,Verstraete; Jacques Allan,0,9,30,30
1649928180554,MATH 170A,A01,083459,Nie; Jiawang,0,2,30,30
1649928180554,MATH 170A,A02,083460,Nie; Jiawang,0,0,30,30
1649928180554,MATH 170A,A03,083461,Nie; Jiawang,7,0,30,23
1649928186579,MATH 193B,A01,083463,Staff,3,0,30,27
1649928186579,MATH 193B,A02,083464,Staff,10,0,30,20
1649928186579,MATH 193B,A03,083465,Staff,19,0,30,11
1649928192631,COGS 2,A01,083966,Boyle; Mary E. T.,18,0,30,12
1649928198669,COGS 9,A01,083968,Staff,42,0,60,18
1649928204695,COGS 14B,A01,083970,Staff,28,0,50,22
1649928210722,COGS 17,A01,092679,Staff,67,0,75,8
1649928216749,COGS 100,A01,083972,Staff,10,0,60,50
1649928228798,COGS 101C,A01,083976,Staff,19,0,30,11
1649928234826,COGS 102A,A01,083978,Johnson; Christine M.,17,0,30,13
1649928240849,COGS 107B,A01,083980,Staff,3,0,50,47
1649928246876,COGS 115,A01,083982,Staff,14,0,30,16
1649928252902,COGS 118B,A01,083367,Staff,0,11,40,40
1649928258930,COGS 172,A01,083984,Provenzano; Emily Kara,17,0,30,13
1649928264952,COGS 177,A00,083368,Staff,0,17,30,30
1649928270978,COGS 186,A01,083986,Staff,21,0,40,19
1649928277003,COGS 187A,A01,083988,Boyle; Mary E. T.,24,0,60,36
1649928283026,CSE 8A,A50,084003,Miranda; Gregory Joseph,0,0,15,15
1649928289050,CSE 11,A01,084005,Miranda; Gregory Joseph,22,0,55,33
1649928295076,CSE 20,A01,084007,Staff,9,0,20,11
1649928301100,CSE 21,A01,084009,Staff,10,0,50,40
1649928307124,CSE 30,A01,083370,Cao; Yingjun,0,20,40,40
1649928313148,CSE 100,A01,083372,Cao; Yingjun,0,23,40,40
1649928319172,CSE 101,A01,084011,Staff,0,48,40,40
1649928325196,CSE 141,A01,083374,Eldon; John,0,51,75,75
1649928331223,CSE 141L,A01,083376,Eldon; John,0,56,75,75
1649928337247,CSE 175,A01,084013,Kumar; Rakesh,22,0,25,3
1649928343276,CSE 190,A00,092508,Dubnov; Shlomo,15,0,15,0
1649928349302,ECE 5,A01,084049,Morris; Karcher William,15,0,20,5
1649928355331,ECE 100,A01,084051,Baghdadchi; Saharnaz,1,0,20,19
1649928355331,ECE 100,A02,091916,Baghdadchi; Saharnaz,16,0,20,4
1649928361370,ECE 101,A01,084053,Baghdadchi; Saharnaz,5,0,37,32
1649928361370,ECE 101,A02,084054,Baghdadchi; Saharnaz,33,0,37,4
1649928367398,ECE 107,A01,083390,Staff,28,0,40,12
1649928373424,ECE 148,A01,084056,Silberman; Jack,7,0,12,5
1649928379457,ECE 180,A00,083391,Abi Samra; Nicholas Camill,25,0,30,5
1649928379457,ECE 180,B00,083392,Abi Samra; Nicholas Camill,22,0,30,8
1649928385484,MATH 10B,A01,084110,Staff,8,0,30,22
1649928385484,MATH 10B,A02,084111,Staff,29,0,30,1
1649928385484,MATH 10B,A03,084112,Staff,28,0,30,2
1649928391507,MATH 10C,A01,083443,Staff,9,0,30,21
1649928391507,MATH 10C,A02,083444,Staff,16,0,30,14
1649928391507,MATH 10C,B01,084114,Staff,25,0,30,5
1649928391507,MATH 10C,B02,084115,Staff,29,0,30,1
1649928397533,MATH 18,A01,084117,Harel; Guershon,27,0,30,3
1649928397533,MATH 18,A02,084119,Harel; Guershon,29,0,30,1
1649928397533,MATH 18,A03,084120,Harel; Guershon,30,0,30,0
1649928397533,MATH 18,A04,084121,Harel; Guershon,29,0,30,1
1649928403558,MATH 20B,A01,084124,Um; Ko Woon,31,0,35,4
1649928403558,MATH 20B,B01,084126,Um; Ko Woon,32,0,35,3
1649928409583,MATH 20C,A01,083446,Hammock; Frances H,17,0,30,13
1649928409583,MATH 20C,A02,083447,Hammock; Frances H,28,0,30,2
1649928409583,MATH 20C,A03,083448,Hammock; Frances H,30,0,30,0
1649928409583,MATH 20C,A04,083449,Hammock; Frances H,30,0,30,0
1649928409583,MATH 20C,B01,083451,Hammock; Frances H,25,0,30,5
1649928409583,MATH 20C,B02,083452,Hammock; Frances H,27,0,30,3
1649928409583,MATH 20C,B03,083453,Hammock; Frances H,26,0,30,4
1649928409583,MATH 20C,B04,083454,Hammock; Frances H,30,0,30,0
1649928415611,MATH 20D,A01,084128,Staff,26,0,30,4
1649928415611,MATH 20D,A02,084129,Staff,30,0,30,0
1649928415611,MATH 20D,A03,084130,Staff,29,0,30,1
1649928415611,MATH 20D,B01,084133,Staff,21,0,30,9
1649928415611,MATH 20D,B02,084134,Staff,27,0,30,3
1649928415611,MATH 20D,B03,084135,Staff,30,0,30,0
1649928421634,MATH 20E,A01,084138,Staff,22,0,30,8
1649928421634,MATH 20E,A02,084139,Staff,22,0,30,8
1649928421634,MATH 20E,A03,084140,Staff,23,0,30,7
1649928421634,MATH 20E,A04,084141,Staff,25,0,30,5
1649928427659,MATH 102,A01,084143,Harel; Guershon,16,0,30,14
1649928427659,MATH 102,A02,084144,Harel; Guershon,22,0,30,8
1649928433688,MATH 103B,A01,083456,Staff,0,8,30,30
1649928433688,MATH 103B,A02,083457,Staff,0,9,30,30
1649928439714,MATH 109,A01,084146,Salehi Golsefidy; Alireza,28,0,30,2
1649928439714,MATH 109,A02,084147,Salehi Golsefidy; Alireza,22,0,30,8
1649928445742,MATH 120A,A01,085445,Eggers; John Dietrich,20,0,35,15
1649928445742,MATH 120A,A02,085446,Eggers; John Dietrich,28,0,35,7
1649928451771,MATH 142B,A01,084149,Verstraete; Jacques Allan,0,10,30,30
1649928451771,MATH 142B,A02,084150,Verstraete; Jacques Allan,0,9,30,30
1649928457799,MATH 170A,A01,083459,Nie; Jiawang,0,2,30,30
1649928457799,MATH 170A,A02,083460,Nie; Jiawang,0,0,30,30
1649928457799,MATH 170A,A03,083461,Nie; Jiawang,7,0,30,23
1649928463823,MATH 193B,A01,083463,Staff,3,0,30,27
1649928463823,MATH 193B,A02,083464,Staff,10,0,30,20
1649928463823,MATH 193B,A03,083465,Staff,19,0,30,11
1649928469876,COGS 2,A01,083966,Boyle; Mary E. T.,18,0,30,12
1649928475901,COGS 9,A01,083968,Staff,41,0,60,19
1649928481925,COGS 14B,A01,083970,Staff,28,0,50,22
1649928487951,COGS 17,A01,092679,Staff,67,0,75,8
1649928493979,COGS 100,A01,083972,Staff,10,0,60,50
1649928506028,COGS 101C,A01,083976,Staff,19,0,30,11
1649928512051,COGS 102A,A01,083978,Johnson; Christine M.,17,0,30,13
1649928518075,COGS 107B,A01,083980,Staff,3,0,50,47
1649928524099,COGS 115,A01,083982,Staff,14,0,30,16
1649928530127,COGS 118B,A01,083367,Staff,0,11,40,40
1649928536164,COGS 172,A01,083984,Provenzano; Emily Kara,17,0,30,13
1649928542188,COGS 177,A00,083368,Staff,0,17,30,30
1649928548213,COGS 186,A01,083986,Staff,21,0,40,19
1649928554235,COGS 187A,A01,083988,Boyle; Mary E. T.,24,0,60,36
1649928560264,CSE 8A,A50,084003,Miranda; Gregory Joseph,0,0,15,15
1649928566291,CSE 11,A01,084005,Miranda; Gregory Joseph,22,0,55,33
1649928572316,CSE 20,A01,084007,Staff,9,0,20,11
1649928578339,CSE 21,A01,084009,Staff,10,0,50,40
1649928584363,CSE 30,A01,083370,Cao; Yingjun,0,20,40,40
1649928590390,CSE 100,A01,083372,Cao; Yingjun,0,23,40,40
1649928596498,CSE 101,A01,084011,Staff,0,48,40,40
1649928602528,CSE 141,A01,083374,Eldon; John,0,51,75,75
1649928608552,CSE 141L,A01,083376,Eldon; John,0,56,75,75
1649928614585,CSE 175,A01,084013,Kumar; Rakesh,22,0,25,3
1649928620608,CSE 190,A00,092508,Dubnov; Shlomo,15,0,15,0
1649928626635,ECE 5,A01,084049,Morris; Karcher William,15,0,20,5
1649928632660,ECE 100,A01,084051,Baghdadchi; Saharnaz,1,0,20,19
1649928632660,ECE 100,A02,091916,Baghdadchi; Saharnaz,16,0,20,4
1649928638689,ECE 101,A01,084053,Baghdadchi; Saharnaz,5,0,37,32
1649928638689,ECE 101,A02,084054,Baghdadchi; Saharnaz,33,0,37,4
1649928644717,ECE 107,A01,083390,Staff,28,0,40,12
1649928650742,ECE 148,A01,084056,Silberman; Jack,7,0,12,5
1649928656771,ECE 180,A00,083391,Abi Samra; Nicholas Camill,25,0,30,5
1649928656771,ECE 180,B00,083392,Abi Samra; Nicholas Camill,22,0,30,8
1649928662798,MATH 10B,A01,084110,Staff,8,0,30,22
1649928662798,MATH 10B,A02,084111,Staff,29,0,30,1
1649928662798,MATH 10B,A03,084112,Staff,28,0,30,2
1649928668825,MATH 10C,A01,083443,Staff,9,0,30,21
1649928668825,MATH 10C,A02,083444,Staff,16,0,30,14
1649928668825,MATH 10C,B01,084114,Staff,25,0,30,5
1649928668825,MATH 10C,B02,084115,Staff,29,0,30,1
1649928674850,MATH 18,A01,084117,Harel; Guershon,27,0,30,3
1649928674850,MATH 18,A02,084119,Harel; Guershon,29,0,30,1
1649928674850,MATH 18,A03,084120,Harel; Guershon,30,0,30,0
1649928674850,MATH 18,A04,084121,Harel; Guershon,29,0,30,1
1649928680881,MATH 20B,A01,084124,Um; Ko Woon,31,0,35,4
1649928680881,MATH 20B,B01,084126,Um; Ko Woon,32,0,35,3
1649928686905,MATH 20C,A01,083446,Hammock; Frances H,17,0,30,13
1649928686905,MATH 20C,A02,083447,Hammock; Frances H,28,0,30,2
1649928686905,MATH 20C,A03,083448,Hammock; Frances H,30,0,30,0
1649928686905,MATH 20C,A04,083449,Hammock; Frances H,30,0,30,0
1649928686905,MATH 20C,B01,083451,Hammock; Frances H,25,0,30,5
1649928686905,MATH 20C,B02,083452,Hammock; Frances H,27,0,30,3
1649928686905,MATH 20C,B03,083453,Hammock; Frances H,26,0,30,4
1649928686905,MATH 20C,B04,083454,Hammock; Frances H,30,0,30,0
1649928692932,MATH 20D,A01,084128,Staff,26,0,30,4
1649928692932,MATH 20D,A02,084129,Staff,30,0,30,0
1649928692932,MATH 20D,A03,084130,Staff,29,0,30,1
1649928692932,MATH 20D,B01,084133,Staff,21,0,30,9
1649928692932,MATH 20D,B02,084134,Staff,27,0,30,3
1649928692932,MATH 20D,B03,084135,Staff,30,0,30,0
1649928698963,MATH 20E,A01,084138,Staff,22,0,30,8
1649928698963,MATH 20E,A02,084139,Staff,22,0,30,8
1649928698963,MATH 20E,A03,084140,Staff,23,0,30,7
1649928698963,MATH 20E,A04,084141,Staff,25,0,30,5
1649928704990,MATH 102,A01,084143,Harel; Guershon,16,0,30,14
1649928704990,MATH 102,A02,084144,Harel; Guershon,22,0,30,8
1649928711013,MATH 103B,A01,083456,Staff,0,8,30,30
1649928711013,MATH 103B,A02,083457,Staff,0,9,30,30
1649928717037,MATH 109,A01,084146,Salehi Golsefidy; Alireza,28,0,30,2
1649928717037,MATH 109,A02,084147,Salehi Golsefidy; Alireza,22,0,30,8
1649928723061,MATH 120A,A01,085445,Eggers; John Dietrich,20,0,35,15
1649928723061,MATH 120A,A02,085446,Eggers; John Dietrich,28,0,35,7
1649928729086,MATH 142B,A01,084149,Verstraete; Jacques Allan,0,10,30,30
1649928729086,MATH 142B,A02,084150,Verstraete; Jacques Allan,0,9,30,30
1649928735111,MATH 170A,A01,083459,Nie; Jiawang,0,2,30,30
1649928735111,MATH 170A,A02,083460,Nie; Jiawang,0,0,30,30
1649928735111,MATH 170A,A03,083461,Nie; Jiawang,7,0,30,23
1649928741136,MATH 193B,A01,083463,Staff,3,0,30,27
1649928741136,MATH 193B,A02,083464,Staff,10,0,30,20
1649928741136,MATH 193B,A03,083465,Staff,19,0,30,11
1649928747192,COGS 2,A01,083966,Boyle; Mary E. T.,18,0,30,12
1649928753215,COGS 9,A01,083968,Staff,41,0,60,19
1649928759240,COGS 14B,A01,083970,Staff,28,0,50,22
1649928765264,COGS 17,A01,092679,Staff,67,0,75,8
1649928771287,COGS 100,A01,083972,Staff,10,0,60,50
1649928783340,COGS 101C,A01,083976,Staff,19,0,30,11
1649928789364,COGS 102A,A01,083978,Johnson; Christine M.,17,0,30,13
1649928795397,COGS 107B,A01,083980,Staff,3,0,50,47
1649928801419,COGS 115,A01,083982,Staff,14,0,30,16
1649928807446,COGS 118B,A01,083367,Staff,0,11,40,40
1649928813470,COGS 172,A01,083984,Provenzano; Emily Kara,17,0,30,13
1649928819496,COGS 177,A00,083368,Staff,0,17,30,30
1649928825523,COGS 186,A01,083986,Staff,21,0,40,19
1649928831547,COGS 187A,A01,083988,Boyle; Mary E. T.,24,0,60,36
1649928837571,CSE 8A,A50,084003,Miranda; Gregory Joseph,0,0,15,15
1649928843595,CSE 11,A01,084005,Miranda; Gregory Joseph,22,0,55,33
1649928849626,CSE 20,A01,084007,Staff,9,0,20,11
1649928855650,CSE 21,A01,084009,Staff,10,0,50,40
1649928861680,CSE 30,A01,083370,Cao; Yingjun,0,20,40,40
1649928867707,CSE 100,A01,083372,Cao; Yingjun,0,23,40,40
1649928873734,CSE 101,A01,084011,Staff,0,48,40,40
1649928879758,CSE 141,A01,083374,Eldon; John,0,51,75,75
1649928885782,CSE 141L,A01,083376,Eldon; John,0,56,75,75
1649928891806,CSE 175,A01,084013,Kumar; Rakesh,22,0,25,3
1649928897835,CSE 190,A00,092508,Dubnov; Shlomo,15,0,15,0
1649928903858,ECE 5,A01,084049,Morris; Karcher William,15,0,20,5
1649928909883,ECE 100,A01,084051,Baghdadchi; Saharnaz,1,0,20,19
1649928909883,ECE 100,A02,091916,Baghdadchi; Saharnaz,16,0,20,4
1649928915910,ECE 101,A01,084053,Baghdadchi; Saharnaz,5,0,37,32
1649928915910,ECE 101,A02,084054,Baghdadchi; Saharnaz,33,0,37,4
1649928921934,ECE 107,A01,083390,Staff,28,0,40,12
1649928927960,ECE 148,A01,084056,Silberman; Jack,7,0,12,5
1649928933986,ECE 180,A00,083391,Abi Samra; Nicholas Camill,25,0,30,5
1649928933986,ECE 180,B00,083392,Abi Samra; Nicholas Camill,22,0,30,8
1649928940009,MATH 10B,A01,084110,Staff,8,0,30,22
1649928940009,MATH 10B,A02,084111,Staff,29,0,30,1
1649928940009,MATH 10B,A03,084112,Staff,28,0,30,2
1649928946038,MATH 10C,A01,083443,Staff,9,0,30,21
1649928946038,MATH 10C,A02,083444,Staff,16,0,30,14
1649928946038,MATH 10C,B01,084114,Staff,25,0,30,5
1649928946038,MATH 10C,B02,084115,Staff,29,0,30,1
1649928952066,MATH 18,A01,084117,Harel; Guershon,27,0,30,3
1649928952066,MATH 18,A02,084119,Harel; Guershon,29,0,30,1
1649928952066,MATH 18,A03,084120,Harel; Guershon,30,0,30,0
1649928952066,MATH 18,A04,084121,Harel; Guershon,29,0,30,1
1649928958092,MATH 20B,A01,084124,Um; Ko Woon,31,0,35,4
1649928958092,MATH 20B,B01,084126,Um; Ko Woon,32,0,35,3
1649928964115,MATH 20C,A01,083446,Hammock; Frances H,17,0,30,13
1649928964115,MATH 20C,A02,083447,Hammock; Frances H,28,0,30,2
1649928964115,MATH 20C,A03,083448,Hammock; Frances H,30,0,30,0
1649928964115,MATH 20C,A04,083449,Hammock; Frances H,30,0,30,0
1649928964115,MATH 20C,B01,083451,Hammock; Frances H,25,0,30,5
1649928964115,MATH 20C,B02,083452,Hammock; Frances H,27,0,30,3
1649928964115,MATH 20C,B03,083453,Hammock; Frances H,26,0,30,4
1649928964115,MATH 20C,B04,083454,Hammock; Frances H,30,0,30,0
1649928970143,MATH 20D,A01,084128,Staff,26,0,30,4
1649928970143,MATH 20D,A02,084129,Staff,30,0,30,0
1649928970143,MATH 20D,A03,084130,Staff,29,0,30,1
1649928970143,MATH 20D,B01,084133,Staff,21,0,30,9
1649928970143,MATH 20D,B02,084134,Staff,27,0,30,3
1649928970143,MATH 20D,B03,084135,Staff,30,0,30,0
1649928976168,MATH 20E,A01,084138,Staff,22,0,30,8
1649928976168,MATH 20E,A02,084139,Staff,22,0,30,8
1649928976168,MATH 20E,A03,084140,Staff,23,0,30,7
1649928976168,MATH 20E,A04,084141,Staff,25,0,30,5
1649928982195,MATH 102,A01,084143,Harel; Guershon,16,0,30,14
1649928982195,MATH 102,A02,084144,Harel; Guershon,22,0,30,8
1649928988220,MATH 103B,A01,083456,Staff,0,8,30,30
1649928988220,MATH 103B,A02,083457,Staff,0,9,30,30
1649928994247,MATH 109,A01,084146,Salehi Golsefidy; Alireza,28,0,30,2
1649928994247,MATH 109,A02,084147,Salehi Golsefidy; Alireza,22,0,30,8
1649929000269,MATH 120A,A01,085445,Eggers; John Dietrich,20,0,35,15
1649929000269,MATH 120A,A02,085446,Eggers; John Dietrich,28,0,35,7
1649929006293,MATH 142B,A01,084149,Verstraete; Jacques Allan,0,10,30,30
1649929006293,MATH 142B,A02,084150,Verstraete; Jacques Allan,0,9,30,30
1649929012321,MATH 170A,A01,083459,Nie; Jiawang,0,2,30,30
1649929012321,MATH 170A,A02,083460,Nie; Jiawang,0,0,30,30
1649929012321,MATH 170A,A03,083461,Nie; Jiawang,7,0,30,23
1649929018349,MATH 193B,A01,083463,Staff,3,0,30,27
1649929018349,MATH 193B,A02,083464,Staff,10,0,30,20
1649929018349,MATH 193B,A03,083465,Staff,19,0,30,11
1649929024409,COGS 2,A01,083966,Boyle; Mary E. T.,18,0,30,12
1649929030434,COGS 9,A01,083968,Staff,41,0,60,19
1649929036458,COGS 14B,A01,083970,Staff,28,0,50,22
1649929042486,COGS 17,A01,092679,Staff,67,0,75,8
1649929048508,COGS 100,A01,083972,Staff,10,0,60,50
1649929060558,COGS 101C,A01,083976,Staff,19,0,30,11
1649929066584,COGS 102A,A01,083978,Johnson; Christine M.,17,0,30,13
1649929072610,COGS 107B,A01,083980,Staff,3,0,50,47
1649929078637,COGS 115,A01,083982,Staff,14,0,30,16
1649929084667,COGS 118B,A01,083367,Staff,0,11,40,40
1649929090694,COGS 172,A01,083984,Provenzano; Emily Kara,17,0,30,13
1649929096718,COGS 177,A00,083368,Staff,0,17,30,30
1649929102744,COGS 186,A01,083986,Staff,21,0,40,19
1649929108767,COGS 187A,A01,083988,Boyle; Mary E. T.,24,0,60,36
1649929114794,CSE 8A,A50,084003,Miranda; Gregory Joseph,0,0,15,15
1649929120820,CSE 11,A01,084005,Miranda; Gregory Joseph,22,0,55,33
1649929126846,CSE 20,A01,084007,Staff,9,0,20,11
1649929132869,CSE 21,A01,084009,Staff,10,0,50,40
1649929138896,CSE 30,A01,083370,Cao; Yingjun,0,20,40,40
1649929144922,CSE 100,A01,083372,Cao; Yingjun,0,23,40,40
1649929150945,CSE 101,A01,084011,Staff,0,48,40,40
1649929156969,CSE 141,A01,083374,Eldon; John,0,51,75,75
1649929162995,CSE 141L,A01,083376,Eldon; John,0,56,75,75
1649929169022,CSE 175,A01,084013,Kumar; Rakesh,22,0,25,3
1649929175044,CSE 190,A00,092508,Dubnov; Shlomo,15,0,15,0
1649929181068,ECE 5,A01,084049,Morris; Karcher William,15,0,20,5
1649929187093,ECE 100,A01,084051,Baghdadchi; Saharnaz,1,0,20,19
1649929187093,ECE 100,A02,091916,Baghdadchi; Saharnaz,16,0,20,4
1649929193205,ECE 101,A01,084053,Baghdadchi; Saharnaz,5,0,37,32
1649929193205,ECE 101,A02,084054,Baghdadchi; Saharnaz,33,0,37,4
1649929199229,ECE 107,A01,083390,Staff,28,0,40,12
1649929205253,ECE 148,A01,084056,Silberman; Jack,7,0,12,5
1649929211281,ECE 180,A00,083391,Abi Samra; Nicholas Camill,25,0,30,5
1649929211281,ECE 180,B00,083392,Abi Samra; Nicholas Camill,22,0,30,8
1649929217306,MATH 10B,A01,084110,Staff,8,0,30,22
1649929217306,MATH 10B,A02,084111,Staff,29,0,30,1
1649929217306,MATH 10B,A03,084112,Staff,28,0,30,2
1649929223334,MATH 10C,A01,083443,Staff,9,0,30,21
1649929223334,MATH 10C,A02,083444,Staff,16,0,30,14
1649929223334,MATH 10C,B01,084114,Staff,25,0,30,5
1649929223334,MATH 10C,B02,084115,Staff,29,0,30,1
1649929229361,MATH 18,A01,084117,Harel; Guershon,27,0,30,3
1649929229361,MATH 18,A02,084119,Harel; Guershon,29,0,30,1
1649929229361,MATH 18,A03,084120,Harel; Guershon,30,0,30,0
1649929229361,MATH 18,A04,084121,Harel; Guershon,29,0,30,1
1649929235385,MATH 20B,A01,084124,Um; Ko Woon,31,0,35,4
1649929235385,MATH 20B,B01,084126,Um; Ko Woon,32,0,35,3
1649929241415,MATH 20C,A01,083446,Hammock; Frances H,17,0,30,13
1649929241415,MATH 20C,A02,083447,Hammock; Frances H,28,0,30,2
1649929241415,MATH 20C,A03,083448,Hammock; Frances H,30,0,30,0
1649929241415,MATH 20C,A04,083449,Hammock; Frances H,30,0,30,0
1649929241415,MATH 20C,B01,083451,Hammock; Frances H,25,0,30,5
1649929241415,MATH 20C,B02,083452,Hammock; Frances H,27,0,30,3
1649929241415,MATH 20C,B03,083453,Hammock; Frances H,26,0,30,4
1649929241415,MATH 20C,B04,083454,Hammock; Frances H,30,0,30,0
1649929247444,MATH 20D,A01,084128,Staff,26,0,30,4
1649929247444,MATH 20D,A02,084129,Staff,30,0,30,0
1649929247444,MATH 20D,A03,084130,Staff,29,0,30,1
1649929247444,MATH 20D,B01,084133,Staff,21,0,30,9
1649929247444,MATH 20D,B02,084134,Staff,27,0,30,3
1649929247444,MATH 20D,B03,084135,Staff,30,0,30,0
1649929253472,MATH 20E,A01,084138,Staff,22,0,30,8
1649929253472,MATH 20E,A02,084139,Staff,22,0,30,8
1649929253472,MATH 20E,A03,084140,Staff,23,0,30,7
1649929253472,MATH 20E,A04,084141,Staff,25,0,30,5
1649929259496,MATH 102,A01,084143,Harel; Guershon,16,0,30,14
1649929259496,MATH 102,A02,084144,Harel; Guershon,22,0,30,8
1649929265523,MATH 103B,A01,083456,Staff,0,8,30,30
1649929265523,MATH 103B,A02,083457,Staff,0,9,30,30
1649929271546,MATH 109,A01,084146,Salehi Golsefidy; Alireza,28,0,30,2
1649929271546,MATH 109,A02,084147,Salehi Golsefidy; Alireza,22,0,30,8
1649929277570,MATH 120A,A01,085445,Eggers; John Dietrich,20,0,35,15
1649929277570,MATH 120A,A02,085446,Eggers; John Dietrich,28,0,35,7
1649929283598,MATH 142B,A01,084149,Verstraete; Jacques Allan,0,10,30,30
1649929283598,MATH 142B,A02,084150,Verstraete; Jacques Allan,0,9,30,30
1649929289625,MATH 170A,A01,083459,Nie; Jiawang,0,2,30,30
1649929289625,MATH 170A,A02,083460,Nie; Jiawang,0,0,30,30
1649929289625,MATH 170A,A03,083461,Nie; Jiawang,7,0,30,23
1649929295651,MATH 193B,A01,083463,Staff,3,0,30,27
1649929295651,MATH 193B,A02,083464,Staff,10,0,30,20
1649929295651,MATH 193B,A03,083465,Staff,19,0,30,11
1649929301711,COGS 2,A01,083966,Boyle; Mary E. T.,18,0,30,12
1649929307736,COGS 9,A01,083968,Staff,41,0,60,19
1649929313762,COGS 14B,A01,083970,Staff,28,0,50,22
1649929319786,COGS 17,A01,092679,Staff,67,0,75,8
1649929325808,COGS 100,A01,083972,Staff,10,0,60,50
1649929337858,COGS 101C,A01,083976,Staff,19,0,30,11
1649929343881,COGS 102A,A01,083978,Johnson; Christine M.,17,0,30,13
1649929349902,COGS 107B,A01,083980,Staff,3,0,50,47
1649929355925,COGS 115,A01,083982,Staff,14,0,30,16
1649929361951,COGS 118B,A01,083367,Staff,0,11,40,40
1649929367975,COGS 172,A01,083984,Provenzano; Emily Kara,17,0,30,13
1649929374011,COGS 177,A00,083368,Staff,0,17,30,30
1649929380038,COGS 186,A01,083986,Staff,21,0,40,19
1649929386065,COGS 187A,A01,083988,Boyle; Mary E. T.,24,0,60,36
1649929392089,CSE 8A,A50,084003,Miranda; Gregory Joseph,0,0,15,15
1649929398115,CSE 11,A01,084005,Miranda; Gregory Joseph,22,0,55,33
1649929404138,CSE 20,A01,084007,Staff,9,0,20,11
1649929410162,CSE 21,A01,084009,Staff,10,0,50,40
1649929416189,CSE 30,A01,083370,Cao; Yingjun,0,20,40,40
1649929422215,CSE 100,A01,083372,Cao; Yingjun,0,23,40,40
1649929428245,CSE 101,A01,084011,Staff,0,48,40,40
1649929434280,CSE 141,A01,083374,Eldon; John,0,51,75,75
1649929440314,CSE 141L,A01,083376,Eldon; John,0,56,75,75
1649929446347,CSE 175,A01,084013,Kumar; Rakesh,22,0,25,3
1649929452368,CSE 190,A00,092508,Dubnov; Shlomo,15,0,15,0
1649929458390,ECE 5,A01,084049,Morris; Karcher William,15,0,20,5
1649929464413,ECE 100,A01,084051,Baghdadchi; Saharnaz,1,0,20,19
1649929464413,ECE 100,A02,091916,Baghdadchi; Saharnaz,16,0,20,4
1649929470437,ECE 101,A01,084053,Baghdadchi; Saharnaz,5,0,37,32
1649929470437,ECE 101,A02,084054,Baghdadchi; Saharnaz,33,0,37,4
1649929476472,ECE 107,A01,083390,Staff,28,0,40,12
1649929482499,ECE 148,A01,084056,Silberman; Jack,7,0,12,5
1649929488525,ECE 180,A00,083391,Abi Samra; Nicholas Camill,25,0,30,5
1649929488525,ECE 180,B00,083392,Abi Samra; Nicholas Camill,22,0,30,8
1649929494555,MATH 10B,A01,084110,Staff,8,0,30,22
1649929494555,MATH 10B,A02,084111,Staff,29,0,30,1
1649929494555,MATH 10B,A03,084112,Staff,28,0,30,2
1649929500580,MATH 10C,A01,083443,Staff,9,0,30,21
1649929500580,MATH 10C,A02,083444,Staff,16,0,30,14
1649929500580,MATH 10C,B01,084114,Staff,25,0,30,5
1649929500580,MATH 10C,B02,084115,Staff,29,0,30,1
1649929506610,MATH 18,A01,084117,Harel; Guershon,27,0,30,3
1649929506610,MATH 18,A02,084119,Harel; Guershon,29,0,30,1
1649929506610,MATH 18,A03,084120,Harel; Guershon,30,0,30,0
1649929506610,MATH 18,A04,084121,Harel; Guershon,29,0,30,1
1649929512637,MATH 20B,A01,084124,Um; Ko Woon,31,0,35,4
1649929512637,MATH 20B,B01,084126,Um; Ko Woon,32,0,35,3
1649929518662,MATH 20C,A01,083446,Hammock; Frances H,17,0,30,13
1649929518662,MATH 20C,A02,083447,Hammock; Frances H,28,0,30,2
1649929518662,MATH 20C,A03,083448,Hammock; Frances H,30,0,30,0
1649929518662,MATH 20C,A04,083449,Hammock; Frances H,30,0,30,0
1649929518662,MATH 20C,B01,083451,Hammock; Frances H,25,0,30,5
1649929518662,MATH 20C,B02,083452,Hammock; Frances H,27,0,30,3
1649929518662,MATH 20C,B03,083453,Hammock; Frances H,26,0,30,4
1649929518662,MATH 20C,B04,083454,Hammock; Frances H,30,0,30,0
1649929524690,MATH 20D,A01,084128,Staff,26,0,30,4
1649929524690,MATH 20D,A02,084129,Staff,30,0,30,0
1649929524690,MATH 20D,A03,084130,Staff,29,0,30,1
1649929524690,MATH 20D,B01,084133,Staff,21,0,30,9
1649929524690,MATH 20D,B02,084134,Staff,27,0,30,3
1649929524690,MATH 20D,B03,084135,Staff,30,0,30,0
1649929530714,MATH 20E,A01,084138,Staff,22,0,30,8
1649929530714,MATH 20E,A02,084139,Staff,22,0,30,8
1649929530714,MATH 20E,A03,084140,Staff,23,0,30,7
1649929530714,MATH 20E,A04,084141,Staff,25,0,30,5
1649929536741,MATH 102,A01,084143,Harel; Guershon,16,0,30,14
1649929536741,MATH 102,A02,084144,Harel; Guershon,22,0,30,8
1649929542763,MATH 103B,A01,083456,Staff,0,8,30,30
1649929542763,MATH 103B,A02,083457,Staff,0,9,30,30
1649929548791,MATH 109,A01,084146,Salehi Golsefidy; Alireza,28,0,30,2
1649929548791,MATH 109,A02,084147,Salehi Golsefidy; Alireza,22,0,30,8
1649929554816,MATH 120A,A01,085445,Eggers; John Dietrich,20,0,35,15
1649929554816,MATH 120A,A02,085446,Eggers; John Dietrich,28,0,35,7
1649929560840,MATH 142B,A01,084149,Verstraete; Jacques Allan,0,10,30,30
1649929560840,MATH 142B,A02,084150,Verstraete; Jacques Allan,0,9,30,30
1649929566863,MATH 170A,A01,083459,Nie; Jiawang,0,2,30,30
1649929566863,MATH 170A,A02,083460,Nie; Jiawang,0,0,30,30
1649929566863,MATH 170A,A03,083461,Nie; Jiawang,7,0,30,23
1649929572890,MATH 193B,A01,083463,Staff,3,0,30,27
1649929572890,MATH 193B,A02,083464,Staff,10,0,30,20
1649929572890,MATH 193B,A03,083465,Staff,19,0,30,11
1649929578942,COGS 2,A01,083966,Boyle; Mary E. T.,18,0,30,12
1649929584965,COGS 9,A01,083968,Staff,41,0,60,19
1649929590992,COGS 14B,A01,083970,Staff,28,0,50,22
1649929597018,COGS 17,A01,092679,Staff,67,0,75,8
1649929603047,COGS 100,A01,083972,Staff,10,0,60,50
1649929615093,COGS 101C,A01,083976,Staff,19,0,30,11
1649929621119,COGS 102A,A01,083978,Johnson; Christine M.,17,0,30,13
1649929627143,COGS 107B,A01,083980,Staff,3,0,50,47
1649929633166,COGS 115,A01,083982,Staff,14,0,30,16
1649929639190,COGS 118B,A01,083367,Staff,0,11,40,40
1649929645217,COGS 172,A01,083984,Provenzano; Emily Kara,17,0,30,13
1649929651241,COGS 177,A00,083368,Staff,0,17,30,30
1649929657267,COGS 186,A01,083986,Staff,21,0,40,19
1649929663294,COGS 187A,A01,083988,Boyle; Mary E. T.,24,0,60,36
1649929669319,CSE 8A,A50,084003,Miranda; Gregory Joseph,0,0,15,15
1649929675344,CSE 11,A01,084005,Miranda; Gregory Joseph,22,0,55,33
1649929681367,CSE 20,A01,084007,Staff,9,0,20,11
1649929687394,CSE 21,A01,084009,Staff,10,0,50,40
1649929693421,CSE 30,A01,083370,Cao; Yingjun,0,20,40,40
1649929699450,CSE 100,A01,083372,Cao; Yingjun,0,23,40,40
1649929705474,CSE 101,A01,084011,Staff,0,48,40,40
1649929711497,CSE 141,A01,083374,Eldon; John,0,51,75,75
1649929717520,CSE 141L,A01,083376,Eldon; John,0,56,75,75
1649929723543,CSE 175,A01,084013,Kumar; Rakesh,22,0,25,3
1649929736782,CSE 190,A00,092508,Dubnov; Shlomo,15,0,15,0
1649929742809,ECE 5,A01,084049,Morris; Karcher William,15,0,20,5
1649929748840,ECE 100,A01,084051,Baghdadchi; Saharnaz,1,0,20,19
1649929748840,ECE 100,A02,091916,Baghdadchi; Saharnaz,16,0,20,4
1649929754867,ECE 101,A01,084053,Baghdadchi; Saharnaz,5,0,37,32
1649929754867,ECE 101,A02,084054,Baghdadchi; Saharnaz,33,0,37,4
1649929760896,ECE 107,A01,083390,Staff,28,0,40,12
1649929766919,ECE 148,A01,084056,Silberman; Jack,7,0,12,5
1649929772944,ECE 180,A00,083391,Abi Samra; Nicholas Camill,25,0,30,5
1649929772944,ECE 180,B00,083392,Abi Samra; Nicholas Camill,22,0,30,8
1649929778975,MATH 10B,A01,084110,Staff,8,0,30,22
1649929778975,MATH 10B,A02,084111,Staff,29,0,30,1
1649929778975,MATH 10B,A03,084112,Staff,28,0,30,2
1649929785000,MATH 10C,A01,083443,Staff,9,0,30,21
1649929785000,MATH 10C,A02,083444,Staff,16,0,30,14
1649929785000,MATH 10C,B01,084114,Staff,25,0,30,5
1649929785000,MATH 10C,B02,084115,Staff,29,0,30,1
1649929791024,MATH 18,A01,084117,Harel; Guershon,27,0,30,3
1649929791024,MATH 18,A02,084119,Harel; Guershon,29,0,30,1
1649929791024,MATH 18,A03,084120,Harel; Guershon,30,0,30,0
1649929791024,MATH 18,A04,084121,Harel; Guershon,29,0,30,1
1649929797137,MATH 20B,A01,084124,Um; Ko Woon,31,0,35,4
1649929797137,MATH 20B,B01,084126,Um; Ko Woon,32,0,35,3
1649929803168,MATH 20C,A01,083446,Hammock; Frances H,17,0,30,13
1649929803168,MATH 20C,A02,083447,Hammock; Frances H,28,0,30,2
1649929803168,MATH 20C,A03,083448,Hammock; Frances H,30,0,30,0
1649929803168,MATH 20C,A04,083449,Hammock; Frances H,30,0,30,0
1649929803168,MATH 20C,B01,083451,Hammock; Frances H,25,0,30,5
1649929803168,MATH 20C,B02,083452,Hammock; Frances H,27,0,30,3
1649929803168,MATH 20C,B03,083453,Hammock; Frances H,26,0,30,4
1649929803168,MATH 20C,B04,083454,Hammock; Frances H,30,0,30,0
1649929809200,MATH 20D,A01,084128,Staff,26,0,30,4
1649929809200,MATH 20D,A02,084129,Staff,30,0,30,0
1649929809200,MATH 20D,A03,084130,Staff,29,0,30,1
1649929809200,MATH 20D,B01,084133,Staff,21,0,30,9
1649929809200,MATH 20D,B02,084134,Staff,27,0,30,3
1649929809200,MATH 20D,B03,084135,Staff,30,0,30,0
1649929815226,MATH 20E,A01,084138,Staff,22,0,30,8
1649929815226,MATH 20E,A02,084139,Staff,22,0,30,8
1649929815226,MATH 20E,A03,084140,Staff,23,0,30,7
1649929815226,MATH 20E,A04,084141,Staff,25,0,30,5
1649929821249,MATH 102,A01,084143,Harel; Guershon,16,0,30,14
1649929821249,MATH 102,A02,084144,Harel; Guershon,22,0,30,8
1649929827272,MATH 103B,A01,083456,Staff,0,8,30,30
1649929827272,MATH 103B,A02,083457,Staff,0,9,30,30
1649929833296,MATH 109,A01,084146,Salehi Golsefidy; Alireza,28,0,30,2
1649929833296,MATH 109,A02,084147,Salehi Golsefidy; Alireza,22,0,30,8
1649929839318,MATH 120A,A01,085445,Eggers; John Dietrich,20,0,35,15
1649929839318,MATH 120A,A02,085446,Eggers; John Dietrich,28,0,35,7
1649929845341,MATH 142B,A01,084149,Verstraete; Jacques Allan,0,10,30,30
1649929845341,MATH 142B,A02,084150,Verstraete; Jacques Allan,0,9,30,30
1649929851367,MATH 170A,A01,083459,Nie; Jiawang,0,2,30,30
1649929851367,MATH 170A,A02,083460,Nie; Jiawang,0,0,30,30
1649929851367,MATH 170A,A03,083461,Nie; Jiawang,7,0,30,23
1649929857391,MATH 193B,A01,083463,Staff,3,0,30,27
1649929857391,MATH 193B,A02,083464,Staff,10,0,30,20
1649929857391,MATH 193B,A03,083465,Staff,19,0,30,11
1649929863452,COGS 2,A01,083966,Boyle; Mary E. T.,18,0,30,12
1649929869483,COGS 9,A01,083968,Staff,41,0,60,19
1649929875506,COGS 14B,A01,083970,Staff,28,0,50,22
1649929881528,COGS 17,A01,092679,Staff,67,0,75,8
1649929887554,COGS 100,A01,083972,Staff,10,0,60,50
1649929899602,COGS 101C,A01,083976,Staff,19,0,30,11
1649929905626,COGS 102A,A01,083978,Johnson; Christine M.,17,0,30,13
1649929911649,COGS 107B,A01,083980,Staff,3,0,50,47
1649929917677,COGS 115,A01,083982,Staff,14,0,30,16
1649929923699,COGS 118B,A01,083367,Staff,0,11,40,40
1649929929723,COGS 172,A01,083984,Provenzano; Emily Kara,17,0,30,13
1649929935748,COGS 177,A00,083368,Staff,0,17,30,30
1649929941775,COGS 186,A01,083986,Staff,21,0,40,19
1649929947798,COGS 187A,A01,083988,Boyle; Mary E. T.,24,0,60,36
1649929953821,CSE 8A,A50,084003,Miranda; Gregory Joseph,0,0,15,15
1649929959847,CSE 11,A01,084005,Miranda; Gregory Joseph,22,0,55,33
1649929965923,CSE 20,A01,084007,Staff,9,0,20,11
1649929971951,CSE 21,A01,084009,Staff,10,0,50,40
1649929977975,CSE 30,A01,083370,Cao; Yingjun,0,20,40,40
1649929984002,CSE 100,A01,083372,Cao; Yingjun,0,23,40,40
1649929990024,CSE 101,A01,084011,Staff,0,48,40,40
1649929996048,CSE 141,A01,083374,Eldon; John,0,51,75,75
1649930002072,CSE 141L,A01,083376,Eldon; John,0,56,75,75
1649930008096,CSE 175,A01,084013,Kumar; Rakesh,22,0,25,3
1649930014123,CSE 190,A00,092508,Dubnov; Shlomo,15,0,15,0
1649930020146,ECE 5,A01,084049,Morris; Karcher William,15,0,20,5
1649930026173,ECE 100,A01,084051,Baghdadchi; Saharnaz,1,0,20,19
1649930026173,ECE 100,A02,091916,Baghdadchi; Saharnaz,16,0,20,4
1649930032195,ECE 101,A01,084053,Baghdadchi; Saharnaz,5,0,37,32
1649930032195,ECE 101,A02,084054,Baghdadchi; Saharnaz,33,0,37,4
1649930038220,ECE 107,A01,083390,Staff,28,0,40,12
1649930044242,ECE 148,A01,084056,Silberman; Jack,7,0,12,5
1649930050266,ECE 180,A00,083391,Abi Samra; Nicholas Camill,25,0,30,5
1649930050266,ECE 180,B00,083392,Abi Samra; Nicholas Camill,22,0,30,8
1649930056293,MATH 10B,A01,084110,Staff,8,0,30,22
1649930056293,MATH 10B,A02,084111,Staff,29,0,30,1
1649930056293,MATH 10B,A03,084112,Staff,28,0,30,2
1649930062320,MATH 10C,A01,083443,Staff,9,0,30,21
1649930062320,MATH 10C,A02,083444,Staff,16,0,30,14
1649930062320,MATH 10C,B01,084114,Staff,25,0,30,5
1649930062320,MATH 10C,B02,084115,Staff,29,0,30,1
1649930068349,MATH 18,A01,084117,Harel; Guershon,27,0,30,3
1649930068349,MATH 18,A02,084119,Harel; Guershon,29,0,30,1
1649930068349,MATH 18,A03,084120,Harel; Guershon,30,0,30,0
1649930068349,MATH 18,A04,084121,Harel; Guershon,29,0,30,1
1649930074375,MATH 20B,A01,084124,Um; Ko Woon,31,0,35,4
1649930074375,MATH 20B,B01,084126,Um; Ko Woon,32,0,35,3
1649930080398,MATH 20C,A01,083446,Hammock; Frances H,17,0,30,13
1649930080398,MATH 20C,A02,083447,Hammock; Frances H,28,0,30,2
1649930080398,MATH 20C,A03,083448,Hammock; Frances H,30,0,30,0
1649930080398,MATH 20C,A04,083449,Hammock; Frances H,30,0,30,0
1649930080398,MATH 20C,B01,083451,Hammock; Frances H,25,0,30,5
1649930080398,MATH 20C,B02,083452,Hammock; Frances H,27,0,30,3
1649930080398,MATH 20C,B03,083453,Hammock; Frances H,26,0,30,4
1649930080398,MATH 20C,B04,083454,Hammock; Frances H,30,0,30,0
1649930086426,MATH 20D,A01,084128,Staff,26,0,30,4
1649930086426,MATH 20D,A02,084129,Staff,30,0,30,0
1649930086426,MATH 20D,A03,084130,Staff,29,0,30,1
1649930086426,MATH 20D,B01,084133,Staff,21,0,30,9
1649930086426,MATH 20D,B02,084134,Staff,27,0,30,3
1649930086426,MATH 20D,B03,084135,Staff,30,0,30,0
1649930092449,MATH 20E,A01,084138,Staff,22,0,30,8
1649930092449,MATH 20E,A02,084139,Staff,22,0,30,8
1649930092449,MATH 20E,A03,084140,Staff,23,0,30,7
1649930092449,MATH 20E,A04,084141,Staff,25,0,30,5
1649930098471,MATH 102,A01,084143,Harel; Guershon,16,0,30,14
1649930098471,MATH 102,A02,084144,Harel; Guershon,22,0,30,8
1649930104498,MATH 103B,A01,083456,Staff,0,8,30,30
1649930104498,MATH 103B,A02,083457,Staff,0,9,30,30
1649930110526,MATH 109,A01,084146,Salehi Golsefidy; Alireza,28,0,30,2
1649930110526,MATH 109,A02,084147,Salehi Golsefidy; Alireza,22,0,30,8
1649930116550,MATH 120A,A01,085445,Eggers; John Dietrich,20,0,35,15
1649930116550,MATH 120A,A02,085446,Eggers; John Dietrich,28,0,35,7
1649930122573,MATH 142B,A01,084149,Verstraete; Jacques Allan,0,10,30,30
1649930122573,MATH 142B,A02,084150,Verstraete; Jacques Allan,0,9,30,30
1649930128601,MATH 170A,A01,083459,Nie; Jiawang,0,2,30,30
1649930128601,MATH 170A,A02,083460,Nie; Jiawang,0,0,30,30
1649930128601,MATH 170A,A03,083461,Nie; Jiawang,7,0,30,23
1649930134624,MATH 193B,A01,083463,Staff,3,0,30,27
1649930134624,MATH 193B,A02,083464,Staff,10,0,30,20
1649930134624,MATH 193B,A03,083465,Staff,19,0,30,11
1649930140678,COGS 2,A01,083966,Boyle; Mary E. T.,18,0,30,12
1649930146701,COGS 9,A01,083968,Staff,41,0,60,19
1649930152724,COGS 14B,A01,083970,Staff,28,0,50,22
1649930158749,COGS 17,A01,092679,Staff,67,0,75,8
1649930164774,COGS 100,A01,083972,Staff,10,0,60,50
1649930176827,COGS 101C,A01,083976,Staff,19,0,30,11
1649930182851,COGS 102A,A01,083978,Johnson; Christine M.,17,0,30,13
1649930188876,COGS 107B,A01,083980,Staff,3,0,50,47
1649930194902,COGS 115,A01,083982,Staff,14,0,30,16
1649930200936,COGS 118B,A01,083367,Staff,0,11,40,40
1649930206960,COGS 172,A01,083984,Provenzano; Emily Kara,17,0,30,13
1649930212987,COGS 177,A00,083368,Staff,0,17,30,30
1649930219010,COGS 186,A01,083986,Staff,21,0,40,19
1649930225037,COGS 187A,A01,083988,Boyle; Mary E. T.,24,0,60,36
1649930231061,CSE 8A,A50,084003,Miranda; Gregory Joseph,0,0,15,15
1649930237094,CSE 11,A01,084005,Miranda; Gregory Joseph,22,0,55,33
1649930243118,CSE 20,A01,084007,Staff,9,0,20,11
1649930249143,CSE 21,A01,084009,Staff,10,0,50,40
1649930255167,CSE 30,A01,083370,Cao; Yingjun,0,20,40,40
1649930261205,CSE 100,A01,083372,Cao; Yingjun,0,23,40,40
1649930267242,CSE 101,A01,084011,Staff,0,48,40,40
1649930273266,CSE 141,A01,083374,Eldon; John,0,51,75,75
1649930279294,CSE 141L,A01,083376,Eldon; John,0,56,75,75
1649930285318,CSE 175,A01,084013,Kumar; Rakesh,22,0,25,3
1649930291340,CSE 190,A00,092508,Dubnov; Shlomo,15,0,15,0
1649930297364,ECE 5,A01,084049,Morris; Karcher William,15,0,20,5
1649930303397,ECE 100,A01,084051,Baghdadchi; Saharnaz,1,0,20,19
1649930303397,ECE 100,A02,091916,Baghdadchi; Saharnaz,16,0,20,4
1649930309425,ECE 101,A01,084053,Baghdadchi; Saharnaz,5,0,37,32
1649930309425,ECE 101,A02,084054,Baghdadchi; Saharnaz,33,0,37,4
1649930315446,ECE 107,A01,083390,Staff,28,0,40,12
1649930321469,ECE 148,A01,084056,Silberman; Jack,7,0,12,5
1649930327495,ECE 180,A00,083391,Abi Samra; Nicholas Camill,25,0,30,5
1649930327495,ECE 180,B00,083392,Abi Samra; Nicholas Camill,22,0,30,8
1649930333521,MATH 10B,A01,084110,Staff,8,0,30,22
1649930333521,MATH 10B,A02,084111,Staff,29,0,30,1
1649930333521,MATH 10B,A03,084112,Staff,28,0,30,2
1649930339544,MATH 10C,A01,083443,Staff,9,0,30,21
1649930339544,MATH 10C,A02,083444,Staff,16,0,30,14
1649930339544,MATH 10C,B01,084114,Staff,25,0,30,5
1649930339544,MATH 10C,B02,084115,Staff,29,0,30,1
1649930345572,MATH 18,A01,084117,Harel; Guershon,27,0,30,3
1649930345572,MATH 18,A02,084119,Harel; Guershon,29,0,30,1
1649930345572,MATH 18,A03,084120,Harel; Guershon,30,0,30,0
1649930345572,MATH 18,A04,084121,Harel; Guershon,29,0,30,1
1649930351600,MATH 20B,A01,084124,Um; Ko Woon,31,0,35,4
1649930351600,MATH 20B,B01,084126,Um; Ko Woon,32,0,35,3
1649930357628,MATH 20C,A01,083446,Hammock; Frances H,17,0,30,13
1649930357628,MATH 20C,A02,083447,Hammock; Frances H,28,0,30,2
1649930357628,MATH 20C,A03,083448,Hammock; Frances H,30,0,30,0
1649930357628,MATH 20C,A04,083449,Hammock; Frances H,30,0,30,0
1649930357628,MATH 20C,B01,083451,Hammock; Frances H,25,0,30,5
1649930357628,MATH 20C,B02,083452,Hammock; Frances H,27,0,30,3
1649930357628,MATH 20C,B03,083453,Hammock; Frances H,26,0,30,4
1649930357628,MATH 20C,B04,083454,Hammock; Frances H,30,0,30,0
1649930363655,MATH 20D,A01,084128,Staff,26,0,30,4
1649930363655,MATH 20D,A02,084129,Staff,30,0,30,0
1649930363655,MATH 20D,A03,084130,Staff,29,0,30,1
1649930363655,MATH 20D,B01,084133,Staff,21,0,30,9
1649930363655,MATH 20D,B02,084134,Staff,27,0,30,3
1649930363655,MATH 20D,B03,084135,Staff,30,0,30,0
1649930369691,MATH 20E,A01,084138,Staff,22,0,30,8
1649930369691,MATH 20E,A02,084139,Staff,22,0,30,8
1649930369691,MATH 20E,A03,084140,Staff,23,0,30,7
1649930369691,MATH 20E,A04,084141,Staff,25,0,30,5
1649930375722,MATH 102,A01,084143,Harel; Guershon,16,0,30,14
1649930375722,MATH 102,A02,084144,Harel; Guershon,22,0,30,8
1649930381748,MATH 103B,A01,083456,Staff,0,8,30,30
1649930381748,MATH 103B,A02,083457,Staff,0,9,30,30
1649930387777,MATH 109,A01,084146,Salehi Golsefidy; Alireza,28,0,30,2
1649930387777,MATH 109,A02,084147,Salehi Golsefidy; Alireza,22,0,30,8
1649930393887,MATH 120A,A01,085445,Eggers; John Dietrich,20,0,35,15
1649930393887,MATH 120A,A02,085446,Eggers; John Dietrich,28,0,35,7
1649930399909,MATH 142B,A01,084149,Verstraete; Jacques Allan,0,10,30,30
1649930399909,MATH 142B,A02,084150,Verstraete; Jacques Allan,0,9,30,30
1649930405933,MATH 170A,A01,083459,Nie; Jiawang,0,2,30,30
1649930405933,MATH 170A,A02,083460,Nie; Jiawang,0,0,30,30
1649930405933,MATH 170A,A03,083461,Nie; Jiawang,7,0,30,23
1649930411961,MATH 193B,A01,083463,Staff,3,0,30,27
1649930411961,MATH 193B,A02,083464,Staff,10,0,30,20
1649930411961,MATH 193B,A03,083465,Staff,19,0,30,11
1649930418010,COGS 2,A01,083966,Boyle; Mary E. T.,18,0,30,12
1649930424049,COGS 9,A01,083968,Staff,41,0,60,19
1649930430074,COGS 14B,A01,083970,Staff,28,0,50,22
1649930436099,COGS 17,A01,092679,Staff,67,0,75,8
1649930442125,COGS 100,A01,083972,Staff,10,0,60,50
1649930454176,COGS 101C,A01,083976,Staff,19,0,30,11
1649930460198,COGS 102A,A01,083978,Johnson; Christine M.,17,0,30,13
1649930466221,COGS 107B,A01,083980,Staff,3,0,50,47
1649930472244,COGS 115,A01,083982,Staff,14,0,30,16
1649930478268,COGS 118B,A01,083367,Staff,0,11,40,40
1649930484291,COGS 172,A01,083984,Provenzano; Emily Kara,17,0,30,13
1649930490318,COGS 177,A00,083368,Staff,0,17,30,30
1649930496341,COGS 186,A01,083986,Staff,21,0,40,19
1649930502364,COGS 187A,A01,083988,Boyle; Mary E. T.,24,0,60,36
1649930508390,CSE 8A,A50,084003,Miranda; Gregory Joseph,0,0,15,15
1649930514414,CSE 11,A01,084005,Miranda; Gregory Joseph,22,0,55,33
1649930520441,CSE 20,A01,084007,Staff,9,0,20,11
1649930526467,CSE 21,A01,084009,Staff,10,0,50,40
1649930532492,CSE 30,A01,083370,Cao; Yingjun,0,20,40,40
1649930538515,CSE 100,A01,083372,Cao; Yingjun,0,23,40,40
1649930544549,CSE 101,A01,084011,Staff,0,48,40,40
1649930550572,CSE 141,A01,083374,Eldon; John,0,51,75,75
1649930556595,CSE 141L,A01,083376,Eldon; John,0,56,75,75
1649930562622,CSE 175,A01,084013,Kumar; Rakesh,22,0,25,3
1649930568644,CSE 190,A00,092508,Dubnov; Shlomo,15,0,15,0
1649930574668,ECE 5,A01,084049,Morris; Karcher William,15,0,20,5
1649930580696,ECE 100,A01,084051,Baghdadchi; Saharnaz,1,0,20,19
1649930580696,ECE 100,A02,091916,Baghdadchi; Saharnaz,16,0,20,4
1649930586720,ECE 101,A01,084053,Baghdadchi; Saharnaz,5,0,37,32
1649930586720,ECE 101,A02,084054,Baghdadchi; Saharnaz,33,0,37,4
1649930592745,ECE 107,A01,083390,Staff,28,0,40,12
1649930598767,ECE 148,A01,084056,Silberman; Jack,7,0,12,5
1649930604803,ECE 180,A00,083391,Abi Samra; Nicholas Camill,25,0,30,5
1649930604803,ECE 180,B00,083392,Abi Samra; Nicholas Camill,22,0,30,8
1649930610826,MATH 10B,A01,084110,Staff,8,0,30,22
1649930610826,MATH 10B,A02,084111,Staff,29,0,30,1
1649930610826,MATH 10B,A03,084112,Staff,28,0,30,2
1649930616854,MATH 10C,A01,083443,Staff,9,0,30,21
1649930616854,MATH 10C,A02,083444,Staff,16,0,30,14
1649930616854,MATH 10C,B01,084114,Staff,25,0,30,5
1649930616854,MATH 10C,B02,084115,Staff,29,0,30,1
1649930622889,MATH 18,A01,084117,Harel; Guershon,27,0,30,3
1649930622889,MATH 18,A02,084119,Harel; Guershon,29,0,30,1
1649930622889,MATH 18,A03,084120,Harel; Guershon,30,0,30,0
1649930622889,MATH 18,A04,084121,Harel; Guershon,29,0,30,1
1649930628914,MATH 20B,A01,084124,Um; Ko Woon,31,0,35,4
1649930628914,MATH 20B,B01,084126,Um; Ko Woon,32,0,35,3
1649930634938,MATH 20C,A01,083446,Hammock; Frances H,17,0,30,13
1649930634938,MATH 20C,A02,083447,Hammock; Frances H,28,0,30,2
1649930634938,MATH 20C,A03,083448,Hammock; Frances H,30,0,30,0
1649930634938,MATH 20C,A04,083449,Hammock; Frances H,30,0,30,0
1649930634938,MATH 20C,B01,083451,Hammock; Frances H,25,0,30,5
1649930634938,MATH 20C,B02,083452,Hammock; Frances H,27,0,30,3
1649930634938,MATH 20C,B03,083453,Hammock; Frances H,26,0,30,4
1649930634938,MATH 20C,B04,083454,Hammock; Frances H,30,0,30,0
1649930640962,MATH 20D,A01,084128,Staff,26,0,30,4
1649930640962,MATH 20D,A02,084129,Staff,30,0,30,0
1649930640962,MATH 20D,A03,084130,Staff,29,0,30,1
1649930640962,MATH 20D,B01,084133,Staff,21,0,30,9
1649930640962,MATH 20D,B02,084134,Staff,27,0,30,3
1649930640962,MATH 20D,B03,084135,Staff,30,0,30,0
1649930646986,MATH 20E,A01,084138,Staff,22,0,30,8
1649930646986,MATH 20E,A02,084139,Staff,22,0,30,8
1649930646986,MATH 20E,A03,084140,Staff,23,0,30,7
1649930646986,MATH 20E,A04,084141,Staff,25,0,30,5
1649930653014,MATH 102,A01,084143,Harel; Guershon,16,0,30,14
1649930653014,MATH 102,A02,084144,Harel; Guershon,22,0,30,8
1649930659037,MATH 103B,A01,083456,Staff,0,8,30,30
1649930659037,MATH 103B,A02,083457,Staff,0,9,30,30
1649930665061,MATH 109,A01,084146,Salehi Golsefidy; Alireza,28,0,30,2
1649930665061,MATH 109,A02,084147,Salehi Golsefidy; Alireza,22,0,30,8
1649930671085,MATH 120A,A01,085445,Eggers; John Dietrich,20,0,35,15
1649930671085,MATH 120A,A02,085446,Eggers; John Dietrich,28,0,35,7
1649930677112,MATH 142B,A01,084149,Verstraete; Jacques Allan,0,10,30,30
1649930677112,MATH 142B,A02,084150,Verstraete; Jacques Allan,0,9,30,30
1649930683136,MATH 170A,A01,083459,Nie; Jiawang,0,2,30,30
1649930683136,MATH 170A,A02,083460,Nie; Jiawang,0,0,30,30
1649930683136,MATH 170A,A03,083461,Nie; Jiawang,7,0,30,23
1649930689157,MATH 193B,A01,083463,Staff,3,0,30,27
1649930689157,MATH 193B,A02,083464,Staff,10,0,30,20
1649930689157,MATH 193B,A03,083465,Staff,19,0,30,11
1649930695208,COGS 2,A01,083966,Boyle; Mary E. T.,18,0,30,12
1649930701231,COGS 9,A01,083968,Staff,41,0,60,19
1649930707262,COGS 14B,A01,083970,Staff,28,0,50,22
1649930713286,COGS 17,A01,092679,Staff,67,0,75,8
1649930719320,COGS 100,A01,083972,Staff,10,0,60,50
1649930731368,COGS 101C,A01,083976,Staff,19,0,30,11
1649930737391,COGS 102A,A01,083978,Johnson; Christine M.,17,0,30,13
1649930743418,COGS 107B,A01,083980,Staff,3,0,50,47
1649930749441,COGS 115,A01,083982,Staff,14,0,30,16
1649930755465,COGS 118B,A01,083367,Staff,0,11,40,40
1649930761492,COGS 172,A01,083984,Provenzano; Emily Kara,17,0,30,13
1649930767514,COGS 177,A00,083368,Staff,0,17,30,30
1649930773542,COGS 186,A01,083986,Staff,21,0,40,19
1649930779567,COGS 187A,A01,083988,Boyle; Mary E. T.,24,0,60,36
1649930785591,CSE 8A,A50,084003,Miranda; Gregory Joseph,0,0,15,15
1649930791614,CSE 11,A01,084005,Miranda; Gregory Joseph,22,0,55,33
1649930797638,CSE 20,A01,084007,Staff,9,0,20,11
1649930803665,CSE 21,A01,084009,Staff,10,0,50,40
1649930809696,CSE 30,A01,083370,Cao; Yingjun,0,20,40,40
1649930815722,CSE 100,A01,083372,Cao; Yingjun,0,23,40,40
1649930821747,CSE 101,A01,084011,Staff,0,49,40,40
1649930827773,CSE 141,A01,083374,Eldon; John,0,51,75,75
1649930833797,CSE 141L,A01,083376,Eldon; John,0,56,75,75
1649930839819,CSE 175,A01,084013,Kumar; Rakesh,22,0,25,3
1649930845846,CSE 190,A00,092508,Dubnov; Shlomo,15,0,15,0
1649930851870,ECE 5,A01,084049,Morris; Karcher William,15,0,20,5
1649930857894,ECE 100,A01,084051,Baghdadchi; Saharnaz,1,0,20,19
1649930857894,ECE 100,A02,091916,Baghdadchi; Saharnaz,16,0,20,4
1649930863918,ECE 101,A01,084053,Baghdadchi; Saharnaz,5,0,37,32
1649930863918,ECE 101,A02,084054,Baghdadchi; Saharnaz,33,0,37,4
1649930869945,ECE 107,A01,083390,Staff,28,0,40,12
1649930875972,ECE 148,A01,084056,Silberman; Jack,7,0,12,5
1649930881996,ECE 180,A00,083391,Abi Samra; Nicholas Camill,25,0,30,5
1649930881996,ECE 180,B00,083392,Abi Samra; Nicholas Camill,22,0,30,8
1649930888024,MATH 10B,A01,084110,Staff,8,0,30,22
1649930888024,MATH 10B,A02,084111,Staff,29,0,30,1
1649930888024,MATH 10B,A03,084112,Staff,28,0,30,2
1649930894048,MATH 10C,A01,083443,Staff,9,0,30,21
1649930894048,MATH 10C,A02,083444,Staff,16,0,30,14
1649930894048,MATH 10C,B01,084114,Staff,25,0,30,5
1649930894048,MATH 10C,B02,084115,Staff,29,0,30,1
1649930900072,MATH 18,A01,084117,Harel; Guershon,27,0,30,3
1649930900072,MATH 18,A02,084119,Harel; Guershon,29,0,30,1
1649930900072,MATH 18,A03,084120,Harel; Guershon,30,0,30,0
1649930900072,MATH 18,A04,084121,Harel; Guershon,29,0,30,1
1649930906096,MATH 20B,A01,084124,Um; Ko Woon,31,0,35,4
1649930906096,MATH 20B,B01,084126,Um; Ko Woon,32,0,35,3
1649930912122,MATH 20C,A01,083446,Hammock; Frances H,17,0,30,13
1649930912122,MATH 20C,A02,083447,Hammock; Frances H,28,0,30,2
1649930912122,MATH 20C,A03,083448,Hammock; Frances H,30,0,30,0
1649930912122,MATH 20C,A04,083449,Hammock; Frances H,30,0,30,0
1649930912122,MATH 20C,B01,083451,Hammock; Frances H,25,0,30,5
1649930912122,MATH 20C,B02,083452,Hammock; Frances H,27,0,30,3
1649930912122,MATH 20C,B03,083453,Hammock; Frances H,26,0,30,4
1649930912122,MATH 20C,B04,083454,Hammock; Frances H,30,0,30,0
1649930918149,MATH 20D,A01,084128,Staff,26,0,30,4
1649930918149,MATH 20D,A02,084129,Staff,30,0,30,0
1649930918149,MATH 20D,A03,084130,Staff,29,0,30,1
1649930918149,MATH 20D,B01,084133,Staff,21,0,30,9
1649930918149,MATH 20D,B02,084134,Staff,27,0,30,3
1649930918149,MATH 20D,B03,084135,Staff,30,0,30,0
1649930924175,MATH 20E,A01,084138,Staff,22,0,30,8
1649930924175,MATH 20E,A02,084139,Staff,22,0,30,8
1649930924175,MATH 20E,A03,084140,Staff,23,0,30,7
1649930924175,MATH 20E,A04,084141,Staff,25,0,30,5
1649930930198,MATH 102,A01,084143,Harel; Guershon,16,0,30,14
1649930930198,MATH 102,A02,084144,Harel; Guershon,22,0,30,8
1649930936222,MATH 103B,A01,083456,Staff,0,8,30,30
1649930936222,MATH 103B,A02,083457,Staff,0,9,30,30
1649930942246,MATH 109,A01,084146,Salehi Golsefidy; Alireza,28,0,30,2
1649930942246,MATH 109,A02,084147,Salehi Golsefidy; Alireza,22,0,30,8
1649930948277,MATH 120A,A01,085445,Eggers; John Dietrich,20,0,35,15
1649930948277,MATH 120A,A02,085446,Eggers; John Dietrich,28,0,35,7
1649930954300,MATH 142B,A01,084149,Verstraete; Jacques Allan,0,10,30,30
1649930954300,MATH 142B,A02,084150,Verstraete; Jacques Allan,0,9,30,30
1649930960323,MATH 170A,A01,083459,Nie; Jiawang,0,2,30,30
1649930960323,MATH 170A,A02,083460,Nie; Jiawang,0,0,30,30
1649930960323,MATH 170A,A03,083461,Nie; Jiawang,7,0,30,23
1649930966349,MATH 193B,A01,083463,Staff,3,0,30,27
1649930966349,MATH 193B,A02,083464,Staff,10,0,30,20
1649930966349,MATH 193B,A03,083465,Staff,19,0,30,11
1649930972412,COGS 2,A01,083966,Boyle; Mary E. T.,18,0,30,12
1649930978444,COGS 9,A01,083968,Staff,41,0,60,19
1649930984538,COGS 14B,A01,083970,Staff,28,0,50,22
1649930990562,COGS 17,A01,092679,Staff,67,0,75,8
1649930996589,COGS 100,A01,083972,Staff,10,0,60,50
1649931008641,COGS 101C,A01,083976,Staff,19,0,30,11
1649931014665,COGS 102A,A01,083978,Johnson; Christine M.,17,0,30,13
1649931020690,COGS 107B,A01,083980,Staff,3,0,50,47
1649931026712,COGS 115,A01,083982,Staff,14,0,30,16
1649931032734,COGS 118B,A01,083367,Staff,0,11,40,40
1649931038756,COGS 172,A01,083984,Provenzano; Emily Kara,17,0,30,13
1649931044779,COGS 177,A00,083368,Staff,0,17,30,30
1649931050805,COGS 186,A01,083986,Staff,21,0,40,19
1649931056832,COGS 187A,A01,083988,Boyle; Mary E. T.,24,0,60,36
1649931062856,CSE 8A,A50,084003,Miranda; Gregory Joseph,0,0,15,15
1649931068882,CSE 11,A01,084005,Miranda; Gregory Joseph,22,0,55,33
1649931074905,CSE 20,A01,084007,Staff,9,0,20,11
1649931080931,CSE 21,A01,084009,Staff,10,0,50,40
1649931086955,CSE 30,A01,083370,Cao; Yingjun,0,20,40,40
1649931092978,CSE 100,A01,083372,Cao; Yingjun,0,23,40,40
1649931099002,CSE 101,A01,084011,Staff,0,49,40,40
1649931105028,CSE 141,A01,083374,Eldon; John,0,51,75,75
1649931111055,CSE 141L,A01,083376,Eldon; John,0,56,75,75
1649931117079,CSE 175,A01,084013,Kumar; Rakesh,22,0,25,3
1649931123101,CSE 190,A00,092508,Dubnov; Shlomo,15,0,15,0
1649931129125,ECE 5,A01,084049,Morris; Karcher William,15,0,20,5
1649931135152,ECE 100,A01,084051,Baghdadchi; Saharnaz,1,0,20,19
1649931135152,ECE 100,A02,091916,Baghdadchi; Saharnaz,16,0,20,4
1649931141175,ECE 101,A01,084053,Baghdadchi; Saharnaz,5,0,37,32
1649931141175,ECE 101,A02,084054,Baghdadchi; Saharnaz,33,0,37,4
1649931147202,ECE 107,A01,083390,Staff,28,0,40,12
1649931153224,ECE 148,A01,084056,Silberman; Jack,7,0,12,5
1649931159247,ECE 180,A00,083391,Abi Samra; Nicholas Camill,25,0,30,5
1649931159247,ECE 180,B00,083392,Abi Samra; Nicholas Camill,22,0,30,8
1649931165271,MATH 10B,A01,084110,Staff,8,0,30,22
1649931165271,MATH 10B,A02,084111,Staff,29,0,30,1
1649931165271,MATH 10B,A03,084112,Staff,28,0,30,2
1649931171293,MATH 10C,A01,083443,Staff,9,0,30,21
1649931171293,MATH 10C,A02,083444,Staff,16,0,30,14
1649931171293,MATH 10C,B01,084114,Staff,25,0,30,5
1649931171293,MATH 10C,B02,084115,Staff,29,0,30,1
1649931177321,MATH 18,A01,084117,Harel; Guershon,27,0,30,3
1649931177321,MATH 18,A02,084119,Harel; Guershon,29,0,30,1
1649931177321,MATH 18,A03,084120,Harel; Guershon,30,0,30,0
1649931177321,MATH 18,A04,084121,Harel; Guershon,29,0,30,1
1649931183345,MATH 20B,A01,084124,Um; Ko Woon,31,0,35,4
1649931183345,MATH 20B,B01,084126,Um; Ko Woon,32,0,35,3
1649931189368,MATH 20C,A01,083446,Hammock; Frances H,17,0,30,13
1649931189368,MATH 20C,A02,083447,Hammock; Frances H,28,0,30,2
1649931189368,MATH 20C,A03,083448,Hammock; Frances H,30,0,30,0
1649931189368,MATH 20C,A04,083449,Hammock; Frances H,30,0,30,0
1649931189368,MATH 20C,B01,083451,Hammock; Frances H,25,0,30,5
1649931189368,MATH 20C,B02,083452,Hammock; Frances H,27,0,30,3
1649931189368,MATH 20C,B03,083453,Hammock; Frances H,26,0,30,4
1649931189368,MATH 20C,B04,083454,Hammock; Frances H,30,0,30,0
1649931195391,MATH 20D,A01,084128,Staff,26,0,30,4
1649931195391,MATH 20D,A02,084129,Staff,30,0,30,0
1649931195391,MATH 20D,A03,084130,Staff,29,0,30,1
1649931195391,MATH 20D,B01,084133,Staff,21,0,30,9
1649931195391,MATH 20D,B02,084134,Staff,27,0,30,3
1649931195391,MATH 20D,B03,084135,Staff,30,0,30,0
1649931201419,MATH 20E,A01,084138,Staff,22,0,30,8
1649931201419,MATH 20E,A02,084139,Staff,22,0,30,8
1649931201419,MATH 20E,A03,084140,Staff,23,0,30,7
1649931201419,MATH 20E,A04,084141,Staff,25,0,30,5
1649931207443,MATH 102,A01,084143,Harel; Guershon,16,0,30,14
1649931207443,MATH 102,A02,084144,Harel; Guershon,22,0,30,8
1649931213467,MATH 103B,A01,083456,Staff,0,8,30,30
1649931213467,MATH 103B,A02,083457,Staff,0,9,30,30
1649931219491,MATH 109,A01,084146,Salehi Golsefidy; Alireza,28,0,30,2
1649931219491,MATH 109,A02,084147,Salehi Golsefidy; Alireza,22,0,30,8
1649931225521,MATH 120A,A01,085445,Eggers; John Dietrich,20,0,35,15
1649931225521,MATH 120A,A02,085446,Eggers; John Dietrich,28,0,35,7
1649931231550,MATH 142B,A01,084149,Verstraete; Jacques Allan,0,10,30,30
1649931231550,MATH 142B,A02,084150,Verstraete; Jacques Allan,0,9,30,30
1649931237573,MATH 170A,A01,083459,Nie; Jiawang,0,2,30,30
1649931237573,MATH 170A,A02,083460,Nie; Jiawang,0,0,30,30
1649931237573,MATH 170A,A03,083461,Nie; Jiawang,7,0,30,23
1649931243600,MATH 193B,A01,083463,Staff,3,0,30,27
1649931243600,MATH 193B,A02,083464,Staff,10,0,30,20
1649931243600,MATH 193B,A03,083465,Staff,19,0,30,11
1649931249652,COGS 2,A01,083966,Boyle; Mary E. T.,18,0,30,12
1649931255677,COGS 9,A01,083968,Staff,41,0,60,19
1649931261704,COGS 14B,A01,083970,Staff,28,0,50,22
1649931267727,COGS 17,A01,092679,Staff,67,0,75,8
1649931273755,COGS 100,A01,083972,Staff,10,0,60,50
1649931285816,COGS 101C,A01,083976,Staff,19,0,30,11
1649931291841,COGS 102A,A01,083978,Johnson; Christine M.,17,0,30,13
1649931297869,COGS 107B,A01,083980,Staff,3,0,50,47
1649931303893,COGS 115,A01,083982,Staff,14,0,30,16
1649931309926,COGS 118B,A01,083367,Staff,0,11,40,40
1649931315953,COGS 172,A01,083984,Provenzano; Emily Kara,17,0,30,13
1649931321977,COGS 177,A00,083368,Staff,0,17,30,30
1649931327999,COGS 186,A01,083986,Staff,21,0,40,19
1649931334028,COGS 187A,A01,083988,Boyle; Mary E. T.,24,0,60,36
1649931340064,CSE 8A,A50,084003,Miranda; Gregory Joseph,0,0,15,15
1649931346096,CSE 11,A01,084005,Miranda; Gregory Joseph,22,0,55,33
1649931352126,CSE 20,A01,084007,Staff,9,0,20,11
1649931358161,CSE 21,A01,084009,Staff,10,0,50,40
1649931364190,CSE 30,A01,083370,Cao; Yingjun,0,20,40,40
1649931370212,CSE 100,A01,083372,Cao; Yingjun,0,23,40,40
1649931376249,CSE 101,A01,084011,Staff,0,49,40,40
1649931382298,CSE 141,A01,083374,Eldon; John,0,51,75,75
1649931388323,CSE 141L,A01,083376,Eldon; John,0,56,75,75
1649931394348,CSE 175,A01,084013,Kumar; Rakesh,22,0,25,3
1649931400382,CSE 190,A00,092508,Dubnov; Shlomo,15,0,15,0
1649931406409,ECE 5,A01,084049,Morris; Karcher William,15,0,20,5
1649931412435,ECE 100,A01,084051,Baghdadchi; Saharnaz,1,0,20,19
1649931412435,ECE 100,A02,091916,Baghdadchi; Saharnaz,16,0,20,4
1649931418465,ECE 101,A01,084053,Baghdadchi; Saharnaz,5,0,37,32
1649931418465,ECE 101,A02,084054,Baghdadchi; Saharnaz,33,0,37,4
1649931424500,ECE 107,A01,083390,Staff,28,0,40,12
1649931430532,ECE 148,A01,084056,Silberman; Jack,7,0,12,5
1649931436560,ECE 180,A00,083391,Abi Samra; Nicholas Camill,25,0,30,5
1649931436560,ECE 180,B00,083392,Abi Samra; Nicholas Camill,22,0,30,8
1649931442586,MATH 10B,A01,084110,Staff,8,0,30,22
1649931442586,MATH 10B,A02,084111,Staff,29,0,30,1
1649931442586,MATH 10B,A03,084112,Staff,28,0,30,2
1649931448618,MATH 10C,A01,083443,Staff,9,0,30,21
1649931448618,MATH 10C,A02,083444,Staff,16,0,30,14
1649931448618,MATH 10C,B01,084114,Staff,25,0,30,5
1649931448618,MATH 10C,B02,084115,Staff,29,0,30,1
1649931454645,MATH 18,A01,084117,Harel; Guershon,27,0,30,3
1649931454645,MATH 18,A02,084119,Harel; Guershon,29,0,30,1
1649931454645,MATH 18,A03,084120,Harel; Guershon,30,0,30,0
1649931454645,MATH 18,A04,084121,Harel; Guershon,29,0,30,1
1649931460669,MATH 20B,A01,084124,Um; Ko Woon,31,0,35,4
1649931460669,MATH 20B,B01,084126,Um; Ko Woon,32,0,35,3
1649931466703,MATH 20C,A01,083446,Hammock; Frances H,17,0,30,13
1649931466703,MATH 20C,A02,083447,Hammock; Frances H,28,0,30,2
1649931466703,MATH 20C,A03,083448,Hammock; Frances H,30,0,30,0
1649931466703,MATH 20C,A04,083449,Hammock; Frances H,30,0,30,0
1649931466703,MATH 20C,B01,083451,Hammock; Frances H,25,0,30,5
1649931466703,MATH 20C,B02,083452,Hammock; Frances H,27,0,30,3
1649931466703,MATH 20C,B03,083453,Hammock; Frances H,26,0,30,4
1649931466703,MATH 20C,B04,083454,Hammock; Frances H,30,0,30,0
1649931472729,MATH 20D,A01,084128,Staff,26,0,30,4
1649931472729,MATH 20D,A02,084129,Staff,30,0,30,0
1649931472729,MATH 20D,A03,084130,Staff,29,0,30,1
1649931472729,MATH 20D,B01,084133,Staff,21,0,30,9
1649931472729,MATH 20D,B02,084134,Staff,27,0,30,3
1649931472729,MATH 20D,B03,084135,Staff,30,0,30,0
1649931478754,MATH 20E,A01,084138,Staff,22,0,30,8
1649931478754,MATH 20E,A02,084139,Staff,22,0,30,8
1649931478754,MATH 20E,A03,084140,Staff,23,0,30,7
1649931478754,MATH 20E,A04,084141,Staff,25,0,30,5
1649931484784,MATH 102,A01,084143,Harel; Guershon,16,0,30,14
1649931484784,MATH 102,A02,084144,Harel; Guershon,22,0,30,8
1649931490809,MATH 103B,A01,083456,Staff,0,8,30,30
1649931490809,MATH 103B,A02,083457,Staff,0,9,30,30
1649931496845,MATH 109,A01,084146,Salehi Golsefidy; Alireza,28,0,30,2
1649931496845,MATH 109,A02,084147,Salehi Golsefidy; Alireza,22,0,30,8
1649931502878,MATH 120A,A01,085445,Eggers; John Dietrich,20,0,35,15
1649931502878,MATH 120A,A02,085446,Eggers; John Dietrich,28,0,35,7
1649931508904,MATH 142B,A01,084149,Verstraete; Jacques Allan,0,10,30,30
1649931508904,MATH 142B,A02,084150,Verstraete; Jacques Allan,0,9,30,30
1649931514940,MATH 170A,A01,083459,Nie; Jiawang,0,2,30,30
1649931514940,MATH 170A,A02,083460,Nie; Jiawang,0,0,30,30
1649931514940,MATH 170A,A03,083461,Nie; Jiawang,7,0,30,23
1649931520967,MATH 193B,A01,083463,Staff,3,0,30,27
1649931520967,MATH 193B,A02,083464,Staff,10,0,30,20
1649931520967,MATH 193B,A03,083465,Staff,19,0,30,11
1649931527035,COGS 2,A01,083966,Boyle; Mary E. T.,18,0,30,12
1649931533082,COGS 9,A01,083968,Staff,41,0,60,19
1649931539108,COGS 14B,A01,083970,Staff,28,0,50,22
1649931545135,COGS 17,A01,092679,Staff,67,0,75,8
1649931551161,COGS 100,A01,083972,Staff,10,0,60,50
1649931563223,COGS 101C,A01,083976,Staff,19,0,30,11
1649931569249,COGS 102A,A01,083978,Johnson; Christine M.,17,0,30,13
1649931575277,COGS 107B,A01,083980,Staff,3,0,50,47
1649931581388,COGS 115,A01,083982,Staff,14,0,30,16
1649931587413,COGS 118B,A01,083367,Staff,0,11,40,40
1649931593439,COGS 172,A01,083984,Provenzano; Emily Kara,17,0,30,13
1649931599469,COGS 177,A00,083368,Staff,0,17,30,30
1649931605496,COGS 186,A01,083986,Staff,21,0,40,19
1649931611522,COGS 187A,A01,083988,Boyle; Mary E. T.,24,0,60,36
1649931617555,CSE 8A,A50,084003,Miranda; Gregory Joseph,0,0,15,15
1649931623580,CSE 11,A01,084005,Miranda; Gregory Joseph,22,0,55,33
1649931629605,CSE 20,A01,084007,Staff,9,0,20,11
1649931635636,CSE 21,A01,084009,Staff,10,0,50,40
1649931641658,CSE 30,A01,083370,Cao; Yingjun,0,20,40,40
1649931647686,CSE 100,A01,083372,Cao; Yingjun,0,23,40,40
1649931653712,CSE 101,A01,084011,Staff,0,49,40,40
1649931659742,CSE 141,A01,083374,Eldon; John,0,51,75,75
1649931665772,CSE 141L,A01,083376,Eldon; John,0,56,75,75
1649931671803,CSE 175,A01,084013,Kumar; Rakesh,22,0,25,3
1649931677832,CSE 190,A00,092508,Dubnov; Shlomo,15,0,15,0
1649931683859,ECE 5,A01,084049,Morris; Karcher William,15,0,20,5
1649931689886,ECE 100,A01,084051,Baghdadchi; Saharnaz,1,0,20,19
1649931689886,ECE 100,A02,091916,Baghdadchi; Saharnaz,16,0,20,4
1649931695914,ECE 101,A01,084053,Baghdadchi; Saharnaz,5,0,37,32
1649931695914,ECE 101,A02,084054,Baghdadchi; Saharnaz,33,0,37,4
1649931701939,ECE 107,A01,083390,Staff,28,0,40,12
1649931707968,ECE 148,A01,084056,Silberman; Jack,7,0,12,5
1649931713993,ECE 180,A00,083391,Abi Samra; Nicholas Camill,25,0,30,5
1649931713993,ECE 180,B00,083392,Abi Samra; Nicholas Camill,22,0,30,8
1649931720030,MATH 10B,A01,084110,Staff,8,0,30,22
1649931720030,MATH 10B,A02,084111,Staff,29,0,30,1
1649931720030,MATH 10B,A03,084112,Staff,28,0,30,2
1649931726056,MATH 10C,A01,083443,Staff,9,0,30,21
1649931726056,MATH 10C,A02,083444,Staff,16,0,30,14
1649931726056,MATH 10C,B01,084114,Staff,25,0,30,5
1649931726056,MATH 10C,B02,084115,Staff,29,0,30,1
1649931732081,MATH 18,A01,084117,Harel; Guershon,27,0,30,3
1649931732081,MATH 18,A02,084119,Harel; Guershon,29,0,30,1
1649931732081,MATH 18,A03,084120,Harel; Guershon,30,0,30,0
1649931732081,MATH 18,A04,084121,Harel; Guershon,29,0,30,1
1649931738112,MATH 20B,A01,084124,Um; Ko Woon,31,0,35,4
1649931738112,MATH 20B,B01,084126,Um; Ko Woon,32,0,35,3
1649931744139,MATH 20C,A01,083446,Hammock; Frances H,17,0,30,13
1649931744139,MATH 20C,A02,083447,Hammock; Frances H,28,0,30,2
1649931744139,MATH 20C,A03,083448,Hammock; Frances H,30,0,30,0
1649931744139,MATH 20C,A04,083449,Hammock; Frances H,30,0,30,0
1649931744139,MATH 20C,B01,083451,Hammock; Frances H,25,0,30,5
1649931744139,MATH 20C,B02,083452,Hammock; Frances H,27,0,30,3
1649931744139,MATH 20C,B03,083453,Hammock; Frances H,26,0,30,4
1649931744139,MATH 20C,B04,083454,Hammock; Frances H,30,0,30,0
1649931750169,MATH 20D,A01,084128,Staff,26,0,30,4
1649931750169,MATH 20D,A02,084129,Staff,30,0,30,0
1649931750169,MATH 20D,A03,084130,Staff,29,0,30,1
1649931750169,MATH 20D,B01,084133,Staff,21,0,30,9
1649931750169,MATH 20D,B02,084134,Staff,27,0,30,3
1649931750169,MATH 20D,B03,084135,Staff,30,0,30,0
1649931756197,MATH 20E,A01,084138,Staff,22,0,30,8
1649931756197,MATH 20E,A02,084139,Staff,22,0,30,8
1649931756197,MATH 20E,A03,084140,Staff,23,0,30,7
1649931756197,MATH 20E,A04,084141,Staff,25,0,30,5
1649931762220,MATH 102,A01,084143,Harel; Guershon,16,0,30,14
1649931762220,MATH 102,A02,084144,Harel; Guershon,22,0,30,8
1649931768247,MATH 103B,A01,083456,Staff,0,8,30,30
1649931768247,MATH 103B,A02,083457,Staff,0,9,30,30
1649931774277,MATH 109,A01,084146,Salehi Golsefidy; Alireza,28,0,30,2
1649931774277,MATH 109,A02,084147,Salehi Golsefidy; Alireza,22,0,30,8
1649931780310,MATH 120A,A01,085445,Eggers; John Dietrich,20,0,35,15
1649931780310,MATH 120A,A02,085446,Eggers; John Dietrich,28,0,35,7
1649931786340,MATH 142B,A01,084149,Verstraete; Jacques Allan,0,10,30,30
1649931786340,MATH 142B,A02,084150,Verstraete; Jacques Allan,0,9,30,30
1649931792366,MATH 170A,A01,083459,Nie; Jiawang,0,2,30,30
1649931792366,MATH 170A,A02,083460,Nie; Jiawang,0,0,30,30
1649931792366,MATH 170A,A03,083461,Nie; Jiawang,7,0,30,23
1649931798396,MATH 193B,A01,083463,Staff,3,0,30,27
1649931798396,MATH 193B,A02,083464,Staff,10,0,30,20
1649931798396,MATH 193B,A03,083465,Staff,19,0,30,11
1649931804476,COGS 2,A01,083966,Boyle; Mary E. T.,18,0,30,12
1649931810513,COGS 9,A01,083968,Staff,41,0,60,19
1649931816543,COGS 14B,A01,083970,Staff,28,0,50,22
1649931822567,COGS 17,A01,092679,Staff,67,0,75,8
1649931828592,COGS 100,A01,083972,Staff,10,0,60,50
1649931840652,COGS 101C,A01,083976,Staff,19,0,30,11
1649931846682,COGS 102A,A01,083978,Johnson; Christine M.,17,0,30,13
1649931852712,COGS 107B,A01,083980,Staff,3,0,50,47
1649931858742,COGS 115,A01,083982,Staff,14,0,30,16
1649931864767,COGS 118B,A01,083367,Staff,0,11,40,40
1649931870797,COGS 172,A01,083984,Provenzano; Emily Kara,17,0,30,13
1649931876826,COGS 177,A00,083368,Staff,0,17,30,30
1649931882855,COGS 186,A01,083986,Staff,21,0,40,19
1649931888879,COGS 187A,A01,083988,Boyle; Mary E. T.,24,0,60,36
1649931894906,CSE 8A,A50,084003,Miranda; Gregory Joseph,0,0,15,15
1649931900932,CSE 11,A01,084005,Miranda; Gregory Joseph,22,0,55,33
1649931906958,CSE 20,A01,084007,Staff,9,0,20,11
1649931912984,CSE 21,A01,084009,Staff,10,0,50,40
1649931919011,CSE 30,A01,083370,Cao; Yingjun,0,20,40,40
1649931925037,CSE 100,A01,083372,Cao; Yingjun,0,23,40,40
1649931931064,CSE 101,A01,084011,Staff,0,49,40,40
1649931937089,CSE 141,A01,083374,Eldon; John,0,51,75,75
1649931943114,CSE 141L,A01,083376,Eldon; John,0,56,75,75
1649931949137,CSE 175,A01,084013,Kumar; Rakesh,22,0,25,3
1649931955166,CSE 190,A00,092508,Dubnov; Shlomo,15,0,15,0
1649931961190,ECE 5,A01,084049,Morris; Karcher William,15,0,20,5
1649931967219,ECE 100,A01,084051,Baghdadchi; Saharnaz,1,0,20,19
1649931967219,ECE 100,A02,091916,Baghdadchi; Saharnaz,16,0,20,4
1649931973248,ECE 101,A01,084053,Baghdadchi; Saharnaz,5,0,37,32
1649931973248,ECE 101,A02,084054,Baghdadchi; Saharnaz,33,0,37,4
1649931979274,ECE 107,A01,083390,Staff,28,0,40,12
1649931985311,ECE 148,A01,084056,Silberman; Jack,7,0,12,5
1649931991340,ECE 180,A00,083391,Abi Samra; Nicholas Camill,25,0,30,5
1649931991340,ECE 180,B00,083392,Abi Samra; Nicholas Camill,22,0,30,8
1649931997367,MATH 10B,A01,084110,Staff,8,0,30,22
1649931997367,MATH 10B,A02,084111,Staff,29,0,30,1
1649931997367,MATH 10B,A03,084112,Staff,28,0,30,2
1649932003398,MATH 10C,A01,083443,Staff,9,0,30,21
1649932003398,MATH 10C,A02,083444,Staff,16,0,30,14
1649932003398,MATH 10C,B01,084114,Staff,25,0,30,5
1649932003398,MATH 10C,B02,084115,Staff,29,0,30,1
1649932009428,MATH 18,A01,084117,Harel; Guershon,27,0,30,3
1649932009428,MATH 18,A02,084119,Harel; Guershon,29,0,30,1
1649932009428,MATH 18,A03,084120,Harel; Guershon,30,0,30,0
1649932009428,MATH 18,A04,084121,Harel; Guershon,29,0,30,1
1649932015468,MATH 20B,A01,084124,Um; Ko Woon,31,0,35,4
1649932015468,MATH 20B,B01,084126,Um; Ko Woon,32,0,35,3
1649932021495,MATH 20C,A01,083446,Hammock; Frances H,17,0,30,13
1649932021495,MATH 20C,A02,083447,Hammock; Frances H,28,0,30,2
1649932021495,MATH 20C,A03,083448,Hammock; Frances H,30,0,30,0
1649932021495,MATH 20C,A04,083449,Hammock; Frances H,30,0,30,0
1649932021495,MATH 20C,B01,083451,Hammock; Frances H,25,0,30,5
1649932021495,MATH 20C,B02,083452,Hammock; Frances H,27,0,30,3
1649932021495,MATH 20C,B03,083453,Hammock; Frances H,26,0,30,4
1649932021495,MATH 20C,B04,083454,Hammock; Frances H,30,0,30,0
1649932027531,MATH 20D,A01,084128,Staff,26,0,30,4
1649932027531,MATH 20D,A02,084129,Staff,30,0,30,0
1649932027531,MATH 20D,A03,084130,Staff,29,0,30,1
1649932027531,MATH 20D,B01,084133,Staff,21,0,30,9
1649932027531,MATH 20D,B02,084134,Staff,27,0,30,3
1649932027531,MATH 20D,B03,084135,Staff,30,0,30,0
1649932033556,MATH 20E,A01,084138,Staff,22,0,30,8
1649932033556,MATH 20E,A02,084139,Staff,22,0,30,8
1649932033556,MATH 20E,A03,084140,Staff,23,0,30,7
1649932033556,MATH 20E,A04,084141,Staff,25,0,30,5
1649932039584,MATH 102,A01,084143,Harel; Guershon,16,0,30,14
1649932039584,MATH 102,A02,084144,Harel; Guershon,22,0,30,8
1649932045609,MATH 103B,A01,083456,Staff,0,8,30,30
1649932045609,MATH 103B,A02,083457,Staff,0,9,30,30
1649932051640,MATH 109,A01,084146,Salehi Golsefidy; Alireza,28,0,30,2
1649932051640,MATH 109,A02,084147,Salehi Golsefidy; Alireza,22,0,30,8
1649932057665,MATH 120A,A01,085445,Eggers; John Dietrich,20,0,35,15
1649932057665,MATH 120A,A02,085446,Eggers; John Dietrich,28,0,35,7
1649932063710,MATH 142B,A01,084149,Verstraete; Jacques Allan,0,10,30,30
1649932063710,MATH 142B,A02,084150,Verstraete; Jacques Allan,0,9,30,30
1649932069742,MATH 170A,A01,083459,Nie; Jiawang,0,2,30,30
1649932069742,MATH 170A,A02,083460,Nie; Jiawang,0,0,30,30
1649932069742,MATH 170A,A03,083461,Nie; Jiawang,7,0,30,23
1649932075770,MATH 193B,A01,083463,Staff,3,0,30,27
1649932075770,MATH 193B,A02,083464,Staff,10,0,30,20
1649932075770,MATH 193B,A03,083465,Staff,19,0,30,11
1649932081871,COGS 2,A01,083966,Boyle; Mary E. T.,18,0,30,12
1649932087899,COGS 9,A01,083968,Staff,41,0,60,19
1649932093928,COGS 14B,A01,083970,Staff,28,0,50,22
1649932099952,COGS 17,A01,092679,Staff,67,0,75,8
1649932105983,COGS 100,A01,083972,Staff,9,0,60,51
1649932118038,COGS 101C,A01,083976,Staff,19,0,30,11
1649932124063,COGS 102A,A01,083978,Johnson; Christine M.,17,0,30,13
1649932130091,COGS 107B,A01,083980,Staff,3,0,50,47
1649932136118,COGS 115,A01,083982,Staff,14,0,30,16
1649932142145,COGS 118B,A01,083367,Staff,0,11,40,40
1649932148174,COGS 172,A01,083984,Provenzano; Emily Kara,17,0,30,13
1649932154197,COGS 177,A00,083368,Staff,0,17,30,30
1649932160225,COGS 186,A01,083986,Staff,21,0,40,19
1649932166248,COGS 187A,A01,083988,Boyle; Mary E. T.,24,0,60,36
1649932172275,CSE 8A,A50,084003,Miranda; Gregory Joseph,0,0,15,15
1649932178390,CSE 11,A01,084005,Miranda; Gregory Joseph,22,0,55,33
1649932184420,CSE 20,A01,084007,Staff,9,0,20,11
1649932190446,CSE 21,A01,084009,Staff,10,0,50,40
1649932196470,CSE 30,A01,083370,Cao; Yingjun,0,20,40,40
1649932202494,CSE 100,A01,083372,Cao; Yingjun,0,23,40,40
1649932208522,CSE 101,A01,084011,Staff,0,49,40,40
1649932214550,CSE 141,A01,083374,Eldon; John,0,51,75,75
1649932220580,CSE 141L,A01,083376,Eldon; John,0,56,75,75
1649932226605,CSE 175,A01,084013,Kumar; Rakesh,22,0,25,3
1649932232627,CSE 190,A00,092508,Dubnov; Shlomo,15,0,15,0
1649932238652,ECE 5,A01,084049,Morris; Karcher William,15,0,20,5
1649932244681,ECE 100,A01,084051,Baghdadchi; Saharnaz,1,0,20,19
1649932244681,ECE 100,A02,091916,Baghdadchi; Saharnaz,16,0,20,4
1649932250718,ECE 101,A01,084053,Baghdadchi; Saharnaz,5,0,37,32
1649932250718,ECE 101,A02,084054,Baghdadchi; Saharnaz,33,0,37,4
1649932256747,ECE 107,A01,083390,Staff,28,0,40,12
1649932262774,ECE 148,A01,084056,Silberman; Jack,7,0,12,5
1649932268806,ECE 180,A00,083391,Abi Samra; Nicholas Camill,25,0,30,5
1649932268806,ECE 180,B00,083392,Abi Samra; Nicholas Camill,22,0,30,8
1649932274836,MATH 10B,A01,084110,Staff,8,0,30,22
1649932274836,MATH 10B,A02,084111,Staff,29,0,30,1
1649932274836,MATH 10B,A03,084112,Staff,28,0,30,2
1649932280869,MATH 10C,A01,083443,Staff,9,0,30,21
1649932280869,MATH 10C,A02,083444,Staff,16,0,30,14
1649932280869,MATH 10C,B01,084114,Staff,25,0,30,5
1649932280869,MATH 10C,B02,084115,Staff,29,0,30,1
1649932286893,MATH 18,A01,084117,Harel; Guershon,27,0,30,3
1649932286893,MATH 18,A02,084119,Harel; Guershon,29,0,30,1
1649932286893,MATH 18,A03,084120,Harel; Guershon,30,0,30,0
1649932286893,MATH 18,A04,084121,Harel; Guershon,29,0,30,1
1649932292928,MATH 20B,A01,084124,Um; Ko Woon,31,0,35,4
1649932292928,MATH 20B,B01,084126,Um; Ko Woon,32,0,35,3
1649932298964,MATH 20C,A01,083446,Hammock; Frances H,17,0,30,13
1649932298964,MATH 20C,A02,083447,Hammock; Frances H,28,0,30,2
1649932298964,MATH 20C,A03,083448,Hammock; Frances H,30,0,30,0
1649932298964,MATH 20C,A04,083449,Hammock; Frances H,30,0,30,0
1649932298964,MATH 20C,B01,083451,Hammock; Frances H,25,0,30,5
1649932298964,MATH 20C,B02,083452,Hammock; Frances H,27,0,30,3
1649932298964,MATH 20C,B03,083453,Hammock; Frances H,26,0,30,4
1649932298964,MATH 20C,B04,083454,Hammock; Frances H,30,0,30,0
1649932305000,MATH 20D,A01,084128,Staff,26,0,30,4
1649932305000,MATH 20D,A02,084129,Staff,30,0,30,0
1649932305000,MATH 20D,A03,084130,Staff,29,0,30,1
1649932305000,MATH 20D,B01,084133,Staff,21,0,30,9
1649932305000,MATH 20D,B02,084134,Staff,27,0,30,3
1649932305000,MATH 20D,B03,084135,Staff,30,0,30,0
1649932311026,MATH 20E,A01,084138,Staff,22,0,30,8
1649932311026,MATH 20E,A02,084139,Staff,22,0,30,8
1649932311026,MATH 20E,A03,084140,Staff,23,0,30,7
1649932311026,MATH 20E,A04,084141,Staff,25,0,30,5
1649932317057,MATH 102,A01,084143,Harel; Guershon,16,0,30,14
1649932317057,MATH 102,A02,084144,Harel; Guershon,22,0,30,8
1649932323088,MATH 103B,A01,083456,Staff,0,8,30,30
1649932323088,MATH 103B,A02,083457,Staff,0,9,30,30
1649932329119,MATH 109,A01,084146,Salehi Golsefidy; Alireza,28,0,30,2
1649932329119,MATH 109,A02,084147,Salehi Golsefidy; Alireza,22,0,30,8
1649932335145,MATH 120A,A01,085445,Eggers; John Dietrich,20,0,35,15
1649932335145,MATH 120A,A02,085446,Eggers; John Dietrich,28,0,35,7
1649932341174,MATH 142B,A01,084149,Verstraete; Jacques Allan,0,10,30,30
1649932341174,MATH 142B,A02,084150,Verstraete; Jacques Allan,0,9,30,30
1649932347201,MATH 170A,A01,083459,Nie; Jiawang,0,2,30,30
1649932347201,MATH 170A,A02,083460,Nie; Jiawang,0,0,30,30
1649932347201,MATH 170A,A03,083461,Nie; Jiawang,7,0,30,23
1649932353224,MATH 193B,A01,083463,Staff,3,0,30,27
1649932353224,MATH 193B,A02,083464,Staff,10,0,30,20
1649932353224,MATH 193B,A03,083465,Staff,19,0,30,11
1649932359292,COGS 2,A01,083966,Boyle; Mary E. T.,18,0,30,12
1649932365317,COGS 9,A01,083968,Staff,41,0,60,19
1649932371354,COGS 14B,A01,083970,Staff,28,0,50,22
1649932377379,COGS 17,A01,092679,Staff,67,0,75,8
1649932383408,COGS 100,A01,083972,Staff,9,0,60,51
1649932395469,COGS 101C,A01,083976,Staff,19,0,30,11
1649932401496,COGS 102A,A01,083978,Johnson; Christine M.,17,0,30,13
1649932407526,COGS 107B,A01,083980,Staff,3,0,50,47
1649932413551,COGS 115,A01,083982,Staff,14,0,30,16
1649932419575,COGS 118B,A01,083367,Staff,0,11,40,40
1649932425601,COGS 172,A01,083984,Provenzano; Emily Kara,17,0,30,13
1649932431631,COGS 177,A00,083368,Staff,0,17,30,30
1649932437660,COGS 186,A01,083986,Staff,21,0,40,19
1649932443694,COGS 187A,A01,083988,Boyle; Mary E. T.,24,0,60,36
1649932449724,CSE 8A,A50,084003,Miranda; Gregory Joseph,0,0,15,15
1649932455756,CSE 11,A01,084005,Miranda; Gregory Joseph,22,0,55,33
1649932461788,CSE 20,A01,084007,Staff,9,0,20,11
1649932467814,CSE 21,A01,084009,Staff,10,0,50,40
1649932473841,CSE 30,A01,083370,Cao; Yingjun,0,20,40,40
1649932479867,CSE 100,A01,083372,Cao; Yingjun,0,23,40,40
1649932485897,CSE 101,A01,084011,Staff,0,49,40,40
1649932491923,CSE 141,A01,083374,Eldon; John,0,51,75,75
1649932497959,CSE 141L,A01,083376,Eldon; John,0,56,75,75
1649932503986,CSE 175,A01,084013,Kumar; Rakesh,22,0,25,3
1649932510012,CSE 190,A00,092508,Dubnov; Shlomo,15,0,15,0
1649932516046,ECE 5,A01,084049,Morris; Karcher William,15,0,20,5
1649932522073,ECE 100,A01,084051,Baghdadchi; Saharnaz,1,0,20,19
1649932522073,ECE 100,A02,091916,Baghdadchi; Saharnaz,16,0,20,4
1649932528099,ECE 101,A01,084053,Baghdadchi; Saharnaz,5,0,37,32
1649932528099,ECE 101,A02,084054,Baghdadchi; Saharnaz,33,0,37,4
1649932534132,ECE 107,A01,083390,Staff,28,0,40,12
1649932540165,ECE 148,A01,084056,Silberman; Jack,7,0,12,5
1649932546190,ECE 180,A00,083391,Abi Samra; Nicholas Camill,25,0,30,5
1649932546190,ECE 180,B00,083392,Abi Samra; Nicholas Camill,22,0,30,8
1649932552217,MATH 10B,A01,084110,Staff,8,0,30,22
1649932552217,MATH 10B,A02,084111,Staff,29,0,30,1
1649932552217,MATH 10B,A03,084112,Staff,28,0,30,2
1649932558243,MATH 10C,A01,083443,Staff,9,0,30,21
1649932558243,MATH 10C,A02,083444,Staff,16,0,30,14
1649932558243,MATH 10C,B01,084114,Staff,25,0,30,5
1649932558243,MATH 10C,B02,084115,Staff,29,0,30,1
1649932564278,MATH 18,A01,084117,Harel; Guershon,27,0,30,3
1649932564278,MATH 18,A02,084119,Harel; Guershon,29,0,30,1
1649932564278,MATH 18,A03,084120,Harel; Guershon,30,0,30,0
1649932564278,MATH 18,A04,084121,Harel; Guershon,29,0,30,1
1649932570314,MATH 20B,A01,084124,Um; Ko Woon,31,0,35,4
1649932570314,MATH 20B,B01,084126,Um; Ko Woon,32,0,35,3
1649932576341,MATH 20C,A01,083446,Hammock; Frances H,17,0,30,13
1649932576341,MATH 20C,A02,083447,Hammock; Frances H,28,0,30,2
1649932576341,MATH 20C,A03,083448,Hammock; Frances H,30,0,30,0
1649932576341,MATH 20C,A04,083449,Hammock; Frances H,30,0,30,0
1649932576341,MATH 20C,B01,083451,Hammock; Frances H,25,0,30,5
1649932576341,MATH 20C,B02,083452,Hammock; Frances H,27,0,30,3
1649932576341,MATH 20C,B03,083453,Hammock; Frances H,26,0,30,4
1649932576341,MATH 20C,B04,083454,Hammock; Frances H,30,0,30,0
1649932582368,MATH 20D,A01,084128,Staff,26,0,30,4
1649932582368,MATH 20D,A02,084129,Staff,30,0,30,0
1649932582368,MATH 20D,A03,084130,Staff,29,0,30,1
1649932582368,MATH 20D,B01,084133,Staff,21,0,30,9
1649932582368,MATH 20D,B02,084134,Staff,27,0,30,3
1649932582368,MATH 20D,B03,084135,Staff,30,0,30,0
1649932588398,MATH 20E,A01,084138,Staff,22,0,30,8
1649932588398,MATH 20E,A02,084139,Staff,22,0,30,8
1649932588398,MATH 20E,A03,084140,Staff,23,0,30,7
1649932588398,MATH 20E,A04,084141,Staff,25,0,30,5
1649932594431,MATH 102,A01,084143,Harel; Guershon,16,0,30,14
1649932594431,MATH 102,A02,084144,Harel; Guershon,22,0,30,8
1649932600454,MATH 103B,A01,083456,Staff,0,8,30,30
1649932600454,MATH 103B,A02,083457,Staff,0,9,30,30
1649932606481,MATH 109,A01,084146,Salehi Golsefidy; Alireza,28,0,30,2
1649932606481,MATH 109,A02,084147,Salehi Golsefidy; Alireza,22,0,30,8
1649932612508,MATH 120A,A01,085445,Eggers; John Dietrich,20,0,35,15
1649932612508,MATH 120A,A02,085446,Eggers; John Dietrich,28,0,35,7
1649932618539,MATH 142B,A01,084149,Verstraete; Jacques Allan,0,10,30,30
1649932618539,MATH 142B,A02,084150,Verstraete; Jacques Allan,0,9,30,30
1649932624571,MATH 170A,A01,083459,Nie; Jiawang,0,2,30,30
1649932624571,MATH 170A,A02,083460,Nie; Jiawang,0,0,30,30
1649932624571,MATH 170A,A03,083461,Nie; Jiawang,7,0,30,23
1649932630597,MATH 193B,A01,083463,Staff,3,0,30,27
1649932630597,MATH 193B,A02,083464,Staff,10,0,30,20
1649932630597,MATH 193B,A03,083465,Staff,19,0,30,11
1649932636667,COGS 2,A01,083966,Boyle; Mary E. T.,18,0,30,12
1649932642692,COGS 9,A01,083968,Staff,41,0,60,19
1649932648725,COGS 14B,A01,083970,Staff,28,0,50,22
1649932654754,COGS 17,A01,092679,Staff,67,0,75,8
1649932660782,COGS 100,A01,083972,Staff,9,0,60,51
1649932672835,COGS 101C,A01,083976,Staff,19,0,30,11
1649932678864,COGS 102A,A01,083978,Johnson; Christine M.,17,0,30,13
1649932684888,COGS 107B,A01,083980,Staff,3,0,50,47
1649932690925,COGS 115,A01,083982,Staff,14,0,30,16
1649932696950,COGS 118B,A01,083367,Staff,0,11,40,40
1649932702985,COGS 172,A01,083984,Provenzano; Emily Kara,17,0,30,13
1649932709009,COGS 177,A00,083368,Staff,0,17,30,30
1649932715037,COGS 186,A01,083986,Staff,21,0,40,19
1649932721067,COGS 187A,A01,083988,Boyle; Mary E. T.,24,0,60,36
1649932727100,CSE 8A,A50,084003,Miranda; Gregory Joseph,0,0,15,15
1649932733125,CSE 11,A01,084005,Miranda; Gregory Joseph,22,0,55,33
1649932739153,CSE 20,A01,084007,Staff,9,0,20,11
1649932745178,CSE 21,A01,084009,Staff,10,0,50,40
1649932751202,CSE 30,A01,083370,Cao; Yingjun,0,20,40,40
1649932757226,CSE 100,A01,083372,Cao; Yingjun,0,23,40,40
1649932763251,CSE 101,A01,084011,Staff,0,49,40,40
1649932769289,CSE 141,A01,083374,Eldon; John,0,51,75,75
1649932775399,CSE 141L,A01,083376,Eldon; John,0,56,75,75
1649932781438,CSE 175,A01,084013,Kumar; Rakesh,22,0,25,3
1649932787464,CSE 190,A00,092508,Dubnov; Shlomo,15,0,15,0
1649932793497,ECE 5,A01,084049,Morris; Karcher William,15,0,20,5
1649932799542,ECE 100,A01,084051,Baghdadchi; Saharnaz,1,0,20,19
1649932799542,ECE 100,A02,091916,Baghdadchi; Saharnaz,16,0,20,4
1649932805575,ECE 101,A01,084053,Baghdadchi; Saharnaz,5,0,37,32
1649932805575,ECE 101,A02,084054,Baghdadchi; Saharnaz,33,0,37,4
1649932811616,ECE 107,A01,083390,Staff,28,0,40,12
1649932817643,ECE 148,A01,084056,Silberman; Jack,7,0,12,5
1649932823685,ECE 180,A00,083391,Abi Samra; Nicholas Camill,25,0,30,5
1649932823685,ECE 180,B00,083392,Abi Samra; Nicholas Camill,22,0,30,8
1649932829712,MATH 10B,A01,084110,Staff,8,0,30,22
1649932829712,MATH 10B,A02,084111,Staff,29,0,30,1
1649932829712,MATH 10B,A03,084112,Staff,28,0,30,2
1649932835745,MATH 10C,A01,083443,Staff,9,0,30,21
1649932835745,MATH 10C,A02,083444,Staff,16,0,30,14
1649932835745,MATH 10C,B01,084114,Staff,25,0,30,5
1649932835745,MATH 10C,B02,084115,Staff,29,0,30,1
1649932841769,MATH 18,A01,084117,Harel; Guershon,27,0,30,3
1649932841769,MATH 18,A02,084119,Harel; Guershon,29,0,30,1
1649932841769,MATH 18,A03,084120,Harel; Guershon,30,0,30,0
1649932841769,MATH 18,A04,084121,Harel; Guershon,29,0,30,1
1649932847795,MATH 20B,A01,084124,Um; Ko Woon,31,0,35,4
1649932847795,MATH 20B,B01,084126,Um; Ko Woon,32,0,35,3
1649932853822,MATH 20C,A01,083446,Hammock; Frances H,17,0,30,13
1649932853822,MATH 20C,A02,083447,Hammock; Frances H,28,0,30,2
1649932853822,MATH 20C,A03,083448,Hammock; Frances H,30,0,30,0
1649932853822,MATH 20C,A04,083449,Hammock; Frances H,30,0,30,0
1649932853822,MATH 20C,B01,083451,Hammock; Frances H,25,0,30,5
1649932853822,MATH 20C,B02,083452,Hammock; Frances H,27,0,30,3
1649932853822,MATH 20C,B03,083453,Hammock; Frances H,26,0,30,4
1649932853822,MATH 20C,B04,083454,Hammock; Frances H,30,0,30,0
1649932859852,MATH 20D,A01,084128,Staff,26,0,30,4
1649932859852,MATH 20D,A02,084129,Staff,30,0,30,0
1649932859852,MATH 20D,A03,084130,Staff,29,0,30,1
1649932859852,MATH 20D,B01,084133,Staff,21,0,30,9
1649932859852,MATH 20D,B02,084134,Staff,27,0,30,3
1649932859852,MATH 20D,B03,084135,Staff,30,0,30,0
1649932865883,MATH 20E,A01,084138,Staff,22,0,30,8
1649932865883,MATH 20E,A02,084139,Staff,22,0,30,8
1649932865883,MATH 20E,A03,084140,Staff,23,0,30,7
1649932865883,MATH 20E,A04,084141,Staff,25,0,30,5
1649932871913,MATH 102,A01,084143,Harel; Guershon,16,0,30,14
1649932871913,MATH 102,A02,084144,Harel; Guershon,22,0,30,8
1649932877937,MATH 103B,A01,083456,Staff,0,8,30,30
1649932877937,MATH 103B,A02,083457,Staff,0,9,30,30
1649932883972,MATH 109,A01,084146,Salehi Golsefidy; Alireza,28,0,30,2
1649932883972,MATH 109,A02,084147,Salehi Golsefidy; Alireza,22,0,30,8
1649932890004,MATH 120A,A01,085445,Eggers; John Dietrich,20,0,35,15
1649932890004,MATH 120A,A02,085446,Eggers; John Dietrich,28,0,35,7
1649932896029,MATH 142B,A01,084149,Verstraete; Jacques Allan,0,10,30,30
1649932896029,MATH 142B,A02,084150,Verstraete; Jacques Allan,0,9,30,30
1649932902059,MATH 170A,A01,083459,Nie; Jiawang,0,2,30,30
1649932902059,MATH 170A,A02,083460,Nie; Jiawang,0,0,30,30
1649932902059,MATH 170A,A03,083461,Nie; Jiawang,7,0,30,23
1649932908083,MATH 193B,A01,083463,Staff,3,0,30,27
1649932908083,MATH 193B,A02,083464,Staff,10,0,30,20
1649932908083,MATH 193B,A03,083465,Staff,19,0,30,11
1649932914156,COGS 2,A01,083966,Boyle; Mary E. T.,18,0,30,12
1649932920189,COGS 9,A01,083968,Staff,41,0,60,19
1649932926221,COGS 14B,A01,083970,Staff,28,0,50,22
1649932932251,COGS 17,A01,092679,Staff,67,0,75,8
1649932938276,COGS 100,A01,083972,Staff,9,0,60,51
1649932950331,COGS 101C,A01,083976,Staff,19,0,30,11
1649932956362,COGS 102A,A01,083978,Johnson; Christine M.,17,0,30,13
1649932962389,COGS 107B,A01,083980,Staff,3,0,50,47
1649932968414,COGS 115,A01,083982,Staff,14,0,30,16
1649932974442,COGS 118B,A01,083367,Staff,0,11,40,40
1649932980469,COGS 172,A01,083984,Provenzano; Emily Kara,17,0,30,13
1649932986493,COGS 177,A00,083368,Staff,0,17,30,30
1649932992523,COGS 186,A01,083986,Staff,21,0,40,19
1649932998549,COGS 187A,A01,083988,Boyle; Mary E. T.,24,0,60,36
1649933004582,CSE 8A,A50,084003,Miranda; Gregory Joseph,0,0,15,15
1649933010607,CSE 11,A01,084005,Miranda; Gregory Joseph,22,0,55,33
1649933016635,CSE 20,A01,084007,Staff,9,0,20,11
1649933022663,CSE 21,A01,084009,Staff,10,0,50,40
1649933028693,CSE 30,A01,083370,Cao; Yingjun,0,20,40,40
1649933034719,CSE 100,A01,083372,Cao; Yingjun,0,23,40,40
1649933040745,CSE 101,A01,084011,Staff,0,49,40,40
1649933046770,CSE 141,A01,083374,Eldon; John,0,51,75,75
1649933052800,CSE 141L,A01,083376,Eldon; John,0,56,75,75
1649933058826,CSE 175,A01,084013,Kumar; Rakesh,22,0,25,3
1649933064851,CSE 190,A00,092508,Dubnov; Shlomo,15,0,15,0
1649933070883,ECE 5,A01,084049,Morris; Karcher William,15,0,20,5
1649933076912,ECE 100,A01,084051,Baghdadchi; Saharnaz,1,0,20,19
1649933076912,ECE 100,A02,091916,Baghdadchi; Saharnaz,16,0,20,4
1649933082938,ECE 101,A01,084053,Baghdadchi; Saharnaz,5,0,37,32
1649933082938,ECE 101,A02,084054,Baghdadchi; Saharnaz,33,0,37,4
1649933088969,ECE 107,A01,083390,Staff,28,0,40,12
1649933094994,ECE 148,A01,084056,Silberman; Jack,7,0,12,5
1649933101019,ECE 180,A00,083391,Abi Samra; Nicholas Camill,25,0,30,5
1649933101019,ECE 180,B00,083392,Abi Samra; Nicholas Camill,22,0,30,8
1649933107046,MATH 10B,A01,084110,Staff,8,0,30,22
1649933107046,MATH 10B,A02,084111,Staff,29,0,30,1
1649933107046,MATH 10B,A03,084112,Staff,28,0,30,2
1649933113070,MATH 10C,A01,083443,Staff,9,0,30,21
1649933113070,MATH 10C,A02,083444,Staff,16,0,30,14
1649933113070,MATH 10C,B01,084114,Staff,25,0,30,5
1649933113070,MATH 10C,B02,084115,Staff,29,0,30,1
1649933119101,MATH 18,A01,084117,Harel; Guershon,27,0,30,3
1649933119101,MATH 18,A02,084119,Harel; Guershon,29,0,30,1
1649933119101,MATH 18,A03,084120,Harel; Guershon,30,0,30,0
1649933119101,MATH 18,A04,084121,Harel; Guershon,29,0,30,1
1649933125128,MATH 20B,A01,084124,Um; Ko Woon,31,0,35,4
1649933125128,MATH 20B,B01,084126,Um; Ko Woon,32,0,35,3
1649933131155,MATH 20C,A01,083446,Hammock; Frances H,17,0,30,13
1649933131155,MATH 20C,A02,083447,Hammock; Frances H,28,0,30,2
1649933131155,MATH 20C,A03,083448,Hammock; Frances H,30,0,30,0
1649933131155,MATH 20C,A04,083449,Hammock; Frances H,30,0,30,0
1649933131155,MATH 20C,B01,083451,Hammock; Frances H,25,0,30,5
1649933131155,MATH 20C,B02,083452,Hammock; Frances H,27,0,30,3
1649933131155,MATH 20C,B03,083453,Hammock; Frances H,26,0,30,4
1649933131155,MATH 20C,B04,083454,Hammock; Frances H,30,0,30,0
1649933137195,MATH 20D,A01,084128,Staff,26,0,30,4
1649933137195,MATH 20D,A02,084129,Staff,30,0,30,0
1649933137195,MATH 20D,A03,084130,Staff,29,0,30,1
1649933137195,MATH 20D,B01,084133,Staff,21,0,30,9
1649933137195,MATH 20D,B02,084134,Staff,27,0,30,3
1649933137195,MATH 20D,B03,084135,Staff,30,0,30,0
1649933143220,MATH 20E,A01,084138,Staff,22,0,30,8
1649933143220,MATH 20E,A02,084139,Staff,22,0,30,8
1649933143220,MATH 20E,A03,084140,Staff,23,0,30,7
1649933143220,MATH 20E,A04,084141,Staff,25,0,30,5
1649933149244,MATH 102,A01,084143,Harel; Guershon,16,0,30,14
1649933149244,MATH 102,A02,084144,Harel; Guershon,22,0,30,8
1649933155269,MATH 103B,A01,083456,Staff,0,8,30,30
1649933155269,MATH 103B,A02,083457,Staff,0,9,30,30
1649933161294,MATH 109,A01,084146,Salehi Golsefidy; Alireza,28,0,30,2
1649933161294,MATH 109,A02,084147,Salehi Golsefidy; Alireza,22,0,30,8
1649933167326,MATH 120A,A01,085445,Eggers; John Dietrich,20,0,35,15
1649933167326,MATH 120A,A02,085446,Eggers; John Dietrich,28,0,35,7
1649933173353,MATH 142B,A01,084149,Verstraete; Jacques Allan,0,10,30,30
1649933173353,MATH 142B,A02,084150,Verstraete; Jacques Allan,0,9,30,30
1649933179377,MATH 170A,A01,083459,Nie; Jiawang,0,2,30,30
1649933179377,MATH 170A,A02,083460,Nie; Jiawang,0,0,30,30
1649933179377,MATH 170A,A03,083461,Nie; Jiawang,7,0,30,23
1649933185402,MATH 193B,A01,083463,Staff,3,0,30,27
1649933185402,MATH 193B,A02,083464,Staff,10,0,30,20
1649933185402,MATH 193B,A03,083465,Staff,19,0,30,11
1649933191479,COGS 2,A01,083966,Boyle; Mary E. T.,18,0,30,12
1649933197510,COGS 9,A01,083968,Staff,41,0,60,19
1649933203534,COGS 14B,A01,083970,Staff,28,0,50,22
1649933209567,COGS 17,A01,092679,Staff,67,0,75,8
1649933215596,COGS 100,A01,083972,Staff,9,0,60,51
1649933227650,COGS 101C,A01,083976,Staff,19,0,30,11
1649933233674,COGS 102A,A01,083978,Johnson; Christine M.,17,0,30,13
1649933239699,COGS 107B,A01,083980,Staff,3,0,50,47
1649933245723,COGS 115,A01,083982,Staff,14,0,30,16
1649933251748,COGS 118B,A01,083367,Staff,0,11,40,40
1649933257774,COGS 172,A01,083984,Provenzano; Emily Kara,17,0,30,13
1649933263798,COGS 177,A00,083368,Staff,0,17,30,30
1649933269826,COGS 186,A01,083986,Staff,21,0,40,19
1649933275854,COGS 187A,A01,083988,Boyle; Mary E. T.,24,0,60,36
1649933281885,CSE 8A,A50,084003,Miranda; Gregory Joseph,0,0,15,15
1649933287910,CSE 11,A01,084005,Miranda; Gregory Joseph,22,0,55,33
1649933293937,CSE 20,A01,084007,Staff,9,0,20,11
1649933299961,CSE 21,A01,084009,Staff,10,0,50,40
1649933305986,CSE 30,A01,083370,Cao; Yingjun,0,20,40,40
1649933312011,CSE 100,A01,083372,Cao; Yingjun,0,23,40,40
1649933318036,CSE 101,A01,084011,Staff,0,49,40,40
1649933324061,CSE 141,A01,083374,Eldon; John,0,51,75,75
1649933330089,CSE 141L,A01,083376,Eldon; John,0,56,75,75
1649933336114,CSE 175,A01,084013,Kumar; Rakesh,22,0,25,3
1649933342145,CSE 190,A00,092508,Dubnov; Shlomo,15,0,15,0
1649933348179,ECE 5,A01,084049,Morris; Karcher William,15,0,20,5
1649933354205,ECE 100,A01,084051,Baghdadchi; Saharnaz,1,0,20,19
1649933354205,ECE 100,A02,091916,Baghdadchi; Saharnaz,16,0,20,4
1649933360229,ECE 101,A01,084053,Baghdadchi; Saharnaz,5,0,37,32
1649933360229,ECE 101,A02,084054,Baghdadchi; Saharnaz,33,0,37,4
1649933366258,ECE 107,A01,083390,Staff,28,0,40,12
1649933372383,ECE 148,A01,084056,Silberman; Jack,7,0,12,5
1649933378408,ECE 180,A00,083391,Abi Samra; Nicholas Camill,25,0,30,5
1649933378408,ECE 180,B00,083392,Abi Samra; Nicholas Camill,22,0,30,8
1649933384438,MATH 10B,A01,084110,Staff,8,0,30,22
1649933384438,MATH 10B,A02,084111,Staff,29,0,30,1
1649933384438,MATH 10B,A03,084112,Staff,28,0,30,2
1649933390463,MATH 10C,A01,083443,Staff,9,0,30,21
1649933390463,MATH 10C,A02,083444,Staff,16,0,30,14
1649933390463,MATH 10C,B01,084114,Staff,25,0,30,5
1649933390463,MATH 10C,B02,084115,Staff,29,0,30,1
1649933396489,MATH 18,A01,084117,Harel; Guershon,27,0,30,3
1649933396489,MATH 18,A02,084119,Harel; Guershon,29,0,30,1
1649933396489,MATH 18,A03,084120,Harel; Guershon,30,0,30,0
1649933396489,MATH 18,A04,084121,Harel; Guershon,29,0,30,1
1649933402519,MATH 20B,A01,084124,Um; Ko Woon,31,0,35,4
1649933402519,MATH 20B,B01,084126,Um; Ko Woon,32,0,35,3
1649933408544,MATH 20C,A01,083446,Hammock; Frances H,17,0,30,13
1649933408544,MATH 20C,A02,083447,Hammock; Frances H,28,0,30,2
1649933408544,MATH 20C,A03,083448,Hammock; Frances H,30,0,30,0
1649933408544,MATH 20C,A04,083449,Hammock; Frances H,30,0,30,0
1649933408544,MATH 20C,B01,083451,Hammock; Frances H,25,0,30,5
1649933408544,MATH 20C,B02,083452,Hammock; Frances H,27,0,30,3
1649933408544,MATH 20C,B03,083453,Hammock; Frances H,26,0,30,4
1649933408544,MATH 20C,B04,083454,Hammock; Frances H,30,0,30,0
1649933414569,MATH 20D,A01,084128,Staff,26,0,30,4
1649933414569,MATH 20D,A02,084129,Staff,30,0,30,0
1649933414569,MATH 20D,A03,084130,Staff,29,0,30,1
1649933414569,MATH 20D,B01,084133,Staff,21,0,30,9
1649933414569,MATH 20D,B02,084134,Staff,27,0,30,3
1649933414569,MATH 20D,B03,084135,Staff,30,0,30,0
1649933420598,MATH 20E,A01,084138,Staff,22,0,30,8
1649933420598,MATH 20E,A02,084139,Staff,22,0,30,8
1649933420598,MATH 20E,A03,084140,Staff,23,0,30,7
1649933420598,MATH 20E,A04,084141,Staff,25,0,30,5
1649933426623,MATH 102,A01,084143,Harel; Guershon,16,0,30,14
1649933426623,MATH 102,A02,084144,Harel; Guershon,22,0,30,8
1649933432651,MATH 103B,A01,083456,Staff,0,8,30,30
1649933432651,MATH 103B,A02,083457,Staff,0,9,30,30
1649933438683,MATH 109,A01,084146,Salehi Golsefidy; Alireza,28,0,30,2
1649933438683,MATH 109,A02,084147,Salehi Golsefidy; Alireza,22,0,30,8
1649933444709,MATH 120A,A01,085445,Eggers; John Dietrich,20,0,35,15
1649933444709,MATH 120A,A02,085446,Eggers; John Dietrich,28,0,35,7
1649933450737,MATH 142B,A01,084149,Verstraete; Jacques Allan,0,10,30,30
1649933450737,MATH 142B,A02,084150,Verstraete; Jacques Allan,0,9,30,30
1649933456764,MATH 170A,A01,083459,Nie; Jiawang,0,2,30,30
1649933456764,MATH 170A,A02,083460,Nie; Jiawang,0,0,30,30
1649933456764,MATH 170A,A03,083461,Nie; Jiawang,7,0,30,23
1649933462793,MATH 193B,A01,083463,Staff,3,0,30,27
1649933462793,MATH 193B,A02,083464,Staff,10,0,30,20
1649933462793,MATH 193B,A03,083465,Staff,19,0,30,11
1649933468868,COGS 2,A01,083966,Boyle; Mary E. T.,18,0,30,12
1649933474891,COGS 9,A01,083968,Staff,41,0,60,19
1649933480916,COGS 14B,A01,083970,Staff,28,0,50,22
1649933486940,COGS 17,A01,092679,Staff,67,0,75,8
1649933492968,COGS 100,A01,083972,Staff,9,0,60,51
1649933505023,COGS 101C,A01,083976,Staff,19,0,30,11
1649933511046,COGS 102A,A01,083978,Johnson; Christine M.,17,0,30,13
1649933517069,COGS 107B,A01,083980,Staff,3,0,50,47
1649933523091,COGS 115,A01,083982,Staff,14,0,30,16
1649933529117,COGS 118B,A01,083367,Staff,0,11,40,40
1649933535149,COGS 172,A01,083984,Provenzano; Emily Kara,17,0,30,13
1649933541172,COGS 177,A00,083368,Staff,0,17,30,30
1649933547199,COGS 186,A01,083986,Staff,21,0,40,19
1649933553225,COGS 187A,A01,083988,Boyle; Mary E. T.,24,0,60,36
1649933559257,CSE 8A,A50,084003,Miranda; Gregory Joseph,0,0,15,15
1649933565282,CSE 11,A01,084005,Miranda; Gregory Joseph,22,0,55,33
1649933571306,CSE 20,A01,084007,Staff,9,0,20,11
1649933577330,CSE 21,A01,084009,Staff,10,0,50,40
1649933583353,CSE 30,A01,083370,Cao; Yingjun,0,20,40,40
1649933589376,CSE 100,A01,083372,Cao; Yingjun,0,23,40,40
1649933595403,CSE 101,A01,084011,Staff,0,49,40,40
1649933601428,CSE 141,A01,083374,Eldon; John,0,51,75,75
1649933607457,CSE 141L,A01,083376,Eldon; John,0,56,75,75
1649933613489,CSE 175,A01,084013,Kumar; Rakesh,22,0,25,3
1649933619518,CSE 190,A00,092508,Dubnov; Shlomo,15,0,15,0
1649933625545,ECE 5,A01,084049,Morris; Karcher William,15,0,20,5
1649933631577,ECE 100,A01,084051,Baghdadchi; Saharnaz,1,0,20,19
1649933631577,ECE 100,A02,091916,Baghdadchi; Saharnaz,16,0,20,4
1649933637606,ECE 101,A01,084053,Baghdadchi; Saharnaz,5,0,37,32
1649933637606,ECE 101,A02,084054,Baghdadchi; Saharnaz,33,0,37,4
1649933643632,ECE 107,A01,083390,Staff,28,0,40,12
1649933649663,ECE 148,A01,084056,Silberman; Jack,7,0,12,5
1649933655687,ECE 180,A00,083391,Abi Samra; Nicholas Camill,25,0,30,5
1649933655687,ECE 180,B00,083392,Abi Samra; Nicholas Camill,22,0,30,8
1649933661718,MATH 10B,A01,084110,Staff,8,0,30,22
1649933661718,MATH 10B,A02,084111,Staff,29,0,30,1
1649933661718,MATH 10B,A03,084112,Staff,28,0,30,2
1649933667742,MATH 10C,A01,083443,Staff,9,0,30,21
1649933667742,MATH 10C,A02,083444,Staff,16,0,30,14
1649933667742,MATH 10C,B01,084114,Staff,25,0,30,5
1649933667742,MATH 10C,B02,084115,Staff,29,0,30,1
1649933673777,MATH 18,A01,084117,Harel; Guershon,27,0,30,3
1649933673777,MATH 18,A02,084119,Harel; Guershon,29,0,30,1
1649933673777,MATH 18,A03,084120,Harel; Guershon,30,0,30,0
1649933673777,MATH 18,A04,084121,Harel; Guershon,29,0,30,1
1649933679807,MATH 20B,A01,084124,Um; Ko Woon,31,0,35,4
1649933679807,MATH 20B,B01,084126,Um; Ko Woon,32,0,35,3
1649933685832,MATH 20C,A01,083446,Hammock; Frances H,17,0,30,13
1649933685832,MATH 20C,A02,083447,Hammock; Frances H,28,0,30,2
1649933685832,MATH 20C,A03,083448,Hammock; Frances H,30,0,30,0
1649933685832,MATH 20C,A04,083449,Hammock; Frances H,30,0,30,0
1649933685832,MATH 20C,B01,083451,Hammock; Frances H,25,0,30,5
1649933685832,MATH 20C,B02,083452,Hammock; Frances H,27,0,30,3
1649933685832,MATH 20C,B03,083453,Hammock; Frances H,26,0,30,4
1649933685832,MATH 20C,B04,083454,Hammock; Frances H,30,0,30,0
1649933691858,MATH 20D,A01,084128,Staff,26,0,30,4
1649933691858,MATH 20D,A02,084129,Staff,30,0,30,0
1649933691858,MATH 20D,A03,084130,Staff,29,0,30,1
1649933691858,MATH 20D,B01,084133,Staff,21,0,30,9
1649933691858,MATH 20D,B02,084134,Staff,27,0,30,3
1649933691858,MATH 20D,B03,084135,Staff,30,0,30,0
1649933697901,MATH 20E,A01,084138,Staff,22,0,30,8
1649933697901,MATH 20E,A02,084139,Staff,22,0,30,8
1649933697901,MATH 20E,A03,084140,Staff,23,0,30,7
1649933697901,MATH 20E,A04,084141,Staff,25,0,30,5
1649933703927,MATH 102,A01,084143,Harel; Guershon,16,0,30,14
1649933703927,MATH 102,A02,084144,Harel; Guershon,22,0,30,8
1649933709968,MATH 103B,A01,083456,Staff,0,8,30,30
1649933709968,MATH 103B,A02,083457,Staff,0,9,30,30
1649933715999,MATH 109,A01,084146,Salehi Golsefidy; Alireza,28,0,30,2
1649933715999,MATH 109,A02,084147,Salehi Golsefidy; Alireza,22,0,30,8
1649933722025,MATH 120A,A01,085445,Eggers; John Dietrich,20,0,35,15
1649933722025,MATH 120A,A02,085446,Eggers; John Dietrich,28,0,35,7
1649933728051,MATH 142B,A01,084149,Verstraete; Jacques Allan,0,10,30,30
1649933728051,MATH 142B,A02,084150,Verstraete; Jacques Allan,0,9,30,30
1649933734077,MATH 170A,A01,083459,Nie; Jiawang,0,2,30,30
1649933734077,MATH 170A,A02,083460,Nie; Jiawang,0,0,30,30
1649933734077,MATH 170A,A03,083461,Nie; Jiawang,7,0,30,23
1649933740102,MATH 193B,A01,083463,Staff,3,0,30,27
1649933740102,MATH 193B,A02,083464,Staff,10,0,30,20
1649933740102,MATH 193B,A03,083465,Staff,19,0,30,11
1649933746165,COGS 2,A01,083966,Boyle; Mary E. T.,18,0,30,12
1649933752194,COGS 9,A01,083968,Staff,41,0,60,19
1649933758218,COGS 14B,A01,083970,Staff,28,0,50,22
1649933764249,COGS 17,A01,092679,Staff,67,0,75,8
1649933770273,COGS 100,A01,083972,Staff,9,0,60,51
1649933782330,COGS 101C,A01,083976,Staff,19,0,30,11
1649933788359,COGS 102A,A01,083978,Johnson; Christine M.,17,0,30,13
1649933794384,COGS 107B,A01,083980,Staff,3,0,50,47
1649933800407,COGS 115,A01,083982,Staff,14,0,30,16
1649933806435,COGS 118B,A01,083367,Staff,0,11,40,40
1649933812461,COGS 172,A01,083984,Provenzano; Emily Kara,17,0,30,13
1649933818484,COGS 177,A00,083368,Staff,0,17,30,30
1649933824512,COGS 186,A01,083986,Staff,21,0,40,19
1649933830537,COGS 187A,A01,083988,Boyle; Mary E. T.,24,0,60,36
1649933836563,CSE 8A,A50,084003,Miranda; Gregory Joseph,0,0,15,15
1649933842585,CSE 11,A01,084005,Miranda; Gregory Joseph,22,0,55,33
1649933848612,CSE 20,A01,084007,Staff,9,0,20,11
1649933854641,CSE 21,A01,084009,Staff,10,0,50,40
1649933860667,CSE 30,A01,083370,Cao; Yingjun,0,20,40,40
1649933866695,CSE 100,A01,083372,Cao; Yingjun,0,23,40,40
1649933872725,CSE 101,A01,084011,Staff,0,49,40,40
1649933878759,CSE 141,A01,083374,Eldon; John,0,51,75,75
1649933884787,CSE 141L,A01,083376,Eldon; John,0,56,75,75
1649933890811,CSE 175,A01,084013,Kumar; Rakesh,22,0,25,3
1649933896836,CSE 190,A00,092508,Dubnov; Shlomo,15,0,15,0
1649933902866,ECE 5,A01,084049,Morris; Karcher William,15,0,20,5
1649933908890,ECE 100,A01,084051,Baghdadchi; Saharnaz,1,0,20,19
1649933908890,ECE 100,A02,091916,Baghdadchi; Saharnaz,16,0,20,4
1649933914917,ECE 101,A01,084053,Baghdadchi; Saharnaz,5,0,37,32
1649933914917,ECE 101,A02,084054,Baghdadchi; Saharnaz,33,0,37,4
1649933920944,ECE 107,A01,083390,Staff,28,0,40,12
1649933926968,ECE 148,A01,084056,Silberman; Jack,7,0,12,5
1649933932994,ECE 180,A00,083391,Abi Samra; Nicholas Camill,25,0,30,5
1649933932994,ECE 180,B00,083392,Abi Samra; Nicholas Camill,22,0,30,8
1649933939020,MATH 10B,A01,084110,Staff,8,0,30,22
1649933939020,MATH 10B,A02,084111,Staff,29,0,30,1
1649933939020,MATH 10B,A03,084112,Staff,28,0,30,2
1649933945051,MATH 10C,A01,083443,Staff,9,0,30,21
1649933945051,MATH 10C,A02,083444,Staff,16,0,30,14
1649933945051,MATH 10C,B01,084114,Staff,25,0,30,5
1649933945051,MATH 10C,B02,084115,Staff,29,0,30,1
1649933951077,MATH 18,A01,084117,Harel; Guershon,27,0,30,3
1649933951077,MATH 18,A02,084119,Harel; Guershon,29,0,30,1
1649933951077,MATH 18,A03,084120,Harel; Guershon,30,0,30,0
1649933951077,MATH 18,A04,084121,Harel; Guershon,29,0,30,1
1649933957103,MATH 20B,A01,084124,Um; Ko Woon,31,0,35,4
1649933957103,MATH 20B,B01,084126,Um; Ko Woon,32,0,35,3
1649933963133,MATH 20C,A01,083446,Hammock; Frances H,17,0,30,13
1649933963133,MATH 20C,A02,083447,Hammock; Frances H,28,0,30,2
1649933963133,MATH 20C,A03,083448,Hammock; Frances H,30,0,30,0
1649933963133,MATH 20C,A04,083449,Hammock; Frances H,30,0,30,0
1649933963133,MATH 20C,B01,083451,Hammock; Frances H,25,0,30,5
1649933963133,MATH 20C,B02,083452,Hammock; Frances H,27,0,30,3
1649933963133,MATH 20C,B03,083453,Hammock; Frances H,26,0,30,4
1649933963133,MATH 20C,B04,083454,Hammock; Frances H,30,0,30,0
1649933969253,MATH 20D,A01,084128,Staff,26,0,30,4
1649933969253,MATH 20D,A02,084129,Staff,30,0,30,0
1649933969253,MATH 20D,A03,084130,Staff,29,0,30,1
1649933969253,MATH 20D,B01,084133,Staff,21,0,30,9
1649933969253,MATH 20D,B02,084134,Staff,27,0,30,3
1649933969253,MATH 20D,B03,084135,Staff,30,0,30,0
1649933975278,MATH 20E,A01,084138,Staff,22,0,30,8
1649933975278,MATH 20E,A02,084139,Staff,22,0,30,8
1649933975278,MATH 20E,A03,084140,Staff,23,0,30,7
1649933975278,MATH 20E,A04,084141,Staff,25,0,30,5
1649933981307,MATH 102,A01,084143,Harel; Guershon,16,0,30,14
1649933981307,MATH 102,A02,084144,Harel; Guershon,22,0,30,8
1649933987331,MATH 103B,A01,083456,Staff,0,8,30,30
1649933987331,MATH 103B,A02,083457,Staff,0,9,30,30
1649933993358,MATH 109,A01,084146,Salehi Golsefidy; Alireza,28,0,30,2
1649933993358,MATH 109,A02,084147,Salehi Golsefidy; Alireza,22,0,30,8
1649933999383,MATH 120A,A01,085445,Eggers; John Dietrich,20,0,35,15
1649933999383,MATH 120A,A02,085446,Eggers; John Dietrich,28,0,35,7
1649934005407,MATH 142B,A01,084149,Verstraete; Jacques Allan,0,10,30,30
1649934005407,MATH 142B,A02,084150,Verstraete; Jacques Allan,0,9,30,30
1649934011438,MATH 170A,A01,083459,Nie; Jiawang,0,2,30,30
1649934011438,MATH 170A,A02,083460,Nie; Jiawang,0,0,30,30
1649934011438,MATH 170A,A03,083461,Nie; Jiawang,7,0,30,23
1649934017466,MATH 193B,A01,083463,Staff,3,0,30,27
1649934017466,MATH 193B,A02,083464,Staff,10,0,30,20
1649934017466,MATH 193B,A03,083465,Staff,19,0,30,11
1649934023529,COGS 2,A01,083966,Boyle; Mary E. T.,18,0,30,12
1649934029557,COGS 9,A01,083968,Staff,41,0,60,19
1649934035580,COGS 14B,A01,083970,Staff,28,0,50,22
1649934041603,COGS 17,A01,092679,Staff,67,0,75,8
1649934047626,COGS 100,A01,083972,Staff,9,0,60,51
1649934059677,COGS 101C,A01,083976,Staff,19,0,30,11
1649934065710,COGS 102A,A01,083978,Johnson; Christine M.,17,0,30,13
1649934071735,COGS 107B,A01,083980,Staff,3,0,50,47
1649934077758,COGS 115,A01,083982,Staff,14,0,30,16
1649934083787,COGS 118B,A01,083367,Staff,0,11,40,40
1649934089817,COGS 172,A01,083984,Provenzano; Emily Kara,17,0,30,13
1649934095842,COGS 177,A00,083368,Staff,0,17,30,30
1649934101869,COGS 186,A01,083986,Staff,21,0,40,19
1649934107894,COGS 187A,A01,083988,Boyle; Mary E. T.,24,0,60,36
1649934113920,CSE 8A,A50,084003,Miranda; Gregory Joseph,0,0,15,15
1649934119944,CSE 11,A01,084005,Miranda; Gregory Joseph,22,0,55,33
1649934125969,CSE 20,A01,084007,Staff,9,0,20,11
1649934131993,CSE 21,A01,084009,Staff,10,0,50,40
1649934138019,CSE 30,A01,083370,Cao; Yingjun,0,20,40,40
1649934144042,CSE 100,A01,083372,Cao; Yingjun,0,23,40,40
1649934150071,CSE 101,A01,084011,Staff,0,49,40,40
1649934156099,CSE 141,A01,083374,Eldon; John,0,51,75,75
1649934162121,CSE 141L,A01,083376,Eldon; John,0,56,75,75
1649934168149,CSE 175,A01,084013,Kumar; Rakesh,22,0,25,3
1649934174192,CSE 190,A00,092508,Dubnov; Shlomo,15,0,15,0
1649934180218,ECE 5,A01,084049,Morris; Karcher William,15,0,20,5
1649934186242,ECE 100,A01,084051,Baghdadchi; Saharnaz,1,0,20,19
1649934186242,ECE 100,A02,091916,Baghdadchi; Saharnaz,16,0,20,4
1649934192270,ECE 101,A01,084053,Baghdadchi; Saharnaz,5,0,37,32
1649934192270,ECE 101,A02,084054,Baghdadchi; Saharnaz,33,0,37,4
1649934198300,ECE 107,A01,083390,Staff,28,0,40,12
1649934204322,ECE 148,A01,084056,Silberman; Jack,7,0,12,5
1649934210350,ECE 180,A00,083391,Abi Samra; Nicholas Camill,25,0,30,5
1649934210350,ECE 180,B00,083392,Abi Samra; Nicholas Camill,22,0,30,8
1649934216374,MATH 10B,A01,084110,Staff,8,0,30,22
1649934216374,MATH 10B,A02,084111,Staff,29,0,30,1
1649934216374,MATH 10B,A03,084112,Staff,28,0,30,2
1649934222404,MATH 10C,A01,083443,Staff,9,0,30,21
1649934222404,MATH 10C,A02,083444,Staff,16,0,30,14
1649934222404,MATH 10C,B01,084114,Staff,25,0,30,5
1649934222404,MATH 10C,B02,084115,Staff,29,0,30,1
1649934228429,MATH 18,A01,084117,Harel; Guershon,27,0,30,3
1649934228429,MATH 18,A02,084119,Harel; Guershon,29,0,30,1
1649934228429,MATH 18,A03,084120,Harel; Guershon,30,0,30,0
1649934228429,MATH 18,A04,084121,Harel; Guershon,29,0,30,1
1649934234453,MATH 20B,A01,084124,Um; Ko Woon,31,0,35,4
1649934234453,MATH 20B,B01,084126,Um; Ko Woon,32,0,35,3
1649934240487,MATH 20C,A01,083446,Hammock; Frances H,17,0,30,13
1649934240487,MATH 20C,A02,083447,Hammock; Frances H,28,0,30,2
1649934240487,MATH 20C,A03,083448,Hammock; Frances H,30,0,30,0
1649934240487,MATH 20C,A04,083449,Hammock; Frances H,30,0,30,0
1649934240487,MATH 20C,B01,083451,Hammock; Frances H,25,0,30,5
1649934240487,MATH 20C,B02,083452,Hammock; Frances H,27,0,30,3
1649934240487,MATH 20C,B03,083453,Hammock; Frances H,26,0,30,4
1649934240487,MATH 20C,B04,083454,Hammock; Frances H,30,0,30,0
1649934246521,MATH 20D,A01,084128,Staff,26,0,30,4
1649934246521,MATH 20D,A02,084129,Staff,30,0,30,0
1649934246521,MATH 20D,A03,084130,Staff,29,0,30,1
1649934246521,MATH 20D,B01,084133,Staff,21,0,30,9
1649934246521,MATH 20D,B02,084134,Staff,27,0,30,3
1649934246521,MATH 20D,B03,084135,Staff,30,0,30,0
1649934252550,MATH 20E,A01,084138,Staff,22,0,30,8
1649934252550,MATH 20E,A02,084139,Staff,22,0,30,8
1649934252550,MATH 20E,A03,084140,Staff,23,0,30,7
1649934252550,MATH 20E,A04,084141,Staff,25,0,30,5
1649934258584,MATH 102,A01,084143,Harel; Guershon,16,0,30,14
1649934258584,MATH 102,A02,084144,Harel; Guershon,22,0,30,8
1649934264608,MATH 103B,A01,083456,Staff,0,8,30,30
1649934264608,MATH 103B,A02,083457,Staff,0,9,30,30
1649934270638,MATH 109,A01,084146,Salehi Golsefidy; Alireza,28,0,30,2
1649934270638,MATH 109,A02,084147,Salehi Golsefidy; Alireza,22,0,30,8
1649934276667,MATH 120A,A01,085445,Eggers; John Dietrich,20,0,35,15
1649934276667,MATH 120A,A02,085446,Eggers; John Dietrich,28,0,35,7
1649934282698,MATH 142B,A01,084149,Verstraete; Jacques Allan,0,10,30,30
1649934282698,MATH 142B,A02,084150,Verstraete; Jacques Allan,0,9,30,30
1649934288723,MATH 170A,A01,083459,Nie; Jiawang,0,2,30,30
1649934288723,MATH 170A,A02,083460,Nie; Jiawang,0,0,30,30
1649934288723,MATH 170A,A03,083461,Nie; Jiawang,7,0,30,23
1649934294748,MATH 193B,A01,083463,Staff,3,0,30,27
1649934294748,MATH 193B,A02,083464,Staff,10,0,30,20
1649934294748,MATH 193B,A03,083465,Staff,19,0,30,11
1649934300828,COGS 2,A01,083966,Boyle; Mary E. T.,18,0,30,12
1649934306925,COGS 9,A01,083968,Staff,41,0,60,19
1649934312963,COGS 14B,A01,083970,Staff,28,0,50,22
1649934318987,COGS 17,A01,092679,Staff,67,0,75,8
1649934325012,COGS 100,A01,083972,Staff,9,0,60,51
1649934337060,COGS 101C,A01,083976,Staff,19,0,30,11
1649934343091,COGS 102A,A01,083978,Johnson; Christine M.,17,0,30,13
1649934349118,COGS 107B,A01,083980,Staff,3,0,50,47
1649934355146,COGS 115,A01,083982,Staff,14,0,30,16
1649934361171,COGS 118B,A01,083367,Staff,0,11,40,40
1649934367196,COGS 172,A01,083984,Provenzano; Emily Kara,17,0,30,13
1649934373222,COGS 177,A00,083368,Staff,0,17,30,30
1649934379245,COGS 186,A01,083986,Staff,21,0,40,19
1649934385272,COGS 187A,A01,083988,Boyle; Mary E. T.,24,0,60,36
1649934391304,CSE 8A,A50,084003,Miranda; Gregory Joseph,0,0,15,15
1649934397333,CSE 11,A01,084005,Miranda; Gregory Joseph,22,0,55,33
1649934403359,CSE 20,A01,084007,Staff,9,0,20,11
1649934409384,CSE 21,A01,084009,Staff,10,0,50,40
1649934415418,CSE 30,A01,083370,Cao; Yingjun,0,20,40,40
1649934421443,CSE 100,A01,083372,Cao; Yingjun,0,23,40,40
1649934427467,CSE 101,A01,084011,Staff,0,49,40,40
1649934433491,CSE 141,A01,083374,Eldon; John,0,51,75,75
1649934439519,CSE 141L,A01,083376,Eldon; John,0,56,75,75
1649934445545,CSE 175,A01,084013,Kumar; Rakesh,22,0,25,3
1649934451576,CSE 190,A00,092508,Dubnov; Shlomo,15,0,15,0
1649934457608,ECE 5,A01,084049,Morris; Karcher William,15,0,20,5
1649934463633,ECE 100,A01,084051,Baghdadchi; Saharnaz,1,0,20,19
1649934463633,ECE 100,A02,091916,Baghdadchi; Saharnaz,16,0,20,4
1649934469659,ECE 101,A01,084053,Baghdadchi; Saharnaz,5,0,37,32
1649934469659,ECE 101,A02,084054,Baghdadchi; Saharnaz,33,0,37,4
1649934475689,ECE 107,A01,083390,Staff,28,0,40,12
1649934481717,ECE 148,A01,084056,Silberman; Jack,7,0,12,5
1649934487748,ECE 180,A00,083391,Abi Samra; Nicholas Camill,25,0,30,5
1649934487748,ECE 180,B00,083392,Abi Samra; Nicholas Camill,22,0,30,8
1649934493786,MATH 10B,A01,084110,Staff,8,0,30,22
1649934493786,MATH 10B,A02,084111,Staff,29,0,30,1
1649934493786,MATH 10B,A03,084112,Staff,28,0,30,2
1649934499823,MATH 10C,A01,083443,Staff,9,0,30,21
1649934499823,MATH 10C,A02,083444,Staff,16,0,30,14
1649934499823,MATH 10C,B01,084114,Staff,25,0,30,5
1649934499823,MATH 10C,B02,084115,Staff,29,0,30,1
1649934505853,MATH 18,A01,084117,Harel; Guershon,27,0,30,3
1649934505853,MATH 18,A02,084119,Harel; Guershon,29,0,30,1
1649934505853,MATH 18,A03,084120,Harel; Guershon,30,0,30,0
1649934505853,MATH 18,A04,084121,Harel; Guershon,29,0,30,1
1649934511885,MATH 20B,A01,084124,Um; Ko Woon,31,0,35,4
1649934511885,MATH 20B,B01,084126,Um; Ko Woon,32,0,35,3
1649934517912,MATH 20C,A01,083446,Hammock; Frances H,17,0,30,13
1649934517912,MATH 20C,A02,083447,Hammock; Frances H,28,0,30,2
1649934517912,MATH 20C,A03,083448,Hammock; Frances H,30,0,30,0
1649934517912,MATH 20C,A04,083449,Hammock; Frances H,30,0,30,0
1649934517912,MATH 20C,B01,083451,Hammock; Frances H,25,0,30,5
1649934517912,MATH 20C,B02,083452,Hammock; Frances H,27,0,30,3
1649934517912,MATH 20C,B03,083453,Hammock; Frances H,26,0,30,4
1649934517912,MATH 20C,B04,083454,Hammock; Frances H,30,0,30,0
1649934523946,MATH 20D,A01,084128,Staff,26,0,30,4
1649934523946,MATH 20D,A02,084129,Staff,30,0,30,0
1649934523946,MATH 20D,A03,084130,Staff,29,0,30,1
1649934523946,MATH 20D,B01,084133,Staff,21,0,30,9
1649934523946,MATH 20D,B02,084134,Staff,27,0,30,3
1649934523946,MATH 20D,B03,084135,Staff,30,0,30,0
1649934529973,MATH 20E,A01,084138,Staff,22,0,30,8
1649934529973,MATH 20E,A02,084139,Staff,22,0,30,8
1649934529973,MATH 20E,A03,084140,Staff,23,0,30,7
1649934529973,MATH 20E,A04,084141,Staff,25,0,30,5
1649934536010,MATH 102,A01,084143,Harel; Guershon,16,0,30,14
1649934536010,MATH 102,A02,084144,Harel; Guershon,22,0,30,8
1649934542038,MATH 103B,A01,083456,Staff,0,8,30,30
1649934542038,MATH 103B,A02,083457,Staff,0,9,30,30
1649934548063,MATH 109,A01,084146,Salehi Golsefidy; Alireza,28,0,30,2
1649934548063,MATH 109,A02,084147,Salehi Golsefidy; Alireza,22,0,30,8
1649934554088,MATH 120A,A01,085445,Eggers; John Dietrich,20,0,35,15
1649934554088,MATH 120A,A02,085446,Eggers; John Dietrich,28,0,35,7
1649934560117,MATH 142B,A01,084149,Verstraete; Jacques Allan,0,10,30,30
1649934560117,MATH 142B,A02,084150,Verstraete; Jacques Allan,0,9,30,30
1649934566142,MATH 170A,A01,083459,Nie; Jiawang,0,2,30,30
1649934566142,MATH 170A,A02,083460,Nie; Jiawang,0,0,30,30
1649934566142,MATH 170A,A03,083461,Nie; Jiawang,7,0,30,23
1649934572170,MATH 193B,A01,083463,Staff,3,0,30,27
1649934572170,MATH 193B,A02,083464,Staff,10,0,30,20
1649934572170,MATH 193B,A03,083465,Staff,19,0,30,11
1649934578231,COGS 2,A01,083966,Boyle; Mary E. T.,18,0,30,12
1649934584255,COGS 9,A01,083968,Staff,41,0,60,19
1649934590279,COGS 14B,A01,083970,Staff,28,0,50,22
1649934596307,COGS 17,A01,092679,Staff,67,0,75,8
1649934602332,COGS 100,A01,083972,Staff,9,0,60,51
1649934614396,COGS 101C,A01,083976,Staff,19,0,30,11
1649934620420,COGS 102A,A01,083978,Johnson; Christine M.,17,0,30,13
1649934626444,COGS 107B,A01,083980,Staff,3,0,50,47
1649934632467,COGS 115,A01,083982,Staff,14,0,30,16
1649934638491,COGS 118B,A01,083367,Staff,0,11,40,40
1649934644515,COGS 172,A01,083984,Provenzano; Emily Kara,16,0,30,14
1649934650538,COGS 177,A00,083368,Staff,0,17,30,30
1649934656569,COGS 186,A01,083986,Staff,21,0,40,19
1649934662599,COGS 187A,A01,083988,Boyle; Mary E. T.,24,0,60,36
1649934668639,CSE 8A,A50,084003,Miranda; Gregory Joseph,0,0,15,15
1649934674667,CSE 11,A01,084005,Miranda; Gregory Joseph,22,0,55,33
1649934680692,CSE 20,A01,084007,Staff,9,0,20,11
1649934686717,CSE 21,A01,084009,Staff,10,0,50,40
1649934692747,CSE 30,A01,083370,Cao; Yingjun,0,20,40,40
1649934698774,CSE 100,A01,083372,Cao; Yingjun,0,23,40,40
1649934704823,CSE 101,A01,084011,Staff,0,49,40,40
1649934710852,CSE 141,A01,083374,Eldon; John,0,51,75,75
1649934716875,CSE 141L,A01,083376,Eldon; John,0,56,75,75
1649934722899,CSE 175,A01,084013,Kumar; Rakesh,22,0,25,3
1649934728923,CSE 190,A00,092508,Dubnov; Shlomo,15,0,15,0
1649934734952,ECE 5,A01,084049,Morris; Karcher William,15,0,20,5
1649934740985,ECE 100,A01,084051,Baghdadchi; Saharnaz,1,0,20,19
1649934740985,ECE 100,A02,091916,Baghdadchi; Saharnaz,16,0,20,4
1649934747010,ECE 101,A01,084053,Baghdadchi; Saharnaz,5,0,37,32
1649934747010,ECE 101,A02,084054,Baghdadchi; Saharnaz,33,0,37,4
1649934753036,ECE 107,A01,083390,Staff,28,0,40,12
1649934759061,ECE 148,A01,084056,Silberman; Jack,7,0,12,5
1649934765089,ECE 180,A00,083391,Abi Samra; Nicholas Camill,25,0,30,5
1649934765089,ECE 180,B00,083392,Abi Samra; Nicholas Camill,22,0,30,8
1649934771134,MATH 10B,A01,084110,Staff,8,0,30,22
1649934771134,MATH 10B,A02,084111,Staff,29,0,30,1
1649934771134,MATH 10B,A03,084112,Staff,28,0,30,2
1649934777180,MATH 10C,A01,083443,Staff,9,0,30,21
1649934777180,MATH 10C,A02,083444,Staff,16,0,30,14
1649934777180,MATH 10C,B01,084114,Staff,25,0,30,5
1649934777180,MATH 10C,B02,084115,Staff,29,0,30,1
1649934783204,MATH 18,A01,084117,Harel; Guershon,27,0,30,3
1649934783204,MATH 18,A02,084119,Harel; Guershon,29,0,30,1
1649934783204,MATH 18,A03,084120,Harel; Guershon,30,0,30,0
1649934783204,MATH 18,A04,084121,Harel; Guershon,29,0,30,1
1649934789233,MATH 20B,A01,084124,Um; Ko Woon,31,0,35,4
1649934789233,MATH 20B,B01,084126,Um; Ko Woon,32,0,35,3
1649934795268,MATH 20C,A01,083446,Hammock; Frances H,17,0,30,13
1649934795268,MATH 20C,A02,083447,Hammock; Frances H,28,0,30,2
1649934795268,MATH 20C,A03,083448,Hammock; Frances H,30,0,30,0
1649934795268,MATH 20C,A04,083449,Hammock; Frances H,30,0,30,0
1649934795268,MATH 20C,B01,083451,Hammock; Frances H,25,0,30,5
1649934795268,MATH 20C,B02,083452,Hammock; Frances H,27,0,30,3
1649934795268,MATH 20C,B03,083453,Hammock; Frances H,26,0,30,4
1649934795268,MATH 20C,B04,083454,Hammock; Frances H,30,0,30,0
1649934801293,MATH 20D,A01,084128,Staff,26,0,30,4
1649934801293,MATH 20D,A02,084129,Staff,30,0,30,0
1649934801293,MATH 20D,A03,084130,Staff,29,0,30,1
1649934801293,MATH 20D,B01,084133,Staff,21,0,30,9
1649934801293,MATH 20D,B02,084134,Staff,27,0,30,3
1649934801293,MATH 20D,B03,084135,Staff,30,0,30,0
1649934807326,MATH 20E,A01,084138,Staff,22,0,30,8
1649934807326,MATH 20E,A02,084139,Staff,22,0,30,8
1649934807326,MATH 20E,A03,084140,Staff,23,0,30,7
1649934807326,MATH 20E,A04,084141,Staff,25,0,30,5
1649934813349,MATH 102,A01,084143,Harel; Guershon,16,0,30,14
1649934813349,MATH 102,A02,084144,Harel; Guershon,22,0,30,8
1649934819378,MATH 103B,A01,083456,Staff,0,8,30,30
1649934819378,MATH 103B,A02,083457,Staff,0,9,30,30
1649934825417,MATH 109,A01,084146,Salehi Golsefidy; Alireza,28,0,30,2
1649934825417,MATH 109,A02,084147,Salehi Golsefidy; Alireza,22,0,30,8
1649934831450,MATH 120A,A01,085445,Eggers; John Dietrich,20,0,35,15
1649934831450,MATH 120A,A02,085446,Eggers; John Dietrich,28,0,35,7
1649934837475,MATH 142B,A01,084149,Verstraete; Jacques Allan,0,10,30,30
1649934837475,MATH 142B,A02,084150,Verstraete; Jacques Allan,0,9,30,30
1649934843504,MATH 170A,A01,083459,Nie; Jiawang,0,2,30,30
1649934843504,MATH 170A,A02,083460,Nie; Jiawang,0,0,30,30
1649934843504,MATH 170A,A03,083461,Nie; Jiawang,7,0,30,23
1649934849531,MATH 193B,A01,083463,Staff,3,0,30,27
1649934849531,MATH 193B,A02,083464,Staff,10,0,30,20
1649934849531,MATH 193B,A03,083465,Staff,19,0,30,11
1649934855603,COGS 2,A01,083966,Boyle; Mary E. T.,18,0,30,12
1649934861628,COGS 9,A01,083968,Staff,41,0,60,19
1649934867653,COGS 14B,A01,083970,Staff,28,0,50,22
1649934873677,COGS 17,A01,092679,Staff,67,0,75,8
1649934879701,COGS 100,A01,083972,Staff,9,0,60,51
1649934891759,COGS 101C,A01,083976,Staff,19,0,30,11
1649934897793,COGS 102A,A01,083978,Johnson; Christine M.,17,0,30,13
