time,subj_course_id,sec_code,sec_id,prof,available,waitlist,total,enrolled_ct
1650022082547,COGS 2,A01,083966,Boyle; Mary E. T.,9,0,30,21
1650022088579,COGS 9,A01,083968,Staff,9,0,60,51
1650022094617,COGS 14B,A01,083970,Staff,9,0,50,41
1650022100661,COGS 17,A01,092679,Staff,50,0,75,25
1650022106699,COGS 100,A01,083972,Staff,0,15,60,60
1650022118764,COGS 101C,A01,083976,Staff,12,0,30,18
1650022124800,COGS 102A,A01,083978,Johnson; Christine M.,14,0,30,16
1650022130835,COGS 107B,A01,083980,Staff,0,7,50,50
1650022136869,COGS 115,A01,083982,Staff,10,0,30,20
1650022142899,COGS 118B,A01,083367,Staff,0,15,40,40
1650022148930,COGS 172,A01,083984,Provenzano; Emily Kara,15,0,30,15
1650022154960,COGS 177,A00,083368,Staff,0,20,30,30
1650022160990,COGS 186,A01,083986,Staff,21,0,40,19
1650022167026,COGS 187A,A01,083988,Boyle; Mary E. T.,20,0,60,40
1650022173062,CSE 8A,A50,084003,Miranda; Gregory Joseph,0,13,15,15
1650022179090,CSE 11,A01,084005,Miranda; Gregory Joseph,0,22,55,55
1650022185124,CSE 20,A01,084007,Staff,0,5,20,20
1650022191159,CSE 21,A01,084009,Staff,0,30,50,50
1650022197188,CSE 30,A01,083370,Cao; Yingjun,0,65,40,40
1650022203214,CSE 100,A01,083372,Cao; Yingjun,0,46,40,40
1650022209245,CSE 101,A01,084011,Staff,0,54,40,40
1650022215273,CSE 141,A01,083374,Eldon; John,0,64,75,75
1650022221306,CSE 141L,A01,083376,Eldon; John,0,70,75,75
1650022227341,CSE 175,A01,084013,Kumar; Rakesh,22,0,25,3
1650022233372,CSE 190,A00,092508,Dubnov; Shlomo,20,0,20,0
1650022239402,ECE 5,A01,084049,Morris; Karcher William,13,0,20,7
1650022245433,ECE 100,A01,084051,Baghdadchi; Saharnaz,0,0,20,20
1650022245433,ECE 100,A02,091916,Baghdadchi; Saharnaz,13,0,20,7
1650022251464,ECE 101,A01,084053,Baghdadchi; Saharnaz,0,0,37,37
1650022251464,ECE 101,A02,084054,Baghdadchi; Saharnaz,30,0,37,7
1650022257496,ECE 107,A01,083390,Staff,26,0,40,14
1650022263528,ECE 148,A01,084056,Silberman; Jack,8,0,12,4
1650022269566,ECE 180,A00,083391,Abi Samra; Nicholas Camill,25,0,30,5
1650022269566,ECE 180,B00,083392,Abi Samra; Nicholas Camill,21,0,30,9
1650022275595,MATH 10B,A01,084110,Staff,0,0,30,30
1650022275595,MATH 10B,A02,084111,Staff,18,0,30,12
1650022275595,MATH 10B,A03,084112,Staff,24,0,30,6
1650022281628,MATH 10C,A01,083443,Staff,0,16,30,30
1650022281628,MATH 10C,A02,083444,Staff,0,15,30,30
1650022281628,MATH 10C,B01,084114,Staff,19,0,30,11
1650022281628,MATH 10C,B02,084115,Staff,25,0,30,5
1650022287665,MATH 18,A01,084117,Harel; Guershon,14,0,30,16
1650022287665,MATH 18,A02,084119,Harel; Guershon,28,0,30,2
1650022287665,MATH 18,A03,084120,Harel; Guershon,29,0,30,1
1650022287665,MATH 18,A04,084121,Harel; Guershon,29,0,30,1
1650022293705,MATH 20B,A01,084124,Um; Ko Woon,16,0,35,19
1650022293705,MATH 20B,B01,084126,Um; Ko Woon,24,0,35,11
1650022299737,MATH 20C,A01,083446,Hammock; Frances H,0,0,30,30
1650022299737,MATH 20C,A02,083447,Hammock; Frances H,16,0,30,14
1650022299737,MATH 20C,A03,083448,Hammock; Frances H,19,0,30,11
1650022299737,MATH 20C,A04,083449,Hammock; Frances H,20,0,30,10
1650022299737,MATH 20C,B01,083451,Hammock; Frances H,0,0,30,30
1650022299737,MATH 20C,B02,083452,Hammock; Frances H,19,0,30,11
1650022299737,MATH 20C,B03,083453,Hammock; Frances H,21,0,30,9
1650022299737,MATH 20C,B04,083454,Hammock; Frances H,23,0,30,7
1650022305774,MATH 20D,A01,084128,Staff,14,0,30,16
1650022305774,MATH 20D,A02,084129,Staff,29,0,30,1
1650022305774,MATH 20D,A03,084130,Staff,27,0,30,3
1650022305774,MATH 20D,B01,084133,Staff,3,0,30,27
1650022305774,MATH 20D,B02,084134,Staff,24,0,30,6
1650022305774,MATH 20D,B03,084135,Staff,28,0,30,2
1650022311803,MATH 20E,A01,084138,Staff,14,0,30,16
1650022311803,MATH 20E,A02,084139,Staff,6,0,30,24
1650022311803,MATH 20E,A03,084140,Staff,15,0,30,15
1650022311803,MATH 20E,A04,084141,Staff,20,0,30,10
1650022317834,MATH 102,A01,084143,Harel; Guershon,12,0,30,18
1650022317834,MATH 102,A02,084144,Harel; Guershon,19,0,30,11
1650022323873,MATH 103B,A01,083456,Staff,0,13,30,30
1650022323873,MATH 103B,A02,083457,Staff,0,13,30,30
1650022329904,MATH 109,A01,084146,Salehi Golsefidy; Alireza,18,0,30,12
1650022329904,MATH 109,A02,084147,Salehi Golsefidy; Alireza,15,0,30,15
1650022335942,MATH 120A,A01,085445,Eggers; John Dietrich,10,0,35,25
1650022335942,MATH 120A,A02,085446,Eggers; John Dietrich,27,0,35,8
1650022341979,MATH 142B,A01,084149,Verstraete; Jacques Allan,0,12,30,30
1650022341979,MATH 142B,A02,084150,Verstraete; Jacques Allan,0,12,30,30
1650022348023,MATH 170A,A01,083459,Nie; Jiawang,0,9,30,30
1650022348023,MATH 170A,A02,083460,Nie; Jiawang,0,8,30,30
1650022348023,MATH 170A,A03,083461,Nie; Jiawang,0,9,30,30
1650022354062,MATH 193B,A01,083463,Staff,1,0,30,29
1650022354062,MATH 193B,A02,083464,Staff,9,0,30,21
1650022354062,MATH 193B,A03,083465,Staff,18,0,30,12
1650022360168,COGS 2,A01,083966,Boyle; Mary E. T.,9,0,30,21
1650022366201,COGS 9,A01,083968,Staff,9,0,60,51
1650022372231,COGS 14B,A01,083970,Staff,9,0,50,41
1650022378264,COGS 17,A01,092679,Staff,50,0,75,25
1650022384298,COGS 100,A01,083972,Staff,0,15,60,60
1650022396363,COGS 101C,A01,083976,Staff,12,0,30,18
1650022402396,COGS 102A,A01,083978,Johnson; Christine M.,14,0,30,16
1650022408424,COGS 107B,A01,083980,Staff,0,7,50,50
1650022414457,COGS 115,A01,083982,Staff,10,0,30,20
1650022420490,COGS 118B,A01,083367,Staff,0,15,40,40
1650022426519,COGS 172,A01,083984,Provenzano; Emily Kara,15,0,30,15
1650022432547,COGS 177,A00,083368,Staff,0,20,30,30
1650022438582,COGS 186,A01,083986,Staff,21,0,40,19
1650022444628,COGS 187A,A01,083988,Boyle; Mary E. T.,20,0,60,40
1650022450666,CSE 8A,A50,084003,Miranda; Gregory Joseph,0,13,15,15
1650022456695,CSE 11,A01,084005,Miranda; Gregory Joseph,0,22,55,55
1650022462728,CSE 20,A01,084007,Staff,0,5,20,20
1650022468763,CSE 21,A01,084009,Staff,0,30,50,50
1650022474797,CSE 30,A01,083370,Cao; Yingjun,0,65,40,40
1650022480826,CSE 100,A01,083372,Cao; Yingjun,0,46,40,40
1650022486855,CSE 101,A01,084011,Staff,0,54,40,40
1650022492896,CSE 141,A01,083374,Eldon; John,0,64,75,75
1650022498932,CSE 141L,A01,083376,Eldon; John,0,70,75,75
1650022504964,CSE 175,A01,084013,Kumar; Rakesh,22,0,25,3
1650022511006,CSE 190,A00,092508,Dubnov; Shlomo,20,0,20,0
1650022517039,ECE 5,A01,084049,Morris; Karcher William,13,0,20,7
1650022523080,ECE 100,A01,084051,Baghdadchi; Saharnaz,0,0,20,20
1650022523080,ECE 100,A02,091916,Baghdadchi; Saharnaz,13,0,20,7
1650022529112,ECE 101,A01,084053,Baghdadchi; Saharnaz,0,0,37,37
1650022529112,ECE 101,A02,084054,Baghdadchi; Saharnaz,30,0,37,7
1650022535144,ECE 107,A01,083390,Staff,26,0,40,14
1650022541179,ECE 148,A01,084056,Silberman; Jack,8,0,12,4
1650022547211,ECE 180,A00,083391,Abi Samra; Nicholas Camill,25,0,30,5
1650022547211,ECE 180,B00,083392,Abi Samra; Nicholas Camill,21,0,30,9
1650022553248,MATH 10B,A01,084110,Staff,0,0,30,30
1650022553248,MATH 10B,A02,084111,Staff,18,0,30,12
1650022553248,MATH 10B,A03,084112,Staff,24,0,30,6
1650022559282,MATH 10C,A01,083443,Staff,0,16,30,30
1650022559282,MATH 10C,A02,083444,Staff,0,15,30,30
1650022559282,MATH 10C,B01,084114,Staff,19,0,30,11
1650022559282,MATH 10C,B02,084115,Staff,25,0,30,5
1650022565313,MATH 18,A01,084117,Harel; Guershon,14,0,30,16
1650022565313,MATH 18,A02,084119,Harel; Guershon,28,0,30,2
1650022565313,MATH 18,A03,084120,Harel; Guershon,29,0,30,1
1650022565313,MATH 18,A04,084121,Harel; Guershon,29,0,30,1
1650022571343,MATH 20B,A01,084124,Um; Ko Woon,16,0,35,19
1650022571343,MATH 20B,B01,084126,Um; Ko Woon,24,0,35,11
1650022577376,MATH 20C,A01,083446,Hammock; Frances H,0,0,30,30
1650022577376,MATH 20C,A02,083447,Hammock; Frances H,16,0,30,14
1650022577376,MATH 20C,A03,083448,Hammock; Frances H,19,0,30,11
1650022577376,MATH 20C,A04,083449,Hammock; Frances H,20,0,30,10
1650022577376,MATH 20C,B01,083451,Hammock; Frances H,0,0,30,30
1650022577376,MATH 20C,B02,083452,Hammock; Frances H,19,0,30,11
1650022577376,MATH 20C,B03,083453,Hammock; Frances H,21,0,30,9
1650022577376,MATH 20C,B04,083454,Hammock; Frances H,23,0,30,7
1650022583413,MATH 20D,A01,084128,Staff,14,0,30,16
1650022583413,MATH 20D,A02,084129,Staff,29,0,30,1
1650022583413,MATH 20D,A03,084130,Staff,27,0,30,3
1650022583413,MATH 20D,B01,084133,Staff,3,0,30,27
1650022583413,MATH 20D,B02,084134,Staff,24,0,30,6
1650022583413,MATH 20D,B03,084135,Staff,28,0,30,2
1650022589446,MATH 20E,A01,084138,Staff,14,0,30,16
1650022589446,MATH 20E,A02,084139,Staff,6,0,30,24
1650022589446,MATH 20E,A03,084140,Staff,15,0,30,15
1650022589446,MATH 20E,A04,084141,Staff,20,0,30,10
1650022595476,MATH 102,A01,084143,Harel; Guershon,12,0,30,18
1650022595476,MATH 102,A02,084144,Harel; Guershon,19,0,30,11
1650022601507,MATH 103B,A01,083456,Staff,0,13,30,30
1650022601507,MATH 103B,A02,083457,Staff,0,13,30,30
1650022607538,MATH 109,A01,084146,Salehi Golsefidy; Alireza,18,0,30,12
1650022607538,MATH 109,A02,084147,Salehi Golsefidy; Alireza,15,0,30,15
1650022613569,MATH 120A,A01,085445,Eggers; John Dietrich,10,0,35,25
1650022613569,MATH 120A,A02,085446,Eggers; John Dietrich,27,0,35,8
1650022619608,MATH 142B,A01,084149,Verstraete; Jacques Allan,0,12,30,30
1650022619608,MATH 142B,A02,084150,Verstraete; Jacques Allan,0,12,30,30
1650022625639,MATH 170A,A01,083459,Nie; Jiawang,0,9,30,30
1650022625639,MATH 170A,A02,083460,Nie; Jiawang,0,8,30,30
1650022625639,MATH 170A,A03,083461,Nie; Jiawang,0,9,30,30
1650022631671,MATH 193B,A01,083463,Staff,1,0,30,29
1650022631671,MATH 193B,A02,083464,Staff,9,0,30,21
1650022631671,MATH 193B,A03,083465,Staff,18,0,30,12
1650022637758,COGS 2,A01,083966,Boyle; Mary E. T.,9,0,30,21
1650022643787,COGS 9,A01,083968,Staff,9,0,60,51
1650022649820,COGS 14B,A01,083970,Staff,9,0,50,41
1650022655937,COGS 17,A01,092679,Staff,50,0,75,25
1650022661972,COGS 100,A01,083972,Staff,0,15,60,60
1650022674032,COGS 101C,A01,083976,Staff,12,0,30,18
1650022680068,COGS 102A,A01,083978,Johnson; Christine M.,14,0,30,16
1650022686101,COGS 107B,A01,083980,Staff,0,7,50,50
1650022692130,COGS 115,A01,083982,Staff,10,0,30,20
1650022698159,COGS 118B,A01,083367,Staff,0,15,40,40
1650022704198,COGS 172,A01,083984,Provenzano; Emily Kara,15,0,30,15
1650022710228,COGS 177,A00,083368,Staff,0,20,30,30
1650022716256,COGS 186,A01,083986,Staff,21,0,40,19
1650022722289,COGS 187A,A01,083988,Boyle; Mary E. T.,20,0,60,40
1650022728324,CSE 8A,A50,084003,Miranda; Gregory Joseph,0,13,15,15
1650022734352,CSE 11,A01,084005,Miranda; Gregory Joseph,0,22,55,55
1650022740381,CSE 20,A01,084007,Staff,0,5,20,20
1650022746410,CSE 21,A01,084009,Staff,0,30,50,50
1650022752449,CSE 30,A01,083370,Cao; Yingjun,0,65,40,40
1650022763638,CSE 100,A01,083372,Cao; Yingjun,0,46,40,40
1650022769756,CSE 101,A01,084011,Staff,0,54,40,40
1650022784092,CSE 141,A01,083374,Eldon; John,0,64,75,75
1650022790120,CSE 141L,A01,083376,Eldon; John,0,70,75,75
1650022804236,CSE 175,A01,084013,Kumar; Rakesh,22,0,25,3
1650022810269,CSE 190,A00,092508,Dubnov; Shlomo,20,0,20,0
1650022824460,ECE 5,A01,084049,Morris; Karcher William,13,0,20,7
1650022830493,ECE 100,A01,084051,Baghdadchi; Saharnaz,0,0,20,20
1650022830493,ECE 100,A02,091916,Baghdadchi; Saharnaz,13,0,20,7
1650022845077,ECE 101,A01,084053,Baghdadchi; Saharnaz,0,0,37,37
1650022845077,ECE 101,A02,084054,Baghdadchi; Saharnaz,30,0,37,7
1650022851108,ECE 107,A01,083390,Staff,26,0,40,14
1650022865338,ECE 148,A01,084056,Silberman; Jack,8,0,12,4
1650022871373,ECE 180,A00,083391,Abi Samra; Nicholas Camill,25,0,30,5
1650022871373,ECE 180,B00,083392,Abi Samra; Nicholas Camill,21,0,30,9
1650022878986,MATH 10B,A01,084110,Staff,0,0,30,30
1650022878986,MATH 10B,A02,084111,Staff,18,0,30,12
1650022878986,MATH 10B,A03,084112,Staff,24,0,30,6
1650022885015,MATH 10C,A01,083443,Staff,0,16,30,30
1650022885015,MATH 10C,A02,083444,Staff,0,15,30,30
1650022885015,MATH 10C,B01,084114,Staff,19,0,30,11
1650022885015,MATH 10C,B02,084115,Staff,25,0,30,5
1650022891045,MATH 18,A01,084117,Harel; Guershon,14,0,30,16
1650022891045,MATH 18,A02,084119,Harel; Guershon,28,0,30,2
1650022891045,MATH 18,A03,084120,Harel; Guershon,29,0,30,1
1650022891045,MATH 18,A04,084121,Harel; Guershon,29,0,30,1
1650022897089,MATH 20B,A01,084124,Um; Ko Woon,16,0,35,19
1650022897089,MATH 20B,B01,084126,Um; Ko Woon,24,0,35,11
1650022903120,MATH 20C,A01,083446,Hammock; Frances H,0,0,30,30
1650022903120,MATH 20C,A02,083447,Hammock; Frances H,16,0,30,14
1650022903120,MATH 20C,A03,083448,Hammock; Frances H,19,0,30,11
1650022903120,MATH 20C,A04,083449,Hammock; Frances H,20,0,30,10
1650022903120,MATH 20C,B01,083451,Hammock; Frances H,0,0,30,30
1650022903120,MATH 20C,B02,083452,Hammock; Frances H,19,0,30,11
1650022903120,MATH 20C,B03,083453,Hammock; Frances H,21,0,30,9
1650022903120,MATH 20C,B04,083454,Hammock; Frances H,23,0,30,7
1650022909157,MATH 20D,A01,084128,Staff,14,0,30,16
1650022909157,MATH 20D,A02,084129,Staff,29,0,30,1
1650022909157,MATH 20D,A03,084130,Staff,27,0,30,3
1650022909157,MATH 20D,B01,084133,Staff,3,0,30,27
1650022909157,MATH 20D,B02,084134,Staff,24,0,30,6
1650022909157,MATH 20D,B03,084135,Staff,28,0,30,2
1650022915192,MATH 20E,A01,084138,Staff,14,0,30,16
1650022915192,MATH 20E,A02,084139,Staff,6,0,30,24
1650022915192,MATH 20E,A03,084140,Staff,15,0,30,15
1650022915192,MATH 20E,A04,084141,Staff,20,0,30,10
1650022921225,MATH 102,A01,084143,Harel; Guershon,12,0,30,18
1650022921225,MATH 102,A02,084144,Harel; Guershon,19,0,30,11
1650022927253,MATH 103B,A01,083456,Staff,0,13,30,30
1650022927253,MATH 103B,A02,083457,Staff,0,13,30,30
1650022933287,MATH 109,A01,084146,Salehi Golsefidy; Alireza,18,0,30,12
1650022933287,MATH 109,A02,084147,Salehi Golsefidy; Alireza,15,0,30,15
1650022939325,MATH 120A,A01,085445,Eggers; John Dietrich,10,0,35,25
1650022939325,MATH 120A,A02,085446,Eggers; John Dietrich,27,0,35,8
1650022945356,MATH 142B,A01,084149,Verstraete; Jacques Allan,0,12,30,30
1650022945356,MATH 142B,A02,084150,Verstraete; Jacques Allan,0,12,30,30
1650022951387,MATH 170A,A01,083459,Nie; Jiawang,0,9,30,30
1650022951387,MATH 170A,A02,083460,Nie; Jiawang,0,8,30,30
1650022951387,MATH 170A,A03,083461,Nie; Jiawang,0,9,30,30
1650022957417,MATH 193B,A01,083463,Staff,1,0,30,29
1650022957417,MATH 193B,A02,083464,Staff,9,0,30,21
1650022957417,MATH 193B,A03,083465,Staff,18,0,30,12
1650022963486,COGS 2,A01,083966,Boyle; Mary E. T.,9,0,30,21
1650022969519,COGS 9,A01,083968,Staff,9,0,60,51
1650022975552,COGS 14B,A01,083970,Staff,9,0,50,41
1650022981584,COGS 17,A01,092679,Staff,50,0,75,25
1650022987616,COGS 100,A01,083972,Staff,0,15,60,60
1650022999681,COGS 101C,A01,083976,Staff,12,0,30,18
1650023005711,COGS 102A,A01,083978,Johnson; Christine M.,14,0,30,16
1650023011741,COGS 107B,A01,083980,Staff,0,7,50,50
1650023017773,COGS 115,A01,083982,Staff,10,0,30,20
1650023023801,COGS 118B,A01,083367,Staff,0,15,40,40
1650023029833,COGS 172,A01,083984,Provenzano; Emily Kara,15,0,30,15
1650023035864,COGS 177,A00,083368,Staff,0,20,30,30
1650023041895,COGS 186,A01,083986,Staff,21,0,40,19
1650023047929,COGS 187A,A01,083988,Boyle; Mary E. T.,20,0,60,40
1650023053961,CSE 8A,A50,084003,Miranda; Gregory Joseph,0,13,15,15
1650023059987,CSE 11,A01,084005,Miranda; Gregory Joseph,0,22,55,55
1650023066018,CSE 20,A01,084007,Staff,0,5,20,20
1650023072049,CSE 21,A01,084009,Staff,0,30,50,50
1650023078081,CSE 30,A01,083370,Cao; Yingjun,0,65,40,40
1650023084112,CSE 100,A01,083372,Cao; Yingjun,0,46,40,40
1650023090141,CSE 101,A01,084011,Staff,0,54,40,40
1650023096175,CSE 141,A01,083374,Eldon; John,0,64,75,75
1650023102208,CSE 141L,A01,083376,Eldon; John,0,70,75,75
1650023108239,CSE 175,A01,084013,Kumar; Rakesh,22,0,25,3
1650023114267,CSE 190,A00,092508,Dubnov; Shlomo,20,0,20,0
1650023120304,ECE 5,A01,084049,Morris; Karcher William,13,0,20,7
1650023126336,ECE 100,A01,084051,Baghdadchi; Saharnaz,0,0,20,20
1650023126336,ECE 100,A02,091916,Baghdadchi; Saharnaz,13,0,20,7
1650023132372,ECE 101,A01,084053,Baghdadchi; Saharnaz,0,0,37,37
1650023132372,ECE 101,A02,084054,Baghdadchi; Saharnaz,30,0,37,7
1650023138406,ECE 107,A01,083390,Staff,26,0,40,14
1650023144436,ECE 148,A01,084056,Silberman; Jack,8,0,12,4
1650023150473,ECE 180,A00,083391,Abi Samra; Nicholas Camill,25,0,30,5
1650023150473,ECE 180,B00,083392,Abi Samra; Nicholas Camill,21,0,30,9
1650023156502,MATH 10B,A01,084110,Staff,0,0,30,30
1650023156502,MATH 10B,A02,084111,Staff,18,0,30,12
1650023156502,MATH 10B,A03,084112,Staff,24,0,30,6
1650023162532,MATH 10C,A01,083443,Staff,0,16,30,30
1650023162532,MATH 10C,A02,083444,Staff,0,15,30,30
1650023162532,MATH 10C,B01,084114,Staff,19,0,30,11
1650023162532,MATH 10C,B02,084115,Staff,25,0,30,5
1650023168564,MATH 18,A01,084117,Harel; Guershon,14,0,30,16
1650023168564,MATH 18,A02,084119,Harel; Guershon,28,0,30,2
1650023168564,MATH 18,A03,084120,Harel; Guershon,29,0,30,1
1650023168564,MATH 18,A04,084121,Harel; Guershon,29,0,30,1
1650023174601,MATH 20B,A01,084124,Um; Ko Woon,16,0,35,19
1650023174601,MATH 20B,B01,084126,Um; Ko Woon,24,0,35,11
1650023180635,MATH 20C,A01,083446,Hammock; Frances H,0,0,30,30
1650023180635,MATH 20C,A02,083447,Hammock; Frances H,16,0,30,14
1650023180635,MATH 20C,A03,083448,Hammock; Frances H,19,0,30,11
1650023180635,MATH 20C,A04,083449,Hammock; Frances H,20,0,30,10
1650023180635,MATH 20C,B01,083451,Hammock; Frances H,0,0,30,30
1650023180635,MATH 20C,B02,083452,Hammock; Frances H,19,0,30,11
1650023180635,MATH 20C,B03,083453,Hammock; Frances H,21,0,30,9
1650023180635,MATH 20C,B04,083454,Hammock; Frances H,23,0,30,7
1650023186667,MATH 20D,A01,084128,Staff,14,0,30,16
1650023186667,MATH 20D,A02,084129,Staff,29,0,30,1
1650023186667,MATH 20D,A03,084130,Staff,27,0,30,3
1650023186667,MATH 20D,B01,084133,Staff,3,0,30,27
1650023186667,MATH 20D,B02,084134,Staff,24,0,30,6
1650023186667,MATH 20D,B03,084135,Staff,28,0,30,2
1650023192701,MATH 20E,A01,084138,Staff,14,0,30,16
1650023192701,MATH 20E,A02,084139,Staff,6,0,30,24
1650023192701,MATH 20E,A03,084140,Staff,15,0,30,15
1650023192701,MATH 20E,A04,084141,Staff,20,0,30,10
1650023198730,MATH 102,A01,084143,Harel; Guershon,12,0,30,18
1650023198730,MATH 102,A02,084144,Harel; Guershon,19,0,30,11
1650023204766,MATH 103B,A01,083456,Staff,0,13,30,30
1650023204766,MATH 103B,A02,083457,Staff,0,13,30,30
1650023210804,MATH 109,A01,084146,Salehi Golsefidy; Alireza,18,0,30,12
1650023210804,MATH 109,A02,084147,Salehi Golsefidy; Alireza,15,0,30,15
1650023216832,MATH 120A,A01,085445,Eggers; John Dietrich,10,0,35,25
1650023216832,MATH 120A,A02,085446,Eggers; John Dietrich,27,0,35,8
1650023222867,MATH 142B,A01,084149,Verstraete; Jacques Allan,0,12,30,30
1650023222867,MATH 142B,A02,084150,Verstraete; Jacques Allan,0,12,30,30
1650023228900,MATH 170A,A01,083459,Nie; Jiawang,0,9,30,30
1650023228900,MATH 170A,A02,083460,Nie; Jiawang,0,8,30,30
1650023228900,MATH 170A,A03,083461,Nie; Jiawang,0,9,30,30
1650023234930,MATH 193B,A01,083463,Staff,1,0,30,29
1650023234930,MATH 193B,A02,083464,Staff,9,0,30,21
1650023234930,MATH 193B,A03,083465,Staff,18,0,30,12
1650023241003,COGS 2,A01,083966,Boyle; Mary E. T.,9,0,30,21
1650023247032,COGS 9,A01,083968,Staff,9,0,60,51
1650023253082,COGS 14B,A01,083970,Staff,9,0,50,41
1650023259116,COGS 17,A01,092679,Staff,50,0,75,25
1650023274373,COGS 100,A01,083972,Staff,0,15,60,60
1650023289233,COGS 101C,A01,083976,Staff,12,0,30,18
1650023295265,COGS 102A,A01,083978,Johnson; Christine M.,14,0,30,16
1650023301294,COGS 107B,A01,083980,Staff,0,7,50,50
1650023307327,COGS 115,A01,083982,Staff,10,0,30,20
1650023313461,COGS 118B,A01,083367,Staff,0,15,40,40
1650023319499,COGS 172,A01,083984,Provenzano; Emily Kara,15,0,30,15
1650023325525,COGS 177,A00,083368,Staff,0,20,30,30
1650023331559,COGS 186,A01,083986,Staff,21,0,40,19
1650023337589,COGS 187A,A01,083988,Boyle; Mary E. T.,20,0,60,40
1650023343624,CSE 8A,A50,084003,Miranda; Gregory Joseph,0,13,15,15
1650023349653,CSE 11,A01,084005,Miranda; Gregory Joseph,0,22,55,55
1650023355682,CSE 20,A01,084007,Staff,0,5,20,20
1650023361712,CSE 21,A01,084009,Staff,0,30,50,50
1650023367737,CSE 30,A01,083370,Cao; Yingjun,0,65,40,40
1650023373765,CSE 100,A01,083372,Cao; Yingjun,0,46,40,40
1650023379797,CSE 101,A01,084011,Staff,0,54,40,40
1650023385832,CSE 141,A01,083374,Eldon; John,0,64,75,75
1650023391864,CSE 141L,A01,083376,Eldon; John,0,70,75,75
1650023397895,CSE 175,A01,084013,Kumar; Rakesh,22,0,25,3
1650023403933,CSE 190,A00,092508,Dubnov; Shlomo,20,0,20,0
1650023409963,ECE 5,A01,084049,Morris; Karcher William,13,0,20,7
1650023415998,ECE 100,A01,084051,Baghdadchi; Saharnaz,0,0,20,20
1650023415998,ECE 100,A02,091916,Baghdadchi; Saharnaz,13,0,20,7
1650023422042,ECE 101,A01,084053,Baghdadchi; Saharnaz,0,0,37,37
1650023422042,ECE 101,A02,084054,Baghdadchi; Saharnaz,30,0,37,7
1650023428071,ECE 107,A01,083390,Staff,26,0,40,14
1650023434099,ECE 148,A01,084056,Silberman; Jack,8,0,12,4
1650023440133,ECE 180,A00,083391,Abi Samra; Nicholas Camill,25,0,30,5
1650023440133,ECE 180,B00,083392,Abi Samra; Nicholas Camill,21,0,30,9
1650023446164,MATH 10B,A01,084110,Staff,0,0,30,30
1650023446164,MATH 10B,A02,084111,Staff,18,0,30,12
1650023446164,MATH 10B,A03,084112,Staff,24,0,30,6
1650023452193,MATH 10C,A01,083443,Staff,0,16,30,30
1650023452193,MATH 10C,A02,083444,Staff,0,15,30,30
1650023452193,MATH 10C,B01,084114,Staff,19,0,30,11
1650023452193,MATH 10C,B02,084115,Staff,25,0,30,5
1650023458222,MATH 18,A01,084117,Harel; Guershon,14,0,30,16
1650023458222,MATH 18,A02,084119,Harel; Guershon,28,0,30,2
1650023458222,MATH 18,A03,084120,Harel; Guershon,29,0,30,1
1650023458222,MATH 18,A04,084121,Harel; Guershon,29,0,30,1
1650023464251,MATH 20B,A01,084124,Um; Ko Woon,16,0,35,19
1650023464251,MATH 20B,B01,084126,Um; Ko Woon,24,0,35,11
1650023470288,MATH 20C,A01,083446,Hammock; Frances H,0,0,30,30
1650023470288,MATH 20C,A02,083447,Hammock; Frances H,16,0,30,14
1650023470288,MATH 20C,A03,083448,Hammock; Frances H,19,0,30,11
1650023470288,MATH 20C,A04,083449,Hammock; Frances H,20,0,30,10
1650023470288,MATH 20C,B01,083451,Hammock; Frances H,0,0,30,30
1650023470288,MATH 20C,B02,083452,Hammock; Frances H,19,0,30,11
1650023470288,MATH 20C,B03,083453,Hammock; Frances H,21,0,30,9
1650023470288,MATH 20C,B04,083454,Hammock; Frances H,23,0,30,7
1650023476316,MATH 20D,A01,084128,Staff,14,0,30,16
1650023476316,MATH 20D,A02,084129,Staff,29,0,30,1
1650023476316,MATH 20D,A03,084130,Staff,27,0,30,3
1650023476316,MATH 20D,B01,084133,Staff,3,0,30,27
1650023476316,MATH 20D,B02,084134,Staff,24,0,30,6
1650023476316,MATH 20D,B03,084135,Staff,28,0,30,2
1650023482344,MATH 20E,A01,084138,Staff,14,0,30,16
1650023482344,MATH 20E,A02,084139,Staff,6,0,30,24
1650023482344,MATH 20E,A03,084140,Staff,15,0,30,15
1650023482344,MATH 20E,A04,084141,Staff,20,0,30,10
1650023488377,MATH 102,A01,084143,Harel; Guershon,12,0,30,18
1650023488377,MATH 102,A02,084144,Harel; Guershon,19,0,30,11
1650023494410,MATH 103B,A01,083456,Staff,0,13,30,30
1650023494410,MATH 103B,A02,083457,Staff,0,13,30,30
1650023500443,MATH 109,A01,084146,Salehi Golsefidy; Alireza,18,0,30,12
1650023500443,MATH 109,A02,084147,Salehi Golsefidy; Alireza,15,0,30,15
1650023506472,MATH 120A,A01,085445,Eggers; John Dietrich,10,0,35,25
1650023506472,MATH 120A,A02,085446,Eggers; John Dietrich,27,0,35,8
1650023512506,MATH 142B,A01,084149,Verstraete; Jacques Allan,0,12,30,30
1650023512506,MATH 142B,A02,084150,Verstraete; Jacques Allan,0,12,30,30
1650023518534,MATH 170A,A01,083459,Nie; Jiawang,0,9,30,30
1650023518534,MATH 170A,A02,083460,Nie; Jiawang,0,8,30,30
1650023518534,MATH 170A,A03,083461,Nie; Jiawang,0,9,30,30
1650023524563,MATH 193B,A01,083463,Staff,1,0,30,29
1650023524563,MATH 193B,A02,083464,Staff,9,0,30,21
1650023524563,MATH 193B,A03,083465,Staff,18,0,30,12
1650023530644,COGS 2,A01,083966,Boyle; Mary E. T.,9,0,30,21
1650023536674,COGS 9,A01,083968,Staff,9,0,60,51
1650023542706,COGS 14B,A01,083970,Staff,9,0,50,41
1650023548740,COGS 17,A01,092679,Staff,50,0,75,25
1650023554771,COGS 100,A01,083972,Staff,0,15,60,60
1650023566833,COGS 101C,A01,083976,Staff,12,0,30,18
1650023572862,COGS 102A,A01,083978,Johnson; Christine M.,14,0,30,16
1650023578891,COGS 107B,A01,083980,Staff,0,7,50,50
1650023584918,COGS 115,A01,083982,Staff,10,0,30,20
1650023590948,COGS 118B,A01,083367,Staff,0,15,40,40
1650023596977,COGS 172,A01,083984,Provenzano; Emily Kara,15,0,30,15
1650023603005,COGS 177,A00,083368,Staff,0,20,30,30
1650023609034,COGS 186,A01,083986,Staff,21,0,40,19
1650023615062,COGS 187A,A01,083988,Boyle; Mary E. T.,20,0,60,40
1650023621096,CSE 8A,A50,084003,Miranda; Gregory Joseph,0,13,15,15
1650023627129,CSE 11,A01,084005,Miranda; Gregory Joseph,0,22,55,55
1650023633159,CSE 20,A01,084007,Staff,0,5,20,20
1650023639187,CSE 21,A01,084009,Staff,0,30,50,50
1650023645220,CSE 30,A01,083370,Cao; Yingjun,0,65,40,40
1650023651250,CSE 100,A01,083372,Cao; Yingjun,0,46,40,40
1650023657278,CSE 101,A01,084011,Staff,0,54,40,40
1650023663305,CSE 141,A01,083374,Eldon; John,0,64,75,75
1650023669334,CSE 141L,A01,083376,Eldon; John,0,70,75,75
1650023675374,CSE 175,A01,084013,Kumar; Rakesh,22,0,25,3
1650023681402,CSE 190,A00,092508,Dubnov; Shlomo,20,0,20,0
1650023687435,ECE 5,A01,084049,Morris; Karcher William,13,0,20,7
1650023693484,ECE 100,A01,084051,Baghdadchi; Saharnaz,0,0,20,20
1650023693484,ECE 100,A02,091916,Baghdadchi; Saharnaz,13,0,20,7
1650023699522,ECE 101,A01,084053,Baghdadchi; Saharnaz,0,0,37,37
1650023699522,ECE 101,A02,084054,Baghdadchi; Saharnaz,30,0,37,7
1650023705556,ECE 107,A01,083390,Staff,26,0,40,14
1650023711585,ECE 148,A01,084056,Silberman; Jack,8,0,12,4
1650023717617,ECE 180,A00,083391,Abi Samra; Nicholas Camill,25,0,30,5
1650023717617,ECE 180,B00,083392,Abi Samra; Nicholas Camill,21,0,30,9
1650023723644,MATH 10B,A01,084110,Staff,0,0,30,30
1650023723644,MATH 10B,A02,084111,Staff,18,0,30,12
1650023723644,MATH 10B,A03,084112,Staff,24,0,30,6
1650023729674,MATH 10C,A01,083443,Staff,0,16,30,30
1650023729674,MATH 10C,A02,083444,Staff,0,15,30,30
1650023729674,MATH 10C,B01,084114,Staff,19,0,30,11
1650023729674,MATH 10C,B02,084115,Staff,25,0,30,5
1650023735709,MATH 18,A01,084117,Harel; Guershon,14,0,30,16
1650023735709,MATH 18,A02,084119,Harel; Guershon,28,0,30,2
1650023735709,MATH 18,A03,084120,Harel; Guershon,29,0,30,1
1650023735709,MATH 18,A04,084121,Harel; Guershon,29,0,30,1
1650023741745,MATH 20B,A01,084124,Um; Ko Woon,16,0,35,19
1650023741745,MATH 20B,B01,084126,Um; Ko Woon,24,0,35,11
1650023747776,MATH 20C,A01,083446,Hammock; Frances H,0,0,30,30
1650023747776,MATH 20C,A02,083447,Hammock; Frances H,16,0,30,14
1650023747776,MATH 20C,A03,083448,Hammock; Frances H,19,0,30,11
1650023747776,MATH 20C,A04,083449,Hammock; Frances H,20,0,30,10
1650023747776,MATH 20C,B01,083451,Hammock; Frances H,0,0,30,30
1650023747776,MATH 20C,B02,083452,Hammock; Frances H,19,0,30,11
1650023747776,MATH 20C,B03,083453,Hammock; Frances H,21,0,30,9
1650023747776,MATH 20C,B04,083454,Hammock; Frances H,23,0,30,7
1650023753802,MATH 20D,A01,084128,Staff,14,0,30,16
1650023753802,MATH 20D,A02,084129,Staff,29,0,30,1
1650023753802,MATH 20D,A03,084130,Staff,27,0,30,3
1650023753802,MATH 20D,B01,084133,Staff,3,0,30,27
1650023753802,MATH 20D,B02,084134,Staff,24,0,30,6
1650023753802,MATH 20D,B03,084135,Staff,28,0,30,2
1650023759829,MATH 20E,A01,084138,Staff,14,0,30,16
1650023759829,MATH 20E,A02,084139,Staff,6,0,30,24
1650023759829,MATH 20E,A03,084140,Staff,15,0,30,15
1650023759829,MATH 20E,A04,084141,Staff,20,0,30,10
1650023765860,MATH 102,A01,084143,Harel; Guershon,12,0,30,18
1650023765860,MATH 102,A02,084144,Harel; Guershon,19,0,30,11
1650023771888,MATH 103B,A01,083456,Staff,0,13,30,30
1650023771888,MATH 103B,A02,083457,Staff,0,14,30,30
1650023777920,MATH 109,A01,084146,Salehi Golsefidy; Alireza,18,0,30,12
1650023777920,MATH 109,A02,084147,Salehi Golsefidy; Alireza,15,0,30,15
1650023783963,MATH 120A,A01,085445,Eggers; John Dietrich,10,0,35,25
1650023783963,MATH 120A,A02,085446,Eggers; John Dietrich,27,0,35,8
1650023789992,MATH 142B,A01,084149,Verstraete; Jacques Allan,0,12,30,30
1650023789992,MATH 142B,A02,084150,Verstraete; Jacques Allan,0,12,30,30
1650023796025,MATH 170A,A01,083459,Nie; Jiawang,0,9,30,30
1650023796025,MATH 170A,A02,083460,Nie; Jiawang,0,8,30,30
1650023796025,MATH 170A,A03,083461,Nie; Jiawang,0,9,30,30
1650023802050,MATH 193B,A01,083463,Staff,1,0,30,29
1650023802050,MATH 193B,A02,083464,Staff,9,0,30,21
1650023802050,MATH 193B,A03,083465,Staff,18,0,30,12
1650023808113,COGS 2,A01,083966,Boyle; Mary E. T.,9,0,30,21
1650023814137,COGS 9,A01,083968,Staff,9,0,60,51
1650023820170,COGS 14B,A01,083970,Staff,9,0,50,41
1650023826198,COGS 17,A01,092679,Staff,50,0,75,25
1650023832228,COGS 100,A01,083972,Staff,0,15,60,60
1650023844285,COGS 101C,A01,083976,Staff,12,0,30,18
1650023850315,COGS 102A,A01,083978,Johnson; Christine M.,14,0,30,16
1650023856347,COGS 107B,A01,083980,Staff,0,7,50,50
1650023862376,COGS 115,A01,083982,Staff,10,0,30,20
1650023868404,COGS 118B,A01,083367,Staff,0,15,40,40
1650023874433,COGS 172,A01,083984,Provenzano; Emily Kara,15,0,30,15
1650023880460,COGS 177,A00,083368,Staff,0,20,30,30
1650023886489,COGS 186,A01,083986,Staff,21,0,40,19
1650023892517,COGS 187A,A01,083988,Boyle; Mary E. T.,20,0,60,40
1650023898547,CSE 8A,A50,084003,Miranda; Gregory Joseph,0,13,15,15
1650023904574,CSE 11,A01,084005,Miranda; Gregory Joseph,0,22,55,55
1650023910698,CSE 20,A01,084007,Staff,0,5,20,20
1650023916728,CSE 21,A01,084009,Staff,0,30,50,50
1650023922760,CSE 30,A01,083370,Cao; Yingjun,0,65,40,40
1650023928792,CSE 100,A01,083372,Cao; Yingjun,0,46,40,40
1650023934819,CSE 101,A01,084011,Staff,0,54,40,40
1650023940852,CSE 141,A01,083374,Eldon; John,0,64,75,75
1650023946878,CSE 141L,A01,083376,Eldon; John,0,70,75,75
1650023952913,CSE 175,A01,084013,Kumar; Rakesh,22,0,25,3
1650023958944,CSE 190,A00,092508,Dubnov; Shlomo,20,0,20,0
1650023964972,ECE 5,A01,084049,Morris; Karcher William,13,0,20,7
1650023971004,ECE 100,A01,084051,Baghdadchi; Saharnaz,0,0,20,20
1650023971004,ECE 100,A02,091916,Baghdadchi; Saharnaz,13,0,20,7
1650023977040,ECE 101,A01,084053,Baghdadchi; Saharnaz,0,0,37,37
1650023977040,ECE 101,A02,084054,Baghdadchi; Saharnaz,30,0,37,7
1650023983075,ECE 107,A01,083390,Staff,26,0,40,14
1650023989110,ECE 148,A01,084056,Silberman; Jack,8,0,12,4
1650023995138,ECE 180,A00,083391,Abi Samra; Nicholas Camill,25,0,30,5
1650023995138,ECE 180,B00,083392,Abi Samra; Nicholas Camill,21,0,30,9
1650024001187,MATH 10B,A01,084110,Staff,0,0,30,30
1650024001187,MATH 10B,A02,084111,Staff,18,0,30,12
1650024001187,MATH 10B,A03,084112,Staff,24,0,30,6
1650024007222,MATH 10C,A01,083443,Staff,0,16,30,30
1650024007222,MATH 10C,A02,083444,Staff,0,15,30,30
1650024007222,MATH 10C,B01,084114,Staff,19,0,30,11
1650024007222,MATH 10C,B02,084115,Staff,25,0,30,5
1650024013253,MATH 18,A01,084117,Harel; Guershon,14,0,30,16
1650024013253,MATH 18,A02,084119,Harel; Guershon,28,0,30,2
1650024013253,MATH 18,A03,084120,Harel; Guershon,29,0,30,1
1650024013253,MATH 18,A04,084121,Harel; Guershon,29,0,30,1
1650024019285,MATH 20B,A01,084124,Um; Ko Woon,16,0,35,19
1650024019285,MATH 20B,B01,084126,Um; Ko Woon,24,0,35,11
1650024025313,MATH 20C,A01,083446,Hammock; Frances H,0,0,30,30
1650024025313,MATH 20C,A02,083447,Hammock; Frances H,16,0,30,14
1650024025313,MATH 20C,A03,083448,Hammock; Frances H,19,0,30,11
1650024025313,MATH 20C,A04,083449,Hammock; Frances H,20,0,30,10
1650024025313,MATH 20C,B01,083451,Hammock; Frances H,0,0,30,30
1650024025313,MATH 20C,B02,083452,Hammock; Frances H,19,0,30,11
1650024025313,MATH 20C,B03,083453,Hammock; Frances H,21,0,30,9
1650024025313,MATH 20C,B04,083454,Hammock; Frances H,23,0,30,7
1650024031345,MATH 20D,A01,084128,Staff,14,0,30,16
1650024031345,MATH 20D,A02,084129,Staff,29,0,30,1
1650024031345,MATH 20D,A03,084130,Staff,27,0,30,3
1650024031345,MATH 20D,B01,084133,Staff,3,0,30,27
1650024031345,MATH 20D,B02,084134,Staff,24,0,30,6
1650024031345,MATH 20D,B03,084135,Staff,28,0,30,2
1650024037373,MATH 20E,A01,084138,Staff,14,0,30,16
1650024037373,MATH 20E,A02,084139,Staff,6,0,30,24
1650024037373,MATH 20E,A03,084140,Staff,15,0,30,15
1650024037373,MATH 20E,A04,084141,Staff,20,0,30,10
1650024043403,MATH 102,A01,084143,Harel; Guershon,12,0,30,18
1650024043403,MATH 102,A02,084144,Harel; Guershon,19,0,30,11
1650024049430,MATH 103B,A01,083456,Staff,0,13,30,30
1650024049430,MATH 103B,A02,083457,Staff,0,14,30,30
1650024055464,MATH 109,A01,084146,Salehi Golsefidy; Alireza,18,0,30,12
1650024055464,MATH 109,A02,084147,Salehi Golsefidy; Alireza,15,0,30,15
1650024061491,MATH 120A,A01,085445,Eggers; John Dietrich,10,0,35,25
1650024061491,MATH 120A,A02,085446,Eggers; John Dietrich,27,0,35,8
1650024067520,MATH 142B,A01,084149,Verstraete; Jacques Allan,0,12,30,30
1650024067520,MATH 142B,A02,084150,Verstraete; Jacques Allan,0,12,30,30
1650024073552,MATH 170A,A01,083459,Nie; Jiawang,0,9,30,30
1650024073552,MATH 170A,A02,083460,Nie; Jiawang,0,8,30,30
1650024073552,MATH 170A,A03,083461,Nie; Jiawang,0,9,30,30
1650024079578,MATH 193B,A01,083463,Staff,1,0,30,29
1650024079578,MATH 193B,A02,083464,Staff,9,0,30,21
1650024079578,MATH 193B,A03,083465,Staff,18,0,30,12
1650024085785,COGS 2,A01,083966,Boyle; Mary E. T.,9,0,30,21
1650024091812,COGS 9,A01,083968,Staff,9,0,60,51
1650024097845,COGS 14B,A01,083970,Staff,9,0,50,41
1650024103872,COGS 17,A01,092679,Staff,50,0,75,25
1650024109900,COGS 100,A01,083972,Staff,0,15,60,60
1650024121954,COGS 101C,A01,083976,Staff,12,0,30,18
1650024127983,COGS 102A,A01,083978,Johnson; Christine M.,14,0,30,16
1650024134013,COGS 107B,A01,083980,Staff,0,7,50,50
1650024140041,COGS 115,A01,083982,Staff,10,0,30,20
1650024146075,COGS 118B,A01,083367,Staff,0,15,40,40
1650024152103,COGS 172,A01,083984,Provenzano; Emily Kara,15,0,30,15
1650024158144,COGS 177,A00,083368,Staff,0,20,30,30
1650024164172,COGS 186,A01,083986,Staff,21,0,40,19
1650024170200,COGS 187A,A01,083988,Boyle; Mary E. T.,20,0,60,40
1650024176233,CSE 8A,A50,084003,Miranda; Gregory Joseph,0,13,15,15
1650024182262,CSE 11,A01,084005,Miranda; Gregory Joseph,0,22,55,55
1650024188299,CSE 20,A01,084007,Staff,0,5,20,20
1650024194336,CSE 21,A01,084009,Staff,0,30,50,50
1650024200362,CSE 30,A01,083370,Cao; Yingjun,0,65,40,40
1650024206395,CSE 100,A01,083372,Cao; Yingjun,0,46,40,40
1650024212422,CSE 101,A01,084011,Staff,0,54,40,40
1650024218455,CSE 141,A01,083374,Eldon; John,0,64,75,75
1650024224483,CSE 141L,A01,083376,Eldon; John,0,70,75,75
1650024230509,CSE 175,A01,084013,Kumar; Rakesh,22,0,25,3
1650024236540,CSE 190,A00,092508,Dubnov; Shlomo,20,0,20,0
1650024242572,ECE 5,A01,084049,Morris; Karcher William,13,0,20,7
1650024248604,ECE 100,A01,084051,Baghdadchi; Saharnaz,0,0,20,20
1650024248604,ECE 100,A02,091916,Baghdadchi; Saharnaz,13,0,20,7
1650024254632,ECE 101,A01,084053,Baghdadchi; Saharnaz,0,0,37,37
1650024254632,ECE 101,A02,084054,Baghdadchi; Saharnaz,30,0,37,7
1650024260660,ECE 107,A01,083390,Staff,26,0,40,14
1650024266693,ECE 148,A01,084056,Silberman; Jack,8,0,12,4
1650024272722,ECE 180,A00,083391,Abi Samra; Nicholas Camill,25,0,30,5
1650024272722,ECE 180,B00,083392,Abi Samra; Nicholas Camill,21,0,30,9
1650024278762,MATH 10B,A01,084110,Staff,0,0,30,30
1650024278762,MATH 10B,A02,084111,Staff,18,0,30,12
1650024278762,MATH 10B,A03,084112,Staff,24,0,30,6
1650024284788,MATH 10C,A01,083443,Staff,0,16,30,30
1650024284788,MATH 10C,A02,083444,Staff,0,15,30,30
1650024284788,MATH 10C,B01,084114,Staff,19,0,30,11
1650024284788,MATH 10C,B02,084115,Staff,25,0,30,5
1650024290816,MATH 18,A01,084117,Harel; Guershon,14,0,30,16
1650024290816,MATH 18,A02,084119,Harel; Guershon,28,0,30,2
1650024290816,MATH 18,A03,084120,Harel; Guershon,29,0,30,1
1650024290816,MATH 18,A04,084121,Harel; Guershon,29,0,30,1
1650024296844,MATH 20B,A01,084124,Um; Ko Woon,16,0,35,19
1650024296844,MATH 20B,B01,084126,Um; Ko Woon,24,0,35,11
1650024302916,MATH 20C,A01,083446,Hammock; Frances H,0,0,30,30
1650024302916,MATH 20C,A02,083447,Hammock; Frances H,16,0,30,14
1650024302916,MATH 20C,A03,083448,Hammock; Frances H,19,0,30,11
1650024302916,MATH 20C,A04,083449,Hammock; Frances H,20,0,30,10
1650024302916,MATH 20C,B01,083451,Hammock; Frances H,0,0,30,30
1650024302916,MATH 20C,B02,083452,Hammock; Frances H,19,0,30,11
1650024302916,MATH 20C,B03,083453,Hammock; Frances H,21,0,30,9
1650024302916,MATH 20C,B04,083454,Hammock; Frances H,23,0,30,7
1650024308948,MATH 20D,A01,084128,Staff,14,0,30,16
1650024308948,MATH 20D,A02,084129,Staff,29,0,30,1
1650024308948,MATH 20D,A03,084130,Staff,27,0,30,3
1650024308948,MATH 20D,B01,084133,Staff,3,0,30,27
1650024308948,MATH 20D,B02,084134,Staff,24,0,30,6
1650024308948,MATH 20D,B03,084135,Staff,28,0,30,2
1650024314977,MATH 20E,A01,084138,Staff,14,0,30,16
1650024314977,MATH 20E,A02,084139,Staff,6,0,30,24
1650024314977,MATH 20E,A03,084140,Staff,15,0,30,15
1650024314977,MATH 20E,A04,084141,Staff,20,0,30,10
1650024321002,MATH 102,A01,084143,Harel; Guershon,12,0,30,18
1650024321002,MATH 102,A02,084144,Harel; Guershon,19,0,30,11
1650024327043,MATH 103B,A01,083456,Staff,0,13,30,30
1650024327043,MATH 103B,A02,083457,Staff,0,14,30,30
1650024333077,MATH 109,A01,084146,Salehi Golsefidy; Alireza,18,0,30,12
1650024333077,MATH 109,A02,084147,Salehi Golsefidy; Alireza,15,0,30,15
1650024339110,MATH 120A,A01,085445,Eggers; John Dietrich,10,0,35,25
1650024339110,MATH 120A,A02,085446,Eggers; John Dietrich,27,0,35,8
1650024345142,MATH 142B,A01,084149,Verstraete; Jacques Allan,0,12,30,30
1650024345142,MATH 142B,A02,084150,Verstraete; Jacques Allan,0,12,30,30
1650024351170,MATH 170A,A01,083459,Nie; Jiawang,0,9,30,30
1650024351170,MATH 170A,A02,083460,Nie; Jiawang,0,8,30,30
1650024351170,MATH 170A,A03,083461,Nie; Jiawang,0,9,30,30
1650024357197,MATH 193B,A01,083463,Staff,1,0,30,29
1650024357197,MATH 193B,A02,083464,Staff,9,0,30,21
1650024357197,MATH 193B,A03,083465,Staff,18,0,30,12
1650024363277,COGS 2,A01,083966,Boyle; Mary E. T.,9,0,30,21
1650024369317,COGS 9,A01,083968,Staff,9,0,60,51
1650024375345,COGS 14B,A01,083970,Staff,9,0,50,41
1650024381374,COGS 17,A01,092679,Staff,50,0,75,25
1650024387404,COGS 100,A01,083972,Staff,0,15,60,60
1650024399463,COGS 101C,A01,083976,Staff,12,0,30,18
1650024405489,COGS 102A,A01,083978,Johnson; Christine M.,14,0,30,16
1650024411516,COGS 107B,A01,083980,Staff,0,7,50,50
1650024417544,COGS 115,A01,083982,Staff,10,0,30,20
1650024423583,COGS 118B,A01,083367,Staff,0,15,40,40
1650024429632,COGS 172,A01,083984,Provenzano; Emily Kara,15,0,30,15
1650024435659,COGS 177,A00,083368,Staff,0,20,30,30
1650024441687,COGS 186,A01,083986,Staff,21,0,40,19
1650024447733,COGS 187A,A01,083988,Boyle; Mary E. T.,20,0,60,40
1650024453763,CSE 8A,A50,084003,Miranda; Gregory Joseph,0,13,15,15
1650024459794,CSE 11,A01,084005,Miranda; Gregory Joseph,0,22,55,55
1650024465829,CSE 20,A01,084007,Staff,0,5,20,20
1650024471857,CSE 21,A01,084009,Staff,0,30,50,50
1650024477889,CSE 30,A01,083370,Cao; Yingjun,0,65,40,40
1650024483920,CSE 100,A01,083372,Cao; Yingjun,0,46,40,40
1650024489947,CSE 101,A01,084011,Staff,0,54,40,40
1650024495974,CSE 141,A01,083374,Eldon; John,0,64,75,75
1650024502001,CSE 141L,A01,083376,Eldon; John,0,70,75,75
1650024508130,CSE 175,A01,084013,Kumar; Rakesh,22,0,25,3
1650024514160,CSE 190,A00,092508,Dubnov; Shlomo,20,0,20,0
1650024520197,ECE 5,A01,084049,Morris; Karcher William,13,0,20,7
1650024526224,ECE 100,A01,084051,Baghdadchi; Saharnaz,0,0,20,20
1650024526224,ECE 100,A02,091916,Baghdadchi; Saharnaz,13,0,20,7
1650024532256,ECE 101,A01,084053,Baghdadchi; Saharnaz,0,0,37,37
1650024532256,ECE 101,A02,084054,Baghdadchi; Saharnaz,30,0,37,7
1650024538291,ECE 107,A01,083390,Staff,26,0,40,14
1650024544318,ECE 148,A01,084056,Silberman; Jack,8,0,12,4
1650024550345,ECE 180,A00,083391,Abi Samra; Nicholas Camill,25,0,30,5
1650024550345,ECE 180,B00,083392,Abi Samra; Nicholas Camill,21,0,30,9
1650024556375,MATH 10B,A01,084110,Staff,0,0,30,30
1650024556375,MATH 10B,A02,084111,Staff,18,0,30,12
1650024556375,MATH 10B,A03,084112,Staff,24,0,30,6
1650024562407,MATH 10C,A01,083443,Staff,0,16,30,30
1650024562407,MATH 10C,A02,083444,Staff,0,15,30,30
1650024562407,MATH 10C,B01,084114,Staff,19,0,30,11
1650024562407,MATH 10C,B02,084115,Staff,25,0,30,5
1650024568436,MATH 18,A01,084117,Harel; Guershon,14,0,30,16
1650024568436,MATH 18,A02,084119,Harel; Guershon,28,0,30,2
1650024568436,MATH 18,A03,084120,Harel; Guershon,29,0,30,1
1650024568436,MATH 18,A04,084121,Harel; Guershon,29,0,30,1
1650024574472,MATH 20B,A01,084124,Um; Ko Woon,16,0,35,19
1650024574472,MATH 20B,B01,084126,Um; Ko Woon,24,0,35,11
1650024580507,MATH 20C,A01,083446,Hammock; Frances H,0,0,30,30
1650024580507,MATH 20C,A02,083447,Hammock; Frances H,16,0,30,14
1650024580507,MATH 20C,A03,083448,Hammock; Frances H,19,0,30,11
1650024580507,MATH 20C,A04,083449,Hammock; Frances H,20,0,30,10
1650024580507,MATH 20C,B01,083451,Hammock; Frances H,0,0,30,30
1650024580507,MATH 20C,B02,083452,Hammock; Frances H,19,0,30,11
1650024580507,MATH 20C,B03,083453,Hammock; Frances H,21,0,30,9
1650024580507,MATH 20C,B04,083454,Hammock; Frances H,23,0,30,7
1650024586536,MATH 20D,A01,084128,Staff,14,0,30,16
1650024586536,MATH 20D,A02,084129,Staff,29,0,30,1
1650024586536,MATH 20D,A03,084130,Staff,27,0,30,3
1650024586536,MATH 20D,B01,084133,Staff,3,0,30,27
1650024586536,MATH 20D,B02,084134,Staff,24,0,30,6
1650024586536,MATH 20D,B03,084135,Staff,28,0,30,2
1650024592562,MATH 20E,A01,084138,Staff,14,0,30,16
1650024592562,MATH 20E,A02,084139,Staff,6,0,30,24
1650024592562,MATH 20E,A03,084140,Staff,15,0,30,15
1650024592562,MATH 20E,A04,084141,Staff,20,0,30,10
1650024598595,MATH 102,A01,084143,Harel; Guershon,12,0,30,18
1650024598595,MATH 102,A02,084144,Harel; Guershon,19,0,30,11
1650024604620,MATH 103B,A01,083456,Staff,0,13,30,30
1650024604620,MATH 103B,A02,083457,Staff,0,14,30,30
1650024610652,MATH 109,A01,084146,Salehi Golsefidy; Alireza,18,0,30,12
1650024610652,MATH 109,A02,084147,Salehi Golsefidy; Alireza,15,0,30,15
1650024616681,MATH 120A,A01,085445,Eggers; John Dietrich,10,0,35,25
1650024616681,MATH 120A,A02,085446,Eggers; John Dietrich,27,0,35,8
1650024622716,MATH 142B,A01,084149,Verstraete; Jacques Allan,0,12,30,30
1650024622716,MATH 142B,A02,084150,Verstraete; Jacques Allan,0,12,30,30
1650024628742,MATH 170A,A01,083459,Nie; Jiawang,0,9,30,30
1650024628742,MATH 170A,A02,083460,Nie; Jiawang,0,8,30,30
1650024628742,MATH 170A,A03,083461,Nie; Jiawang,0,9,30,30
1650024634773,MATH 193B,A01,083463,Staff,1,0,30,29
1650024634773,MATH 193B,A02,083464,Staff,9,0,30,21
1650024634773,MATH 193B,A03,083465,Staff,18,0,30,12
1650024640855,COGS 2,A01,083966,Boyle; Mary E. T.,9,0,30,21
1650024646883,COGS 9,A01,083968,Staff,9,0,60,51
1650024652915,COGS 14B,A01,083970,Staff,9,0,50,41
1650024658939,COGS 17,A01,092679,Staff,50,0,75,25
1650024664966,COGS 100,A01,083972,Staff,0,15,60,60
1650024677022,COGS 101C,A01,083976,Staff,12,0,30,18
1650024683052,COGS 102A,A01,083978,Johnson; Christine M.,14,0,30,16
1650024689080,COGS 107B,A01,083980,Staff,0,7,50,50
1650024695124,COGS 115,A01,083982,Staff,10,0,30,20
1650024701153,COGS 118B,A01,083367,Staff,0,15,40,40
1650024707185,COGS 172,A01,083984,Provenzano; Emily Kara,15,0,30,15
1650024713216,COGS 177,A00,083368,Staff,0,20,30,30
1650024719246,COGS 186,A01,083986,Staff,21,0,40,19
1650024725273,COGS 187A,A01,083988,Boyle; Mary E. T.,20,0,60,40
1650024731302,CSE 8A,A50,084003,Miranda; Gregory Joseph,0,13,15,15
1650024737329,CSE 11,A01,084005,Miranda; Gregory Joseph,0,22,55,55
1650024743357,CSE 20,A01,084007,Staff,0,5,20,20
1650024749381,CSE 21,A01,084009,Staff,0,30,50,50
1650024755411,CSE 30,A01,083370,Cao; Yingjun,0,65,40,40
1650024761437,CSE 100,A01,083372,Cao; Yingjun,0,46,40,40
1650024767463,CSE 101,A01,084011,Staff,0,54,40,40
1650024773490,CSE 141,A01,083374,Eldon; John,0,64,75,75
1650024779522,CSE 141L,A01,083376,Eldon; John,0,70,75,75
1650024785552,CSE 175,A01,084013,Kumar; Rakesh,22,0,25,3
1650024791579,CSE 190,A00,092508,Dubnov; Shlomo,20,0,20,0
1650024797615,ECE 5,A01,084049,Morris; Karcher William,13,0,20,7
1650024803645,ECE 100,A01,084051,Baghdadchi; Saharnaz,0,0,20,20
1650024803645,ECE 100,A02,091916,Baghdadchi; Saharnaz,13,0,20,7
1650024809673,ECE 101,A01,084053,Baghdadchi; Saharnaz,0,0,37,37
1650024809673,ECE 101,A02,084054,Baghdadchi; Saharnaz,30,0,37,7
1650024815705,ECE 107,A01,083390,Staff,26,0,40,14
1650024821738,ECE 148,A01,084056,Silberman; Jack,8,0,12,4
1650024827771,ECE 180,A00,083391,Abi Samra; Nicholas Camill,25,0,30,5
1650024827771,ECE 180,B00,083392,Abi Samra; Nicholas Camill,21,0,30,9
1650024833799,MATH 10B,A01,084110,Staff,0,0,30,30
1650024833799,MATH 10B,A02,084111,Staff,18,0,30,12
1650024833799,MATH 10B,A03,084112,Staff,24,0,30,6
1650024839825,MATH 10C,A01,083443,Staff,0,16,30,30
1650024839825,MATH 10C,A02,083444,Staff,0,15,30,30
1650024839825,MATH 10C,B01,084114,Staff,19,0,30,11
1650024839825,MATH 10C,B02,084115,Staff,25,0,30,5
1650024845864,MATH 18,A01,084117,Harel; Guershon,14,0,30,16
1650024845864,MATH 18,A02,084119,Harel; Guershon,28,0,30,2
1650024845864,MATH 18,A03,084120,Harel; Guershon,29,0,30,1
1650024845864,MATH 18,A04,084121,Harel; Guershon,29,0,30,1
1650024851892,MATH 20B,A01,084124,Um; Ko Woon,16,0,35,19
1650024851892,MATH 20B,B01,084126,Um; Ko Woon,24,0,35,11
1650024857919,MATH 20C,A01,083446,Hammock; Frances H,0,0,30,30
1650024857919,MATH 20C,A02,083447,Hammock; Frances H,16,0,30,14
1650024857919,MATH 20C,A03,083448,Hammock; Frances H,19,0,30,11
1650024857919,MATH 20C,A04,083449,Hammock; Frances H,20,0,30,10
1650024857919,MATH 20C,B01,083451,Hammock; Frances H,0,0,30,30
1650024857919,MATH 20C,B02,083452,Hammock; Frances H,19,0,30,11
1650024857919,MATH 20C,B03,083453,Hammock; Frances H,21,0,30,9
1650024857919,MATH 20C,B04,083454,Hammock; Frances H,23,0,30,7
1650024863953,MATH 20D,A01,084128,Staff,14,0,30,16
1650024863953,MATH 20D,A02,084129,Staff,29,0,30,1
1650024863953,MATH 20D,A03,084130,Staff,27,0,30,3
1650024863953,MATH 20D,B01,084133,Staff,3,0,30,27
1650024863953,MATH 20D,B02,084134,Staff,24,0,30,6
1650024863953,MATH 20D,B03,084135,Staff,28,0,30,2
1650024869989,MATH 20E,A01,084138,Staff,14,0,30,16
1650024869989,MATH 20E,A02,084139,Staff,6,0,30,24
1650024869989,MATH 20E,A03,084140,Staff,15,0,30,15
1650024869989,MATH 20E,A04,084141,Staff,20,0,30,10
1650024876015,MATH 102,A01,084143,Harel; Guershon,12,0,30,18
1650024876015,MATH 102,A02,084144,Harel; Guershon,19,0,30,11
1650024882045,MATH 103B,A01,083456,Staff,0,13,30,30
1650024882045,MATH 103B,A02,083457,Staff,0,14,30,30
1650024888080,MATH 109,A01,084146,Salehi Golsefidy; Alireza,18,0,30,12
1650024888080,MATH 109,A02,084147,Salehi Golsefidy; Alireza,15,0,30,15
1650024894111,MATH 120A,A01,085445,Eggers; John Dietrich,10,0,35,25
1650024894111,MATH 120A,A02,085446,Eggers; John Dietrich,27,0,35,8
1650024900140,MATH 142B,A01,084149,Verstraete; Jacques Allan,0,12,30,30
1650024900140,MATH 142B,A02,084150,Verstraete; Jacques Allan,0,12,30,30
1650024906172,MATH 170A,A01,083459,Nie; Jiawang,0,9,30,30
1650024906172,MATH 170A,A02,083460,Nie; Jiawang,0,8,30,30
1650024906172,MATH 170A,A03,083461,Nie; Jiawang,0,9,30,30
1650024912198,MATH 193B,A01,083463,Staff,1,0,30,29
1650024912198,MATH 193B,A02,083464,Staff,9,0,30,21
1650024912198,MATH 193B,A03,083465,Staff,18,0,30,12
1650024918295,COGS 2,A01,083966,Boyle; Mary E. T.,9,0,30,21
1650024924325,COGS 9,A01,083968,Staff,9,0,60,51
1650024930354,COGS 14B,A01,083970,Staff,9,0,50,41
1650024936380,COGS 17,A01,092679,Staff,50,0,75,25
1650024942409,COGS 100,A01,083972,Staff,0,15,60,60
1650024954465,COGS 101C,A01,083976,Staff,12,0,30,18
1650024960497,COGS 102A,A01,083978,Johnson; Christine M.,14,0,30,16
1650024966529,COGS 107B,A01,083980,Staff,0,7,50,50
1650024972563,COGS 115,A01,083982,Staff,10,0,30,20
1650024978595,COGS 118B,A01,083367,Staff,0,15,40,40
1650024984630,COGS 172,A01,083984,Provenzano; Emily Kara,15,0,30,15
1650024990656,COGS 177,A00,083368,Staff,0,20,30,30
1650024996683,COGS 186,A01,083986,Staff,21,0,40,19
1650025002710,COGS 187A,A01,083988,Boyle; Mary E. T.,20,0,60,40
1650025008741,CSE 8A,A50,084003,Miranda; Gregory Joseph,0,13,15,15
1650025014768,CSE 11,A01,084005,Miranda; Gregory Joseph,0,22,55,55
1650025020795,CSE 20,A01,084007,Staff,0,5,20,20
1650025026835,CSE 21,A01,084009,Staff,0,30,50,50
1650025032867,CSE 30,A01,083370,Cao; Yingjun,0,65,40,40
1650025038905,CSE 100,A01,083372,Cao; Yingjun,0,46,40,40
1650025044953,CSE 101,A01,084011,Staff,0,54,40,40
1650025050983,CSE 141,A01,083374,Eldon; John,0,64,75,75
1650025057015,CSE 141L,A01,083376,Eldon; John,0,70,75,75
1650025063060,CSE 175,A01,084013,Kumar; Rakesh,22,0,25,3
1650025069088,CSE 190,A00,092508,Dubnov; Shlomo,20,0,20,0
1650025075120,ECE 5,A01,084049,Morris; Karcher William,13,0,20,7
1650025081154,ECE 100,A01,084051,Baghdadchi; Saharnaz,0,0,20,20
1650025081154,ECE 100,A02,091916,Baghdadchi; Saharnaz,13,0,20,7
1650025087183,ECE 101,A01,084053,Baghdadchi; Saharnaz,0,0,37,37
1650025087183,ECE 101,A02,084054,Baghdadchi; Saharnaz,30,0,37,7
1650025093211,ECE 107,A01,083390,Staff,26,0,40,14
1650025099240,ECE 148,A01,084056,Silberman; Jack,8,0,12,4
1650025105363,ECE 180,A00,083391,Abi Samra; Nicholas Camill,25,0,30,5
1650025105363,ECE 180,B00,083392,Abi Samra; Nicholas Camill,21,0,30,9
1650025111391,MATH 10B,A01,084110,Staff,0,0,30,30
1650025111391,MATH 10B,A02,084111,Staff,18,0,30,12
1650025111391,MATH 10B,A03,084112,Staff,24,0,30,6
1650025117420,MATH 10C,A01,083443,Staff,0,16,30,30
1650025117420,MATH 10C,A02,083444,Staff,0,15,30,30
1650025117420,MATH 10C,B01,084114,Staff,19,0,30,11
1650025117420,MATH 10C,B02,084115,Staff,25,0,30,5
1650025123449,MATH 18,A01,084117,Harel; Guershon,14,0,30,16
1650025123449,MATH 18,A02,084119,Harel; Guershon,28,0,30,2
1650025123449,MATH 18,A03,084120,Harel; Guershon,29,0,30,1
1650025123449,MATH 18,A04,084121,Harel; Guershon,29,0,30,1
1650025129477,MATH 20B,A01,084124,Um; Ko Woon,16,0,35,19
1650025129477,MATH 20B,B01,084126,Um; Ko Woon,24,0,35,11
1650025135511,MATH 20C,A01,083446,Hammock; Frances H,0,0,30,30
1650025135511,MATH 20C,A02,083447,Hammock; Frances H,16,0,30,14
1650025135511,MATH 20C,A03,083448,Hammock; Frances H,19,0,30,11
1650025135511,MATH 20C,A04,083449,Hammock; Frances H,20,0,30,10
1650025135511,MATH 20C,B01,083451,Hammock; Frances H,0,0,30,30
1650025135511,MATH 20C,B02,083452,Hammock; Frances H,19,0,30,11
1650025135511,MATH 20C,B03,083453,Hammock; Frances H,21,0,30,9
1650025135511,MATH 20C,B04,083454,Hammock; Frances H,23,0,30,7
1650025141545,MATH 20D,A01,084128,Staff,14,0,30,16
1650025141545,MATH 20D,A02,084129,Staff,29,0,30,1
1650025141545,MATH 20D,A03,084130,Staff,27,0,30,3
1650025141545,MATH 20D,B01,084133,Staff,3,0,30,27
1650025141545,MATH 20D,B02,084134,Staff,24,0,30,6
1650025141545,MATH 20D,B03,084135,Staff,28,0,30,2
1650025147574,MATH 20E,A01,084138,Staff,14,0,30,16
1650025147574,MATH 20E,A02,084139,Staff,6,0,30,24
1650025147574,MATH 20E,A03,084140,Staff,15,0,30,15
1650025147574,MATH 20E,A04,084141,Staff,20,0,30,10
1650025153621,MATH 102,A01,084143,Harel; Guershon,12,0,30,18
1650025153621,MATH 102,A02,084144,Harel; Guershon,19,0,30,11
1650025159651,MATH 103B,A01,083456,Staff,0,13,30,30
1650025159651,MATH 103B,A02,083457,Staff,0,14,30,30
1650025165684,MATH 109,A01,084146,Salehi Golsefidy; Alireza,18,0,30,12
1650025165684,MATH 109,A02,084147,Salehi Golsefidy; Alireza,15,0,30,15
1650025171713,MATH 120A,A01,085445,Eggers; John Dietrich,10,0,35,25
1650025171713,MATH 120A,A02,085446,Eggers; John Dietrich,27,0,35,8
1650025177747,MATH 142B,A01,084149,Verstraete; Jacques Allan,0,12,30,30
1650025177747,MATH 142B,A02,084150,Verstraete; Jacques Allan,0,12,30,30
1650025183776,MATH 170A,A01,083459,Nie; Jiawang,0,9,30,30
1650025183776,MATH 170A,A02,083460,Nie; Jiawang,0,8,30,30
1650025183776,MATH 170A,A03,083461,Nie; Jiawang,0,9,30,30
1650025189806,MATH 193B,A01,083463,Staff,1,0,30,29
1650025189806,MATH 193B,A02,083464,Staff,9,0,30,21
1650025189806,MATH 193B,A03,083465,Staff,18,0,30,12
1650025195891,COGS 2,A01,083966,Boyle; Mary E. T.,9,0,30,21
1650025201930,COGS 9,A01,083968,Staff,9,0,60,51
1650025207968,COGS 14B,A01,083970,Staff,9,0,50,41
1650025213996,COGS 17,A01,092679,Staff,50,0,75,25
1650025220027,COGS 100,A01,083972,Staff,0,15,60,60
1650025232086,COGS 101C,A01,083976,Staff,12,0,30,18
1650025238115,COGS 102A,A01,083978,Johnson; Christine M.,14,0,30,16
1650025244145,COGS 107B,A01,083980,Staff,0,7,50,50
1650025250177,COGS 115,A01,083982,Staff,10,0,30,20
1650025256204,COGS 118B,A01,083367,Staff,0,15,40,40
1650025262250,COGS 172,A01,083984,Provenzano; Emily Kara,15,0,30,15
1650025268279,COGS 177,A00,083368,Staff,0,20,30,30
1650025274303,COGS 186,A01,083986,Staff,21,0,40,19
1650025280333,COGS 187A,A01,083988,Boyle; Mary E. T.,20,0,60,40
1650025286365,CSE 8A,A50,084003,Miranda; Gregory Joseph,0,13,15,15
1650025292390,CSE 11,A01,084005,Miranda; Gregory Joseph,0,22,55,55
1650025298418,CSE 20,A01,084007,Staff,0,5,20,20
1650025304450,CSE 21,A01,084009,Staff,0,30,50,50
1650025310477,CSE 30,A01,083370,Cao; Yingjun,0,65,40,40
1650025316507,CSE 100,A01,083372,Cao; Yingjun,0,46,40,40
1650025322543,CSE 101,A01,084011,Staff,0,54,40,40
1650025328571,CSE 141,A01,083374,Eldon; John,0,64,75,75
1650025334597,CSE 141L,A01,083376,Eldon; John,0,70,75,75
1650025340629,CSE 175,A01,084013,Kumar; Rakesh,22,0,25,3
1650025346662,CSE 190,A00,092508,Dubnov; Shlomo,20,0,20,0
1650025352694,ECE 5,A01,084049,Morris; Karcher William,13,0,20,7
1650025358722,ECE 100,A01,084051,Baghdadchi; Saharnaz,0,0,20,20
1650025358722,ECE 100,A02,091916,Baghdadchi; Saharnaz,13,0,20,7
1650025364749,ECE 101,A01,084053,Baghdadchi; Saharnaz,0,0,37,37
1650025364749,ECE 101,A02,084054,Baghdadchi; Saharnaz,30,0,37,7
1650025370784,ECE 107,A01,083390,Staff,26,0,40,14
1650025376819,ECE 148,A01,084056,Silberman; Jack,8,0,12,4
1650025382860,ECE 180,A00,083391,Abi Samra; Nicholas Camill,25,0,30,5
1650025382860,ECE 180,B00,083392,Abi Samra; Nicholas Camill,21,0,30,9
1650025388901,MATH 10B,A01,084110,Staff,0,0,30,30
1650025388901,MATH 10B,A02,084111,Staff,18,0,30,12
1650025388901,MATH 10B,A03,084112,Staff,24,0,30,6
1650025394928,MATH 10C,A01,083443,Staff,0,16,30,30
1650025394928,MATH 10C,A02,083444,Staff,0,15,30,30
1650025394928,MATH 10C,B01,084114,Staff,19,0,30,11
1650025394928,MATH 10C,B02,084115,Staff,25,0,30,5
1650025400956,MATH 18,A01,084117,Harel; Guershon,14,0,30,16
1650025400956,MATH 18,A02,084119,Harel; Guershon,28,0,30,2
1650025400956,MATH 18,A03,084120,Harel; Guershon,29,0,30,1
1650025400956,MATH 18,A04,084121,Harel; Guershon,29,0,30,1
1650025406983,MATH 20B,A01,084124,Um; Ko Woon,16,0,35,19
1650025406983,MATH 20B,B01,084126,Um; Ko Woon,24,0,35,11
1650025413007,MATH 20C,A01,083446,Hammock; Frances H,0,0,30,30
1650025413007,MATH 20C,A02,083447,Hammock; Frances H,16,0,30,14
1650025413007,MATH 20C,A03,083448,Hammock; Frances H,19,0,30,11
1650025413007,MATH 20C,A04,083449,Hammock; Frances H,20,0,30,10
1650025413007,MATH 20C,B01,083451,Hammock; Frances H,0,0,30,30
1650025413007,MATH 20C,B02,083452,Hammock; Frances H,19,0,30,11
1650025413007,MATH 20C,B03,083453,Hammock; Frances H,21,0,30,9
1650025413007,MATH 20C,B04,083454,Hammock; Frances H,23,0,30,7
1650025419053,MATH 20D,A01,084128,Staff,14,0,30,16
1650025419053,MATH 20D,A02,084129,Staff,29,0,30,1
1650025419053,MATH 20D,A03,084130,Staff,27,0,30,3
1650025419053,MATH 20D,B01,084133,Staff,3,0,30,27
1650025419053,MATH 20D,B02,084134,Staff,24,0,30,6
1650025419053,MATH 20D,B03,084135,Staff,28,0,30,2
1650025425080,MATH 20E,A01,084138,Staff,14,0,30,16
1650025425080,MATH 20E,A02,084139,Staff,6,0,30,24
1650025425080,MATH 20E,A03,084140,Staff,15,0,30,15
1650025425080,MATH 20E,A04,084141,Staff,20,0,30,10
1650025431116,MATH 102,A01,084143,Harel; Guershon,12,0,30,18
1650025431116,MATH 102,A02,084144,Harel; Guershon,19,0,30,11
1650025437145,MATH 103B,A01,083456,Staff,0,13,30,30
1650025437145,MATH 103B,A02,083457,Staff,0,14,30,30
1650025443173,MATH 109,A01,084146,Salehi Golsefidy; Alireza,18,0,30,12
1650025443173,MATH 109,A02,084147,Salehi Golsefidy; Alireza,15,0,30,15
1650025449207,MATH 120A,A01,085445,Eggers; John Dietrich,10,0,35,25
1650025449207,MATH 120A,A02,085446,Eggers; John Dietrich,27,0,35,8
1650025455233,MATH 142B,A01,084149,Verstraete; Jacques Allan,0,12,30,30
1650025455233,MATH 142B,A02,084150,Verstraete; Jacques Allan,0,12,30,30
1650025461264,MATH 170A,A01,083459,Nie; Jiawang,0,9,30,30
1650025461264,MATH 170A,A02,083460,Nie; Jiawang,0,8,30,30
1650025461264,MATH 170A,A03,083461,Nie; Jiawang,0,9,30,30
1650025467290,MATH 193B,A01,083463,Staff,1,0,30,29
1650025467290,MATH 193B,A02,083464,Staff,9,0,30,21
1650025467290,MATH 193B,A03,083465,Staff,18,0,30,12
1650025473370,COGS 2,A01,083966,Boyle; Mary E. T.,9,0,30,21
1650025479397,COGS 9,A01,083968,Staff,9,0,60,51
1650025485426,COGS 14B,A01,083970,Staff,9,0,50,41
1650025491460,COGS 17,A01,092679,Staff,50,0,75,25
1650025497491,COGS 100,A01,083972,Staff,0,15,60,60
1650025509565,COGS 101C,A01,083976,Staff,12,0,30,18
1650025515661,COGS 102A,A01,083978,Johnson; Christine M.,14,0,30,16
1650025521692,COGS 107B,A01,083980,Staff,0,7,50,50
1650025527718,COGS 115,A01,083982,Staff,10,0,30,20
1650025533748,COGS 118B,A01,083367,Staff,0,15,40,40
1650025539798,COGS 172,A01,083984,Provenzano; Emily Kara,15,0,30,15
1650025545823,COGS 177,A00,083368,Staff,0,20,30,30
1650025551851,COGS 186,A01,083986,Staff,21,0,40,19
1650025557894,COGS 187A,A01,083988,Boyle; Mary E. T.,20,0,60,40
1650025563922,CSE 8A,A50,084003,Miranda; Gregory Joseph,0,13,15,15
1650025569956,CSE 11,A01,084005,Miranda; Gregory Joseph,0,22,55,55
1650025575982,CSE 20,A01,084007,Staff,0,5,20,20
1650025582013,CSE 21,A01,084009,Staff,0,30,50,50
1650025588048,CSE 30,A01,083370,Cao; Yingjun,0,65,40,40
1650025594078,CSE 100,A01,083372,Cao; Yingjun,0,46,40,40
1650025600107,CSE 101,A01,084011,Staff,0,54,40,40
1650025606150,CSE 141,A01,083374,Eldon; John,0,64,75,75
1650025612178,CSE 141L,A01,083376,Eldon; John,0,70,75,75
1650025618211,CSE 175,A01,084013,Kumar; Rakesh,22,0,25,3
1650025624241,CSE 190,A00,092508,Dubnov; Shlomo,20,0,20,0
1650025630271,ECE 5,A01,084049,Morris; Karcher William,13,0,20,7
1650025636305,ECE 100,A01,084051,Baghdadchi; Saharnaz,0,0,20,20
1650025636305,ECE 100,A02,091916,Baghdadchi; Saharnaz,13,0,20,7
1650025642333,ECE 101,A01,084053,Baghdadchi; Saharnaz,0,0,37,37
1650025642333,ECE 101,A02,084054,Baghdadchi; Saharnaz,30,0,37,7
1650025648364,ECE 107,A01,083390,Staff,26,0,40,14
1650025654391,ECE 148,A01,084056,Silberman; Jack,8,0,12,4
1650025660416,ECE 180,A00,083391,Abi Samra; Nicholas Camill,25,0,30,5
1650025660416,ECE 180,B00,083392,Abi Samra; Nicholas Camill,21,0,30,9
1650025666451,MATH 10B,A01,084110,Staff,0,0,30,30
1650025666451,MATH 10B,A02,084111,Staff,18,0,30,12
1650025666451,MATH 10B,A03,084112,Staff,24,0,30,6
1650025672483,MATH 10C,A01,083443,Staff,0,16,30,30
1650025672483,MATH 10C,A02,083444,Staff,0,15,30,30
1650025672483,MATH 10C,B01,084114,Staff,19,0,30,11
1650025672483,MATH 10C,B02,084115,Staff,25,0,30,5
1650025678520,MATH 18,A01,084117,Harel; Guershon,14,0,30,16
1650025678520,MATH 18,A02,084119,Harel; Guershon,28,0,30,2
1650025678520,MATH 18,A03,084120,Harel; Guershon,29,0,30,1
1650025678520,MATH 18,A04,084121,Harel; Guershon,29,0,30,1
1650025684560,MATH 20B,A01,084124,Um; Ko Woon,16,0,35,19
1650025684560,MATH 20B,B01,084126,Um; Ko Woon,24,0,35,11
1650025690589,MATH 20C,A01,083446,Hammock; Frances H,0,0,30,30
1650025690589,MATH 20C,A02,083447,Hammock; Frances H,16,0,30,14
1650025690589,MATH 20C,A03,083448,Hammock; Frances H,19,0,30,11
1650025690589,MATH 20C,A04,083449,Hammock; Frances H,20,0,30,10
1650025690589,MATH 20C,B01,083451,Hammock; Frances H,0,0,30,30
1650025690589,MATH 20C,B02,083452,Hammock; Frances H,19,0,30,11
1650025690589,MATH 20C,B03,083453,Hammock; Frances H,21,0,30,9
1650025690589,MATH 20C,B04,083454,Hammock; Frances H,23,0,30,7
1650025696622,MATH 20D,A01,084128,Staff,14,0,30,16
1650025696622,MATH 20D,A02,084129,Staff,29,0,30,1
1650025696622,MATH 20D,A03,084130,Staff,27,0,30,3
1650025696622,MATH 20D,B01,084133,Staff,3,0,30,27
1650025696622,MATH 20D,B02,084134,Staff,24,0,30,6
1650025696622,MATH 20D,B03,084135,Staff,28,0,30,2
1650025702721,MATH 20E,A01,084138,Staff,14,0,30,16
1650025702721,MATH 20E,A02,084139,Staff,6,0,30,24
1650025702721,MATH 20E,A03,084140,Staff,15,0,30,15
1650025702721,MATH 20E,A04,084141,Staff,20,0,30,10
1650025708746,MATH 102,A01,084143,Harel; Guershon,12,0,30,18
1650025708746,MATH 102,A02,084144,Harel; Guershon,19,0,30,11
1650025714773,MATH 103B,A01,083456,Staff,0,13,30,30
1650025714773,MATH 103B,A02,083457,Staff,0,14,30,30
1650025720807,MATH 109,A01,084146,Salehi Golsefidy; Alireza,18,0,30,12
1650025720807,MATH 109,A02,084147,Salehi Golsefidy; Alireza,15,0,30,15
1650025726836,MATH 120A,A01,085445,Eggers; John Dietrich,10,0,35,25
1650025726836,MATH 120A,A02,085446,Eggers; John Dietrich,27,0,35,8
1650025732865,MATH 142B,A01,084149,Verstraete; Jacques Allan,0,12,30,30
1650025732865,MATH 142B,A02,084150,Verstraete; Jacques Allan,0,12,30,30
1650025738905,MATH 170A,A01,083459,Nie; Jiawang,0,9,30,30
1650025738905,MATH 170A,A02,083460,Nie; Jiawang,0,8,30,30
1650025738905,MATH 170A,A03,083461,Nie; Jiawang,0,9,30,30
1650025744933,MATH 193B,A01,083463,Staff,1,0,30,29
1650025744933,MATH 193B,A02,083464,Staff,9,0,30,21
1650025744933,MATH 193B,A03,083465,Staff,18,0,30,12
1650025751021,COGS 2,A01,083966,Boyle; Mary E. T.,9,0,30,21
1650025757047,COGS 9,A01,083968,Staff,9,0,60,51
1650025763072,COGS 14B,A01,083970,Staff,9,0,50,41
1650025769099,COGS 17,A01,092679,Staff,50,0,75,25
1650025775131,COGS 100,A01,083972,Staff,0,15,60,60
1650025787183,COGS 101C,A01,083976,Staff,12,0,30,18
1650025793210,COGS 102A,A01,083978,Johnson; Christine M.,14,0,30,16
1650025799237,COGS 107B,A01,083980,Staff,0,7,50,50
1650025805262,COGS 115,A01,083982,Staff,10,0,30,20
1650025811303,COGS 118B,A01,083367,Staff,0,15,40,40
1650025817337,COGS 172,A01,083984,Provenzano; Emily Kara,15,0,30,15
1650025823377,COGS 177,A00,083368,Staff,0,20,30,30
1650025829403,COGS 186,A01,083986,Staff,21,0,40,19
1650025835438,COGS 187A,A01,083988,Boyle; Mary E. T.,20,0,60,40
1650025841473,CSE 8A,A50,084003,Miranda; Gregory Joseph,0,13,15,15
1650025847499,CSE 11,A01,084005,Miranda; Gregory Joseph,0,22,55,55
1650025853524,CSE 20,A01,084007,Staff,0,5,20,20
1650025859562,CSE 21,A01,084009,Staff,0,30,50,50
1650025865588,CSE 30,A01,083370,Cao; Yingjun,0,65,40,40
1650025871625,CSE 100,A01,083372,Cao; Yingjun,0,46,40,40
1650025877664,CSE 101,A01,084011,Staff,0,54,40,40
1650025883695,CSE 141,A01,083374,Eldon; John,0,64,75,75
1650025889722,CSE 141L,A01,083376,Eldon; John,0,70,75,75
1650025895765,CSE 175,A01,084013,Kumar; Rakesh,22,0,25,3
1650025901794,CSE 190,A00,092508,Dubnov; Shlomo,20,0,20,0
1650025907829,ECE 5,A01,084049,Morris; Karcher William,13,0,20,7
1650025913856,ECE 100,A01,084051,Baghdadchi; Saharnaz,0,0,20,20
1650025913856,ECE 100,A02,091916,Baghdadchi; Saharnaz,13,0,20,7
1650025919887,ECE 101,A01,084053,Baghdadchi; Saharnaz,0,0,37,37
1650025919887,ECE 101,A02,084054,Baghdadchi; Saharnaz,30,0,37,7
1650025925911,ECE 107,A01,083390,Staff,26,0,40,14
1650025931952,ECE 148,A01,084056,Silberman; Jack,8,0,12,4
1650025937991,ECE 180,A00,083391,Abi Samra; Nicholas Camill,25,0,30,5
1650025937991,ECE 180,B00,083392,Abi Samra; Nicholas Camill,21,0,30,9
1650025944028,MATH 10B,A01,084110,Staff,0,0,30,30
1650025944028,MATH 10B,A02,084111,Staff,18,0,30,12
1650025944028,MATH 10B,A03,084112,Staff,24,0,30,6
1650025950054,MATH 10C,A01,083443,Staff,0,16,30,30
1650025950054,MATH 10C,A02,083444,Staff,0,15,30,30
1650025950054,MATH 10C,B01,084114,Staff,19,0,30,11
1650025950054,MATH 10C,B02,084115,Staff,25,0,30,5
1650025956081,MATH 18,A01,084117,Harel; Guershon,14,0,30,16
1650025956081,MATH 18,A02,084119,Harel; Guershon,28,0,30,2
1650025956081,MATH 18,A03,084120,Harel; Guershon,29,0,30,1
1650025956081,MATH 18,A04,084121,Harel; Guershon,29,0,30,1
1650025962115,MATH 20B,A01,084124,Um; Ko Woon,16,0,35,19
1650025962115,MATH 20B,B01,084126,Um; Ko Woon,24,0,35,11
1650025968144,MATH 20C,A01,083446,Hammock; Frances H,0,0,30,30
1650025968144,MATH 20C,A02,083447,Hammock; Frances H,16,0,30,14
1650025968144,MATH 20C,A03,083448,Hammock; Frances H,19,0,30,11
1650025968144,MATH 20C,A04,083449,Hammock; Frances H,20,0,30,10
1650025968144,MATH 20C,B01,083451,Hammock; Frances H,0,0,30,30
1650025968144,MATH 20C,B02,083452,Hammock; Frances H,19,0,30,11
1650025968144,MATH 20C,B03,083453,Hammock; Frances H,21,0,30,9
1650025968144,MATH 20C,B04,083454,Hammock; Frances H,23,0,30,7
1650025974175,MATH 20D,A01,084128,Staff,14,0,30,16
1650025974175,MATH 20D,A02,084129,Staff,29,0,30,1
1650025974175,MATH 20D,A03,084130,Staff,27,0,30,3
1650025974175,MATH 20D,B01,084133,Staff,3,0,30,27
1650025974175,MATH 20D,B02,084134,Staff,24,0,30,6
1650025974175,MATH 20D,B03,084135,Staff,28,0,30,2
1650025980207,MATH 20E,A01,084138,Staff,14,0,30,16
1650025980207,MATH 20E,A02,084139,Staff,6,0,30,24
1650025980207,MATH 20E,A03,084140,Staff,15,0,30,15
1650025980207,MATH 20E,A04,084141,Staff,20,0,30,10
1650025986233,MATH 102,A01,084143,Harel; Guershon,12,0,30,18
1650025986233,MATH 102,A02,084144,Harel; Guershon,19,0,30,11
1650025992264,MATH 103B,A01,083456,Staff,0,13,30,30
1650025992264,MATH 103B,A02,083457,Staff,0,14,30,30
1650025998291,MATH 109,A01,084146,Salehi Golsefidy; Alireza,18,0,30,12
1650025998291,MATH 109,A02,084147,Salehi Golsefidy; Alireza,15,0,30,15
1650026004330,MATH 120A,A01,085445,Eggers; John Dietrich,10,0,35,25
1650026004330,MATH 120A,A02,085446,Eggers; John Dietrich,27,0,35,8
1650026010372,MATH 142B,A01,084149,Verstraete; Jacques Allan,0,12,30,30
1650026010372,MATH 142B,A02,084150,Verstraete; Jacques Allan,0,12,30,30
1650026016397,MATH 170A,A01,083459,Nie; Jiawang,0,9,30,30
1650026016397,MATH 170A,A02,083460,Nie; Jiawang,0,8,30,30
1650026016397,MATH 170A,A03,083461,Nie; Jiawang,0,9,30,30
1650026022428,MATH 193B,A01,083463,Staff,1,0,30,29
1650026022428,MATH 193B,A02,083464,Staff,9,0,30,21
1650026022428,MATH 193B,A03,083465,Staff,18,0,30,12
1650026028514,COGS 2,A01,083966,Boyle; Mary E. T.,9,0,30,21
1650026034540,COGS 9,A01,083968,Staff,9,0,60,51
1650026040566,COGS 14B,A01,083970,Staff,9,0,50,41
1650026046595,COGS 17,A01,092679,Staff,50,0,75,25
1650026052632,COGS 100,A01,083972,Staff,0,15,60,60
1650026064687,COGS 101C,A01,083976,Staff,12,0,30,18
1650026070720,COGS 102A,A01,083978,Johnson; Christine M.,14,0,30,16
1650026076757,COGS 107B,A01,083980,Staff,0,7,50,50
1650026082791,COGS 115,A01,083982,Staff,10,0,30,20
1650026088820,COGS 118B,A01,083367,Staff,0,15,40,40
1650026094852,COGS 172,A01,083984,Provenzano; Emily Kara,15,0,30,15
1650026100878,COGS 177,A00,083368,Staff,0,20,30,30
1650026106906,COGS 186,A01,083986,Staff,21,0,40,19
1650026112937,COGS 187A,A01,083988,Boyle; Mary E. T.,20,0,60,40
1650026118970,CSE 8A,A50,084003,Miranda; Gregory Joseph,0,13,15,15
1650026124996,CSE 11,A01,084005,Miranda; Gregory Joseph,0,22,55,55
1650026131022,CSE 20,A01,084007,Staff,0,5,20,20
1650026137058,CSE 21,A01,084009,Staff,0,30,50,50
1650026143102,CSE 30,A01,083370,Cao; Yingjun,0,65,40,40
1650026149127,CSE 100,A01,083372,Cao; Yingjun,0,46,40,40
1650026155153,CSE 101,A01,084011,Staff,0,54,40,40
1650026161183,CSE 141,A01,083374,Eldon; John,0,64,75,75
1650026167209,CSE 141L,A01,083376,Eldon; John,0,70,75,75
1650026173240,CSE 175,A01,084013,Kumar; Rakesh,22,0,25,3
1650026179267,CSE 190,A00,092508,Dubnov; Shlomo,20,0,20,0
1650026185301,ECE 5,A01,084049,Morris; Karcher William,13,0,20,7
1650026191333,ECE 100,A01,084051,Baghdadchi; Saharnaz,0,0,20,20
1650026191333,ECE 100,A02,091916,Baghdadchi; Saharnaz,13,0,20,7
1650026197365,ECE 101,A01,084053,Baghdadchi; Saharnaz,0,0,37,37
1650026197365,ECE 101,A02,084054,Baghdadchi; Saharnaz,30,0,37,7
1650026203397,ECE 107,A01,083390,Staff,26,0,40,14
1650026209428,ECE 148,A01,084056,Silberman; Jack,8,0,12,4
1650026215454,ECE 180,A00,083391,Abi Samra; Nicholas Camill,25,0,30,5
1650026215454,ECE 180,B00,083392,Abi Samra; Nicholas Camill,21,0,30,9
1650026221487,MATH 10B,A01,084110,Staff,0,0,30,30
1650026221487,MATH 10B,A02,084111,Staff,18,0,30,12
1650026221487,MATH 10B,A03,084112,Staff,24,0,30,6
1650026227515,MATH 10C,A01,083443,Staff,0,16,30,30
1650026227515,MATH 10C,A02,083444,Staff,0,15,30,30
1650026227515,MATH 10C,B01,084114,Staff,19,0,30,11
1650026227515,MATH 10C,B02,084115,Staff,25,0,30,5
1650026233540,MATH 18,A01,084117,Harel; Guershon,14,0,30,16
1650026233540,MATH 18,A02,084119,Harel; Guershon,28,0,30,2
1650026233540,MATH 18,A03,084120,Harel; Guershon,29,0,30,1
1650026233540,MATH 18,A04,084121,Harel; Guershon,29,0,30,1
1650026239567,MATH 20B,A01,084124,Um; Ko Woon,16,0,35,19
1650026239567,MATH 20B,B01,084126,Um; Ko Woon,24,0,35,11
1650026245600,MATH 20C,A01,083446,Hammock; Frances H,0,0,30,30
1650026245600,MATH 20C,A02,083447,Hammock; Frances H,16,0,30,14
1650026245600,MATH 20C,A03,083448,Hammock; Frances H,19,0,30,11
1650026245600,MATH 20C,A04,083449,Hammock; Frances H,20,0,30,10
1650026245600,MATH 20C,B01,083451,Hammock; Frances H,0,0,30,30
1650026245600,MATH 20C,B02,083452,Hammock; Frances H,19,0,30,11
1650026245600,MATH 20C,B03,083453,Hammock; Frances H,21,0,30,9
1650026245600,MATH 20C,B04,083454,Hammock; Frances H,23,0,30,7
1650026251627,MATH 20D,A01,084128,Staff,14,0,30,16
1650026251627,MATH 20D,A02,084129,Staff,29,0,30,1
1650026251627,MATH 20D,A03,084130,Staff,27,0,30,3
1650026251627,MATH 20D,B01,084133,Staff,3,0,30,27
1650026251627,MATH 20D,B02,084134,Staff,24,0,30,6
1650026251627,MATH 20D,B03,084135,Staff,28,0,30,2
1650026257656,MATH 20E,A01,084138,Staff,14,0,30,16
1650026257656,MATH 20E,A02,084139,Staff,6,0,30,24
1650026257656,MATH 20E,A03,084140,Staff,15,0,30,15
1650026257656,MATH 20E,A04,084141,Staff,20,0,30,10
1650026263687,MATH 102,A01,084143,Harel; Guershon,12,0,30,18
1650026263687,MATH 102,A02,084144,Harel; Guershon,19,0,30,11
1650026269715,MATH 103B,A01,083456,Staff,0,13,30,30
1650026269715,MATH 103B,A02,083457,Staff,0,14,30,30
1650026275746,MATH 109,A01,084146,Salehi Golsefidy; Alireza,18,0,30,12
1650026275746,MATH 109,A02,084147,Salehi Golsefidy; Alireza,15,0,30,15
1650026281774,MATH 120A,A01,085445,Eggers; John Dietrich,10,0,35,25
1650026281774,MATH 120A,A02,085446,Eggers; John Dietrich,27,0,35,8
1650026287803,MATH 142B,A01,084149,Verstraete; Jacques Allan,0,12,30,30
1650026287803,MATH 142B,A02,084150,Verstraete; Jacques Allan,0,12,30,30
1650026293836,MATH 170A,A01,083459,Nie; Jiawang,0,9,30,30
1650026293836,MATH 170A,A02,083460,Nie; Jiawang,0,8,30,30
1650026293836,MATH 170A,A03,083461,Nie; Jiawang,0,9,30,30
1650026299968,MATH 193B,A01,083463,Staff,1,0,30,29
1650026299968,MATH 193B,A02,083464,Staff,9,0,30,21
1650026299968,MATH 193B,A03,083465,Staff,18,0,30,12
1650026306044,COGS 2,A01,083966,Boyle; Mary E. T.,9,0,30,21
1650026312069,COGS 9,A01,083968,Staff,9,0,60,51
1650026318102,COGS 14B,A01,083970,Staff,9,0,50,41
1650026324132,COGS 17,A01,092679,Staff,50,0,75,25
1650026330159,COGS 100,A01,083972,Staff,0,15,60,60
1650026342229,COGS 101C,A01,083976,Staff,12,0,30,18
1650026348255,COGS 102A,A01,083978,Johnson; Christine M.,14,0,30,16
1650026354281,COGS 107B,A01,083980,Staff,0,7,50,50
1650026360309,COGS 115,A01,083982,Staff,10,0,30,20
1650026366335,COGS 118B,A01,083367,Staff,0,15,40,40
1650026372378,COGS 172,A01,083984,Provenzano; Emily Kara,15,0,30,15
1650026378403,COGS 177,A00,083368,Staff,0,20,30,30
1650026384434,COGS 186,A01,083986,Staff,21,0,40,19
1650026390459,COGS 187A,A01,083988,Boyle; Mary E. T.,20,0,60,40
1650026396487,CSE 8A,A50,084003,Miranda; Gregory Joseph,0,13,15,15
1650026402511,CSE 11,A01,084005,Miranda; Gregory Joseph,0,22,55,55
1650026408544,CSE 20,A01,084007,Staff,0,5,20,20
1650026414571,CSE 21,A01,084009,Staff,0,30,50,50
1650026420604,CSE 30,A01,083370,Cao; Yingjun,0,65,40,40
1650026426632,CSE 100,A01,083372,Cao; Yingjun,0,46,40,40
1650026432659,CSE 101,A01,084011,Staff,0,54,40,40
1650026438687,CSE 141,A01,083374,Eldon; John,0,64,75,75
1650026444717,CSE 141L,A01,083376,Eldon; John,0,70,75,75
1650026450747,CSE 175,A01,084013,Kumar; Rakesh,22,0,25,3
1650026456772,CSE 190,A00,092508,Dubnov; Shlomo,20,0,20,0
1650026462798,ECE 5,A01,084049,Morris; Karcher William,13,0,20,7
1650026468829,ECE 100,A01,084051,Baghdadchi; Saharnaz,0,0,20,20
1650026468829,ECE 100,A02,091916,Baghdadchi; Saharnaz,13,0,20,7
1650026474855,ECE 101,A01,084053,Baghdadchi; Saharnaz,0,0,37,37
1650026474855,ECE 101,A02,084054,Baghdadchi; Saharnaz,30,0,37,7
1650026480881,ECE 107,A01,083390,Staff,26,0,40,14
1650026486908,ECE 148,A01,084056,Silberman; Jack,8,0,12,4
1650026492937,ECE 180,A00,083391,Abi Samra; Nicholas Camill,25,0,30,5
1650026492937,ECE 180,B00,083392,Abi Samra; Nicholas Camill,21,0,30,9
1650026498964,MATH 10B,A01,084110,Staff,0,0,30,30
1650026498964,MATH 10B,A02,084111,Staff,18,0,30,12
1650026498964,MATH 10B,A03,084112,Staff,24,0,30,6
1650026504995,MATH 10C,A01,083443,Staff,0,16,30,30
1650026504995,MATH 10C,A02,083444,Staff,0,15,30,30
1650026504995,MATH 10C,B01,084114,Staff,19,0,30,11
1650026504995,MATH 10C,B02,084115,Staff,25,0,30,5
1650026511022,MATH 18,A01,084117,Harel; Guershon,14,0,30,16
1650026511022,MATH 18,A02,084119,Harel; Guershon,28,0,30,2
1650026511022,MATH 18,A03,084120,Harel; Guershon,29,0,30,1
1650026511022,MATH 18,A04,084121,Harel; Guershon,29,0,30,1
1650026517048,MATH 20B,A01,084124,Um; Ko Woon,16,0,35,19
1650026517048,MATH 20B,B01,084126,Um; Ko Woon,24,0,35,11
1650026523078,MATH 20C,A01,083446,Hammock; Frances H,0,0,30,30
1650026523078,MATH 20C,A02,083447,Hammock; Frances H,16,0,30,14
1650026523078,MATH 20C,A03,083448,Hammock; Frances H,19,0,30,11
1650026523078,MATH 20C,A04,083449,Hammock; Frances H,20,0,30,10
1650026523078,MATH 20C,B01,083451,Hammock; Frances H,0,0,30,30
1650026523078,MATH 20C,B02,083452,Hammock; Frances H,19,0,30,11
1650026523078,MATH 20C,B03,083453,Hammock; Frances H,21,0,30,9
1650026523078,MATH 20C,B04,083454,Hammock; Frances H,23,0,30,7
1650026529106,MATH 20D,A01,084128,Staff,14,0,30,16
1650026529106,MATH 20D,A02,084129,Staff,29,0,30,1
1650026529106,MATH 20D,A03,084130,Staff,27,0,30,3
1650026529106,MATH 20D,B01,084133,Staff,3,0,30,27
1650026529106,MATH 20D,B02,084134,Staff,24,0,30,6
1650026529106,MATH 20D,B03,084135,Staff,28,0,30,2
1650026535135,MATH 20E,A01,084138,Staff,14,0,30,16
1650026535135,MATH 20E,A02,084139,Staff,6,0,30,24
1650026535135,MATH 20E,A03,084140,Staff,15,0,30,15
1650026535135,MATH 20E,A04,084141,Staff,20,0,30,10
1650026541164,MATH 102,A01,084143,Harel; Guershon,12,0,30,18
1650026541164,MATH 102,A02,084144,Harel; Guershon,19,0,30,11
1650026547187,MATH 103B,A01,083456,Staff,0,13,30,30
1650026547187,MATH 103B,A02,083457,Staff,0,14,30,30
1650026553218,MATH 109,A01,084146,Salehi Golsefidy; Alireza,17,0,30,13
1650026553218,MATH 109,A02,084147,Salehi Golsefidy; Alireza,15,0,30,15
1650026559241,MATH 120A,A01,085445,Eggers; John Dietrich,10,0,35,25
1650026559241,MATH 120A,A02,085446,Eggers; John Dietrich,27,0,35,8
1650026565270,MATH 142B,A01,084149,Verstraete; Jacques Allan,0,12,30,30
1650026565270,MATH 142B,A02,084150,Verstraete; Jacques Allan,0,12,30,30
1650026571300,MATH 170A,A01,083459,Nie; Jiawang,0,9,30,30
1650026571300,MATH 170A,A02,083460,Nie; Jiawang,0,8,30,30
1650026571300,MATH 170A,A03,083461,Nie; Jiawang,0,9,30,30
1650026577325,MATH 193B,A01,083463,Staff,1,0,30,29
1650026577325,MATH 193B,A02,083464,Staff,9,0,30,21
1650026577325,MATH 193B,A03,083465,Staff,18,0,30,12
1650026583383,COGS 2,A01,083966,Boyle; Mary E. T.,9,0,30,21
1650026589412,COGS 9,A01,083968,Staff,9,0,60,51
1650026595437,COGS 14B,A01,083970,Staff,9,0,50,41
1650026601461,COGS 17,A01,092679,Staff,50,0,75,25
1650026607488,COGS 100,A01,083972,Staff,0,15,60,60
1650026619541,COGS 101C,A01,083976,Staff,12,0,30,18
1650026625574,COGS 102A,A01,083978,Johnson; Christine M.,14,0,30,16
1650026631599,COGS 107B,A01,083980,Staff,0,7,50,50
1650026637627,COGS 115,A01,083982,Staff,10,0,30,20
1650026643652,COGS 118B,A01,083367,Staff,0,15,40,40
1650026649681,COGS 172,A01,083984,Provenzano; Emily Kara,15,0,30,15
1650026655705,COGS 177,A00,083368,Staff,0,20,30,30
1650026661738,COGS 186,A01,083986,Staff,21,0,40,19
1650026667762,COGS 187A,A01,083988,Boyle; Mary E. T.,20,0,60,40
1650026673793,CSE 8A,A50,084003,Miranda; Gregory Joseph,0,13,15,15
1650026679825,CSE 11,A01,084005,Miranda; Gregory Joseph,0,22,55,55
1650026685861,CSE 20,A01,084007,Staff,0,5,20,20
1650026691893,CSE 21,A01,084009,Staff,0,30,50,50
1650026697924,CSE 30,A01,083370,Cao; Yingjun,0,65,40,40
1650026703949,CSE 100,A01,083372,Cao; Yingjun,0,46,40,40
1650026709975,CSE 101,A01,084011,Staff,0,54,40,40
1650026716012,CSE 141,A01,083374,Eldon; John,0,64,75,75
1650026722043,CSE 141L,A01,083376,Eldon; John,0,70,75,75
1650026728067,CSE 175,A01,084013,Kumar; Rakesh,22,0,25,3
1650026734102,CSE 190,A00,092508,Dubnov; Shlomo,20,0,20,0
1650026740136,ECE 5,A01,084049,Morris; Karcher William,13,0,20,7
1650026746181,ECE 100,A01,084051,Baghdadchi; Saharnaz,0,0,20,20
1650026746181,ECE 100,A02,091916,Baghdadchi; Saharnaz,13,0,20,7
1650026752207,ECE 101,A01,084053,Baghdadchi; Saharnaz,0,0,37,37
1650026752207,ECE 101,A02,084054,Baghdadchi; Saharnaz,30,0,37,7
1650026758238,ECE 107,A01,083390,Staff,26,0,40,14
1650026764266,ECE 148,A01,084056,Silberman; Jack,8,0,12,4
1650026770291,ECE 180,A00,083391,Abi Samra; Nicholas Camill,25,0,30,5
1650026770291,ECE 180,B00,083392,Abi Samra; Nicholas Camill,21,0,30,9
1650026776329,MATH 10B,A01,084110,Staff,0,0,30,30
1650026776329,MATH 10B,A02,084111,Staff,18,0,30,12
1650026776329,MATH 10B,A03,084112,Staff,24,0,30,6
1650026782356,MATH 10C,A01,083443,Staff,0,16,30,30
1650026782356,MATH 10C,A02,083444,Staff,0,15,30,30
1650026782356,MATH 10C,B01,084114,Staff,19,0,30,11
1650026782356,MATH 10C,B02,084115,Staff,25,0,30,5
1650026788383,MATH 18,A01,084117,Harel; Guershon,14,0,30,16
1650026788383,MATH 18,A02,084119,Harel; Guershon,28,0,30,2
1650026788383,MATH 18,A03,084120,Harel; Guershon,29,0,30,1
1650026788383,MATH 18,A04,084121,Harel; Guershon,29,0,30,1
1650026794410,MATH 20B,A01,084124,Um; Ko Woon,16,0,35,19
1650026794410,MATH 20B,B01,084126,Um; Ko Woon,24,0,35,11
1650026800448,MATH 20C,A01,083446,Hammock; Frances H,0,0,30,30
1650026800448,MATH 20C,A02,083447,Hammock; Frances H,16,0,30,14
1650026800448,MATH 20C,A03,083448,Hammock; Frances H,19,0,30,11
1650026800448,MATH 20C,A04,083449,Hammock; Frances H,20,0,30,10
1650026800448,MATH 20C,B01,083451,Hammock; Frances H,0,0,30,30
1650026800448,MATH 20C,B02,083452,Hammock; Frances H,19,0,30,11
1650026800448,MATH 20C,B03,083453,Hammock; Frances H,21,0,30,9
1650026800448,MATH 20C,B04,083454,Hammock; Frances H,23,0,30,7
1650026806482,MATH 20D,A01,084128,Staff,14,0,30,16
1650026806482,MATH 20D,A02,084129,Staff,29,0,30,1
1650026806482,MATH 20D,A03,084130,Staff,27,0,30,3
1650026806482,MATH 20D,B01,084133,Staff,3,0,30,27
1650026806482,MATH 20D,B02,084134,Staff,24,0,30,6
1650026806482,MATH 20D,B03,084135,Staff,28,0,30,2
1650026812511,MATH 20E,A01,084138,Staff,14,0,30,16
1650026812511,MATH 20E,A02,084139,Staff,6,0,30,24
1650026812511,MATH 20E,A03,084140,Staff,15,0,30,15
1650026812511,MATH 20E,A04,084141,Staff,20,0,30,10
1650026818542,MATH 102,A01,084143,Harel; Guershon,12,0,30,18
1650026818542,MATH 102,A02,084144,Harel; Guershon,19,0,30,11
1650026824568,MATH 103B,A01,083456,Staff,0,13,30,30
1650026824568,MATH 103B,A02,083457,Staff,0,14,30,30
1650026830603,MATH 109,A01,084146,Salehi Golsefidy; Alireza,17,0,30,13
1650026830603,MATH 109,A02,084147,Salehi Golsefidy; Alireza,15,0,30,15
1650026836632,MATH 120A,A01,085445,Eggers; John Dietrich,10,0,35,25
1650026836632,MATH 120A,A02,085446,Eggers; John Dietrich,27,0,35,8
1650026842658,MATH 142B,A01,084149,Verstraete; Jacques Allan,0,12,30,30
1650026842658,MATH 142B,A02,084150,Verstraete; Jacques Allan,0,12,30,30
1650026848685,MATH 170A,A01,083459,Nie; Jiawang,0,9,30,30
1650026848685,MATH 170A,A02,083460,Nie; Jiawang,0,8,30,30
1650026848685,MATH 170A,A03,083461,Nie; Jiawang,0,9,30,30
1650026854710,MATH 193B,A01,083463,Staff,1,0,30,29
1650026854710,MATH 193B,A02,083464,Staff,9,0,30,21
1650026854710,MATH 193B,A03,083465,Staff,18,0,30,12
1650026860805,COGS 2,A01,083966,Boyle; Mary E. T.,9,0,30,21
1650026866843,COGS 9,A01,083968,Staff,9,0,60,51
1650026872880,COGS 14B,A01,083970,Staff,9,0,50,41
1650026878907,COGS 17,A01,092679,Staff,50,0,75,25
1650026884935,COGS 100,A01,083972,Staff,0,15,60,60
1650026897082,COGS 101C,A01,083976,Staff,12,0,30,18
1650026903109,COGS 102A,A01,083978,Johnson; Christine M.,14,0,30,16
1650026909148,COGS 107B,A01,083980,Staff,0,7,50,50
1650026915185,COGS 115,A01,083982,Staff,10,0,30,20
1650026921221,COGS 118B,A01,083367,Staff,0,15,40,40
1650026927249,COGS 172,A01,083984,Provenzano; Emily Kara,15,0,30,15
1650026933281,COGS 177,A00,083368,Staff,0,20,30,30
1650026939308,COGS 186,A01,083986,Staff,21,0,40,19
1650026945334,COGS 187A,A01,083988,Boyle; Mary E. T.,20,0,60,40
1650026951364,CSE 8A,A50,084003,Miranda; Gregory Joseph,0,13,15,15
1650026957395,CSE 11,A01,084005,Miranda; Gregory Joseph,0,22,55,55
1650026963485,CSE 20,A01,084007,Staff,0,5,20,20
1650026969513,CSE 21,A01,084009,Staff,0,30,50,50
1650026975564,CSE 30,A01,083370,Cao; Yingjun,0,65,40,40
1650026981594,CSE 100,A01,083372,Cao; Yingjun,0,46,40,40
1650026987620,CSE 101,A01,084011,Staff,0,54,40,40
1650026993660,CSE 141,A01,083374,Eldon; John,0,64,75,75
1650026999692,CSE 141L,A01,083376,Eldon; John,0,70,75,75
1650027005725,CSE 175,A01,084013,Kumar; Rakesh,22,0,25,3
1650027011756,CSE 190,A00,092508,Dubnov; Shlomo,20,0,20,0
1650027017806,ECE 5,A01,084049,Morris; Karcher William,13,0,20,7
1650027023832,ECE 100,A01,084051,Baghdadchi; Saharnaz,0,0,20,20
1650027023832,ECE 100,A02,091916,Baghdadchi; Saharnaz,13,0,20,7
1650027029866,ECE 101,A01,084053,Baghdadchi; Saharnaz,0,0,37,37
1650027029866,ECE 101,A02,084054,Baghdadchi; Saharnaz,30,0,37,7
1650027035896,ECE 107,A01,083390,Staff,26,0,40,14
1650027041927,ECE 148,A01,084056,Silberman; Jack,8,0,12,4
1650027047955,ECE 180,A00,083391,Abi Samra; Nicholas Camill,25,0,30,5
1650027047955,ECE 180,B00,083392,Abi Samra; Nicholas Camill,21,0,30,9
1650027053987,MATH 10B,A01,084110,Staff,0,0,30,30
1650027053987,MATH 10B,A02,084111,Staff,18,0,30,12
1650027053987,MATH 10B,A03,084112,Staff,24,0,30,6
1650027060020,MATH 10C,A01,083443,Staff,0,16,30,30
1650027060020,MATH 10C,A02,083444,Staff,0,15,30,30
1650027060020,MATH 10C,B01,084114,Staff,19,0,30,11
1650027060020,MATH 10C,B02,084115,Staff,25,0,30,5
1650027066054,MATH 18,A01,084117,Harel; Guershon,14,0,30,16
1650027066054,MATH 18,A02,084119,Harel; Guershon,28,0,30,2
1650027066054,MATH 18,A03,084120,Harel; Guershon,29,0,30,1
1650027066054,MATH 18,A04,084121,Harel; Guershon,29,0,30,1
1650027072082,MATH 20B,A01,084124,Um; Ko Woon,16,0,35,19
1650027072082,MATH 20B,B01,084126,Um; Ko Woon,24,0,35,11
1650027078120,MATH 20C,A01,083446,Hammock; Frances H,0,0,30,30
1650027078120,MATH 20C,A02,083447,Hammock; Frances H,16,0,30,14
1650027078120,MATH 20C,A03,083448,Hammock; Frances H,19,0,30,11
1650027078120,MATH 20C,A04,083449,Hammock; Frances H,20,0,30,10
1650027078120,MATH 20C,B01,083451,Hammock; Frances H,0,0,30,30
1650027078120,MATH 20C,B02,083452,Hammock; Frances H,19,0,30,11
1650027078120,MATH 20C,B03,083453,Hammock; Frances H,21,0,30,9
1650027078120,MATH 20C,B04,083454,Hammock; Frances H,23,0,30,7
1650027084152,MATH 20D,A01,084128,Staff,14,0,30,16
1650027084152,MATH 20D,A02,084129,Staff,29,0,30,1
1650027084152,MATH 20D,A03,084130,Staff,27,0,30,3
1650027084152,MATH 20D,B01,084133,Staff,3,0,30,27
1650027084152,MATH 20D,B02,084134,Staff,24,0,30,6
1650027084152,MATH 20D,B03,084135,Staff,28,0,30,2
1650027090182,MATH 20E,A01,084138,Staff,14,0,30,16
1650027090182,MATH 20E,A02,084139,Staff,6,0,30,24
1650027090182,MATH 20E,A03,084140,Staff,15,0,30,15
1650027090182,MATH 20E,A04,084141,Staff,20,0,30,10
1650027096207,MATH 102,A01,084143,Harel; Guershon,12,0,30,18
1650027096207,MATH 102,A02,084144,Harel; Guershon,19,0,30,11
1650027102232,MATH 103B,A01,083456,Staff,0,13,30,30
1650027102232,MATH 103B,A02,083457,Staff,0,14,30,30
1650027108260,MATH 109,A01,084146,Salehi Golsefidy; Alireza,17,0,30,13
1650027108260,MATH 109,A02,084147,Salehi Golsefidy; Alireza,15,0,30,15
1650027114299,MATH 120A,A01,085445,Eggers; John Dietrich,10,0,35,25
1650027114299,MATH 120A,A02,085446,Eggers; John Dietrich,27,0,35,8
1650027120333,MATH 142B,A01,084149,Verstraete; Jacques Allan,0,12,30,30
1650027120333,MATH 142B,A02,084150,Verstraete; Jacques Allan,0,12,30,30
1650027126371,MATH 170A,A01,083459,Nie; Jiawang,0,9,30,30
1650027126371,MATH 170A,A02,083460,Nie; Jiawang,0,8,30,30
1650027126371,MATH 170A,A03,083461,Nie; Jiawang,0,9,30,30
1650027132397,MATH 193B,A01,083463,Staff,1,0,30,29
1650027132397,MATH 193B,A02,083464,Staff,9,0,30,21
1650027132397,MATH 193B,A03,083465,Staff,18,0,30,12
1650027138465,COGS 2,A01,083966,Boyle; Mary E. T.,9,0,30,21
1650027144494,COGS 9,A01,083968,Staff,9,0,60,51
1650027150535,COGS 14B,A01,083970,Staff,9,0,50,41
1650027156563,COGS 17,A01,092679,Staff,50,0,75,25
1650027162588,COGS 100,A01,083972,Staff,0,15,60,60
1650027174662,COGS 101C,A01,083976,Staff,12,0,30,18
1650027180686,COGS 102A,A01,083978,Johnson; Christine M.,14,0,30,16
1650027186722,COGS 107B,A01,083980,Staff,0,7,50,50
1650027192750,COGS 115,A01,083982,Staff,10,0,30,20
1650027198777,COGS 118B,A01,083367,Staff,0,15,40,40
1650027204807,COGS 172,A01,083984,Provenzano; Emily Kara,15,0,30,15
1650027210832,COGS 177,A00,083368,Staff,0,20,30,30
1650027216863,COGS 186,A01,083986,Staff,21,0,40,19
1650027222891,COGS 187A,A01,083988,Boyle; Mary E. T.,20,0,60,40
1650027228918,CSE 8A,A50,084003,Miranda; Gregory Joseph,0,13,15,15
1650027234949,CSE 11,A01,084005,Miranda; Gregory Joseph,0,22,55,55
1650027240976,CSE 20,A01,084007,Staff,0,5,20,20
1650027247005,CSE 21,A01,084009,Staff,0,30,50,50
1650027253035,CSE 30,A01,083370,Cao; Yingjun,0,65,40,40
1650027259062,CSE 100,A01,083372,Cao; Yingjun,0,46,40,40
1650027265088,CSE 101,A01,084011,Staff,0,54,40,40
1650027271115,CSE 141,A01,083374,Eldon; John,0,64,75,75
1650027277140,CSE 141L,A01,083376,Eldon; John,0,70,75,75
1650027283166,CSE 175,A01,084013,Kumar; Rakesh,22,0,25,3
1650027289209,CSE 190,A00,092508,Dubnov; Shlomo,20,0,20,0
1650027295241,ECE 5,A01,084049,Morris; Karcher William,13,0,20,7
1650027301275,ECE 100,A01,084051,Baghdadchi; Saharnaz,0,0,20,20
1650027301275,ECE 100,A02,091916,Baghdadchi; Saharnaz,13,0,20,7
1650027307309,ECE 101,A01,084053,Baghdadchi; Saharnaz,0,0,37,37
1650027307309,ECE 101,A02,084054,Baghdadchi; Saharnaz,30,0,37,7
1650027313335,ECE 107,A01,083390,Staff,26,0,40,14
1650027319362,ECE 148,A01,084056,Silberman; Jack,8,0,12,4
1650027325387,ECE 180,A00,083391,Abi Samra; Nicholas Camill,25,0,30,5
1650027325387,ECE 180,B00,083392,Abi Samra; Nicholas Camill,21,0,30,9
1650027331424,MATH 10B,A01,084110,Staff,0,0,30,30
1650027331424,MATH 10B,A02,084111,Staff,18,0,30,12
1650027331424,MATH 10B,A03,084112,Staff,24,0,30,6
1650027337460,MATH 10C,A01,083443,Staff,0,16,30,30
1650027337460,MATH 10C,A02,083444,Staff,0,15,30,30
1650027337460,MATH 10C,B01,084114,Staff,19,0,30,11
1650027337460,MATH 10C,B02,084115,Staff,25,0,30,5
1650027343486,MATH 18,A01,084117,Harel; Guershon,14,0,30,16
1650027343486,MATH 18,A02,084119,Harel; Guershon,28,0,30,2
1650027343486,MATH 18,A03,084120,Harel; Guershon,29,0,30,1
1650027343486,MATH 18,A04,084121,Harel; Guershon,29,0,30,1
1650027349512,MATH 20B,A01,084124,Um; Ko Woon,16,0,35,19
1650027349512,MATH 20B,B01,084126,Um; Ko Woon,24,0,35,11
1650027355542,MATH 20C,A01,083446,Hammock; Frances H,0,0,30,30
1650027355542,MATH 20C,A02,083447,Hammock; Frances H,16,0,30,14
1650027355542,MATH 20C,A03,083448,Hammock; Frances H,19,0,30,11
1650027355542,MATH 20C,A04,083449,Hammock; Frances H,20,0,30,10
1650027355542,MATH 20C,B01,083451,Hammock; Frances H,0,0,30,30
1650027355542,MATH 20C,B02,083452,Hammock; Frances H,19,0,30,11
1650027355542,MATH 20C,B03,083453,Hammock; Frances H,21,0,30,9
1650027355542,MATH 20C,B04,083454,Hammock; Frances H,23,0,30,7
1650027361570,MATH 20D,A01,084128,Staff,14,0,30,16
1650027361570,MATH 20D,A02,084129,Staff,29,0,30,1
1650027361570,MATH 20D,A03,084130,Staff,27,0,30,3
1650027361570,MATH 20D,B01,084133,Staff,3,0,30,27
1650027361570,MATH 20D,B02,084134,Staff,24,0,30,6
1650027361570,MATH 20D,B03,084135,Staff,28,0,30,2
1650027367599,MATH 20E,A01,084138,Staff,14,0,30,16
1650027367599,MATH 20E,A02,084139,Staff,6,0,30,24
1650027367599,MATH 20E,A03,084140,Staff,15,0,30,15
1650027367599,MATH 20E,A04,084141,Staff,20,0,30,10
1650027373625,MATH 102,A01,084143,Harel; Guershon,12,0,30,18
1650027373625,MATH 102,A02,084144,Harel; Guershon,19,0,30,11
1650027379650,MATH 103B,A01,083456,Staff,0,13,30,30
1650027379650,MATH 103B,A02,083457,Staff,0,14,30,30
1650027385675,MATH 109,A01,084146,Salehi Golsefidy; Alireza,17,0,30,13
1650027385675,MATH 109,A02,084147,Salehi Golsefidy; Alireza,15,0,30,15
1650027391706,MATH 120A,A01,085445,Eggers; John Dietrich,10,0,35,25
1650027391706,MATH 120A,A02,085446,Eggers; John Dietrich,27,0,35,8
1650027397736,MATH 142B,A01,084149,Verstraete; Jacques Allan,0,12,30,30
1650027397736,MATH 142B,A02,084150,Verstraete; Jacques Allan,0,12,30,30
1650027403773,MATH 170A,A01,083459,Nie; Jiawang,0,9,30,30
1650027403773,MATH 170A,A02,083460,Nie; Jiawang,0,8,30,30
1650027403773,MATH 170A,A03,083461,Nie; Jiawang,0,9,30,30
1650027409799,MATH 193B,A01,083463,Staff,1,0,30,29
1650027409799,MATH 193B,A02,083464,Staff,9,0,30,21
1650027409799,MATH 193B,A03,083465,Staff,18,0,30,12
1650027415862,COGS 2,A01,083966,Boyle; Mary E. T.,9,0,30,21
1650027421888,COGS 9,A01,083968,Staff,9,0,60,51
1650027427918,COGS 14B,A01,083970,Staff,9,0,50,41
1650027433952,COGS 17,A01,092679,Staff,50,0,75,25
1650027439981,COGS 100,A01,083972,Staff,0,15,60,60
1650027452032,COGS 101C,A01,083976,Staff,12,0,30,18
1650027458060,COGS 102A,A01,083978,Johnson; Christine M.,14,0,30,16
1650027464084,COGS 107B,A01,083980,Staff,0,7,50,50
1650027470113,COGS 115,A01,083982,Staff,10,0,30,20
1650027476147,COGS 118B,A01,083367,Staff,0,15,40,40
1650027482187,COGS 172,A01,083984,Provenzano; Emily Kara,15,0,30,15
1650027488300,COGS 177,A00,083368,Staff,0,20,30,30
1650027494327,COGS 186,A01,083986,Staff,21,0,40,19
1650027500355,COGS 187A,A01,083988,Boyle; Mary E. T.,20,0,60,40
1650027506386,CSE 8A,A50,084003,Miranda; Gregory Joseph,0,13,15,15
1650027512415,CSE 11,A01,084005,Miranda; Gregory Joseph,0,22,55,55
1650027518445,CSE 20,A01,084007,Staff,0,5,20,20
1650027524475,CSE 21,A01,084009,Staff,0,30,50,50
1650027530499,CSE 30,A01,083370,Cao; Yingjun,0,65,40,40
1650027536527,CSE 100,A01,083372,Cao; Yingjun,0,46,40,40
1650027542551,CSE 101,A01,084011,Staff,0,54,40,40
1650027548577,CSE 141,A01,083374,Eldon; John,0,64,75,75
1650027554607,CSE 141L,A01,083376,Eldon; John,0,70,75,75
1650027560635,CSE 175,A01,084013,Kumar; Rakesh,22,0,25,3
1650027566663,CSE 190,A00,092508,Dubnov; Shlomo,20,0,20,0
1650027572692,ECE 5,A01,084049,Morris; Karcher William,13,0,20,7
1650027578719,ECE 100,A01,084051,Baghdadchi; Saharnaz,0,0,20,20
1650027578719,ECE 100,A02,091916,Baghdadchi; Saharnaz,13,0,20,7
1650027584750,ECE 101,A01,084053,Baghdadchi; Saharnaz,0,0,37,37
1650027584750,ECE 101,A02,084054,Baghdadchi; Saharnaz,30,0,37,7
1650027590780,ECE 107,A01,083390,Staff,26,0,40,14
1650027596804,ECE 148,A01,084056,Silberman; Jack,8,0,12,4
1650027602845,ECE 180,A00,083391,Abi Samra; Nicholas Camill,25,0,30,5
1650027602845,ECE 180,B00,083392,Abi Samra; Nicholas Camill,21,0,30,9
1650027608873,MATH 10B,A01,084110,Staff,0,0,30,30
1650027608873,MATH 10B,A02,084111,Staff,18,0,30,12
1650027608873,MATH 10B,A03,084112,Staff,24,0,30,6
1650027614901,MATH 10C,A01,083443,Staff,0,16,30,30
1650027614901,MATH 10C,A02,083444,Staff,0,15,30,30
1650027614901,MATH 10C,B01,084114,Staff,19,0,30,11
1650027614901,MATH 10C,B02,084115,Staff,25,0,30,5
1650027620929,MATH 18,A01,084117,Harel; Guershon,14,0,30,16
1650027620929,MATH 18,A02,084119,Harel; Guershon,28,0,30,2
1650027620929,MATH 18,A03,084120,Harel; Guershon,29,0,30,1
1650027620929,MATH 18,A04,084121,Harel; Guershon,29,0,30,1
1650027626960,MATH 20B,A01,084124,Um; Ko Woon,16,0,35,19
1650027626960,MATH 20B,B01,084126,Um; Ko Woon,24,0,35,11
1650027632995,MATH 20C,A01,083446,Hammock; Frances H,0,0,30,30
1650027632995,MATH 20C,A02,083447,Hammock; Frances H,16,0,30,14
1650027632995,MATH 20C,A03,083448,Hammock; Frances H,19,0,30,11
1650027632995,MATH 20C,A04,083449,Hammock; Frances H,20,0,30,10
1650027632995,MATH 20C,B01,083451,Hammock; Frances H,0,0,30,30
1650027632995,MATH 20C,B02,083452,Hammock; Frances H,19,0,30,11
1650027632995,MATH 20C,B03,083453,Hammock; Frances H,21,0,30,9
1650027632995,MATH 20C,B04,083454,Hammock; Frances H,23,0,30,7
1650027639023,MATH 20D,A01,084128,Staff,14,0,30,16
1650027639023,MATH 20D,A02,084129,Staff,29,0,30,1
1650027639023,MATH 20D,A03,084130,Staff,27,0,30,3
1650027639023,MATH 20D,B01,084133,Staff,3,0,30,27
1650027639023,MATH 20D,B02,084134,Staff,24,0,30,6
1650027639023,MATH 20D,B03,084135,Staff,28,0,30,2
1650027645065,MATH 20E,A01,084138,Staff,14,0,30,16
1650027645065,MATH 20E,A02,084139,Staff,6,0,30,24
1650027645065,MATH 20E,A03,084140,Staff,15,0,30,15
1650027645065,MATH 20E,A04,084141,Staff,20,0,30,10
1650027651091,MATH 102,A01,084143,Harel; Guershon,12,0,30,18
1650027651091,MATH 102,A02,084144,Harel; Guershon,19,0,30,11
1650027657120,MATH 103B,A01,083456,Staff,0,13,30,30
1650027657120,MATH 103B,A02,083457,Staff,0,14,30,30
1650027663146,MATH 109,A01,084146,Salehi Golsefidy; Alireza,17,0,30,13
1650027663146,MATH 109,A02,084147,Salehi Golsefidy; Alireza,15,0,30,15
1650027669183,MATH 120A,A01,085445,Eggers; John Dietrich,10,0,35,25
1650027669183,MATH 120A,A02,085446,Eggers; John Dietrich,27,0,35,8
1650027675214,MATH 142B,A01,084149,Verstraete; Jacques Allan,0,12,30,30
1650027675214,MATH 142B,A02,084150,Verstraete; Jacques Allan,0,12,30,30
1650027681243,MATH 170A,A01,083459,Nie; Jiawang,0,9,30,30
1650027681243,MATH 170A,A02,083460,Nie; Jiawang,0,8,30,30
1650027681243,MATH 170A,A03,083461,Nie; Jiawang,0,9,30,30
1650027687267,MATH 193B,A01,083463,Staff,1,0,30,29
1650027687267,MATH 193B,A02,083464,Staff,9,0,30,21
1650027687267,MATH 193B,A03,083465,Staff,18,0,30,12
1650027693326,COGS 2,A01,083966,Boyle; Mary E. T.,9,0,30,21
1650027699354,COGS 9,A01,083968,Staff,9,0,60,51
1650027705380,COGS 14B,A01,083970,Staff,9,0,50,41
1650027711410,COGS 17,A01,092679,Staff,50,0,75,25
1650027717436,COGS 100,A01,083972,Staff,0,15,60,60
1650027729493,COGS 101C,A01,083976,Staff,12,0,30,18
1650027735519,COGS 102A,A01,083978,Johnson; Christine M.,14,0,30,16
1650027741546,COGS 107B,A01,083980,Staff,0,7,50,50
1650027747578,COGS 115,A01,083982,Staff,10,0,30,20
1650027753607,COGS 118B,A01,083367,Staff,0,15,40,40
1650027759638,COGS 172,A01,083984,Provenzano; Emily Kara,15,0,30,15
1650027765663,COGS 177,A00,083368,Staff,0,20,30,30
1650027771695,COGS 186,A01,083986,Staff,21,0,40,19
1650027777719,COGS 187A,A01,083988,Boyle; Mary E. T.,20,0,60,40
1650027783768,CSE 8A,A50,084003,Miranda; Gregory Joseph,0,13,15,15
1650027789793,CSE 11,A01,084005,Miranda; Gregory Joseph,0,22,55,55
1650027795824,CSE 20,A01,084007,Staff,0,5,20,20
1650027801855,CSE 21,A01,084009,Staff,0,30,50,50
1650027807880,CSE 30,A01,083370,Cao; Yingjun,0,65,40,40
1650027813911,CSE 100,A01,083372,Cao; Yingjun,0,46,40,40
1650027819938,CSE 101,A01,084011,Staff,0,54,40,40
1650027825966,CSE 141,A01,083374,Eldon; John,0,64,75,75
1650027831991,CSE 141L,A01,083376,Eldon; John,0,70,75,75
1650027838030,CSE 175,A01,084013,Kumar; Rakesh,22,0,25,3
1650027844068,CSE 190,A00,092508,Dubnov; Shlomo,20,0,20,0
1650027850103,ECE 5,A01,084049,Morris; Karcher William,13,0,20,7
1650027856130,ECE 100,A01,084051,Baghdadchi; Saharnaz,0,0,20,20
1650027856130,ECE 100,A02,091916,Baghdadchi; Saharnaz,13,0,20,7
1650027862162,ECE 101,A01,084053,Baghdadchi; Saharnaz,0,0,37,37
1650027862162,ECE 101,A02,084054,Baghdadchi; Saharnaz,30,0,37,7
1650027868188,ECE 107,A01,083390,Staff,26,0,40,14
1650027874213,ECE 148,A01,084056,Silberman; Jack,8,0,12,4
1650027880240,ECE 180,A00,083391,Abi Samra; Nicholas Camill,25,0,30,5
1650027880240,ECE 180,B00,083392,Abi Samra; Nicholas Camill,21,0,30,9
1650027886267,MATH 10B,A01,084110,Staff,0,0,30,30
1650027886267,MATH 10B,A02,084111,Staff,18,0,30,12
1650027886267,MATH 10B,A03,084112,Staff,24,0,30,6
1650027892293,MATH 10C,A01,083443,Staff,0,16,30,30
1650027892293,MATH 10C,A02,083444,Staff,0,15,30,30
1650027892293,MATH 10C,B01,084114,Staff,19,0,30,11
1650027892293,MATH 10C,B02,084115,Staff,25,0,30,5
1650027898319,MATH 18,A01,084117,Harel; Guershon,14,0,30,16
1650027898319,MATH 18,A02,084119,Harel; Guershon,28,0,30,2
1650027898319,MATH 18,A03,084120,Harel; Guershon,29,0,30,1
1650027898319,MATH 18,A04,084121,Harel; Guershon,29,0,30,1
1650027904345,MATH 20B,A01,084124,Um; Ko Woon,16,0,35,19
1650027904345,MATH 20B,B01,084126,Um; Ko Woon,24,0,35,11
1650027910376,MATH 20C,A01,083446,Hammock; Frances H,0,0,30,30
1650027910376,MATH 20C,A02,083447,Hammock; Frances H,16,0,30,14
1650027910376,MATH 20C,A03,083448,Hammock; Frances H,19,0,30,11
1650027910376,MATH 20C,A04,083449,Hammock; Frances H,20,0,30,10
1650027910376,MATH 20C,B01,083451,Hammock; Frances H,0,0,30,30
1650027910376,MATH 20C,B02,083452,Hammock; Frances H,19,0,30,11
1650027910376,MATH 20C,B03,083453,Hammock; Frances H,21,0,30,9
1650027910376,MATH 20C,B04,083454,Hammock; Frances H,23,0,30,7
1650027916408,MATH 20D,A01,084128,Staff,14,0,30,16
1650027916408,MATH 20D,A02,084129,Staff,29,0,30,1
1650027916408,MATH 20D,A03,084130,Staff,27,0,30,3
1650027916408,MATH 20D,B01,084133,Staff,3,0,30,27
1650027916408,MATH 20D,B02,084134,Staff,24,0,30,6
1650027916408,MATH 20D,B03,084135,Staff,28,0,30,2
1650027922434,MATH 20E,A01,084138,Staff,14,0,30,16
1650027922434,MATH 20E,A02,084139,Staff,6,0,30,24
1650027922434,MATH 20E,A03,084140,Staff,15,0,30,15
1650027922434,MATH 20E,A04,084141,Staff,20,0,30,10
1650027928461,MATH 102,A01,084143,Harel; Guershon,12,0,30,18
1650027928461,MATH 102,A02,084144,Harel; Guershon,19,0,30,11
1650027934485,MATH 103B,A01,083456,Staff,0,13,30,30
1650027934485,MATH 103B,A02,083457,Staff,0,14,30,30
1650027940524,MATH 109,A01,084146,Salehi Golsefidy; Alireza,17,0,30,13
1650027940524,MATH 109,A02,084147,Salehi Golsefidy; Alireza,15,0,30,15
1650027946550,MATH 120A,A01,085445,Eggers; John Dietrich,10,0,35,25
1650027946550,MATH 120A,A02,085446,Eggers; John Dietrich,27,0,35,8
1650027952586,MATH 142B,A01,084149,Verstraete; Jacques Allan,0,12,30,30
1650027952586,MATH 142B,A02,084150,Verstraete; Jacques Allan,0,12,30,30
1650027958623,MATH 170A,A01,083459,Nie; Jiawang,0,9,30,30
1650027958623,MATH 170A,A02,083460,Nie; Jiawang,0,8,30,30
1650027958623,MATH 170A,A03,083461,Nie; Jiawang,0,9,30,30
1650027964651,MATH 193B,A01,083463,Staff,1,0,30,29
1650027964651,MATH 193B,A02,083464,Staff,9,0,30,21
1650027964651,MATH 193B,A03,083465,Staff,18,0,30,12
1650027970723,COGS 2,A01,083966,Boyle; Mary E. T.,9,0,30,21
1650027976753,COGS 9,A01,083968,Staff,9,0,60,51
1650027982780,COGS 14B,A01,083970,Staff,9,0,50,41
1650027988806,COGS 17,A01,092679,Staff,50,0,75,25
1650027994833,COGS 100,A01,083972,Staff,0,15,60,60
1650028006887,COGS 101C,A01,083976,Staff,12,0,30,18
1650028012927,COGS 102A,A01,083978,Johnson; Christine M.,14,0,30,16
1650028018960,COGS 107B,A01,083980,Staff,0,7,50,50
1650028024990,COGS 115,A01,083982,Staff,10,0,30,20
1650028031019,COGS 118B,A01,083367,Staff,0,15,40,40
1650028037048,COGS 172,A01,083984,Provenzano; Emily Kara,15,0,30,15
1650028043076,COGS 177,A00,083368,Staff,0,20,30,30
1650028049111,COGS 186,A01,083986,Staff,21,0,40,19
1650028055148,COGS 187A,A01,083988,Boyle; Mary E. T.,20,0,60,40
1650028061176,CSE 8A,A50,084003,Miranda; Gregory Joseph,0,13,15,15
1650028067204,CSE 11,A01,084005,Miranda; Gregory Joseph,0,22,55,55
1650028073230,CSE 20,A01,084007,Staff,0,5,20,20
1650028079257,CSE 21,A01,084009,Staff,0,30,50,50
1650028085377,CSE 30,A01,083370,Cao; Yingjun,0,65,40,40
1650028091409,CSE 100,A01,083372,Cao; Yingjun,0,46,40,40
1650028097433,CSE 101,A01,084011,Staff,0,54,40,40
1650028103458,CSE 141,A01,083374,Eldon; John,0,64,75,75
1650028109485,CSE 141L,A01,083376,Eldon; John,0,70,75,75
1650028115529,CSE 175,A01,084013,Kumar; Rakesh,22,0,25,3
1650028121561,CSE 190,A00,092508,Dubnov; Shlomo,20,0,20,0
1650028127587,ECE 5,A01,084049,Morris; Karcher William,13,0,20,7
1650028133632,ECE 100,A01,084051,Baghdadchi; Saharnaz,0,0,20,20
1650028133632,ECE 100,A02,091916,Baghdadchi; Saharnaz,13,0,20,7
1650028139667,ECE 101,A01,084053,Baghdadchi; Saharnaz,0,0,37,37
1650028139667,ECE 101,A02,084054,Baghdadchi; Saharnaz,30,0,37,7
1650028145691,ECE 107,A01,083390,Staff,26,0,40,14
1650028151713,ECE 148,A01,084056,Silberman; Jack,8,0,12,4
1650028157743,ECE 180,A00,083391,Abi Samra; Nicholas Camill,25,0,30,5
1650028157743,ECE 180,B00,083392,Abi Samra; Nicholas Camill,21,0,30,9
1650028163778,MATH 10B,A01,084110,Staff,0,0,30,30
1650028163778,MATH 10B,A02,084111,Staff,18,0,30,12
1650028163778,MATH 10B,A03,084112,Staff,24,0,30,6
1650028169804,MATH 10C,A01,083443,Staff,0,16,30,30
1650028169804,MATH 10C,A02,083444,Staff,0,15,30,30
1650028169804,MATH 10C,B01,084114,Staff,19,0,30,11
1650028169804,MATH 10C,B02,084115,Staff,25,0,30,5
1650028175830,MATH 18,A01,084117,Harel; Guershon,14,0,30,16
1650028175830,MATH 18,A02,084119,Harel; Guershon,28,0,30,2
1650028175830,MATH 18,A03,084120,Harel; Guershon,29,0,30,1
1650028175830,MATH 18,A04,084121,Harel; Guershon,29,0,30,1
1650028181865,MATH 20B,A01,084124,Um; Ko Woon,16,0,35,19
1650028181865,MATH 20B,B01,084126,Um; Ko Woon,24,0,35,11
1650028187898,MATH 20C,A01,083446,Hammock; Frances H,0,0,30,30
1650028187898,MATH 20C,A02,083447,Hammock; Frances H,16,0,30,14
1650028187898,MATH 20C,A03,083448,Hammock; Frances H,19,0,30,11
1650028187898,MATH 20C,A04,083449,Hammock; Frances H,20,0,30,10
1650028187898,MATH 20C,B01,083451,Hammock; Frances H,0,0,30,30
1650028187898,MATH 20C,B02,083452,Hammock; Frances H,19,0,30,11
1650028187898,MATH 20C,B03,083453,Hammock; Frances H,21,0,30,9
1650028187898,MATH 20C,B04,083454,Hammock; Frances H,23,0,30,7
1650028193943,MATH 20D,A01,084128,Staff,14,0,30,16
1650028193943,MATH 20D,A02,084129,Staff,29,0,30,1
1650028193943,MATH 20D,A03,084130,Staff,27,0,30,3
1650028193943,MATH 20D,B01,084133,Staff,3,0,30,27
1650028193943,MATH 20D,B02,084134,Staff,24,0,30,6
1650028193943,MATH 20D,B03,084135,Staff,28,0,30,2
1650028199969,MATH 20E,A01,084138,Staff,14,0,30,16
1650028199969,MATH 20E,A02,084139,Staff,6,0,30,24
1650028199969,MATH 20E,A03,084140,Staff,15,0,30,15
1650028199969,MATH 20E,A04,084141,Staff,20,0,30,10
1650028205997,MATH 102,A01,084143,Harel; Guershon,12,0,30,18
1650028205997,MATH 102,A02,084144,Harel; Guershon,19,0,30,11
1650028212024,MATH 103B,A01,083456,Staff,0,13,30,30
1650028212024,MATH 103B,A02,083457,Staff,0,14,30,30
1650028218051,MATH 109,A01,084146,Salehi Golsefidy; Alireza,17,0,30,13
1650028218051,MATH 109,A02,084147,Salehi Golsefidy; Alireza,15,0,30,15
1650028224084,MATH 120A,A01,085445,Eggers; John Dietrich,10,0,35,25
1650028224084,MATH 120A,A02,085446,Eggers; John Dietrich,27,0,35,8
1650028230110,MATH 142B,A01,084149,Verstraete; Jacques Allan,0,12,30,30
1650028230110,MATH 142B,A02,084150,Verstraete; Jacques Allan,0,12,30,30
1650028236147,MATH 170A,A01,083459,Nie; Jiawang,0,9,30,30
1650028236147,MATH 170A,A02,083460,Nie; Jiawang,0,8,30,30
1650028236147,MATH 170A,A03,083461,Nie; Jiawang,0,9,30,30
1650028242173,MATH 193B,A01,083463,Staff,1,0,30,29
1650028242173,MATH 193B,A02,083464,Staff,9,0,30,21
1650028242173,MATH 193B,A03,083465,Staff,18,0,30,12
1650028248247,COGS 2,A01,083966,Boyle; Mary E. T.,9,0,30,21
1650028254288,COGS 9,A01,083968,Staff,9,0,60,51
1650028260325,COGS 14B,A01,083970,Staff,9,0,50,41
1650028266350,COGS 17,A01,092679,Staff,50,0,75,25
1650028272377,COGS 100,A01,083972,Staff,0,15,60,60
1650028284434,COGS 101C,A01,083976,Staff,12,0,30,18
1650028290460,COGS 102A,A01,083978,Johnson; Christine M.,14,0,30,16
1650028296483,COGS 107B,A01,083980,Staff,0,7,50,50
1650028302518,COGS 115,A01,083982,Staff,10,0,30,20
1650028308547,COGS 118B,A01,083367,Staff,0,15,40,40
1650028314588,COGS 172,A01,083984,Provenzano; Emily Kara,15,0,30,15
1650028320617,COGS 177,A00,083368,Staff,0,20,30,30
1650028326663,COGS 186,A01,083986,Staff,21,0,40,19
1650028332693,COGS 187A,A01,083988,Boyle; Mary E. T.,20,0,60,40
1650028338723,CSE 8A,A50,084003,Miranda; Gregory Joseph,0,13,15,15
1650028344748,CSE 11,A01,084005,Miranda; Gregory Joseph,0,22,55,55
1650028350776,CSE 20,A01,084007,Staff,0,5,20,20
1650028356806,CSE 21,A01,084009,Staff,0,30,50,50
1650028362833,CSE 30,A01,083370,Cao; Yingjun,0,65,40,40
1650028368858,CSE 100,A01,083372,Cao; Yingjun,0,46,40,40
1650028374888,CSE 101,A01,084011,Staff,0,54,40,40
1650028380913,CSE 141,A01,083374,Eldon; John,0,64,75,75
1650028386947,CSE 141L,A01,083376,Eldon; John,0,70,75,75
1650028392976,CSE 175,A01,084013,Kumar; Rakesh,22,0,25,3
1650028399002,CSE 190,A00,092508,Dubnov; Shlomo,20,0,20,0
1650028405030,ECE 5,A01,084049,Morris; Karcher William,13,0,20,7
1650028411057,ECE 100,A01,084051,Baghdadchi; Saharnaz,0,0,20,20
1650028411057,ECE 100,A02,091916,Baghdadchi; Saharnaz,13,0,20,7
1650028417086,ECE 101,A01,084053,Baghdadchi; Saharnaz,0,0,37,37
1650028417086,ECE 101,A02,084054,Baghdadchi; Saharnaz,30,0,37,7
1650028423130,ECE 107,A01,083390,Staff,26,0,40,14
1650028429156,ECE 148,A01,084056,Silberman; Jack,8,0,12,4
1650028435184,ECE 180,A00,083391,Abi Samra; Nicholas Camill,25,0,30,5
1650028435184,ECE 180,B00,083392,Abi Samra; Nicholas Camill,21,0,30,9
1650028441220,MATH 10B,A01,084110,Staff,0,0,30,30
1650028441220,MATH 10B,A02,084111,Staff,18,0,30,12
1650028441220,MATH 10B,A03,084112,Staff,24,0,30,6
1650028447247,MATH 10C,A01,083443,Staff,0,16,30,30
1650028447247,MATH 10C,A02,083444,Staff,0,15,30,30
1650028447247,MATH 10C,B01,084114,Staff,19,0,30,11
1650028447247,MATH 10C,B02,084115,Staff,25,0,30,5
1650028453273,MATH 18,A01,084117,Harel; Guershon,14,0,30,16
1650028453273,MATH 18,A02,084119,Harel; Guershon,28,0,30,2
1650028453273,MATH 18,A03,084120,Harel; Guershon,29,0,30,1
1650028453273,MATH 18,A04,084121,Harel; Guershon,29,0,30,1
1650028459301,MATH 20B,A01,084124,Um; Ko Woon,16,0,35,19
1650028459301,MATH 20B,B01,084126,Um; Ko Woon,24,0,35,11
1650028465333,MATH 20C,A01,083446,Hammock; Frances H,0,0,30,30
1650028465333,MATH 20C,A02,083447,Hammock; Frances H,16,0,30,14
1650028465333,MATH 20C,A03,083448,Hammock; Frances H,19,0,30,11
1650028465333,MATH 20C,A04,083449,Hammock; Frances H,20,0,30,10
1650028465333,MATH 20C,B01,083451,Hammock; Frances H,0,0,30,30
1650028465333,MATH 20C,B02,083452,Hammock; Frances H,19,0,30,11
1650028465333,MATH 20C,B03,083453,Hammock; Frances H,21,0,30,9
1650028465333,MATH 20C,B04,083454,Hammock; Frances H,23,0,30,7
1650028471363,MATH 20D,A01,084128,Staff,14,0,30,16
1650028471363,MATH 20D,A02,084129,Staff,29,0,30,1
1650028471363,MATH 20D,A03,084130,Staff,27,0,30,3
1650028471363,MATH 20D,B01,084133,Staff,3,0,30,27
1650028471363,MATH 20D,B02,084134,Staff,24,0,30,6
1650028471363,MATH 20D,B03,084135,Staff,28,0,30,2
1650028477389,MATH 20E,A01,084138,Staff,14,0,30,16
1650028477389,MATH 20E,A02,084139,Staff,6,0,30,24
1650028477389,MATH 20E,A03,084140,Staff,15,0,30,15
1650028477389,MATH 20E,A04,084141,Staff,20,0,30,10
1650028483414,MATH 102,A01,084143,Harel; Guershon,12,0,30,18
1650028483414,MATH 102,A02,084144,Harel; Guershon,19,0,30,11
1650028489441,MATH 103B,A01,083456,Staff,0,13,30,30
1650028489441,MATH 103B,A02,083457,Staff,0,14,30,30
1650028495466,MATH 109,A01,084146,Salehi Golsefidy; Alireza,17,0,30,13
1650028495466,MATH 109,A02,084147,Salehi Golsefidy; Alireza,15,0,30,15
1650028501495,MATH 120A,A01,085445,Eggers; John Dietrich,10,0,35,25
1650028501495,MATH 120A,A02,085446,Eggers; John Dietrich,27,0,35,8
1650028507521,MATH 142B,A01,084149,Verstraete; Jacques Allan,0,12,30,30
1650028507521,MATH 142B,A02,084150,Verstraete; Jacques Allan,0,12,30,30
1650028513549,MATH 170A,A01,083459,Nie; Jiawang,0,9,30,30
1650028513549,MATH 170A,A02,083460,Nie; Jiawang,0,8,30,30
1650028513549,MATH 170A,A03,083461,Nie; Jiawang,0,9,30,30
1650028519581,MATH 193B,A01,083463,Staff,1,0,30,29
1650028519581,MATH 193B,A02,083464,Staff,9,0,30,21
1650028519581,MATH 193B,A03,083465,Staff,18,0,30,12
1650028525675,COGS 2,A01,083966,Boyle; Mary E. T.,9,0,30,21
1650028531701,COGS 9,A01,083968,Staff,9,0,60,51
1650028537724,COGS 14B,A01,083970,Staff,9,0,50,41
1650028543750,COGS 17,A01,092679,Staff,50,0,75,25
1650028549781,COGS 100,A01,083972,Staff,0,15,60,60
1650028561839,COGS 101C,A01,083976,Staff,12,0,30,18
1650028567863,COGS 102A,A01,083978,Johnson; Christine M.,14,0,30,16
1650028573891,COGS 107B,A01,083980,Staff,0,7,50,50
1650028579920,COGS 115,A01,083982,Staff,10,0,30,20
1650028585948,COGS 118B,A01,083367,Staff,0,15,40,40
1650028591974,COGS 172,A01,083984,Provenzano; Emily Kara,15,0,30,15
1650028598010,COGS 177,A00,083368,Staff,0,20,30,30
1650028604038,COGS 186,A01,083986,Staff,21,0,40,19
1650028610061,COGS 187A,A01,083988,Boyle; Mary E. T.,20,0,60,40
1650028616090,CSE 8A,A50,084003,Miranda; Gregory Joseph,0,13,15,15
1650028622118,CSE 11,A01,084005,Miranda; Gregory Joseph,0,22,55,55
1650028628144,CSE 20,A01,084007,Staff,0,5,20,20
1650028634174,CSE 21,A01,084009,Staff,0,30,50,50
1650028640200,CSE 30,A01,083370,Cao; Yingjun,0,65,40,40
1650028646225,CSE 100,A01,083372,Cao; Yingjun,0,46,40,40
1650028652255,CSE 101,A01,084011,Staff,0,54,40,40
1650028658309,CSE 141,A01,083374,Eldon; John,0,64,75,75
1650028664336,CSE 141L,A01,083376,Eldon; John,0,70,75,75
1650028670363,CSE 175,A01,084013,Kumar; Rakesh,22,0,25,3
1650028676394,CSE 190,A00,092508,Dubnov; Shlomo,20,0,20,0
1650028682511,ECE 5,A01,084049,Morris; Karcher William,13,0,20,7
1650028688545,ECE 100,A01,084051,Baghdadchi; Saharnaz,0,0,20,20
1650028688545,ECE 100,A02,091916,Baghdadchi; Saharnaz,13,0,20,7
1650028694569,ECE 101,A01,084053,Baghdadchi; Saharnaz,0,0,37,37
1650028694569,ECE 101,A02,084054,Baghdadchi; Saharnaz,30,0,37,7
1650028700600,ECE 107,A01,083390,Staff,26,0,40,14
1650028706635,ECE 148,A01,084056,Silberman; Jack,8,0,12,4
1650028712663,ECE 180,A00,083391,Abi Samra; Nicholas Camill,25,0,30,5
1650028712663,ECE 180,B00,083392,Abi Samra; Nicholas Camill,21,0,30,9
1650028718694,MATH 10B,A01,084110,Staff,0,0,30,30
1650028718694,MATH 10B,A02,084111,Staff,18,0,30,12
1650028718694,MATH 10B,A03,084112,Staff,24,0,30,6
1650028724733,MATH 10C,A01,083443,Staff,0,16,30,30
1650028724733,MATH 10C,A02,083444,Staff,0,15,30,30
1650028724733,MATH 10C,B01,084114,Staff,19,0,30,11
1650028724733,MATH 10C,B02,084115,Staff,25,0,30,5
1650028730763,MATH 18,A01,084117,Harel; Guershon,14,0,30,16
1650028730763,MATH 18,A02,084119,Harel; Guershon,27,0,30,3
1650028730763,MATH 18,A03,084120,Harel; Guershon,30,0,30,0
1650028730763,MATH 18,A04,084121,Harel; Guershon,29,0,30,1
1650028736802,MATH 20B,A01,084124,Um; Ko Woon,16,0,35,19
1650028736802,MATH 20B,B01,084126,Um; Ko Woon,24,0,35,11
1650028742833,MATH 20C,A01,083446,Hammock; Frances H,0,0,30,30
1650028742833,MATH 20C,A02,083447,Hammock; Frances H,16,0,30,14
1650028742833,MATH 20C,A03,083448,Hammock; Frances H,19,0,30,11
1650028742833,MATH 20C,A04,083449,Hammock; Frances H,20,0,30,10
1650028742833,MATH 20C,B01,083451,Hammock; Frances H,0,0,30,30
1650028742833,MATH 20C,B02,083452,Hammock; Frances H,19,0,30,11
1650028742833,MATH 20C,B03,083453,Hammock; Frances H,21,0,30,9
1650028742833,MATH 20C,B04,083454,Hammock; Frances H,23,0,30,7
1650028748859,MATH 20D,A01,084128,Staff,14,0,30,16
1650028748859,MATH 20D,A02,084129,Staff,29,0,30,1
1650028748859,MATH 20D,A03,084130,Staff,27,0,30,3
1650028748859,MATH 20D,B01,084133,Staff,3,0,30,27
1650028748859,MATH 20D,B02,084134,Staff,24,0,30,6
1650028748859,MATH 20D,B03,084135,Staff,28,0,30,2
1650028754890,MATH 20E,A01,084138,Staff,14,0,30,16
1650028754890,MATH 20E,A02,084139,Staff,6,0,30,24
1650028754890,MATH 20E,A03,084140,Staff,15,0,30,15
1650028754890,MATH 20E,A04,084141,Staff,20,0,30,10
1650028760925,MATH 102,A01,084143,Harel; Guershon,12,0,30,18
1650028760925,MATH 102,A02,084144,Harel; Guershon,19,0,30,11
1650028766954,MATH 103B,A01,083456,Staff,0,13,30,30
1650028766954,MATH 103B,A02,083457,Staff,0,14,30,30
1650028772987,MATH 109,A01,084146,Salehi Golsefidy; Alireza,17,0,30,13
1650028772987,MATH 109,A02,084147,Salehi Golsefidy; Alireza,15,0,30,15
1650028779015,MATH 120A,A01,085445,Eggers; John Dietrich,10,0,35,25
1650028779015,MATH 120A,A02,085446,Eggers; John Dietrich,27,0,35,8
1650028785052,MATH 142B,A01,084149,Verstraete; Jacques Allan,0,12,30,30
1650028785052,MATH 142B,A02,084150,Verstraete; Jacques Allan,0,12,30,30
1650028791077,MATH 170A,A01,083459,Nie; Jiawang,0,9,30,30
1650028791077,MATH 170A,A02,083460,Nie; Jiawang,0,8,30,30
1650028791077,MATH 170A,A03,083461,Nie; Jiawang,0,9,30,30
1650028797103,MATH 193B,A01,083463,Staff,1,0,30,29
1650028797103,MATH 193B,A02,083464,Staff,9,0,30,21
1650028797103,MATH 193B,A03,083465,Staff,18,0,30,12
1650028803173,COGS 2,A01,083966,Boyle; Mary E. T.,9,0,30,21
1650028809200,COGS 9,A01,083968,Staff,9,0,60,51
1650028815225,COGS 14B,A01,083970,Staff,9,0,50,41
1650028821253,COGS 17,A01,092679,Staff,50,0,75,25
1650028827281,COGS 100,A01,083972,Staff,0,15,60,60
1650028839340,COGS 101C,A01,083976,Staff,12,0,30,18
1650028845367,COGS 102A,A01,083978,Johnson; Christine M.,14,0,30,16
1650028851391,COGS 107B,A01,083980,Staff,0,7,50,50
1650028857418,COGS 115,A01,083982,Staff,10,0,30,20
1650028863444,COGS 118B,A01,083367,Staff,0,15,40,40
1650028869471,COGS 172,A01,083984,Provenzano; Emily Kara,15,0,30,15
1650028875514,COGS 177,A00,083368,Staff,0,20,30,30
1650028881539,COGS 186,A01,083986,Staff,21,0,40,19
1650028887565,COGS 187A,A01,083988,Boyle; Mary E. T.,20,0,60,40
1650028893591,CSE 8A,A50,084003,Miranda; Gregory Joseph,0,13,15,15
1650028899624,CSE 11,A01,084005,Miranda; Gregory Joseph,0,22,55,55
1650028905650,CSE 20,A01,084007,Staff,0,5,20,20
1650028911683,CSE 21,A01,084009,Staff,0,30,50,50
1650028917708,CSE 30,A01,083370,Cao; Yingjun,0,65,40,40
1650028923744,CSE 100,A01,083372,Cao; Yingjun,0,46,40,40
1650028929771,CSE 101,A01,084011,Staff,0,54,40,40
1650028935795,CSE 141,A01,083374,Eldon; John,0,64,75,75
1650028941820,CSE 141L,A01,083376,Eldon; John,0,70,75,75
1650028947844,CSE 175,A01,084013,Kumar; Rakesh,22,0,25,3
1650028953883,CSE 190,A00,092508,Dubnov; Shlomo,20,0,20,0
1650028959908,ECE 5,A01,084049,Morris; Karcher William,13,0,20,7
1650028965940,ECE 100,A01,084051,Baghdadchi; Saharnaz,0,0,20,20
1650028965940,ECE 100,A02,091916,Baghdadchi; Saharnaz,13,0,20,7
1650028971969,ECE 101,A01,084053,Baghdadchi; Saharnaz,0,0,37,37
1650028971969,ECE 101,A02,084054,Baghdadchi; Saharnaz,30,0,37,7
1650028977997,ECE 107,A01,083390,Staff,26,0,40,14
1650028984022,ECE 148,A01,084056,Silberman; Jack,8,0,12,4
1650028990070,ECE 180,A00,083391,Abi Samra; Nicholas Camill,25,0,30,5
1650028990070,ECE 180,B00,083392,Abi Samra; Nicholas Camill,21,0,30,9
1650028996101,MATH 10B,A01,084110,Staff,0,0,30,30
1650028996101,MATH 10B,A02,084111,Staff,18,0,30,12
1650028996101,MATH 10B,A03,084112,Staff,24,0,30,6
1650029002126,MATH 10C,A01,083443,Staff,0,16,30,30
1650029002126,MATH 10C,A02,083444,Staff,0,15,30,30
1650029002126,MATH 10C,B01,084114,Staff,19,0,30,11
1650029002126,MATH 10C,B02,084115,Staff,25,0,30,5
1650029008152,MATH 18,A01,084117,Harel; Guershon,14,0,30,16
1650029008152,MATH 18,A02,084119,Harel; Guershon,27,0,30,3
1650029008152,MATH 18,A03,084120,Harel; Guershon,30,0,30,0
1650029008152,MATH 18,A04,084121,Harel; Guershon,29,0,30,1
1650029014177,MATH 20B,A01,084124,Um; Ko Woon,16,0,35,19
1650029014177,MATH 20B,B01,084126,Um; Ko Woon,24,0,35,11
1650029020204,MATH 20C,A01,083446,Hammock; Frances H,0,0,30,30
1650029020204,MATH 20C,A02,083447,Hammock; Frances H,16,0,30,14
1650029020204,MATH 20C,A03,083448,Hammock; Frances H,19,0,30,11
1650029020204,MATH 20C,A04,083449,Hammock; Frances H,20,0,30,10
1650029020204,MATH 20C,B01,083451,Hammock; Frances H,0,0,30,30
1650029020204,MATH 20C,B02,083452,Hammock; Frances H,19,0,30,11
1650029020204,MATH 20C,B03,083453,Hammock; Frances H,21,0,30,9
1650029020204,MATH 20C,B04,083454,Hammock; Frances H,23,0,30,7
1650029026235,MATH 20D,A01,084128,Staff,14,0,30,16
1650029026235,MATH 20D,A02,084129,Staff,29,0,30,1
1650029026235,MATH 20D,A03,084130,Staff,27,0,30,3
1650029026235,MATH 20D,B01,084133,Staff,3,0,30,27
1650029026235,MATH 20D,B02,084134,Staff,24,0,30,6
1650029026235,MATH 20D,B03,084135,Staff,28,0,30,2
1650029032261,MATH 20E,A01,084138,Staff,14,0,30,16
1650029032261,MATH 20E,A02,084139,Staff,6,0,30,24
1650029032261,MATH 20E,A03,084140,Staff,15,0,30,15
1650029032261,MATH 20E,A04,084141,Staff,20,0,30,10
1650029038287,MATH 102,A01,084143,Harel; Guershon,12,0,30,18
1650029038287,MATH 102,A02,084144,Harel; Guershon,19,0,30,11
1650029044314,MATH 103B,A01,083456,Staff,0,13,30,30
1650029044314,MATH 103B,A02,083457,Staff,0,14,30,30
1650029050339,MATH 109,A01,084146,Salehi Golsefidy; Alireza,17,0,30,13
1650029050339,MATH 109,A02,084147,Salehi Golsefidy; Alireza,15,0,30,15
1650029056364,MATH 120A,A01,085445,Eggers; John Dietrich,10,0,35,25
1650029056364,MATH 120A,A02,085446,Eggers; John Dietrich,27,0,35,8
1650029062396,MATH 142B,A01,084149,Verstraete; Jacques Allan,0,12,30,30
1650029062396,MATH 142B,A02,084150,Verstraete; Jacques Allan,0,12,30,30
1650029068429,MATH 170A,A01,083459,Nie; Jiawang,0,9,30,30
1650029068429,MATH 170A,A02,083460,Nie; Jiawang,0,8,30,30
1650029068429,MATH 170A,A03,083461,Nie; Jiawang,0,9,30,30
1650029074455,MATH 193B,A01,083463,Staff,1,0,30,29
1650029074455,MATH 193B,A02,083464,Staff,9,0,30,21
1650029074455,MATH 193B,A03,083465,Staff,18,0,30,12
1650029080519,COGS 2,A01,083966,Boyle; Mary E. T.,9,0,30,21
1650029086545,COGS 9,A01,083968,Staff,9,0,60,51
1650029092580,COGS 14B,A01,083970,Staff,9,0,50,41
1650029098609,COGS 17,A01,092679,Staff,50,0,75,25
1650029104633,COGS 100,A01,083972,Staff,0,15,60,60
1650029116683,COGS 101C,A01,083976,Staff,12,0,30,18
1650029122711,COGS 102A,A01,083978,Johnson; Christine M.,14,0,30,16
1650029128737,COGS 107B,A01,083980,Staff,0,7,50,50
1650029134760,COGS 115,A01,083982,Staff,10,0,30,20
1650029140785,COGS 118B,A01,083367,Staff,0,15,40,40
1650029146812,COGS 172,A01,083984,Provenzano; Emily Kara,15,0,30,15
1650029152834,COGS 177,A00,083368,Staff,0,20,30,30
1650029158863,COGS 186,A01,083986,Staff,21,0,40,19
1650029164898,COGS 187A,A01,083988,Boyle; Mary E. T.,20,0,60,40
1650029170929,CSE 8A,A50,084003,Miranda; Gregory Joseph,0,13,15,15
1650029176959,CSE 11,A01,084005,Miranda; Gregory Joseph,0,22,55,55
1650029182988,CSE 20,A01,084007,Staff,0,5,20,20
1650029189018,CSE 21,A01,084009,Staff,0,30,50,50
1650029195045,CSE 30,A01,083370,Cao; Yingjun,0,65,40,40
1650029201069,CSE 100,A01,083372,Cao; Yingjun,0,46,40,40
1650029207096,CSE 101,A01,084011,Staff,0,54,40,40
1650029213121,CSE 141,A01,083374,Eldon; John,0,64,75,75
1650029219149,CSE 141L,A01,083376,Eldon; John,0,70,75,75
1650029225174,CSE 175,A01,084013,Kumar; Rakesh,22,0,25,3
1650029231199,CSE 190,A00,092508,Dubnov; Shlomo,20,0,20,0
1650029237228,ECE 5,A01,084049,Morris; Karcher William,13,0,20,7
1650029243255,ECE 100,A01,084051,Baghdadchi; Saharnaz,0,0,20,20
1650029243255,ECE 100,A02,091916,Baghdadchi; Saharnaz,13,0,20,7
1650029249280,ECE 101,A01,084053,Baghdadchi; Saharnaz,0,0,37,37
1650029249280,ECE 101,A02,084054,Baghdadchi; Saharnaz,30,0,37,7
1650029255309,ECE 107,A01,083390,Staff,26,0,40,14
1650029261342,ECE 148,A01,084056,Silberman; Jack,8,0,12,4
1650029267367,ECE 180,A00,083391,Abi Samra; Nicholas Camill,25,0,30,5
1650029267367,ECE 180,B00,083392,Abi Samra; Nicholas Camill,21,0,30,9
1650029273392,MATH 10B,A01,084110,Staff,0,0,30,30
1650029273392,MATH 10B,A02,084111,Staff,18,0,30,12
1650029273392,MATH 10B,A03,084112,Staff,24,0,30,6
1650029279512,MATH 10C,A01,083443,Staff,0,16,30,30
1650029279512,MATH 10C,A02,083444,Staff,0,15,30,30
1650029279512,MATH 10C,B01,084114,Staff,19,0,30,11
1650029279512,MATH 10C,B02,084115,Staff,25,0,30,5
1650029285541,MATH 18,A01,084117,Harel; Guershon,14,0,30,16
1650029285541,MATH 18,A02,084119,Harel; Guershon,27,0,30,3
1650029285541,MATH 18,A03,084120,Harel; Guershon,30,0,30,0
1650029285541,MATH 18,A04,084121,Harel; Guershon,29,0,30,1
1650029291566,MATH 20B,A01,084124,Um; Ko Woon,16,0,35,19
1650029291566,MATH 20B,B01,084126,Um; Ko Woon,24,0,35,11
1650029297596,MATH 20C,A01,083446,Hammock; Frances H,0,0,30,30
1650029297596,MATH 20C,A02,083447,Hammock; Frances H,16,0,30,14
1650029297596,MATH 20C,A03,083448,Hammock; Frances H,19,0,30,11
1650029297596,MATH 20C,A04,083449,Hammock; Frances H,20,0,30,10
1650029297596,MATH 20C,B01,083451,Hammock; Frances H,0,0,30,30
1650029297596,MATH 20C,B02,083452,Hammock; Frances H,19,0,30,11
1650029297596,MATH 20C,B03,083453,Hammock; Frances H,21,0,30,9
1650029297596,MATH 20C,B04,083454,Hammock; Frances H,23,0,30,7
1650029303626,MATH 20D,A01,084128,Staff,14,0,30,16
1650029303626,MATH 20D,A02,084129,Staff,29,0,30,1
1650029303626,MATH 20D,A03,084130,Staff,27,0,30,3
1650029303626,MATH 20D,B01,084133,Staff,3,0,30,27
1650029303626,MATH 20D,B02,084134,Staff,24,0,30,6
1650029303626,MATH 20D,B03,084135,Staff,28,0,30,2
1650029309652,MATH 20E,A01,084138,Staff,14,0,30,16
1650029309652,MATH 20E,A02,084139,Staff,6,0,30,24
1650029309652,MATH 20E,A03,084140,Staff,15,0,30,15
1650029309652,MATH 20E,A04,084141,Staff,20,0,30,10
1650029315689,MATH 102,A01,084143,Harel; Guershon,12,0,30,18
1650029315689,MATH 102,A02,084144,Harel; Guershon,19,0,30,11
1650029321723,MATH 103B,A01,083456,Staff,0,13,30,30
1650029321723,MATH 103B,A02,083457,Staff,0,14,30,30
1650029327748,MATH 109,A01,084146,Salehi Golsefidy; Alireza,17,0,30,13
1650029327748,MATH 109,A02,084147,Salehi Golsefidy; Alireza,15,0,30,15
1650029333777,MATH 120A,A01,085445,Eggers; John Dietrich,10,0,35,25
1650029333777,MATH 120A,A02,085446,Eggers; John Dietrich,27,0,35,8
1650029339803,MATH 142B,A01,084149,Verstraete; Jacques Allan,0,12,30,30
1650029339803,MATH 142B,A02,084150,Verstraete; Jacques Allan,0,12,30,30
1650029345832,MATH 170A,A01,083459,Nie; Jiawang,0,9,30,30
1650029345832,MATH 170A,A02,083460,Nie; Jiawang,0,8,30,30
1650029345832,MATH 170A,A03,083461,Nie; Jiawang,0,9,30,30
1650029351859,MATH 193B,A01,083463,Staff,1,0,30,29
1650029351859,MATH 193B,A02,083464,Staff,9,0,30,21
1650029351859,MATH 193B,A03,083465,Staff,18,0,30,12
1650029357935,COGS 2,A01,083966,Boyle; Mary E. T.,9,0,30,21
1650029363964,COGS 9,A01,083968,Staff,9,0,60,51
1650029369993,COGS 14B,A01,083970,Staff,9,0,50,41
1650029376023,COGS 17,A01,092679,Staff,50,0,75,25
1650029382048,COGS 100,A01,083972,Staff,0,15,60,60
1650029394103,COGS 101C,A01,083976,Staff,12,0,30,18
1650029400137,COGS 102A,A01,083978,Johnson; Christine M.,14,0,30,16
1650029406163,COGS 107B,A01,083980,Staff,0,7,50,50
1650029412186,COGS 115,A01,083982,Staff,10,0,30,20
1650029418214,COGS 118B,A01,083367,Staff,0,15,40,40
1650029424240,COGS 172,A01,083984,Provenzano; Emily Kara,15,0,30,15
1650029430262,COGS 177,A00,083368,Staff,0,20,30,30
1650029436288,COGS 186,A01,083986,Staff,21,0,40,19
1650029442321,COGS 187A,A01,083988,Boyle; Mary E. T.,20,0,60,40
1650029448345,CSE 8A,A50,084003,Miranda; Gregory Joseph,0,13,15,15
1650029454369,CSE 11,A01,084005,Miranda; Gregory Joseph,0,22,55,55
1650029460392,CSE 20,A01,084007,Staff,0,5,20,20
1650029466420,CSE 21,A01,084009,Staff,0,30,50,50
1650029472456,CSE 30,A01,083370,Cao; Yingjun,0,65,40,40
1650029478491,CSE 100,A01,083372,Cao; Yingjun,0,46,40,40
1650029484526,CSE 101,A01,084011,Staff,0,54,40,40
1650029490550,CSE 141,A01,083374,Eldon; John,0,64,75,75
1650029496586,CSE 141L,A01,083376,Eldon; John,0,70,75,75
1650029502610,CSE 175,A01,084013,Kumar; Rakesh,22,0,25,3
1650029508639,CSE 190,A00,092508,Dubnov; Shlomo,20,0,20,0
1650029514667,ECE 5,A01,084049,Morris; Karcher William,13,0,20,7
1650029520693,ECE 100,A01,084051,Baghdadchi; Saharnaz,0,0,20,20
1650029520693,ECE 100,A02,091916,Baghdadchi; Saharnaz,13,0,20,7
1650029526723,ECE 101,A01,084053,Baghdadchi; Saharnaz,0,0,37,37
1650029526723,ECE 101,A02,084054,Baghdadchi; Saharnaz,30,0,37,7
1650029532747,ECE 107,A01,083390,Staff,26,0,40,14
1650029538772,ECE 148,A01,084056,Silberman; Jack,8,0,12,4
1650029544796,ECE 180,A00,083391,Abi Samra; Nicholas Camill,25,0,30,5
1650029544796,ECE 180,B00,083392,Abi Samra; Nicholas Camill,21,0,30,9
1650029550821,MATH 10B,A01,084110,Staff,0,0,30,30
1650029550821,MATH 10B,A02,084111,Staff,18,0,30,12
1650029550821,MATH 10B,A03,084112,Staff,24,0,30,6
1650029556851,MATH 10C,A01,083443,Staff,0,16,30,30
1650029556851,MATH 10C,A02,083444,Staff,0,15,30,30
1650029556851,MATH 10C,B01,084114,Staff,19,0,30,11
1650029556851,MATH 10C,B02,084115,Staff,25,0,30,5
1650029562880,MATH 18,A01,084117,Harel; Guershon,14,0,30,16
1650029562880,MATH 18,A02,084119,Harel; Guershon,27,0,30,3
1650029562880,MATH 18,A03,084120,Harel; Guershon,30,0,30,0
1650029562880,MATH 18,A04,084121,Harel; Guershon,29,0,30,1
1650029568905,MATH 20B,A01,084124,Um; Ko Woon,15,0,35,20
1650029568905,MATH 20B,B01,084126,Um; Ko Woon,24,0,35,11
1650029574932,MATH 20C,A01,083446,Hammock; Frances H,0,0,30,30
1650029574932,MATH 20C,A02,083447,Hammock; Frances H,16,0,30,14
1650029574932,MATH 20C,A03,083448,Hammock; Frances H,19,0,30,11
1650029574932,MATH 20C,A04,083449,Hammock; Frances H,20,0,30,10
1650029574932,MATH 20C,B01,083451,Hammock; Frances H,0,0,30,30
1650029574932,MATH 20C,B02,083452,Hammock; Frances H,19,0,30,11
1650029574932,MATH 20C,B03,083453,Hammock; Frances H,21,0,30,9
1650029574932,MATH 20C,B04,083454,Hammock; Frances H,23,0,30,7
1650029580960,MATH 20D,A01,084128,Staff,14,0,30,16
1650029580960,MATH 20D,A02,084129,Staff,29,0,30,1
1650029580960,MATH 20D,A03,084130,Staff,27,0,30,3
1650029580960,MATH 20D,B01,084133,Staff,3,0,30,27
1650029580960,MATH 20D,B02,084134,Staff,24,0,30,6
1650029580960,MATH 20D,B03,084135,Staff,28,0,30,2
1650029586985,MATH 20E,A01,084138,Staff,14,0,30,16
1650029586985,MATH 20E,A02,084139,Staff,6,0,30,24
1650029586985,MATH 20E,A03,084140,Staff,15,0,30,15
1650029586985,MATH 20E,A04,084141,Staff,20,0,30,10
1650029593010,MATH 102,A01,084143,Harel; Guershon,12,0,30,18
1650029593010,MATH 102,A02,084144,Harel; Guershon,19,0,30,11
1650029599035,MATH 103B,A01,083456,Staff,0,13,30,30
1650029599035,MATH 103B,A02,083457,Staff,0,14,30,30
1650029605071,MATH 109,A01,084146,Salehi Golsefidy; Alireza,17,0,30,13
1650029605071,MATH 109,A02,084147,Salehi Golsefidy; Alireza,15,0,30,15
1650029611128,MATH 120A,A01,085445,Eggers; John Dietrich,10,0,35,25
1650029611128,MATH 120A,A02,085446,Eggers; John Dietrich,27,0,35,8
1650029617156,MATH 142B,A01,084149,Verstraete; Jacques Allan,0,12,30,30
1650029617156,MATH 142B,A02,084150,Verstraete; Jacques Allan,0,12,30,30
1650029623185,MATH 170A,A01,083459,Nie; Jiawang,0,9,30,30
1650029623185,MATH 170A,A02,083460,Nie; Jiawang,0,8,30,30
1650029623185,MATH 170A,A03,083461,Nie; Jiawang,0,9,30,30
1650029629217,MATH 193B,A01,083463,Staff,1,0,30,29
1650029629217,MATH 193B,A02,083464,Staff,9,0,30,21
1650029629217,MATH 193B,A03,083465,Staff,18,0,30,12
1650029635270,COGS 2,A01,083966,Boyle; Mary E. T.,9,0,30,21
1650029641296,COGS 9,A01,083968,Staff,9,0,60,51
1650029647319,COGS 14B,A01,083970,Staff,9,0,50,41
1650029653347,COGS 17,A01,092679,Staff,50,0,75,25
1650029659370,COGS 100,A01,083972,Staff,0,15,60,60
1650029671423,COGS 101C,A01,083976,Staff,12,0,30,18
1650029677450,COGS 102A,A01,083978,Johnson; Christine M.,14,0,30,16
1650029683476,COGS 107B,A01,083980,Staff,0,7,50,50
1650029689503,COGS 115,A01,083982,Staff,10,0,30,20
1650029695532,COGS 118B,A01,083367,Staff,0,15,40,40
1650029701558,COGS 172,A01,083984,Provenzano; Emily Kara,15,0,30,15
1650029707587,COGS 177,A00,083368,Staff,0,20,30,30
1650029713611,COGS 186,A01,083986,Staff,21,0,40,19
1650029719640,COGS 187A,A01,083988,Boyle; Mary E. T.,20,0,60,40
1650029725667,CSE 8A,A50,084003,Miranda; Gregory Joseph,0,13,15,15
1650029731715,CSE 11,A01,084005,Miranda; Gregory Joseph,0,22,55,55
1650029737741,CSE 20,A01,084007,Staff,0,5,20,20
1650029743765,CSE 21,A01,084009,Staff,0,30,50,50
1650029749790,CSE 30,A01,083370,Cao; Yingjun,0,65,40,40
1650029755815,CSE 100,A01,083372,Cao; Yingjun,0,46,40,40
1650029761842,CSE 101,A01,084011,Staff,0,54,40,40
1650029767868,CSE 141,A01,083374,Eldon; John,0,64,75,75
1650029773898,CSE 141L,A01,083376,Eldon; John,0,70,75,75
1650029779929,CSE 175,A01,084013,Kumar; Rakesh,22,0,25,3
1650029785954,CSE 190,A00,092508,Dubnov; Shlomo,20,0,20,0
1650029791989,ECE 5,A01,084049,Morris; Karcher William,13,0,20,7
1650029798018,ECE 100,A01,084051,Baghdadchi; Saharnaz,0,0,20,20
1650029798018,ECE 100,A02,091916,Baghdadchi; Saharnaz,13,0,20,7
1650029804054,ECE 101,A01,084053,Baghdadchi; Saharnaz,0,0,37,37
1650029804054,ECE 101,A02,084054,Baghdadchi; Saharnaz,30,0,37,7
1650029810083,ECE 107,A01,083390,Staff,26,0,40,14
1650029816116,ECE 148,A01,084056,Silberman; Jack,8,0,12,4
1650029822155,ECE 180,A00,083391,Abi Samra; Nicholas Camill,25,0,30,5
1650029822155,ECE 180,B00,083392,Abi Samra; Nicholas Camill,21,0,30,9
1650029828185,MATH 10B,A01,084110,Staff,0,0,30,30
1650029828185,MATH 10B,A02,084111,Staff,18,0,30,12
1650029828185,MATH 10B,A03,084112,Staff,24,0,30,6
1650029834223,MATH 10C,A01,083443,Staff,0,16,30,30
1650029834223,MATH 10C,A02,083444,Staff,0,15,30,30
1650029834223,MATH 10C,B01,084114,Staff,19,0,30,11
1650029834223,MATH 10C,B02,084115,Staff,25,0,30,5
1650029840248,MATH 18,A01,084117,Harel; Guershon,14,0,30,16
1650029840248,MATH 18,A02,084119,Harel; Guershon,27,0,30,3
1650029840248,MATH 18,A03,084120,Harel; Guershon,30,0,30,0
1650029840248,MATH 18,A04,084121,Harel; Guershon,29,0,30,1
1650029846292,MATH 20B,A01,084124,Um; Ko Woon,15,0,35,20
1650029846292,MATH 20B,B01,084126,Um; Ko Woon,24,0,35,11
1650029852319,MATH 20C,A01,083446,Hammock; Frances H,0,0,30,30
1650029852319,MATH 20C,A02,083447,Hammock; Frances H,16,0,30,14
1650029852319,MATH 20C,A03,083448,Hammock; Frances H,19,0,30,11
1650029852319,MATH 20C,A04,083449,Hammock; Frances H,20,0,30,10
1650029852319,MATH 20C,B01,083451,Hammock; Frances H,0,0,30,30
1650029852319,MATH 20C,B02,083452,Hammock; Frances H,19,0,30,11
1650029852319,MATH 20C,B03,083453,Hammock; Frances H,21,0,30,9
1650029852319,MATH 20C,B04,083454,Hammock; Frances H,23,0,30,7
1650029858345,MATH 20D,A01,084128,Staff,14,0,30,16
1650029858345,MATH 20D,A02,084129,Staff,29,0,30,1
1650029858345,MATH 20D,A03,084130,Staff,27,0,30,3
1650029858345,MATH 20D,B01,084133,Staff,3,0,30,27
1650029858345,MATH 20D,B02,084134,Staff,24,0,30,6
1650029858345,MATH 20D,B03,084135,Staff,28,0,30,2
1650029864381,MATH 20E,A01,084138,Staff,14,0,30,16
1650029864381,MATH 20E,A02,084139,Staff,6,0,30,24
1650029864381,MATH 20E,A03,084140,Staff,15,0,30,15
1650029864381,MATH 20E,A04,084141,Staff,20,0,30,10
1650029870407,MATH 102,A01,084143,Harel; Guershon,12,0,30,18
1650029870407,MATH 102,A02,084144,Harel; Guershon,19,0,30,11
1650029876527,MATH 103B,A01,083456,Staff,0,13,30,30
1650029876527,MATH 103B,A02,083457,Staff,0,14,30,30
1650029882559,MATH 109,A01,084146,Salehi Golsefidy; Alireza,17,0,30,13
1650029882559,MATH 109,A02,084147,Salehi Golsefidy; Alireza,15,0,30,15
1650029888586,MATH 120A,A01,085445,Eggers; John Dietrich,10,0,35,25
1650029888586,MATH 120A,A02,085446,Eggers; John Dietrich,27,0,35,8
1650029894620,MATH 142B,A01,084149,Verstraete; Jacques Allan,0,12,30,30
1650029894620,MATH 142B,A02,084150,Verstraete; Jacques Allan,0,12,30,30
1650029900645,MATH 170A,A01,083459,Nie; Jiawang,0,9,30,30
1650029900645,MATH 170A,A02,083460,Nie; Jiawang,0,8,30,30
1650029900645,MATH 170A,A03,083461,Nie; Jiawang,0,9,30,30
1650029906681,MATH 193B,A01,083463,Staff,1,0,30,29
1650029906681,MATH 193B,A02,083464,Staff,9,0,30,21
1650029906681,MATH 193B,A03,083465,Staff,18,0,30,12
1650029912739,COGS 2,A01,083966,Boyle; Mary E. T.,9,0,30,21
1650029918765,COGS 9,A01,083968,Staff,9,0,60,51
1650029924797,COGS 14B,A01,083970,Staff,9,0,50,41
1650029930821,COGS 17,A01,092679,Staff,50,0,75,25
1650029936857,COGS 100,A01,083972,Staff,0,15,60,60
1650029948928,COGS 101C,A01,083976,Staff,12,0,30,18
1650029954954,COGS 102A,A01,083978,Johnson; Christine M.,14,0,30,16
1650029960987,COGS 107B,A01,083980,Staff,0,7,50,50
1650029967016,COGS 115,A01,083982,Staff,10,0,30,20
1650029973043,COGS 118B,A01,083367,Staff,0,15,40,40
1650029979068,COGS 172,A01,083984,Provenzano; Emily Kara,15,0,30,15
1650029985092,COGS 177,A00,083368,Staff,0,20,30,30
1650029991116,COGS 186,A01,083986,Staff,21,0,40,19
1650029997143,COGS 187A,A01,083988,Boyle; Mary E. T.,20,0,60,40
1650030003168,CSE 8A,A50,084003,Miranda; Gregory Joseph,0,13,15,15
1650030009195,CSE 11,A01,084005,Miranda; Gregory Joseph,0,22,55,55
1650030015219,CSE 20,A01,084007,Staff,0,5,20,20
1650030021248,CSE 21,A01,084009,Staff,0,30,50,50
1650030027276,CSE 30,A01,083370,Cao; Yingjun,0,65,40,40
1650030033303,CSE 100,A01,083372,Cao; Yingjun,0,46,40,40
1650030039326,CSE 101,A01,084011,Staff,0,54,40,40
1650030045351,CSE 141,A01,083374,Eldon; John,0,64,75,75
1650030051379,CSE 141L,A01,083376,Eldon; John,0,70,75,75
1650030057411,CSE 175,A01,084013,Kumar; Rakesh,22,0,25,3
1650030063451,CSE 190,A00,092508,Dubnov; Shlomo,20,0,20,0
1650030069481,ECE 5,A01,084049,Morris; Karcher William,13,0,20,7
1650030075517,ECE 100,A01,084051,Baghdadchi; Saharnaz,0,0,20,20
1650030075517,ECE 100,A02,091916,Baghdadchi; Saharnaz,13,0,20,7
1650030081542,ECE 101,A01,084053,Baghdadchi; Saharnaz,0,0,37,37
1650030081542,ECE 101,A02,084054,Baghdadchi; Saharnaz,30,0,37,7
1650030087566,ECE 107,A01,083390,Staff,26,0,40,14
1650030093606,ECE 148,A01,084056,Silberman; Jack,8,0,12,4
1650030099634,ECE 180,A00,083391,Abi Samra; Nicholas Camill,25,0,30,5
1650030099634,ECE 180,B00,083392,Abi Samra; Nicholas Camill,21,0,30,9
1650030105660,MATH 10B,A01,084110,Staff,0,0,30,30
1650030105660,MATH 10B,A02,084111,Staff,18,0,30,12
1650030105660,MATH 10B,A03,084112,Staff,24,0,30,6
1650030111696,MATH 10C,A01,083443,Staff,0,16,30,30
1650030111696,MATH 10C,A02,083444,Staff,0,15,30,30
1650030111696,MATH 10C,B01,084114,Staff,19,0,30,11
1650030111696,MATH 10C,B02,084115,Staff,25,0,30,5
1650030117723,MATH 18,A01,084117,Harel; Guershon,14,0,30,16
1650030117723,MATH 18,A02,084119,Harel; Guershon,27,0,30,3
1650030117723,MATH 18,A03,084120,Harel; Guershon,30,0,30,0
1650030117723,MATH 18,A04,084121,Harel; Guershon,29,0,30,1
1650030123748,MATH 20B,A01,084124,Um; Ko Woon,15,0,35,20
1650030123748,MATH 20B,B01,084126,Um; Ko Woon,24,0,35,11
1650030129777,MATH 20C,A01,083446,Hammock; Frances H,0,0,30,30
1650030129777,MATH 20C,A02,083447,Hammock; Frances H,16,0,30,14
1650030129777,MATH 20C,A03,083448,Hammock; Frances H,19,0,30,11
1650030129777,MATH 20C,A04,083449,Hammock; Frances H,20,0,30,10
1650030129777,MATH 20C,B01,083451,Hammock; Frances H,0,0,30,30
1650030129777,MATH 20C,B02,083452,Hammock; Frances H,19,0,30,11
1650030129777,MATH 20C,B03,083453,Hammock; Frances H,21,0,30,9
1650030129777,MATH 20C,B04,083454,Hammock; Frances H,23,0,30,7
1650030135802,MATH 20D,A01,084128,Staff,14,0,30,16
1650030135802,MATH 20D,A02,084129,Staff,29,0,30,1
1650030135802,MATH 20D,A03,084130,Staff,27,0,30,3
1650030135802,MATH 20D,B01,084133,Staff,3,0,30,27
1650030135802,MATH 20D,B02,084134,Staff,24,0,30,6
1650030135802,MATH 20D,B03,084135,Staff,28,0,30,2
1650030141829,MATH 20E,A01,084138,Staff,14,0,30,16
1650030141829,MATH 20E,A02,084139,Staff,6,0,30,24
1650030141829,MATH 20E,A03,084140,Staff,15,0,30,15
1650030141829,MATH 20E,A04,084141,Staff,20,0,30,10
1650030147853,MATH 102,A01,084143,Harel; Guershon,12,0,30,18
1650030147853,MATH 102,A02,084144,Harel; Guershon,19,0,30,11
1650030153881,MATH 103B,A01,083456,Staff,0,13,30,30
1650030153881,MATH 103B,A02,083457,Staff,0,14,30,30
1650030159910,MATH 109,A01,084146,Salehi Golsefidy; Alireza,17,0,30,13
1650030159910,MATH 109,A02,084147,Salehi Golsefidy; Alireza,15,0,30,15
1650030165935,MATH 120A,A01,085445,Eggers; John Dietrich,10,0,35,25
1650030165935,MATH 120A,A02,085446,Eggers; John Dietrich,27,0,35,8
1650030171964,MATH 142B,A01,084149,Verstraete; Jacques Allan,0,12,30,30
1650030171964,MATH 142B,A02,084150,Verstraete; Jacques Allan,0,12,30,30
1650030177989,MATH 170A,A01,083459,Nie; Jiawang,0,9,30,30
1650030177989,MATH 170A,A02,083460,Nie; Jiawang,0,8,30,30
1650030177989,MATH 170A,A03,083461,Nie; Jiawang,0,9,30,30
1650030184015,MATH 193B,A01,083463,Staff,1,0,30,29
1650030184015,MATH 193B,A02,083464,Staff,9,0,30,21
1650030184015,MATH 193B,A03,083465,Staff,18,0,30,12
1650030190093,COGS 2,A01,083966,Boyle; Mary E. T.,9,0,30,21
1650030196117,COGS 9,A01,083968,Staff,9,0,60,51
1650030202153,COGS 14B,A01,083970,Staff,9,0,50,41
1650030208178,COGS 17,A01,092679,Staff,50,0,75,25
1650030214217,COGS 100,A01,083972,Staff,0,15,60,60
1650030226269,COGS 101C,A01,083976,Staff,12,0,30,18
1650030232294,COGS 102A,A01,083978,Johnson; Christine M.,14,0,30,16
1650030238330,COGS 107B,A01,083980,Staff,0,7,50,50
1650030244355,COGS 115,A01,083982,Staff,10,0,30,20
1650030250385,COGS 118B,A01,083367,Staff,0,15,40,40
1650030256413,COGS 172,A01,083984,Provenzano; Emily Kara,15,0,30,15
1650030262438,COGS 177,A00,083368,Staff,0,20,30,30
1650030268462,COGS 186,A01,083986,Staff,21,0,40,19
1650030274487,COGS 187A,A01,083988,Boyle; Mary E. T.,20,0,60,40
1650030280516,CSE 8A,A50,084003,Miranda; Gregory Joseph,0,13,15,15
1650030286547,CSE 11,A01,084005,Miranda; Gregory Joseph,0,22,55,55
1650030292572,CSE 20,A01,084007,Staff,0,5,20,20
1650030298600,CSE 21,A01,084009,Staff,0,30,50,50
1650030304625,CSE 30,A01,083370,Cao; Yingjun,0,65,40,40
1650030310650,CSE 100,A01,083372,Cao; Yingjun,0,46,40,40
1650030316679,CSE 101,A01,084011,Staff,0,54,40,40
1650030322708,CSE 141,A01,083374,Eldon; John,0,64,75,75
1650030328733,CSE 141L,A01,083376,Eldon; John,0,70,75,75
1650030334758,CSE 175,A01,084013,Kumar; Rakesh,22,0,25,3
1650030340791,CSE 190,A00,092508,Dubnov; Shlomo,20,0,20,0
1650030346820,ECE 5,A01,084049,Morris; Karcher William,13,0,20,7
1650030352850,ECE 100,A01,084051,Baghdadchi; Saharnaz,0,0,20,20
1650030352850,ECE 100,A02,091916,Baghdadchi; Saharnaz,13,0,20,7
1650030358890,ECE 101,A01,084053,Baghdadchi; Saharnaz,0,0,37,37
1650030358890,ECE 101,A02,084054,Baghdadchi; Saharnaz,30,0,37,7
1650030364926,ECE 107,A01,083390,Staff,26,0,40,14
1650030370953,ECE 148,A01,084056,Silberman; Jack,8,0,12,4
1650030376985,ECE 180,A00,083391,Abi Samra; Nicholas Camill,25,0,30,5
1650030376985,ECE 180,B00,083392,Abi Samra; Nicholas Camill,21,0,30,9
1650030383013,MATH 10B,A01,084110,Staff,0,0,30,30
1650030383013,MATH 10B,A02,084111,Staff,18,0,30,12
1650030383013,MATH 10B,A03,084112,Staff,24,0,30,6
1650030389041,MATH 10C,A01,083443,Staff,0,16,30,30
1650030389041,MATH 10C,A02,083444,Staff,0,15,30,30
1650030389041,MATH 10C,B01,084114,Staff,19,0,30,11
1650030389041,MATH 10C,B02,084115,Staff,25,0,30,5
1650030395067,MATH 18,A01,084117,Harel; Guershon,14,0,30,16
1650030395067,MATH 18,A02,084119,Harel; Guershon,27,0,30,3
1650030395067,MATH 18,A03,084120,Harel; Guershon,30,0,30,0
1650030395067,MATH 18,A04,084121,Harel; Guershon,29,0,30,1
1650030401099,MATH 20B,A01,084124,Um; Ko Woon,15,0,35,20
1650030401099,MATH 20B,B01,084126,Um; Ko Woon,24,0,35,11
1650030407138,MATH 20C,A01,083446,Hammock; Frances H,0,0,30,30
1650030407138,MATH 20C,A02,083447,Hammock; Frances H,16,0,30,14
1650030407138,MATH 20C,A03,083448,Hammock; Frances H,19,0,30,11
1650030407138,MATH 20C,A04,083449,Hammock; Frances H,20,0,30,10
1650030407138,MATH 20C,B01,083451,Hammock; Frances H,0,0,30,30
1650030407138,MATH 20C,B02,083452,Hammock; Frances H,19,0,30,11
1650030407138,MATH 20C,B03,083453,Hammock; Frances H,21,0,30,9
1650030407138,MATH 20C,B04,083454,Hammock; Frances H,23,0,30,7
1650030413167,MATH 20D,A01,084128,Staff,14,0,30,16
1650030413167,MATH 20D,A02,084129,Staff,29,0,30,1
1650030413167,MATH 20D,A03,084130,Staff,27,0,30,3
1650030413167,MATH 20D,B01,084133,Staff,3,0,30,27
1650030413167,MATH 20D,B02,084134,Staff,24,0,30,6
1650030413167,MATH 20D,B03,084135,Staff,28,0,30,2
1650030419192,MATH 20E,A01,084138,Staff,14,0,30,16
1650030419192,MATH 20E,A02,084139,Staff,6,0,30,24
1650030419192,MATH 20E,A03,084140,Staff,15,0,30,15
1650030419192,MATH 20E,A04,084141,Staff,20,0,30,10
1650030425219,MATH 102,A01,084143,Harel; Guershon,12,0,30,18
1650030425219,MATH 102,A02,084144,Harel; Guershon,19,0,30,11
1650030431246,MATH 103B,A01,083456,Staff,0,13,30,30
1650030431246,MATH 103B,A02,083457,Staff,0,14,30,30
1650030437271,MATH 109,A01,084146,Salehi Golsefidy; Alireza,17,0,30,13
1650030437271,MATH 109,A02,084147,Salehi Golsefidy; Alireza,15,0,30,15
1650030443296,MATH 120A,A01,085445,Eggers; John Dietrich,10,0,35,25
1650030443296,MATH 120A,A02,085446,Eggers; John Dietrich,27,0,35,8
1650030449324,MATH 142B,A01,084149,Verstraete; Jacques Allan,0,12,30,30
1650030449324,MATH 142B,A02,084150,Verstraete; Jacques Allan,0,12,30,30
1650030455353,MATH 170A,A01,083459,Nie; Jiawang,0,9,30,30
1650030455353,MATH 170A,A02,083460,Nie; Jiawang,0,8,30,30
1650030455353,MATH 170A,A03,083461,Nie; Jiawang,0,9,30,30
1650030461379,MATH 193B,A01,083463,Staff,1,0,30,29
1650030461379,MATH 193B,A02,083464,Staff,9,0,30,21
1650030461379,MATH 193B,A03,083465,Staff,18,0,30,12
1650030467522,COGS 2,A01,083966,Boyle; Mary E. T.,9,0,30,21
1650030473547,COGS 9,A01,083968,Staff,9,0,60,51
1650030479571,COGS 14B,A01,083970,Staff,9,0,50,41
1650030485598,COGS 17,A01,092679,Staff,50,0,75,25
1650030491633,COGS 100,A01,083972,Staff,0,15,60,60
1650030503688,COGS 101C,A01,083976,Staff,12,0,30,18
1650030509715,COGS 102A,A01,083978,Johnson; Christine M.,14,0,30,16
1650030515745,COGS 107B,A01,083980,Staff,0,7,50,50
1650030521772,COGS 115,A01,083982,Staff,10,0,30,20
1650030527798,COGS 118B,A01,083367,Staff,0,15,40,40
1650030533823,COGS 172,A01,083984,Provenzano; Emily Kara,15,0,30,15
1650030539855,COGS 177,A00,083368,Staff,0,20,30,30
1650030545879,COGS 186,A01,083986,Staff,21,0,40,19
1650030551936,COGS 187A,A01,083988,Boyle; Mary E. T.,20,0,60,40
1650030557970,CSE 8A,A50,084003,Miranda; Gregory Joseph,0,13,15,15
1650030563997,CSE 11,A01,084005,Miranda; Gregory Joseph,0,22,55,55
1650030570021,CSE 20,A01,084007,Staff,0,5,20,20
1650030576044,CSE 21,A01,084009,Staff,0,30,50,50
1650030582067,CSE 30,A01,083370,Cao; Yingjun,0,65,40,40
1650030588095,CSE 100,A01,083372,Cao; Yingjun,0,46,40,40
1650030594124,CSE 101,A01,084011,Staff,0,54,40,40
1650030600149,CSE 141,A01,083374,Eldon; John,0,64,75,75
1650030606177,CSE 141L,A01,083376,Eldon; John,0,70,75,75
1650030612205,CSE 175,A01,084013,Kumar; Rakesh,22,0,25,3
1650030618229,CSE 190,A00,092508,Dubnov; Shlomo,20,0,20,0
1650030624261,ECE 5,A01,084049,Morris; Karcher William,13,0,20,7
1650030630298,ECE 100,A01,084051,Baghdadchi; Saharnaz,0,0,20,20
1650030630298,ECE 100,A02,091916,Baghdadchi; Saharnaz,13,0,20,7
1650030636326,ECE 101,A01,084053,Baghdadchi; Saharnaz,0,0,37,37
1650030636326,ECE 101,A02,084054,Baghdadchi; Saharnaz,30,0,37,7
1650030642369,ECE 107,A01,083390,Staff,26,0,40,14
1650030648395,ECE 148,A01,084056,Silberman; Jack,8,0,12,4
1650030654421,ECE 180,A00,083391,Abi Samra; Nicholas Camill,25,0,30,5
1650030654421,ECE 180,B00,083392,Abi Samra; Nicholas Camill,21,0,30,9
1650030660447,MATH 10B,A01,084110,Staff,0,0,30,30
1650030660447,MATH 10B,A02,084111,Staff,18,0,30,12
1650030660447,MATH 10B,A03,084112,Staff,24,0,30,6
1650030666483,MATH 10C,A01,083443,Staff,0,16,30,30
1650030666483,MATH 10C,A02,083444,Staff,0,15,30,30
1650030666483,MATH 10C,B01,084114,Staff,19,0,30,11
1650030666483,MATH 10C,B02,084115,Staff,25,0,30,5
1650030672508,MATH 18,A01,084117,Harel; Guershon,14,0,30,16
1650030672508,MATH 18,A02,084119,Harel; Guershon,27,0,30,3
1650030672508,MATH 18,A03,084120,Harel; Guershon,30,0,30,0
1650030672508,MATH 18,A04,084121,Harel; Guershon,29,0,30,1
1650030678540,MATH 20B,A01,084124,Um; Ko Woon,15,0,35,20
1650030678540,MATH 20B,B01,084126,Um; Ko Woon,24,0,35,11
1650030684574,MATH 20C,A01,083446,Hammock; Frances H,0,0,30,30
1650030684574,MATH 20C,A02,083447,Hammock; Frances H,16,0,30,14
1650030684574,MATH 20C,A03,083448,Hammock; Frances H,19,0,30,11
1650030684574,MATH 20C,A04,083449,Hammock; Frances H,20,0,30,10
1650030684574,MATH 20C,B01,083451,Hammock; Frances H,0,0,30,30
1650030684574,MATH 20C,B02,083452,Hammock; Frances H,19,0,30,11
1650030684574,MATH 20C,B03,083453,Hammock; Frances H,21,0,30,9
1650030684574,MATH 20C,B04,083454,Hammock; Frances H,23,0,30,7
1650030690606,MATH 20D,A01,084128,Staff,14,0,30,16
1650030690606,MATH 20D,A02,084129,Staff,29,0,30,1
1650030690606,MATH 20D,A03,084130,Staff,27,0,30,3
1650030690606,MATH 20D,B01,084133,Staff,3,0,30,27
1650030690606,MATH 20D,B02,084134,Staff,24,0,30,6
1650030690606,MATH 20D,B03,084135,Staff,28,0,30,2
1650030696631,MATH 20E,A01,084138,Staff,14,0,30,16
1650030696631,MATH 20E,A02,084139,Staff,6,0,30,24
1650030696631,MATH 20E,A03,084140,Staff,15,0,30,15
1650030696631,MATH 20E,A04,084141,Staff,20,0,30,10
1650030702660,MATH 102,A01,084143,Harel; Guershon,12,0,30,18
1650030702660,MATH 102,A02,084144,Harel; Guershon,19,0,30,11
1650030708686,MATH 103B,A01,083456,Staff,0,13,30,30
1650030708686,MATH 103B,A02,083457,Staff,0,14,30,30
1650030714726,MATH 109,A01,084146,Salehi Golsefidy; Alireza,17,0,30,13
1650030714726,MATH 109,A02,084147,Salehi Golsefidy; Alireza,15,0,30,15
1650030720752,MATH 120A,A01,085445,Eggers; John Dietrich,10,0,35,25
1650030720752,MATH 120A,A02,085446,Eggers; John Dietrich,27,0,35,8
1650030726784,MATH 142B,A01,084149,Verstraete; Jacques Allan,0,12,30,30
1650030726784,MATH 142B,A02,084150,Verstraete; Jacques Allan,0,12,30,30
1650030732821,MATH 170A,A01,083459,Nie; Jiawang,0,9,30,30
1650030732821,MATH 170A,A02,083460,Nie; Jiawang,0,8,30,30
1650030732821,MATH 170A,A03,083461,Nie; Jiawang,0,9,30,30
1650030738853,MATH 193B,A01,083463,Staff,1,0,30,29
1650030738853,MATH 193B,A02,083464,Staff,9,0,30,21
1650030738853,MATH 193B,A03,083465,Staff,18,0,30,12
1650030744909,COGS 2,A01,083966,Boyle; Mary E. T.,9,0,30,21
1650030750938,COGS 9,A01,083968,Staff,9,0,60,51
1650030756965,COGS 14B,A01,083970,Staff,9,0,50,41
1650030762989,COGS 17,A01,092679,Staff,50,0,75,25
1650030769018,COGS 100,A01,083972,Staff,0,15,60,60
1650030781088,COGS 101C,A01,083976,Staff,12,0,30,18
1650030787114,COGS 102A,A01,083978,Johnson; Christine M.,14,0,30,16
1650030793139,COGS 107B,A01,083980,Staff,0,7,50,50
1650030799163,COGS 115,A01,083982,Staff,10,0,30,20
1650030805190,COGS 118B,A01,083367,Staff,0,15,40,40
1650030811222,COGS 172,A01,083984,Provenzano; Emily Kara,15,0,30,15
1650030817264,COGS 177,A00,083368,Staff,0,20,30,30
1650030823292,COGS 186,A01,083986,Staff,21,0,40,19
1650030829318,COGS 187A,A01,083988,Boyle; Mary E. T.,20,0,60,40
1650030835373,CSE 8A,A50,084003,Miranda; Gregory Joseph,0,13,15,15
1650030841405,CSE 11,A01,084005,Miranda; Gregory Joseph,0,22,55,55
1650030847430,CSE 20,A01,084007,Staff,0,5,20,20
1650030853455,CSE 21,A01,084009,Staff,0,30,50,50
1650030859481,CSE 30,A01,083370,Cao; Yingjun,0,65,40,40
1650030865510,CSE 100,A01,083372,Cao; Yingjun,0,46,40,40
1650030871536,CSE 101,A01,084011,Staff,0,54,40,40
1650030877566,CSE 141,A01,083374,Eldon; John,0,64,75,75
1650030883591,CSE 141L,A01,083376,Eldon; John,0,70,75,75
1650030889618,CSE 175,A01,084013,Kumar; Rakesh,22,0,25,3
1650030895646,CSE 190,A00,092508,Dubnov; Shlomo,20,0,20,0
1650030901672,ECE 5,A01,084049,Morris; Karcher William,13,0,20,7
1650030907697,ECE 100,A01,084051,Baghdadchi; Saharnaz,0,0,20,20
1650030907697,ECE 100,A02,091916,Baghdadchi; Saharnaz,13,0,20,7
1650030913733,ECE 101,A01,084053,Baghdadchi; Saharnaz,0,0,37,37
1650030913733,ECE 101,A02,084054,Baghdadchi; Saharnaz,30,0,37,7
1650030919774,ECE 107,A01,083390,Staff,26,0,40,14
1650030925805,ECE 148,A01,084056,Silberman; Jack,8,0,12,4
1650030931837,ECE 180,A00,083391,Abi Samra; Nicholas Camill,25,0,30,5
1650030931837,ECE 180,B00,083392,Abi Samra; Nicholas Camill,21,0,30,9
1650030937865,MATH 10B,A01,084110,Staff,0,0,30,30
1650030937865,MATH 10B,A02,084111,Staff,18,0,30,12
1650030937865,MATH 10B,A03,084112,Staff,24,0,30,6
1650030943906,MATH 10C,A01,083443,Staff,0,16,30,30
1650030943906,MATH 10C,A02,083444,Staff,0,15,30,30
1650030943906,MATH 10C,B01,084114,Staff,19,0,30,11
1650030943906,MATH 10C,B02,084115,Staff,25,0,30,5
1650030949936,MATH 18,A01,084117,Harel; Guershon,14,0,30,16
1650030949936,MATH 18,A02,084119,Harel; Guershon,27,0,30,3
1650030949936,MATH 18,A03,084120,Harel; Guershon,30,0,30,0
1650030949936,MATH 18,A04,084121,Harel; Guershon,29,0,30,1
1650030955966,MATH 20B,A01,084124,Um; Ko Woon,15,0,35,20
1650030955966,MATH 20B,B01,084126,Um; Ko Woon,24,0,35,11
1650030961995,MATH 20C,A01,083446,Hammock; Frances H,0,0,30,30
1650030961995,MATH 20C,A02,083447,Hammock; Frances H,16,0,30,14
1650030961995,MATH 20C,A03,083448,Hammock; Frances H,19,0,30,11
1650030961995,MATH 20C,A04,083449,Hammock; Frances H,20,0,30,10
1650030961995,MATH 20C,B01,083451,Hammock; Frances H,0,0,30,30
1650030961995,MATH 20C,B02,083452,Hammock; Frances H,19,0,30,11
1650030961995,MATH 20C,B03,083453,Hammock; Frances H,21,0,30,9
1650030961995,MATH 20C,B04,083454,Hammock; Frances H,23,0,30,7
1650030968021,MATH 20D,A01,084128,Staff,14,0,30,16
1650030968021,MATH 20D,A02,084129,Staff,29,0,30,1
1650030968021,MATH 20D,A03,084130,Staff,27,0,30,3
1650030968021,MATH 20D,B01,084133,Staff,3,0,30,27
1650030968021,MATH 20D,B02,084134,Staff,24,0,30,6
1650030968021,MATH 20D,B03,084135,Staff,28,0,30,2
1650030974054,MATH 20E,A01,084138,Staff,14,0,30,16
1650030974054,MATH 20E,A02,084139,Staff,6,0,30,24
1650030974054,MATH 20E,A03,084140,Staff,15,0,30,15
1650030974054,MATH 20E,A04,084141,Staff,20,0,30,10
1650030980087,MATH 102,A01,084143,Harel; Guershon,12,0,30,18
1650030980087,MATH 102,A02,084144,Harel; Guershon,19,0,30,11
1650030986114,MATH 103B,A01,083456,Staff,0,13,30,30
1650030986114,MATH 103B,A02,083457,Staff,0,14,30,30
1650030992144,MATH 109,A01,084146,Salehi Golsefidy; Alireza,17,0,30,13
1650030992144,MATH 109,A02,084147,Salehi Golsefidy; Alireza,15,0,30,15
1650030998179,MATH 120A,A01,085445,Eggers; John Dietrich,10,0,35,25
1650030998179,MATH 120A,A02,085446,Eggers; John Dietrich,27,0,35,8
1650031004208,MATH 142B,A01,084149,Verstraete; Jacques Allan,0,12,30,30
1650031004208,MATH 142B,A02,084150,Verstraete; Jacques Allan,0,12,30,30
1650031010237,MATH 170A,A01,083459,Nie; Jiawang,0,9,30,30
1650031010237,MATH 170A,A02,083460,Nie; Jiawang,0,8,30,30
1650031010237,MATH 170A,A03,083461,Nie; Jiawang,0,9,30,30
1650031016284,MATH 193B,A01,083463,Staff,1,0,30,29
1650031016284,MATH 193B,A02,083464,Staff,9,0,30,21
1650031016284,MATH 193B,A03,083465,Staff,18,0,30,12
1650031022355,COGS 2,A01,083966,Boyle; Mary E. T.,9,0,30,21
1650031028382,COGS 9,A01,083968,Staff,9,0,60,51
1650031034417,COGS 14B,A01,083970,Staff,9,0,50,41
1650031040454,COGS 17,A01,092679,Staff,50,0,75,25
1650031046480,COGS 100,A01,083972,Staff,0,15,60,60
1650031058536,COGS 101C,A01,083976,Staff,12,0,30,18
1650031064633,COGS 102A,A01,083978,Johnson; Christine M.,14,0,30,16
1650031070658,COGS 107B,A01,083980,Staff,0,7,50,50
1650031076692,COGS 115,A01,083982,Staff,10,0,30,20
1650031082715,COGS 118B,A01,083367,Staff,0,15,40,40
1650031088745,COGS 172,A01,083984,Provenzano; Emily Kara,15,0,30,15
1650031094773,COGS 177,A00,083368,Staff,0,20,30,30
1650031100807,COGS 186,A01,083986,Staff,21,0,40,19
1650031106831,COGS 187A,A01,083988,Boyle; Mary E. T.,20,0,60,40
1650031112860,CSE 8A,A50,084003,Miranda; Gregory Joseph,0,13,15,15
1650031118889,CSE 11,A01,084005,Miranda; Gregory Joseph,0,22,55,55
1650031124922,CSE 20,A01,084007,Staff,0,5,20,20
1650031130955,CSE 21,A01,084009,Staff,0,30,50,50
1650031136985,CSE 30,A01,083370,Cao; Yingjun,0,65,40,40
1650031143010,CSE 100,A01,083372,Cao; Yingjun,0,46,40,40
1650031149034,CSE 101,A01,084011,Staff,0,54,40,40
1650031155059,CSE 141,A01,083374,Eldon; John,0,64,75,75
1650031161083,CSE 141L,A01,083376,Eldon; John,0,70,75,75
1650031167108,CSE 175,A01,084013,Kumar; Rakesh,22,0,25,3
1650031173133,CSE 190,A00,092508,Dubnov; Shlomo,20,0,20,0
1650031179155,ECE 5,A01,084049,Morris; Karcher William,13,0,20,7
1650031185177,ECE 100,A01,084051,Baghdadchi; Saharnaz,0,0,20,20
1650031185177,ECE 100,A02,091916,Baghdadchi; Saharnaz,13,0,20,7
1650031191204,ECE 101,A01,084053,Baghdadchi; Saharnaz,0,0,37,37
1650031191204,ECE 101,A02,084054,Baghdadchi; Saharnaz,30,0,37,7
1650031197231,ECE 107,A01,083390,Staff,26,0,40,14
1650031203254,ECE 148,A01,084056,Silberman; Jack,8,0,12,4
1650031209276,ECE 180,A00,083391,Abi Samra; Nicholas Camill,25,0,30,5
1650031209276,ECE 180,B00,083392,Abi Samra; Nicholas Camill,21,0,30,9
1650031215301,MATH 10B,A01,084110,Staff,0,0,30,30
1650031215301,MATH 10B,A02,084111,Staff,18,0,30,12
1650031215301,MATH 10B,A03,084112,Staff,24,0,30,6
1650031221324,MATH 10C,A01,083443,Staff,0,16,30,30
1650031221324,MATH 10C,A02,083444,Staff,0,15,30,30
1650031221324,MATH 10C,B01,084114,Staff,19,0,30,11
1650031221324,MATH 10C,B02,084115,Staff,25,0,30,5
1650031227349,MATH 18,A01,084117,Harel; Guershon,14,0,30,16
1650031227349,MATH 18,A02,084119,Harel; Guershon,27,0,30,3
1650031227349,MATH 18,A03,084120,Harel; Guershon,30,0,30,0
1650031227349,MATH 18,A04,084121,Harel; Guershon,29,0,30,1
1650031233385,MATH 20B,A01,084124,Um; Ko Woon,15,0,35,20
1650031233385,MATH 20B,B01,084126,Um; Ko Woon,24,0,35,11
1650031239408,MATH 20C,A01,083446,Hammock; Frances H,0,0,30,30
1650031239408,MATH 20C,A02,083447,Hammock; Frances H,16,0,30,14
1650031239408,MATH 20C,A03,083448,Hammock; Frances H,19,0,30,11
1650031239408,MATH 20C,A04,083449,Hammock; Frances H,20,0,30,10
1650031239408,MATH 20C,B01,083451,Hammock; Frances H,0,0,30,30
1650031239408,MATH 20C,B02,083452,Hammock; Frances H,19,0,30,11
1650031239408,MATH 20C,B03,083453,Hammock; Frances H,21,0,30,9
1650031239408,MATH 20C,B04,083454,Hammock; Frances H,23,0,30,7
1650031245435,MATH 20D,A01,084128,Staff,14,0,30,16
1650031245435,MATH 20D,A02,084129,Staff,29,0,30,1
1650031245435,MATH 20D,A03,084130,Staff,27,0,30,3
1650031245435,MATH 20D,B01,084133,Staff,3,0,30,27
1650031245435,MATH 20D,B02,084134,Staff,24,0,30,6
1650031245435,MATH 20D,B03,084135,Staff,28,0,30,2
1650031251460,MATH 20E,A01,084138,Staff,14,0,30,16
1650031251460,MATH 20E,A02,084139,Staff,6,0,30,24
1650031251460,MATH 20E,A03,084140,Staff,15,0,30,15
1650031251460,MATH 20E,A04,084141,Staff,20,0,30,10
1650031257489,MATH 102,A01,084143,Harel; Guershon,12,0,30,18
1650031257489,MATH 102,A02,084144,Harel; Guershon,19,0,30,11
1650031263541,MATH 103B,A01,083456,Staff,0,13,30,30
1650031263541,MATH 103B,A02,083457,Staff,0,14,30,30
1650031269580,MATH 109,A01,084146,Salehi Golsefidy; Alireza,17,0,30,13
1650031269580,MATH 109,A02,084147,Salehi Golsefidy; Alireza,15,0,30,15
1650031275609,MATH 120A,A01,085445,Eggers; John Dietrich,10,0,35,25
1650031275609,MATH 120A,A02,085446,Eggers; John Dietrich,27,0,35,8
1650031281646,MATH 142B,A01,084149,Verstraete; Jacques Allan,0,12,30,30
1650031281646,MATH 142B,A02,084150,Verstraete; Jacques Allan,0,12,30,30
1650031287681,MATH 170A,A01,083459,Nie; Jiawang,0,9,30,30
1650031287681,MATH 170A,A02,083460,Nie; Jiawang,0,8,30,30
1650031287681,MATH 170A,A03,083461,Nie; Jiawang,0,9,30,30
1650031293708,MATH 193B,A01,083463,Staff,1,0,30,29
1650031293708,MATH 193B,A02,083464,Staff,9,0,30,21
1650031293708,MATH 193B,A03,083465,Staff,18,0,30,12
1650031299773,COGS 2,A01,083966,Boyle; Mary E. T.,9,0,30,21
1650031305807,COGS 9,A01,083968,Staff,9,0,60,51
1650031311833,COGS 14B,A01,083970,Staff,9,0,50,41
1650031317868,COGS 17,A01,092679,Staff,50,0,75,25
1650031323896,COGS 100,A01,083972,Staff,0,15,60,60
1650031335949,COGS 101C,A01,083976,Staff,12,0,30,18
1650031341975,COGS 102A,A01,083978,Johnson; Christine M.,14,0,30,16
1650031348000,COGS 107B,A01,083980,Staff,0,7,50,50
1650031354027,COGS 115,A01,083982,Staff,10,0,30,20
1650031360051,COGS 118B,A01,083367,Staff,0,15,40,40
1650031366087,COGS 172,A01,083984,Provenzano; Emily Kara,15,0,30,15
1650031372114,COGS 177,A00,083368,Staff,0,20,30,30
1650031378139,COGS 186,A01,083986,Staff,21,0,40,19
1650031384163,COGS 187A,A01,083988,Boyle; Mary E. T.,20,0,60,40
1650031390189,CSE 8A,A50,084003,Miranda; Gregory Joseph,0,13,15,15
1650031396217,CSE 11,A01,084005,Miranda; Gregory Joseph,0,22,55,55
1650031402244,CSE 20,A01,084007,Staff,0,5,20,20
1650031408268,CSE 21,A01,084009,Staff,0,30,50,50
1650031414298,CSE 30,A01,083370,Cao; Yingjun,0,65,40,40
1650031420323,CSE 100,A01,083372,Cao; Yingjun,0,46,40,40
1650031426347,CSE 101,A01,084011,Staff,0,54,40,40
1650031432370,CSE 141,A01,083374,Eldon; John,0,64,75,75
1650031438404,CSE 141L,A01,083376,Eldon; John,0,70,75,75
1650031444440,CSE 175,A01,084013,Kumar; Rakesh,22,0,25,3
1650031450463,CSE 190,A00,092508,Dubnov; Shlomo,20,0,20,0
1650031456493,ECE 5,A01,084049,Morris; Karcher William,13,0,20,7
1650031462532,ECE 100,A01,084051,Baghdadchi; Saharnaz,0,0,20,20
1650031462532,ECE 100,A02,091916,Baghdadchi; Saharnaz,13,0,20,7
1650031468558,ECE 101,A01,084053,Baghdadchi; Saharnaz,0,0,37,37
1650031468558,ECE 101,A02,084054,Baghdadchi; Saharnaz,30,0,37,7
1650031474584,ECE 107,A01,083390,Staff,26,0,40,14
1650031480616,ECE 148,A01,084056,Silberman; Jack,8,0,12,4
1650031486645,ECE 180,A00,083391,Abi Samra; Nicholas Camill,25,0,30,5
1650031486645,ECE 180,B00,083392,Abi Samra; Nicholas Camill,21,0,30,9
1650031492675,MATH 10B,A01,084110,Staff,0,0,30,30
1650031492675,MATH 10B,A02,084111,Staff,18,0,30,12
1650031492675,MATH 10B,A03,084112,Staff,24,0,30,6
1650031498712,MATH 10C,A01,083443,Staff,0,16,30,30
1650031498712,MATH 10C,A02,083444,Staff,0,15,30,30
1650031498712,MATH 10C,B01,084114,Staff,19,0,30,11
1650031498712,MATH 10C,B02,084115,Staff,25,0,30,5
1650031504742,MATH 18,A01,084117,Harel; Guershon,14,0,30,16
1650031504742,MATH 18,A02,084119,Harel; Guershon,27,0,30,3
1650031504742,MATH 18,A03,084120,Harel; Guershon,30,0,30,0
1650031504742,MATH 18,A04,084121,Harel; Guershon,29,0,30,1
1650031510767,MATH 20B,A01,084124,Um; Ko Woon,15,0,35,20
1650031510767,MATH 20B,B01,084126,Um; Ko Woon,24,0,35,11
1650031516799,MATH 20C,A01,083446,Hammock; Frances H,0,0,30,30
1650031516799,MATH 20C,A02,083447,Hammock; Frances H,16,0,30,14
1650031516799,MATH 20C,A03,083448,Hammock; Frances H,19,0,30,11
1650031516799,MATH 20C,A04,083449,Hammock; Frances H,20,0,30,10
1650031516799,MATH 20C,B01,083451,Hammock; Frances H,0,0,30,30
1650031516799,MATH 20C,B02,083452,Hammock; Frances H,19,0,30,11
1650031516799,MATH 20C,B03,083453,Hammock; Frances H,21,0,30,9
1650031516799,MATH 20C,B04,083454,Hammock; Frances H,23,0,30,7
1650031522830,MATH 20D,A01,084128,Staff,14,0,30,16
1650031522830,MATH 20D,A02,084129,Staff,29,0,30,1
1650031522830,MATH 20D,A03,084130,Staff,27,0,30,3
1650031522830,MATH 20D,B01,084133,Staff,3,0,30,27
1650031522830,MATH 20D,B02,084134,Staff,24,0,30,6
1650031522830,MATH 20D,B03,084135,Staff,28,0,30,2
1650031528854,MATH 20E,A01,084138,Staff,14,0,30,16
1650031528854,MATH 20E,A02,084139,Staff,6,0,30,24
1650031528854,MATH 20E,A03,084140,Staff,15,0,30,15
1650031528854,MATH 20E,A04,084141,Staff,20,0,30,10
1650031534881,MATH 102,A01,084143,Harel; Guershon,12,0,30,18
1650031534881,MATH 102,A02,084144,Harel; Guershon,19,0,30,11
1650031540906,MATH 103B,A01,083456,Staff,0,13,30,30
1650031540906,MATH 103B,A02,083457,Staff,0,14,30,30
1650031546938,MATH 109,A01,084146,Salehi Golsefidy; Alireza,17,0,30,13
1650031546938,MATH 109,A02,084147,Salehi Golsefidy; Alireza,15,0,30,15
1650031552963,MATH 120A,A01,085445,Eggers; John Dietrich,10,0,35,25
1650031552963,MATH 120A,A02,085446,Eggers; John Dietrich,27,0,35,8
1650031558995,MATH 142B,A01,084149,Verstraete; Jacques Allan,0,12,30,30
1650031558995,MATH 142B,A02,084150,Verstraete; Jacques Allan,0,12,30,30
1650031565019,MATH 170A,A01,083459,Nie; Jiawang,0,9,30,30
1650031565019,MATH 170A,A02,083460,Nie; Jiawang,0,8,30,30
1650031565019,MATH 170A,A03,083461,Nie; Jiawang,0,9,30,30
1650031571049,MATH 193B,A01,083463,Staff,1,0,30,29
1650031571049,MATH 193B,A02,083464,Staff,9,0,30,21
1650031571049,MATH 193B,A03,083465,Staff,18,0,30,12
1650031577119,COGS 2,A01,083966,Boyle; Mary E. T.,9,0,30,21
1650031583149,COGS 9,A01,083968,Staff,9,0,60,51
1650031589174,COGS 14B,A01,083970,Staff,9,0,50,41
1650031595201,COGS 17,A01,092679,Staff,50,0,75,25
1650031601230,COGS 100,A01,083972,Staff,0,15,60,60
1650031613297,COGS 101C,A01,083976,Staff,12,0,30,18
1650031619341,COGS 102A,A01,083978,Johnson; Christine M.,14,0,30,16
1650031625369,COGS 107B,A01,083980,Staff,0,7,50,50
1650031631392,COGS 115,A01,083982,Staff,10,0,30,20
1650031637420,COGS 118B,A01,083367,Staff,0,15,40,40
1650031643456,COGS 172,A01,083984,Provenzano; Emily Kara,15,0,30,15
1650031649481,COGS 177,A00,083368,Staff,0,20,30,30
1650031655505,COGS 186,A01,083986,Staff,21,0,40,19
1650031661622,COGS 187A,A01,083988,Boyle; Mary E. T.,20,0,60,40
1650031667647,CSE 8A,A50,084003,Miranda; Gregory Joseph,0,13,15,15
1650031673679,CSE 11,A01,084005,Miranda; Gregory Joseph,0,22,55,55
1650031679706,CSE 20,A01,084007,Staff,0,5,20,20
1650031685731,CSE 21,A01,084009,Staff,0,30,50,50
1650031693202,CSE 30,A01,083370,Cao; Yingjun,0,65,40,40
1650031699234,CSE 100,A01,083372,Cao; Yingjun,0,46,40,40
1650031705259,CSE 101,A01,084011,Staff,0,54,40,40
1650031711287,CSE 141,A01,083374,Eldon; John,0,64,75,75
1650031717319,CSE 141L,A01,083376,Eldon; John,0,70,75,75
1650031723343,CSE 175,A01,084013,Kumar; Rakesh,22,0,25,3
1650031729368,CSE 190,A00,092508,Dubnov; Shlomo,20,0,20,0
1650031735393,ECE 5,A01,084049,Morris; Karcher William,13,0,20,7
1650031741420,ECE 100,A01,084051,Baghdadchi; Saharnaz,0,0,20,20
1650031741420,ECE 100,A02,091916,Baghdadchi; Saharnaz,13,0,20,7
1650031747447,ECE 101,A01,084053,Baghdadchi; Saharnaz,0,0,37,37
1650031747447,ECE 101,A02,084054,Baghdadchi; Saharnaz,30,0,37,7
1650031753471,ECE 107,A01,083390,Staff,26,0,40,14
1650031759497,ECE 148,A01,084056,Silberman; Jack,8,0,12,4
1650031765525,ECE 180,A00,083391,Abi Samra; Nicholas Camill,25,0,30,5
1650031765525,ECE 180,B00,083392,Abi Samra; Nicholas Camill,21,0,30,9
1650031771549,MATH 10B,A01,084110,Staff,0,0,30,30
1650031771549,MATH 10B,A02,084111,Staff,18,0,30,12
1650031771549,MATH 10B,A03,084112,Staff,24,0,30,6
1650031777574,MATH 10C,A01,083443,Staff,0,16,30,30
1650031777574,MATH 10C,A02,083444,Staff,0,15,30,30
1650031777574,MATH 10C,B01,084114,Staff,19,0,30,11
1650031777574,MATH 10C,B02,084115,Staff,25,0,30,5
1650031783599,MATH 18,A01,084117,Harel; Guershon,14,0,30,16
1650031783599,MATH 18,A02,084119,Harel; Guershon,27,0,30,3
1650031783599,MATH 18,A03,084120,Harel; Guershon,30,0,30,0
1650031783599,MATH 18,A04,084121,Harel; Guershon,29,0,30,1
1650031789642,MATH 20B,A01,084124,Um; Ko Woon,15,0,35,20
1650031789642,MATH 20B,B01,084126,Um; Ko Woon,24,0,35,11
1650031795669,MATH 20C,A01,083446,Hammock; Frances H,0,0,30,30
1650031795669,MATH 20C,A02,083447,Hammock; Frances H,16,0,30,14
1650031795669,MATH 20C,A03,083448,Hammock; Frances H,19,0,30,11
1650031795669,MATH 20C,A04,083449,Hammock; Frances H,20,0,30,10
1650031795669,MATH 20C,B01,083451,Hammock; Frances H,0,0,30,30
1650031795669,MATH 20C,B02,083452,Hammock; Frances H,18,0,30,12
1650031795669,MATH 20C,B03,083453,Hammock; Frances H,21,0,30,9
1650031795669,MATH 20C,B04,083454,Hammock; Frances H,23,0,30,7
1650031801697,MATH 20D,A01,084128,Staff,14,0,30,16
1650031801697,MATH 20D,A02,084129,Staff,29,0,30,1
1650031801697,MATH 20D,A03,084130,Staff,27,0,30,3
1650031801697,MATH 20D,B01,084133,Staff,3,0,30,27
1650031801697,MATH 20D,B02,084134,Staff,24,0,30,6
1650031801697,MATH 20D,B03,084135,Staff,28,0,30,2
1650031807723,MATH 20E,A01,084138,Staff,14,0,30,16
1650031807723,MATH 20E,A02,084139,Staff,6,0,30,24
1650031807723,MATH 20E,A03,084140,Staff,15,0,30,15
1650031807723,MATH 20E,A04,084141,Staff,20,0,30,10
1650031813761,MATH 102,A01,084143,Harel; Guershon,12,0,30,18
1650031813761,MATH 102,A02,084144,Harel; Guershon,19,0,30,11
1650031819789,MATH 103B,A01,083456,Staff,0,13,30,30
1650031819789,MATH 103B,A02,083457,Staff,0,14,30,30
1650031825822,MATH 109,A01,084146,Salehi Golsefidy; Alireza,17,0,30,13
1650031825822,MATH 109,A02,084147,Salehi Golsefidy; Alireza,15,0,30,15
1650031831846,MATH 120A,A01,085445,Eggers; John Dietrich,10,0,35,25
1650031831846,MATH 120A,A02,085446,Eggers; John Dietrich,27,0,35,8
1650031837874,MATH 142B,A01,084149,Verstraete; Jacques Allan,0,12,30,30
1650031837874,MATH 142B,A02,084150,Verstraete; Jacques Allan,0,12,30,30
1650031843904,MATH 170A,A01,083459,Nie; Jiawang,0,9,30,30
1650031843904,MATH 170A,A02,083460,Nie; Jiawang,0,8,30,30
1650031843904,MATH 170A,A03,083461,Nie; Jiawang,0,9,30,30
1650031849931,MATH 193B,A01,083463,Staff,1,0,30,29
1650031849931,MATH 193B,A02,083464,Staff,9,0,30,21
1650031849931,MATH 193B,A03,083465,Staff,18,0,30,12
1650031855994,COGS 2,A01,083966,Boyle; Mary E. T.,9,0,30,21
1650031862026,COGS 9,A01,083968,Staff,9,0,60,51
1650031868055,COGS 14B,A01,083970,Staff,9,0,50,41
1650031874078,COGS 17,A01,092679,Staff,50,0,75,25
1650031880101,COGS 100,A01,083972,Staff,0,15,60,60
1650031892153,COGS 101C,A01,083976,Staff,12,0,30,18
1650031898177,COGS 102A,A01,083978,Johnson; Christine M.,14,0,30,16
1650031904202,COGS 107B,A01,083980,Staff,0,7,50,50
1650031910232,COGS 115,A01,083982,Staff,10,0,30,20
1650031916258,COGS 118B,A01,083367,Staff,0,15,40,40
1650031922283,COGS 172,A01,083984,Provenzano; Emily Kara,15,0,30,15
1650031928306,COGS 177,A00,083368,Staff,0,20,30,30
1650031934334,COGS 186,A01,083986,Staff,21,0,40,19
1650031940359,COGS 187A,A01,083988,Boyle; Mary E. T.,20,0,60,40
1650031946389,CSE 8A,A50,084003,Miranda; Gregory Joseph,0,13,15,15
1650031952434,CSE 11,A01,084005,Miranda; Gregory Joseph,0,22,55,55
1650031958468,CSE 20,A01,084007,Staff,0,5,20,20
1650031964493,CSE 21,A01,084009,Staff,0,30,50,50
1650031970521,CSE 30,A01,083370,Cao; Yingjun,0,65,40,40
1650031976549,CSE 100,A01,083372,Cao; Yingjun,0,46,40,40
1650031982579,CSE 101,A01,084011,Staff,0,54,40,40
1650031988604,CSE 141,A01,083374,Eldon; John,0,64,75,75
1650031994629,CSE 141L,A01,083376,Eldon; John,0,70,75,75
1650032000657,CSE 175,A01,084013,Kumar; Rakesh,22,0,25,3
1650032006701,CSE 190,A00,092508,Dubnov; Shlomo,20,0,20,0
1650032012730,ECE 5,A01,084049,Morris; Karcher William,13,0,20,7
1650032018756,ECE 100,A01,084051,Baghdadchi; Saharnaz,0,0,20,20
1650032018756,ECE 100,A02,091916,Baghdadchi; Saharnaz,13,0,20,7
1650032024800,ECE 101,A01,084053,Baghdadchi; Saharnaz,0,0,37,37
1650032024800,ECE 101,A02,084054,Baghdadchi; Saharnaz,30,0,37,7
1650032030840,ECE 107,A01,083390,Staff,26,0,40,14
1650032036865,ECE 148,A01,084056,Silberman; Jack,8,0,12,4
1650032042899,ECE 180,A00,083391,Abi Samra; Nicholas Camill,25,0,30,5
1650032042899,ECE 180,B00,083392,Abi Samra; Nicholas Camill,21,0,30,9
1650032048925,MATH 10B,A01,084110,Staff,0,0,30,30
1650032048925,MATH 10B,A02,084111,Staff,18,0,30,12
1650032048925,MATH 10B,A03,084112,Staff,24,0,30,6
1650032054955,MATH 10C,A01,083443,Staff,0,16,30,30
1650032054955,MATH 10C,A02,083444,Staff,0,15,30,30
1650032054955,MATH 10C,B01,084114,Staff,19,0,30,11
1650032054955,MATH 10C,B02,084115,Staff,25,0,30,5
1650032060985,MATH 18,A01,084117,Harel; Guershon,14,0,30,16
1650032060985,MATH 18,A02,084119,Harel; Guershon,27,0,30,3
1650032060985,MATH 18,A03,084120,Harel; Guershon,30,0,30,0
1650032060985,MATH 18,A04,084121,Harel; Guershon,29,0,30,1
1650032067019,MATH 20B,A01,084124,Um; Ko Woon,15,0,35,20
1650032067019,MATH 20B,B01,084126,Um; Ko Woon,24,0,35,11
1650032073047,MATH 20C,A01,083446,Hammock; Frances H,0,0,30,30
1650032073047,MATH 20C,A02,083447,Hammock; Frances H,16,0,30,14
1650032073047,MATH 20C,A03,083448,Hammock; Frances H,19,0,30,11
1650032073047,MATH 20C,A04,083449,Hammock; Frances H,20,0,30,10
1650032073047,MATH 20C,B01,083451,Hammock; Frances H,0,0,30,30
1650032073047,MATH 20C,B02,083452,Hammock; Frances H,18,0,30,12
1650032073047,MATH 20C,B03,083453,Hammock; Frances H,21,0,30,9
1650032073047,MATH 20C,B04,083454,Hammock; Frances H,23,0,30,7
1650032079074,MATH 20D,A01,084128,Staff,14,0,30,16
1650032079074,MATH 20D,A02,084129,Staff,29,0,30,1
1650032079074,MATH 20D,A03,084130,Staff,27,0,30,3
1650032079074,MATH 20D,B01,084133,Staff,3,0,30,27
1650032079074,MATH 20D,B02,084134,Staff,24,0,30,6
1650032079074,MATH 20D,B03,084135,Staff,28,0,30,2
1650032085098,MATH 20E,A01,084138,Staff,14,0,30,16
1650032085098,MATH 20E,A02,084139,Staff,6,0,30,24
1650032085098,MATH 20E,A03,084140,Staff,15,0,30,15
1650032085098,MATH 20E,A04,084141,Staff,20,0,30,10
1650032091130,MATH 102,A01,084143,Harel; Guershon,12,0,30,18
1650032091130,MATH 102,A02,084144,Harel; Guershon,19,0,30,11
1650032097166,MATH 103B,A01,083456,Staff,0,13,30,30
1650032097166,MATH 103B,A02,083457,Staff,0,14,30,30
1650032103192,MATH 109,A01,084146,Salehi Golsefidy; Alireza,17,0,30,13
1650032103192,MATH 109,A02,084147,Salehi Golsefidy; Alireza,15,0,30,15
1650032109215,MATH 120A,A01,085445,Eggers; John Dietrich,10,0,35,25
1650032109215,MATH 120A,A02,085446,Eggers; John Dietrich,27,0,35,8
1650032115241,MATH 142B,A01,084149,Verstraete; Jacques Allan,0,12,30,30
1650032115241,MATH 142B,A02,084150,Verstraete; Jacques Allan,0,12,30,30
1650032121273,MATH 170A,A01,083459,Nie; Jiawang,0,9,30,30
1650032121273,MATH 170A,A02,083460,Nie; Jiawang,0,8,30,30
1650032121273,MATH 170A,A03,083461,Nie; Jiawang,0,9,30,30
1650032127301,MATH 193B,A01,083463,Staff,1,0,30,29
1650032127301,MATH 193B,A02,083464,Staff,9,0,30,21
1650032127301,MATH 193B,A03,083465,Staff,18,0,30,12
1650032133373,COGS 2,A01,083966,Boyle; Mary E. T.,9,0,30,21
1650032139398,COGS 9,A01,083968,Staff,9,0,60,51
1650032145427,COGS 14B,A01,083970,Staff,9,0,50,41
1650032151463,COGS 17,A01,092679,Staff,50,0,75,25
1650032157488,COGS 100,A01,083972,Staff,0,15,60,60
1650032169540,COGS 101C,A01,083976,Staff,12,0,30,18
1650032175566,COGS 102A,A01,083978,Johnson; Christine M.,14,0,30,16
1650032181591,COGS 107B,A01,083980,Staff,0,7,50,50
1650032187616,COGS 115,A01,083982,Staff,10,0,30,20
1650032193641,COGS 118B,A01,083367,Staff,0,15,40,40
1650032199666,COGS 172,A01,083984,Provenzano; Emily Kara,15,0,30,15
1650032205691,COGS 177,A00,083368,Staff,0,20,30,30
1650032211719,COGS 186,A01,083986,Staff,21,0,40,19
1650032217744,COGS 187A,A01,083988,Boyle; Mary E. T.,20,0,60,40
1650032223780,CSE 8A,A50,084003,Miranda; Gregory Joseph,0,13,15,15
1650032229812,CSE 11,A01,084005,Miranda; Gregory Joseph,0,22,55,55
1650032235857,CSE 20,A01,084007,Staff,0,5,20,20
1650032241880,CSE 21,A01,084009,Staff,0,30,50,50
1650032247917,CSE 30,A01,083370,Cao; Yingjun,0,65,40,40
1650032253942,CSE 100,A01,083372,Cao; Yingjun,0,46,40,40
1650032260078,CSE 101,A01,084011,Staff,0,54,40,40
1650032266106,CSE 141,A01,083374,Eldon; John,0,64,75,75
1650032272134,CSE 141L,A01,083376,Eldon; John,0,70,75,75
1650032278159,CSE 175,A01,084013,Kumar; Rakesh,22,0,25,3
1650032284184,CSE 190,A00,092508,Dubnov; Shlomo,20,0,20,0
1650032290212,ECE 5,A01,084049,Morris; Karcher William,13,0,20,7
1650032296240,ECE 100,A01,084051,Baghdadchi; Saharnaz,0,0,20,20
1650032296240,ECE 100,A02,091916,Baghdadchi; Saharnaz,13,0,20,7
1650032302270,ECE 101,A01,084053,Baghdadchi; Saharnaz,0,0,37,37
1650032302270,ECE 101,A02,084054,Baghdadchi; Saharnaz,30,0,37,7
1650032308294,ECE 107,A01,083390,Staff,26,0,40,14
1650032314323,ECE 148,A01,084056,Silberman; Jack,8,0,12,4
1650032320350,ECE 180,A00,083391,Abi Samra; Nicholas Camill,25,0,30,5
1650032320350,ECE 180,B00,083392,Abi Samra; Nicholas Camill,21,0,30,9
1650032326376,MATH 10B,A01,084110,Staff,0,0,30,30
1650032326376,MATH 10B,A02,084111,Staff,18,0,30,12
1650032326376,MATH 10B,A03,084112,Staff,24,0,30,6
1650032332401,MATH 10C,A01,083443,Staff,0,16,30,30
1650032332401,MATH 10C,A02,083444,Staff,0,15,30,30
1650032332401,MATH 10C,B01,084114,Staff,19,0,30,11
1650032332401,MATH 10C,B02,084115,Staff,25,0,30,5
1650032338426,MATH 18,A01,084117,Harel; Guershon,14,0,30,16
1650032338426,MATH 18,A02,084119,Harel; Guershon,27,0,30,3
1650032338426,MATH 18,A03,084120,Harel; Guershon,30,0,30,0
1650032338426,MATH 18,A04,084121,Harel; Guershon,29,0,30,1
1650032344452,MATH 20B,A01,084124,Um; Ko Woon,15,0,35,20
1650032344452,MATH 20B,B01,084126,Um; Ko Woon,24,0,35,11
1650032350478,MATH 20C,A01,083446,Hammock; Frances H,0,0,30,30
1650032350478,MATH 20C,A02,083447,Hammock; Frances H,16,0,30,14
1650032350478,MATH 20C,A03,083448,Hammock; Frances H,19,0,30,11
1650032350478,MATH 20C,A04,083449,Hammock; Frances H,20,0,30,10
1650032350478,MATH 20C,B01,083451,Hammock; Frances H,0,0,30,30
1650032350478,MATH 20C,B02,083452,Hammock; Frances H,18,0,30,12
1650032350478,MATH 20C,B03,083453,Hammock; Frances H,21,0,30,9
1650032350478,MATH 20C,B04,083454,Hammock; Frances H,23,0,30,7
1650032356509,MATH 20D,A01,084128,Staff,14,0,30,16
1650032356509,MATH 20D,A02,084129,Staff,29,0,30,1
1650032356509,MATH 20D,A03,084130,Staff,27,0,30,3
1650032356509,MATH 20D,B01,084133,Staff,3,0,30,27
1650032356509,MATH 20D,B02,084134,Staff,24,0,30,6
1650032356509,MATH 20D,B03,084135,Staff,28,0,30,2
1650032362533,MATH 20E,A01,084138,Staff,14,0,30,16
1650032362533,MATH 20E,A02,084139,Staff,6,0,30,24
1650032362533,MATH 20E,A03,084140,Staff,15,0,30,15
1650032362533,MATH 20E,A04,084141,Staff,20,0,30,10
1650032368560,MATH 102,A01,084143,Harel; Guershon,12,0,30,18
1650032368560,MATH 102,A02,084144,Harel; Guershon,19,0,30,11
1650032374584,MATH 103B,A01,083456,Staff,0,13,30,30
1650032374584,MATH 103B,A02,083457,Staff,0,14,30,30
1650032380607,MATH 109,A01,084146,Salehi Golsefidy; Alireza,17,0,30,13
1650032380607,MATH 109,A02,084147,Salehi Golsefidy; Alireza,15,0,30,15
1650032386636,MATH 120A,A01,085445,Eggers; John Dietrich,10,0,35,25
1650032386636,MATH 120A,A02,085446,Eggers; John Dietrich,27,0,35,8
1650032392661,MATH 142B,A01,084149,Verstraete; Jacques Allan,0,12,30,30
1650032392661,MATH 142B,A02,084150,Verstraete; Jacques Allan,0,12,30,30
1650032398686,MATH 170A,A01,083459,Nie; Jiawang,0,9,30,30
1650032398686,MATH 170A,A02,083460,Nie; Jiawang,0,8,30,30
1650032398686,MATH 170A,A03,083461,Nie; Jiawang,0,9,30,30
1650032404715,MATH 193B,A01,083463,Staff,1,0,30,29
1650032404715,MATH 193B,A02,083464,Staff,9,0,30,21
1650032404715,MATH 193B,A03,083465,Staff,18,0,30,12
1650032410775,COGS 2,A01,083966,Boyle; Mary E. T.,9,0,30,21
1650032416805,COGS 9,A01,083968,Staff,9,0,60,51
1650032422828,COGS 14B,A01,083970,Staff,9,0,50,41
1650032428864,COGS 17,A01,092679,Staff,50,0,75,25
1650032434895,COGS 100,A01,083972,Staff,0,15,60,60
1650032446945,COGS 101C,A01,083976,Staff,12,0,30,18
1650032452976,COGS 102A,A01,083978,Johnson; Christine M.,14,0,30,16
1650032459001,COGS 107B,A01,083980,Staff,0,7,50,50
1650032465030,COGS 115,A01,083982,Staff,10,0,30,20
1650032471058,COGS 118B,A01,083367,Staff,0,15,40,40
1650032477082,COGS 172,A01,083984,Provenzano; Emily Kara,15,0,30,15
1650032483109,COGS 177,A00,083368,Staff,0,20,30,30
1650032489133,COGS 186,A01,083986,Staff,21,0,40,19
1650032495156,COGS 187A,A01,083988,Boyle; Mary E. T.,20,0,60,40
1650032501188,CSE 8A,A50,084003,Miranda; Gregory Joseph,0,13,15,15
1650032507213,CSE 11,A01,084005,Miranda; Gregory Joseph,0,22,55,55
1650032513240,CSE 20,A01,084007,Staff,0,5,20,20
1650032519265,CSE 21,A01,084009,Staff,0,30,50,50
1650032525292,CSE 30,A01,083370,Cao; Yingjun,0,65,40,40
1650032531316,CSE 100,A01,083372,Cao; Yingjun,0,46,40,40
1650032537341,CSE 101,A01,084011,Staff,0,54,40,40
1650032543368,CSE 141,A01,083374,Eldon; John,0,64,75,75
1650032549397,CSE 141L,A01,083376,Eldon; John,0,70,75,75
1650032555422,CSE 175,A01,084013,Kumar; Rakesh,22,0,25,3
1650032561447,CSE 190,A00,092508,Dubnov; Shlomo,20,0,20,0
1650032567482,ECE 5,A01,084049,Morris; Karcher William,13,0,20,7
1650032573524,ECE 100,A01,084051,Baghdadchi; Saharnaz,0,0,20,20
1650032573524,ECE 100,A02,091916,Baghdadchi; Saharnaz,13,0,20,7
1650032579554,ECE 101,A01,084053,Baghdadchi; Saharnaz,0,0,37,37
1650032579554,ECE 101,A02,084054,Baghdadchi; Saharnaz,30,0,37,7
1650032585579,ECE 107,A01,083390,Staff,26,0,40,14
1650032591603,ECE 148,A01,084056,Silberman; Jack,8,0,12,4
1650032597627,ECE 180,A00,083391,Abi Samra; Nicholas Camill,25,0,30,5
1650032597627,ECE 180,B00,083392,Abi Samra; Nicholas Camill,21,0,30,9
1650032603665,MATH 10B,A01,084110,Staff,0,0,30,30
1650032603665,MATH 10B,A02,084111,Staff,18,0,30,12
1650032603665,MATH 10B,A03,084112,Staff,24,0,30,6
1650032609688,MATH 10C,A01,083443,Staff,0,16,30,30
1650032609688,MATH 10C,A02,083444,Staff,0,15,30,30
1650032609688,MATH 10C,B01,084114,Staff,19,0,30,11
1650032609688,MATH 10C,B02,084115,Staff,25,0,30,5
1650032615713,MATH 18,A01,084117,Harel; Guershon,14,0,30,16
1650032615713,MATH 18,A02,084119,Harel; Guershon,27,0,30,3
1650032615713,MATH 18,A03,084120,Harel; Guershon,30,0,30,0
1650032615713,MATH 18,A04,084121,Harel; Guershon,29,0,30,1
1650032621739,MATH 20B,A01,084124,Um; Ko Woon,15,0,35,20
1650032621739,MATH 20B,B01,084126,Um; Ko Woon,24,0,35,11
1650032627767,MATH 20C,A01,083446,Hammock; Frances H,0,0,30,30
1650032627767,MATH 20C,A02,083447,Hammock; Frances H,16,0,30,14
1650032627767,MATH 20C,A03,083448,Hammock; Frances H,19,0,30,11
1650032627767,MATH 20C,A04,083449,Hammock; Frances H,20,0,30,10
1650032627767,MATH 20C,B01,083451,Hammock; Frances H,0,0,30,30
1650032627767,MATH 20C,B02,083452,Hammock; Frances H,18,0,30,12
1650032627767,MATH 20C,B03,083453,Hammock; Frances H,21,0,30,9
1650032627767,MATH 20C,B04,083454,Hammock; Frances H,23,0,30,7
1650032633790,MATH 20D,A01,084128,Staff,14,0,30,16
1650032633790,MATH 20D,A02,084129,Staff,29,0,30,1
1650032633790,MATH 20D,A03,084130,Staff,27,0,30,3
1650032633790,MATH 20D,B01,084133,Staff,3,0,30,27
1650032633790,MATH 20D,B02,084134,Staff,24,0,30,6
1650032633790,MATH 20D,B03,084135,Staff,28,0,30,2
1650032639845,MATH 20E,A01,084138,Staff,14,0,30,16
1650032639845,MATH 20E,A02,084139,Staff,6,0,30,24
1650032639845,MATH 20E,A03,084140,Staff,15,0,30,15
1650032639845,MATH 20E,A04,084141,Staff,20,0,30,10
1650032645880,MATH 102,A01,084143,Harel; Guershon,12,0,30,18
1650032645880,MATH 102,A02,084144,Harel; Guershon,19,0,30,11
1650032651916,MATH 103B,A01,083456,Staff,0,13,30,30
1650032651916,MATH 103B,A02,083457,Staff,0,14,30,30
1650032657941,MATH 109,A01,084146,Salehi Golsefidy; Alireza,17,0,30,13
1650032657941,MATH 109,A02,084147,Salehi Golsefidy; Alireza,15,0,30,15
1650032663969,MATH 120A,A01,085445,Eggers; John Dietrich,10,0,35,25
1650032663969,MATH 120A,A02,085446,Eggers; John Dietrich,27,0,35,8
1650032669993,MATH 142B,A01,084149,Verstraete; Jacques Allan,0,12,30,30
1650032669993,MATH 142B,A02,084150,Verstraete; Jacques Allan,0,12,30,30
1650032676018,MATH 170A,A01,083459,Nie; Jiawang,0,9,30,30
1650032676018,MATH 170A,A02,083460,Nie; Jiawang,0,8,30,30
1650032676018,MATH 170A,A03,083461,Nie; Jiawang,0,9,30,30
1650032682040,MATH 193B,A01,083463,Staff,1,0,30,29
1650032682040,MATH 193B,A02,083464,Staff,9,0,30,21
1650032682040,MATH 193B,A03,083465,Staff,18,0,30,12
1650032688091,COGS 2,A01,083966,Boyle; Mary E. T.,9,0,30,21
1650032694115,COGS 9,A01,083968,Staff,9,0,60,51
1650032700142,COGS 14B,A01,083970,Staff,9,0,50,41
1650032706166,COGS 17,A01,092679,Staff,50,0,75,25
1650032712196,COGS 100,A01,083972,Staff,0,15,60,60
1650032724245,COGS 101C,A01,083976,Staff,12,0,30,18
1650032730271,COGS 102A,A01,083978,Johnson; Christine M.,14,0,30,16
1650032736298,COGS 107B,A01,083980,Staff,0,7,50,50
1650032742323,COGS 115,A01,083982,Staff,10,0,30,20
1650032748348,COGS 118B,A01,083367,Staff,0,15,40,40
1650032754372,COGS 172,A01,083984,Provenzano; Emily Kara,15,0,30,15
1650032760398,COGS 177,A00,083368,Staff,0,20,30,30
1650032766422,COGS 186,A01,083986,Staff,21,0,40,19
1650032772448,COGS 187A,A01,083988,Boyle; Mary E. T.,20,0,60,40
1650032778472,CSE 8A,A50,084003,Miranda; Gregory Joseph,0,13,15,15
1650032784508,CSE 11,A01,084005,Miranda; Gregory Joseph,0,22,55,55
1650032790534,CSE 20,A01,084007,Staff,0,5,20,20
1650032796562,CSE 21,A01,084009,Staff,0,30,50,50
1650032802587,CSE 30,A01,083370,Cao; Yingjun,0,65,40,40
1650032808623,CSE 100,A01,083372,Cao; Yingjun,0,46,40,40
1650032814647,CSE 101,A01,084011,Staff,0,54,40,40
1650032820680,CSE 141,A01,083374,Eldon; John,0,64,75,75
1650032826707,CSE 141L,A01,083376,Eldon; John,0,70,75,75
1650032832732,CSE 175,A01,084013,Kumar; Rakesh,22,0,25,3
1650032838757,CSE 190,A00,092508,Dubnov; Shlomo,20,0,20,0
1650032844783,ECE 5,A01,084049,Morris; Karcher William,13,0,20,7
1650032850810,ECE 100,A01,084051,Baghdadchi; Saharnaz,0,0,20,20
1650032850810,ECE 100,A02,091916,Baghdadchi; Saharnaz,13,0,20,7
1650032856952,ECE 101,A01,084053,Baghdadchi; Saharnaz,0,0,37,37
1650032856952,ECE 101,A02,084054,Baghdadchi; Saharnaz,30,0,37,7
1650032862976,ECE 107,A01,083390,Staff,26,0,40,14
1650032869003,ECE 148,A01,084056,Silberman; Jack,8,0,12,4
1650032875027,ECE 180,A00,083391,Abi Samra; Nicholas Camill,25,0,30,5
1650032875027,ECE 180,B00,083392,Abi Samra; Nicholas Camill,21,0,30,9
1650032881052,MATH 10B,A01,084110,Staff,0,0,30,30
1650032881052,MATH 10B,A02,084111,Staff,18,0,30,12
1650032881052,MATH 10B,A03,084112,Staff,24,0,30,6
1650032887077,MATH 10C,A01,083443,Staff,0,16,30,30
1650032887077,MATH 10C,A02,083444,Staff,0,15,30,30
1650032887077,MATH 10C,B01,084114,Staff,19,0,30,11
1650032887077,MATH 10C,B02,084115,Staff,25,0,30,5
1650032893105,MATH 18,A01,084117,Harel; Guershon,14,0,30,16
1650032893105,MATH 18,A02,084119,Harel; Guershon,27,0,30,3
1650032893105,MATH 18,A03,084120,Harel; Guershon,30,0,30,0
1650032893105,MATH 18,A04,084121,Harel; Guershon,29,0,30,1
1650032899136,MATH 20B,A01,084124,Um; Ko Woon,14,0,35,21
1650032899136,MATH 20B,B01,084126,Um; Ko Woon,24,0,35,11
1650032905162,MATH 20C,A01,083446,Hammock; Frances H,0,0,30,30
1650032905162,MATH 20C,A02,083447,Hammock; Frances H,16,0,30,14
1650032905162,MATH 20C,A03,083448,Hammock; Frances H,19,0,30,11
1650032905162,MATH 20C,A04,083449,Hammock; Frances H,20,0,30,10
1650032905162,MATH 20C,B01,083451,Hammock; Frances H,0,0,30,30
1650032905162,MATH 20C,B02,083452,Hammock; Frances H,18,0,30,12
1650032905162,MATH 20C,B03,083453,Hammock; Frances H,21,0,30,9
1650032905162,MATH 20C,B04,083454,Hammock; Frances H,23,0,30,7
1650032911187,MATH 20D,A01,084128,Staff,14,0,30,16
1650032911187,MATH 20D,A02,084129,Staff,29,0,30,1
1650032911187,MATH 20D,A03,084130,Staff,27,0,30,3
1650032911187,MATH 20D,B01,084133,Staff,3,0,30,27
1650032911187,MATH 20D,B02,084134,Staff,24,0,30,6
1650032911187,MATH 20D,B03,084135,Staff,28,0,30,2
1650032917214,MATH 20E,A01,084138,Staff,14,0,30,16
1650032917214,MATH 20E,A02,084139,Staff,6,0,30,24
1650032917214,MATH 20E,A03,084140,Staff,15,0,30,15
1650032917214,MATH 20E,A04,084141,Staff,20,0,30,10
1650032923239,MATH 102,A01,084143,Harel; Guershon,12,0,30,18
1650032923239,MATH 102,A02,084144,Harel; Guershon,19,0,30,11
1650032929261,MATH 103B,A01,083456,Staff,0,13,30,30
1650032929261,MATH 103B,A02,083457,Staff,0,14,30,30
1650032935288,MATH 109,A01,084146,Salehi Golsefidy; Alireza,17,0,30,13
1650032935288,MATH 109,A02,084147,Salehi Golsefidy; Alireza,15,0,30,15
1650032941317,MATH 120A,A01,085445,Eggers; John Dietrich,10,0,35,25
1650032941317,MATH 120A,A02,085446,Eggers; John Dietrich,27,0,35,8
1650032947344,MATH 142B,A01,084149,Verstraete; Jacques Allan,0,12,30,30
1650032947344,MATH 142B,A02,084150,Verstraete; Jacques Allan,0,12,30,30
1650032953373,MATH 170A,A01,083459,Nie; Jiawang,0,9,30,30
1650032953373,MATH 170A,A02,083460,Nie; Jiawang,0,8,30,30
1650032953373,MATH 170A,A03,083461,Nie; Jiawang,0,9,30,30
1650032959401,MATH 193B,A01,083463,Staff,1,0,30,29
1650032959401,MATH 193B,A02,083464,Staff,9,0,30,21
1650032959401,MATH 193B,A03,083465,Staff,18,0,30,12
1650032965466,COGS 2,A01,083966,Boyle; Mary E. T.,9,0,30,21
1650032971492,COGS 9,A01,083968,Staff,9,0,60,51
1650032977520,COGS 14B,A01,083970,Staff,9,0,50,41
1650032983550,COGS 17,A01,092679,Staff,50,0,75,25
1650032989575,COGS 100,A01,083972,Staff,0,15,60,60
1650033001625,COGS 101C,A01,083976,Staff,12,0,30,18
1650033007649,COGS 102A,A01,083978,Johnson; Christine M.,14,0,30,16
1650033013685,COGS 107B,A01,083980,Staff,0,7,50,50
1650033019716,COGS 115,A01,083982,Staff,10,0,30,20
1650033025740,COGS 118B,A01,083367,Staff,0,15,40,40
1650033031764,COGS 172,A01,083984,Provenzano; Emily Kara,15,0,30,15
1650033037788,COGS 177,A00,083368,Staff,0,20,30,30
1650033043819,COGS 186,A01,083986,Staff,21,0,40,19
1650033049848,COGS 187A,A01,083988,Boyle; Mary E. T.,20,0,60,40
1650033055877,CSE 8A,A50,084003,Miranda; Gregory Joseph,0,13,15,15
1650033061914,CSE 11,A01,084005,Miranda; Gregory Joseph,0,22,55,55
1650033067941,CSE 20,A01,084007,Staff,0,5,20,20
1650033073967,CSE 21,A01,084009,Staff,0,30,50,50
1650033079994,CSE 30,A01,083370,Cao; Yingjun,0,65,40,40
1650033086030,CSE 100,A01,083372,Cao; Yingjun,0,46,40,40
1650033092059,CSE 101,A01,084011,Staff,0,54,40,40
1650033098085,CSE 141,A01,083374,Eldon; John,0,64,75,75
1650033104117,CSE 141L,A01,083376,Eldon; John,0,70,75,75
1650033110148,CSE 175,A01,084013,Kumar; Rakesh,22,0,25,3
1650033116180,CSE 190,A00,092508,Dubnov; Shlomo,20,0,20,0
1650033122207,ECE 5,A01,084049,Morris; Karcher William,13,0,20,7
1650033128232,ECE 100,A01,084051,Baghdadchi; Saharnaz,0,0,20,20
1650033128232,ECE 100,A02,091916,Baghdadchi; Saharnaz,13,0,20,7
1650033134259,ECE 101,A01,084053,Baghdadchi; Saharnaz,0,0,37,37
1650033134259,ECE 101,A02,084054,Baghdadchi; Saharnaz,30,0,37,7
1650033140284,ECE 107,A01,083390,Staff,26,0,40,14
1650033146311,ECE 148,A01,084056,Silberman; Jack,8,0,12,4
1650033152338,ECE 180,A00,083391,Abi Samra; Nicholas Camill,25,0,30,5
1650033152338,ECE 180,B00,083392,Abi Samra; Nicholas Camill,21,0,30,9
1650033158367,MATH 10B,A01,084110,Staff,0,0,30,30
1650033158367,MATH 10B,A02,084111,Staff,18,0,30,12
1650033158367,MATH 10B,A03,084112,Staff,24,0,30,6
1650033164392,MATH 10C,A01,083443,Staff,0,16,30,30
1650033164392,MATH 10C,A02,083444,Staff,0,15,30,30
1650033164392,MATH 10C,B01,084114,Staff,19,0,30,11
1650033164392,MATH 10C,B02,084115,Staff,25,0,30,5
1650033170431,MATH 18,A01,084117,Harel; Guershon,14,0,30,16
1650033170431,MATH 18,A02,084119,Harel; Guershon,27,0,30,3
1650033170431,MATH 18,A03,084120,Harel; Guershon,30,0,30,0
1650033170431,MATH 18,A04,084121,Harel; Guershon,29,0,30,1
1650033176460,MATH 20B,A01,084124,Um; Ko Woon,14,0,35,21
1650033176460,MATH 20B,B01,084126,Um; Ko Woon,24,0,35,11
1650033182491,MATH 20C,A01,083446,Hammock; Frances H,0,0,30,30
1650033182491,MATH 20C,A02,083447,Hammock; Frances H,16,0,30,14
1650033182491,MATH 20C,A03,083448,Hammock; Frances H,19,0,30,11
1650033182491,MATH 20C,A04,083449,Hammock; Frances H,20,0,30,10
1650033182491,MATH 20C,B01,083451,Hammock; Frances H,0,0,30,30
1650033182491,MATH 20C,B02,083452,Hammock; Frances H,18,0,30,12
1650033182491,MATH 20C,B03,083453,Hammock; Frances H,21,0,30,9
1650033182491,MATH 20C,B04,083454,Hammock; Frances H,23,0,30,7
1650033188523,MATH 20D,A01,084128,Staff,14,0,30,16
1650033188523,MATH 20D,A02,084129,Staff,29,0,30,1
1650033188523,MATH 20D,A03,084130,Staff,27,0,30,3
1650033188523,MATH 20D,B01,084133,Staff,3,0,30,27
1650033188523,MATH 20D,B02,084134,Staff,24,0,30,6
1650033188523,MATH 20D,B03,084135,Staff,28,0,30,2
1650033194548,MATH 20E,A01,084138,Staff,14,0,30,16
1650033194548,MATH 20E,A02,084139,Staff,6,0,30,24
1650033194548,MATH 20E,A03,084140,Staff,15,0,30,15
1650033194548,MATH 20E,A04,084141,Staff,20,0,30,10
1650033200571,MATH 102,A01,084143,Harel; Guershon,12,0,30,18
1650033200571,MATH 102,A02,084144,Harel; Guershon,19,0,30,11
1650033206600,MATH 103B,A01,083456,Staff,0,13,30,30
1650033206600,MATH 103B,A02,083457,Staff,0,14,30,30
1650033212624,MATH 109,A01,084146,Salehi Golsefidy; Alireza,17,0,30,13
1650033212624,MATH 109,A02,084147,Salehi Golsefidy; Alireza,15,0,30,15
1650033218649,MATH 120A,A01,085445,Eggers; John Dietrich,10,0,35,25
1650033218649,MATH 120A,A02,085446,Eggers; John Dietrich,27,0,35,8
1650033224673,MATH 142B,A01,084149,Verstraete; Jacques Allan,0,12,30,30
1650033224673,MATH 142B,A02,084150,Verstraete; Jacques Allan,0,12,30,30
1650033230698,MATH 170A,A01,083459,Nie; Jiawang,0,9,30,30
1650033230698,MATH 170A,A02,083460,Nie; Jiawang,0,8,30,30
1650033230698,MATH 170A,A03,083461,Nie; Jiawang,0,9,30,30
1650033236729,MATH 193B,A01,083463,Staff,1,0,30,29
1650033236729,MATH 193B,A02,083464,Staff,9,0,30,21
1650033236729,MATH 193B,A03,083465,Staff,18,0,30,12
1650033242786,COGS 2,A01,083966,Boyle; Mary E. T.,9,0,30,21
1650033248814,COGS 9,A01,083968,Staff,9,0,60,51
1650033254839,COGS 14B,A01,083970,Staff,9,0,50,41
1650033260874,COGS 17,A01,092679,Staff,50,0,75,25
1650033266899,COGS 100,A01,083972,Staff,0,15,60,60
1650033278951,COGS 101C,A01,083976,Staff,12,0,30,18
1650033284976,COGS 102A,A01,083978,Johnson; Christine M.,14,0,30,16
1650033291000,COGS 107B,A01,083980,Staff,0,7,50,50
1650033297026,COGS 115,A01,083982,Staff,10,0,30,20
1650033303049,COGS 118B,A01,083367,Staff,0,15,40,40
1650033309085,COGS 172,A01,083984,Provenzano; Emily Kara,15,0,30,15
1650033315108,COGS 177,A00,083368,Staff,0,20,30,30
1650033321144,COGS 186,A01,083986,Staff,21,0,40,19
1650033327169,COGS 187A,A01,083988,Boyle; Mary E. T.,20,0,60,40
1650033333191,CSE 8A,A50,084003,Miranda; Gregory Joseph,0,13,15,15
1650033339213,CSE 11,A01,084005,Miranda; Gregory Joseph,0,22,55,55
1650033345239,CSE 20,A01,084007,Staff,0,5,20,20
1650033351262,CSE 21,A01,084009,Staff,0,30,50,50
1650033357292,CSE 30,A01,083370,Cao; Yingjun,0,65,40,40
1650033363328,CSE 100,A01,083372,Cao; Yingjun,0,46,40,40
1650033369355,CSE 101,A01,084011,Staff,0,54,40,40
1650033375383,CSE 141,A01,083374,Eldon; John,0,64,75,75
1650033381411,CSE 141L,A01,083376,Eldon; John,0,70,75,75
1650033387437,CSE 175,A01,084013,Kumar; Rakesh,22,0,25,3
1650033393473,CSE 190,A00,092508,Dubnov; Shlomo,20,0,20,0
1650033399501,ECE 5,A01,084049,Morris; Karcher William,13,0,20,7
1650033405529,ECE 100,A01,084051,Baghdadchi; Saharnaz,0,0,20,20
1650033405529,ECE 100,A02,091916,Baghdadchi; Saharnaz,13,0,20,7
1650033411557,ECE 101,A01,084053,Baghdadchi; Saharnaz,0,0,37,37
1650033411557,ECE 101,A02,084054,Baghdadchi; Saharnaz,30,0,37,7
1650033417586,ECE 107,A01,083390,Staff,26,0,40,14
1650033423610,ECE 148,A01,084056,Silberman; Jack,8,0,12,4
1650033429638,ECE 180,A00,083391,Abi Samra; Nicholas Camill,25,0,30,5
1650033429638,ECE 180,B00,083392,Abi Samra; Nicholas Camill,21,0,30,9
1650033435661,MATH 10B,A01,084110,Staff,0,0,30,30
1650033435661,MATH 10B,A02,084111,Staff,18,0,30,12
1650033435661,MATH 10B,A03,084112,Staff,24,0,30,6
1650033441687,MATH 10C,A01,083443,Staff,0,16,30,30
1650033441687,MATH 10C,A02,083444,Staff,0,15,30,30
1650033441687,MATH 10C,B01,084114,Staff,19,0,30,11
1650033441687,MATH 10C,B02,084115,Staff,25,0,30,5
1650033447715,MATH 18,A01,084117,Harel; Guershon,14,0,30,16
1650033447715,MATH 18,A02,084119,Harel; Guershon,27,0,30,3
1650033447715,MATH 18,A03,084120,Harel; Guershon,30,0,30,0
1650033447715,MATH 18,A04,084121,Harel; Guershon,29,0,30,1
1650033453841,MATH 20B,A01,084124,Um; Ko Woon,14,0,35,21
1650033453841,MATH 20B,B01,084126,Um; Ko Woon,24,0,35,11
1650033459877,MATH 20C,A01,083446,Hammock; Frances H,0,0,30,30
1650033459877,MATH 20C,A02,083447,Hammock; Frances H,16,0,30,14
1650033459877,MATH 20C,A03,083448,Hammock; Frances H,19,0,30,11
1650033459877,MATH 20C,A04,083449,Hammock; Frances H,20,0,30,10
1650033459877,MATH 20C,B01,083451,Hammock; Frances H,0,0,30,30
1650033459877,MATH 20C,B02,083452,Hammock; Frances H,18,0,30,12
1650033459877,MATH 20C,B03,083453,Hammock; Frances H,21,0,30,9
1650033459877,MATH 20C,B04,083454,Hammock; Frances H,23,0,30,7
1650033465902,MATH 20D,A01,084128,Staff,14,0,30,16
1650033465902,MATH 20D,A02,084129,Staff,29,0,30,1
1650033465902,MATH 20D,A03,084130,Staff,27,0,30,3
1650033465902,MATH 20D,B01,084133,Staff,3,0,30,27
1650033465902,MATH 20D,B02,084134,Staff,24,0,30,6
1650033465902,MATH 20D,B03,084135,Staff,28,0,30,2
1650033471925,MATH 20E,A01,084138,Staff,14,0,30,16
1650033471925,MATH 20E,A02,084139,Staff,6,0,30,24
1650033471925,MATH 20E,A03,084140,Staff,15,0,30,15
1650033471925,MATH 20E,A04,084141,Staff,20,0,30,10
1650033477962,MATH 102,A01,084143,Harel; Guershon,12,0,30,18
1650033477962,MATH 102,A02,084144,Harel; Guershon,19,0,30,11
1650033483986,MATH 103B,A01,083456,Staff,0,13,30,30
1650033483986,MATH 103B,A02,083457,Staff,0,14,30,30
1650033490024,MATH 109,A01,084146,Salehi Golsefidy; Alireza,17,0,30,13
1650033490024,MATH 109,A02,084147,Salehi Golsefidy; Alireza,15,0,30,15
1650033496052,MATH 120A,A01,085445,Eggers; John Dietrich,10,0,35,25
1650033496052,MATH 120A,A02,085446,Eggers; John Dietrich,27,0,35,8
1650033502077,MATH 142B,A01,084149,Verstraete; Jacques Allan,0,12,30,30
1650033502077,MATH 142B,A02,084150,Verstraete; Jacques Allan,0,12,30,30
1650033508107,MATH 170A,A01,083459,Nie; Jiawang,0,9,30,30
1650033508107,MATH 170A,A02,083460,Nie; Jiawang,0,8,30,30
1650033508107,MATH 170A,A03,083461,Nie; Jiawang,0,9,30,30
1650033514135,MATH 193B,A01,083463,Staff,1,0,30,29
1650033514135,MATH 193B,A02,083464,Staff,9,0,30,21
1650033514135,MATH 193B,A03,083465,Staff,18,0,30,12
1650033520187,COGS 2,A01,083966,Boyle; Mary E. T.,9,0,30,21
1650033526219,COGS 9,A01,083968,Staff,9,0,60,51
1650033532245,COGS 14B,A01,083970,Staff,9,0,50,41
1650033538270,COGS 17,A01,092679,Staff,50,0,75,25
1650033544297,COGS 100,A01,083972,Staff,0,15,60,60
1650033556346,COGS 101C,A01,083976,Staff,12,0,30,18
1650033562374,COGS 102A,A01,083978,Johnson; Christine M.,14,0,30,16
1650033568397,COGS 107B,A01,083980,Staff,0,7,50,50
1650033574422,COGS 115,A01,083982,Staff,10,0,30,20
1650033580446,COGS 118B,A01,083367,Staff,0,15,40,40
1650033586476,COGS 172,A01,083984,Provenzano; Emily Kara,15,0,30,15
1650033592504,COGS 177,A00,083368,Staff,0,20,30,30
1650033598529,COGS 186,A01,083986,Staff,21,0,40,19
1650033604554,COGS 187A,A01,083988,Boyle; Mary E. T.,20,0,60,40
1650033610583,CSE 8A,A50,084003,Miranda; Gregory Joseph,0,13,15,15
1650033616611,CSE 11,A01,084005,Miranda; Gregory Joseph,0,22,55,55
1650033622637,CSE 20,A01,084007,Staff,0,5,20,20
1650033628667,CSE 21,A01,084009,Staff,0,30,50,50
1650033634702,CSE 30,A01,083370,Cao; Yingjun,0,65,40,40
1650033640737,CSE 100,A01,083372,Cao; Yingjun,0,46,40,40
1650033646773,CSE 101,A01,084011,Staff,0,54,40,40
1650033652805,CSE 141,A01,083374,Eldon; John,0,64,75,75
1650033658840,CSE 141L,A01,083376,Eldon; John,0,70,75,75
1650033664875,CSE 175,A01,084013,Kumar; Rakesh,22,0,25,3
1650033670905,CSE 190,A00,092508,Dubnov; Shlomo,20,0,20,0
1650033676935,ECE 5,A01,084049,Morris; Karcher William,13,0,20,7
1650033682959,ECE 100,A01,084051,Baghdadchi; Saharnaz,0,0,20,20
1650033682959,ECE 100,A02,091916,Baghdadchi; Saharnaz,13,0,20,7
1650033688984,ECE 101,A01,084053,Baghdadchi; Saharnaz,0,0,37,37
1650033688984,ECE 101,A02,084054,Baghdadchi; Saharnaz,30,0,37,7
1650033695013,ECE 107,A01,083390,Staff,26,0,40,14
1650033701040,ECE 148,A01,084056,Silberman; Jack,8,0,12,4
1650033707063,ECE 180,A00,083391,Abi Samra; Nicholas Camill,25,0,30,5
1650033707063,ECE 180,B00,083392,Abi Samra; Nicholas Camill,21,0,30,9
1650033713088,MATH 10B,A01,084110,Staff,0,0,30,30
1650033713088,MATH 10B,A02,084111,Staff,18,0,30,12
1650033713088,MATH 10B,A03,084112,Staff,24,0,30,6
1650033719111,MATH 10C,A01,083443,Staff,0,16,30,30
1650033719111,MATH 10C,A02,083444,Staff,0,15,30,30
1650033719111,MATH 10C,B01,084114,Staff,19,0,30,11
1650033719111,MATH 10C,B02,084115,Staff,25,0,30,5
1650033725140,MATH 18,A01,084117,Harel; Guershon,14,0,30,16
1650033725140,MATH 18,A02,084119,Harel; Guershon,27,0,30,3
1650033725140,MATH 18,A03,084120,Harel; Guershon,30,0,30,0
1650033725140,MATH 18,A04,084121,Harel; Guershon,29,0,30,1
1650033731173,MATH 20B,A01,084124,Um; Ko Woon,14,0,35,21
1650033731173,MATH 20B,B01,084126,Um; Ko Woon,24,0,35,11
1650033737200,MATH 20C,A01,083446,Hammock; Frances H,0,0,30,30
1650033737200,MATH 20C,A02,083447,Hammock; Frances H,16,0,30,14
1650033737200,MATH 20C,A03,083448,Hammock; Frances H,19,0,30,11
1650033737200,MATH 20C,A04,083449,Hammock; Frances H,20,0,30,10
1650033737200,MATH 20C,B01,083451,Hammock; Frances H,0,0,30,30
1650033737200,MATH 20C,B02,083452,Hammock; Frances H,18,0,30,12
1650033737200,MATH 20C,B03,083453,Hammock; Frances H,21,0,30,9
1650033737200,MATH 20C,B04,083454,Hammock; Frances H,23,0,30,7
1650033743229,MATH 20D,A01,084128,Staff,14,0,30,16
1650033743229,MATH 20D,A02,084129,Staff,29,0,30,1
1650033743229,MATH 20D,A03,084130,Staff,27,0,30,3
1650033743229,MATH 20D,B01,084133,Staff,3,0,30,27
1650033743229,MATH 20D,B02,084134,Staff,24,0,30,6
1650033743229,MATH 20D,B03,084135,Staff,28,0,30,2
1650033749256,MATH 20E,A01,084138,Staff,14,0,30,16
1650033749256,MATH 20E,A02,084139,Staff,6,0,30,24
1650033749256,MATH 20E,A03,084140,Staff,15,0,30,15
1650033749256,MATH 20E,A04,084141,Staff,20,0,30,10
1650033755280,MATH 102,A01,084143,Harel; Guershon,12,0,30,18
1650033755280,MATH 102,A02,084144,Harel; Guershon,19,0,30,11
1650033761305,MATH 103B,A01,083456,Staff,0,13,30,30
1650033761305,MATH 103B,A02,083457,Staff,0,14,30,30
1650033767332,MATH 109,A01,084146,Salehi Golsefidy; Alireza,17,0,30,13
1650033767332,MATH 109,A02,084147,Salehi Golsefidy; Alireza,15,0,30,15
1650033773366,MATH 120A,A01,085445,Eggers; John Dietrich,10,0,35,25
1650033773366,MATH 120A,A02,085446,Eggers; John Dietrich,27,0,35,8
1650033779393,MATH 142B,A01,084149,Verstraete; Jacques Allan,0,12,30,30
1650033779393,MATH 142B,A02,084150,Verstraete; Jacques Allan,0,12,30,30
1650033785418,MATH 170A,A01,083459,Nie; Jiawang,0,9,30,30
1650033785418,MATH 170A,A02,083460,Nie; Jiawang,0,8,30,30
1650033785418,MATH 170A,A03,083461,Nie; Jiawang,0,9,30,30
1650033791445,MATH 193B,A01,083463,Staff,1,0,30,29
1650033791445,MATH 193B,A02,083464,Staff,9,0,30,21
1650033791445,MATH 193B,A03,083465,Staff,18,0,30,12
1650033797519,COGS 2,A01,083966,Boyle; Mary E. T.,9,0,30,21
1650033803543,COGS 9,A01,083968,Staff,9,0,60,51
1650033809577,COGS 14B,A01,083970,Staff,9,0,50,41
1650033815601,COGS 17,A01,092679,Staff,50,0,75,25
1650033821628,COGS 100,A01,083972,Staff,0,15,60,60
1650033833707,COGS 101C,A01,083976,Staff,12,0,30,18
1650033839738,COGS 102A,A01,083978,Johnson; Christine M.,14,0,30,16
1650033845784,COGS 107B,A01,083980,Staff,0,7,50,50
1650033851809,COGS 115,A01,083982,Staff,10,0,30,20
1650033857834,COGS 118B,A01,083367,Staff,0,15,40,40
1650033863857,COGS 172,A01,083984,Provenzano; Emily Kara,15,0,30,15
1650033869881,COGS 177,A00,083368,Staff,0,20,30,30
1650033875906,COGS 186,A01,083986,Staff,21,0,40,19
1650033881931,COGS 187A,A01,083988,Boyle; Mary E. T.,20,0,60,40
1650033887955,CSE 8A,A50,084003,Miranda; Gregory Joseph,0,13,15,15
1650033893987,CSE 11,A01,084005,Miranda; Gregory Joseph,0,22,55,55
1650033900011,CSE 20,A01,084007,Staff,0,5,20,20
1650033906034,CSE 21,A01,084009,Staff,0,30,50,50
1650033912065,CSE 30,A01,083370,Cao; Yingjun,0,65,40,40
1650033918094,CSE 100,A01,083372,Cao; Yingjun,0,46,40,40
1650033924134,CSE 101,A01,084011,Staff,0,54,40,40
1650033930159,CSE 141,A01,083374,Eldon; John,0,64,75,75
1650033936185,CSE 141L,A01,083376,Eldon; John,0,70,75,75
1650033942208,CSE 175,A01,084013,Kumar; Rakesh,22,0,25,3
1650033948238,CSE 190,A00,092508,Dubnov; Shlomo,20,0,20,0
1650033954264,ECE 5,A01,084049,Morris; Karcher William,13,0,20,7
1650033960306,ECE 100,A01,084051,Baghdadchi; Saharnaz,0,0,20,20
1650033960306,ECE 100,A02,091916,Baghdadchi; Saharnaz,13,0,20,7
1650033966343,ECE 101,A01,084053,Baghdadchi; Saharnaz,0,0,37,37
1650033966343,ECE 101,A02,084054,Baghdadchi; Saharnaz,30,0,37,7
1650033972379,ECE 107,A01,083390,Staff,26,0,40,14
1650033978405,ECE 148,A01,084056,Silberman; Jack,8,0,12,4
1650033984432,ECE 180,A00,083391,Abi Samra; Nicholas Camill,25,0,30,5
1650033984432,ECE 180,B00,083392,Abi Samra; Nicholas Camill,21,0,30,9
1650033990457,MATH 10B,A01,084110,Staff,0,0,30,30
1650033990457,MATH 10B,A02,084111,Staff,18,0,30,12
1650033990457,MATH 10B,A03,084112,Staff,24,0,30,6
1650033996480,MATH 10C,A01,083443,Staff,0,16,30,30
1650033996480,MATH 10C,A02,083444,Staff,0,15,30,30
1650033996480,MATH 10C,B01,084114,Staff,19,0,30,11
1650033996480,MATH 10C,B02,084115,Staff,25,0,30,5
1650034002509,MATH 18,A01,084117,Harel; Guershon,14,0,30,16
1650034002509,MATH 18,A02,084119,Harel; Guershon,27,0,30,3
1650034002509,MATH 18,A03,084120,Harel; Guershon,30,0,30,0
1650034002509,MATH 18,A04,084121,Harel; Guershon,29,0,30,1
1650034008537,MATH 20B,A01,084124,Um; Ko Woon,14,0,35,21
1650034008537,MATH 20B,B01,084126,Um; Ko Woon,24,0,35,11
1650034014565,MATH 20C,A01,083446,Hammock; Frances H,0,0,30,30
1650034014565,MATH 20C,A02,083447,Hammock; Frances H,16,0,30,14
1650034014565,MATH 20C,A03,083448,Hammock; Frances H,19,0,30,11
1650034014565,MATH 20C,A04,083449,Hammock; Frances H,20,0,30,10
1650034014565,MATH 20C,B01,083451,Hammock; Frances H,0,0,30,30
1650034014565,MATH 20C,B02,083452,Hammock; Frances H,18,0,30,12
1650034014565,MATH 20C,B03,083453,Hammock; Frances H,21,0,30,9
1650034014565,MATH 20C,B04,083454,Hammock; Frances H,23,0,30,7
1650034020589,MATH 20D,A01,084128,Staff,14,0,30,16
1650034020589,MATH 20D,A02,084129,Staff,29,0,30,1
1650034020589,MATH 20D,A03,084130,Staff,27,0,30,3
1650034020589,MATH 20D,B01,084133,Staff,3,0,30,27
1650034020589,MATH 20D,B02,084134,Staff,24,0,30,6
1650034020589,MATH 20D,B03,084135,Staff,28,0,30,2
1650034026615,MATH 20E,A01,084138,Staff,14,0,30,16
1650034026615,MATH 20E,A02,084139,Staff,6,0,30,24
1650034026615,MATH 20E,A03,084140,Staff,15,0,30,15
1650034026615,MATH 20E,A04,084141,Staff,20,0,30,10
1650034032642,MATH 102,A01,084143,Harel; Guershon,12,0,30,18
1650034032642,MATH 102,A02,084144,Harel; Guershon,19,0,30,11
1650034038686,MATH 103B,A01,083456,Staff,0,13,30,30
1650034038686,MATH 103B,A02,083457,Staff,0,14,30,30
1650034044714,MATH 109,A01,084146,Salehi Golsefidy; Alireza,17,0,30,13
1650034044714,MATH 109,A02,084147,Salehi Golsefidy; Alireza,15,0,30,15
1650034050849,MATH 120A,A01,085445,Eggers; John Dietrich,10,0,35,25
1650034050849,MATH 120A,A02,085446,Eggers; John Dietrich,27,0,35,8
1650034056872,MATH 142B,A01,084149,Verstraete; Jacques Allan,0,12,30,30
1650034056872,MATH 142B,A02,084150,Verstraete; Jacques Allan,0,12,30,30
1650034062900,MATH 170A,A01,083459,Nie; Jiawang,0,9,30,30
1650034062900,MATH 170A,A02,083460,Nie; Jiawang,0,8,30,30
1650034062900,MATH 170A,A03,083461,Nie; Jiawang,0,9,30,30
1650034068921,MATH 193B,A01,083463,Staff,1,0,30,29
1650034068921,MATH 193B,A02,083464,Staff,9,0,30,21
1650034068921,MATH 193B,A03,083465,Staff,18,0,30,12
1650034074980,COGS 2,A01,083966,Boyle; Mary E. T.,9,0,30,21
1650034081004,COGS 9,A01,083968,Staff,9,0,60,51
1650034087030,COGS 14B,A01,083970,Staff,9,0,50,41
1650034093056,COGS 17,A01,092679,Staff,50,0,75,25
1650034099082,COGS 100,A01,083972,Staff,0,15,60,60
1650034111137,COGS 101C,A01,083976,Staff,12,0,30,18
1650034117162,COGS 102A,A01,083978,Johnson; Christine M.,14,0,30,16
1650034123187,COGS 107B,A01,083980,Staff,0,7,50,50
1650034129210,COGS 115,A01,083982,Staff,10,0,30,20
1650034135234,COGS 118B,A01,083367,Staff,0,15,40,40
1650034141255,COGS 172,A01,083984,Provenzano; Emily Kara,15,0,30,15
1650034147286,COGS 177,A00,083368,Staff,0,20,30,30
1650034153316,COGS 186,A01,083986,Staff,21,0,40,19
1650034159338,COGS 187A,A01,083988,Boyle; Mary E. T.,20,0,60,40
1650034165362,CSE 8A,A50,084003,Miranda; Gregory Joseph,0,13,15,15
1650034171394,CSE 11,A01,084005,Miranda; Gregory Joseph,0,22,55,55
1650034177422,CSE 20,A01,084007,Staff,0,5,20,20
1650034183447,CSE 21,A01,084009,Staff,0,30,50,50
1650034189470,CSE 30,A01,083370,Cao; Yingjun,0,65,40,40
1650034195498,CSE 100,A01,083372,Cao; Yingjun,0,46,40,40
1650034201522,CSE 101,A01,084011,Staff,0,54,40,40
1650034207554,CSE 141,A01,083374,Eldon; John,0,64,75,75
1650034213581,CSE 141L,A01,083376,Eldon; John,0,70,75,75
1650034219604,CSE 175,A01,084013,Kumar; Rakesh,22,0,25,3
1650034225633,CSE 190,A00,092508,Dubnov; Shlomo,20,0,20,0
1650034231658,ECE 5,A01,084049,Morris; Karcher William,13,0,20,7
1650034237682,ECE 100,A01,084051,Baghdadchi; Saharnaz,0,0,20,20
1650034237682,ECE 100,A02,091916,Baghdadchi; Saharnaz,13,0,20,7
1650034243720,ECE 101,A01,084053,Baghdadchi; Saharnaz,0,0,37,37
1650034243720,ECE 101,A02,084054,Baghdadchi; Saharnaz,30,0,37,7
1650034249744,ECE 107,A01,083390,Staff,26,0,40,14
1650034255772,ECE 148,A01,084056,Silberman; Jack,8,0,12,4
1650034261799,ECE 180,A00,083391,Abi Samra; Nicholas Camill,25,0,30,5
1650034261799,ECE 180,B00,083392,Abi Samra; Nicholas Camill,21,0,30,9
1650034267827,MATH 10B,A01,084110,Staff,0,0,30,30
1650034267827,MATH 10B,A02,084111,Staff,18,0,30,12
1650034267827,MATH 10B,A03,084112,Staff,24,0,30,6
1650034273856,MATH 10C,A01,083443,Staff,0,16,30,30
1650034273856,MATH 10C,A02,083444,Staff,0,15,30,30
1650034273856,MATH 10C,B01,084114,Staff,19,0,30,11
1650034273856,MATH 10C,B02,084115,Staff,25,0,30,5
1650034279884,MATH 18,A01,084117,Harel; Guershon,14,0,30,16
1650034279884,MATH 18,A02,084119,Harel; Guershon,27,0,30,3
1650034279884,MATH 18,A03,084120,Harel; Guershon,30,0,30,0
1650034279884,MATH 18,A04,084121,Harel; Guershon,29,0,30,1
1650034285907,MATH 20B,A01,084124,Um; Ko Woon,14,0,35,21
1650034285907,MATH 20B,B01,084126,Um; Ko Woon,24,0,35,11
1650034291932,MATH 20C,A01,083446,Hammock; Frances H,0,0,30,30
1650034291932,MATH 20C,A02,083447,Hammock; Frances H,16,0,30,14
1650034291932,MATH 20C,A03,083448,Hammock; Frances H,19,0,30,11
1650034291932,MATH 20C,A04,083449,Hammock; Frances H,20,0,30,10
1650034291932,MATH 20C,B01,083451,Hammock; Frances H,0,0,30,30
1650034291932,MATH 20C,B02,083452,Hammock; Frances H,18,0,30,12
1650034291932,MATH 20C,B03,083453,Hammock; Frances H,21,0,30,9
1650034291932,MATH 20C,B04,083454,Hammock; Frances H,23,0,30,7
1650034297959,MATH 20D,A01,084128,Staff,14,0,30,16
1650034297959,MATH 20D,A02,084129,Staff,29,0,30,1
1650034297959,MATH 20D,A03,084130,Staff,27,0,30,3
1650034297959,MATH 20D,B01,084133,Staff,3,0,30,27
1650034297959,MATH 20D,B02,084134,Staff,24,0,30,6
1650034297959,MATH 20D,B03,084135,Staff,28,0,30,2
1650034303991,MATH 20E,A01,084138,Staff,14,0,30,16
1650034303991,MATH 20E,A02,084139,Staff,6,0,30,24
1650034303991,MATH 20E,A03,084140,Staff,15,0,30,15
1650034303991,MATH 20E,A04,084141,Staff,20,0,30,10
1650034310028,MATH 102,A01,084143,Harel; Guershon,12,0,30,18
1650034310028,MATH 102,A02,084144,Harel; Guershon,19,0,30,11
1650034316075,MATH 103B,A01,083456,Staff,0,13,30,30
1650034316075,MATH 103B,A02,083457,Staff,0,14,30,30
1650034322099,MATH 109,A01,084146,Salehi Golsefidy; Alireza,17,0,30,13
1650034322099,MATH 109,A02,084147,Salehi Golsefidy; Alireza,15,0,30,15
1650034328129,MATH 120A,A01,085445,Eggers; John Dietrich,10,0,35,25
1650034328129,MATH 120A,A02,085446,Eggers; John Dietrich,27,0,35,8
1650034334157,MATH 142B,A01,084149,Verstraete; Jacques Allan,0,12,30,30
1650034334157,MATH 142B,A02,084150,Verstraete; Jacques Allan,0,12,30,30
1650034340184,MATH 170A,A01,083459,Nie; Jiawang,0,9,30,30
1650034340184,MATH 170A,A02,083460,Nie; Jiawang,0,8,30,30
1650034340184,MATH 170A,A03,083461,Nie; Jiawang,0,9,30,30
1650034346208,MATH 193B,A01,083463,Staff,1,0,30,29
1650034346208,MATH 193B,A02,083464,Staff,9,0,30,21
1650034346208,MATH 193B,A03,083465,Staff,18,0,30,12
1650034352270,COGS 2,A01,083966,Boyle; Mary E. T.,9,0,30,21
1650034358298,COGS 9,A01,083968,Staff,9,0,60,51
1650034364323,COGS 14B,A01,083970,Staff,9,0,50,41
1650034370356,COGS 17,A01,092679,Staff,50,0,75,25
1650034376390,COGS 100,A01,083972,Staff,0,15,60,60
1650034388438,COGS 101C,A01,083976,Staff,12,0,30,18
1650034394462,COGS 102A,A01,083978,Johnson; Christine M.,13,0,30,17
1650034400492,COGS 107B,A01,083980,Staff,0,7,50,50
1650034406518,COGS 115,A01,083982,Staff,10,0,30,20
1650034412553,COGS 118B,A01,083367,Staff,0,15,40,40
1650034418580,COGS 172,A01,083984,Provenzano; Emily Kara,15,0,30,15
1650034424610,COGS 177,A00,083368,Staff,0,20,30,30
1650034430634,COGS 186,A01,083986,Staff,21,0,40,19
1650034436661,COGS 187A,A01,083988,Boyle; Mary E. T.,20,0,60,40
1650034442690,CSE 8A,A50,084003,Miranda; Gregory Joseph,0,13,15,15
1650034448714,CSE 11,A01,084005,Miranda; Gregory Joseph,0,22,55,55
1650034454747,CSE 20,A01,084007,Staff,0,5,20,20
1650034460782,CSE 21,A01,084009,Staff,0,30,50,50
1650034466809,CSE 30,A01,083370,Cao; Yingjun,0,65,40,40
1650034472833,CSE 100,A01,083372,Cao; Yingjun,0,46,40,40
1650034478855,CSE 101,A01,084011,Staff,0,54,40,40
1650034484881,CSE 141,A01,083374,Eldon; John,0,64,75,75
1650034490915,CSE 141L,A01,083376,Eldon; John,0,70,75,75
1650034496949,CSE 175,A01,084013,Kumar; Rakesh,22,0,25,3
1650034502975,CSE 190,A00,092508,Dubnov; Shlomo,20,0,20,0
1650034509000,ECE 5,A01,084049,Morris; Karcher William,13,0,20,7
1650034515026,ECE 100,A01,084051,Baghdadchi; Saharnaz,0,0,20,20
1650034515026,ECE 100,A02,091916,Baghdadchi; Saharnaz,13,0,20,7
1650034521055,ECE 101,A01,084053,Baghdadchi; Saharnaz,0,0,37,37
1650034521055,ECE 101,A02,084054,Baghdadchi; Saharnaz,30,0,37,7
1650034527088,ECE 107,A01,083390,Staff,26,0,40,14
1650034533113,ECE 148,A01,084056,Silberman; Jack,8,0,12,4
1650034539136,ECE 180,A00,083391,Abi Samra; Nicholas Camill,25,0,30,5
1650034539136,ECE 180,B00,083392,Abi Samra; Nicholas Camill,21,0,30,9
1650034545174,MATH 10B,A01,084110,Staff,0,0,30,30
1650034545174,MATH 10B,A02,084111,Staff,18,0,30,12
1650034545174,MATH 10B,A03,084112,Staff,24,0,30,6
1650034551211,MATH 10C,A01,083443,Staff,0,16,30,30
1650034551211,MATH 10C,A02,083444,Staff,0,15,30,30
1650034551211,MATH 10C,B01,084114,Staff,19,0,30,11
1650034551211,MATH 10C,B02,084115,Staff,25,0,30,5
1650034557265,MATH 18,A01,084117,Harel; Guershon,13,0,30,17
1650034557265,MATH 18,A02,084119,Harel; Guershon,27,0,30,3
1650034557265,MATH 18,A03,084120,Harel; Guershon,30,0,30,0
1650034557265,MATH 18,A04,084121,Harel; Guershon,29,0,30,1
1650034563296,MATH 20B,A01,084124,Um; Ko Woon,14,0,35,21
1650034563296,MATH 20B,B01,084126,Um; Ko Woon,24,0,35,11
1650034569335,MATH 20C,A01,083446,Hammock; Frances H,0,0,30,30
1650034569335,MATH 20C,A02,083447,Hammock; Frances H,16,0,30,14
1650034569335,MATH 20C,A03,083448,Hammock; Frances H,19,0,30,11
1650034569335,MATH 20C,A04,083449,Hammock; Frances H,20,0,30,10
1650034569335,MATH 20C,B01,083451,Hammock; Frances H,0,0,30,30
1650034569335,MATH 20C,B02,083452,Hammock; Frances H,18,0,30,12
1650034569335,MATH 20C,B03,083453,Hammock; Frances H,21,0,30,9
1650034569335,MATH 20C,B04,083454,Hammock; Frances H,23,0,30,7
1650034575361,MATH 20D,A01,084128,Staff,14,0,30,16
1650034575361,MATH 20D,A02,084129,Staff,29,0,30,1
1650034575361,MATH 20D,A03,084130,Staff,27,0,30,3
1650034575361,MATH 20D,B01,084133,Staff,3,0,30,27
1650034575361,MATH 20D,B02,084134,Staff,24,0,30,6
1650034575361,MATH 20D,B03,084135,Staff,28,0,30,2
1650034581389,MATH 20E,A01,084138,Staff,14,0,30,16
1650034581389,MATH 20E,A02,084139,Staff,6,0,30,24
1650034581389,MATH 20E,A03,084140,Staff,15,0,30,15
1650034581389,MATH 20E,A04,084141,Staff,20,0,30,10
1650034587431,MATH 102,A01,084143,Harel; Guershon,12,0,30,18
1650034587431,MATH 102,A02,084144,Harel; Guershon,19,0,30,11
1650034593458,MATH 103B,A01,083456,Staff,0,13,30,30
1650034593458,MATH 103B,A02,083457,Staff,0,14,30,30
1650034599483,MATH 109,A01,084146,Salehi Golsefidy; Alireza,17,0,30,13
1650034599483,MATH 109,A02,084147,Salehi Golsefidy; Alireza,15,0,30,15
1650034605507,MATH 120A,A01,085445,Eggers; John Dietrich,10,0,35,25
1650034605507,MATH 120A,A02,085446,Eggers; John Dietrich,27,0,35,8
1650034611531,MATH 142B,A01,084149,Verstraete; Jacques Allan,0,12,30,30
1650034611531,MATH 142B,A02,084150,Verstraete; Jacques Allan,0,12,30,30
1650034617560,MATH 170A,A01,083459,Nie; Jiawang,0,9,30,30
1650034617560,MATH 170A,A02,083460,Nie; Jiawang,0,8,30,30
1650034617560,MATH 170A,A03,083461,Nie; Jiawang,0,9,30,30
1650034623609,MATH 193B,A01,083463,Staff,1,0,30,29
1650034623609,MATH 193B,A02,083464,Staff,9,0,30,21
1650034623609,MATH 193B,A03,083465,Staff,18,0,30,12
1650034629665,COGS 2,A01,083966,Boyle; Mary E. T.,9,0,30,21
1650034635707,COGS 9,A01,083968,Staff,9,0,60,51
1650034641826,COGS 14B,A01,083970,Staff,9,0,50,41
1650034647856,COGS 17,A01,092679,Staff,50,0,75,25
1650034653883,COGS 100,A01,083972,Staff,0,15,60,60
1650034665941,COGS 101C,A01,083976,Staff,12,0,30,18
1650034671976,COGS 102A,A01,083978,Johnson; Christine M.,13,0,30,17
1650034678003,COGS 107B,A01,083980,Staff,0,7,50,50
1650034684029,COGS 115,A01,083982,Staff,10,0,30,20
1650034690056,COGS 118B,A01,083367,Staff,0,15,40,40
1650034696086,COGS 172,A01,083984,Provenzano; Emily Kara,15,0,30,15
1650034702111,COGS 177,A00,083368,Staff,0,20,30,30
1650034708152,COGS 186,A01,083986,Staff,21,0,40,19
1650034714181,COGS 187A,A01,083988,Boyle; Mary E. T.,20,0,60,40
1650034720208,CSE 8A,A50,084003,Miranda; Gregory Joseph,0,13,15,15
1650034726238,CSE 11,A01,084005,Miranda; Gregory Joseph,0,22,55,55
1650034732263,CSE 20,A01,084007,Staff,0,5,20,20
1650034738300,CSE 21,A01,084009,Staff,0,30,50,50
1650034744328,CSE 30,A01,083370,Cao; Yingjun,0,65,40,40
1650034750357,CSE 100,A01,083372,Cao; Yingjun,0,46,40,40
1650034756380,CSE 101,A01,084011,Staff,0,54,40,40
1650034762407,CSE 141,A01,083374,Eldon; John,0,64,75,75
1650034768443,CSE 141L,A01,083376,Eldon; John,0,70,75,75
1650034774488,CSE 175,A01,084013,Kumar; Rakesh,22,0,25,3
1650034780530,CSE 190,A00,092508,Dubnov; Shlomo,20,0,20,0
1650034786562,ECE 5,A01,084049,Morris; Karcher William,13,0,20,7
1650034792588,ECE 100,A01,084051,Baghdadchi; Saharnaz,0,0,20,20
1650034792588,ECE 100,A02,091916,Baghdadchi; Saharnaz,13,0,20,7
1650034798612,ECE 101,A01,084053,Baghdadchi; Saharnaz,0,0,37,37
1650034798612,ECE 101,A02,084054,Baghdadchi; Saharnaz,30,0,37,7
1650034804639,ECE 107,A01,083390,Staff,26,0,40,14
1650034810664,ECE 148,A01,084056,Silberman; Jack,8,0,12,4
1650034816702,ECE 180,A00,083391,Abi Samra; Nicholas Camill,25,0,30,5
1650034816702,ECE 180,B00,083392,Abi Samra; Nicholas Camill,21,0,30,9
1650034822724,MATH 10B,A01,084110,Staff,0,0,30,30
1650034822724,MATH 10B,A02,084111,Staff,18,0,30,12
1650034822724,MATH 10B,A03,084112,Staff,24,0,30,6
1650034828749,MATH 10C,A01,083443,Staff,0,16,30,30
1650034828749,MATH 10C,A02,083444,Staff,0,15,30,30
1650034828749,MATH 10C,B01,084114,Staff,19,0,30,11
1650034828749,MATH 10C,B02,084115,Staff,25,0,30,5
1650034834772,MATH 18,A01,084117,Harel; Guershon,13,0,30,17
1650034834772,MATH 18,A02,084119,Harel; Guershon,27,0,30,3
1650034834772,MATH 18,A03,084120,Harel; Guershon,30,0,30,0
1650034834772,MATH 18,A04,084121,Harel; Guershon,29,0,30,1
1650034840796,MATH 20B,A01,084124,Um; Ko Woon,14,0,35,21
1650034840796,MATH 20B,B01,084126,Um; Ko Woon,24,0,35,11
1650034846832,MATH 20C,A01,083446,Hammock; Frances H,0,0,30,30
1650034846832,MATH 20C,A02,083447,Hammock; Frances H,16,0,30,14
1650034846832,MATH 20C,A03,083448,Hammock; Frances H,19,0,30,11
1650034846832,MATH 20C,A04,083449,Hammock; Frances H,20,0,30,10
1650034846832,MATH 20C,B01,083451,Hammock; Frances H,0,0,30,30
1650034846832,MATH 20C,B02,083452,Hammock; Frances H,18,0,30,12
1650034846832,MATH 20C,B03,083453,Hammock; Frances H,21,0,30,9
1650034846832,MATH 20C,B04,083454,Hammock; Frances H,23,0,30,7
1650034852862,MATH 20D,A01,084128,Staff,14,0,30,16
1650034852862,MATH 20D,A02,084129,Staff,29,0,30,1
1650034852862,MATH 20D,A03,084130,Staff,27,0,30,3
1650034852862,MATH 20D,B01,084133,Staff,3,0,30,27
1650034852862,MATH 20D,B02,084134,Staff,24,0,30,6
1650034852862,MATH 20D,B03,084135,Staff,28,0,30,2
1650034858886,MATH 20E,A01,084138,Staff,14,0,30,16
1650034858886,MATH 20E,A02,084139,Staff,6,0,30,24
1650034858886,MATH 20E,A03,084140,Staff,15,0,30,15
1650034858886,MATH 20E,A04,084141,Staff,20,0,30,10
1650034864911,MATH 102,A01,084143,Harel; Guershon,12,0,30,18
1650034864911,MATH 102,A02,084144,Harel; Guershon,19,0,30,11
1650034870937,MATH 103B,A01,083456,Staff,0,13,30,30
1650034870937,MATH 103B,A02,083457,Staff,0,14,30,30
1650034876965,MATH 109,A01,084146,Salehi Golsefidy; Alireza,17,0,30,13
1650034876965,MATH 109,A02,084147,Salehi Golsefidy; Alireza,15,0,30,15
1650034882993,MATH 120A,A01,085445,Eggers; John Dietrich,10,0,35,25
1650034882993,MATH 120A,A02,085446,Eggers; John Dietrich,27,0,35,8
1650034889015,MATH 142B,A01,084149,Verstraete; Jacques Allan,0,12,30,30
1650034889015,MATH 142B,A02,084150,Verstraete; Jacques Allan,0,12,30,30
1650034895040,MATH 170A,A01,083459,Nie; Jiawang,0,9,30,30
1650034895040,MATH 170A,A02,083460,Nie; Jiawang,0,8,30,30
1650034895040,MATH 170A,A03,083461,Nie; Jiawang,0,9,30,30
1650034901066,MATH 193B,A01,083463,Staff,1,0,30,29
1650034901066,MATH 193B,A02,083464,Staff,9,0,30,21
1650034901066,MATH 193B,A03,083465,Staff,18,0,30,12
1650034907126,COGS 2,A01,083966,Boyle; Mary E. T.,9,0,30,21
1650034913151,COGS 9,A01,083968,Staff,9,0,60,51
1650034919188,COGS 14B,A01,083970,Staff,9,0,50,41
1650034925224,COGS 17,A01,092679,Staff,50,0,75,25
1650034931252,COGS 100,A01,083972,Staff,0,15,60,60
1650034943304,COGS 101C,A01,083976,Staff,12,0,30,18
1650034949326,COGS 102A,A01,083978,Johnson; Christine M.,13,0,30,17
1650034955348,COGS 107B,A01,083980,Staff,0,7,50,50
1650034961375,COGS 115,A01,083982,Staff,10,0,30,20
1650034967399,COGS 118B,A01,083367,Staff,0,15,40,40
1650034973425,COGS 172,A01,083984,Provenzano; Emily Kara,15,0,30,15
1650034979452,COGS 177,A00,083368,Staff,0,20,30,30
1650034985477,COGS 186,A01,083986,Staff,21,0,40,19
1650034991499,COGS 187A,A01,083988,Boyle; Mary E. T.,20,0,60,40
1650034997527,CSE 8A,A50,084003,Miranda; Gregory Joseph,0,14,15,15
1650035003555,CSE 11,A01,084005,Miranda; Gregory Joseph,0,22,55,55
1650035009579,CSE 20,A01,084007,Staff,0,5,20,20
1650035015604,CSE 21,A01,084009,Staff,0,30,50,50
1650035021628,CSE 30,A01,083370,Cao; Yingjun,0,65,40,40
1650035027655,CSE 100,A01,083372,Cao; Yingjun,0,46,40,40
1650035033679,CSE 101,A01,084011,Staff,0,54,40,40
1650035039704,CSE 141,A01,083374,Eldon; John,0,64,75,75
1650035045734,CSE 141L,A01,083376,Eldon; John,0,70,75,75
1650035051760,CSE 175,A01,084013,Kumar; Rakesh,22,0,25,3
1650035057788,CSE 190,A00,092508,Dubnov; Shlomo,20,0,20,0
1650035063813,ECE 5,A01,084049,Morris; Karcher William,13,0,20,7
1650035069841,ECE 100,A01,084051,Baghdadchi; Saharnaz,0,0,20,20
1650035069841,ECE 100,A02,091916,Baghdadchi; Saharnaz,13,0,20,7
1650035075868,ECE 101,A01,084053,Baghdadchi; Saharnaz,0,0,37,37
1650035075868,ECE 101,A02,084054,Baghdadchi; Saharnaz,30,0,37,7
1650035081893,ECE 107,A01,083390,Staff,26,0,40,14
1650035087933,ECE 148,A01,084056,Silberman; Jack,8,0,12,4
1650035093973,ECE 180,A00,083391,Abi Samra; Nicholas Camill,25,0,30,5
1650035093973,ECE 180,B00,083392,Abi Samra; Nicholas Camill,21,0,30,9
1650035100001,MATH 10B,A01,084110,Staff,0,0,30,30
1650035100001,MATH 10B,A02,084111,Staff,18,0,30,12
1650035100001,MATH 10B,A03,084112,Staff,24,0,30,6
1650035106024,MATH 10C,A01,083443,Staff,0,16,30,30
1650035106024,MATH 10C,A02,083444,Staff,0,15,30,30
1650035106024,MATH 10C,B01,084114,Staff,19,0,30,11
1650035106024,MATH 10C,B02,084115,Staff,25,0,30,5
1650035112051,MATH 18,A01,084117,Harel; Guershon,13,0,30,17
1650035112051,MATH 18,A02,084119,Harel; Guershon,27,0,30,3
1650035112051,MATH 18,A03,084120,Harel; Guershon,30,0,30,0
1650035112051,MATH 18,A04,084121,Harel; Guershon,29,0,30,1
1650035118080,MATH 20B,A01,084124,Um; Ko Woon,14,0,35,21
1650035118080,MATH 20B,B01,084126,Um; Ko Woon,24,0,35,11
1650035124108,MATH 20C,A01,083446,Hammock; Frances H,0,0,30,30
1650035124108,MATH 20C,A02,083447,Hammock; Frances H,16,0,30,14
1650035124108,MATH 20C,A03,083448,Hammock; Frances H,19,0,30,11
1650035124108,MATH 20C,A04,083449,Hammock; Frances H,20,0,30,10
1650035124108,MATH 20C,B01,083451,Hammock; Frances H,0,0,30,30
1650035124108,MATH 20C,B02,083452,Hammock; Frances H,18,0,30,12
1650035124108,MATH 20C,B03,083453,Hammock; Frances H,21,0,30,9
1650035124108,MATH 20C,B04,083454,Hammock; Frances H,23,0,30,7
1650035130132,MATH 20D,A01,084128,Staff,14,0,30,16
1650035130132,MATH 20D,A02,084129,Staff,29,0,30,1
1650035130132,MATH 20D,A03,084130,Staff,27,0,30,3
1650035130132,MATH 20D,B01,084133,Staff,3,0,30,27
1650035130132,MATH 20D,B02,084134,Staff,24,0,30,6
1650035130132,MATH 20D,B03,084135,Staff,28,0,30,2
1650035136158,MATH 20E,A01,084138,Staff,14,0,30,16
1650035136158,MATH 20E,A02,084139,Staff,6,0,30,24
1650035136158,MATH 20E,A03,084140,Staff,15,0,30,15
1650035136158,MATH 20E,A04,084141,Staff,20,0,30,10
1650035142186,MATH 102,A01,084143,Harel; Guershon,12,0,30,18
1650035142186,MATH 102,A02,084144,Harel; Guershon,19,0,30,11
1650035148212,MATH 103B,A01,083456,Staff,0,13,30,30
1650035148212,MATH 103B,A02,083457,Staff,0,14,30,30
1650035154241,MATH 109,A01,084146,Salehi Golsefidy; Alireza,17,0,30,13
1650035154241,MATH 109,A02,084147,Salehi Golsefidy; Alireza,15,0,30,15
1650035160291,MATH 120A,A01,085445,Eggers; John Dietrich,10,0,35,25
1650035160291,MATH 120A,A02,085446,Eggers; John Dietrich,27,0,35,8
1650035166315,MATH 142B,A01,084149,Verstraete; Jacques Allan,0,12,30,30
1650035166315,MATH 142B,A02,084150,Verstraete; Jacques Allan,0,12,30,30
1650035172339,MATH 170A,A01,083459,Nie; Jiawang,0,9,30,30
1650035172339,MATH 170A,A02,083460,Nie; Jiawang,0,8,30,30
1650035172339,MATH 170A,A03,083461,Nie; Jiawang,0,9,30,30
1650035178375,MATH 193B,A01,083463,Staff,1,0,30,29
1650035178375,MATH 193B,A02,083464,Staff,9,0,30,21
1650035178375,MATH 193B,A03,083465,Staff,18,0,30,12
1650035184425,COGS 2,A01,083966,Boyle; Mary E. T.,9,0,30,21
1650035190449,COGS 9,A01,083968,Staff,9,0,60,51
1650035196482,COGS 14B,A01,083970,Staff,9,0,50,41
1650035202506,COGS 17,A01,092679,Staff,50,0,75,25
1650035208529,COGS 100,A01,083972,Staff,0,15,60,60
1650035220593,COGS 101C,A01,083976,Staff,12,0,30,18
1650035226617,COGS 102A,A01,083978,Johnson; Christine M.,13,0,30,17
1650035232641,COGS 107B,A01,083980,Staff,0,7,50,50
1650035238772,COGS 115,A01,083982,Staff,10,0,30,20
1650035244798,COGS 118B,A01,083367,Staff,0,15,40,40
1650035250825,COGS 172,A01,083984,Provenzano; Emily Kara,15,0,30,15
1650035256848,COGS 177,A00,083368,Staff,0,20,30,30
1650035262874,COGS 186,A01,083986,Staff,21,0,40,19
1650035268899,COGS 187A,A01,083988,Boyle; Mary E. T.,20,0,60,40
1650035274950,CSE 8A,A50,084003,Miranda; Gregory Joseph,0,14,15,15
1650035280976,CSE 11,A01,084005,Miranda; Gregory Joseph,0,22,55,55
1650035287006,CSE 20,A01,084007,Staff,0,5,20,20
1650035293031,CSE 21,A01,084009,Staff,0,30,50,50
1650035299059,CSE 30,A01,083370,Cao; Yingjun,0,65,40,40
1650035305085,CSE 100,A01,083372,Cao; Yingjun,0,46,40,40
1650035311110,CSE 101,A01,084011,Staff,0,54,40,40
1650035317138,CSE 141,A01,083374,Eldon; John,0,64,75,75
1650035323163,CSE 141L,A01,083376,Eldon; John,0,70,75,75
1650035329188,CSE 175,A01,084013,Kumar; Rakesh,22,0,25,3
1650035335209,CSE 190,A00,092508,Dubnov; Shlomo,20,0,20,0
1650035341234,ECE 5,A01,084049,Morris; Karcher William,13,0,20,7
1650035347258,ECE 100,A01,084051,Baghdadchi; Saharnaz,0,0,20,20
1650035347258,ECE 100,A02,091916,Baghdadchi; Saharnaz,13,0,20,7
1650035353285,ECE 101,A01,084053,Baghdadchi; Saharnaz,0,0,37,37
1650035353285,ECE 101,A02,084054,Baghdadchi; Saharnaz,30,0,37,7
1650035359311,ECE 107,A01,083390,Staff,26,0,40,14
1650035365333,ECE 148,A01,084056,Silberman; Jack,8,0,12,4
1650035371355,ECE 180,A00,083391,Abi Samra; Nicholas Camill,25,0,30,5
1650035371355,ECE 180,B00,083392,Abi Samra; Nicholas Camill,21,0,30,9
1650035377380,MATH 10B,A01,084110,Staff,0,0,30,30
1650035377380,MATH 10B,A02,084111,Staff,18,0,30,12
1650035377380,MATH 10B,A03,084112,Staff,24,0,30,6
1650035383416,MATH 10C,A01,083443,Staff,0,16,30,30
1650035383416,MATH 10C,A02,083444,Staff,0,15,30,30
1650035383416,MATH 10C,B01,084114,Staff,19,0,30,11
1650035383416,MATH 10C,B02,084115,Staff,25,0,30,5
1650035389439,MATH 18,A01,084117,Harel; Guershon,13,0,30,17
1650035389439,MATH 18,A02,084119,Harel; Guershon,27,0,30,3
1650035389439,MATH 18,A03,084120,Harel; Guershon,30,0,30,0
1650035389439,MATH 18,A04,084121,Harel; Guershon,29,0,30,1
1650035395462,MATH 20B,A01,084124,Um; Ko Woon,14,0,35,21
1650035395462,MATH 20B,B01,084126,Um; Ko Woon,24,0,35,11
1650035401487,MATH 20C,A01,083446,Hammock; Frances H,0,0,30,30
1650035401487,MATH 20C,A02,083447,Hammock; Frances H,16,0,30,14
1650035401487,MATH 20C,A03,083448,Hammock; Frances H,19,0,30,11
1650035401487,MATH 20C,A04,083449,Hammock; Frances H,20,0,30,10
1650035401487,MATH 20C,B01,083451,Hammock; Frances H,0,0,30,30
1650035401487,MATH 20C,B02,083452,Hammock; Frances H,18,0,30,12
1650035401487,MATH 20C,B03,083453,Hammock; Frances H,21,0,30,9
1650035401487,MATH 20C,B04,083454,Hammock; Frances H,23,0,30,7
1650035407532,MATH 20D,A01,084128,Staff,14,0,30,16
1650035407532,MATH 20D,A02,084129,Staff,29,0,30,1
1650035407532,MATH 20D,A03,084130,Staff,27,0,30,3
1650035407532,MATH 20D,B01,084133,Staff,3,0,30,27
1650035407532,MATH 20D,B02,084134,Staff,24,0,30,6
1650035407532,MATH 20D,B03,084135,Staff,28,0,30,2
1650035413569,MATH 20E,A01,084138,Staff,14,0,30,16
1650035413569,MATH 20E,A02,084139,Staff,6,0,30,24
1650035413569,MATH 20E,A03,084140,Staff,15,0,30,15
1650035413569,MATH 20E,A04,084141,Staff,20,0,30,10
1650035419593,MATH 102,A01,084143,Harel; Guershon,12,0,30,18
1650035419593,MATH 102,A02,084144,Harel; Guershon,19,0,30,11
1650035425621,MATH 103B,A01,083456,Staff,0,13,30,30
1650035425621,MATH 103B,A02,083457,Staff,0,14,30,30
1650035431652,MATH 109,A01,084146,Salehi Golsefidy; Alireza,17,0,30,13
1650035431652,MATH 109,A02,084147,Salehi Golsefidy; Alireza,15,0,30,15
1650035437679,MATH 120A,A01,085445,Eggers; John Dietrich,10,0,35,25
1650035437679,MATH 120A,A02,085446,Eggers; John Dietrich,27,0,35,8
1650035443708,MATH 142B,A01,084149,Verstraete; Jacques Allan,0,12,30,30
1650035443708,MATH 142B,A02,084150,Verstraete; Jacques Allan,0,12,30,30
1650035449733,MATH 170A,A01,083459,Nie; Jiawang,0,9,30,30
1650035449733,MATH 170A,A02,083460,Nie; Jiawang,0,8,30,30
1650035449733,MATH 170A,A03,083461,Nie; Jiawang,0,9,30,30
1650035455766,MATH 193B,A01,083463,Staff,1,0,30,29
1650035455766,MATH 193B,A02,083464,Staff,9,0,30,21
1650035455766,MATH 193B,A03,083465,Staff,18,0,30,12
1650035461829,COGS 2,A01,083966,Boyle; Mary E. T.,9,0,30,21
1650035467853,COGS 9,A01,083968,Staff,9,0,60,51
1650035473878,COGS 14B,A01,083970,Staff,9,0,50,41
1650035479901,COGS 17,A01,092679,Staff,50,0,75,25
1650035485929,COGS 100,A01,083972,Staff,0,15,60,60
1650035497988,COGS 101C,A01,083976,Staff,12,0,30,18
1650035504014,COGS 102A,A01,083978,Johnson; Christine M.,13,0,30,17
1650035510043,COGS 107B,A01,083980,Staff,0,7,50,50
1650035516068,COGS 115,A01,083982,Staff,10,0,30,20
1650035522096,COGS 118B,A01,083367,Staff,0,15,40,40
1650035528121,COGS 172,A01,083984,Provenzano; Emily Kara,15,0,30,15
1650035534146,COGS 177,A00,083368,Staff,0,20,30,30
1650035540171,COGS 186,A01,083986,Staff,21,0,40,19
1650035546196,COGS 187A,A01,083988,Boyle; Mary E. T.,20,0,60,40
1650035552229,CSE 8A,A50,084003,Miranda; Gregory Joseph,0,14,15,15
1650035558255,CSE 11,A01,084005,Miranda; Gregory Joseph,0,22,55,55
1650035564283,CSE 20,A01,084007,Staff,0,5,20,20
1650035570316,CSE 21,A01,084009,Staff,0,30,50,50
1650035576339,CSE 30,A01,083370,Cao; Yingjun,0,65,40,40
1650035582362,CSE 100,A01,083372,Cao; Yingjun,0,46,40,40
1650035588388,CSE 101,A01,084011,Staff,0,54,40,40
1650035594418,CSE 141,A01,083374,Eldon; John,0,64,75,75
1650035600448,CSE 141L,A01,083376,Eldon; John,0,70,75,75
1650035606473,CSE 175,A01,084013,Kumar; Rakesh,22,0,25,3
1650035612500,CSE 190,A00,092508,Dubnov; Shlomo,20,0,20,0
1650035618523,ECE 5,A01,084049,Morris; Karcher William,13,0,20,7
1650035624549,ECE 100,A01,084051,Baghdadchi; Saharnaz,0,0,20,20
1650035624549,ECE 100,A02,091916,Baghdadchi; Saharnaz,13,0,20,7
1650035630576,ECE 101,A01,084053,Baghdadchi; Saharnaz,0,0,37,37
1650035630576,ECE 101,A02,084054,Baghdadchi; Saharnaz,30,0,37,7
1650035636601,ECE 107,A01,083390,Staff,26,0,40,14
1650035642640,ECE 148,A01,084056,Silberman; Jack,8,0,12,4
1650035648666,ECE 180,A00,083391,Abi Samra; Nicholas Camill,25,0,30,5
1650035648666,ECE 180,B00,083392,Abi Samra; Nicholas Camill,21,0,30,9
1650035654690,MATH 10B,A01,084110,Staff,0,0,30,30
1650035654690,MATH 10B,A02,084111,Staff,18,0,30,12
1650035654690,MATH 10B,A03,084112,Staff,24,0,30,6
1650035660714,MATH 10C,A01,083443,Staff,0,16,30,30
1650035660714,MATH 10C,A02,083444,Staff,0,15,30,30
1650035660714,MATH 10C,B01,084114,Staff,19,0,30,11
1650035660714,MATH 10C,B02,084115,Staff,25,0,30,5
1650035666737,MATH 18,A01,084117,Harel; Guershon,13,0,30,17
1650035666737,MATH 18,A02,084119,Harel; Guershon,27,0,30,3
1650035666737,MATH 18,A03,084120,Harel; Guershon,30,0,30,0
1650035666737,MATH 18,A04,084121,Harel; Guershon,29,0,30,1
1650035672765,MATH 20B,A01,084124,Um; Ko Woon,14,0,35,21
1650035672765,MATH 20B,B01,084126,Um; Ko Woon,24,0,35,11
1650035678796,MATH 20C,A01,083446,Hammock; Frances H,0,0,30,30
1650035678796,MATH 20C,A02,083447,Hammock; Frances H,16,0,30,14
1650035678796,MATH 20C,A03,083448,Hammock; Frances H,19,0,30,11
1650035678796,MATH 20C,A04,083449,Hammock; Frances H,20,0,30,10
1650035678796,MATH 20C,B01,083451,Hammock; Frances H,0,0,30,30
1650035678796,MATH 20C,B02,083452,Hammock; Frances H,18,0,30,12
1650035678796,MATH 20C,B03,083453,Hammock; Frances H,21,0,30,9
1650035678796,MATH 20C,B04,083454,Hammock; Frances H,23,0,30,7
1650035684835,MATH 20D,A01,084128,Staff,14,0,30,16
1650035684835,MATH 20D,A02,084129,Staff,29,0,30,1
1650035684835,MATH 20D,A03,084130,Staff,27,0,30,3
1650035684835,MATH 20D,B01,084133,Staff,3,0,30,27
1650035684835,MATH 20D,B02,084134,Staff,24,0,30,6
1650035684835,MATH 20D,B03,084135,Staff,28,0,30,2
1650035690878,MATH 20E,A01,084138,Staff,14,0,30,16
1650035690878,MATH 20E,A02,084139,Staff,6,0,30,24
1650035690878,MATH 20E,A03,084140,Staff,15,0,30,15
1650035690878,MATH 20E,A04,084141,Staff,20,0,30,10
1650035696901,MATH 102,A01,084143,Harel; Guershon,12,0,30,18
1650035696901,MATH 102,A02,084144,Harel; Guershon,19,0,30,11
1650035702925,MATH 103B,A01,083456,Staff,0,13,30,30
1650035702925,MATH 103B,A02,083457,Staff,0,14,30,30
1650035708947,MATH 109,A01,084146,Salehi Golsefidy; Alireza,17,0,30,13
1650035708947,MATH 109,A02,084147,Salehi Golsefidy; Alireza,15,0,30,15
1650035714972,MATH 120A,A01,085445,Eggers; John Dietrich,10,0,35,25
1650035714972,MATH 120A,A02,085446,Eggers; John Dietrich,27,0,35,8
1650035720999,MATH 142B,A01,084149,Verstraete; Jacques Allan,0,12,30,30
1650035720999,MATH 142B,A02,084150,Verstraete; Jacques Allan,0,12,30,30
1650035727024,MATH 170A,A01,083459,Nie; Jiawang,0,9,30,30
1650035727024,MATH 170A,A02,083460,Nie; Jiawang,0,8,30,30
1650035727024,MATH 170A,A03,083461,Nie; Jiawang,0,9,30,30
1650035733045,MATH 193B,A01,083463,Staff,1,0,30,29
1650035733045,MATH 193B,A02,083464,Staff,9,0,30,21
1650035733045,MATH 193B,A03,083465,Staff,18,0,30,12
1650035739103,COGS 2,A01,083966,Boyle; Mary E. T.,9,0,30,21
1650035745128,COGS 9,A01,083968,Staff,9,0,60,51
1650035751157,COGS 14B,A01,083970,Staff,9,0,50,41
1650035757180,COGS 17,A01,092679,Staff,50,0,75,25
1650035763201,COGS 100,A01,083972,Staff,0,15,60,60
1650035775256,COGS 101C,A01,083976,Staff,12,0,30,18
1650035781289,COGS 102A,A01,083978,Johnson; Christine M.,13,0,30,17
1650035787315,COGS 107B,A01,083980,Staff,0,7,50,50
1650035793345,COGS 115,A01,083982,Staff,10,0,30,20
1650035799388,COGS 118B,A01,083367,Staff,0,15,40,40
1650035805413,COGS 172,A01,083984,Provenzano; Emily Kara,15,0,30,15
1650035811437,COGS 177,A00,083368,Staff,0,20,30,30
1650035817461,COGS 186,A01,083986,Staff,21,0,40,19
1650035823485,COGS 187A,A01,083988,Boyle; Mary E. T.,20,0,60,40
1650035829511,CSE 8A,A50,084003,Miranda; Gregory Joseph,0,14,15,15
1650035835622,CSE 11,A01,084005,Miranda; Gregory Joseph,0,22,55,55
1650035841649,CSE 20,A01,084007,Staff,0,5,20,20
1650035847676,CSE 21,A01,084009,Staff,0,31,50,50
1650035853700,CSE 30,A01,083370,Cao; Yingjun,0,65,40,40
1650035859724,CSE 100,A01,083372,Cao; Yingjun,0,46,40,40
1650035865748,CSE 101,A01,084011,Staff,0,54,40,40
1650035871772,CSE 141,A01,083374,Eldon; John,0,64,75,75
1650035877795,CSE 141L,A01,083376,Eldon; John,0,70,75,75
1650035883822,CSE 175,A01,084013,Kumar; Rakesh,22,0,25,3
1650035889846,CSE 190,A00,092508,Dubnov; Shlomo,20,0,20,0
1650035895872,ECE 5,A01,084049,Morris; Karcher William,13,0,20,7
1650035901895,ECE 100,A01,084051,Baghdadchi; Saharnaz,0,0,20,20
1650035901895,ECE 100,A02,091916,Baghdadchi; Saharnaz,13,0,20,7
1650035907922,ECE 101,A01,084053,Baghdadchi; Saharnaz,0,0,37,37
1650035907922,ECE 101,A02,084054,Baghdadchi; Saharnaz,30,0,37,7
1650035913960,ECE 107,A01,083390,Staff,26,0,40,14
1650035919994,ECE 148,A01,084056,Silberman; Jack,8,0,12,4
1650035926019,ECE 180,A00,083391,Abi Samra; Nicholas Camill,25,0,30,5
1650035926019,ECE 180,B00,083392,Abi Samra; Nicholas Camill,21,0,30,9
1650035932044,MATH 10B,A01,084110,Staff,0,0,30,30
1650035932044,MATH 10B,A02,084111,Staff,18,0,30,12
1650035932044,MATH 10B,A03,084112,Staff,24,0,30,6
1650035938071,MATH 10C,A01,083443,Staff,0,16,30,30
1650035938071,MATH 10C,A02,083444,Staff,0,15,30,30
1650035938071,MATH 10C,B01,084114,Staff,19,0,30,11
1650035938071,MATH 10C,B02,084115,Staff,25,0,30,5
1650035944122,MATH 18,A01,084117,Harel; Guershon,13,0,30,17
1650035944122,MATH 18,A02,084119,Harel; Guershon,27,0,30,3
1650035944122,MATH 18,A03,084120,Harel; Guershon,30,0,30,0
1650035944122,MATH 18,A04,084121,Harel; Guershon,29,0,30,1
1650035950153,MATH 20B,A01,084124,Um; Ko Woon,14,0,35,21
1650035950153,MATH 20B,B01,084126,Um; Ko Woon,24,0,35,11
1650035956180,MATH 20C,A01,083446,Hammock; Frances H,0,0,30,30
1650035956180,MATH 20C,A02,083447,Hammock; Frances H,16,0,30,14
1650035956180,MATH 20C,A03,083448,Hammock; Frances H,19,0,30,11
1650035956180,MATH 20C,A04,083449,Hammock; Frances H,20,0,30,10
1650035956180,MATH 20C,B01,083451,Hammock; Frances H,0,0,30,30
1650035956180,MATH 20C,B02,083452,Hammock; Frances H,18,0,30,12
1650035956180,MATH 20C,B03,083453,Hammock; Frances H,21,0,30,9
1650035956180,MATH 20C,B04,083454,Hammock; Frances H,23,0,30,7
1650035962214,MATH 20D,A01,084128,Staff,14,0,30,16
1650035962214,MATH 20D,A02,084129,Staff,29,0,30,1
1650035962214,MATH 20D,A03,084130,Staff,27,0,30,3
1650035962214,MATH 20D,B01,084133,Staff,3,0,30,27
1650035962214,MATH 20D,B02,084134,Staff,24,0,30,6
1650035962214,MATH 20D,B03,084135,Staff,28,0,30,2
1650035968241,MATH 20E,A01,084138,Staff,14,0,30,16
1650035968241,MATH 20E,A02,084139,Staff,6,0,30,24
1650035968241,MATH 20E,A03,084140,Staff,15,0,30,15
1650035968241,MATH 20E,A04,084141,Staff,20,0,30,10
1650035974266,MATH 102,A01,084143,Harel; Guershon,12,0,30,18
1650035974266,MATH 102,A02,084144,Harel; Guershon,19,0,30,11
1650035980293,MATH 103B,A01,083456,Staff,0,13,30,30
1650035980293,MATH 103B,A02,083457,Staff,0,14,30,30
1650035986323,MATH 109,A01,084146,Salehi Golsefidy; Alireza,17,0,30,13
1650035986323,MATH 109,A02,084147,Salehi Golsefidy; Alireza,15,0,30,15
1650035992348,MATH 120A,A01,085445,Eggers; John Dietrich,10,0,35,25
1650035992348,MATH 120A,A02,085446,Eggers; John Dietrich,27,0,35,8
1650035998374,MATH 142B,A01,084149,Verstraete; Jacques Allan,0,12,30,30
1650035998374,MATH 142B,A02,084150,Verstraete; Jacques Allan,0,12,30,30
1650036004403,MATH 170A,A01,083459,Nie; Jiawang,0,9,30,30
1650036004403,MATH 170A,A02,083460,Nie; Jiawang,0,8,30,30
1650036004403,MATH 170A,A03,083461,Nie; Jiawang,0,9,30,30
1650036010433,MATH 193B,A01,083463,Staff,1,0,30,29
1650036010433,MATH 193B,A02,083464,Staff,9,0,30,21
1650036010433,MATH 193B,A03,083465,Staff,18,0,30,12
1650036016493,COGS 2,A01,083966,Boyle; Mary E. T.,9,0,30,21
1650036022518,COGS 9,A01,083968,Staff,9,0,60,51
1650036028549,COGS 14B,A01,083970,Staff,9,0,50,41
1650036034572,COGS 17,A01,092679,Staff,50,0,75,25
1650036040596,COGS 100,A01,083972,Staff,0,15,60,60
1650036052659,COGS 101C,A01,083976,Staff,12,0,30,18
1650036058696,COGS 102A,A01,083978,Johnson; Christine M.,13,0,30,17
1650036064723,COGS 107B,A01,083980,Staff,0,7,50,50
1650036070755,COGS 115,A01,083982,Staff,10,0,30,20
1650036076780,COGS 118B,A01,083367,Staff,0,15,40,40
1650036082804,COGS 172,A01,083984,Provenzano; Emily Kara,15,0,30,15
1650036088832,COGS 177,A00,083368,Staff,0,20,30,30
1650036094859,COGS 186,A01,083986,Staff,21,0,40,19
1650036100885,COGS 187A,A01,083988,Boyle; Mary E. T.,20,0,60,40
1650036106908,CSE 8A,A50,084003,Miranda; Gregory Joseph,0,14,15,15
1650036112930,CSE 11,A01,084005,Miranda; Gregory Joseph,0,22,55,55
1650036118954,CSE 20,A01,084007,Staff,0,5,20,20
1650036124980,CSE 21,A01,084009,Staff,0,31,50,50
1650036131003,CSE 30,A01,083370,Cao; Yingjun,0,65,40,40
1650036137039,CSE 100,A01,083372,Cao; Yingjun,0,46,40,40
1650036143065,CSE 101,A01,084011,Staff,0,54,40,40
1650036149090,CSE 141,A01,083374,Eldon; John,0,64,75,75
1650036155113,CSE 141L,A01,083376,Eldon; John,0,70,75,75
1650036161141,CSE 175,A01,084013,Kumar; Rakesh,22,0,25,3
1650036167163,CSE 190,A00,092508,Dubnov; Shlomo,20,0,20,0
1650036173189,ECE 5,A01,084049,Morris; Karcher William,13,0,20,7
1650036179216,ECE 100,A01,084051,Baghdadchi; Saharnaz,0,0,20,20
1650036179216,ECE 100,A02,091916,Baghdadchi; Saharnaz,13,0,20,7
1650036185240,ECE 101,A01,084053,Baghdadchi; Saharnaz,0,0,37,37
1650036185240,ECE 101,A02,084054,Baghdadchi; Saharnaz,30,0,37,7
1650036191290,ECE 107,A01,083390,Staff,26,0,40,14
1650036197315,ECE 148,A01,084056,Silberman; Jack,8,0,12,4
1650036203341,ECE 180,A00,083391,Abi Samra; Nicholas Camill,25,0,30,5
1650036203341,ECE 180,B00,083392,Abi Samra; Nicholas Camill,21,0,30,9
1650036209377,MATH 10B,A01,084110,Staff,0,0,30,30
1650036209377,MATH 10B,A02,084111,Staff,18,0,30,12
1650036209377,MATH 10B,A03,084112,Staff,24,0,30,6
1650036215404,MATH 10C,A01,083443,Staff,0,16,30,30
1650036215404,MATH 10C,A02,083444,Staff,0,15,30,30
1650036215404,MATH 10C,B01,084114,Staff,19,0,30,11
1650036215404,MATH 10C,B02,084115,Staff,25,0,30,5
1650036221429,MATH 18,A01,084117,Harel; Guershon,13,0,30,17
1650036221429,MATH 18,A02,084119,Harel; Guershon,27,0,30,3
1650036221429,MATH 18,A03,084120,Harel; Guershon,30,0,30,0
1650036221429,MATH 18,A04,084121,Harel; Guershon,29,0,30,1
1650036227458,MATH 20B,A01,084124,Um; Ko Woon,14,0,35,21
1650036227458,MATH 20B,B01,084126,Um; Ko Woon,24,0,35,11
1650036233482,MATH 20C,A01,083446,Hammock; Frances H,0,0,30,30
1650036233482,MATH 20C,A02,083447,Hammock; Frances H,16,0,30,14
1650036233482,MATH 20C,A03,083448,Hammock; Frances H,19,0,30,11
1650036233482,MATH 20C,A04,083449,Hammock; Frances H,20,0,30,10
1650036233482,MATH 20C,B01,083451,Hammock; Frances H,0,0,30,30
1650036233482,MATH 20C,B02,083452,Hammock; Frances H,18,0,30,12
1650036233482,MATH 20C,B03,083453,Hammock; Frances H,21,0,30,9
1650036233482,MATH 20C,B04,083454,Hammock; Frances H,23,0,30,7
1650036239507,MATH 20D,A01,084128,Staff,14,0,30,16
1650036239507,MATH 20D,A02,084129,Staff,29,0,30,1
1650036239507,MATH 20D,A03,084130,Staff,27,0,30,3
1650036239507,MATH 20D,B01,084133,Staff,3,0,30,27
1650036239507,MATH 20D,B02,084134,Staff,24,0,30,6
1650036239507,MATH 20D,B03,084135,Staff,28,0,30,2
1650036245537,MATH 20E,A01,084138,Staff,14,0,30,16
1650036245537,MATH 20E,A02,084139,Staff,6,0,30,24
1650036245537,MATH 20E,A03,084140,Staff,15,0,30,15
1650036245537,MATH 20E,A04,084141,Staff,20,0,30,10
1650036251564,MATH 102,A01,084143,Harel; Guershon,12,0,30,18
1650036251564,MATH 102,A02,084144,Harel; Guershon,19,0,30,11
1650036257596,MATH 103B,A01,083456,Staff,0,13,30,30
1650036257596,MATH 103B,A02,083457,Staff,0,14,30,30
1650036263620,MATH 109,A01,084146,Salehi Golsefidy; Alireza,17,0,30,13
1650036263620,MATH 109,A02,084147,Salehi Golsefidy; Alireza,15,0,30,15
1650036269647,MATH 120A,A01,085445,Eggers; John Dietrich,10,0,35,25
1650036269647,MATH 120A,A02,085446,Eggers; John Dietrich,27,0,35,8
1650036275680,MATH 142B,A01,084149,Verstraete; Jacques Allan,0,12,30,30
1650036275680,MATH 142B,A02,084150,Verstraete; Jacques Allan,0,12,30,30
1650036281709,MATH 170A,A01,083459,Nie; Jiawang,0,9,30,30
1650036281709,MATH 170A,A02,083460,Nie; Jiawang,0,8,30,30
1650036281709,MATH 170A,A03,083461,Nie; Jiawang,0,9,30,30
1650036287737,MATH 193B,A01,083463,Staff,1,0,30,29
1650036287737,MATH 193B,A02,083464,Staff,9,0,30,21
1650036287737,MATH 193B,A03,083465,Staff,18,0,30,12
1650036293791,COGS 2,A01,083966,Boyle; Mary E. T.,9,0,30,21
1650036299819,COGS 9,A01,083968,Staff,9,0,60,51
1650036305847,COGS 14B,A01,083970,Staff,9,0,50,41
1650036311870,COGS 17,A01,092679,Staff,50,0,75,25
1650036317893,COGS 100,A01,083972,Staff,0,15,60,60
1650036329943,COGS 101C,A01,083976,Staff,12,0,30,18
1650036335965,COGS 102A,A01,083978,Johnson; Christine M.,13,0,30,17
1650036341993,COGS 107B,A01,083980,Staff,0,7,50,50
1650036348017,COGS 115,A01,083982,Staff,10,0,30,20
1650036354040,COGS 118B,A01,083367,Staff,0,15,40,40
1650036360063,COGS 172,A01,083984,Provenzano; Emily Kara,15,0,30,15
1650036366090,COGS 177,A00,083368,Staff,0,20,30,30
1650036372116,COGS 186,A01,083986,Staff,21,0,40,19
1650036378138,COGS 187A,A01,083988,Boyle; Mary E. T.,20,0,60,40
1650036384161,CSE 8A,A50,084003,Miranda; Gregory Joseph,0,14,15,15
1650036390188,CSE 11,A01,084005,Miranda; Gregory Joseph,0,22,55,55
1650036396219,CSE 20,A01,084007,Staff,0,5,20,20
1650036402247,CSE 21,A01,084009,Staff,0,31,50,50
1650036408274,CSE 30,A01,083370,Cao; Yingjun,0,65,40,40
1650036414305,CSE 100,A01,083372,Cao; Yingjun,0,46,40,40
1650036420329,CSE 101,A01,084011,Staff,0,54,40,40
1650036426353,CSE 141,A01,083374,Eldon; John,0,64,75,75
1650036432451,CSE 141L,A01,083376,Eldon; John,0,70,75,75
1650036438486,CSE 175,A01,084013,Kumar; Rakesh,22,0,25,3
1650036444513,CSE 190,A00,092508,Dubnov; Shlomo,20,0,20,0
1650036450541,ECE 5,A01,084049,Morris; Karcher William,13,0,20,7
1650036456570,ECE 100,A01,084051,Baghdadchi; Saharnaz,0,0,20,20
1650036456570,ECE 100,A02,091916,Baghdadchi; Saharnaz,13,0,20,7
1650036462592,ECE 101,A01,084053,Baghdadchi; Saharnaz,0,0,37,37
1650036462592,ECE 101,A02,084054,Baghdadchi; Saharnaz,30,0,37,7
1650036468617,ECE 107,A01,083390,Staff,26,0,40,14
1650036474640,ECE 148,A01,084056,Silberman; Jack,8,0,12,4
1650036480666,ECE 180,A00,083391,Abi Samra; Nicholas Camill,25,0,30,5
1650036480666,ECE 180,B00,083392,Abi Samra; Nicholas Camill,21,0,30,9
1650036486705,MATH 10B,A01,084110,Staff,0,0,30,30
1650036486705,MATH 10B,A02,084111,Staff,18,0,30,12
1650036486705,MATH 10B,A03,084112,Staff,24,0,30,6
1650036492734,MATH 10C,A01,083443,Staff,0,16,30,30
1650036492734,MATH 10C,A02,083444,Staff,0,15,30,30
1650036492734,MATH 10C,B01,084114,Staff,19,0,30,11
1650036492734,MATH 10C,B02,084115,Staff,25,0,30,5
1650036498757,MATH 18,A01,084117,Harel; Guershon,13,0,30,17
1650036498757,MATH 18,A02,084119,Harel; Guershon,27,0,30,3
1650036498757,MATH 18,A03,084120,Harel; Guershon,30,0,30,0
1650036498757,MATH 18,A04,084121,Harel; Guershon,29,0,30,1
1650036504784,MATH 20B,A01,084124,Um; Ko Woon,14,0,35,21
1650036504784,MATH 20B,B01,084126,Um; Ko Woon,24,0,35,11
1650036510813,MATH 20C,A01,083446,Hammock; Frances H,0,0,30,30
1650036510813,MATH 20C,A02,083447,Hammock; Frances H,16,0,30,14
1650036510813,MATH 20C,A03,083448,Hammock; Frances H,19,0,30,11
1650036510813,MATH 20C,A04,083449,Hammock; Frances H,20,0,30,10
1650036510813,MATH 20C,B01,083451,Hammock; Frances H,0,0,30,30
1650036510813,MATH 20C,B02,083452,Hammock; Frances H,18,0,30,12
1650036510813,MATH 20C,B03,083453,Hammock; Frances H,21,0,30,9
1650036510813,MATH 20C,B04,083454,Hammock; Frances H,23,0,30,7
1650036516839,MATH 20D,A01,084128,Staff,14,0,30,16
1650036516839,MATH 20D,A02,084129,Staff,29,0,30,1
1650036516839,MATH 20D,A03,084130,Staff,27,0,30,3
1650036516839,MATH 20D,B01,084133,Staff,3,0,30,27
1650036516839,MATH 20D,B02,084134,Staff,24,0,30,6
1650036516839,MATH 20D,B03,084135,Staff,28,0,30,2
1650036522866,MATH 20E,A01,084138,Staff,14,0,30,16
1650036522866,MATH 20E,A02,084139,Staff,6,0,30,24
1650036522866,MATH 20E,A03,084140,Staff,15,0,30,15
1650036522866,MATH 20E,A04,084141,Staff,20,0,30,10
1650036528889,MATH 102,A01,084143,Harel; Guershon,12,0,30,18
1650036528889,MATH 102,A02,084144,Harel; Guershon,19,0,30,11
1650036534912,MATH 103B,A01,083456,Staff,0,13,30,30
1650036534912,MATH 103B,A02,083457,Staff,0,14,30,30
1650036540943,MATH 109,A01,084146,Salehi Golsefidy; Alireza,17,0,30,13
1650036540943,MATH 109,A02,084147,Salehi Golsefidy; Alireza,15,0,30,15
1650036546967,MATH 120A,A01,085445,Eggers; John Dietrich,10,0,35,25
1650036546967,MATH 120A,A02,085446,Eggers; John Dietrich,27,0,35,8
1650036552996,MATH 142B,A01,084149,Verstraete; Jacques Allan,0,12,30,30
1650036552996,MATH 142B,A02,084150,Verstraete; Jacques Allan,0,12,30,30
1650036559021,MATH 170A,A01,083459,Nie; Jiawang,0,9,30,30
1650036559021,MATH 170A,A02,083460,Nie; Jiawang,0,8,30,30
1650036559021,MATH 170A,A03,083461,Nie; Jiawang,0,9,30,30
1650036565044,MATH 193B,A01,083463,Staff,1,0,30,29
1650036565044,MATH 193B,A02,083464,Staff,9,0,30,21
1650036565044,MATH 193B,A03,083465,Staff,18,0,30,12
1650036571096,COGS 2,A01,083966,Boyle; Mary E. T.,9,0,30,21
1650036577124,COGS 9,A01,083968,Staff,9,0,60,51
1650036583147,COGS 14B,A01,083970,Staff,9,0,50,41
1650036589180,COGS 17,A01,092679,Staff,50,0,75,25
1650036595206,COGS 100,A01,083972,Staff,0,15,60,60
1650036607261,COGS 101C,A01,083976,Staff,12,0,30,18
1650036613285,COGS 102A,A01,083978,Johnson; Christine M.,13,0,30,17
1650036619309,COGS 107B,A01,083980,Staff,0,7,50,50
1650036625333,COGS 115,A01,083982,Staff,10,0,30,20
1650036631361,COGS 118B,A01,083367,Staff,0,15,40,40
1650036637389,COGS 172,A01,083984,Provenzano; Emily Kara,15,0,30,15
1650036643415,COGS 177,A00,083368,Staff,0,20,30,30
1650036649439,COGS 186,A01,083986,Staff,21,0,40,19
1650036655474,COGS 187A,A01,083988,Boyle; Mary E. T.,20,0,60,40
1650036661513,CSE 8A,A50,084003,Miranda; Gregory Joseph,0,14,15,15
1650036667542,CSE 11,A01,084005,Miranda; Gregory Joseph,0,22,55,55
1650036673568,CSE 20,A01,084007,Staff,0,5,20,20
1650036679608,CSE 21,A01,084009,Staff,0,31,50,50
1650036685632,CSE 30,A01,083370,Cao; Yingjun,0,65,40,40
1650036691654,CSE 100,A01,083372,Cao; Yingjun,0,46,40,40
1650036697680,CSE 101,A01,084011,Staff,0,54,40,40
1650036703702,CSE 141,A01,083374,Eldon; John,0,64,75,75
1650036709726,CSE 141L,A01,083376,Eldon; John,0,70,75,75
1650036715750,CSE 175,A01,084013,Kumar; Rakesh,22,0,25,3
1650036721777,CSE 190,A00,092508,Dubnov; Shlomo,20,0,20,0
1650036727802,ECE 5,A01,084049,Morris; Karcher William,13,0,20,7
1650036733827,ECE 100,A01,084051,Baghdadchi; Saharnaz,0,0,20,20
1650036733827,ECE 100,A02,091916,Baghdadchi; Saharnaz,13,0,20,7
1650036739858,ECE 101,A01,084053,Baghdadchi; Saharnaz,0,0,37,37
1650036739858,ECE 101,A02,084054,Baghdadchi; Saharnaz,30,0,37,7
1650036745895,ECE 107,A01,083390,Staff,26,0,40,14
1650036751924,ECE 148,A01,084056,Silberman; Jack,8,0,12,4
1650036757951,ECE 180,A00,083391,Abi Samra; Nicholas Camill,25,0,30,5
1650036757951,ECE 180,B00,083392,Abi Samra; Nicholas Camill,21,0,30,9
1650036763990,MATH 10B,A01,084110,Staff,0,0,30,30
1650036763990,MATH 10B,A02,084111,Staff,18,0,30,12
1650036763990,MATH 10B,A03,084112,Staff,24,0,30,6
1650036770024,MATH 10C,A01,083443,Staff,0,16,30,30
1650036770024,MATH 10C,A02,083444,Staff,0,15,30,30
1650036770024,MATH 10C,B01,084114,Staff,19,0,30,11
1650036770024,MATH 10C,B02,084115,Staff,25,0,30,5
1650036776050,MATH 18,A01,084117,Harel; Guershon,13,0,30,17
1650036776050,MATH 18,A02,084119,Harel; Guershon,27,0,30,3
1650036776050,MATH 18,A03,084120,Harel; Guershon,30,0,30,0
1650036776050,MATH 18,A04,084121,Harel; Guershon,29,0,30,1
1650036782074,MATH 20B,A01,084124,Um; Ko Woon,14,0,35,21
1650036782074,MATH 20B,B01,084126,Um; Ko Woon,24,0,35,11
1650036788098,MATH 20C,A01,083446,Hammock; Frances H,0,0,30,30
1650036788098,MATH 20C,A02,083447,Hammock; Frances H,16,0,30,14
1650036788098,MATH 20C,A03,083448,Hammock; Frances H,19,0,30,11
1650036788098,MATH 20C,A04,083449,Hammock; Frances H,20,0,30,10
1650036788098,MATH 20C,B01,083451,Hammock; Frances H,0,0,30,30
1650036788098,MATH 20C,B02,083452,Hammock; Frances H,18,0,30,12
1650036788098,MATH 20C,B03,083453,Hammock; Frances H,21,0,30,9
1650036788098,MATH 20C,B04,083454,Hammock; Frances H,23,0,30,7
1650036794122,MATH 20D,A01,084128,Staff,14,0,30,16
1650036794122,MATH 20D,A02,084129,Staff,29,0,30,1
1650036794122,MATH 20D,A03,084130,Staff,27,0,30,3
1650036794122,MATH 20D,B01,084133,Staff,3,0,30,27
1650036794122,MATH 20D,B02,084134,Staff,24,0,30,6
1650036794122,MATH 20D,B03,084135,Staff,28,0,30,2
1650036800144,MATH 20E,A01,084138,Staff,14,0,30,16
1650036800144,MATH 20E,A02,084139,Staff,6,0,30,24
1650036800144,MATH 20E,A03,084140,Staff,15,0,30,15
1650036800144,MATH 20E,A04,084141,Staff,20,0,30,10
1650036806171,MATH 102,A01,084143,Harel; Guershon,12,0,30,18
1650036806171,MATH 102,A02,084144,Harel; Guershon,19,0,30,11
1650036812199,MATH 103B,A01,083456,Staff,0,13,30,30
1650036812199,MATH 103B,A02,083457,Staff,0,14,30,30
1650036818235,MATH 109,A01,084146,Salehi Golsefidy; Alireza,17,0,30,13
1650036818235,MATH 109,A02,084147,Salehi Golsefidy; Alireza,15,0,30,15
1650036824257,MATH 120A,A01,085445,Eggers; John Dietrich,10,0,35,25
1650036824257,MATH 120A,A02,085446,Eggers; John Dietrich,27,0,35,8
1650036830283,MATH 142B,A01,084149,Verstraete; Jacques Allan,0,12,30,30
1650036830283,MATH 142B,A02,084150,Verstraete; Jacques Allan,0,12,30,30
1650036836317,MATH 170A,A01,083459,Nie; Jiawang,0,9,30,30
1650036836317,MATH 170A,A02,083460,Nie; Jiawang,0,8,30,30
1650036836317,MATH 170A,A03,083461,Nie; Jiawang,0,9,30,30
1650036842341,MATH 193B,A01,083463,Staff,1,0,30,29
1650036842341,MATH 193B,A02,083464,Staff,9,0,30,21
1650036842341,MATH 193B,A03,083465,Staff,18,0,30,12
1650036848398,COGS 2,A01,083966,Boyle; Mary E. T.,9,0,30,21
1650036854428,COGS 9,A01,083968,Staff,9,0,60,51
1650036860450,COGS 14B,A01,083970,Staff,9,0,50,41
1650036866476,COGS 17,A01,092679,Staff,50,0,75,25
1650036872505,COGS 100,A01,083972,Staff,0,15,60,60
1650036884553,COGS 101C,A01,083976,Staff,12,0,30,18
1650036890585,COGS 102A,A01,083978,Johnson; Christine M.,13,0,30,17
1650036896609,COGS 107B,A01,083980,Staff,0,7,50,50
1650036902634,COGS 115,A01,083982,Staff,10,0,30,20
1650036908667,COGS 118B,A01,083367,Staff,0,15,40,40
1650036914694,COGS 172,A01,083984,Provenzano; Emily Kara,15,0,30,15
1650036920720,COGS 177,A00,083368,Staff,0,20,30,30
1650036926758,COGS 186,A01,083986,Staff,21,0,40,19
1650036932784,COGS 187A,A01,083988,Boyle; Mary E. T.,20,0,60,40
1650036938812,CSE 8A,A50,084003,Miranda; Gregory Joseph,0,14,15,15
1650036944848,CSE 11,A01,084005,Miranda; Gregory Joseph,0,22,55,55
1650036950885,CSE 20,A01,084007,Staff,0,5,20,20
1650036956912,CSE 21,A01,084009,Staff,0,31,50,50
1650036962945,CSE 30,A01,083370,Cao; Yingjun,0,65,40,40
1650036968969,CSE 100,A01,083372,Cao; Yingjun,0,46,40,40
1650036974995,CSE 101,A01,084011,Staff,0,54,40,40
1650036981020,CSE 141,A01,083374,Eldon; John,0,64,75,75
1650036987043,CSE 141L,A01,083376,Eldon; John,0,70,75,75
1650036993069,CSE 175,A01,084013,Kumar; Rakesh,22,0,25,3
1650036999098,CSE 190,A00,092508,Dubnov; Shlomo,20,0,20,0
1650037005119,ECE 5,A01,084049,Morris; Karcher William,13,0,20,7
1650037011151,ECE 100,A01,084051,Baghdadchi; Saharnaz,0,0,20,20
1650037011151,ECE 100,A02,091916,Baghdadchi; Saharnaz,13,0,20,7
1650037017174,ECE 101,A01,084053,Baghdadchi; Saharnaz,0,0,37,37
1650037017174,ECE 101,A02,084054,Baghdadchi; Saharnaz,30,0,37,7
1650037023210,ECE 107,A01,083390,Staff,26,0,40,14
1650037029309,ECE 148,A01,084056,Silberman; Jack,8,0,12,4
1650037035333,ECE 180,A00,083391,Abi Samra; Nicholas Camill,25,0,30,5
1650037035333,ECE 180,B00,083392,Abi Samra; Nicholas Camill,21,0,30,9
1650037041354,MATH 10B,A01,084110,Staff,0,0,30,30
1650037041354,MATH 10B,A02,084111,Staff,18,0,30,12
1650037041354,MATH 10B,A03,084112,Staff,24,0,30,6
1650037047383,MATH 10C,A01,083443,Staff,0,16,30,30
1650037047383,MATH 10C,A02,083444,Staff,0,15,30,30
1650037047383,MATH 10C,B01,084114,Staff,19,0,30,11
1650037047383,MATH 10C,B02,084115,Staff,25,0,30,5
1650037053410,MATH 18,A01,084117,Harel; Guershon,13,0,30,17
1650037053410,MATH 18,A02,084119,Harel; Guershon,27,0,30,3
1650037053410,MATH 18,A03,084120,Harel; Guershon,30,0,30,0
1650037053410,MATH 18,A04,084121,Harel; Guershon,29,0,30,1
1650037059433,MATH 20B,A01,084124,Um; Ko Woon,14,0,35,21
1650037059433,MATH 20B,B01,084126,Um; Ko Woon,24,0,35,11
1650037065465,MATH 20C,A01,083446,Hammock; Frances H,0,0,30,30
1650037065465,MATH 20C,A02,083447,Hammock; Frances H,16,0,30,14
1650037065465,MATH 20C,A03,083448,Hammock; Frances H,19,0,30,11
1650037065465,MATH 20C,A04,083449,Hammock; Frances H,20,0,30,10
1650037065465,MATH 20C,B01,083451,Hammock; Frances H,0,0,30,30
1650037065465,MATH 20C,B02,083452,Hammock; Frances H,18,0,30,12
1650037065465,MATH 20C,B03,083453,Hammock; Frances H,21,0,30,9
1650037065465,MATH 20C,B04,083454,Hammock; Frances H,23,0,30,7
1650037071501,MATH 20D,A01,084128,Staff,14,0,30,16
1650037071501,MATH 20D,A02,084129,Staff,29,0,30,1
1650037071501,MATH 20D,A03,084130,Staff,27,0,30,3
1650037071501,MATH 20D,B01,084133,Staff,3,0,30,27
1650037071501,MATH 20D,B02,084134,Staff,24,0,30,6
1650037071501,MATH 20D,B03,084135,Staff,28,0,30,2
1650037077525,MATH 20E,A01,084138,Staff,14,0,30,16
1650037077525,MATH 20E,A02,084139,Staff,6,0,30,24
1650037077525,MATH 20E,A03,084140,Staff,15,0,30,15
1650037077525,MATH 20E,A04,084141,Staff,20,0,30,10
1650037083558,MATH 102,A01,084143,Harel; Guershon,12,0,30,18
1650037083558,MATH 102,A02,084144,Harel; Guershon,19,0,30,11
1650037089582,MATH 103B,A01,083456,Staff,0,13,30,30
1650037089582,MATH 103B,A02,083457,Staff,0,14,30,30
1650037095606,MATH 109,A01,084146,Salehi Golsefidy; Alireza,17,0,30,13
1650037095606,MATH 109,A02,084147,Salehi Golsefidy; Alireza,15,0,30,15
1650037101630,MATH 120A,A01,085445,Eggers; John Dietrich,10,0,35,25
1650037101630,MATH 120A,A02,085446,Eggers; John Dietrich,27,0,35,8
1650037107654,MATH 142B,A01,084149,Verstraete; Jacques Allan,0,12,30,30
1650037107654,MATH 142B,A02,084150,Verstraete; Jacques Allan,0,12,30,30
1650037113679,MATH 170A,A01,083459,Nie; Jiawang,0,9,30,30
1650037113679,MATH 170A,A02,083460,Nie; Jiawang,0,8,30,30
1650037113679,MATH 170A,A03,083461,Nie; Jiawang,0,9,30,30
1650037119703,MATH 193B,A01,083463,Staff,1,0,30,29
1650037119703,MATH 193B,A02,083464,Staff,9,0,30,21
1650037119703,MATH 193B,A03,083465,Staff,18,0,30,12
1650037125756,COGS 2,A01,083966,Boyle; Mary E. T.,9,0,30,21
1650037131779,COGS 9,A01,083968,Staff,9,0,60,51
1650037137801,COGS 14B,A01,083970,Staff,9,0,50,41
1650037143828,COGS 17,A01,092679,Staff,50,0,75,25
1650037149855,COGS 100,A01,083972,Staff,0,15,60,60
1650037161909,COGS 101C,A01,083976,Staff,12,0,30,18
1650037167936,COGS 102A,A01,083978,Johnson; Christine M.,13,0,30,17
1650037173965,COGS 107B,A01,083980,Staff,0,7,50,50
1650037179989,COGS 115,A01,083982,Staff,10,0,30,20
1650037186013,COGS 118B,A01,083367,Staff,0,15,40,40
1650037192037,COGS 172,A01,083984,Provenzano; Emily Kara,15,0,30,15
1650037198065,COGS 177,A00,083368,Staff,0,20,30,30
1650037204093,COGS 186,A01,083986,Staff,21,0,40,19
1650037210116,COGS 187A,A01,083988,Boyle; Mary E. T.,20,0,60,40
1650037216139,CSE 8A,A50,084003,Miranda; Gregory Joseph,0,14,15,15
1650037222165,CSE 11,A01,084005,Miranda; Gregory Joseph,0,22,55,55
1650037228188,CSE 20,A01,084007,Staff,0,5,20,20
1650037234212,CSE 21,A01,084009,Staff,0,31,50,50
1650037240246,CSE 30,A01,083370,Cao; Yingjun,0,65,40,40
1650037246278,CSE 100,A01,083372,Cao; Yingjun,0,46,40,40
1650037252306,CSE 101,A01,084011,Staff,0,54,40,40
1650037258342,CSE 141,A01,083374,Eldon; John,0,64,75,75
1650037264365,CSE 141L,A01,083376,Eldon; John,0,70,75,75
1650037270390,CSE 175,A01,084013,Kumar; Rakesh,22,0,25,3
1650037276411,CSE 190,A00,092508,Dubnov; Shlomo,20,0,20,0
1650037282435,ECE 5,A01,084049,Morris; Karcher William,13,0,20,7
1650037288463,ECE 100,A01,084051,Baghdadchi; Saharnaz,0,0,20,20
1650037288463,ECE 100,A02,091916,Baghdadchi; Saharnaz,13,0,20,7
1650037294486,ECE 101,A01,084053,Baghdadchi; Saharnaz,0,0,37,37
1650037294486,ECE 101,A02,084054,Baghdadchi; Saharnaz,30,0,37,7
1650037300517,ECE 107,A01,083390,Staff,26,0,40,14
1650037306544,ECE 148,A01,084056,Silberman; Jack,8,0,12,4
1650037312571,ECE 180,A00,083391,Abi Samra; Nicholas Camill,25,0,30,5
1650037312571,ECE 180,B00,083392,Abi Samra; Nicholas Camill,21,0,30,9
1650037318599,MATH 10B,A01,084110,Staff,0,0,30,30
1650037318599,MATH 10B,A02,084111,Staff,18,0,30,12
1650037318599,MATH 10B,A03,084112,Staff,24,0,30,6
1650037324622,MATH 10C,A01,083443,Staff,0,16,30,30
1650037324622,MATH 10C,A02,083444,Staff,0,15,30,30
1650037324622,MATH 10C,B01,084114,Staff,19,0,30,11
1650037324622,MATH 10C,B02,084115,Staff,25,0,30,5
1650037330654,MATH 18,A01,084117,Harel; Guershon,13,0,30,17
1650037330654,MATH 18,A02,084119,Harel; Guershon,27,0,30,3
1650037330654,MATH 18,A03,084120,Harel; Guershon,30,0,30,0
1650037330654,MATH 18,A04,084121,Harel; Guershon,29,0,30,1
1650037336682,MATH 20B,A01,084124,Um; Ko Woon,14,0,35,21
1650037336682,MATH 20B,B01,084126,Um; Ko Woon,24,0,35,11
1650037342711,MATH 20C,A01,083446,Hammock; Frances H,0,0,30,30
1650037342711,MATH 20C,A02,083447,Hammock; Frances H,16,0,30,14
1650037342711,MATH 20C,A03,083448,Hammock; Frances H,19,0,30,11
1650037342711,MATH 20C,A04,083449,Hammock; Frances H,20,0,30,10
1650037342711,MATH 20C,B01,083451,Hammock; Frances H,0,0,30,30
1650037342711,MATH 20C,B02,083452,Hammock; Frances H,18,0,30,12
1650037342711,MATH 20C,B03,083453,Hammock; Frances H,21,0,30,9
1650037342711,MATH 20C,B04,083454,Hammock; Frances H,23,0,30,7
1650037348735,MATH 20D,A01,084128,Staff,14,0,30,16
1650037348735,MATH 20D,A02,084129,Staff,29,0,30,1
1650037348735,MATH 20D,A03,084130,Staff,27,0,30,3
1650037348735,MATH 20D,B01,084133,Staff,3,0,30,27
1650037348735,MATH 20D,B02,084134,Staff,24,0,30,6
1650037348735,MATH 20D,B03,084135,Staff,28,0,30,2
1650037354762,MATH 20E,A01,084138,Staff,14,0,30,16
1650037354762,MATH 20E,A02,084139,Staff,6,0,30,24
1650037354762,MATH 20E,A03,084140,Staff,15,0,30,15
1650037354762,MATH 20E,A04,084141,Staff,20,0,30,10
1650037360789,MATH 102,A01,084143,Harel; Guershon,12,0,30,18
1650037360789,MATH 102,A02,084144,Harel; Guershon,19,0,30,11
1650037366816,MATH 103B,A01,083456,Staff,0,13,30,30
1650037366816,MATH 103B,A02,083457,Staff,0,14,30,30
1650037372853,MATH 109,A01,084146,Salehi Golsefidy; Alireza,17,0,30,13
1650037372853,MATH 109,A02,084147,Salehi Golsefidy; Alireza,15,0,30,15
1650037378889,MATH 120A,A01,085445,Eggers; John Dietrich,10,0,35,25
1650037378889,MATH 120A,A02,085446,Eggers; John Dietrich,27,0,35,8
1650037384913,MATH 142B,A01,084149,Verstraete; Jacques Allan,0,12,30,30
1650037384913,MATH 142B,A02,084150,Verstraete; Jacques Allan,0,12,30,30
1650037390952,MATH 170A,A01,083459,Nie; Jiawang,0,9,30,30
1650037390952,MATH 170A,A02,083460,Nie; Jiawang,0,8,30,30
1650037390952,MATH 170A,A03,083461,Nie; Jiawang,0,9,30,30
1650037396979,MATH 193B,A01,083463,Staff,1,0,30,29
1650037396979,MATH 193B,A02,083464,Staff,9,0,30,21
1650037396979,MATH 193B,A03,083465,Staff,18,0,30,12
1650037403036,COGS 2,A01,083966,Boyle; Mary E. T.,9,0,30,21
1650037409071,COGS 9,A01,083968,Staff,9,0,60,51
1650037415096,COGS 14B,A01,083970,Staff,9,0,50,41
1650037421134,COGS 17,A01,092679,Staff,50,0,75,25
1650037427171,COGS 100,A01,083972,Staff,0,15,60,60
1650037439232,COGS 101C,A01,083976,Staff,12,0,30,18
1650037445260,COGS 102A,A01,083978,Johnson; Christine M.,13,0,30,17
1650037451289,COGS 107B,A01,083980,Staff,0,7,50,50
1650037457317,COGS 115,A01,083982,Staff,10,0,30,20
1650037463344,COGS 118B,A01,083367,Staff,0,15,40,40
1650037469371,COGS 172,A01,083984,Provenzano; Emily Kara,15,0,30,15
1650037475394,COGS 177,A00,083368,Staff,0,20,30,30
1650037481424,COGS 186,A01,083986,Staff,21,0,40,19
1650037487446,COGS 187A,A01,083988,Boyle; Mary E. T.,20,0,60,40
1650037493471,CSE 8A,A50,084003,Miranda; Gregory Joseph,0,14,15,15
1650037499496,CSE 11,A01,084005,Miranda; Gregory Joseph,0,22,55,55
1650037505521,CSE 20,A01,084007,Staff,0,5,20,20
1650037511544,CSE 21,A01,084009,Staff,0,31,50,50
1650037517570,CSE 30,A01,083370,Cao; Yingjun,0,65,40,40
1650037523595,CSE 100,A01,083372,Cao; Yingjun,0,46,40,40
1650037529623,CSE 101,A01,084011,Staff,0,54,40,40
1650037535649,CSE 141,A01,083374,Eldon; John,0,64,75,75
1650037541676,CSE 141L,A01,083376,Eldon; John,0,70,75,75
1650037547712,CSE 175,A01,084013,Kumar; Rakesh,22,0,25,3
1650037553735,CSE 190,A00,092508,Dubnov; Shlomo,20,0,20,0
1650037559770,ECE 5,A01,084049,Morris; Karcher William,13,0,20,7
1650037565796,ECE 100,A01,084051,Baghdadchi; Saharnaz,0,0,20,20
1650037565796,ECE 100,A02,091916,Baghdadchi; Saharnaz,13,0,20,7
1650037571823,ECE 101,A01,084053,Baghdadchi; Saharnaz,0,0,37,37
1650037571823,ECE 101,A02,084054,Baghdadchi; Saharnaz,30,0,37,7
1650037577850,ECE 107,A01,083390,Staff,26,0,40,14
1650037583881,ECE 148,A01,084056,Silberman; Jack,8,0,12,4
1650037589908,ECE 180,A00,083391,Abi Samra; Nicholas Camill,25,0,30,5
1650037589908,ECE 180,B00,083392,Abi Samra; Nicholas Camill,21,0,30,9
1650037595934,MATH 10B,A01,084110,Staff,0,0,30,30
1650037595934,MATH 10B,A02,084111,Staff,18,0,30,12
1650037595934,MATH 10B,A03,084112,Staff,24,0,30,6
1650037601959,MATH 10C,A01,083443,Staff,0,16,30,30
1650037601959,MATH 10C,A02,083444,Staff,0,15,30,30
1650037601959,MATH 10C,B01,084114,Staff,19,0,30,11
1650037601959,MATH 10C,B02,084115,Staff,25,0,30,5
1650037607987,MATH 18,A01,084117,Harel; Guershon,13,0,30,17
1650037607987,MATH 18,A02,084119,Harel; Guershon,27,0,30,3
1650037607987,MATH 18,A03,084120,Harel; Guershon,30,0,30,0
1650037607987,MATH 18,A04,084121,Harel; Guershon,29,0,30,1
1650037614011,MATH 20B,A01,084124,Um; Ko Woon,14,0,35,21
1650037614011,MATH 20B,B01,084126,Um; Ko Woon,24,0,35,11
1650037620036,MATH 20C,A01,083446,Hammock; Frances H,0,0,30,30
1650037620036,MATH 20C,A02,083447,Hammock; Frances H,16,0,30,14
1650037620036,MATH 20C,A03,083448,Hammock; Frances H,19,0,30,11
1650037620036,MATH 20C,A04,083449,Hammock; Frances H,20,0,30,10
1650037620036,MATH 20C,B01,083451,Hammock; Frances H,0,0,30,30
1650037620036,MATH 20C,B02,083452,Hammock; Frances H,18,0,30,12
1650037620036,MATH 20C,B03,083453,Hammock; Frances H,21,0,30,9
1650037620036,MATH 20C,B04,083454,Hammock; Frances H,23,0,30,7
1650037626156,MATH 20D,A01,084128,Staff,14,0,30,16
1650037626156,MATH 20D,A02,084129,Staff,29,0,30,1
1650037626156,MATH 20D,A03,084130,Staff,27,0,30,3
1650037626156,MATH 20D,B01,084133,Staff,3,0,30,27
1650037626156,MATH 20D,B02,084134,Staff,23,0,30,7
1650037626156,MATH 20D,B03,084135,Staff,28,0,30,2
1650037632183,MATH 20E,A01,084138,Staff,14,0,30,16
1650037632183,MATH 20E,A02,084139,Staff,6,0,30,24
1650037632183,MATH 20E,A03,084140,Staff,15,0,30,15
1650037632183,MATH 20E,A04,084141,Staff,20,0,30,10
1650037638205,MATH 102,A01,084143,Harel; Guershon,12,0,30,18
1650037638205,MATH 102,A02,084144,Harel; Guershon,19,0,30,11
1650037644235,MATH 103B,A01,083456,Staff,0,13,30,30
1650037644235,MATH 103B,A02,083457,Staff,0,14,30,30
1650037650257,MATH 109,A01,084146,Salehi Golsefidy; Alireza,17,0,30,13
1650037650257,MATH 109,A02,084147,Salehi Golsefidy; Alireza,15,0,30,15
1650037656280,MATH 120A,A01,085445,Eggers; John Dietrich,10,0,35,25
1650037656280,MATH 120A,A02,085446,Eggers; John Dietrich,27,0,35,8
1650037662307,MATH 142B,A01,084149,Verstraete; Jacques Allan,0,12,30,30
1650037662307,MATH 142B,A02,084150,Verstraete; Jacques Allan,0,12,30,30
1650037668330,MATH 170A,A01,083459,Nie; Jiawang,0,9,30,30
1650037668330,MATH 170A,A02,083460,Nie; Jiawang,0,8,30,30
1650037668330,MATH 170A,A03,083461,Nie; Jiawang,0,9,30,30
1650037674360,MATH 193B,A01,083463,Staff,1,0,30,29
1650037674360,MATH 193B,A02,083464,Staff,9,0,30,21
1650037674360,MATH 193B,A03,083465,Staff,18,0,30,12
1650037680422,COGS 2,A01,083966,Boyle; Mary E. T.,9,0,30,21
1650037686447,COGS 9,A01,083968,Staff,9,0,60,51
1650037692470,COGS 14B,A01,083970,Staff,9,0,50,41
1650037698493,COGS 17,A01,092679,Staff,50,0,75,25
1650037704523,COGS 100,A01,083972,Staff,0,15,60,60
1650037716580,COGS 101C,A01,083976,Staff,12,0,30,18
1650037722606,COGS 102A,A01,083978,Johnson; Christine M.,13,0,30,17
1650037728635,COGS 107B,A01,083980,Staff,0,7,50,50
1650037734661,COGS 115,A01,083982,Staff,10,0,30,20
1650037740692,COGS 118B,A01,083367,Staff,0,15,40,40
1650037746716,COGS 172,A01,083984,Provenzano; Emily Kara,15,0,30,15
1650037752744,COGS 177,A00,083368,Staff,0,20,30,30
1650037758778,COGS 186,A01,083986,Staff,21,0,40,19
1650037764801,COGS 187A,A01,083988,Boyle; Mary E. T.,20,0,60,40
1650037770826,CSE 8A,A50,084003,Miranda; Gregory Joseph,0,14,15,15
1650037776853,CSE 11,A01,084005,Miranda; Gregory Joseph,0,22,55,55
1650037782877,CSE 20,A01,084007,Staff,0,5,20,20
1650037788901,CSE 21,A01,084009,Staff,0,31,50,50
1650037794927,CSE 30,A01,083370,Cao; Yingjun,0,65,40,40
1650037800951,CSE 100,A01,083372,Cao; Yingjun,0,46,40,40
1650037806975,CSE 101,A01,084011,Staff,0,54,40,40
1650037813003,CSE 141,A01,083374,Eldon; John,0,64,75,75
1650037819026,CSE 141L,A01,083376,Eldon; John,0,70,75,75
1650037825052,CSE 175,A01,084013,Kumar; Rakesh,22,0,25,3
1650037831076,CSE 190,A00,092508,Dubnov; Shlomo,20,0,20,0
1650037837099,ECE 5,A01,084049,Morris; Karcher William,13,0,20,7
1650037843123,ECE 100,A01,084051,Baghdadchi; Saharnaz,0,0,20,20
1650037843123,ECE 100,A02,091916,Baghdadchi; Saharnaz,13,0,20,7
1650037849149,ECE 101,A01,084053,Baghdadchi; Saharnaz,0,0,37,37
1650037849149,ECE 101,A02,084054,Baghdadchi; Saharnaz,30,0,37,7
1650037855180,ECE 107,A01,083390,Staff,26,0,40,14
1650037861207,ECE 148,A01,084056,Silberman; Jack,8,0,12,4
1650037867242,ECE 180,A00,083391,Abi Samra; Nicholas Camill,25,0,30,5
1650037867242,ECE 180,B00,083392,Abi Samra; Nicholas Camill,21,0,30,9
1650037873274,MATH 10B,A01,084110,Staff,0,0,30,30
1650037873274,MATH 10B,A02,084111,Staff,18,0,30,12
1650037873274,MATH 10B,A03,084112,Staff,24,0,30,6
1650037879301,MATH 10C,A01,083443,Staff,0,16,30,30
1650037879301,MATH 10C,A02,083444,Staff,0,15,30,30
1650037879301,MATH 10C,B01,084114,Staff,19,0,30,11
1650037879301,MATH 10C,B02,084115,Staff,25,0,30,5
1650037885324,MATH 18,A01,084117,Harel; Guershon,13,0,30,17
1650037885324,MATH 18,A02,084119,Harel; Guershon,27,0,30,3
1650037885324,MATH 18,A03,084120,Harel; Guershon,30,0,30,0
1650037885324,MATH 18,A04,084121,Harel; Guershon,29,0,30,1
1650037891348,MATH 20B,A01,084124,Um; Ko Woon,14,0,35,21
1650037891348,MATH 20B,B01,084126,Um; Ko Woon,24,0,35,11
1650037897379,MATH 20C,A01,083446,Hammock; Frances H,0,0,30,30
1650037897379,MATH 20C,A02,083447,Hammock; Frances H,16,0,30,14
1650037897379,MATH 20C,A03,083448,Hammock; Frances H,19,0,30,11
1650037897379,MATH 20C,A04,083449,Hammock; Frances H,20,0,30,10
1650037897379,MATH 20C,B01,083451,Hammock; Frances H,0,0,30,30
1650037897379,MATH 20C,B02,083452,Hammock; Frances H,18,0,30,12
1650037897379,MATH 20C,B03,083453,Hammock; Frances H,21,0,30,9
1650037897379,MATH 20C,B04,083454,Hammock; Frances H,23,0,30,7
1650037903422,MATH 20D,A01,084128,Staff,14,0,30,16
1650037903422,MATH 20D,A02,084129,Staff,29,0,30,1
1650037903422,MATH 20D,A03,084130,Staff,27,0,30,3
1650037903422,MATH 20D,B01,084133,Staff,3,0,30,27
1650037903422,MATH 20D,B02,084134,Staff,23,0,30,7
1650037903422,MATH 20D,B03,084135,Staff,28,0,30,2
1650037909447,MATH 20E,A01,084138,Staff,14,0,30,16
1650037909447,MATH 20E,A02,084139,Staff,6,0,30,24
1650037909447,MATH 20E,A03,084140,Staff,15,0,30,15
1650037909447,MATH 20E,A04,084141,Staff,20,0,30,10
1650037915485,MATH 102,A01,084143,Harel; Guershon,12,0,30,18
1650037915485,MATH 102,A02,084144,Harel; Guershon,19,0,30,11
1650037921507,MATH 103B,A01,083456,Staff,0,13,30,30
1650037921507,MATH 103B,A02,083457,Staff,0,14,30,30
1650037927529,MATH 109,A01,084146,Salehi Golsefidy; Alireza,17,0,30,13
1650037927529,MATH 109,A02,084147,Salehi Golsefidy; Alireza,15,0,30,15
1650037933552,MATH 120A,A01,085445,Eggers; John Dietrich,10,0,35,25
1650037933552,MATH 120A,A02,085446,Eggers; John Dietrich,27,0,35,8
1650037939578,MATH 142B,A01,084149,Verstraete; Jacques Allan,0,12,30,30
1650037939578,MATH 142B,A02,084150,Verstraete; Jacques Allan,0,12,30,30
1650037945600,MATH 170A,A01,083459,Nie; Jiawang,0,9,30,30
1650037945600,MATH 170A,A02,083460,Nie; Jiawang,0,8,30,30
1650037945600,MATH 170A,A03,083461,Nie; Jiawang,0,9,30,30
1650037951624,MATH 193B,A01,083463,Staff,1,0,30,29
1650037951624,MATH 193B,A02,083464,Staff,9,0,30,21
1650037951624,MATH 193B,A03,083465,Staff,18,0,30,12
1650037957687,COGS 2,A01,083966,Boyle; Mary E. T.,10,0,30,20
1650037963711,COGS 9,A01,083968,Staff,9,0,60,51
1650037969741,COGS 14B,A01,083970,Staff,9,0,50,41
1650037975764,COGS 17,A01,092679,Staff,50,0,75,25
1650037981793,COGS 100,A01,083972,Staff,0,16,60,60
1650037993849,COGS 101C,A01,083976,Staff,12,0,30,18
1650037999873,COGS 102A,A01,083978,Johnson; Christine M.,13,0,30,17
1650038005895,COGS 107B,A01,083980,Staff,0,7,50,50
1650038011923,COGS 115,A01,083982,Staff,10,0,30,20
1650038017949,COGS 118B,A01,083367,Staff,0,15,40,40
1650038023972,COGS 172,A01,083984,Provenzano; Emily Kara,15,0,30,15
1650038029999,COGS 177,A00,083368,Staff,0,20,30,30
1650038036021,COGS 186,A01,083986,Staff,21,0,40,19
1650038042046,COGS 187A,A01,083988,Boyle; Mary E. T.,20,0,60,40
1650038048073,CSE 8A,A50,084003,Miranda; Gregory Joseph,0,14,15,15
1650038054107,CSE 11,A01,084005,Miranda; Gregory Joseph,0,22,55,55
1650038060134,CSE 20,A01,084007,Staff,0,5,20,20
1650038066158,CSE 21,A01,084009,Staff,0,31,50,50
1650038072180,CSE 30,A01,083370,Cao; Yingjun,0,65,40,40
1650038078207,CSE 100,A01,083372,Cao; Yingjun,0,46,40,40
1650038084232,CSE 101,A01,084011,Staff,0,54,40,40
1650038090256,CSE 141,A01,083374,Eldon; John,0,64,75,75
1650038096283,CSE 141L,A01,083376,Eldon; John,0,70,75,75
1650038102321,CSE 175,A01,084013,Kumar; Rakesh,22,0,25,3
1650038108345,CSE 190,A00,092508,Dubnov; Shlomo,20,0,20,0
1650038114371,ECE 5,A01,084049,Morris; Karcher William,13,0,20,7
1650038120394,ECE 100,A01,084051,Baghdadchi; Saharnaz,0,0,20,20
1650038120394,ECE 100,A02,091916,Baghdadchi; Saharnaz,13,0,20,7
1650038126418,ECE 101,A01,084053,Baghdadchi; Saharnaz,0,0,37,37
1650038126418,ECE 101,A02,084054,Baghdadchi; Saharnaz,30,0,37,7
1650038132445,ECE 107,A01,083390,Staff,26,0,40,14
1650038138473,ECE 148,A01,084056,Silberman; Jack,8,0,12,4
1650038144496,ECE 180,A00,083391,Abi Samra; Nicholas Camill,25,0,30,5
1650038144496,ECE 180,B00,083392,Abi Samra; Nicholas Camill,21,0,30,9
1650038150525,MATH 10B,A01,084110,Staff,0,0,30,30
1650038150525,MATH 10B,A02,084111,Staff,18,0,30,12
1650038150525,MATH 10B,A03,084112,Staff,24,0,30,6
1650038156548,MATH 10C,A01,083443,Staff,0,16,30,30
1650038156548,MATH 10C,A02,083444,Staff,0,16,30,30
1650038156548,MATH 10C,B01,084114,Staff,19,0,30,11
1650038156548,MATH 10C,B02,084115,Staff,25,0,30,5
1650038162576,MATH 18,A01,084117,Harel; Guershon,13,0,30,17
1650038162576,MATH 18,A02,084119,Harel; Guershon,27,0,30,3
1650038162576,MATH 18,A03,084120,Harel; Guershon,30,0,30,0
1650038162576,MATH 18,A04,084121,Harel; Guershon,29,0,30,1
1650038168604,MATH 20B,A01,084124,Um; Ko Woon,14,0,35,21
1650038168604,MATH 20B,B01,084126,Um; Ko Woon,24,0,35,11
1650038174632,MATH 20C,A01,083446,Hammock; Frances H,0,0,30,30
1650038174632,MATH 20C,A02,083447,Hammock; Frances H,16,0,30,14
1650038174632,MATH 20C,A03,083448,Hammock; Frances H,19,0,30,11
1650038174632,MATH 20C,A04,083449,Hammock; Frances H,20,0,30,10
1650038174632,MATH 20C,B01,083451,Hammock; Frances H,0,0,30,30
1650038174632,MATH 20C,B02,083452,Hammock; Frances H,18,0,30,12
1650038174632,MATH 20C,B03,083453,Hammock; Frances H,21,0,30,9
1650038174632,MATH 20C,B04,083454,Hammock; Frances H,23,0,30,7
1650038180656,MATH 20D,A01,084128,Staff,14,0,30,16
1650038180656,MATH 20D,A02,084129,Staff,29,0,30,1
1650038180656,MATH 20D,A03,084130,Staff,27,0,30,3
1650038180656,MATH 20D,B01,084133,Staff,3,0,30,27
1650038180656,MATH 20D,B02,084134,Staff,23,0,30,7
1650038180656,MATH 20D,B03,084135,Staff,28,0,30,2
1650038186686,MATH 20E,A01,084138,Staff,14,0,30,16
1650038186686,MATH 20E,A02,084139,Staff,6,0,30,24
1650038186686,MATH 20E,A03,084140,Staff,15,0,30,15
1650038186686,MATH 20E,A04,084141,Staff,20,0,30,10
1650038192713,MATH 102,A01,084143,Harel; Guershon,12,0,30,18
1650038192713,MATH 102,A02,084144,Harel; Guershon,19,0,30,11
1650038198740,MATH 103B,A01,083456,Staff,0,13,30,30
1650038198740,MATH 103B,A02,083457,Staff,0,14,30,30
1650038204765,MATH 109,A01,084146,Salehi Golsefidy; Alireza,17,0,30,13
1650038204765,MATH 109,A02,084147,Salehi Golsefidy; Alireza,15,0,30,15
1650038210791,MATH 120A,A01,085445,Eggers; John Dietrich,10,0,35,25
1650038210791,MATH 120A,A02,085446,Eggers; John Dietrich,27,0,35,8
1650038216815,MATH 142B,A01,084149,Verstraete; Jacques Allan,0,12,30,30
1650038216815,MATH 142B,A02,084150,Verstraete; Jacques Allan,0,12,30,30
1650038222915,MATH 170A,A01,083459,Nie; Jiawang,0,9,30,30
1650038222915,MATH 170A,A02,083460,Nie; Jiawang,0,8,30,30
1650038222915,MATH 170A,A03,083461,Nie; Jiawang,0,9,30,30
1650038228943,MATH 193B,A01,083463,Staff,1,0,30,29
1650038228943,MATH 193B,A02,083464,Staff,9,0,30,21
1650038228943,MATH 193B,A03,083465,Staff,18,0,30,12
1650038235016,COGS 2,A01,083966,Boyle; Mary E. T.,10,0,30,20
1650038241037,COGS 9,A01,083968,Staff,9,0,60,51
1650038247063,COGS 14B,A01,083970,Staff,9,0,50,41
1650038253087,COGS 17,A01,092679,Staff,50,0,75,25
1650038259116,COGS 100,A01,083972,Staff,0,16,60,60
1650038271166,COGS 101C,A01,083976,Staff,12,0,30,18
1650038277194,COGS 102A,A01,083978,Johnson; Christine M.,13,0,30,17
1650038283218,COGS 107B,A01,083980,Staff,0,7,50,50
1650038289249,COGS 115,A01,083982,Staff,10,0,30,20
1650038295280,COGS 118B,A01,083367,Staff,0,15,40,40
1650038301307,COGS 172,A01,083984,Provenzano; Emily Kara,15,0,30,15
1650038307337,COGS 177,A00,083368,Staff,0,20,30,30
1650038313358,COGS 186,A01,083986,Staff,21,0,40,19
1650038319384,COGS 187A,A01,083988,Boyle; Mary E. T.,20,0,60,40
1650038325412,CSE 8A,A50,084003,Miranda; Gregory Joseph,0,14,15,15
1650038331434,CSE 11,A01,084005,Miranda; Gregory Joseph,0,22,55,55
1650038337465,CSE 20,A01,084007,Staff,0,5,20,20
1650038343491,CSE 21,A01,084009,Staff,0,31,50,50
1650038349515,CSE 30,A01,083370,Cao; Yingjun,0,65,40,40
1650038355556,CSE 100,A01,083372,Cao; Yingjun,0,46,40,40
1650038361591,CSE 101,A01,084011,Staff,0,54,40,40
1650038367614,CSE 141,A01,083374,Eldon; John,0,64,75,75
1650038373641,CSE 141L,A01,083376,Eldon; John,0,70,75,75
1650038379664,CSE 175,A01,084013,Kumar; Rakesh,22,0,25,3
1650038385695,CSE 190,A00,092508,Dubnov; Shlomo,20,0,20,0
1650038391721,ECE 5,A01,084049,Morris; Karcher William,13,0,20,7
1650038397755,ECE 100,A01,084051,Baghdadchi; Saharnaz,0,0,20,20
1650038397755,ECE 100,A02,091916,Baghdadchi; Saharnaz,13,0,20,7
1650038403788,ECE 101,A01,084053,Baghdadchi; Saharnaz,0,0,37,37
1650038403788,ECE 101,A02,084054,Baghdadchi; Saharnaz,30,0,37,7
1650038409824,ECE 107,A01,083390,Staff,26,0,40,14
1650038415846,ECE 148,A01,084056,Silberman; Jack,8,0,12,4
1650038421870,ECE 180,A00,083391,Abi Samra; Nicholas Camill,25,0,30,5
1650038421870,ECE 180,B00,083392,Abi Samra; Nicholas Camill,21,0,30,9
1650038427892,MATH 10B,A01,084110,Staff,0,0,30,30
1650038427892,MATH 10B,A02,084111,Staff,18,0,30,12
1650038427892,MATH 10B,A03,084112,Staff,24,0,30,6
1650038433927,MATH 10C,A01,083443,Staff,0,17,30,30
1650038433927,MATH 10C,A02,083444,Staff,0,16,30,30
1650038433927,MATH 10C,B01,084114,Staff,19,0,30,11
1650038433927,MATH 10C,B02,084115,Staff,25,0,30,5
1650038439955,MATH 18,A01,084117,Harel; Guershon,13,0,30,17
1650038439955,MATH 18,A02,084119,Harel; Guershon,27,0,30,3
1650038439955,MATH 18,A03,084120,Harel; Guershon,30,0,30,0
1650038439955,MATH 18,A04,084121,Harel; Guershon,29,0,30,1
1650038445979,MATH 20B,A01,084124,Um; Ko Woon,14,0,35,21
1650038445979,MATH 20B,B01,084126,Um; Ko Woon,24,0,35,11
1650038452004,MATH 20C,A01,083446,Hammock; Frances H,0,0,30,30
1650038452004,MATH 20C,A02,083447,Hammock; Frances H,16,0,30,14
1650038452004,MATH 20C,A03,083448,Hammock; Frances H,19,0,30,11
1650038452004,MATH 20C,A04,083449,Hammock; Frances H,20,0,30,10
1650038452004,MATH 20C,B01,083451,Hammock; Frances H,0,0,30,30
1650038452004,MATH 20C,B02,083452,Hammock; Frances H,18,0,30,12
1650038452004,MATH 20C,B03,083453,Hammock; Frances H,21,0,30,9
1650038452004,MATH 20C,B04,083454,Hammock; Frances H,23,0,30,7
1650038458025,MATH 20D,A01,084128,Staff,14,0,30,16
1650038458025,MATH 20D,A02,084129,Staff,29,0,30,1
1650038458025,MATH 20D,A03,084130,Staff,27,0,30,3
1650038458025,MATH 20D,B01,084133,Staff,3,0,30,27
1650038458025,MATH 20D,B02,084134,Staff,23,0,30,7
1650038458025,MATH 20D,B03,084135,Staff,28,0,30,2
1650038464056,MATH 20E,A01,084138,Staff,14,0,30,16
1650038464056,MATH 20E,A02,084139,Staff,6,0,30,24
1650038464056,MATH 20E,A03,084140,Staff,15,0,30,15
1650038464056,MATH 20E,A04,084141,Staff,20,0,30,10
1650038470083,MATH 102,A01,084143,Harel; Guershon,12,0,30,18
1650038470083,MATH 102,A02,084144,Harel; Guershon,19,0,30,11
1650038476107,MATH 103B,A01,083456,Staff,0,13,30,30
1650038476107,MATH 103B,A02,083457,Staff,0,14,30,30
1650038482137,MATH 109,A01,084146,Salehi Golsefidy; Alireza,17,0,30,13
1650038482137,MATH 109,A02,084147,Salehi Golsefidy; Alireza,15,0,30,15
1650038488161,MATH 120A,A01,085445,Eggers; John Dietrich,10,0,35,25
1650038488161,MATH 120A,A02,085446,Eggers; John Dietrich,27,0,35,8
1650038494186,MATH 142B,A01,084149,Verstraete; Jacques Allan,0,12,30,30
1650038494186,MATH 142B,A02,084150,Verstraete; Jacques Allan,0,12,30,30
1650038500214,MATH 170A,A01,083459,Nie; Jiawang,0,9,30,30
1650038500214,MATH 170A,A02,083460,Nie; Jiawang,0,8,30,30
1650038500214,MATH 170A,A03,083461,Nie; Jiawang,0,9,30,30
1650038506240,MATH 193B,A01,083463,Staff,1,0,30,29
1650038506240,MATH 193B,A02,083464,Staff,9,0,30,21
1650038506240,MATH 193B,A03,083465,Staff,18,0,30,12
1650038512312,COGS 2,A01,083966,Boyle; Mary E. T.,10,0,30,20
1650038518343,COGS 9,A01,083968,Staff,9,0,60,51
1650038524373,COGS 14B,A01,083970,Staff,9,0,50,41
1650038530405,COGS 17,A01,092679,Staff,50,0,75,25
1650038536431,COGS 100,A01,083972,Staff,0,16,60,60
1650038548498,COGS 101C,A01,083976,Staff,12,0,30,18
1650038554526,COGS 102A,A01,083978,Johnson; Christine M.,13,0,30,17
1650038560557,COGS 107B,A01,083980,Staff,0,7,50,50
1650038566580,COGS 115,A01,083982,Staff,10,0,30,20
1650038572612,COGS 118B,A01,083367,Staff,0,15,40,40
1650038578640,COGS 172,A01,083984,Provenzano; Emily Kara,15,0,30,15
1650038584666,COGS 177,A00,083368,Staff,0,20,30,30
1650038590689,COGS 186,A01,083986,Staff,21,0,40,19
1650038596712,COGS 187A,A01,083988,Boyle; Mary E. T.,20,0,60,40
1650038602740,CSE 8A,A50,084003,Miranda; Gregory Joseph,0,14,15,15
1650038608764,CSE 11,A01,084005,Miranda; Gregory Joseph,0,22,55,55
1650038614790,CSE 20,A01,084007,Staff,0,5,20,20
1650038620816,CSE 21,A01,084009,Staff,0,31,50,50
1650038626847,CSE 30,A01,083370,Cao; Yingjun,0,65,40,40
1650038632874,CSE 100,A01,083372,Cao; Yingjun,0,46,40,40
1650038638905,CSE 101,A01,084011,Staff,0,54,40,40
1650038644933,CSE 141,A01,083374,Eldon; John,0,64,75,75
1650038650965,CSE 141L,A01,083376,Eldon; John,0,70,75,75
1650038656989,CSE 175,A01,084013,Kumar; Rakesh,22,0,25,3
1650038663014,CSE 190,A00,092508,Dubnov; Shlomo,20,0,20,0
1650038669036,ECE 5,A01,084049,Morris; Karcher William,13,0,20,7
1650038675061,ECE 100,A01,084051,Baghdadchi; Saharnaz,0,0,20,20
1650038675061,ECE 100,A02,091916,Baghdadchi; Saharnaz,13,0,20,7
1650038681084,ECE 101,A01,084053,Baghdadchi; Saharnaz,0,0,37,37
1650038681084,ECE 101,A02,084054,Baghdadchi; Saharnaz,30,0,37,7
1650038687111,ECE 107,A01,083390,Staff,26,0,40,14
1650038693137,ECE 148,A01,084056,Silberman; Jack,8,0,12,4
1650038699159,ECE 180,A00,083391,Abi Samra; Nicholas Camill,25,0,30,5
1650038699159,ECE 180,B00,083392,Abi Samra; Nicholas Camill,21,0,30,9
1650038705187,MATH 10B,A01,084110,Staff,0,0,30,30
1650038705187,MATH 10B,A02,084111,Staff,18,0,30,12
1650038705187,MATH 10B,A03,084112,Staff,24,0,30,6
1650038711220,MATH 10C,A01,083443,Staff,0,17,30,30
1650038711220,MATH 10C,A02,083444,Staff,0,16,30,30
1650038711220,MATH 10C,B01,084114,Staff,19,0,30,11
1650038711220,MATH 10C,B02,084115,Staff,25,0,30,5
1650038717242,MATH 18,A01,084117,Harel; Guershon,13,0,30,17
1650038717242,MATH 18,A02,084119,Harel; Guershon,27,0,30,3
1650038717242,MATH 18,A03,084120,Harel; Guershon,30,0,30,0
1650038717242,MATH 18,A04,084121,Harel; Guershon,29,0,30,1
1650038723265,MATH 20B,A01,084124,Um; Ko Woon,14,0,35,21
1650038723265,MATH 20B,B01,084126,Um; Ko Woon,24,0,35,11
1650038729295,MATH 20C,A01,083446,Hammock; Frances H,0,0,30,30
1650038729295,MATH 20C,A02,083447,Hammock; Frances H,16,0,30,14
1650038729295,MATH 20C,A03,083448,Hammock; Frances H,19,0,30,11
1650038729295,MATH 20C,A04,083449,Hammock; Frances H,20,0,30,10
1650038729295,MATH 20C,B01,083451,Hammock; Frances H,0,0,30,30
1650038729295,MATH 20C,B02,083452,Hammock; Frances H,18,0,30,12
1650038729295,MATH 20C,B03,083453,Hammock; Frances H,21,0,30,9
1650038729295,MATH 20C,B04,083454,Hammock; Frances H,23,0,30,7
1650038735320,MATH 20D,A01,084128,Staff,14,0,30,16
1650038735320,MATH 20D,A02,084129,Staff,29,0,30,1
1650038735320,MATH 20D,A03,084130,Staff,27,0,30,3
1650038735320,MATH 20D,B01,084133,Staff,3,0,30,27
1650038735320,MATH 20D,B02,084134,Staff,23,0,30,7
1650038735320,MATH 20D,B03,084135,Staff,28,0,30,2
1650038741348,MATH 20E,A01,084138,Staff,14,0,30,16
1650038741348,MATH 20E,A02,084139,Staff,6,0,30,24
1650038741348,MATH 20E,A03,084140,Staff,15,0,30,15
1650038741348,MATH 20E,A04,084141,Staff,20,0,30,10
1650038747377,MATH 102,A01,084143,Harel; Guershon,12,0,30,18
1650038747377,MATH 102,A02,084144,Harel; Guershon,19,0,30,11
1650038753403,MATH 103B,A01,083456,Staff,0,13,30,30
1650038753403,MATH 103B,A02,083457,Staff,0,14,30,30
1650038759430,MATH 109,A01,084146,Salehi Golsefidy; Alireza,17,0,30,13
1650038759430,MATH 109,A02,084147,Salehi Golsefidy; Alireza,15,0,30,15
1650038765453,MATH 120A,A01,085445,Eggers; John Dietrich,10,0,35,25
1650038765453,MATH 120A,A02,085446,Eggers; John Dietrich,27,0,35,8
1650038771477,MATH 142B,A01,084149,Verstraete; Jacques Allan,0,12,30,30
1650038771477,MATH 142B,A02,084150,Verstraete; Jacques Allan,0,12,30,30
1650038777503,MATH 170A,A01,083459,Nie; Jiawang,0,9,30,30
1650038777503,MATH 170A,A02,083460,Nie; Jiawang,0,8,30,30
1650038777503,MATH 170A,A03,083461,Nie; Jiawang,0,9,30,30
1650038783538,MATH 193B,A01,083463,Staff,1,0,30,29
1650038783538,MATH 193B,A02,083464,Staff,9,0,30,21
1650038783538,MATH 193B,A03,083465,Staff,18,0,30,12
1650038789602,COGS 2,A01,083966,Boyle; Mary E. T.,10,0,30,20
1650038795629,COGS 9,A01,083968,Staff,9,0,60,51
1650038801652,COGS 14B,A01,083970,Staff,9,0,50,41
1650038807679,COGS 17,A01,092679,Staff,50,0,75,25
1650038813795,COGS 100,A01,083972,Staff,0,16,60,60
1650038825848,COGS 101C,A01,083976,Staff,12,0,30,18
1650038831871,COGS 102A,A01,083978,Johnson; Christine M.,13,0,30,17
1650038837895,COGS 107B,A01,083980,Staff,0,7,50,50
1650038843921,COGS 115,A01,083982,Staff,10,0,30,20
1650038849947,COGS 118B,A01,083367,Staff,0,15,40,40
1650038855975,COGS 172,A01,083984,Provenzano; Emily Kara,15,0,30,15
1650038862014,COGS 177,A00,083368,Staff,0,20,30,30
1650038868036,COGS 186,A01,083986,Staff,21,0,40,19
1650038874060,COGS 187A,A01,083988,Boyle; Mary E. T.,20,0,60,40
1650038880088,CSE 8A,A50,084003,Miranda; Gregory Joseph,0,14,15,15
1650038886129,CSE 11,A01,084005,Miranda; Gregory Joseph,0,22,55,55
1650038892157,CSE 20,A01,084007,Staff,0,5,20,20
1650038898182,CSE 21,A01,084009,Staff,0,31,50,50
1650038904204,CSE 30,A01,083370,Cao; Yingjun,0,65,40,40
1650038910228,CSE 100,A01,083372,Cao; Yingjun,0,46,40,40
1650038916254,CSE 101,A01,084011,Staff,0,54,40,40
1650038922280,CSE 141,A01,083374,Eldon; John,0,64,75,75
1650038928307,CSE 141L,A01,083376,Eldon; John,0,70,75,75
1650038934335,CSE 175,A01,084013,Kumar; Rakesh,22,0,25,3
1650038940357,CSE 190,A00,092508,Dubnov; Shlomo,20,0,20,0
1650038946380,ECE 5,A01,084049,Morris; Karcher William,13,0,20,7
1650038952403,ECE 100,A01,084051,Baghdadchi; Saharnaz,0,0,20,20
1650038952403,ECE 100,A02,091916,Baghdadchi; Saharnaz,13,0,20,7
1650038958436,ECE 101,A01,084053,Baghdadchi; Saharnaz,0,0,37,37
1650038958436,ECE 101,A02,084054,Baghdadchi; Saharnaz,30,0,37,7
1650038964464,ECE 107,A01,083390,Staff,26,0,40,14
1650038970488,ECE 148,A01,084056,Silberman; Jack,8,0,12,4
1650038976511,ECE 180,A00,083391,Abi Samra; Nicholas Camill,25,0,30,5
1650038976511,ECE 180,B00,083392,Abi Samra; Nicholas Camill,21,0,30,9
1650038982540,MATH 10B,A01,084110,Staff,0,0,30,30
1650038982540,MATH 10B,A02,084111,Staff,18,0,30,12
1650038982540,MATH 10B,A03,084112,Staff,24,0,30,6
1650038988563,MATH 10C,A01,083443,Staff,0,17,30,30
1650038988563,MATH 10C,A02,083444,Staff,0,16,30,30
1650038988563,MATH 10C,B01,084114,Staff,19,0,30,11
1650038988563,MATH 10C,B02,084115,Staff,25,0,30,5
1650038994597,MATH 18,A01,084117,Harel; Guershon,13,0,30,17
1650038994597,MATH 18,A02,084119,Harel; Guershon,27,0,30,3
1650038994597,MATH 18,A03,084120,Harel; Guershon,30,0,30,0
1650038994597,MATH 18,A04,084121,Harel; Guershon,29,0,30,1
1650039000622,MATH 20B,A01,084124,Um; Ko Woon,14,0,35,21
1650039000622,MATH 20B,B01,084126,Um; Ko Woon,24,0,35,11
1650039006659,MATH 20C,A01,083446,Hammock; Frances H,0,0,30,30
1650039006659,MATH 20C,A02,083447,Hammock; Frances H,16,0,30,14
1650039006659,MATH 20C,A03,083448,Hammock; Frances H,19,0,30,11
1650039006659,MATH 20C,A04,083449,Hammock; Frances H,20,0,30,10
1650039006659,MATH 20C,B01,083451,Hammock; Frances H,0,0,30,30
1650039006659,MATH 20C,B02,083452,Hammock; Frances H,18,0,30,12
1650039006659,MATH 20C,B03,083453,Hammock; Frances H,21,0,30,9
1650039006659,MATH 20C,B04,083454,Hammock; Frances H,23,0,30,7
1650039012683,MATH 20D,A01,084128,Staff,14,0,30,16
1650039012683,MATH 20D,A02,084129,Staff,29,0,30,1
1650039012683,MATH 20D,A03,084130,Staff,27,0,30,3
1650039012683,MATH 20D,B01,084133,Staff,3,0,30,27
1650039012683,MATH 20D,B02,084134,Staff,23,0,30,7
1650039012683,MATH 20D,B03,084135,Staff,28,0,30,2
1650039018708,MATH 20E,A01,084138,Staff,14,0,30,16
1650039018708,MATH 20E,A02,084139,Staff,6,0,30,24
1650039018708,MATH 20E,A03,084140,Staff,15,0,30,15
1650039018708,MATH 20E,A04,084141,Staff,20,0,30,10
1650039024734,MATH 102,A01,084143,Harel; Guershon,12,0,30,18
1650039024734,MATH 102,A02,084144,Harel; Guershon,19,0,30,11
1650039030769,MATH 103B,A01,083456,Staff,0,13,30,30
1650039030769,MATH 103B,A02,083457,Staff,0,14,30,30
1650039036792,MATH 109,A01,084146,Salehi Golsefidy; Alireza,17,0,30,13
1650039036792,MATH 109,A02,084147,Salehi Golsefidy; Alireza,15,0,30,15
1650039042816,MATH 120A,A01,085445,Eggers; John Dietrich,10,0,35,25
1650039042816,MATH 120A,A02,085446,Eggers; John Dietrich,27,0,35,8
1650039048843,MATH 142B,A01,084149,Verstraete; Jacques Allan,0,12,30,30
1650039048843,MATH 142B,A02,084150,Verstraete; Jacques Allan,0,12,30,30
1650039054876,MATH 170A,A01,083459,Nie; Jiawang,0,9,30,30
1650039054876,MATH 170A,A02,083460,Nie; Jiawang,0,8,30,30
1650039054876,MATH 170A,A03,083461,Nie; Jiawang,0,9,30,30
1650039060903,MATH 193B,A01,083463,Staff,1,0,30,29
1650039060903,MATH 193B,A02,083464,Staff,9,0,30,21
1650039060903,MATH 193B,A03,083465,Staff,18,0,30,12
1650039066957,COGS 2,A01,083966,Boyle; Mary E. T.,10,0,30,20
1650039072983,COGS 9,A01,083968,Staff,9,0,60,51
1650039079007,COGS 14B,A01,083970,Staff,9,0,50,41
1650039085038,COGS 17,A01,092679,Staff,50,0,75,25
1650039091062,COGS 100,A01,083972,Staff,0,16,60,60
1650039103110,COGS 101C,A01,083976,Staff,12,0,30,18
1650039109137,COGS 102A,A01,083978,Johnson; Christine M.,13,0,30,17
1650039115169,COGS 107B,A01,083980,Staff,0,7,50,50
1650039121199,COGS 115,A01,083982,Staff,10,0,30,20
1650039127230,COGS 118B,A01,083367,Staff,0,15,40,40
1650039133257,COGS 172,A01,083984,Provenzano; Emily Kara,15,0,30,15
1650039139279,COGS 177,A00,083368,Staff,0,20,30,30
1650039145301,COGS 186,A01,083986,Staff,21,0,40,19
1650039151328,COGS 187A,A01,083988,Boyle; Mary E. T.,20,0,60,40
1650039157355,CSE 8A,A50,084003,Miranda; Gregory Joseph,0,14,15,15
1650039163378,CSE 11,A01,084005,Miranda; Gregory Joseph,0,22,55,55
1650039169408,CSE 20,A01,084007,Staff,0,5,20,20
1650039175430,CSE 21,A01,084009,Staff,0,31,50,50
1650039181462,CSE 30,A01,083370,Cao; Yingjun,0,65,40,40
1650039187492,CSE 100,A01,083372,Cao; Yingjun,0,46,40,40
1650039193524,CSE 101,A01,084011,Staff,0,54,40,40
1650039199548,CSE 141,A01,083374,Eldon; John,0,64,75,75
1650039205574,CSE 141L,A01,083376,Eldon; John,0,70,75,75
1650039211603,CSE 175,A01,084013,Kumar; Rakesh,22,0,25,3
1650039217626,CSE 190,A00,092508,Dubnov; Shlomo,20,0,20,0
1650039223649,ECE 5,A01,084049,Morris; Karcher William,13,0,20,7
1650039229676,ECE 100,A01,084051,Baghdadchi; Saharnaz,0,0,20,20
1650039229676,ECE 100,A02,091916,Baghdadchi; Saharnaz,13,0,20,7
1650039235697,ECE 101,A01,084053,Baghdadchi; Saharnaz,0,0,37,37
1650039235697,ECE 101,A02,084054,Baghdadchi; Saharnaz,30,0,37,7
1650039241720,ECE 107,A01,083390,Staff,26,0,40,14
1650039247744,ECE 148,A01,084056,Silberman; Jack,8,0,12,4
1650039253786,ECE 180,A00,083391,Abi Samra; Nicholas Camill,25,0,30,5
1650039253786,ECE 180,B00,083392,Abi Samra; Nicholas Camill,21,0,30,9
1650039259811,MATH 10B,A01,084110,Staff,0,0,30,30
1650039259811,MATH 10B,A02,084111,Staff,18,0,30,12
1650039259811,MATH 10B,A03,084112,Staff,24,0,30,6
1650039265848,MATH 10C,A01,083443,Staff,0,17,30,30
1650039265848,MATH 10C,A02,083444,Staff,0,16,30,30
1650039265848,MATH 10C,B01,084114,Staff,19,0,30,11
1650039265848,MATH 10C,B02,084115,Staff,25,0,30,5
1650039271873,MATH 18,A01,084117,Harel; Guershon,13,0,30,17
1650039271873,MATH 18,A02,084119,Harel; Guershon,27,0,30,3
1650039271873,MATH 18,A03,084120,Harel; Guershon,30,0,30,0
1650039271873,MATH 18,A04,084121,Harel; Guershon,29,0,30,1
1650039277898,MATH 20B,A01,084124,Um; Ko Woon,14,0,35,21
1650039277898,MATH 20B,B01,084126,Um; Ko Woon,24,0,35,11
1650039283940,MATH 20C,A01,083446,Hammock; Frances H,0,0,30,30
1650039283940,MATH 20C,A02,083447,Hammock; Frances H,16,0,30,14
1650039283940,MATH 20C,A03,083448,Hammock; Frances H,19,0,30,11
1650039283940,MATH 20C,A04,083449,Hammock; Frances H,20,0,30,10
1650039283940,MATH 20C,B01,083451,Hammock; Frances H,0,0,30,30
1650039283940,MATH 20C,B02,083452,Hammock; Frances H,18,0,30,12
1650039283940,MATH 20C,B03,083453,Hammock; Frances H,21,0,30,9
1650039283940,MATH 20C,B04,083454,Hammock; Frances H,23,0,30,7
1650039289971,MATH 20D,A01,084128,Staff,14,0,30,16
1650039289971,MATH 20D,A02,084129,Staff,29,0,30,1
1650039289971,MATH 20D,A03,084130,Staff,27,0,30,3
1650039289971,MATH 20D,B01,084133,Staff,3,0,30,27
1650039289971,MATH 20D,B02,084134,Staff,23,0,30,7
1650039289971,MATH 20D,B03,084135,Staff,28,0,30,2
1650039295995,MATH 20E,A01,084138,Staff,14,0,30,16
1650039295995,MATH 20E,A02,084139,Staff,6,0,30,24
1650039295995,MATH 20E,A03,084140,Staff,15,0,30,15
1650039295995,MATH 20E,A04,084141,Staff,20,0,30,10
1650039302017,MATH 102,A01,084143,Harel; Guershon,12,0,30,18
1650039302017,MATH 102,A02,084144,Harel; Guershon,19,0,30,11
1650039308054,MATH 103B,A01,083456,Staff,0,13,30,30
1650039308054,MATH 103B,A02,083457,Staff,0,14,30,30
1650039314078,MATH 109,A01,084146,Salehi Golsefidy; Alireza,17,0,30,13
1650039314078,MATH 109,A02,084147,Salehi Golsefidy; Alireza,15,0,30,15
1650039320116,MATH 120A,A01,085445,Eggers; John Dietrich,10,0,35,25
1650039320116,MATH 120A,A02,085446,Eggers; John Dietrich,27,0,35,8
1650039326143,MATH 142B,A01,084149,Verstraete; Jacques Allan,0,12,30,30
1650039326143,MATH 142B,A02,084150,Verstraete; Jacques Allan,0,12,30,30
1650039332170,MATH 170A,A01,083459,Nie; Jiawang,0,9,30,30
1650039332170,MATH 170A,A02,083460,Nie; Jiawang,0,8,30,30
1650039332170,MATH 170A,A03,083461,Nie; Jiawang,0,9,30,30
1650039338194,MATH 193B,A01,083463,Staff,1,0,30,29
1650039338194,MATH 193B,A02,083464,Staff,9,0,30,21
1650039338194,MATH 193B,A03,083465,Staff,18,0,30,12
1650039344247,COGS 2,A01,083966,Boyle; Mary E. T.,10,0,30,20
1650039350274,COGS 9,A01,083968,Staff,9,0,60,51
1650039356301,COGS 14B,A01,083970,Staff,9,0,50,41
1650039362325,COGS 17,A01,092679,Staff,50,0,75,25
1650039368352,COGS 100,A01,083972,Staff,0,16,60,60
1650039380403,COGS 101C,A01,083976,Staff,12,0,30,18
1650039386431,COGS 102A,A01,083978,Johnson; Christine M.,13,0,30,17
1650039392462,COGS 107B,A01,083980,Staff,0,7,50,50
1650039398486,COGS 115,A01,083982,Staff,10,0,30,20
1650039404513,COGS 118B,A01,083367,Staff,0,15,40,40
1650039410646,COGS 172,A01,083984,Provenzano; Emily Kara,15,0,30,15
1650039424647,COGS 177,A00,083368,Staff,0,20,30,30
1650039430669,COGS 186,A01,083986,Staff,21,0,40,19
1650039436702,COGS 187A,A01,083988,Boyle; Mary E. T.,20,0,60,40
1650039442725,CSE 8A,A50,084003,Miranda; Gregory Joseph,0,14,15,15
1650039448748,CSE 11,A01,084005,Miranda; Gregory Joseph,0,22,55,55
1650039454781,CSE 20,A01,084007,Staff,0,5,20,20
1650039460805,CSE 21,A01,084009,Staff,0,31,50,50
1650039466838,CSE 30,A01,083370,Cao; Yingjun,0,65,40,40
1650039472861,CSE 100,A01,083372,Cao; Yingjun,0,46,40,40
1650039478884,CSE 101,A01,084011,Staff,0,54,40,40
1650039484912,CSE 141,A01,083374,Eldon; John,0,64,75,75
1650039490939,CSE 141L,A01,083376,Eldon; John,0,70,75,75
1650039496964,CSE 175,A01,084013,Kumar; Rakesh,22,0,25,3
1650039502989,CSE 190,A00,092508,Dubnov; Shlomo,20,0,20,0
1650039509015,ECE 5,A01,084049,Morris; Karcher William,13,0,20,7
1650039515038,ECE 100,A01,084051,Baghdadchi; Saharnaz,0,0,20,20
1650039515038,ECE 100,A02,091916,Baghdadchi; Saharnaz,13,0,20,7
1650039521076,ECE 101,A01,084053,Baghdadchi; Saharnaz,0,0,37,37
1650039521076,ECE 101,A02,084054,Baghdadchi; Saharnaz,30,0,37,7
1650039527111,ECE 107,A01,083390,Staff,26,0,40,14
1650039533134,ECE 148,A01,084056,Silberman; Jack,8,0,12,4
1650039539161,ECE 180,A00,083391,Abi Samra; Nicholas Camill,25,0,30,5
1650039539161,ECE 180,B00,083392,Abi Samra; Nicholas Camill,21,0,30,9
1650039545185,MATH 10B,A01,084110,Staff,0,0,30,30
1650039545185,MATH 10B,A02,084111,Staff,18,0,30,12
1650039545185,MATH 10B,A03,084112,Staff,24,0,30,6
1650039551211,MATH 10C,A01,083443,Staff,0,17,30,30
1650039551211,MATH 10C,A02,083444,Staff,0,16,30,30
1650039551211,MATH 10C,B01,084114,Staff,19,0,30,11
1650039551211,MATH 10C,B02,084115,Staff,25,0,30,5
1650039557239,MATH 18,A01,084117,Harel; Guershon,13,0,30,17
1650039557239,MATH 18,A02,084119,Harel; Guershon,27,0,30,3
1650039557239,MATH 18,A03,084120,Harel; Guershon,30,0,30,0
1650039557239,MATH 18,A04,084121,Harel; Guershon,29,0,30,1
1650039563263,MATH 20B,A01,084124,Um; Ko Woon,14,0,35,21
1650039563263,MATH 20B,B01,084126,Um; Ko Woon,24,0,35,11
1650039569293,MATH 20C,A01,083446,Hammock; Frances H,0,0,30,30
1650039569293,MATH 20C,A02,083447,Hammock; Frances H,16,0,30,14
1650039569293,MATH 20C,A03,083448,Hammock; Frances H,19,0,30,11
1650039569293,MATH 20C,A04,083449,Hammock; Frances H,20,0,30,10
1650039569293,MATH 20C,B01,083451,Hammock; Frances H,0,0,30,30
1650039569293,MATH 20C,B02,083452,Hammock; Frances H,18,0,30,12
1650039569293,MATH 20C,B03,083453,Hammock; Frances H,21,0,30,9
1650039569293,MATH 20C,B04,083454,Hammock; Frances H,23,0,30,7
1650039575318,MATH 20D,A01,084128,Staff,14,0,30,16
1650039575318,MATH 20D,A02,084129,Staff,29,0,30,1
1650039575318,MATH 20D,A03,084130,Staff,27,0,30,3
1650039575318,MATH 20D,B01,084133,Staff,3,0,30,27
1650039575318,MATH 20D,B02,084134,Staff,23,0,30,7
1650039575318,MATH 20D,B03,084135,Staff,28,0,30,2
1650039581349,MATH 20E,A01,084138,Staff,14,0,30,16
1650039581349,MATH 20E,A02,084139,Staff,6,0,30,24
1650039581349,MATH 20E,A03,084140,Staff,15,0,30,15
1650039581349,MATH 20E,A04,084141,Staff,20,0,30,10
1650039587372,MATH 102,A01,084143,Harel; Guershon,12,0,30,18
1650039587372,MATH 102,A02,084144,Harel; Guershon,19,0,30,11
1650039593404,MATH 103B,A01,083456,Staff,0,13,30,30
1650039593404,MATH 103B,A02,083457,Staff,0,14,30,30
1650039599431,MATH 109,A01,084146,Salehi Golsefidy; Alireza,17,0,30,13
1650039599431,MATH 109,A02,084147,Salehi Golsefidy; Alireza,15,0,30,15
1650039605459,MATH 120A,A01,085445,Eggers; John Dietrich,10,0,35,25
1650039605459,MATH 120A,A02,085446,Eggers; John Dietrich,27,0,35,8
1650039611488,MATH 142B,A01,084149,Verstraete; Jacques Allan,0,12,30,30
1650039611488,MATH 142B,A02,084150,Verstraete; Jacques Allan,0,12,30,30
1650039617520,MATH 170A,A01,083459,Nie; Jiawang,0,9,30,30
1650039617520,MATH 170A,A02,083460,Nie; Jiawang,0,8,30,30
1650039617520,MATH 170A,A03,083461,Nie; Jiawang,0,9,30,30
1650039623547,MATH 193B,A01,083463,Staff,1,0,30,29
1650039623547,MATH 193B,A02,083464,Staff,9,0,30,21
1650039623547,MATH 193B,A03,083465,Staff,18,0,30,12
1650039629612,COGS 2,A01,083966,Boyle; Mary E. T.,10,0,30,20
1650039635636,COGS 9,A01,083968,Staff,9,0,60,51
1650039641660,COGS 14B,A01,083970,Staff,9,0,50,41
1650039647690,COGS 17,A01,092679,Staff,50,0,75,25
1650039653725,COGS 100,A01,083972,Staff,0,16,60,60
1650039665774,COGS 101C,A01,083976,Staff,12,0,30,18
1650039671802,COGS 102A,A01,083978,Johnson; Christine M.,13,0,30,17
1650039677826,COGS 107B,A01,083980,Staff,0,7,50,50
1650039683859,COGS 115,A01,083982,Staff,10,0,30,20
1650039689883,COGS 118B,A01,083367,Staff,0,15,40,40
1650039695911,COGS 172,A01,083984,Provenzano; Emily Kara,15,0,30,15
1650039701935,COGS 177,A00,083368,Staff,0,20,30,30
1650039707961,COGS 186,A01,083986,Staff,21,0,40,19
1650039713986,COGS 187A,A01,083988,Boyle; Mary E. T.,20,0,60,40
1650039720010,CSE 8A,A50,084003,Miranda; Gregory Joseph,0,14,15,15
1650039726034,CSE 11,A01,084005,Miranda; Gregory Joseph,0,22,55,55
1650039732057,CSE 20,A01,084007,Staff,0,5,20,20
1650039738079,CSE 21,A01,084009,Staff,0,31,50,50
1650039744110,CSE 30,A01,083370,Cao; Yingjun,0,65,40,40
1650039750131,CSE 100,A01,083372,Cao; Yingjun,0,46,40,40
1650039756161,CSE 101,A01,084011,Staff,0,54,40,40
1650039762197,CSE 141,A01,083374,Eldon; John,0,64,75,75
1650039768221,CSE 141L,A01,083376,Eldon; John,0,70,75,75
1650039774246,CSE 175,A01,084013,Kumar; Rakesh,22,0,25,3
1650039780269,CSE 190,A00,092508,Dubnov; Shlomo,20,0,20,0
1650039786297,ECE 5,A01,084049,Morris; Karcher William,13,0,20,7
1650039792320,ECE 100,A01,084051,Baghdadchi; Saharnaz,0,0,20,20
1650039792320,ECE 100,A02,091916,Baghdadchi; Saharnaz,13,0,20,7
1650039798346,ECE 101,A01,084053,Baghdadchi; Saharnaz,0,0,37,37
1650039798346,ECE 101,A02,084054,Baghdadchi; Saharnaz,30,0,37,7
1650039804373,ECE 107,A01,083390,Staff,26,0,40,14
1650039810397,ECE 148,A01,084056,Silberman; Jack,8,0,12,4
1650039816436,ECE 180,A00,083391,Abi Samra; Nicholas Camill,25,0,30,5
1650039816436,ECE 180,B00,083392,Abi Samra; Nicholas Camill,21,0,30,9
1650039822463,MATH 10B,A01,084110,Staff,0,0,30,30
1650039822463,MATH 10B,A02,084111,Staff,18,0,30,12
1650039822463,MATH 10B,A03,084112,Staff,24,0,30,6
1650039828501,MATH 10C,A01,083443,Staff,0,17,30,30
1650039828501,MATH 10C,A02,083444,Staff,0,16,30,30
1650039828501,MATH 10C,B01,084114,Staff,19,0,30,11
1650039828501,MATH 10C,B02,084115,Staff,25,0,30,5
1650039834525,MATH 18,A01,084117,Harel; Guershon,13,0,30,17
1650039834525,MATH 18,A02,084119,Harel; Guershon,27,0,30,3
1650039834525,MATH 18,A03,084120,Harel; Guershon,30,0,30,0
1650039834525,MATH 18,A04,084121,Harel; Guershon,29,0,30,1
1650039840554,MATH 20B,A01,084124,Um; Ko Woon,14,0,35,21
1650039840554,MATH 20B,B01,084126,Um; Ko Woon,24,0,35,11
1650039846598,MATH 20C,A01,083446,Hammock; Frances H,0,0,30,30
1650039846598,MATH 20C,A02,083447,Hammock; Frances H,16,0,30,14
1650039846598,MATH 20C,A03,083448,Hammock; Frances H,19,0,30,11
1650039846598,MATH 20C,A04,083449,Hammock; Frances H,20,0,30,10
1650039846598,MATH 20C,B01,083451,Hammock; Frances H,0,0,30,30
1650039846598,MATH 20C,B02,083452,Hammock; Frances H,18,0,30,12
1650039846598,MATH 20C,B03,083453,Hammock; Frances H,21,0,30,9
1650039846598,MATH 20C,B04,083454,Hammock; Frances H,23,0,30,7
1650039852623,MATH 20D,A01,084128,Staff,14,0,30,16
1650039852623,MATH 20D,A02,084129,Staff,29,0,30,1
1650039852623,MATH 20D,A03,084130,Staff,27,0,30,3
1650039852623,MATH 20D,B01,084133,Staff,3,0,30,27
1650039852623,MATH 20D,B02,084134,Staff,23,0,30,7
1650039852623,MATH 20D,B03,084135,Staff,28,0,30,2
1650039858647,MATH 20E,A01,084138,Staff,14,0,30,16
1650039858647,MATH 20E,A02,084139,Staff,6,0,30,24
1650039858647,MATH 20E,A03,084140,Staff,15,0,30,15
1650039858647,MATH 20E,A04,084141,Staff,20,0,30,10
1650039864673,MATH 102,A01,084143,Harel; Guershon,12,0,30,18
1650039864673,MATH 102,A02,084144,Harel; Guershon,19,0,30,11
1650039870696,MATH 103B,A01,083456,Staff,0,13,30,30
1650039870696,MATH 103B,A02,083457,Staff,0,14,30,30
1650039876731,MATH 109,A01,084146,Salehi Golsefidy; Alireza,17,0,30,13
1650039876731,MATH 109,A02,084147,Salehi Golsefidy; Alireza,15,0,30,15
1650039882758,MATH 120A,A01,085445,Eggers; John Dietrich,10,0,35,25
1650039882758,MATH 120A,A02,085446,Eggers; John Dietrich,27,0,35,8
1650039888785,MATH 142B,A01,084149,Verstraete; Jacques Allan,0,12,30,30
1650039888785,MATH 142B,A02,084150,Verstraete; Jacques Allan,0,12,30,30
1650039894817,MATH 170A,A01,083459,Nie; Jiawang,0,9,30,30
1650039894817,MATH 170A,A02,083460,Nie; Jiawang,0,8,30,30
1650039894817,MATH 170A,A03,083461,Nie; Jiawang,0,9,30,30
1650039900861,MATH 193B,A01,083463,Staff,1,0,30,29
1650039900861,MATH 193B,A02,083464,Staff,9,0,30,21
1650039900861,MATH 193B,A03,083465,Staff,18,0,30,12
1650039906908,COGS 2,A01,083966,Boyle; Mary E. T.,10,0,30,20
1650039912935,COGS 9,A01,083968,Staff,9,0,60,51
1650039918962,COGS 14B,A01,083970,Staff,9,0,50,41
1650039924986,COGS 17,A01,092679,Staff,50,0,75,25
1650039931020,COGS 100,A01,083972,Staff,0,16,60,60
1650039943080,COGS 101C,A01,083976,Staff,12,0,30,18
1650039949108,COGS 102A,A01,083978,Johnson; Christine M.,13,0,30,17
1650039955137,COGS 107B,A01,083980,Staff,0,7,50,50
1650039961176,COGS 115,A01,083982,Staff,10,0,30,20
1650039967206,COGS 118B,A01,083367,Staff,0,15,40,40
1650039973230,COGS 172,A01,083984,Provenzano; Emily Kara,15,0,30,15
1650039979254,COGS 177,A00,083368,Staff,0,20,30,30
1650039985283,COGS 186,A01,083986,Staff,21,0,40,19
1650039991316,COGS 187A,A01,083988,Boyle; Mary E. T.,20,0,60,40
1650039997340,CSE 8A,A50,084003,Miranda; Gregory Joseph,0,14,15,15
1650040003378,CSE 11,A01,084005,Miranda; Gregory Joseph,0,22,55,55
1650040009403,CSE 20,A01,084007,Staff,0,5,20,20
1650040015532,CSE 21,A01,084009,Staff,0,31,50,50
1650040021570,CSE 30,A01,083370,Cao; Yingjun,0,65,40,40
1650040027596,CSE 100,A01,083372,Cao; Yingjun,0,46,40,40
1650040033622,CSE 101,A01,084011,Staff,0,54,40,40
1650040039646,CSE 141,A01,083374,Eldon; John,0,64,75,75
1650040045671,CSE 141L,A01,083376,Eldon; John,0,70,75,75
1650040051709,CSE 175,A01,084013,Kumar; Rakesh,22,0,25,3
1650040057738,CSE 190,A00,092508,Dubnov; Shlomo,20,0,20,0
1650040063762,ECE 5,A01,084049,Morris; Karcher William,13,0,20,7
1650040069792,ECE 100,A01,084051,Baghdadchi; Saharnaz,0,0,20,20
1650040069792,ECE 100,A02,091916,Baghdadchi; Saharnaz,13,0,20,7
1650040075817,ECE 101,A01,084053,Baghdadchi; Saharnaz,0,0,37,37
1650040075817,ECE 101,A02,084054,Baghdadchi; Saharnaz,30,0,37,7
1650040081843,ECE 107,A01,083390,Staff,26,0,40,14
1650040087869,ECE 148,A01,084056,Silberman; Jack,8,0,12,4
1650040093892,ECE 180,A00,083391,Abi Samra; Nicholas Camill,25,0,30,5
1650040093892,ECE 180,B00,083392,Abi Samra; Nicholas Camill,21,0,30,9
1650040099940,MATH 10B,A01,084110,Staff,0,0,30,30
1650040099940,MATH 10B,A02,084111,Staff,18,0,30,12
1650040099940,MATH 10B,A03,084112,Staff,24,0,30,6
1650040105966,MATH 10C,A01,083443,Staff,0,17,30,30
1650040105966,MATH 10C,A02,083444,Staff,0,16,30,30
1650040105966,MATH 10C,B01,084114,Staff,19,0,30,11
1650040105966,MATH 10C,B02,084115,Staff,25,0,30,5
1650040111996,MATH 18,A01,084117,Harel; Guershon,13,0,30,17
1650040111996,MATH 18,A02,084119,Harel; Guershon,27,0,30,3
1650040111996,MATH 18,A03,084120,Harel; Guershon,30,0,30,0
1650040111996,MATH 18,A04,084121,Harel; Guershon,29,0,30,1
1650040118030,MATH 20B,A01,084124,Um; Ko Woon,13,0,35,22
1650040118030,MATH 20B,B01,084126,Um; Ko Woon,24,0,35,11
1650040124057,MATH 20C,A01,083446,Hammock; Frances H,0,0,30,30
1650040124057,MATH 20C,A02,083447,Hammock; Frances H,16,0,30,14
1650040124057,MATH 20C,A03,083448,Hammock; Frances H,19,0,30,11
1650040124057,MATH 20C,A04,083449,Hammock; Frances H,20,0,30,10
1650040124057,MATH 20C,B01,083451,Hammock; Frances H,0,0,30,30
1650040124057,MATH 20C,B02,083452,Hammock; Frances H,18,0,30,12
1650040124057,MATH 20C,B03,083453,Hammock; Frances H,21,0,30,9
1650040124057,MATH 20C,B04,083454,Hammock; Frances H,23,0,30,7
1650040130083,MATH 20D,A01,084128,Staff,14,0,30,16
1650040130083,MATH 20D,A02,084129,Staff,29,0,30,1
1650040130083,MATH 20D,A03,084130,Staff,27,0,30,3
1650040130083,MATH 20D,B01,084133,Staff,3,0,30,27
1650040130083,MATH 20D,B02,084134,Staff,23,0,30,7
1650040130083,MATH 20D,B03,084135,Staff,28,0,30,2
1650040136108,MATH 20E,A01,084138,Staff,14,0,30,16
1650040136108,MATH 20E,A02,084139,Staff,6,0,30,24
1650040136108,MATH 20E,A03,084140,Staff,15,0,30,15
1650040136108,MATH 20E,A04,084141,Staff,20,0,30,10
1650040142137,MATH 102,A01,084143,Harel; Guershon,12,0,30,18
1650040142137,MATH 102,A02,084144,Harel; Guershon,19,0,30,11
1650040148162,MATH 103B,A01,083456,Staff,0,13,30,30
1650040148162,MATH 103B,A02,083457,Staff,0,14,30,30
1650040154183,MATH 109,A01,084146,Salehi Golsefidy; Alireza,17,0,30,13
1650040154183,MATH 109,A02,084147,Salehi Golsefidy; Alireza,15,0,30,15
1650040160210,MATH 120A,A01,085445,Eggers; John Dietrich,10,0,35,25
1650040160210,MATH 120A,A02,085446,Eggers; John Dietrich,27,0,35,8
1650040166238,MATH 142B,A01,084149,Verstraete; Jacques Allan,0,12,30,30
1650040166238,MATH 142B,A02,084150,Verstraete; Jacques Allan,0,12,30,30
1650040172266,MATH 170A,A01,083459,Nie; Jiawang,0,9,30,30
1650040172266,MATH 170A,A02,083460,Nie; Jiawang,0,8,30,30
1650040172266,MATH 170A,A03,083461,Nie; Jiawang,0,9,30,30
1650040178290,MATH 193B,A01,083463,Staff,1,0,30,29
1650040178290,MATH 193B,A02,083464,Staff,9,0,30,21
1650040178290,MATH 193B,A03,083465,Staff,18,0,30,12
1650040184362,COGS 2,A01,083966,Boyle; Mary E. T.,10,0,30,20
1650040190395,COGS 9,A01,083968,Staff,9,0,60,51
1650040196422,COGS 14B,A01,083970,Staff,9,0,50,41
1650040202447,COGS 17,A01,092679,Staff,50,0,75,25
1650040208477,COGS 100,A01,083972,Staff,0,16,60,60
1650040220526,COGS 101C,A01,083976,Staff,12,0,30,18
1650040226552,COGS 102A,A01,083978,Johnson; Christine M.,13,0,30,17
1650040232574,COGS 107B,A01,083980,Staff,0,7,50,50
1650040238601,COGS 115,A01,083982,Staff,10,0,30,20
1650040244628,COGS 118B,A01,083367,Staff,0,15,40,40
1650040250653,COGS 172,A01,083984,Provenzano; Emily Kara,15,0,30,15
1650040256681,COGS 177,A00,083368,Staff,0,20,30,30
1650040262708,COGS 186,A01,083986,Staff,21,0,40,19
1650040268736,COGS 187A,A01,083988,Boyle; Mary E. T.,20,0,60,40
1650040274763,CSE 8A,A50,084003,Miranda; Gregory Joseph,0,14,15,15
1650040280790,CSE 11,A01,084005,Miranda; Gregory Joseph,0,22,55,55
1650040286822,CSE 20,A01,084007,Staff,0,5,20,20
1650040292849,CSE 21,A01,084009,Staff,0,31,50,50
1650040298871,CSE 30,A01,083370,Cao; Yingjun,0,65,40,40
1650040304894,CSE 100,A01,083372,Cao; Yingjun,0,46,40,40
1650040310918,CSE 101,A01,084011,Staff,0,54,40,40
1650040316944,CSE 141,A01,083374,Eldon; John,0,64,75,75
1650040322968,CSE 141L,A01,083376,Eldon; John,0,70,75,75
1650040328998,CSE 175,A01,084013,Kumar; Rakesh,22,0,25,3
1650040335024,CSE 190,A00,092508,Dubnov; Shlomo,20,0,20,0
1650040341053,ECE 5,A01,084049,Morris; Karcher William,13,0,20,7
1650040347076,ECE 100,A01,084051,Baghdadchi; Saharnaz,0,0,20,20
1650040347076,ECE 100,A02,091916,Baghdadchi; Saharnaz,13,0,20,7
1650040353099,ECE 101,A01,084053,Baghdadchi; Saharnaz,0,0,37,37
1650040353099,ECE 101,A02,084054,Baghdadchi; Saharnaz,30,0,37,7
1650040359121,ECE 107,A01,083390,Staff,26,0,40,14
1650040365142,ECE 148,A01,084056,Silberman; Jack,8,0,12,4
1650040371188,ECE 180,A00,083391,Abi Samra; Nicholas Camill,25,0,30,5
1650040371188,ECE 180,B00,083392,Abi Samra; Nicholas Camill,21,0,30,9
1650040377213,MATH 10B,A01,084110,Staff,0,0,30,30
1650040377213,MATH 10B,A02,084111,Staff,18,0,30,12
1650040377213,MATH 10B,A03,084112,Staff,24,0,30,6
1650040383236,MATH 10C,A01,083443,Staff,0,17,30,30
1650040383236,MATH 10C,A02,083444,Staff,0,16,30,30
1650040383236,MATH 10C,B01,084114,Staff,19,0,30,11
1650040383236,MATH 10C,B02,084115,Staff,25,0,30,5
1650040389265,MATH 18,A01,084117,Harel; Guershon,13,0,30,17
1650040389265,MATH 18,A02,084119,Harel; Guershon,27,0,30,3
1650040389265,MATH 18,A03,084120,Harel; Guershon,30,0,30,0
1650040389265,MATH 18,A04,084121,Harel; Guershon,29,0,30,1
1650040395290,MATH 20B,A01,084124,Um; Ko Woon,13,0,35,22
1650040395290,MATH 20B,B01,084126,Um; Ko Woon,24,0,35,11
1650040401322,MATH 20C,A01,083446,Hammock; Frances H,0,0,30,30
1650040401322,MATH 20C,A02,083447,Hammock; Frances H,16,0,30,14
1650040401322,MATH 20C,A03,083448,Hammock; Frances H,19,0,30,11
1650040401322,MATH 20C,A04,083449,Hammock; Frances H,20,0,30,10
1650040401322,MATH 20C,B01,083451,Hammock; Frances H,0,0,30,30
1650040401322,MATH 20C,B02,083452,Hammock; Frances H,18,0,30,12
1650040401322,MATH 20C,B03,083453,Hammock; Frances H,21,0,30,9
1650040401322,MATH 20C,B04,083454,Hammock; Frances H,23,0,30,7
1650040407353,MATH 20D,A01,084128,Staff,14,0,30,16
1650040407353,MATH 20D,A02,084129,Staff,29,0,30,1
1650040407353,MATH 20D,A03,084130,Staff,27,0,30,3
1650040407353,MATH 20D,B01,084133,Staff,3,0,30,27
1650040407353,MATH 20D,B02,084134,Staff,23,0,30,7
1650040407353,MATH 20D,B03,084135,Staff,28,0,30,2
1650040413381,MATH 20E,A01,084138,Staff,14,0,30,16
1650040413381,MATH 20E,A02,084139,Staff,6,0,30,24
1650040413381,MATH 20E,A03,084140,Staff,15,0,30,15
1650040413381,MATH 20E,A04,084141,Staff,20,0,30,10
1650040419402,MATH 102,A01,084143,Harel; Guershon,12,0,30,18
1650040419402,MATH 102,A02,084144,Harel; Guershon,19,0,30,11
1650040425425,MATH 103B,A01,083456,Staff,0,13,30,30
1650040425425,MATH 103B,A02,083457,Staff,0,14,30,30
1650040431453,MATH 109,A01,084146,Salehi Golsefidy; Alireza,17,0,30,13
1650040431453,MATH 109,A02,084147,Salehi Golsefidy; Alireza,15,0,30,15
1650040437477,MATH 120A,A01,085445,Eggers; John Dietrich,10,0,35,25
1650040437477,MATH 120A,A02,085446,Eggers; John Dietrich,27,0,35,8
1650040443503,MATH 142B,A01,084149,Verstraete; Jacques Allan,0,12,30,30
1650040443503,MATH 142B,A02,084150,Verstraete; Jacques Allan,0,12,30,30
1650040449529,MATH 170A,A01,083459,Nie; Jiawang,0,9,30,30
1650040449529,MATH 170A,A02,083460,Nie; Jiawang,0,8,30,30
1650040449529,MATH 170A,A03,083461,Nie; Jiawang,0,9,30,30
1650040455556,MATH 193B,A01,083463,Staff,1,0,30,29
1650040455556,MATH 193B,A02,083464,Staff,9,0,30,21
1650040455556,MATH 193B,A03,083465,Staff,18,0,30,12
1650040461610,COGS 2,A01,083966,Boyle; Mary E. T.,10,0,30,20
1650040467638,COGS 9,A01,083968,Staff,9,0,60,51
1650040473664,COGS 14B,A01,083970,Staff,9,0,50,41
1650040479690,COGS 17,A01,092679,Staff,50,0,75,25
1650040485717,COGS 100,A01,083972,Staff,0,16,60,60
1650040497769,COGS 101C,A01,083976,Staff,12,0,30,18
1650040503793,COGS 102A,A01,083978,Johnson; Christine M.,13,0,30,17
1650040509815,COGS 107B,A01,083980,Staff,0,7,50,50
1650040515839,COGS 115,A01,083982,Staff,10,0,30,20
1650040521863,COGS 118B,A01,083367,Staff,0,15,40,40
1650040527886,COGS 172,A01,083984,Provenzano; Emily Kara,15,0,30,15
1650040533912,COGS 177,A00,083368,Staff,0,20,30,30
1650040539940,COGS 186,A01,083986,Staff,21,0,40,19
1650040545963,COGS 187A,A01,083988,Boyle; Mary E. T.,20,0,60,40
1650040551986,CSE 8A,A50,084003,Miranda; Gregory Joseph,0,14,15,15
1650040558014,CSE 11,A01,084005,Miranda; Gregory Joseph,0,22,55,55
1650040564038,CSE 20,A01,084007,Staff,0,5,20,20
1650040570065,CSE 21,A01,084009,Staff,0,31,50,50
1650040576089,CSE 30,A01,083370,Cao; Yingjun,0,65,40,40
1650040582120,CSE 100,A01,083372,Cao; Yingjun,0,46,40,40
1650040588144,CSE 101,A01,084011,Staff,0,54,40,40
1650040594173,CSE 141,A01,083374,Eldon; John,0,64,75,75
1650040600197,CSE 141L,A01,083376,Eldon; John,0,70,75,75
1650040606224,CSE 175,A01,084013,Kumar; Rakesh,22,0,25,3
1650040612336,CSE 190,A00,092508,Dubnov; Shlomo,20,0,20,0
1650040618360,ECE 5,A01,084049,Morris; Karcher William,13,0,20,7
1650040624384,ECE 100,A01,084051,Baghdadchi; Saharnaz,0,0,20,20
1650040624384,ECE 100,A02,091916,Baghdadchi; Saharnaz,13,0,20,7
1650040630413,ECE 101,A01,084053,Baghdadchi; Saharnaz,0,0,37,37
1650040630413,ECE 101,A02,084054,Baghdadchi; Saharnaz,30,0,37,7
1650040636455,ECE 107,A01,083390,Staff,26,0,40,14
1650040642489,ECE 148,A01,084056,Silberman; Jack,8,0,12,4
1650040648523,ECE 180,A00,083391,Abi Samra; Nicholas Camill,25,0,30,5
1650040648523,ECE 180,B00,083392,Abi Samra; Nicholas Camill,21,0,30,9
1650040654553,MATH 10B,A01,084110,Staff,0,0,30,30
1650040654553,MATH 10B,A02,084111,Staff,18,0,30,12
1650040654553,MATH 10B,A03,084112,Staff,24,0,30,6
1650040660577,MATH 10C,A01,083443,Staff,0,17,30,30
1650040660577,MATH 10C,A02,083444,Staff,0,16,30,30
1650040660577,MATH 10C,B01,084114,Staff,19,0,30,11
1650040660577,MATH 10C,B02,084115,Staff,25,0,30,5
1650040666609,MATH 18,A01,084117,Harel; Guershon,13,0,30,17
1650040666609,MATH 18,A02,084119,Harel; Guershon,27,0,30,3
1650040666609,MATH 18,A03,084120,Harel; Guershon,30,0,30,0
1650040666609,MATH 18,A04,084121,Harel; Guershon,29,0,30,1
1650040672642,MATH 20B,A01,084124,Um; Ko Woon,13,0,35,22
1650040672642,MATH 20B,B01,084126,Um; Ko Woon,24,0,35,11
1650040678681,MATH 20C,A01,083446,Hammock; Frances H,0,0,30,30
1650040678681,MATH 20C,A02,083447,Hammock; Frances H,16,0,30,14
1650040678681,MATH 20C,A03,083448,Hammock; Frances H,19,0,30,11
1650040678681,MATH 20C,A04,083449,Hammock; Frances H,20,0,30,10
1650040678681,MATH 20C,B01,083451,Hammock; Frances H,0,0,30,30
1650040678681,MATH 20C,B02,083452,Hammock; Frances H,18,0,30,12
1650040678681,MATH 20C,B03,083453,Hammock; Frances H,21,0,30,9
1650040678681,MATH 20C,B04,083454,Hammock; Frances H,23,0,30,7
1650040684710,MATH 20D,A01,084128,Staff,14,0,30,16
1650040684710,MATH 20D,A02,084129,Staff,29,0,30,1
1650040684710,MATH 20D,A03,084130,Staff,27,0,30,3
1650040684710,MATH 20D,B01,084133,Staff,3,0,30,27
1650040684710,MATH 20D,B02,084134,Staff,23,0,30,7
1650040684710,MATH 20D,B03,084135,Staff,28,0,30,2
1650040690736,MATH 20E,A01,084138,Staff,14,0,30,16
1650040690736,MATH 20E,A02,084139,Staff,6,0,30,24
1650040690736,MATH 20E,A03,084140,Staff,15,0,30,15
1650040690736,MATH 20E,A04,084141,Staff,20,0,30,10
1650040696761,MATH 102,A01,084143,Harel; Guershon,12,0,30,18
1650040696761,MATH 102,A02,084144,Harel; Guershon,19,0,30,11
1650040702788,MATH 103B,A01,083456,Staff,0,13,30,30
1650040702788,MATH 103B,A02,083457,Staff,0,14,30,30
1650040708814,MATH 109,A01,084146,Salehi Golsefidy; Alireza,17,0,30,13
1650040708814,MATH 109,A02,084147,Salehi Golsefidy; Alireza,15,0,30,15
1650040714842,MATH 120A,A01,085445,Eggers; John Dietrich,10,0,35,25
1650040714842,MATH 120A,A02,085446,Eggers; John Dietrich,27,0,35,8
1650040720868,MATH 142B,A01,084149,Verstraete; Jacques Allan,0,12,30,30
1650040720868,MATH 142B,A02,084150,Verstraete; Jacques Allan,0,12,30,30
1650040726894,MATH 170A,A01,083459,Nie; Jiawang,0,9,30,30
1650040726894,MATH 170A,A02,083460,Nie; Jiawang,0,8,30,30
1650040726894,MATH 170A,A03,083461,Nie; Jiawang,0,9,30,30
1650040732921,MATH 193B,A01,083463,Staff,1,0,30,29
1650040732921,MATH 193B,A02,083464,Staff,9,0,30,21
1650040732921,MATH 193B,A03,083465,Staff,18,0,30,12
1650040738980,COGS 2,A01,083966,Boyle; Mary E. T.,10,0,30,20
1650040745006,COGS 9,A01,083968,Staff,9,0,60,51
1650040751029,COGS 14B,A01,083970,Staff,9,0,50,41
1650040757053,COGS 17,A01,092679,Staff,50,0,75,25
1650040763092,COGS 100,A01,083972,Staff,0,16,60,60
1650040775146,COGS 101C,A01,083976,Staff,12,0,30,18
1650040781170,COGS 102A,A01,083978,Johnson; Christine M.,13,0,30,17
1650040787194,COGS 107B,A01,083980,Staff,0,7,50,50
1650040793219,COGS 115,A01,083982,Staff,10,0,30,20
1650040799242,COGS 118B,A01,083367,Staff,0,15,40,40
1650040805265,COGS 172,A01,083984,Provenzano; Emily Kara,15,0,30,15
1650040811298,COGS 177,A00,083368,Staff,0,20,30,30
1650040817325,COGS 186,A01,083986,Staff,21,0,40,19
1650040823364,COGS 187A,A01,083988,Boyle; Mary E. T.,20,0,60,40
1650040829391,CSE 8A,A50,084003,Miranda; Gregory Joseph,0,14,15,15
1650040835414,CSE 11,A01,084005,Miranda; Gregory Joseph,0,22,55,55
1650040841447,CSE 20,A01,084007,Staff,0,5,20,20
1650040847471,CSE 21,A01,084009,Staff,0,31,50,50
1650040853505,CSE 30,A01,083370,Cao; Yingjun,0,65,40,40
1650040859532,CSE 100,A01,083372,Cao; Yingjun,0,46,40,40
1650040865566,CSE 101,A01,084011,Staff,0,54,40,40
1650040871596,CSE 141,A01,083374,Eldon; John,0,64,75,75
1650040877620,CSE 141L,A01,083376,Eldon; John,0,70,75,75
1650040883644,CSE 175,A01,084013,Kumar; Rakesh,22,0,25,3
1650040889687,CSE 190,A00,092508,Dubnov; Shlomo,20,0,20,0
1650040895717,ECE 5,A01,084049,Morris; Karcher William,13,0,20,7
1650040901749,ECE 100,A01,084051,Baghdadchi; Saharnaz,0,0,20,20
1650040901749,ECE 100,A02,091916,Baghdadchi; Saharnaz,13,0,20,7
1650040907778,ECE 101,A01,084053,Baghdadchi; Saharnaz,0,0,37,37
1650040907778,ECE 101,A02,084054,Baghdadchi; Saharnaz,30,0,37,7
1650040913806,ECE 107,A01,083390,Staff,26,0,40,14
1650040919836,ECE 148,A01,084056,Silberman; Jack,8,0,12,4
1650040925863,ECE 180,A00,083391,Abi Samra; Nicholas Camill,25,0,30,5
1650040925863,ECE 180,B00,083392,Abi Samra; Nicholas Camill,21,0,30,9
1650040931894,MATH 10B,A01,084110,Staff,0,0,30,30
1650040931894,MATH 10B,A02,084111,Staff,18,0,30,12
1650040931894,MATH 10B,A03,084112,Staff,24,0,30,6
1650040937924,MATH 10C,A01,083443,Staff,0,17,30,30
1650040937924,MATH 10C,A02,083444,Staff,0,16,30,30
1650040937924,MATH 10C,B01,084114,Staff,19,0,30,11
1650040937924,MATH 10C,B02,084115,Staff,25,0,30,5
1650040943959,MATH 18,A01,084117,Harel; Guershon,13,0,30,17
1650040943959,MATH 18,A02,084119,Harel; Guershon,27,0,30,3
1650040943959,MATH 18,A03,084120,Harel; Guershon,30,0,30,0
1650040943959,MATH 18,A04,084121,Harel; Guershon,29,0,30,1
1650040949985,MATH 20B,A01,084124,Um; Ko Woon,13,0,35,22
1650040949985,MATH 20B,B01,084126,Um; Ko Woon,24,0,35,11
1650040956010,MATH 20C,A01,083446,Hammock; Frances H,0,0,30,30
1650040956010,MATH 20C,A02,083447,Hammock; Frances H,16,0,30,14
1650040956010,MATH 20C,A03,083448,Hammock; Frances H,19,0,30,11
1650040956010,MATH 20C,A04,083449,Hammock; Frances H,20,0,30,10
1650040956010,MATH 20C,B01,083451,Hammock; Frances H,0,0,30,30
1650040956010,MATH 20C,B02,083452,Hammock; Frances H,18,0,30,12
1650040956010,MATH 20C,B03,083453,Hammock; Frances H,21,0,30,9
1650040956010,MATH 20C,B04,083454,Hammock; Frances H,23,0,30,7
1650040962044,MATH 20D,A01,084128,Staff,14,0,30,16
1650040962044,MATH 20D,A02,084129,Staff,29,0,30,1
1650040962044,MATH 20D,A03,084130,Staff,27,0,30,3
1650040962044,MATH 20D,B01,084133,Staff,3,0,30,27
1650040962044,MATH 20D,B02,084134,Staff,23,0,30,7
1650040962044,MATH 20D,B03,084135,Staff,28,0,30,2
1650040968068,MATH 20E,A01,084138,Staff,14,0,30,16
1650040968068,MATH 20E,A02,084139,Staff,6,0,30,24
1650040968068,MATH 20E,A03,084140,Staff,15,0,30,15
1650040968068,MATH 20E,A04,084141,Staff,20,0,30,10
1650040974091,MATH 102,A01,084143,Harel; Guershon,12,0,30,18
1650040974091,MATH 102,A02,084144,Harel; Guershon,19,0,30,11
1650040980115,MATH 103B,A01,083456,Staff,0,13,30,30
1650040980115,MATH 103B,A02,083457,Staff,0,14,30,30
1650040986137,MATH 109,A01,084146,Salehi Golsefidy; Alireza,17,0,30,13
1650040986137,MATH 109,A02,084147,Salehi Golsefidy; Alireza,15,0,30,15
1650040992160,MATH 120A,A01,085445,Eggers; John Dietrich,10,0,35,25
1650040992160,MATH 120A,A02,085446,Eggers; John Dietrich,27,0,35,8
1650040998184,MATH 142B,A01,084149,Verstraete; Jacques Allan,0,12,30,30
1650040998184,MATH 142B,A02,084150,Verstraete; Jacques Allan,0,12,30,30
1650041004207,MATH 170A,A01,083459,Nie; Jiawang,0,9,30,30
1650041004207,MATH 170A,A02,083460,Nie; Jiawang,0,8,30,30
1650041004207,MATH 170A,A03,083461,Nie; Jiawang,0,9,30,30
1650041010233,MATH 193B,A01,083463,Staff,1,0,30,29
1650041010233,MATH 193B,A02,083464,Staff,9,0,30,21
1650041010233,MATH 193B,A03,083465,Staff,18,0,30,12
1650041016284,COGS 2,A01,083966,Boyle; Mary E. T.,10,0,30,20
1650041022311,COGS 9,A01,083968,Staff,9,0,60,51
1650041028333,COGS 14B,A01,083970,Staff,9,0,50,41
1650041034356,COGS 17,A01,092679,Staff,50,0,75,25
1650041040379,COGS 100,A01,083972,Staff,0,16,60,60
1650041052438,COGS 101C,A01,083976,Staff,12,0,30,18
1650041058468,COGS 102A,A01,083978,Johnson; Christine M.,13,0,30,17
1650041064498,COGS 107B,A01,083980,Staff,0,7,50,50
1650041070521,COGS 115,A01,083982,Staff,10,0,30,20
1650041076543,COGS 118B,A01,083367,Staff,0,15,40,40
1650041082570,COGS 172,A01,083984,Provenzano; Emily Kara,15,0,30,15
1650041088602,COGS 177,A00,083368,Staff,0,20,30,30
1650041094629,COGS 186,A01,083986,Staff,21,0,40,19
1650041100654,COGS 187A,A01,083988,Boyle; Mary E. T.,20,0,60,40
1650041106684,CSE 8A,A50,084003,Miranda; Gregory Joseph,0,14,15,15
1650041112714,CSE 11,A01,084005,Miranda; Gregory Joseph,0,22,55,55
1650041118738,CSE 20,A01,084007,Staff,0,5,20,20
1650041124762,CSE 21,A01,084009,Staff,0,31,50,50
1650041130799,CSE 30,A01,083370,Cao; Yingjun,0,65,40,40
1650041136838,CSE 100,A01,083372,Cao; Yingjun,0,46,40,40
1650041142864,CSE 101,A01,084011,Staff,0,54,40,40
1650041148901,CSE 141,A01,083374,Eldon; John,0,64,75,75
1650041154943,CSE 141L,A01,083376,Eldon; John,0,70,75,75
1650041160968,CSE 175,A01,084013,Kumar; Rakesh,22,0,25,3
1650041166997,CSE 190,A00,092508,Dubnov; Shlomo,20,0,20,0
1650041173023,ECE 5,A01,084049,Morris; Karcher William,13,0,20,7
1650041179048,ECE 100,A01,084051,Baghdadchi; Saharnaz,0,0,20,20
1650041179048,ECE 100,A02,091916,Baghdadchi; Saharnaz,13,0,20,7
1650041185075,ECE 101,A01,084053,Baghdadchi; Saharnaz,0,0,37,37
1650041185075,ECE 101,A02,084054,Baghdadchi; Saharnaz,30,0,37,7
1650041191114,ECE 107,A01,083390,Staff,26,0,40,14
1650041197148,ECE 148,A01,084056,Silberman; Jack,8,0,12,4
1650041203171,ECE 180,A00,083391,Abi Samra; Nicholas Camill,25,0,30,5
1650041203171,ECE 180,B00,083392,Abi Samra; Nicholas Camill,21,0,30,9
1650041209282,MATH 10B,A01,084110,Staff,0,0,30,30
1650041209282,MATH 10B,A02,084111,Staff,18,0,30,12
1650041209282,MATH 10B,A03,084112,Staff,24,0,30,6
1650041215309,MATH 10C,A01,083443,Staff,0,17,30,30
1650041215309,MATH 10C,A02,083444,Staff,0,16,30,30
1650041215309,MATH 10C,B01,084114,Staff,19,0,30,11
1650041215309,MATH 10C,B02,084115,Staff,25,0,30,5
1650041221333,MATH 18,A01,084117,Harel; Guershon,13,0,30,17
1650041221333,MATH 18,A02,084119,Harel; Guershon,27,0,30,3
1650041221333,MATH 18,A03,084120,Harel; Guershon,30,0,30,0
1650041221333,MATH 18,A04,084121,Harel; Guershon,29,0,30,1
1650041227358,MATH 20B,A01,084124,Um; Ko Woon,13,0,35,22
1650041227358,MATH 20B,B01,084126,Um; Ko Woon,24,0,35,11
1650041233385,MATH 20C,A01,083446,Hammock; Frances H,0,0,30,30
1650041233385,MATH 20C,A02,083447,Hammock; Frances H,16,0,30,14
1650041233385,MATH 20C,A03,083448,Hammock; Frances H,19,0,30,11
1650041233385,MATH 20C,A04,083449,Hammock; Frances H,20,0,30,10
1650041233385,MATH 20C,B01,083451,Hammock; Frances H,0,0,30,30
1650041233385,MATH 20C,B02,083452,Hammock; Frances H,18,0,30,12
1650041233385,MATH 20C,B03,083453,Hammock; Frances H,21,0,30,9
1650041233385,MATH 20C,B04,083454,Hammock; Frances H,23,0,30,7
1650041239409,MATH 20D,A01,084128,Staff,14,0,30,16
1650041239409,MATH 20D,A02,084129,Staff,29,0,30,1
1650041239409,MATH 20D,A03,084130,Staff,27,0,30,3
1650041239409,MATH 20D,B01,084133,Staff,3,0,30,27
1650041239409,MATH 20D,B02,084134,Staff,23,0,30,7
1650041239409,MATH 20D,B03,084135,Staff,28,0,30,2
1650041245432,MATH 20E,A01,084138,Staff,14,0,30,16
1650041245432,MATH 20E,A02,084139,Staff,6,0,30,24
1650041245432,MATH 20E,A03,084140,Staff,15,0,30,15
1650041245432,MATH 20E,A04,084141,Staff,20,0,30,10
1650041251456,MATH 102,A01,084143,Harel; Guershon,12,0,30,18
1650041251456,MATH 102,A02,084144,Harel; Guershon,19,0,30,11
1650041257478,MATH 103B,A01,083456,Staff,0,13,30,30
1650041257478,MATH 103B,A02,083457,Staff,0,14,30,30
1650041263501,MATH 109,A01,084146,Salehi Golsefidy; Alireza,17,0,30,13
1650041263501,MATH 109,A02,084147,Salehi Golsefidy; Alireza,15,0,30,15
1650041269528,MATH 120A,A01,085445,Eggers; John Dietrich,10,0,35,25
1650041269528,MATH 120A,A02,085446,Eggers; John Dietrich,27,0,35,8
1650041275552,MATH 142B,A01,084149,Verstraete; Jacques Allan,0,12,30,30
1650041275552,MATH 142B,A02,084150,Verstraete; Jacques Allan,0,12,30,30
1650041281577,MATH 170A,A01,083459,Nie; Jiawang,0,9,30,30
1650041281577,MATH 170A,A02,083460,Nie; Jiawang,0,8,30,30
1650041281577,MATH 170A,A03,083461,Nie; Jiawang,0,9,30,30
1650041287600,MATH 193B,A01,083463,Staff,1,0,30,29
1650041287600,MATH 193B,A02,083464,Staff,9,0,30,21
1650041287600,MATH 193B,A03,083465,Staff,18,0,30,12
1650041293653,COGS 2,A01,083966,Boyle; Mary E. T.,10,0,30,20
1650041299678,COGS 9,A01,083968,Staff,9,0,60,51
1650041305701,COGS 14B,A01,083970,Staff,9,0,50,41
1650041311723,COGS 17,A01,092679,Staff,50,0,75,25
1650041317750,COGS 100,A01,083972,Staff,0,16,60,60
1650041329818,COGS 101C,A01,083976,Staff,12,0,30,18
1650041335848,COGS 102A,A01,083978,Johnson; Christine M.,13,0,30,17
1650041341876,COGS 107B,A01,083980,Staff,0,7,50,50
1650041347918,COGS 115,A01,083982,Staff,10,0,30,20
1650041353940,COGS 118B,A01,083367,Staff,0,15,40,40
1650041359965,COGS 172,A01,083984,Provenzano; Emily Kara,15,0,30,15
1650041365988,COGS 177,A00,083368,Staff,0,20,30,30
1650041372011,COGS 186,A01,083986,Staff,21,0,40,19
1650041378042,COGS 187A,A01,083988,Boyle; Mary E. T.,20,0,60,40
1650041384070,CSE 8A,A50,084003,Miranda; Gregory Joseph,0,15,15,15
1650041390100,CSE 11,A01,084005,Miranda; Gregory Joseph,0,22,55,55
1650041396126,CSE 20,A01,084007,Staff,0,5,20,20
1650041402151,CSE 21,A01,084009,Staff,0,31,50,50
1650041408185,CSE 30,A01,083370,Cao; Yingjun,0,65,40,40
1650041414212,CSE 100,A01,083372,Cao; Yingjun,0,46,40,40
1650041420236,CSE 101,A01,084011,Staff,0,54,40,40
1650041426298,CSE 141,A01,083374,Eldon; John,0,64,75,75
1650041432322,CSE 141L,A01,083376,Eldon; John,0,70,75,75
1650041438346,CSE 175,A01,084013,Kumar; Rakesh,22,0,25,3
1650041444368,CSE 190,A00,092508,Dubnov; Shlomo,20,0,20,0
1650041450396,ECE 5,A01,084049,Morris; Karcher William,13,0,20,7
1650041456423,ECE 100,A01,084051,Baghdadchi; Saharnaz,0,0,20,20
1650041456423,ECE 100,A02,091916,Baghdadchi; Saharnaz,13,0,20,7
1650041462467,ECE 101,A01,084053,Baghdadchi; Saharnaz,0,0,37,37
1650041462467,ECE 101,A02,084054,Baghdadchi; Saharnaz,30,0,37,7
1650041468502,ECE 107,A01,083390,Staff,26,0,40,14
1650041474527,ECE 148,A01,084056,Silberman; Jack,8,0,12,4
1650041480553,ECE 180,A00,083391,Abi Samra; Nicholas Camill,25,0,30,5
1650041480553,ECE 180,B00,083392,Abi Samra; Nicholas Camill,21,0,30,9
1650041486583,MATH 10B,A01,084110,Staff,0,0,30,30
1650041486583,MATH 10B,A02,084111,Staff,18,0,30,12
1650041486583,MATH 10B,A03,084112,Staff,24,0,30,6
1650041492607,MATH 10C,A01,083443,Staff,0,17,30,30
1650041492607,MATH 10C,A02,083444,Staff,0,16,30,30
1650041492607,MATH 10C,B01,084114,Staff,19,0,30,11
1650041492607,MATH 10C,B02,084115,Staff,25,0,30,5
1650041498631,MATH 18,A01,084117,Harel; Guershon,13,0,30,17
1650041498631,MATH 18,A02,084119,Harel; Guershon,27,0,30,3
1650041498631,MATH 18,A03,084120,Harel; Guershon,30,0,30,0
1650041498631,MATH 18,A04,084121,Harel; Guershon,29,0,30,1
1650041504656,MATH 20B,A01,084124,Um; Ko Woon,13,0,35,22
1650041504656,MATH 20B,B01,084126,Um; Ko Woon,24,0,35,11
1650041510690,MATH 20C,A01,083446,Hammock; Frances H,0,0,30,30
1650041510690,MATH 20C,A02,083447,Hammock; Frances H,16,0,30,14
1650041510690,MATH 20C,A03,083448,Hammock; Frances H,19,0,30,11
1650041510690,MATH 20C,A04,083449,Hammock; Frances H,20,0,30,10
1650041510690,MATH 20C,B01,083451,Hammock; Frances H,0,0,30,30
1650041510690,MATH 20C,B02,083452,Hammock; Frances H,18,0,30,12
1650041510690,MATH 20C,B03,083453,Hammock; Frances H,21,0,30,9
1650041510690,MATH 20C,B04,083454,Hammock; Frances H,23,0,30,7
1650041516719,MATH 20D,A01,084128,Staff,14,0,30,16
1650041516719,MATH 20D,A02,084129,Staff,29,0,30,1
1650041516719,MATH 20D,A03,084130,Staff,27,0,30,3
1650041516719,MATH 20D,B01,084133,Staff,3,0,30,27
1650041516719,MATH 20D,B02,084134,Staff,23,0,30,7
1650041516719,MATH 20D,B03,084135,Staff,28,0,30,2
1650041522743,MATH 20E,A01,084138,Staff,14,0,30,16
1650041522743,MATH 20E,A02,084139,Staff,6,0,30,24
1650041522743,MATH 20E,A03,084140,Staff,15,0,30,15
1650041522743,MATH 20E,A04,084141,Staff,20,0,30,10
1650041528770,MATH 102,A01,084143,Harel; Guershon,12,0,30,18
1650041528770,MATH 102,A02,084144,Harel; Guershon,19,0,30,11
1650041534796,MATH 103B,A01,083456,Staff,0,13,30,30
1650041534796,MATH 103B,A02,083457,Staff,0,14,30,30
1650041540818,MATH 109,A01,084146,Salehi Golsefidy; Alireza,17,0,30,13
1650041540818,MATH 109,A02,084147,Salehi Golsefidy; Alireza,15,0,30,15
1650041546842,MATH 120A,A01,085445,Eggers; John Dietrich,10,0,35,25
1650041546842,MATH 120A,A02,085446,Eggers; John Dietrich,27,0,35,8
1650041552866,MATH 142B,A01,084149,Verstraete; Jacques Allan,0,12,30,30
1650041552866,MATH 142B,A02,084150,Verstraete; Jacques Allan,0,12,30,30
1650041558891,MATH 170A,A01,083459,Nie; Jiawang,0,9,30,30
1650041558891,MATH 170A,A02,083460,Nie; Jiawang,0,8,30,30
1650041558891,MATH 170A,A03,083461,Nie; Jiawang,0,9,30,30
1650041564920,MATH 193B,A01,083463,Staff,1,0,30,29
1650041564920,MATH 193B,A02,083464,Staff,9,0,30,21
1650041564920,MATH 193B,A03,083465,Staff,18,0,30,12
1650041570983,COGS 2,A01,083966,Boyle; Mary E. T.,10,0,30,20
1650041577030,COGS 9,A01,083968,Staff,9,0,60,51
1650041583064,COGS 14B,A01,083970,Staff,9,0,50,41
1650041589090,COGS 17,A01,092679,Staff,50,0,75,25
1650041595112,COGS 100,A01,083972,Staff,0,16,60,60
1650041607165,COGS 101C,A01,083976,Staff,12,0,30,18
1650041613190,COGS 102A,A01,083978,Johnson; Christine M.,13,0,30,17
1650041619217,COGS 107B,A01,083980,Staff,0,7,50,50
1650041625238,COGS 115,A01,083982,Staff,10,0,30,20
1650041631268,COGS 118B,A01,083367,Staff,0,15,40,40
1650041637296,COGS 172,A01,083984,Provenzano; Emily Kara,15,0,30,15
1650041643319,COGS 177,A00,083368,Staff,0,20,30,30
1650041649342,COGS 186,A01,083986,Staff,21,0,40,19
1650041655365,COGS 187A,A01,083988,Boyle; Mary E. T.,20,0,60,40
1650041661394,CSE 8A,A50,084003,Miranda; Gregory Joseph,0,15,15,15
1650041667417,CSE 11,A01,084005,Miranda; Gregory Joseph,0,22,55,55
1650041673444,CSE 20,A01,084007,Staff,0,5,20,20
1650041679467,CSE 21,A01,084009,Staff,0,31,50,50
1650041685491,CSE 30,A01,083370,Cao; Yingjun,0,65,40,40
1650041691513,CSE 100,A01,083372,Cao; Yingjun,0,46,40,40
1650041697535,CSE 101,A01,084011,Staff,0,54,40,40
1650041703560,CSE 141,A01,083374,Eldon; John,0,64,75,75
1650041709583,CSE 141L,A01,083376,Eldon; John,0,70,75,75
1650041715607,CSE 175,A01,084013,Kumar; Rakesh,22,0,25,3
1650041721640,CSE 190,A00,092508,Dubnov; Shlomo,20,0,20,0
1650041727663,ECE 5,A01,084049,Morris; Karcher William,13,0,20,7
1650041733691,ECE 100,A01,084051,Baghdadchi; Saharnaz,0,0,20,20
1650041733691,ECE 100,A02,091916,Baghdadchi; Saharnaz,13,0,20,7
1650041739717,ECE 101,A01,084053,Baghdadchi; Saharnaz,0,0,37,37
1650041739717,ECE 101,A02,084054,Baghdadchi; Saharnaz,30,0,37,7
1650041745748,ECE 107,A01,083390,Staff,26,0,40,14
1650041751773,ECE 148,A01,084056,Silberman; Jack,8,0,12,4
1650041757807,ECE 180,A00,083391,Abi Samra; Nicholas Camill,25,0,30,5
1650041757807,ECE 180,B00,083392,Abi Samra; Nicholas Camill,21,0,30,9
1650041763831,MATH 10B,A01,084110,Staff,0,0,30,30
1650041763831,MATH 10B,A02,084111,Staff,18,0,30,12
1650041763831,MATH 10B,A03,084112,Staff,24,0,30,6
1650041769857,MATH 10C,A01,083443,Staff,0,17,30,30
1650041769857,MATH 10C,A02,083444,Staff,0,16,30,30
1650041769857,MATH 10C,B01,084114,Staff,19,0,30,11
1650041769857,MATH 10C,B02,084115,Staff,25,0,30,5
1650041775881,MATH 18,A01,084117,Harel; Guershon,13,0,30,17
1650041775881,MATH 18,A02,084119,Harel; Guershon,27,0,30,3
1650041775881,MATH 18,A03,084120,Harel; Guershon,30,0,30,0
1650041775881,MATH 18,A04,084121,Harel; Guershon,29,0,30,1
1650041781909,MATH 20B,A01,084124,Um; Ko Woon,13,0,35,22
1650041781909,MATH 20B,B01,084126,Um; Ko Woon,24,0,35,11
1650041787943,MATH 20C,A01,083446,Hammock; Frances H,0,0,30,30
1650041787943,MATH 20C,A02,083447,Hammock; Frances H,16,0,30,14
1650041787943,MATH 20C,A03,083448,Hammock; Frances H,19,0,30,11
1650041787943,MATH 20C,A04,083449,Hammock; Frances H,20,0,30,10
1650041787943,MATH 20C,B01,083451,Hammock; Frances H,0,0,30,30
1650041787943,MATH 20C,B02,083452,Hammock; Frances H,18,0,30,12
1650041787943,MATH 20C,B03,083453,Hammock; Frances H,21,0,30,9
1650041787943,MATH 20C,B04,083454,Hammock; Frances H,23,0,30,7
1650041793968,MATH 20D,A01,084128,Staff,14,0,30,16
1650041793968,MATH 20D,A02,084129,Staff,29,0,30,1
1650041793968,MATH 20D,A03,084130,Staff,27,0,30,3
1650041793968,MATH 20D,B01,084133,Staff,3,0,30,27
1650041793968,MATH 20D,B02,084134,Staff,23,0,30,7
1650041793968,MATH 20D,B03,084135,Staff,28,0,30,2
1650041799991,MATH 20E,A01,084138,Staff,14,0,30,16
1650041799991,MATH 20E,A02,084139,Staff,6,0,30,24
1650041799991,MATH 20E,A03,084140,Staff,15,0,30,15
1650041799991,MATH 20E,A04,084141,Staff,20,0,30,10
1650041806103,MATH 102,A01,084143,Harel; Guershon,12,0,30,18
1650041806103,MATH 102,A02,084144,Harel; Guershon,19,0,30,11
1650041812157,MATH 103B,A01,083456,Staff,0,13,30,30
1650041812157,MATH 103B,A02,083457,Staff,0,14,30,30
1650041818194,MATH 109,A01,084146,Salehi Golsefidy; Alireza,17,0,30,13
1650041818194,MATH 109,A02,084147,Salehi Golsefidy; Alireza,15,0,30,15
1650041824229,MATH 120A,A01,085445,Eggers; John Dietrich,10,0,35,25
1650041824229,MATH 120A,A02,085446,Eggers; John Dietrich,27,0,35,8
1650041830259,MATH 142B,A01,084149,Verstraete; Jacques Allan,0,12,30,30
1650041830259,MATH 142B,A02,084150,Verstraete; Jacques Allan,0,12,30,30
1650041836287,MATH 170A,A01,083459,Nie; Jiawang,0,9,30,30
1650041836287,MATH 170A,A02,083460,Nie; Jiawang,0,8,30,30
1650041836287,MATH 170A,A03,083461,Nie; Jiawang,0,9,30,30
1650041842316,MATH 193B,A01,083463,Staff,1,0,30,29
1650041842316,MATH 193B,A02,083464,Staff,9,0,30,21
1650041842316,MATH 193B,A03,083465,Staff,18,0,30,12
1650041848388,COGS 2,A01,083966,Boyle; Mary E. T.,10,0,30,20
1650041854412,COGS 9,A01,083968,Staff,9,0,60,51
1650041860438,COGS 14B,A01,083970,Staff,9,0,50,41
1650041866465,COGS 17,A01,092679,Staff,50,0,75,25
1650041872495,COGS 100,A01,083972,Staff,0,16,60,60
1650041884555,COGS 101C,A01,083976,Staff,12,0,30,18
1650041890577,COGS 102A,A01,083978,Johnson; Christine M.,13,0,30,17
1650041896611,COGS 107B,A01,083980,Staff,0,7,50,50
1650041902635,COGS 115,A01,083982,Staff,10,0,30,20
1650041908661,COGS 118B,A01,083367,Staff,0,15,40,40
1650041914691,COGS 172,A01,083984,Provenzano; Emily Kara,15,0,30,15
1650041920720,COGS 177,A00,083368,Staff,0,20,30,30
1650041926746,COGS 186,A01,083986,Staff,21,0,40,19
1650041932777,COGS 187A,A01,083988,Boyle; Mary E. T.,20,0,60,40
1650041938800,CSE 8A,A50,084003,Miranda; Gregory Joseph,0,15,15,15
1650041944829,CSE 11,A01,084005,Miranda; Gregory Joseph,0,22,55,55
1650041950860,CSE 20,A01,084007,Staff,0,5,20,20
1650041956885,CSE 21,A01,084009,Staff,0,31,50,50
1650041962914,CSE 30,A01,083370,Cao; Yingjun,0,65,40,40
1650041968936,CSE 100,A01,083372,Cao; Yingjun,0,46,40,40
1650041974960,CSE 101,A01,084011,Staff,0,54,40,40
1650041980989,CSE 141,A01,083374,Eldon; John,0,64,75,75
1650041987017,CSE 141L,A01,083376,Eldon; John,0,70,75,75
1650041993043,CSE 175,A01,084013,Kumar; Rakesh,22,0,25,3
1650041999078,CSE 190,A00,092508,Dubnov; Shlomo,20,0,20,0
1650042005110,ECE 5,A01,084049,Morris; Karcher William,13,0,20,7
1650042011135,ECE 100,A01,084051,Baghdadchi; Saharnaz,0,0,20,20
1650042011135,ECE 100,A02,091916,Baghdadchi; Saharnaz,13,0,20,7
1650042017163,ECE 101,A01,084053,Baghdadchi; Saharnaz,0,0,37,37
1650042017163,ECE 101,A02,084054,Baghdadchi; Saharnaz,30,0,37,7
1650042023200,ECE 107,A01,083390,Staff,26,0,40,14
1650042029224,ECE 148,A01,084056,Silberman; Jack,8,0,12,4
1650042035252,ECE 180,A00,083391,Abi Samra; Nicholas Camill,25,0,30,5
1650042035252,ECE 180,B00,083392,Abi Samra; Nicholas Camill,21,0,30,9
1650042041278,MATH 10B,A01,084110,Staff,0,0,30,30
1650042041278,MATH 10B,A02,084111,Staff,18,0,30,12
1650042041278,MATH 10B,A03,084112,Staff,24,0,30,6
1650042047301,MATH 10C,A01,083443,Staff,0,17,30,30
1650042047301,MATH 10C,A02,083444,Staff,0,16,30,30
1650042047301,MATH 10C,B01,084114,Staff,19,0,30,11
1650042047301,MATH 10C,B02,084115,Staff,25,0,30,5
1650042053327,MATH 18,A01,084117,Harel; Guershon,13,0,30,17
1650042053327,MATH 18,A02,084119,Harel; Guershon,27,0,30,3
1650042053327,MATH 18,A03,084120,Harel; Guershon,30,0,30,0
1650042053327,MATH 18,A04,084121,Harel; Guershon,29,0,30,1
1650042059356,MATH 20B,A01,084124,Um; Ko Woon,13,0,35,22
1650042059356,MATH 20B,B01,084126,Um; Ko Woon,24,0,35,11
1650042065396,MATH 20C,A01,083446,Hammock; Frances H,0,0,30,30
1650042065396,MATH 20C,A02,083447,Hammock; Frances H,16,0,30,14
1650042065396,MATH 20C,A03,083448,Hammock; Frances H,19,0,30,11
1650042065396,MATH 20C,A04,083449,Hammock; Frances H,20,0,30,10
1650042065396,MATH 20C,B01,083451,Hammock; Frances H,0,0,30,30
1650042065396,MATH 20C,B02,083452,Hammock; Frances H,18,0,30,12
1650042065396,MATH 20C,B03,083453,Hammock; Frances H,21,0,30,9
1650042065396,MATH 20C,B04,083454,Hammock; Frances H,23,0,30,7
1650042071424,MATH 20D,A01,084128,Staff,14,0,30,16
1650042071424,MATH 20D,A02,084129,Staff,29,0,30,1
1650042071424,MATH 20D,A03,084130,Staff,27,0,30,3
1650042071424,MATH 20D,B01,084133,Staff,3,0,30,27
1650042071424,MATH 20D,B02,084134,Staff,23,0,30,7
1650042071424,MATH 20D,B03,084135,Staff,28,0,30,2
1650042077448,MATH 20E,A01,084138,Staff,14,0,30,16
1650042077448,MATH 20E,A02,084139,Staff,6,0,30,24
1650042077448,MATH 20E,A03,084140,Staff,15,0,30,15
1650042077448,MATH 20E,A04,084141,Staff,20,0,30,10
1650042083478,MATH 102,A01,084143,Harel; Guershon,12,0,30,18
1650042083478,MATH 102,A02,084144,Harel; Guershon,19,0,30,11
1650042089520,MATH 103B,A01,083456,Staff,0,13,30,30
1650042089520,MATH 103B,A02,083457,Staff,0,14,30,30
1650042095550,MATH 109,A01,084146,Salehi Golsefidy; Alireza,17,0,30,13
1650042095550,MATH 109,A02,084147,Salehi Golsefidy; Alireza,15,0,30,15
1650042101578,MATH 120A,A01,085445,Eggers; John Dietrich,10,0,35,25
1650042101578,MATH 120A,A02,085446,Eggers; John Dietrich,27,0,35,8
1650042107604,MATH 142B,A01,084149,Verstraete; Jacques Allan,0,12,30,30
1650042107604,MATH 142B,A02,084150,Verstraete; Jacques Allan,0,12,30,30
1650042113630,MATH 170A,A01,083459,Nie; Jiawang,0,9,30,30
1650042113630,MATH 170A,A02,083460,Nie; Jiawang,0,8,30,30
1650042113630,MATH 170A,A03,083461,Nie; Jiawang,0,9,30,30
1650042119658,MATH 193B,A01,083463,Staff,1,0,30,29
1650042119658,MATH 193B,A02,083464,Staff,9,0,30,21
1650042119658,MATH 193B,A03,083465,Staff,18,0,30,12
1650042125817,COGS 2,A01,083966,Boyle; Mary E. T.,10,0,30,20
1650042131842,COGS 9,A01,083968,Staff,9,0,60,51
1650042137873,COGS 14B,A01,083970,Staff,9,0,50,41
1650042143902,COGS 17,A01,092679,Staff,50,0,75,25
1650042149925,COGS 100,A01,083972,Staff,0,16,60,60
1650042161984,COGS 101C,A01,083976,Staff,12,0,30,18
1650042168007,COGS 102A,A01,083978,Johnson; Christine M.,13,0,30,17
1650042174034,COGS 107B,A01,083980,Staff,0,7,50,50
1650042180066,COGS 115,A01,083982,Staff,10,0,30,20
1650042186098,COGS 118B,A01,083367,Staff,0,15,40,40
1650042192131,COGS 172,A01,083984,Provenzano; Emily Kara,15,0,30,15
1650042198161,COGS 177,A00,083368,Staff,0,20,30,30
1650042204187,COGS 186,A01,083986,Staff,21,0,40,19
1650042210223,COGS 187A,A01,083988,Boyle; Mary E. T.,20,0,60,40
1650042216247,CSE 8A,A50,084003,Miranda; Gregory Joseph,0,15,15,15
1650042222274,CSE 11,A01,084005,Miranda; Gregory Joseph,0,22,55,55
1650042228300,CSE 20,A01,084007,Staff,0,5,20,20
1650042234323,CSE 21,A01,084009,Staff,0,31,50,50
1650042240355,CSE 30,A01,083370,Cao; Yingjun,0,65,40,40
1650042246382,CSE 100,A01,083372,Cao; Yingjun,0,46,40,40
1650042252409,CSE 101,A01,084011,Staff,0,54,40,40
1650042258432,CSE 141,A01,083374,Eldon; John,0,64,75,75
1650042264468,CSE 141L,A01,083376,Eldon; John,0,70,75,75
1650042270494,CSE 175,A01,084013,Kumar; Rakesh,22,0,25,3
1650042276520,CSE 190,A00,092508,Dubnov; Shlomo,20,0,20,0
1650042282546,ECE 5,A01,084049,Morris; Karcher William,13,0,20,7
1650042288573,ECE 100,A01,084051,Baghdadchi; Saharnaz,0,0,20,20
1650042288573,ECE 100,A02,091916,Baghdadchi; Saharnaz,13,0,20,7
1650042294603,ECE 101,A01,084053,Baghdadchi; Saharnaz,0,0,37,37
1650042294603,ECE 101,A02,084054,Baghdadchi; Saharnaz,30,0,37,7
1650042300630,ECE 107,A01,083390,Staff,26,0,40,14
1650042306662,ECE 148,A01,084056,Silberman; Jack,8,0,12,4
1650042312689,ECE 180,A00,083391,Abi Samra; Nicholas Camill,25,0,30,5
1650042312689,ECE 180,B00,083392,Abi Samra; Nicholas Camill,21,0,30,9
1650042318713,MATH 10B,A01,084110,Staff,0,0,30,30
1650042318713,MATH 10B,A02,084111,Staff,18,0,30,12
1650042318713,MATH 10B,A03,084112,Staff,24,0,30,6
1650042324741,MATH 10C,A01,083443,Staff,0,17,30,30
1650042324741,MATH 10C,A02,083444,Staff,0,16,30,30
1650042324741,MATH 10C,B01,084114,Staff,19,0,30,11
1650042324741,MATH 10C,B02,084115,Staff,25,0,30,5
1650042330765,MATH 18,A01,084117,Harel; Guershon,13,0,30,17
1650042330765,MATH 18,A02,084119,Harel; Guershon,27,0,30,3
1650042330765,MATH 18,A03,084120,Harel; Guershon,30,0,30,0
1650042330765,MATH 18,A04,084121,Harel; Guershon,29,0,30,1
1650042336791,MATH 20B,A01,084124,Um; Ko Woon,13,0,35,22
1650042336791,MATH 20B,B01,084126,Um; Ko Woon,24,0,35,11
1650042342821,MATH 20C,A01,083446,Hammock; Frances H,0,0,30,30
1650042342821,MATH 20C,A02,083447,Hammock; Frances H,15,0,30,15
1650042342821,MATH 20C,A03,083448,Hammock; Frances H,19,0,30,11
1650042342821,MATH 20C,A04,083449,Hammock; Frances H,20,0,30,10
1650042342821,MATH 20C,B01,083451,Hammock; Frances H,0,0,30,30
1650042342821,MATH 20C,B02,083452,Hammock; Frances H,18,0,30,12
1650042342821,MATH 20C,B03,083453,Hammock; Frances H,21,0,30,9
1650042342821,MATH 20C,B04,083454,Hammock; Frances H,23,0,30,7
1650042348852,MATH 20D,A01,084128,Staff,14,0,30,16
1650042348852,MATH 20D,A02,084129,Staff,29,0,30,1
1650042348852,MATH 20D,A03,084130,Staff,27,0,30,3
1650042348852,MATH 20D,B01,084133,Staff,3,0,30,27
1650042348852,MATH 20D,B02,084134,Staff,23,0,30,7
1650042348852,MATH 20D,B03,084135,Staff,28,0,30,2
1650042354879,MATH 20E,A01,084138,Staff,14,0,30,16
1650042354879,MATH 20E,A02,084139,Staff,6,0,30,24
1650042354879,MATH 20E,A03,084140,Staff,15,0,30,15
1650042354879,MATH 20E,A04,084141,Staff,20,0,30,10
1650042360909,MATH 102,A01,084143,Harel; Guershon,12,0,30,18
1650042360909,MATH 102,A02,084144,Harel; Guershon,19,0,30,11
1650042366932,MATH 103B,A01,083456,Staff,0,13,30,30
1650042366932,MATH 103B,A02,083457,Staff,0,14,30,30
1650042372960,MATH 109,A01,084146,Salehi Golsefidy; Alireza,17,0,30,13
1650042372960,MATH 109,A02,084147,Salehi Golsefidy; Alireza,15,0,30,15
1650042378983,MATH 120A,A01,085445,Eggers; John Dietrich,10,0,35,25
1650042378983,MATH 120A,A02,085446,Eggers; John Dietrich,27,0,35,8
1650042385007,MATH 142B,A01,084149,Verstraete; Jacques Allan,0,12,30,30
1650042385007,MATH 142B,A02,084150,Verstraete; Jacques Allan,0,12,30,30
1650042391039,MATH 170A,A01,083459,Nie; Jiawang,0,9,30,30
1650042391039,MATH 170A,A02,083460,Nie; Jiawang,0,8,30,30
1650042391039,MATH 170A,A03,083461,Nie; Jiawang,0,9,30,30
1650042397066,MATH 193B,A01,083463,Staff,1,0,30,29
1650042397066,MATH 193B,A02,083464,Staff,9,0,30,21
1650042397066,MATH 193B,A03,083465,Staff,18,0,30,12
1650042403221,COGS 2,A01,083966,Boyle; Mary E. T.,10,0,30,20
1650042409245,COGS 9,A01,083968,Staff,9,0,60,51
1650042415271,COGS 14B,A01,083970,Staff,9,0,50,41
1650042421298,COGS 17,A01,092679,Staff,50,0,75,25
1650042427338,COGS 100,A01,083972,Staff,0,16,60,60
1650042439387,COGS 101C,A01,083976,Staff,12,0,30,18
1650042445410,COGS 102A,A01,083978,Johnson; Christine M.,13,0,30,17
1650042451434,COGS 107B,A01,083980,Staff,0,7,50,50
1650042457457,COGS 115,A01,083982,Staff,10,0,30,20
1650042463481,COGS 118B,A01,083367,Staff,0,15,40,40
1650042469508,COGS 172,A01,083984,Provenzano; Emily Kara,15,0,30,15
1650042475532,COGS 177,A00,083368,Staff,0,20,30,30
1650042481563,COGS 186,A01,083986,Staff,21,0,40,19
1650042487599,COGS 187A,A01,083988,Boyle; Mary E. T.,20,0,60,40
1650042493626,CSE 8A,A50,084003,Miranda; Gregory Joseph,0,15,15,15
1650042499655,CSE 11,A01,084005,Miranda; Gregory Joseph,0,22,55,55
1650042505682,CSE 20,A01,084007,Staff,0,5,20,20
1650042511706,CSE 21,A01,084009,Staff,0,31,50,50
1650042517735,CSE 30,A01,083370,Cao; Yingjun,0,65,40,40
1650042523758,CSE 100,A01,083372,Cao; Yingjun,0,46,40,40
1650042529782,CSE 101,A01,084011,Staff,0,54,40,40
1650042535811,CSE 141,A01,083374,Eldon; John,0,64,75,75
1650042541834,CSE 141L,A01,083376,Eldon; John,0,70,75,75
1650042547858,CSE 175,A01,084013,Kumar; Rakesh,22,0,25,3
1650042553884,CSE 190,A00,092508,Dubnov; Shlomo,20,0,20,0
1650042559909,ECE 5,A01,084049,Morris; Karcher William,13,0,20,7
1650042565933,ECE 100,A01,084051,Baghdadchi; Saharnaz,0,0,20,20
1650042565933,ECE 100,A02,091916,Baghdadchi; Saharnaz,13,0,20,7
1650042571961,ECE 101,A01,084053,Baghdadchi; Saharnaz,0,0,37,37
1650042571961,ECE 101,A02,084054,Baghdadchi; Saharnaz,30,0,37,7
1650042577987,ECE 107,A01,083390,Staff,26,0,40,14
1650042584017,ECE 148,A01,084056,Silberman; Jack,8,0,12,4
1650042590041,ECE 180,A00,083391,Abi Samra; Nicholas Camill,25,0,30,5
1650042590041,ECE 180,B00,083392,Abi Samra; Nicholas Camill,21,0,30,9
1650042596076,MATH 10B,A01,084110,Staff,0,0,30,30
1650042596076,MATH 10B,A02,084111,Staff,18,0,30,12
1650042596076,MATH 10B,A03,084112,Staff,24,0,30,6
1650042602102,MATH 10C,A01,083443,Staff,0,17,30,30
1650042602102,MATH 10C,A02,083444,Staff,0,16,30,30
1650042602102,MATH 10C,B01,084114,Staff,19,0,30,11
1650042602102,MATH 10C,B02,084115,Staff,25,0,30,5
1650042608129,MATH 18,A01,084117,Harel; Guershon,13,0,30,17
1650042608129,MATH 18,A02,084119,Harel; Guershon,27,0,30,3
1650042608129,MATH 18,A03,084120,Harel; Guershon,30,0,30,0
1650042608129,MATH 18,A04,084121,Harel; Guershon,29,0,30,1
1650042614153,MATH 20B,A01,084124,Um; Ko Woon,13,0,35,22
1650042614153,MATH 20B,B01,084126,Um; Ko Woon,24,0,35,11
1650042620186,MATH 20C,A01,083446,Hammock; Frances H,0,0,30,30
1650042620186,MATH 20C,A02,083447,Hammock; Frances H,15,0,30,15
1650042620186,MATH 20C,A03,083448,Hammock; Frances H,19,0,30,11
1650042620186,MATH 20C,A04,083449,Hammock; Frances H,20,0,30,10
1650042620186,MATH 20C,B01,083451,Hammock; Frances H,0,0,30,30
1650042620186,MATH 20C,B02,083452,Hammock; Frances H,18,0,30,12
1650042620186,MATH 20C,B03,083453,Hammock; Frances H,21,0,30,9
1650042620186,MATH 20C,B04,083454,Hammock; Frances H,23,0,30,7
1650042626214,MATH 20D,A01,084128,Staff,14,0,30,16
1650042626214,MATH 20D,A02,084129,Staff,29,0,30,1
1650042626214,MATH 20D,A03,084130,Staff,27,0,30,3
1650042626214,MATH 20D,B01,084133,Staff,3,0,30,27
1650042626214,MATH 20D,B02,084134,Staff,23,0,30,7
1650042626214,MATH 20D,B03,084135,Staff,28,0,30,2
1650042632238,MATH 20E,A01,084138,Staff,13,0,30,17
1650042632238,MATH 20E,A02,084139,Staff,6,0,30,24
1650042632238,MATH 20E,A03,084140,Staff,15,0,30,15
1650042632238,MATH 20E,A04,084141,Staff,20,0,30,10
1650042638262,MATH 102,A01,084143,Harel; Guershon,12,0,30,18
1650042638262,MATH 102,A02,084144,Harel; Guershon,19,0,30,11
1650042644297,MATH 103B,A01,083456,Staff,0,13,30,30
1650042644297,MATH 103B,A02,083457,Staff,0,14,30,30
1650042650323,MATH 109,A01,084146,Salehi Golsefidy; Alireza,17,0,30,13
1650042650323,MATH 109,A02,084147,Salehi Golsefidy; Alireza,15,0,30,15
1650042656359,MATH 120A,A01,085445,Eggers; John Dietrich,10,0,35,25
1650042656359,MATH 120A,A02,085446,Eggers; John Dietrich,27,0,35,8
1650042662382,MATH 142B,A01,084149,Verstraete; Jacques Allan,0,12,30,30
1650042662382,MATH 142B,A02,084150,Verstraete; Jacques Allan,0,12,30,30
1650042668412,MATH 170A,A01,083459,Nie; Jiawang,0,9,30,30
1650042668412,MATH 170A,A02,083460,Nie; Jiawang,0,8,30,30
1650042668412,MATH 170A,A03,083461,Nie; Jiawang,0,9,30,30
1650042674444,MATH 193B,A01,083463,Staff,1,0,30,29
1650042674444,MATH 193B,A02,083464,Staff,9,0,30,21
1650042674444,MATH 193B,A03,083465,Staff,18,0,30,12
1650042680517,COGS 2,A01,083966,Boyle; Mary E. T.,10,0,30,20
1650042686541,COGS 9,A01,083968,Staff,9,0,60,51
1650042692569,COGS 14B,A01,083970,Staff,9,0,50,41
1650042698596,COGS 17,A01,092679,Staff,50,0,75,25
1650042704620,COGS 100,A01,083972,Staff,0,16,60,60
1650042716672,COGS 101C,A01,083976,Staff,12,0,30,18
1650042722697,COGS 102A,A01,083978,Johnson; Christine M.,13,0,30,17
1650042728721,COGS 107B,A01,083980,Staff,0,7,50,50
1650042734744,COGS 115,A01,083982,Staff,10,0,30,20
1650042740768,COGS 118B,A01,083367,Staff,0,15,40,40
1650042746795,COGS 172,A01,083984,Provenzano; Emily Kara,15,0,30,15
1650042752839,COGS 177,A00,083368,Staff,0,20,30,30
1650042758868,COGS 186,A01,083986,Staff,21,0,40,19
1650042764892,COGS 187A,A01,083988,Boyle; Mary E. T.,20,0,60,40
1650042770917,CSE 8A,A50,084003,Miranda; Gregory Joseph,0,15,15,15
1650042776939,CSE 11,A01,084005,Miranda; Gregory Joseph,0,22,55,55
1650042782973,CSE 20,A01,084007,Staff,0,5,20,20
1650042788998,CSE 21,A01,084009,Staff,0,31,50,50
1650042795023,CSE 30,A01,083370,Cao; Yingjun,0,65,40,40
1650042801045,CSE 100,A01,083372,Cao; Yingjun,0,46,40,40
1650042807069,CSE 101,A01,084011,Staff,0,54,40,40
1650042813094,CSE 141,A01,083374,Eldon; John,0,64,75,75
1650042819125,CSE 141L,A01,083376,Eldon; John,0,70,75,75
1650042825149,CSE 175,A01,084013,Kumar; Rakesh,22,0,25,3
1650042831174,CSE 190,A00,092508,Dubnov; Shlomo,20,0,20,0
1650042837197,ECE 5,A01,084049,Morris; Karcher William,13,0,20,7
1650042843235,ECE 100,A01,084051,Baghdadchi; Saharnaz,0,0,20,20
1650042843235,ECE 100,A02,091916,Baghdadchi; Saharnaz,13,0,20,7
1650042849260,ECE 101,A01,084053,Baghdadchi; Saharnaz,0,0,37,37
1650042849260,ECE 101,A02,084054,Baghdadchi; Saharnaz,30,0,37,7
1650042855286,ECE 107,A01,083390,Staff,26,0,40,14
1650042861311,ECE 148,A01,084056,Silberman; Jack,8,0,12,4
1650042867336,ECE 180,A00,083391,Abi Samra; Nicholas Camill,25,0,30,5
1650042867336,ECE 180,B00,083392,Abi Samra; Nicholas Camill,21,0,30,9
1650042873363,MATH 10B,A01,084110,Staff,0,0,30,30
1650042873363,MATH 10B,A02,084111,Staff,18,0,30,12
1650042873363,MATH 10B,A03,084112,Staff,24,0,30,6
1650042879386,MATH 10C,A01,083443,Staff,0,17,30,30
1650042879386,MATH 10C,A02,083444,Staff,0,16,30,30
1650042879386,MATH 10C,B01,084114,Staff,19,0,30,11
1650042879386,MATH 10C,B02,084115,Staff,25,0,30,5
1650042885414,MATH 18,A01,084117,Harel; Guershon,13,0,30,17
1650042885414,MATH 18,A02,084119,Harel; Guershon,27,0,30,3
1650042885414,MATH 18,A03,084120,Harel; Guershon,30,0,30,0
1650042885414,MATH 18,A04,084121,Harel; Guershon,29,0,30,1
1650042891439,MATH 20B,A01,084124,Um; Ko Woon,13,0,35,22
1650042891439,MATH 20B,B01,084126,Um; Ko Woon,24,0,35,11
1650042897466,MATH 20C,A01,083446,Hammock; Frances H,0,0,30,30
1650042897466,MATH 20C,A02,083447,Hammock; Frances H,15,0,30,15
1650042897466,MATH 20C,A03,083448,Hammock; Frances H,19,0,30,11
1650042897466,MATH 20C,A04,083449,Hammock; Frances H,20,0,30,10
1650042897466,MATH 20C,B01,083451,Hammock; Frances H,0,0,30,30
1650042897466,MATH 20C,B02,083452,Hammock; Frances H,18,0,30,12
1650042897466,MATH 20C,B03,083453,Hammock; Frances H,21,0,30,9
1650042897466,MATH 20C,B04,083454,Hammock; Frances H,23,0,30,7
1650042903490,MATH 20D,A01,084128,Staff,14,0,30,16
1650042903490,MATH 20D,A02,084129,Staff,29,0,30,1
1650042903490,MATH 20D,A03,084130,Staff,27,0,30,3
1650042903490,MATH 20D,B01,084133,Staff,3,0,30,27
1650042903490,MATH 20D,B02,084134,Staff,23,0,30,7
1650042903490,MATH 20D,B03,084135,Staff,28,0,30,2
1650042909517,MATH 20E,A01,084138,Staff,13,0,30,17
1650042909517,MATH 20E,A02,084139,Staff,6,0,30,24
1650042909517,MATH 20E,A03,084140,Staff,15,0,30,15
1650042909517,MATH 20E,A04,084141,Staff,20,0,30,10
1650042915545,MATH 102,A01,084143,Harel; Guershon,12,0,30,18
1650042915545,MATH 102,A02,084144,Harel; Guershon,19,0,30,11
1650042921572,MATH 103B,A01,083456,Staff,0,13,30,30
1650042921572,MATH 103B,A02,083457,Staff,0,14,30,30
1650042927600,MATH 109,A01,084146,Salehi Golsefidy; Alireza,17,0,30,13
1650042927600,MATH 109,A02,084147,Salehi Golsefidy; Alireza,15,0,30,15
1650042933629,MATH 120A,A01,085445,Eggers; John Dietrich,10,0,35,25
1650042933629,MATH 120A,A02,085446,Eggers; John Dietrich,27,0,35,8
1650042939655,MATH 142B,A01,084149,Verstraete; Jacques Allan,0,12,30,30
1650042939655,MATH 142B,A02,084150,Verstraete; Jacques Allan,0,12,30,30
1650042945682,MATH 170A,A01,083459,Nie; Jiawang,0,9,30,30
1650042945682,MATH 170A,A02,083460,Nie; Jiawang,0,8,30,30
1650042945682,MATH 170A,A03,083461,Nie; Jiawang,0,9,30,30
1650042951713,MATH 193B,A01,083463,Staff,1,0,30,29
1650042951713,MATH 193B,A02,083464,Staff,9,0,30,21
1650042951713,MATH 193B,A03,083465,Staff,18,0,30,12
1650042957764,COGS 2,A01,083966,Boyle; Mary E. T.,10,0,30,20
1650042963803,COGS 9,A01,083968,Staff,9,0,60,51
1650042969837,COGS 14B,A01,083970,Staff,9,0,50,41
1650042975864,COGS 17,A01,092679,Staff,50,0,75,25
1650042981892,COGS 100,A01,083972,Staff,0,16,60,60
1650042994039,COGS 101C,A01,083976,Staff,12,0,30,18
1650043000068,COGS 102A,A01,083978,Johnson; Christine M.,13,0,30,17
1650043006092,COGS 107B,A01,083980,Staff,0,7,50,50
1650043012115,COGS 115,A01,083982,Staff,10,0,30,20
1650043018142,COGS 118B,A01,083367,Staff,0,15,40,40
1650043024166,COGS 172,A01,083984,Provenzano; Emily Kara,15,0,30,15
1650043030195,COGS 177,A00,083368,Staff,0,20,30,30
1650043036222,COGS 186,A01,083986,Staff,21,0,40,19
1650043042245,COGS 187A,A01,083988,Boyle; Mary E. T.,20,0,60,40
1650043048272,CSE 8A,A50,084003,Miranda; Gregory Joseph,0,15,15,15
1650043054296,CSE 11,A01,084005,Miranda; Gregory Joseph,0,22,55,55
1650043060320,CSE 20,A01,084007,Staff,0,5,20,20
1650043066345,CSE 21,A01,084009,Staff,0,31,50,50
1650043072369,CSE 30,A01,083370,Cao; Yingjun,0,65,40,40
1650043078405,CSE 100,A01,083372,Cao; Yingjun,0,46,40,40
1650043084429,CSE 101,A01,084011,Staff,0,54,40,40
1650043090459,CSE 141,A01,083374,Eldon; John,0,64,75,75
1650043096485,CSE 141L,A01,083376,Eldon; John,0,70,75,75
1650043102511,CSE 175,A01,084013,Kumar; Rakesh,22,0,25,3
1650043108535,CSE 190,A00,092508,Dubnov; Shlomo,19,0,20,1
1650043114557,ECE 5,A01,084049,Morris; Karcher William,13,0,20,7
1650043120588,ECE 100,A01,084051,Baghdadchi; Saharnaz,0,0,20,20
1650043120588,ECE 100,A02,091916,Baghdadchi; Saharnaz,13,0,20,7
1650043126615,ECE 101,A01,084053,Baghdadchi; Saharnaz,0,0,37,37
1650043126615,ECE 101,A02,084054,Baghdadchi; Saharnaz,30,0,37,7
1650043132643,ECE 107,A01,083390,Staff,26,0,40,14
1650043138668,ECE 148,A01,084056,Silberman; Jack,8,0,12,4
1650043144694,ECE 180,A00,083391,Abi Samra; Nicholas Camill,25,0,30,5
1650043144694,ECE 180,B00,083392,Abi Samra; Nicholas Camill,21,0,30,9
1650043150729,MATH 10B,A01,084110,Staff,0,0,30,30
1650043150729,MATH 10B,A02,084111,Staff,18,0,30,12
1650043150729,MATH 10B,A03,084112,Staff,24,0,30,6
1650043156752,MATH 10C,A01,083443,Staff,0,17,30,30
1650043156752,MATH 10C,A02,083444,Staff,0,16,30,30
1650043156752,MATH 10C,B01,084114,Staff,19,0,30,11
1650043156752,MATH 10C,B02,084115,Staff,25,0,30,5
1650043162785,MATH 18,A01,084117,Harel; Guershon,13,0,30,17
1650043162785,MATH 18,A02,084119,Harel; Guershon,27,0,30,3
1650043162785,MATH 18,A03,084120,Harel; Guershon,30,0,30,0
1650043162785,MATH 18,A04,084121,Harel; Guershon,29,0,30,1
1650043168809,MATH 20B,A01,084124,Um; Ko Woon,13,0,35,22
1650043168809,MATH 20B,B01,084126,Um; Ko Woon,24,0,35,11
1650043174833,MATH 20C,A01,083446,Hammock; Frances H,0,0,30,30
1650043174833,MATH 20C,A02,083447,Hammock; Frances H,15,0,30,15
1650043174833,MATH 20C,A03,083448,Hammock; Frances H,19,0,30,11
1650043174833,MATH 20C,A04,083449,Hammock; Frances H,20,0,30,10
1650043174833,MATH 20C,B01,083451,Hammock; Frances H,0,0,30,30
1650043174833,MATH 20C,B02,083452,Hammock; Frances H,18,0,30,12
1650043174833,MATH 20C,B03,083453,Hammock; Frances H,21,0,30,9
1650043174833,MATH 20C,B04,083454,Hammock; Frances H,23,0,30,7
1650043180857,MATH 20D,A01,084128,Staff,14,0,30,16
1650043180857,MATH 20D,A02,084129,Staff,29,0,30,1
1650043180857,MATH 20D,A03,084130,Staff,27,0,30,3
1650043180857,MATH 20D,B01,084133,Staff,3,0,30,27
1650043180857,MATH 20D,B02,084134,Staff,23,0,30,7
1650043180857,MATH 20D,B03,084135,Staff,28,0,30,2
1650043186891,MATH 20E,A01,084138,Staff,13,0,30,17
1650043186891,MATH 20E,A02,084139,Staff,6,0,30,24
1650043186891,MATH 20E,A03,084140,Staff,15,0,30,15
1650043186891,MATH 20E,A04,084141,Staff,20,0,30,10
1650043192918,MATH 102,A01,084143,Harel; Guershon,12,0,30,18
1650043192918,MATH 102,A02,084144,Harel; Guershon,19,0,30,11
1650043198942,MATH 103B,A01,083456,Staff,0,13,30,30
1650043198942,MATH 103B,A02,083457,Staff,0,14,30,30
1650043204967,MATH 109,A01,084146,Salehi Golsefidy; Alireza,17,0,30,13
1650043204967,MATH 109,A02,084147,Salehi Golsefidy; Alireza,15,0,30,15
1650043210990,MATH 120A,A01,085445,Eggers; John Dietrich,10,0,35,25
1650043210990,MATH 120A,A02,085446,Eggers; John Dietrich,27,0,35,8
1650043217014,MATH 142B,A01,084149,Verstraete; Jacques Allan,0,12,30,30
1650043217014,MATH 142B,A02,084150,Verstraete; Jacques Allan,0,12,30,30
1650043223044,MATH 170A,A01,083459,Nie; Jiawang,0,9,30,30
1650043223044,MATH 170A,A02,083460,Nie; Jiawang,0,8,30,30
1650043223044,MATH 170A,A03,083461,Nie; Jiawang,0,9,30,30
1650043229066,MATH 193B,A01,083463,Staff,1,0,30,29
1650043229066,MATH 193B,A02,083464,Staff,9,0,30,21
1650043229066,MATH 193B,A03,083465,Staff,18,0,30,12
1650043235139,COGS 2,A01,083966,Boyle; Mary E. T.,10,0,30,20
1650043241167,COGS 9,A01,083968,Staff,9,0,60,51
1650043247191,COGS 14B,A01,083970,Staff,9,0,50,41
1650043253215,COGS 17,A01,092679,Staff,50,0,75,25
1650043259240,COGS 100,A01,083972,Staff,0,16,60,60
1650043271306,COGS 101C,A01,083976,Staff,12,0,30,18
1650043277334,COGS 102A,A01,083978,Johnson; Christine M.,13,0,30,17
1650043283364,COGS 107B,A01,083980,Staff,0,7,50,50
1650043289386,COGS 115,A01,083982,Staff,10,0,30,20
1650043295412,COGS 118B,A01,083367,Staff,0,15,40,40
1650043301439,COGS 172,A01,083984,Provenzano; Emily Kara,15,0,30,15
1650043307462,COGS 177,A00,083368,Staff,0,20,30,30
1650043313493,COGS 186,A01,083986,Staff,21,0,40,19
1650043319521,COGS 187A,A01,083988,Boyle; Mary E. T.,20,0,60,40
1650043325548,CSE 8A,A50,084003,Miranda; Gregory Joseph,0,15,15,15
1650043331570,CSE 11,A01,084005,Miranda; Gregory Joseph,0,22,55,55
1650043337609,CSE 20,A01,084007,Staff,0,5,20,20
1650043343645,CSE 21,A01,084009,Staff,0,31,50,50
1650043349677,CSE 30,A01,083370,Cao; Yingjun,0,65,40,40
1650043355704,CSE 100,A01,083372,Cao; Yingjun,0,46,40,40
1650043361726,CSE 101,A01,084011,Staff,0,54,40,40
1650043367749,CSE 141,A01,083374,Eldon; John,0,64,75,75
1650043373777,CSE 141L,A01,083376,Eldon; John,0,70,75,75
1650043379800,CSE 175,A01,084013,Kumar; Rakesh,22,0,25,3
1650043385823,CSE 190,A00,092508,Dubnov; Shlomo,19,0,20,1
1650043391858,ECE 5,A01,084049,Morris; Karcher William,13,0,20,7
1650043397898,ECE 100,A01,084051,Baghdadchi; Saharnaz,0,0,20,20
1650043397898,ECE 100,A02,091916,Baghdadchi; Saharnaz,13,0,20,7
1650043403922,ECE 101,A01,084053,Baghdadchi; Saharnaz,0,0,37,37
1650043403922,ECE 101,A02,084054,Baghdadchi; Saharnaz,29,0,37,8
1650043409948,ECE 107,A01,083390,Staff,26,0,40,14
1650043415980,ECE 148,A01,084056,Silberman; Jack,8,0,12,4
1650043422006,ECE 180,A00,083391,Abi Samra; Nicholas Camill,25,0,30,5
1650043422006,ECE 180,B00,083392,Abi Samra; Nicholas Camill,21,0,30,9
1650043428033,MATH 10B,A01,084110,Staff,0,0,30,30
1650043428033,MATH 10B,A02,084111,Staff,18,0,30,12
1650043428033,MATH 10B,A03,084112,Staff,24,0,30,6
1650043434056,MATH 10C,A01,083443,Staff,0,17,30,30
1650043434056,MATH 10C,A02,083444,Staff,0,16,30,30
1650043434056,MATH 10C,B01,084114,Staff,19,0,30,11
1650043434056,MATH 10C,B02,084115,Staff,25,0,30,5
1650043440083,MATH 18,A01,084117,Harel; Guershon,13,0,30,17
1650043440083,MATH 18,A02,084119,Harel; Guershon,27,0,30,3
1650043440083,MATH 18,A03,084120,Harel; Guershon,30,0,30,0
1650043440083,MATH 18,A04,084121,Harel; Guershon,29,0,30,1
1650043446115,MATH 20B,A01,084124,Um; Ko Woon,13,0,35,22
1650043446115,MATH 20B,B01,084126,Um; Ko Woon,24,0,35,11
1650043452149,MATH 20C,A01,083446,Hammock; Frances H,0,0,30,30
1650043452149,MATH 20C,A02,083447,Hammock; Frances H,15,0,30,15
1650043452149,MATH 20C,A03,083448,Hammock; Frances H,19,0,30,11
1650043452149,MATH 20C,A04,083449,Hammock; Frances H,20,0,30,10
1650043452149,MATH 20C,B01,083451,Hammock; Frances H,0,0,30,30
1650043452149,MATH 20C,B02,083452,Hammock; Frances H,18,0,30,12
1650043452149,MATH 20C,B03,083453,Hammock; Frances H,21,0,30,9
1650043452149,MATH 20C,B04,083454,Hammock; Frances H,23,0,30,7
1650043458176,MATH 20D,A01,084128,Staff,14,0,30,16
1650043458176,MATH 20D,A02,084129,Staff,29,0,30,1
1650043458176,MATH 20D,A03,084130,Staff,27,0,30,3
1650043458176,MATH 20D,B01,084133,Staff,2,0,30,28
1650043458176,MATH 20D,B02,084134,Staff,23,0,30,7
1650043458176,MATH 20D,B03,084135,Staff,28,0,30,2
1650043464201,MATH 20E,A01,084138,Staff,13,0,30,17
1650043464201,MATH 20E,A02,084139,Staff,6,0,30,24
1650043464201,MATH 20E,A03,084140,Staff,15,0,30,15
1650043464201,MATH 20E,A04,084141,Staff,20,0,30,10
1650043470225,MATH 102,A01,084143,Harel; Guershon,12,0,30,18
1650043470225,MATH 102,A02,084144,Harel; Guershon,19,0,30,11
1650043476246,MATH 103B,A01,083456,Staff,0,13,30,30
1650043476246,MATH 103B,A02,083457,Staff,0,14,30,30
1650043482271,MATH 109,A01,084146,Salehi Golsefidy; Alireza,17,0,30,13
1650043482271,MATH 109,A02,084147,Salehi Golsefidy; Alireza,15,0,30,15
1650043488296,MATH 120A,A01,085445,Eggers; John Dietrich,10,0,35,25
1650043488296,MATH 120A,A02,085446,Eggers; John Dietrich,27,0,35,8
1650043494320,MATH 142B,A01,084149,Verstraete; Jacques Allan,0,12,30,30
1650043494320,MATH 142B,A02,084150,Verstraete; Jacques Allan,0,12,30,30
1650043500350,MATH 170A,A01,083459,Nie; Jiawang,0,9,30,30
1650043500350,MATH 170A,A02,083460,Nie; Jiawang,0,8,30,30
1650043500350,MATH 170A,A03,083461,Nie; Jiawang,0,9,30,30
1650043506376,MATH 193B,A01,083463,Staff,1,0,30,29
1650043506376,MATH 193B,A02,083464,Staff,9,0,30,21
1650043506376,MATH 193B,A03,083465,Staff,18,0,30,12
1650043512444,COGS 2,A01,083966,Boyle; Mary E. T.,10,0,30,20
1650043518468,COGS 9,A01,083968,Staff,9,0,60,51
1650043524492,COGS 14B,A01,083970,Staff,9,0,50,41
1650043530522,COGS 17,A01,092679,Staff,50,0,75,25
1650043536549,COGS 100,A01,083972,Staff,0,16,60,60
1650043548595,COGS 101C,A01,083976,Staff,12,0,30,18
1650043554621,COGS 102A,A01,083978,Johnson; Christine M.,13,0,30,17
1650043560652,COGS 107B,A01,083980,Staff,0,7,50,50
1650043566676,COGS 115,A01,083982,Staff,10,0,30,20
1650043572704,COGS 118B,A01,083367,Staff,0,15,40,40
1650043578734,COGS 172,A01,083984,Provenzano; Emily Kara,15,0,30,15
1650043584760,COGS 177,A00,083368,Staff,0,20,30,30
1650043590880,COGS 186,A01,083986,Staff,21,0,40,19
1650043596911,COGS 187A,A01,083988,Boyle; Mary E. T.,20,0,60,40
1650043602937,CSE 8A,A50,084003,Miranda; Gregory Joseph,0,15,15,15
1650043608979,CSE 11,A01,084005,Miranda; Gregory Joseph,0,22,55,55
1650043615004,CSE 20,A01,084007,Staff,0,5,20,20
1650043621040,CSE 21,A01,084009,Staff,0,31,50,50
1650043627062,CSE 30,A01,083370,Cao; Yingjun,0,65,40,40
1650043633088,CSE 100,A01,083372,Cao; Yingjun,0,46,40,40
1650043639111,CSE 101,A01,084011,Staff,0,54,40,40
1650043645136,CSE 141,A01,083374,Eldon; John,0,64,75,75
1650043651162,CSE 141L,A01,083376,Eldon; John,0,70,75,75
1650043657189,CSE 175,A01,084013,Kumar; Rakesh,22,0,25,3
1650043663214,CSE 190,A00,092508,Dubnov; Shlomo,19,0,20,1
1650043669237,ECE 5,A01,084049,Morris; Karcher William,13,0,20,7
1650043675260,ECE 100,A01,084051,Baghdadchi; Saharnaz,0,0,20,20
1650043675260,ECE 100,A02,091916,Baghdadchi; Saharnaz,13,0,20,7
1650043681289,ECE 101,A01,084053,Baghdadchi; Saharnaz,0,0,37,37
1650043681289,ECE 101,A02,084054,Baghdadchi; Saharnaz,29,0,37,8
1650043687322,ECE 107,A01,083390,Staff,26,0,40,14
1650043693346,ECE 148,A01,084056,Silberman; Jack,8,0,12,4
1650043699370,ECE 180,A00,083391,Abi Samra; Nicholas Camill,25,0,30,5
1650043699370,ECE 180,B00,083392,Abi Samra; Nicholas Camill,21,0,30,9
1650043705399,MATH 10B,A01,084110,Staff,0,0,30,30
1650043705399,MATH 10B,A02,084111,Staff,17,0,30,13
1650043705399,MATH 10B,A03,084112,Staff,24,0,30,6
1650043711428,MATH 10C,A01,083443,Staff,0,17,30,30
1650043711428,MATH 10C,A02,083444,Staff,0,16,30,30
1650043711428,MATH 10C,B01,084114,Staff,19,0,30,11
1650043711428,MATH 10C,B02,084115,Staff,25,0,30,5
1650043717460,MATH 18,A01,084117,Harel; Guershon,13,0,30,17
1650043717460,MATH 18,A02,084119,Harel; Guershon,27,0,30,3
1650043717460,MATH 18,A03,084120,Harel; Guershon,30,0,30,0
1650043717460,MATH 18,A04,084121,Harel; Guershon,29,0,30,1
1650043723497,MATH 20B,A01,084124,Um; Ko Woon,13,0,35,22
1650043723497,MATH 20B,B01,084126,Um; Ko Woon,24,0,35,11
1650043729526,MATH 20C,A01,083446,Hammock; Frances H,0,0,30,30
1650043729526,MATH 20C,A02,083447,Hammock; Frances H,15,0,30,15
1650043729526,MATH 20C,A03,083448,Hammock; Frances H,19,0,30,11
1650043729526,MATH 20C,A04,083449,Hammock; Frances H,20,0,30,10
1650043729526,MATH 20C,B01,083451,Hammock; Frances H,0,0,30,30
1650043729526,MATH 20C,B02,083452,Hammock; Frances H,18,0,30,12
1650043729526,MATH 20C,B03,083453,Hammock; Frances H,21,0,30,9
1650043729526,MATH 20C,B04,083454,Hammock; Frances H,23,0,30,7
1650043735550,MATH 20D,A01,084128,Staff,14,0,30,16
1650043735550,MATH 20D,A02,084129,Staff,29,0,30,1
1650043735550,MATH 20D,A03,084130,Staff,27,0,30,3
1650043735550,MATH 20D,B01,084133,Staff,2,0,30,28
1650043735550,MATH 20D,B02,084134,Staff,23,0,30,7
1650043735550,MATH 20D,B03,084135,Staff,28,0,30,2
1650043741580,MATH 20E,A01,084138,Staff,13,0,30,17
1650043741580,MATH 20E,A02,084139,Staff,6,0,30,24
1650043741580,MATH 20E,A03,084140,Staff,15,0,30,15
1650043741580,MATH 20E,A04,084141,Staff,20,0,30,10
1650043747610,MATH 102,A01,084143,Harel; Guershon,12,0,30,18
1650043747610,MATH 102,A02,084144,Harel; Guershon,19,0,30,11
1650043753638,MATH 103B,A01,083456,Staff,0,13,30,30
1650043753638,MATH 103B,A02,083457,Staff,0,14,30,30
1650043759664,MATH 109,A01,084146,Salehi Golsefidy; Alireza,17,0,30,13
1650043759664,MATH 109,A02,084147,Salehi Golsefidy; Alireza,15,0,30,15
1650043765692,MATH 120A,A01,085445,Eggers; John Dietrich,10,0,35,25
1650043765692,MATH 120A,A02,085446,Eggers; John Dietrich,27,0,35,8
1650043771715,MATH 142B,A01,084149,Verstraete; Jacques Allan,0,12,30,30
1650043771715,MATH 142B,A02,084150,Verstraete; Jacques Allan,0,12,30,30
1650043777740,MATH 170A,A01,083459,Nie; Jiawang,0,9,30,30
1650043777740,MATH 170A,A02,083460,Nie; Jiawang,0,8,30,30
1650043777740,MATH 170A,A03,083461,Nie; Jiawang,0,9,30,30
1650043783773,MATH 193B,A01,083463,Staff,1,0,30,29
1650043783773,MATH 193B,A02,083464,Staff,9,0,30,21
1650043783773,MATH 193B,A03,083465,Staff,18,0,30,12
1650043789834,COGS 2,A01,083966,Boyle; Mary E. T.,10,0,30,20
1650043795861,COGS 9,A01,083968,Staff,9,0,60,51
1650043801894,COGS 14B,A01,083970,Staff,9,0,50,41
1650043807918,COGS 17,A01,092679,Staff,50,0,75,25
1650043813944,COGS 100,A01,083972,Staff,0,16,60,60
1650043825994,COGS 101C,A01,083976,Staff,12,0,30,18
1650043832020,COGS 102A,A01,083978,Johnson; Christine M.,13,0,30,17
1650043838044,COGS 107B,A01,083980,Staff,0,7,50,50
1650043844068,COGS 115,A01,083982,Staff,10,0,30,20
1650043850094,COGS 118B,A01,083367,Staff,0,15,40,40
1650043856118,COGS 172,A01,083984,Provenzano; Emily Kara,15,0,30,15
1650043862149,COGS 177,A00,083368,Staff,0,20,30,30
1650043868178,COGS 186,A01,083986,Staff,21,0,40,19
1650043874215,COGS 187A,A01,083988,Boyle; Mary E. T.,20,0,60,40
1650043880239,CSE 8A,A50,084003,Miranda; Gregory Joseph,0,15,15,15
1650043886266,CSE 11,A01,084005,Miranda; Gregory Joseph,0,22,55,55
1650043892296,CSE 20,A01,084007,Staff,0,5,20,20
1650043898324,CSE 21,A01,084009,Staff,0,31,50,50
1650043904367,CSE 30,A01,083370,Cao; Yingjun,0,65,40,40
1650043910393,CSE 100,A01,083372,Cao; Yingjun,0,46,40,40
1650043916416,CSE 101,A01,084011,Staff,0,54,40,40
1650043922442,CSE 141,A01,083374,Eldon; John,0,64,75,75
1650043928479,CSE 141L,A01,083376,Eldon; John,0,70,75,75
1650043934502,CSE 175,A01,084013,Kumar; Rakesh,22,0,25,3
1650043940528,CSE 190,A00,092508,Dubnov; Shlomo,19,0,20,1
1650043946562,ECE 5,A01,084049,Morris; Karcher William,13,0,20,7
1650043952595,ECE 100,A01,084051,Baghdadchi; Saharnaz,0,0,20,20
1650043952595,ECE 100,A02,091916,Baghdadchi; Saharnaz,13,0,20,7
1650043958623,ECE 101,A01,084053,Baghdadchi; Saharnaz,0,0,37,37
1650043958623,ECE 101,A02,084054,Baghdadchi; Saharnaz,29,0,37,8
1650043964648,ECE 107,A01,083390,Staff,26,0,40,14
1650043970671,ECE 148,A01,084056,Silberman; Jack,8,0,12,4
1650043976695,ECE 180,A00,083391,Abi Samra; Nicholas Camill,25,0,30,5
1650043976695,ECE 180,B00,083392,Abi Samra; Nicholas Camill,21,0,30,9
1650043982718,MATH 10B,A01,084110,Staff,0,0,30,30
1650043982718,MATH 10B,A02,084111,Staff,17,0,30,13
1650043982718,MATH 10B,A03,084112,Staff,24,0,30,6
1650043988743,MATH 10C,A01,083443,Staff,0,17,30,30
1650043988743,MATH 10C,A02,083444,Staff,0,16,30,30
1650043988743,MATH 10C,B01,084114,Staff,19,0,30,11
1650043988743,MATH 10C,B02,084115,Staff,25,0,30,5
1650043994767,MATH 18,A01,084117,Harel; Guershon,13,0,30,17
1650043994767,MATH 18,A02,084119,Harel; Guershon,27,0,30,3
1650043994767,MATH 18,A03,084120,Harel; Guershon,30,0,30,0
1650043994767,MATH 18,A04,084121,Harel; Guershon,29,0,30,1
1650044000795,MATH 20B,A01,084124,Um; Ko Woon,13,0,35,22
1650044000795,MATH 20B,B01,084126,Um; Ko Woon,24,0,35,11
1650044006827,MATH 20C,A01,083446,Hammock; Frances H,0,0,30,30
1650044006827,MATH 20C,A02,083447,Hammock; Frances H,15,0,30,15
1650044006827,MATH 20C,A03,083448,Hammock; Frances H,19,0,30,11
1650044006827,MATH 20C,A04,083449,Hammock; Frances H,20,0,30,10
1650044006827,MATH 20C,B01,083451,Hammock; Frances H,0,0,30,30
1650044006827,MATH 20C,B02,083452,Hammock; Frances H,18,0,30,12
1650044006827,MATH 20C,B03,083453,Hammock; Frances H,21,0,30,9
1650044006827,MATH 20C,B04,083454,Hammock; Frances H,23,0,30,7
1650044012852,MATH 20D,A01,084128,Staff,14,0,30,16
1650044012852,MATH 20D,A02,084129,Staff,29,0,30,1
1650044012852,MATH 20D,A03,084130,Staff,27,0,30,3
1650044012852,MATH 20D,B01,084133,Staff,2,0,30,28
1650044012852,MATH 20D,B02,084134,Staff,23,0,30,7
1650044012852,MATH 20D,B03,084135,Staff,28,0,30,2
1650044018885,MATH 20E,A01,084138,Staff,13,0,30,17
1650044018885,MATH 20E,A02,084139,Staff,6,0,30,24
1650044018885,MATH 20E,A03,084140,Staff,15,0,30,15
1650044018885,MATH 20E,A04,084141,Staff,20,0,30,10
1650044024911,MATH 102,A01,084143,Harel; Guershon,12,0,30,18
1650044024911,MATH 102,A02,084144,Harel; Guershon,19,0,30,11
1650044030938,MATH 103B,A01,083456,Staff,0,13,30,30
1650044030938,MATH 103B,A02,083457,Staff,0,14,30,30
1650044036961,MATH 109,A01,084146,Salehi Golsefidy; Alireza,17,0,30,13
1650044036961,MATH 109,A02,084147,Salehi Golsefidy; Alireza,15,0,30,15
1650044042987,MATH 120A,A01,085445,Eggers; John Dietrich,10,0,35,25
1650044042987,MATH 120A,A02,085446,Eggers; John Dietrich,27,0,35,8
1650044049012,MATH 142B,A01,084149,Verstraete; Jacques Allan,0,12,30,30
1650044049012,MATH 142B,A02,084150,Verstraete; Jacques Allan,0,12,30,30
1650044055039,MATH 170A,A01,083459,Nie; Jiawang,0,9,30,30
1650044055039,MATH 170A,A02,083460,Nie; Jiawang,0,8,30,30
1650044055039,MATH 170A,A03,083461,Nie; Jiawang,0,9,30,30
1650044061066,MATH 193B,A01,083463,Staff,1,0,30,29
1650044061066,MATH 193B,A02,083464,Staff,9,0,30,21
1650044061066,MATH 193B,A03,083465,Staff,18,0,30,12
1650044067120,COGS 2,A01,083966,Boyle; Mary E. T.,10,0,30,20
1650044073144,COGS 9,A01,083968,Staff,9,0,60,51
1650044079177,COGS 14B,A01,083970,Staff,9,0,50,41
1650044085201,COGS 17,A01,092679,Staff,50,0,75,25
1650044091223,COGS 100,A01,083972,Staff,0,16,60,60
1650044103269,COGS 101C,A01,083976,Staff,12,0,30,18
1650044109291,COGS 102A,A01,083978,Johnson; Christine M.,13,0,30,17
1650044115314,COGS 107B,A01,083980,Staff,0,7,50,50
1650044121343,COGS 115,A01,083982,Staff,10,0,30,20
1650044127369,COGS 118B,A01,083367,Staff,0,15,40,40
1650044133408,COGS 172,A01,083984,Provenzano; Emily Kara,15,0,30,15
1650044139443,COGS 177,A00,083368,Staff,0,20,30,30
1650044145465,COGS 186,A01,083986,Staff,21,0,40,19
1650044151487,COGS 187A,A01,083988,Boyle; Mary E. T.,20,0,60,40
1650044157515,CSE 8A,A50,084003,Miranda; Gregory Joseph,0,15,15,15
1650044163538,CSE 11,A01,084005,Miranda; Gregory Joseph,0,22,55,55
1650044169562,CSE 20,A01,084007,Staff,0,5,20,20
1650044175589,CSE 21,A01,084009,Staff,0,31,50,50
1650044181616,CSE 30,A01,083370,Cao; Yingjun,0,65,40,40
1650044187743,CSE 100,A01,083372,Cao; Yingjun,0,46,40,40
1650044193767,CSE 101,A01,084011,Staff,0,54,40,40
1650044199795,CSE 141,A01,083374,Eldon; John,0,64,75,75
1650044205839,CSE 141L,A01,083376,Eldon; John,0,70,75,75
1650044211867,CSE 175,A01,084013,Kumar; Rakesh,22,0,25,3
1650044217909,CSE 190,A00,092508,Dubnov; Shlomo,19,0,20,1
1650044223932,ECE 5,A01,084049,Morris; Karcher William,13,0,20,7
1650044229956,ECE 100,A01,084051,Baghdadchi; Saharnaz,0,0,20,20
1650044229956,ECE 100,A02,091916,Baghdadchi; Saharnaz,13,0,20,7
1650044235983,ECE 101,A01,084053,Baghdadchi; Saharnaz,0,0,37,37
1650044235983,ECE 101,A02,084054,Baghdadchi; Saharnaz,29,0,37,8
1650044242013,ECE 107,A01,083390,Staff,26,0,40,14
1650044248038,ECE 148,A01,084056,Silberman; Jack,8,0,12,4
1650044254063,ECE 180,A00,083391,Abi Samra; Nicholas Camill,25,0,30,5
1650044254063,ECE 180,B00,083392,Abi Samra; Nicholas Camill,21,0,30,9
1650044260089,MATH 10B,A01,084110,Staff,0,0,30,30
1650044260089,MATH 10B,A02,084111,Staff,17,0,30,13
1650044260089,MATH 10B,A03,084112,Staff,24,0,30,6
1650044266143,MATH 10C,A01,083443,Staff,0,17,30,30
1650044266143,MATH 10C,A02,083444,Staff,0,16,30,30
1650044266143,MATH 10C,B01,084114,Staff,19,0,30,11
1650044266143,MATH 10C,B02,084115,Staff,25,0,30,5
1650044272175,MATH 18,A01,084117,Harel; Guershon,13,0,30,17
1650044272175,MATH 18,A02,084119,Harel; Guershon,27,0,30,3
1650044272175,MATH 18,A03,084120,Harel; Guershon,30,0,30,0
1650044272175,MATH 18,A04,084121,Harel; Guershon,29,0,30,1
1650044278199,MATH 20B,A01,084124,Um; Ko Woon,12,0,35,23
1650044278199,MATH 20B,B01,084126,Um; Ko Woon,24,0,35,11
1650044284229,MATH 20C,A01,083446,Hammock; Frances H,0,0,30,30
1650044284229,MATH 20C,A02,083447,Hammock; Frances H,15,0,30,15
1650044284229,MATH 20C,A03,083448,Hammock; Frances H,19,0,30,11
1650044284229,MATH 20C,A04,083449,Hammock; Frances H,20,0,30,10
1650044284229,MATH 20C,B01,083451,Hammock; Frances H,0,0,30,30
1650044284229,MATH 20C,B02,083452,Hammock; Frances H,18,0,30,12
1650044284229,MATH 20C,B03,083453,Hammock; Frances H,21,0,30,9
1650044284229,MATH 20C,B04,083454,Hammock; Frances H,23,0,30,7
1650044290255,MATH 20D,A01,084128,Staff,14,0,30,16
1650044290255,MATH 20D,A02,084129,Staff,29,0,30,1
1650044290255,MATH 20D,A03,084130,Staff,27,0,30,3
1650044290255,MATH 20D,B01,084133,Staff,2,0,30,28
1650044290255,MATH 20D,B02,084134,Staff,23,0,30,7
1650044290255,MATH 20D,B03,084135,Staff,28,0,30,2
1650044296283,MATH 20E,A01,084138,Staff,13,0,30,17
1650044296283,MATH 20E,A02,084139,Staff,6,0,30,24
1650044296283,MATH 20E,A03,084140,Staff,15,0,30,15
1650044296283,MATH 20E,A04,084141,Staff,20,0,30,10
1650044302320,MATH 102,A01,084143,Harel; Guershon,12,0,30,18
1650044302320,MATH 102,A02,084144,Harel; Guershon,19,0,30,11
1650044308342,MATH 103B,A01,083456,Staff,0,13,30,30
1650044308342,MATH 103B,A02,083457,Staff,0,14,30,30
1650044314375,MATH 109,A01,084146,Salehi Golsefidy; Alireza,17,0,30,13
1650044314375,MATH 109,A02,084147,Salehi Golsefidy; Alireza,15,0,30,15
1650044320404,MATH 120A,A01,085445,Eggers; John Dietrich,10,0,35,25
1650044320404,MATH 120A,A02,085446,Eggers; John Dietrich,27,0,35,8
1650044326426,MATH 142B,A01,084149,Verstraete; Jacques Allan,0,12,30,30
1650044326426,MATH 142B,A02,084150,Verstraete; Jacques Allan,0,12,30,30
1650044332449,MATH 170A,A01,083459,Nie; Jiawang,0,9,30,30
1650044332449,MATH 170A,A02,083460,Nie; Jiawang,0,8,30,30
1650044332449,MATH 170A,A03,083461,Nie; Jiawang,0,9,30,30
1650044338472,MATH 193B,A01,083463,Staff,1,0,30,29
1650044338472,MATH 193B,A02,083464,Staff,9,0,30,21
1650044338472,MATH 193B,A03,083465,Staff,18,0,30,12
1650044344560,COGS 2,A01,083966,Boyle; Mary E. T.,10,0,30,20
1650044350594,COGS 9,A01,083968,Staff,9,0,60,51
1650044356624,COGS 14B,A01,083970,Staff,9,0,50,41
1650044362652,COGS 17,A01,092679,Staff,50,0,75,25
1650044368687,COGS 100,A01,083972,Staff,0,16,60,60
1650044380752,COGS 101C,A01,083976,Staff,12,0,30,18
1650044386774,COGS 102A,A01,083978,Johnson; Christine M.,13,0,30,17
1650044392797,COGS 107B,A01,083980,Staff,0,7,50,50
1650044398824,COGS 115,A01,083982,Staff,10,0,30,20
1650044404853,COGS 118B,A01,083367,Staff,0,15,40,40
1650044410881,COGS 172,A01,083984,Provenzano; Emily Kara,15,0,30,15
1650044416918,COGS 177,A00,083368,Staff,0,20,30,30
1650044422964,COGS 186,A01,083986,Staff,21,0,40,19
1650044428994,COGS 187A,A01,083988,Boyle; Mary E. T.,20,0,60,40
1650044435018,CSE 8A,A50,084003,Miranda; Gregory Joseph,0,15,15,15
1650044441046,CSE 11,A01,084005,Miranda; Gregory Joseph,0,22,55,55
1650044447073,CSE 20,A01,084007,Staff,0,5,20,20
1650044453096,CSE 21,A01,084009,Staff,0,31,50,50
1650044459123,CSE 30,A01,083370,Cao; Yingjun,0,65,40,40
1650044465146,CSE 100,A01,083372,Cao; Yingjun,0,46,40,40
1650044471189,CSE 101,A01,084011,Staff,0,54,40,40
1650044477225,CSE 141,A01,083374,Eldon; John,0,64,75,75
1650044483252,CSE 141L,A01,083376,Eldon; John,0,70,75,75
1650044489274,CSE 175,A01,084013,Kumar; Rakesh,22,0,25,3
1650044495306,CSE 190,A00,092508,Dubnov; Shlomo,19,0,20,1
1650044501333,ECE 5,A01,084049,Morris; Karcher William,13,0,20,7
1650044507361,ECE 100,A01,084051,Baghdadchi; Saharnaz,0,0,20,20
1650044507361,ECE 100,A02,091916,Baghdadchi; Saharnaz,13,0,20,7
1650044513395,ECE 101,A01,084053,Baghdadchi; Saharnaz,0,0,37,37
1650044513395,ECE 101,A02,084054,Baghdadchi; Saharnaz,29,0,37,8
1650044519431,ECE 107,A01,083390,Staff,26,0,40,14
1650044525456,ECE 148,A01,084056,Silberman; Jack,8,0,12,4
1650044531495,ECE 180,A00,083391,Abi Samra; Nicholas Camill,25,0,30,5
1650044531495,ECE 180,B00,083392,Abi Samra; Nicholas Camill,21,0,30,9
1650044537530,MATH 10B,A01,084110,Staff,0,0,30,30
1650044537530,MATH 10B,A02,084111,Staff,17,0,30,13
1650044537530,MATH 10B,A03,084112,Staff,24,0,30,6
1650044543558,MATH 10C,A01,083443,Staff,0,17,30,30
1650044543558,MATH 10C,A02,083444,Staff,0,16,30,30
1650044543558,MATH 10C,B01,084114,Staff,19,0,30,11
1650044543558,MATH 10C,B02,084115,Staff,25,0,30,5
1650044549582,MATH 18,A01,084117,Harel; Guershon,12,0,30,18
1650044549582,MATH 18,A02,084119,Harel; Guershon,27,0,30,3
1650044549582,MATH 18,A03,084120,Harel; Guershon,30,0,30,0
1650044549582,MATH 18,A04,084121,Harel; Guershon,29,0,30,1
1650044555611,MATH 20B,A01,084124,Um; Ko Woon,12,0,35,23
1650044555611,MATH 20B,B01,084126,Um; Ko Woon,24,0,35,11
1650044561648,MATH 20C,A01,083446,Hammock; Frances H,0,0,30,30
1650044561648,MATH 20C,A02,083447,Hammock; Frances H,15,0,30,15
1650044561648,MATH 20C,A03,083448,Hammock; Frances H,19,0,30,11
1650044561648,MATH 20C,A04,083449,Hammock; Frances H,20,0,30,10
1650044561648,MATH 20C,B01,083451,Hammock; Frances H,0,0,30,30
1650044561648,MATH 20C,B02,083452,Hammock; Frances H,18,0,30,12
1650044561648,MATH 20C,B03,083453,Hammock; Frances H,21,0,30,9
1650044561648,MATH 20C,B04,083454,Hammock; Frances H,23,0,30,7
1650044567701,MATH 20D,A01,084128,Staff,14,0,30,16
1650044567701,MATH 20D,A02,084129,Staff,29,0,30,1
1650044567701,MATH 20D,A03,084130,Staff,27,0,30,3
1650044567701,MATH 20D,B01,084133,Staff,2,0,30,28
1650044567701,MATH 20D,B02,084134,Staff,23,0,30,7
1650044567701,MATH 20D,B03,084135,Staff,28,0,30,2
1650044573731,MATH 20E,A01,084138,Staff,13,0,30,17
1650044573731,MATH 20E,A02,084139,Staff,6,0,30,24
1650044573731,MATH 20E,A03,084140,Staff,15,0,30,15
1650044573731,MATH 20E,A04,084141,Staff,20,0,30,10
1650044579766,MATH 102,A01,084143,Harel; Guershon,12,0,30,18
1650044579766,MATH 102,A02,084144,Harel; Guershon,19,0,30,11
1650044585788,MATH 103B,A01,083456,Staff,0,13,30,30
1650044585788,MATH 103B,A02,083457,Staff,0,14,30,30
1650044591828,MATH 109,A01,084146,Salehi Golsefidy; Alireza,17,0,30,13
1650044591828,MATH 109,A02,084147,Salehi Golsefidy; Alireza,15,0,30,15
1650044597867,MATH 120A,A01,085445,Eggers; John Dietrich,10,0,35,25
1650044597867,MATH 120A,A02,085446,Eggers; John Dietrich,27,0,35,8
1650044603889,MATH 142B,A01,084149,Verstraete; Jacques Allan,0,12,30,30
1650044603889,MATH 142B,A02,084150,Verstraete; Jacques Allan,0,12,30,30
1650044609915,MATH 170A,A01,083459,Nie; Jiawang,0,9,30,30
1650044609915,MATH 170A,A02,083460,Nie; Jiawang,0,8,30,30
1650044609915,MATH 170A,A03,083461,Nie; Jiawang,0,9,30,30
1650044615946,MATH 193B,A01,083463,Staff,1,0,30,29
1650044615946,MATH 193B,A02,083464,Staff,9,0,30,21
1650044615946,MATH 193B,A03,083465,Staff,18,0,30,12
1650044622013,COGS 2,A01,083966,Boyle; Mary E. T.,10,0,30,20
1650044628036,COGS 9,A01,083968,Staff,9,0,60,51
1650044634068,COGS 14B,A01,083970,Staff,9,0,50,41
1650044640091,COGS 17,A01,092679,Staff,50,0,75,25
1650044646118,COGS 100,A01,083972,Staff,0,16,60,60
1650044658163,COGS 101C,A01,083976,Staff,12,0,30,18
1650044664189,COGS 102A,A01,083978,Johnson; Christine M.,13,0,30,17
1650044670220,COGS 107B,A01,083980,Staff,0,7,50,50
1650044676245,COGS 115,A01,083982,Staff,10,0,30,20
1650044682270,COGS 118B,A01,083367,Staff,0,15,40,40
1650044688299,COGS 172,A01,083984,Provenzano; Emily Kara,15,0,30,15
1650044694336,COGS 177,A00,083368,Staff,0,20,30,30
1650044700374,COGS 186,A01,083986,Staff,21,0,40,19
1650044706424,COGS 187A,A01,083988,Boyle; Mary E. T.,20,0,60,40
1650044712449,CSE 8A,A50,084003,Miranda; Gregory Joseph,0,15,15,15
1650044718473,CSE 11,A01,084005,Miranda; Gregory Joseph,0,22,55,55
1650044724498,CSE 20,A01,084007,Staff,0,5,20,20
1650044730521,CSE 21,A01,084009,Staff,0,31,50,50
1650044736547,CSE 30,A01,083370,Cao; Yingjun,0,65,40,40
1650044742576,CSE 100,A01,083372,Cao; Yingjun,0,46,40,40
1650044748609,CSE 101,A01,084011,Staff,0,54,40,40
1650044754635,CSE 141,A01,083374,Eldon; John,0,64,75,75
1650044760666,CSE 141L,A01,083376,Eldon; John,0,70,75,75
1650044766693,CSE 175,A01,084013,Kumar; Rakesh,22,0,25,3
1650044772723,CSE 190,A00,092508,Dubnov; Shlomo,19,0,20,1
1650044778771,ECE 5,A01,084049,Morris; Karcher William,13,0,20,7
1650044784907,ECE 100,A01,084051,Baghdadchi; Saharnaz,0,0,20,20
1650044784907,ECE 100,A02,091916,Baghdadchi; Saharnaz,13,0,20,7
1650044790931,ECE 101,A01,084053,Baghdadchi; Saharnaz,0,0,37,37
1650044790931,ECE 101,A02,084054,Baghdadchi; Saharnaz,29,0,37,8
1650044796958,ECE 107,A01,083390,Staff,26,0,40,14
1650044802982,ECE 148,A01,084056,Silberman; Jack,8,0,12,4
1650044809020,ECE 180,A00,083391,Abi Samra; Nicholas Camill,25,0,30,5
1650044809020,ECE 180,B00,083392,Abi Samra; Nicholas Camill,21,0,30,9
1650044815048,MATH 10B,A01,084110,Staff,0,0,30,30
1650044815048,MATH 10B,A02,084111,Staff,17,0,30,13
1650044815048,MATH 10B,A03,084112,Staff,24,0,30,6
1650044821072,MATH 10C,A01,083443,Staff,0,17,30,30
1650044821072,MATH 10C,A02,083444,Staff,0,16,30,30
1650044821072,MATH 10C,B01,084114,Staff,19,0,30,11
1650044821072,MATH 10C,B02,084115,Staff,25,0,30,5
1650044827100,MATH 18,A01,084117,Harel; Guershon,12,0,30,18
1650044827100,MATH 18,A02,084119,Harel; Guershon,27,0,30,3
1650044827100,MATH 18,A03,084120,Harel; Guershon,30,0,30,0
1650044827100,MATH 18,A04,084121,Harel; Guershon,29,0,30,1
1650044833125,MATH 20B,A01,084124,Um; Ko Woon,12,0,35,23
1650044833125,MATH 20B,B01,084126,Um; Ko Woon,24,0,35,11
1650044839150,MATH 20C,A01,083446,Hammock; Frances H,0,0,30,30
1650044839150,MATH 20C,A02,083447,Hammock; Frances H,15,0,30,15
1650044839150,MATH 20C,A03,083448,Hammock; Frances H,19,0,30,11
1650044839150,MATH 20C,A04,083449,Hammock; Frances H,20,0,30,10
1650044839150,MATH 20C,B01,083451,Hammock; Frances H,0,0,30,30
1650044839150,MATH 20C,B02,083452,Hammock; Frances H,18,0,30,12
1650044839150,MATH 20C,B03,083453,Hammock; Frances H,21,0,30,9
1650044839150,MATH 20C,B04,083454,Hammock; Frances H,23,0,30,7
1650044845177,MATH 20D,A01,084128,Staff,14,0,30,16
1650044845177,MATH 20D,A02,084129,Staff,29,0,30,1
1650044845177,MATH 20D,A03,084130,Staff,27,0,30,3
1650044845177,MATH 20D,B01,084133,Staff,2,0,30,28
1650044845177,MATH 20D,B02,084134,Staff,23,0,30,7
1650044845177,MATH 20D,B03,084135,Staff,28,0,30,2
1650044851200,MATH 20E,A01,084138,Staff,13,0,30,17
1650044851200,MATH 20E,A02,084139,Staff,6,0,30,24
1650044851200,MATH 20E,A03,084140,Staff,15,0,30,15
1650044851200,MATH 20E,A04,084141,Staff,20,0,30,10
1650044857228,MATH 102,A01,084143,Harel; Guershon,12,0,30,18
1650044857228,MATH 102,A02,084144,Harel; Guershon,19,0,30,11
1650044863256,MATH 103B,A01,083456,Staff,0,13,30,30
1650044863256,MATH 103B,A02,083457,Staff,0,14,30,30
1650044869281,MATH 109,A01,084146,Salehi Golsefidy; Alireza,17,0,30,13
1650044869281,MATH 109,A02,084147,Salehi Golsefidy; Alireza,15,0,30,15
1650044875305,MATH 120A,A01,085445,Eggers; John Dietrich,10,0,35,25
1650044875305,MATH 120A,A02,085446,Eggers; John Dietrich,27,0,35,8
1650044881329,MATH 142B,A01,084149,Verstraete; Jacques Allan,0,12,30,30
1650044881329,MATH 142B,A02,084150,Verstraete; Jacques Allan,0,12,30,30
1650044887353,MATH 170A,A01,083459,Nie; Jiawang,0,9,30,30
1650044887353,MATH 170A,A02,083460,Nie; Jiawang,0,8,30,30
1650044887353,MATH 170A,A03,083461,Nie; Jiawang,0,9,30,30
1650044893383,MATH 193B,A01,083463,Staff,1,0,30,29
1650044893383,MATH 193B,A02,083464,Staff,9,0,30,21
1650044893383,MATH 193B,A03,083465,Staff,18,0,30,12
1650044899454,COGS 2,A01,083966,Boyle; Mary E. T.,10,0,30,20
1650044905478,COGS 9,A01,083968,Staff,9,0,60,51
1650044911511,COGS 14B,A01,083970,Staff,9,0,50,41
1650044917542,COGS 17,A01,092679,Staff,50,0,75,25
1650044923566,COGS 100,A01,083972,Staff,0,16,60,60
1650044935636,COGS 101C,A01,083976,Staff,12,0,30,18
1650044941673,COGS 102A,A01,083978,Johnson; Christine M.,13,0,30,17
1650044947697,COGS 107B,A01,083980,Staff,0,7,50,50
1650044953736,COGS 115,A01,083982,Staff,10,0,30,20
1650044959761,COGS 118B,A01,083367,Staff,0,15,40,40
1650044965784,COGS 172,A01,083984,Provenzano; Emily Kara,15,0,30,15
1650044971813,COGS 177,A00,083368,Staff,0,20,30,30
1650044977846,COGS 186,A01,083986,Staff,21,0,40,19
1650044983872,COGS 187A,A01,083988,Boyle; Mary E. T.,20,0,60,40
1650044989903,CSE 8A,A50,084003,Miranda; Gregory Joseph,0,15,15,15
1650044995931,CSE 11,A01,084005,Miranda; Gregory Joseph,0,22,55,55
1650045001961,CSE 20,A01,084007,Staff,0,5,20,20
1650045007989,CSE 21,A01,084009,Staff,0,31,50,50
1650045014016,CSE 30,A01,083370,Cao; Yingjun,0,65,40,40
1650045020047,CSE 100,A01,083372,Cao; Yingjun,0,46,40,40
1650045026072,CSE 101,A01,084011,Staff,0,54,40,40
1650045032097,CSE 141,A01,083374,Eldon; John,0,64,75,75
1650045038124,CSE 141L,A01,083376,Eldon; John,0,70,75,75
1650045044148,CSE 175,A01,084013,Kumar; Rakesh,22,0,25,3
1650045050180,CSE 190,A00,092508,Dubnov; Shlomo,19,0,20,1
1650045056209,ECE 5,A01,084049,Morris; Karcher William,13,0,20,7
1650045062238,ECE 100,A01,084051,Baghdadchi; Saharnaz,0,0,20,20
1650045062238,ECE 100,A02,091916,Baghdadchi; Saharnaz,13,0,20,7
1650045068273,ECE 101,A01,084053,Baghdadchi; Saharnaz,0,0,37,37
1650045068273,ECE 101,A02,084054,Baghdadchi; Saharnaz,29,0,37,8
1650045074297,ECE 107,A01,083390,Staff,26,0,40,14
1650045080324,ECE 148,A01,084056,Silberman; Jack,8,0,12,4
1650045086351,ECE 180,A00,083391,Abi Samra; Nicholas Camill,25,0,30,5
1650045086351,ECE 180,B00,083392,Abi Samra; Nicholas Camill,21,0,30,9
1650045092378,MATH 10B,A01,084110,Staff,0,0,30,30
1650045092378,MATH 10B,A02,084111,Staff,17,0,30,13
1650045092378,MATH 10B,A03,084112,Staff,24,0,30,6
1650045098403,MATH 10C,A01,083443,Staff,0,17,30,30
1650045098403,MATH 10C,A02,083444,Staff,0,16,30,30
1650045098403,MATH 10C,B01,084114,Staff,19,0,30,11
1650045098403,MATH 10C,B02,084115,Staff,25,0,30,5
1650045104430,MATH 18,A01,084117,Harel; Guershon,12,0,30,18
1650045104430,MATH 18,A02,084119,Harel; Guershon,27,0,30,3
1650045104430,MATH 18,A03,084120,Harel; Guershon,30,0,30,0
1650045104430,MATH 18,A04,084121,Harel; Guershon,29,0,30,1
1650045110453,MATH 20B,A01,084124,Um; Ko Woon,12,0,35,23
1650045110453,MATH 20B,B01,084126,Um; Ko Woon,24,0,35,11
1650045116478,MATH 20C,A01,083446,Hammock; Frances H,0,0,30,30
1650045116478,MATH 20C,A02,083447,Hammock; Frances H,15,0,30,15
1650045116478,MATH 20C,A03,083448,Hammock; Frances H,19,0,30,11
1650045116478,MATH 20C,A04,083449,Hammock; Frances H,20,0,30,10
1650045116478,MATH 20C,B01,083451,Hammock; Frances H,0,0,30,30
1650045116478,MATH 20C,B02,083452,Hammock; Frances H,18,0,30,12
1650045116478,MATH 20C,B03,083453,Hammock; Frances H,21,0,30,9
1650045116478,MATH 20C,B04,083454,Hammock; Frances H,23,0,30,7
1650045122501,MATH 20D,A01,084128,Staff,14,0,30,16
1650045122501,MATH 20D,A02,084129,Staff,29,0,30,1
1650045122501,MATH 20D,A03,084130,Staff,27,0,30,3
1650045122501,MATH 20D,B01,084133,Staff,2,0,30,28
1650045122501,MATH 20D,B02,084134,Staff,23,0,30,7
1650045122501,MATH 20D,B03,084135,Staff,28,0,30,2
1650045128528,MATH 20E,A01,084138,Staff,13,0,30,17
1650045128528,MATH 20E,A02,084139,Staff,6,0,30,24
1650045128528,MATH 20E,A03,084140,Staff,15,0,30,15
1650045128528,MATH 20E,A04,084141,Staff,20,0,30,10
1650045134558,MATH 102,A01,084143,Harel; Guershon,12,0,30,18
1650045134558,MATH 102,A02,084144,Harel; Guershon,19,0,30,11
1650045140593,MATH 103B,A01,083456,Staff,0,13,30,30
1650045140593,MATH 103B,A02,083457,Staff,0,14,30,30
1650045146618,MATH 109,A01,084146,Salehi Golsefidy; Alireza,17,0,30,13
1650045146618,MATH 109,A02,084147,Salehi Golsefidy; Alireza,15,0,30,15
1650045152643,MATH 120A,A01,085445,Eggers; John Dietrich,10,0,35,25
1650045152643,MATH 120A,A02,085446,Eggers; John Dietrich,27,0,35,8
1650045158666,MATH 142B,A01,084149,Verstraete; Jacques Allan,0,12,30,30
1650045158666,MATH 142B,A02,084150,Verstraete; Jacques Allan,0,12,30,30
1650045164690,MATH 170A,A01,083459,Nie; Jiawang,0,9,30,30
1650045164690,MATH 170A,A02,083460,Nie; Jiawang,0,8,30,30
1650045164690,MATH 170A,A03,083461,Nie; Jiawang,0,9,30,30
1650045170729,MATH 193B,A01,083463,Staff,1,0,30,29
1650045170729,MATH 193B,A02,083464,Staff,9,0,30,21
1650045170729,MATH 193B,A03,083465,Staff,18,0,30,12
1650045176785,COGS 2,A01,083966,Boyle; Mary E. T.,10,0,30,20
1650045182813,COGS 9,A01,083968,Staff,9,0,60,51
1650045188836,COGS 14B,A01,083970,Staff,9,0,50,41
1650045194863,COGS 17,A01,092679,Staff,50,0,75,25
1650045200889,COGS 100,A01,083972,Staff,0,16,60,60
1650045212971,COGS 101C,A01,083976,Staff,12,0,30,18
1650045219001,COGS 102A,A01,083978,Johnson; Christine M.,13,0,30,17
1650045225027,COGS 107B,A01,083980,Staff,0,7,50,50
1650045231056,COGS 115,A01,083982,Staff,10,0,30,20
1650045237086,COGS 118B,A01,083367,Staff,0,15,40,40
1650045243117,COGS 172,A01,083984,Provenzano; Emily Kara,15,0,30,15
1650045249145,COGS 177,A00,083368,Staff,0,20,30,30
1650045255174,COGS 186,A01,083986,Staff,21,0,40,19
1650045261200,COGS 187A,A01,083988,Boyle; Mary E. T.,20,0,60,40
1650045267233,CSE 8A,A50,084003,Miranda; Gregory Joseph,0,15,15,15
1650045273257,CSE 11,A01,084005,Miranda; Gregory Joseph,0,22,55,55
1650045279284,CSE 20,A01,084007,Staff,0,5,20,20
1650045285310,CSE 21,A01,084009,Staff,0,31,50,50
1650045291345,CSE 30,A01,083370,Cao; Yingjun,0,65,40,40
1650045297377,CSE 100,A01,083372,Cao; Yingjun,0,46,40,40
1650045303410,CSE 101,A01,084011,Staff,0,54,40,40
1650045309438,CSE 141,A01,083374,Eldon; John,0,64,75,75
1650045315463,CSE 141L,A01,083376,Eldon; John,0,70,75,75
1650045321493,CSE 175,A01,084013,Kumar; Rakesh,22,0,25,3
1650045327530,CSE 190,A00,092508,Dubnov; Shlomo,19,0,20,1
1650045333566,ECE 5,A01,084049,Morris; Karcher William,13,0,20,7
1650045339599,ECE 100,A01,084051,Baghdadchi; Saharnaz,0,0,20,20
1650045339599,ECE 100,A02,091916,Baghdadchi; Saharnaz,13,0,20,7
1650045345623,ECE 101,A01,084053,Baghdadchi; Saharnaz,0,0,37,37
1650045345623,ECE 101,A02,084054,Baghdadchi; Saharnaz,29,0,37,8
1650045351646,ECE 107,A01,083390,Staff,26,0,40,14
1650045357675,ECE 148,A01,084056,Silberman; Jack,8,0,12,4
1650045363703,ECE 180,A00,083391,Abi Samra; Nicholas Camill,25,0,30,5
1650045363703,ECE 180,B00,083392,Abi Samra; Nicholas Camill,21,0,30,9
1650045369729,MATH 10B,A01,084110,Staff,0,0,30,30
1650045369729,MATH 10B,A02,084111,Staff,17,0,30,13
1650045369729,MATH 10B,A03,084112,Staff,24,0,30,6
1650045375763,MATH 10C,A01,083443,Staff,0,17,30,30
1650045375763,MATH 10C,A02,083444,Staff,0,16,30,30
1650045375763,MATH 10C,B01,084114,Staff,19,0,30,11
1650045375763,MATH 10C,B02,084115,Staff,25,0,30,5
1650045381873,MATH 18,A01,084117,Harel; Guershon,12,0,30,18
1650045381873,MATH 18,A02,084119,Harel; Guershon,27,0,30,3
1650045381873,MATH 18,A03,084120,Harel; Guershon,30,0,30,0
1650045381873,MATH 18,A04,084121,Harel; Guershon,29,0,30,1
1650045387897,MATH 20B,A01,084124,Um; Ko Woon,12,0,35,23
1650045387897,MATH 20B,B01,084126,Um; Ko Woon,24,0,35,11
1650045393927,MATH 20C,A01,083446,Hammock; Frances H,0,0,30,30
1650045393927,MATH 20C,A02,083447,Hammock; Frances H,14,0,30,16
1650045393927,MATH 20C,A03,083448,Hammock; Frances H,19,0,30,11
1650045393927,MATH 20C,A04,083449,Hammock; Frances H,20,0,30,10
1650045393927,MATH 20C,B01,083451,Hammock; Frances H,0,0,30,30
1650045393927,MATH 20C,B02,083452,Hammock; Frances H,18,0,30,12
1650045393927,MATH 20C,B03,083453,Hammock; Frances H,21,0,30,9
1650045393927,MATH 20C,B04,083454,Hammock; Frances H,23,0,30,7
1650045399969,MATH 20D,A01,084128,Staff,14,0,30,16
1650045399969,MATH 20D,A02,084129,Staff,29,0,30,1
1650045399969,MATH 20D,A03,084130,Staff,27,0,30,3
1650045399969,MATH 20D,B01,084133,Staff,1,0,30,29
1650045399969,MATH 20D,B02,084134,Staff,23,0,30,7
1650045399969,MATH 20D,B03,084135,Staff,28,0,30,2
1650045405996,MATH 20E,A01,084138,Staff,13,0,30,17
1650045405996,MATH 20E,A02,084139,Staff,6,0,30,24
1650045405996,MATH 20E,A03,084140,Staff,15,0,30,15
1650045405996,MATH 20E,A04,084141,Staff,20,0,30,10
1650045412023,MATH 102,A01,084143,Harel; Guershon,12,0,30,18
1650045412023,MATH 102,A02,084144,Harel; Guershon,19,0,30,11
1650045418049,MATH 103B,A01,083456,Staff,0,13,30,30
1650045418049,MATH 103B,A02,083457,Staff,0,14,30,30
1650045424078,MATH 109,A01,084146,Salehi Golsefidy; Alireza,17,0,30,13
1650045424078,MATH 109,A02,084147,Salehi Golsefidy; Alireza,15,0,30,15
1650045430103,MATH 120A,A01,085445,Eggers; John Dietrich,10,0,35,25
1650045430103,MATH 120A,A02,085446,Eggers; John Dietrich,27,0,35,8
1650045436127,MATH 142B,A01,084149,Verstraete; Jacques Allan,0,12,30,30
1650045436127,MATH 142B,A02,084150,Verstraete; Jacques Allan,0,12,30,30
1650045442152,MATH 170A,A01,083459,Nie; Jiawang,0,9,30,30
1650045442152,MATH 170A,A02,083460,Nie; Jiawang,0,8,30,30
1650045442152,MATH 170A,A03,083461,Nie; Jiawang,0,9,30,30
1650045448173,MATH 193B,A01,083463,Staff,1,0,30,29
1650045448173,MATH 193B,A02,083464,Staff,9,0,30,21
1650045448173,MATH 193B,A03,083465,Staff,18,0,30,12
1650045454242,COGS 2,A01,083966,Boyle; Mary E. T.,10,0,30,20
1650045460266,COGS 9,A01,083968,Staff,9,0,60,51
1650045466296,COGS 14B,A01,083970,Staff,9,0,50,41
1650045472322,COGS 17,A01,092679,Staff,50,0,75,25
1650045478358,COGS 100,A01,083972,Staff,0,16,60,60
1650045490421,COGS 101C,A01,083976,Staff,12,0,30,18
1650045496451,COGS 102A,A01,083978,Johnson; Christine M.,13,0,30,17
1650045502486,COGS 107B,A01,083980,Staff,0,7,50,50
1650045508512,COGS 115,A01,083982,Staff,10,0,30,20
1650045514538,COGS 118B,A01,083367,Staff,0,15,40,40
1650045520575,COGS 172,A01,083984,Provenzano; Emily Kara,15,0,30,15
1650045526601,COGS 177,A00,083368,Staff,0,20,30,30
1650045532623,COGS 186,A01,083986,Staff,21,0,40,19
1650045538661,COGS 187A,A01,083988,Boyle; Mary E. T.,20,0,60,40
1650045544696,CSE 8A,A50,084003,Miranda; Gregory Joseph,0,15,15,15
1650045550723,CSE 11,A01,084005,Miranda; Gregory Joseph,0,22,55,55
1650045556751,CSE 20,A01,084007,Staff,0,5,20,20
1650045562784,CSE 21,A01,084009,Staff,0,31,50,50
1650045568834,CSE 30,A01,083370,Cao; Yingjun,0,65,40,40
1650045574871,CSE 100,A01,083372,Cao; Yingjun,0,46,40,40
1650045580894,CSE 101,A01,084011,Staff,0,54,40,40
1650045586924,CSE 141,A01,083374,Eldon; John,0,64,75,75
1650045592954,CSE 141L,A01,083376,Eldon; John,0,70,75,75
1650045598977,CSE 175,A01,084013,Kumar; Rakesh,22,0,25,3
1650045605002,CSE 190,A00,092508,Dubnov; Shlomo,19,0,20,1
1650045611030,ECE 5,A01,084049,Morris; Karcher William,13,0,20,7
1650045617053,ECE 100,A01,084051,Baghdadchi; Saharnaz,0,0,20,20
1650045617053,ECE 100,A02,091916,Baghdadchi; Saharnaz,13,0,20,7
1650045623075,ECE 101,A01,084053,Baghdadchi; Saharnaz,0,0,37,37
1650045623075,ECE 101,A02,084054,Baghdadchi; Saharnaz,29,0,37,8
1650045629105,ECE 107,A01,083390,Staff,26,0,40,14
1650045635132,ECE 148,A01,084056,Silberman; Jack,8,0,12,4
1650045641168,ECE 180,A00,083391,Abi Samra; Nicholas Camill,25,0,30,5
1650045641168,ECE 180,B00,083392,Abi Samra; Nicholas Camill,21,0,30,9
1650045647194,MATH 10B,A01,084110,Staff,0,0,30,30
1650045647194,MATH 10B,A02,084111,Staff,17,0,30,13
1650045647194,MATH 10B,A03,084112,Staff,24,0,30,6
1650045653219,MATH 10C,A01,083443,Staff,0,17,30,30
1650045653219,MATH 10C,A02,083444,Staff,0,16,30,30
1650045653219,MATH 10C,B01,084114,Staff,19,0,30,11
1650045653219,MATH 10C,B02,084115,Staff,25,0,30,5
1650045659256,MATH 18,A01,084117,Harel; Guershon,12,0,30,18
1650045659256,MATH 18,A02,084119,Harel; Guershon,27,0,30,3
1650045659256,MATH 18,A03,084120,Harel; Guershon,30,0,30,0
1650045659256,MATH 18,A04,084121,Harel; Guershon,29,0,30,1
1650045665281,MATH 20B,A01,084124,Um; Ko Woon,12,0,35,23
1650045665281,MATH 20B,B01,084126,Um; Ko Woon,24,0,35,11
1650045671317,MATH 20C,A01,083446,Hammock; Frances H,0,0,30,30
1650045671317,MATH 20C,A02,083447,Hammock; Frances H,14,0,30,16
1650045671317,MATH 20C,A03,083448,Hammock; Frances H,19,0,30,11
1650045671317,MATH 20C,A04,083449,Hammock; Frances H,20,0,30,10
1650045671317,MATH 20C,B01,083451,Hammock; Frances H,0,0,30,30
1650045671317,MATH 20C,B02,083452,Hammock; Frances H,18,0,30,12
1650045671317,MATH 20C,B03,083453,Hammock; Frances H,21,0,30,9
1650045671317,MATH 20C,B04,083454,Hammock; Frances H,23,0,30,7
1650045677341,MATH 20D,A01,084128,Staff,14,0,30,16
1650045677341,MATH 20D,A02,084129,Staff,29,0,30,1
1650045677341,MATH 20D,A03,084130,Staff,27,0,30,3
1650045677341,MATH 20D,B01,084133,Staff,1,0,30,29
1650045677341,MATH 20D,B02,084134,Staff,23,0,30,7
1650045677341,MATH 20D,B03,084135,Staff,28,0,30,2
1650045683367,MATH 20E,A01,084138,Staff,13,0,30,17
1650045683367,MATH 20E,A02,084139,Staff,6,0,30,24
1650045683367,MATH 20E,A03,084140,Staff,15,0,30,15
1650045683367,MATH 20E,A04,084141,Staff,20,0,30,10
1650045689394,MATH 102,A01,084143,Harel; Guershon,12,0,30,18
1650045689394,MATH 102,A02,084144,Harel; Guershon,19,0,30,11
1650045695425,MATH 103B,A01,083456,Staff,0,13,30,30
1650045695425,MATH 103B,A02,083457,Staff,0,14,30,30
1650045701462,MATH 109,A01,084146,Salehi Golsefidy; Alireza,17,0,30,13
1650045701462,MATH 109,A02,084147,Salehi Golsefidy; Alireza,15,0,30,15
1650045707492,MATH 120A,A01,085445,Eggers; John Dietrich,10,0,35,25
1650045707492,MATH 120A,A02,085446,Eggers; John Dietrich,27,0,35,8
1650045713520,MATH 142B,A01,084149,Verstraete; Jacques Allan,0,12,30,30
1650045713520,MATH 142B,A02,084150,Verstraete; Jacques Allan,0,12,30,30
1650045719547,MATH 170A,A01,083459,Nie; Jiawang,0,9,30,30
1650045719547,MATH 170A,A02,083460,Nie; Jiawang,0,8,30,30
1650045719547,MATH 170A,A03,083461,Nie; Jiawang,0,9,30,30
1650045725572,MATH 193B,A01,083463,Staff,1,0,30,29
1650045725572,MATH 193B,A02,083464,Staff,9,0,30,21
1650045725572,MATH 193B,A03,083465,Staff,18,0,30,12
1650045731638,COGS 2,A01,083966,Boyle; Mary E. T.,10,0,30,20
1650045737665,COGS 9,A01,083968,Staff,8,0,60,52
1650045743713,COGS 14B,A01,083970,Staff,9,0,50,41
1650045749743,COGS 17,A01,092679,Staff,50,0,75,25
1650045755781,COGS 100,A01,083972,Staff,0,16,60,60
1650045767834,COGS 101C,A01,083976,Staff,12,0,30,18
1650045773868,COGS 102A,A01,083978,Johnson; Christine M.,13,0,30,17
1650045779893,COGS 107B,A01,083980,Staff,0,7,50,50
1650045785925,COGS 115,A01,083982,Staff,10,0,30,20
1650045791950,COGS 118B,A01,083367,Staff,0,15,40,40
1650045797974,COGS 172,A01,083984,Provenzano; Emily Kara,15,0,30,15
1650045804001,COGS 177,A00,083368,Staff,0,20,30,30
1650045810027,COGS 186,A01,083986,Staff,21,0,40,19
1650045816059,COGS 187A,A01,083988,Boyle; Mary E. T.,20,0,60,40
1650045822085,CSE 8A,A50,084003,Miranda; Gregory Joseph,0,15,15,15
1650045828108,CSE 11,A01,084005,Miranda; Gregory Joseph,0,22,55,55
1650045834131,CSE 20,A01,084007,Staff,0,5,20,20
1650045840157,CSE 21,A01,084009,Staff,0,31,50,50
1650045846180,CSE 30,A01,083370,Cao; Yingjun,0,65,40,40
1650045852202,CSE 100,A01,083372,Cao; Yingjun,0,46,40,40
1650045858224,CSE 101,A01,084011,Staff,0,54,40,40
1650045864265,CSE 141,A01,083374,Eldon; John,0,64,75,75
1650045870306,CSE 141L,A01,083376,Eldon; John,0,70,75,75
1650045876331,CSE 175,A01,084013,Kumar; Rakesh,22,0,25,3
1650045882365,CSE 190,A00,092508,Dubnov; Shlomo,19,0,20,1
1650045888391,ECE 5,A01,084049,Morris; Karcher William,12,0,20,8
1650045894413,ECE 100,A01,084051,Baghdadchi; Saharnaz,0,0,20,20
1650045894413,ECE 100,A02,091916,Baghdadchi; Saharnaz,13,0,20,7
1650045900439,ECE 101,A01,084053,Baghdadchi; Saharnaz,0,0,37,37
1650045900439,ECE 101,A02,084054,Baghdadchi; Saharnaz,29,0,37,8
1650045906462,ECE 107,A01,083390,Staff,26,0,40,14
1650045912494,ECE 148,A01,084056,Silberman; Jack,8,0,12,4
1650045918528,ECE 180,A00,083391,Abi Samra; Nicholas Camill,25,0,30,5
1650045918528,ECE 180,B00,083392,Abi Samra; Nicholas Camill,21,0,30,9
1650045924566,MATH 10B,A01,084110,Staff,0,0,30,30
1650045924566,MATH 10B,A02,084111,Staff,17,0,30,13
1650045924566,MATH 10B,A03,084112,Staff,24,0,30,6
1650045930591,MATH 10C,A01,083443,Staff,0,17,30,30
1650045930591,MATH 10C,A02,083444,Staff,0,16,30,30
1650045930591,MATH 10C,B01,084114,Staff,19,0,30,11
1650045930591,MATH 10C,B02,084115,Staff,25,0,30,5
1650045936621,MATH 18,A01,084117,Harel; Guershon,12,0,30,18
1650045936621,MATH 18,A02,084119,Harel; Guershon,27,0,30,3
1650045936621,MATH 18,A03,084120,Harel; Guershon,30,0,30,0
1650045936621,MATH 18,A04,084121,Harel; Guershon,29,0,30,1
1650045942655,MATH 20B,A01,084124,Um; Ko Woon,11,0,35,24
1650045942655,MATH 20B,B01,084126,Um; Ko Woon,24,0,35,11
1650045948690,MATH 20C,A01,083446,Hammock; Frances H,0,0,30,30
1650045948690,MATH 20C,A02,083447,Hammock; Frances H,14,0,30,16
1650045948690,MATH 20C,A03,083448,Hammock; Frances H,19,0,30,11
1650045948690,MATH 20C,A04,083449,Hammock; Frances H,20,0,30,10
1650045948690,MATH 20C,B01,083451,Hammock; Frances H,0,0,30,30
1650045948690,MATH 20C,B02,083452,Hammock; Frances H,18,0,30,12
1650045948690,MATH 20C,B03,083453,Hammock; Frances H,21,0,30,9
1650045948690,MATH 20C,B04,083454,Hammock; Frances H,23,0,30,7
1650045954719,MATH 20D,A01,084128,Staff,14,0,30,16
1650045954719,MATH 20D,A02,084129,Staff,29,0,30,1
1650045954719,MATH 20D,A03,084130,Staff,27,0,30,3
1650045954719,MATH 20D,B01,084133,Staff,1,0,30,29
1650045954719,MATH 20D,B02,084134,Staff,23,0,30,7
1650045954719,MATH 20D,B03,084135,Staff,28,0,30,2
1650045960746,MATH 20E,A01,084138,Staff,13,0,30,17
1650045960746,MATH 20E,A02,084139,Staff,6,0,30,24
1650045960746,MATH 20E,A03,084140,Staff,15,0,30,15
1650045960746,MATH 20E,A04,084141,Staff,20,0,30,10
1650045966769,MATH 102,A01,084143,Harel; Guershon,12,0,30,18
1650045966769,MATH 102,A02,084144,Harel; Guershon,19,0,30,11
1650045972797,MATH 103B,A01,083456,Staff,0,13,30,30
1650045972797,MATH 103B,A02,083457,Staff,0,14,30,30
1650045978910,MATH 109,A01,084146,Salehi Golsefidy; Alireza,17,0,30,13
1650045978910,MATH 109,A02,084147,Salehi Golsefidy; Alireza,15,0,30,15
1650045984945,MATH 120A,A01,085445,Eggers; John Dietrich,10,0,35,25
1650045984945,MATH 120A,A02,085446,Eggers; John Dietrich,27,0,35,8
1650045990971,MATH 142B,A01,084149,Verstraete; Jacques Allan,0,12,30,30
1650045990971,MATH 142B,A02,084150,Verstraete; Jacques Allan,0,12,30,30
1650045996995,MATH 170A,A01,083459,Nie; Jiawang,0,9,30,30
1650045996995,MATH 170A,A02,083460,Nie; Jiawang,0,8,30,30
1650045996995,MATH 170A,A03,083461,Nie; Jiawang,0,9,30,30
1650046003021,MATH 193B,A01,083463,Staff,1,0,30,29
1650046003021,MATH 193B,A02,083464,Staff,9,0,30,21
1650046003021,MATH 193B,A03,083465,Staff,18,0,30,12
1650046009069,COGS 2,A01,083966,Boyle; Mary E. T.,10,0,30,20
1650046015095,COGS 9,A01,083968,Staff,8,0,60,52
1650046021128,COGS 14B,A01,083970,Staff,9,0,50,41
1650046027160,COGS 17,A01,092679,Staff,50,0,75,25
1650046033192,COGS 100,A01,083972,Staff,0,16,60,60
1650046045253,COGS 101C,A01,083976,Staff,12,0,30,18
1650046051276,COGS 102A,A01,083978,Johnson; Christine M.,13,0,30,17
1650046057312,COGS 107B,A01,083980,Staff,0,7,50,50
1650046063337,COGS 115,A01,083982,Staff,10,0,30,20
1650046069365,COGS 118B,A01,083367,Staff,0,15,40,40
1650046075394,COGS 172,A01,083984,Provenzano; Emily Kara,15,0,30,15
1650046081417,COGS 177,A00,083368,Staff,0,20,30,30
1650046087444,COGS 186,A01,083986,Staff,21,0,40,19
1650046093485,COGS 187A,A01,083988,Boyle; Mary E. T.,20,0,60,40
1650046099513,CSE 8A,A50,084003,Miranda; Gregory Joseph,0,15,15,15
1650046105541,CSE 11,A01,084005,Miranda; Gregory Joseph,0,22,55,55
1650046111567,CSE 20,A01,084007,Staff,0,5,20,20
1650046117589,CSE 21,A01,084009,Staff,0,31,50,50
1650046123612,CSE 30,A01,083370,Cao; Yingjun,0,65,40,40
1650046129637,CSE 100,A01,083372,Cao; Yingjun,0,46,40,40
1650046135682,CSE 101,A01,084011,Staff,0,54,40,40
1650046141721,CSE 141,A01,083374,Eldon; John,0,64,75,75
1650046147749,CSE 141L,A01,083376,Eldon; John,0,70,75,75
1650046153782,CSE 175,A01,084013,Kumar; Rakesh,22,0,25,3
1650046159805,CSE 190,A00,092508,Dubnov; Shlomo,19,0,20,1
1650046165831,ECE 5,A01,084049,Morris; Karcher William,12,0,20,8
1650046171863,ECE 100,A01,084051,Baghdadchi; Saharnaz,0,0,20,20
1650046171863,ECE 100,A02,091916,Baghdadchi; Saharnaz,13,0,20,7
1650046177892,ECE 101,A01,084053,Baghdadchi; Saharnaz,0,0,37,37
1650046177892,ECE 101,A02,084054,Baghdadchi; Saharnaz,29,0,37,8
1650046183921,ECE 107,A01,083390,Staff,26,0,40,14
1650046189944,ECE 148,A01,084056,Silberman; Jack,8,0,12,4
1650046195965,ECE 180,A00,083391,Abi Samra; Nicholas Camill,25,0,30,5
1650046195965,ECE 180,B00,083392,Abi Samra; Nicholas Camill,21,0,30,9
1650046201994,MATH 10B,A01,084110,Staff,0,0,30,30
1650046201994,MATH 10B,A02,084111,Staff,17,0,30,13
1650046201994,MATH 10B,A03,084112,Staff,24,0,30,6
1650046208018,MATH 10C,A01,083443,Staff,0,17,30,30
1650046208018,MATH 10C,A02,083444,Staff,0,16,30,30
1650046208018,MATH 10C,B01,084114,Staff,19,0,30,11
1650046208018,MATH 10C,B02,084115,Staff,25,0,30,5
1650046214043,MATH 18,A01,084117,Harel; Guershon,12,0,30,18
1650046214043,MATH 18,A02,084119,Harel; Guershon,27,0,30,3
1650046214043,MATH 18,A03,084120,Harel; Guershon,30,0,30,0
1650046214043,MATH 18,A04,084121,Harel; Guershon,29,0,30,1
1650046220066,MATH 20B,A01,084124,Um; Ko Woon,11,0,35,24
1650046220066,MATH 20B,B01,084126,Um; Ko Woon,24,0,35,11
1650046226095,MATH 20C,A01,083446,Hammock; Frances H,0,0,30,30
1650046226095,MATH 20C,A02,083447,Hammock; Frances H,14,0,30,16
1650046226095,MATH 20C,A03,083448,Hammock; Frances H,19,0,30,11
1650046226095,MATH 20C,A04,083449,Hammock; Frances H,20,0,30,10
1650046226095,MATH 20C,B01,083451,Hammock; Frances H,0,0,30,30
1650046226095,MATH 20C,B02,083452,Hammock; Frances H,18,0,30,12
1650046226095,MATH 20C,B03,083453,Hammock; Frances H,21,0,30,9
1650046226095,MATH 20C,B04,083454,Hammock; Frances H,23,0,30,7
1650046232119,MATH 20D,A01,084128,Staff,14,0,30,16
1650046232119,MATH 20D,A02,084129,Staff,29,0,30,1
1650046232119,MATH 20D,A03,084130,Staff,27,0,30,3
1650046232119,MATH 20D,B01,084133,Staff,1,0,30,29
1650046232119,MATH 20D,B02,084134,Staff,23,0,30,7
1650046232119,MATH 20D,B03,084135,Staff,28,0,30,2
1650046238149,MATH 20E,A01,084138,Staff,13,0,30,17
1650046238149,MATH 20E,A02,084139,Staff,6,0,30,24
1650046238149,MATH 20E,A03,084140,Staff,15,0,30,15
1650046238149,MATH 20E,A04,084141,Staff,20,0,30,10
1650046244184,MATH 102,A01,084143,Harel; Guershon,12,0,30,18
1650046244184,MATH 102,A02,084144,Harel; Guershon,19,0,30,11
1650046250208,MATH 103B,A01,083456,Staff,0,13,30,30
1650046250208,MATH 103B,A02,083457,Staff,0,14,30,30
1650046256234,MATH 109,A01,084146,Salehi Golsefidy; Alireza,17,0,30,13
1650046256234,MATH 109,A02,084147,Salehi Golsefidy; Alireza,15,0,30,15
1650046262261,MATH 120A,A01,085445,Eggers; John Dietrich,10,0,35,25
1650046262261,MATH 120A,A02,085446,Eggers; John Dietrich,27,0,35,8
1650046268292,MATH 142B,A01,084149,Verstraete; Jacques Allan,0,12,30,30
1650046268292,MATH 142B,A02,084150,Verstraete; Jacques Allan,0,12,30,30
1650046274315,MATH 170A,A01,083459,Nie; Jiawang,0,9,30,30
1650046274315,MATH 170A,A02,083460,Nie; Jiawang,0,8,30,30
1650046274315,MATH 170A,A03,083461,Nie; Jiawang,0,9,30,30
1650046280339,MATH 193B,A01,083463,Staff,1,0,30,29
1650046280339,MATH 193B,A02,083464,Staff,9,0,30,21
1650046280339,MATH 193B,A03,083465,Staff,18,0,30,12
1650046286399,COGS 2,A01,083966,Boyle; Mary E. T.,10,0,30,20
1650046292425,COGS 9,A01,083968,Staff,8,0,60,52
1650046298448,COGS 14B,A01,083970,Staff,9,0,50,41
1650046304471,COGS 17,A01,092679,Staff,50,0,75,25
1650046310502,COGS 100,A01,083972,Staff,0,16,60,60
1650046322553,COGS 101C,A01,083976,Staff,12,0,30,18
1650046328581,COGS 102A,A01,083978,Johnson; Christine M.,13,0,30,17
1650046334603,COGS 107B,A01,083980,Staff,0,7,50,50
1650046340631,COGS 115,A01,083982,Staff,10,0,30,20
1650046346661,COGS 118B,A01,083367,Staff,0,15,40,40
1650046352683,COGS 172,A01,083984,Provenzano; Emily Kara,15,0,30,15
1650046358709,COGS 177,A00,083368,Staff,0,20,30,30
1650046364736,COGS 186,A01,083986,Staff,21,0,40,19
1650046370763,COGS 187A,A01,083988,Boyle; Mary E. T.,20,0,60,40
1650046376787,CSE 8A,A50,084003,Miranda; Gregory Joseph,0,15,15,15
1650046382813,CSE 11,A01,084005,Miranda; Gregory Joseph,0,22,55,55
1650046388839,CSE 20,A01,084007,Staff,0,5,20,20
1650046394863,CSE 21,A01,084009,Staff,0,31,50,50
1650046400885,CSE 30,A01,083370,Cao; Yingjun,0,65,40,40
1650046406908,CSE 100,A01,083372,Cao; Yingjun,0,46,40,40
1650046412932,CSE 101,A01,084011,Staff,0,54,40,40
1650046418954,CSE 141,A01,083374,Eldon; John,0,64,75,75
1650046424982,CSE 141L,A01,083376,Eldon; John,0,70,75,75
1650046431003,CSE 175,A01,084013,Kumar; Rakesh,22,0,25,3
1650046437026,CSE 190,A00,092508,Dubnov; Shlomo,19,0,20,1
1650046443052,ECE 5,A01,084049,Morris; Karcher William,12,0,20,8
1650046449075,ECE 100,A01,084051,Baghdadchi; Saharnaz,0,0,20,20
1650046449075,ECE 100,A02,091916,Baghdadchi; Saharnaz,13,0,20,7
1650046455099,ECE 101,A01,084053,Baghdadchi; Saharnaz,0,0,37,37
1650046455099,ECE 101,A02,084054,Baghdadchi; Saharnaz,30,0,37,7
1650046461129,ECE 107,A01,083390,Staff,26,0,40,14
1650046467157,ECE 148,A01,084056,Silberman; Jack,8,0,12,4
1650046473184,ECE 180,A00,083391,Abi Samra; Nicholas Camill,25,0,30,5
1650046473184,ECE 180,B00,083392,Abi Samra; Nicholas Camill,21,0,30,9
1650046479209,MATH 10B,A01,084110,Staff,0,0,30,30
1650046479209,MATH 10B,A02,084111,Staff,17,0,30,13
1650046479209,MATH 10B,A03,084112,Staff,24,0,30,6
1650046485238,MATH 10C,A01,083443,Staff,0,17,30,30
1650046485238,MATH 10C,A02,083444,Staff,0,16,30,30
1650046485238,MATH 10C,B01,084114,Staff,19,0,30,11
1650046485238,MATH 10C,B02,084115,Staff,25,0,30,5
1650046491264,MATH 18,A01,084117,Harel; Guershon,12,0,30,18
1650046491264,MATH 18,A02,084119,Harel; Guershon,27,0,30,3
1650046491264,MATH 18,A03,084120,Harel; Guershon,30,0,30,0
1650046491264,MATH 18,A04,084121,Harel; Guershon,29,0,30,1
1650046497287,MATH 20B,A01,084124,Um; Ko Woon,11,0,35,24
1650046497287,MATH 20B,B01,084126,Um; Ko Woon,24,0,35,11
1650046503317,MATH 20C,A01,083446,Hammock; Frances H,0,0,30,30
1650046503317,MATH 20C,A02,083447,Hammock; Frances H,14,0,30,16
1650046503317,MATH 20C,A03,083448,Hammock; Frances H,19,0,30,11
1650046503317,MATH 20C,A04,083449,Hammock; Frances H,20,0,30,10
1650046503317,MATH 20C,B01,083451,Hammock; Frances H,0,0,30,30
1650046503317,MATH 20C,B02,083452,Hammock; Frances H,18,0,30,12
1650046503317,MATH 20C,B03,083453,Hammock; Frances H,21,0,30,9
1650046503317,MATH 20C,B04,083454,Hammock; Frances H,23,0,30,7
1650046509344,MATH 20D,A01,084128,Staff,14,0,30,16
1650046509344,MATH 20D,A02,084129,Staff,29,0,30,1
1650046509344,MATH 20D,A03,084130,Staff,27,0,30,3
1650046509344,MATH 20D,B01,084133,Staff,1,0,30,29
1650046509344,MATH 20D,B02,084134,Staff,23,0,30,7
1650046509344,MATH 20D,B03,084135,Staff,28,0,30,2
1650046515371,MATH 20E,A01,084138,Staff,13,0,30,17
1650046515371,MATH 20E,A02,084139,Staff,6,0,30,24
1650046515371,MATH 20E,A03,084140,Staff,15,0,30,15
1650046515371,MATH 20E,A04,084141,Staff,20,0,30,10
1650046521394,MATH 102,A01,084143,Harel; Guershon,12,0,30,18
1650046521394,MATH 102,A02,084144,Harel; Guershon,19,0,30,11
1650046527425,MATH 103B,A01,083456,Staff,0,13,30,30
1650046527425,MATH 103B,A02,083457,Staff,0,14,30,30
1650046533453,MATH 109,A01,084146,Salehi Golsefidy; Alireza,17,0,30,13
1650046533453,MATH 109,A02,084147,Salehi Golsefidy; Alireza,15,0,30,15
1650046539477,MATH 120A,A01,085445,Eggers; John Dietrich,10,0,35,25
1650046539477,MATH 120A,A02,085446,Eggers; John Dietrich,27,0,35,8
1650046545504,MATH 142B,A01,084149,Verstraete; Jacques Allan,0,12,30,30
1650046545504,MATH 142B,A02,084150,Verstraete; Jacques Allan,0,12,30,30
1650046551540,MATH 170A,A01,083459,Nie; Jiawang,0,9,30,30
1650046551540,MATH 170A,A02,083460,Nie; Jiawang,0,8,30,30
1650046551540,MATH 170A,A03,083461,Nie; Jiawang,0,9,30,30
1650046557573,MATH 193B,A01,083463,Staff,1,0,30,29
1650046557573,MATH 193B,A02,083464,Staff,9,0,30,21
1650046557573,MATH 193B,A03,083465,Staff,18,0,30,12
1650046563639,COGS 2,A01,083966,Boyle; Mary E. T.,10,0,30,20
1650046569763,COGS 9,A01,083968,Staff,7,0,60,53
1650046575795,COGS 14B,A01,083970,Staff,9,0,50,41
1650046581818,COGS 17,A01,092679,Staff,50,0,75,25
1650046587858,COGS 100,A01,083972,Staff,0,16,60,60
1650046599910,COGS 101C,A01,083976,Staff,12,0,30,18
1650046605936,COGS 102A,A01,083978,Johnson; Christine M.,13,0,30,17
1650046611963,COGS 107B,A01,083980,Staff,0,7,50,50
1650046617986,COGS 115,A01,083982,Staff,10,0,30,20
1650046624009,COGS 118B,A01,083367,Staff,0,15,40,40
1650046630037,COGS 172,A01,083984,Provenzano; Emily Kara,15,0,30,15
1650046636067,COGS 177,A00,083368,Staff,0,20,30,30
1650046642090,COGS 186,A01,083986,Staff,21,0,40,19
1650046648114,COGS 187A,A01,083988,Boyle; Mary E. T.,20,0,60,40
1650046654149,CSE 8A,A50,084003,Miranda; Gregory Joseph,0,15,15,15
1650046660181,CSE 11,A01,084005,Miranda; Gregory Joseph,0,22,55,55
1650046666203,CSE 20,A01,084007,Staff,0,5,20,20
1650046672227,CSE 21,A01,084009,Staff,0,32,50,50
1650046678253,CSE 30,A01,083370,Cao; Yingjun,0,65,40,40
1650046684277,CSE 100,A01,083372,Cao; Yingjun,0,46,40,40
1650046690324,CSE 101,A01,084011,Staff,0,54,40,40
1650046696347,CSE 141,A01,083374,Eldon; John,0,64,75,75
1650046702377,CSE 141L,A01,083376,Eldon; John,0,70,75,75
1650046708404,CSE 175,A01,084013,Kumar; Rakesh,22,0,25,3
1650046714432,CSE 190,A00,092508,Dubnov; Shlomo,19,0,20,1
1650046720458,ECE 5,A01,084049,Morris; Karcher William,12,0,20,8
1650046726492,ECE 100,A01,084051,Baghdadchi; Saharnaz,0,0,20,20
1650046726492,ECE 100,A02,091916,Baghdadchi; Saharnaz,13,0,20,7
1650046732519,ECE 101,A01,084053,Baghdadchi; Saharnaz,0,0,37,37
1650046732519,ECE 101,A02,084054,Baghdadchi; Saharnaz,30,0,37,7
1650046738547,ECE 107,A01,083390,Staff,26,0,40,14
1650046744583,ECE 148,A01,084056,Silberman; Jack,8,0,12,4
1650046750613,ECE 180,A00,083391,Abi Samra; Nicholas Camill,25,0,30,5
1650046750613,ECE 180,B00,083392,Abi Samra; Nicholas Camill,21,0,30,9
1650046756645,MATH 10B,A01,084110,Staff,0,0,30,30
1650046756645,MATH 10B,A02,084111,Staff,17,0,30,13
1650046756645,MATH 10B,A03,084112,Staff,24,0,30,6
1650046762672,MATH 10C,A01,083443,Staff,0,17,30,30
1650046762672,MATH 10C,A02,083444,Staff,0,16,30,30
1650046762672,MATH 10C,B01,084114,Staff,19,0,30,11
1650046762672,MATH 10C,B02,084115,Staff,25,0,30,5
1650046768700,MATH 18,A01,084117,Harel; Guershon,12,0,30,18
1650046768700,MATH 18,A02,084119,Harel; Guershon,27,0,30,3
1650046768700,MATH 18,A03,084120,Harel; Guershon,30,0,30,0
1650046768700,MATH 18,A04,084121,Harel; Guershon,29,0,30,1
1650046774729,MATH 20B,A01,084124,Um; Ko Woon,11,0,35,24
1650046774729,MATH 20B,B01,084126,Um; Ko Woon,24,0,35,11
1650046780767,MATH 20C,A01,083446,Hammock; Frances H,0,0,30,30
1650046780767,MATH 20C,A02,083447,Hammock; Frances H,14,0,30,16
1650046780767,MATH 20C,A03,083448,Hammock; Frances H,19,0,30,11
1650046780767,MATH 20C,A04,083449,Hammock; Frances H,20,0,30,10
1650046780767,MATH 20C,B01,083451,Hammock; Frances H,0,0,30,30
1650046780767,MATH 20C,B02,083452,Hammock; Frances H,18,0,30,12
1650046780767,MATH 20C,B03,083453,Hammock; Frances H,21,0,30,9
1650046780767,MATH 20C,B04,083454,Hammock; Frances H,23,0,30,7
1650046786793,MATH 20D,A01,084128,Staff,14,0,30,16
1650046786793,MATH 20D,A02,084129,Staff,29,0,30,1
1650046786793,MATH 20D,A03,084130,Staff,27,0,30,3
1650046786793,MATH 20D,B01,084133,Staff,1,0,30,29
1650046786793,MATH 20D,B02,084134,Staff,23,0,30,7
1650046786793,MATH 20D,B03,084135,Staff,28,0,30,2
1650046792817,MATH 20E,A01,084138,Staff,13,0,30,17
1650046792817,MATH 20E,A02,084139,Staff,6,0,30,24
1650046792817,MATH 20E,A03,084140,Staff,15,0,30,15
1650046792817,MATH 20E,A04,084141,Staff,20,0,30,10
1650046798841,MATH 102,A01,084143,Harel; Guershon,12,0,30,18
1650046798841,MATH 102,A02,084144,Harel; Guershon,19,0,30,11
1650046804877,MATH 103B,A01,083456,Staff,0,13,30,30
1650046804877,MATH 103B,A02,083457,Staff,0,14,30,30
1650046810912,MATH 109,A01,084146,Salehi Golsefidy; Alireza,17,0,30,13
1650046810912,MATH 109,A02,084147,Salehi Golsefidy; Alireza,15,0,30,15
1650046816937,MATH 120A,A01,085445,Eggers; John Dietrich,10,0,35,25
1650046816937,MATH 120A,A02,085446,Eggers; John Dietrich,27,0,35,8
1650046822961,MATH 142B,A01,084149,Verstraete; Jacques Allan,0,12,30,30
1650046822961,MATH 142B,A02,084150,Verstraete; Jacques Allan,0,12,30,30
1650046828984,MATH 170A,A01,083459,Nie; Jiawang,0,9,30,30
1650046828984,MATH 170A,A02,083460,Nie; Jiawang,0,8,30,30
1650046828984,MATH 170A,A03,083461,Nie; Jiawang,0,9,30,30
1650046835008,MATH 193B,A01,083463,Staff,1,0,30,29
1650046835008,MATH 193B,A02,083464,Staff,9,0,30,21
1650046835008,MATH 193B,A03,083465,Staff,18,0,30,12
1650046841064,COGS 2,A01,083966,Boyle; Mary E. T.,10,0,30,20
1650046847088,COGS 9,A01,083968,Staff,7,0,60,53
1650046853115,COGS 14B,A01,083970,Staff,9,0,50,41
1650046859139,COGS 17,A01,092679,Staff,50,0,75,25
1650046865165,COGS 100,A01,083972,Staff,0,16,60,60
1650046877222,COGS 101C,A01,083976,Staff,12,0,30,18
1650046883248,COGS 102A,A01,083978,Johnson; Christine M.,13,0,30,17
1650046889279,COGS 107B,A01,083980,Staff,0,7,50,50
1650046895303,COGS 115,A01,083982,Staff,10,0,30,20
1650046901327,COGS 118B,A01,083367,Staff,0,15,40,40
1650046907353,COGS 172,A01,083984,Provenzano; Emily Kara,15,0,30,15
1650046913376,COGS 177,A00,083368,Staff,0,20,30,30
1650046919404,COGS 186,A01,083986,Staff,21,0,40,19
1650046925428,COGS 187A,A01,083988,Boyle; Mary E. T.,20,0,60,40
1650046931457,CSE 8A,A50,084003,Miranda; Gregory Joseph,0,15,15,15
1650046937488,CSE 11,A01,084005,Miranda; Gregory Joseph,0,22,55,55
1650046943515,CSE 20,A01,084007,Staff,0,5,20,20
1650046949544,CSE 21,A01,084009,Staff,0,32,50,50
1650046955572,CSE 30,A01,083370,Cao; Yingjun,0,65,40,40
1650046961594,CSE 100,A01,083372,Cao; Yingjun,0,46,40,40
1650046967620,CSE 101,A01,084011,Staff,0,54,40,40
1650046973642,CSE 141,A01,083374,Eldon; John,0,64,75,75
1650046979665,CSE 141L,A01,083376,Eldon; John,0,70,75,75
1650046985692,CSE 175,A01,084013,Kumar; Rakesh,22,0,25,3
1650046991721,CSE 190,A00,092508,Dubnov; Shlomo,19,0,20,1
1650046997744,ECE 5,A01,084049,Morris; Karcher William,12,0,20,8
1650047003778,ECE 100,A01,084051,Baghdadchi; Saharnaz,0,0,20,20
1650047003778,ECE 100,A02,091916,Baghdadchi; Saharnaz,13,0,20,7
1650047009802,ECE 101,A01,084053,Baghdadchi; Saharnaz,0,0,37,37
1650047009802,ECE 101,A02,084054,Baghdadchi; Saharnaz,30,0,37,7
1650047015825,ECE 107,A01,083390,Staff,26,0,40,14
1650047021852,ECE 148,A01,084056,Silberman; Jack,8,0,12,4
1650047027879,ECE 180,A00,083391,Abi Samra; Nicholas Camill,25,0,30,5
1650047027879,ECE 180,B00,083392,Abi Samra; Nicholas Camill,21,0,30,9
1650047033906,MATH 10B,A01,084110,Staff,0,0,30,30
1650047033906,MATH 10B,A02,084111,Staff,17,0,30,13
1650047033906,MATH 10B,A03,084112,Staff,24,0,30,6
1650047039930,MATH 10C,A01,083443,Staff,0,17,30,30
1650047039930,MATH 10C,A02,083444,Staff,0,16,30,30
1650047039930,MATH 10C,B01,084114,Staff,19,0,30,11
1650047039930,MATH 10C,B02,084115,Staff,25,0,30,5
1650047045961,MATH 18,A01,084117,Harel; Guershon,12,0,30,18
1650047045961,MATH 18,A02,084119,Harel; Guershon,27,0,30,3
1650047045961,MATH 18,A03,084120,Harel; Guershon,30,0,30,0
1650047045961,MATH 18,A04,084121,Harel; Guershon,29,0,30,1
1650047051993,MATH 20B,A01,084124,Um; Ko Woon,11,0,35,24
1650047051993,MATH 20B,B01,084126,Um; Ko Woon,24,0,35,11
1650047058024,MATH 20C,A01,083446,Hammock; Frances H,0,0,30,30
1650047058024,MATH 20C,A02,083447,Hammock; Frances H,14,0,30,16
1650047058024,MATH 20C,A03,083448,Hammock; Frances H,19,0,30,11
1650047058024,MATH 20C,A04,083449,Hammock; Frances H,20,0,30,10
1650047058024,MATH 20C,B01,083451,Hammock; Frances H,0,0,30,30
1650047058024,MATH 20C,B02,083452,Hammock; Frances H,18,0,30,12
1650047058024,MATH 20C,B03,083453,Hammock; Frances H,21,0,30,9
1650047058024,MATH 20C,B04,083454,Hammock; Frances H,23,0,30,7
1650047064052,MATH 20D,A01,084128,Staff,14,0,30,16
1650047064052,MATH 20D,A02,084129,Staff,29,0,30,1
1650047064052,MATH 20D,A03,084130,Staff,27,0,30,3
1650047064052,MATH 20D,B01,084133,Staff,1,0,30,29
1650047064052,MATH 20D,B02,084134,Staff,23,0,30,7
1650047064052,MATH 20D,B03,084135,Staff,28,0,30,2
1650047070076,MATH 20E,A01,084138,Staff,13,0,30,17
1650047070076,MATH 20E,A02,084139,Staff,6,0,30,24
1650047070076,MATH 20E,A03,084140,Staff,15,0,30,15
1650047070076,MATH 20E,A04,084141,Staff,20,0,30,10
1650047076106,MATH 102,A01,084143,Harel; Guershon,12,0,30,18
1650047076106,MATH 102,A02,084144,Harel; Guershon,19,0,30,11
1650047082132,MATH 103B,A01,083456,Staff,0,13,30,30
1650047082132,MATH 103B,A02,083457,Staff,0,14,30,30
1650047088155,MATH 109,A01,084146,Salehi Golsefidy; Alireza,17,0,30,13
1650047088155,MATH 109,A02,084147,Salehi Golsefidy; Alireza,15,0,30,15
1650047094181,MATH 120A,A01,085445,Eggers; John Dietrich,10,0,35,25
1650047094181,MATH 120A,A02,085446,Eggers; John Dietrich,27,0,35,8
1650047100207,MATH 142B,A01,084149,Verstraete; Jacques Allan,0,12,30,30
1650047100207,MATH 142B,A02,084150,Verstraete; Jacques Allan,0,12,30,30
1650047106230,MATH 170A,A01,083459,Nie; Jiawang,0,9,30,30
1650047106230,MATH 170A,A02,083460,Nie; Jiawang,0,8,30,30
1650047106230,MATH 170A,A03,083461,Nie; Jiawang,0,9,30,30
1650047112255,MATH 193B,A01,083463,Staff,1,0,30,29
1650047112255,MATH 193B,A02,083464,Staff,9,0,30,21
1650047112255,MATH 193B,A03,083465,Staff,18,0,30,12
1650047118318,COGS 2,A01,083966,Boyle; Mary E. T.,10,0,30,20
1650047124341,COGS 9,A01,083968,Staff,7,0,60,53
1650047130375,COGS 14B,A01,083970,Staff,9,0,50,41
1650047136398,COGS 17,A01,092679,Staff,50,0,75,25
1650047142420,COGS 100,A01,083972,Staff,0,16,60,60
1650047154471,COGS 101C,A01,083976,Staff,12,0,30,18
1650047160496,COGS 102A,A01,083978,Johnson; Christine M.,13,0,30,17
1650047166598,COGS 107B,A01,083980,Staff,0,7,50,50
1650047172624,COGS 115,A01,083982,Staff,10,0,30,20
1650047178658,COGS 118B,A01,083367,Staff,0,15,40,40
1650047184692,COGS 172,A01,083984,Provenzano; Emily Kara,15,0,30,15
1650047190717,COGS 177,A00,083368,Staff,0,20,30,30
1650047196743,COGS 186,A01,083986,Staff,21,0,40,19
1650047202768,COGS 187A,A01,083988,Boyle; Mary E. T.,20,0,60,40
1650047208795,CSE 8A,A50,084003,Miranda; Gregory Joseph,0,15,15,15
1650047214817,CSE 11,A01,084005,Miranda; Gregory Joseph,0,22,55,55
1650047220848,CSE 20,A01,084007,Staff,0,5,20,20
1650047226876,CSE 21,A01,084009,Staff,0,32,50,50
1650047232900,CSE 30,A01,083370,Cao; Yingjun,0,65,40,40
1650047238923,CSE 100,A01,083372,Cao; Yingjun,0,46,40,40
1650047244949,CSE 101,A01,084011,Staff,0,54,40,40
1650047250973,CSE 141,A01,083374,Eldon; John,0,65,75,75
1650047257000,CSE 141L,A01,083376,Eldon; John,0,71,75,75
1650047263029,CSE 175,A01,084013,Kumar; Rakesh,22,0,25,3
1650047269061,CSE 190,A00,092508,Dubnov; Shlomo,19,0,20,1
1650047275090,ECE 5,A01,084049,Morris; Karcher William,12,0,20,8
1650047281114,ECE 100,A01,084051,Baghdadchi; Saharnaz,0,0,20,20
1650047281114,ECE 100,A02,091916,Baghdadchi; Saharnaz,13,0,20,7
1650047287152,ECE 101,A01,084053,Baghdadchi; Saharnaz,0,0,37,37
1650047287152,ECE 101,A02,084054,Baghdadchi; Saharnaz,29,0,37,8
1650047293179,ECE 107,A01,083390,Staff,26,0,40,14
1650047299202,ECE 148,A01,084056,Silberman; Jack,8,0,12,4
1650047305227,ECE 180,A00,083391,Abi Samra; Nicholas Camill,25,0,30,5
1650047305227,ECE 180,B00,083392,Abi Samra; Nicholas Camill,21,0,30,9
1650047311253,MATH 10B,A01,084110,Staff,0,0,30,30
1650047311253,MATH 10B,A02,084111,Staff,17,0,30,13
1650047311253,MATH 10B,A03,084112,Staff,24,0,30,6
1650047317277,MATH 10C,A01,083443,Staff,0,17,30,30
1650047317277,MATH 10C,A02,083444,Staff,0,16,30,30
1650047317277,MATH 10C,B01,084114,Staff,19,0,30,11
1650047317277,MATH 10C,B02,084115,Staff,25,0,30,5
1650047323301,MATH 18,A01,084117,Harel; Guershon,12,0,30,18
1650047323301,MATH 18,A02,084119,Harel; Guershon,27,0,30,3
1650047323301,MATH 18,A03,084120,Harel; Guershon,30,0,30,0
1650047323301,MATH 18,A04,084121,Harel; Guershon,29,0,30,1
1650047329323,MATH 20B,A01,084124,Um; Ko Woon,11,0,35,24
1650047329323,MATH 20B,B01,084126,Um; Ko Woon,24,0,35,11
1650047335354,MATH 20C,A01,083446,Hammock; Frances H,0,0,30,30
1650047335354,MATH 20C,A02,083447,Hammock; Frances H,14,0,30,16
1650047335354,MATH 20C,A03,083448,Hammock; Frances H,19,0,30,11
1650047335354,MATH 20C,A04,083449,Hammock; Frances H,20,0,30,10
1650047335354,MATH 20C,B01,083451,Hammock; Frances H,0,0,30,30
1650047335354,MATH 20C,B02,083452,Hammock; Frances H,18,0,30,12
1650047335354,MATH 20C,B03,083453,Hammock; Frances H,21,0,30,9
1650047335354,MATH 20C,B04,083454,Hammock; Frances H,23,0,30,7
1650047341378,MATH 20D,A01,084128,Staff,14,0,30,16
1650047341378,MATH 20D,A02,084129,Staff,29,0,30,1
1650047341378,MATH 20D,A03,084130,Staff,27,0,30,3
1650047341378,MATH 20D,B01,084133,Staff,1,0,30,29
1650047341378,MATH 20D,B02,084134,Staff,23,0,30,7
1650047341378,MATH 20D,B03,084135,Staff,28,0,30,2
1650047347409,MATH 20E,A01,084138,Staff,13,0,30,17
1650047347409,MATH 20E,A02,084139,Staff,6,0,30,24
1650047347409,MATH 20E,A03,084140,Staff,15,0,30,15
1650047347409,MATH 20E,A04,084141,Staff,20,0,30,10
1650047353444,MATH 102,A01,084143,Harel; Guershon,12,0,30,18
1650047353444,MATH 102,A02,084144,Harel; Guershon,19,0,30,11
1650047359466,MATH 103B,A01,083456,Staff,0,13,30,30
1650047359466,MATH 103B,A02,083457,Staff,0,14,30,30
1650047365495,MATH 109,A01,084146,Salehi Golsefidy; Alireza,17,0,30,13
1650047365495,MATH 109,A02,084147,Salehi Golsefidy; Alireza,15,0,30,15
1650047371520,MATH 120A,A01,085445,Eggers; John Dietrich,10,0,35,25
1650047371520,MATH 120A,A02,085446,Eggers; John Dietrich,27,0,35,8
1650047377547,MATH 142B,A01,084149,Verstraete; Jacques Allan,0,12,30,30
1650047377547,MATH 142B,A02,084150,Verstraete; Jacques Allan,0,12,30,30
1650047383574,MATH 170A,A01,083459,Nie; Jiawang,0,9,30,30
1650047383574,MATH 170A,A02,083460,Nie; Jiawang,0,8,30,30
1650047383574,MATH 170A,A03,083461,Nie; Jiawang,0,9,30,30
1650047389597,MATH 193B,A01,083463,Staff,1,0,30,29
1650047389597,MATH 193B,A02,083464,Staff,9,0,30,21
1650047389597,MATH 193B,A03,083465,Staff,18,0,30,12
1650047395668,COGS 2,A01,083966,Boyle; Mary E. T.,10,0,30,20
1650047401693,COGS 9,A01,083968,Staff,8,0,60,52
1650047407717,COGS 14B,A01,083970,Staff,9,0,50,41
1650047413742,COGS 17,A01,092679,Staff,50,0,75,25
1650047419771,COGS 100,A01,083972,Staff,0,16,60,60
1650047431823,COGS 101C,A01,083976,Staff,12,0,30,18
1650047437853,COGS 102A,A01,083978,Johnson; Christine M.,13,0,30,17
1650047443880,COGS 107B,A01,083980,Staff,0,7,50,50
1650047449903,COGS 115,A01,083982,Staff,10,0,30,20
1650047455927,COGS 118B,A01,083367,Staff,0,15,40,40
1650047461949,COGS 172,A01,083984,Provenzano; Emily Kara,15,0,30,15
1650047467974,COGS 177,A00,083368,Staff,0,20,30,30
1650047474001,COGS 186,A01,083986,Staff,21,0,40,19
1650047480028,COGS 187A,A01,083988,Boyle; Mary E. T.,20,0,60,40
1650047486061,CSE 8A,A50,084003,Miranda; Gregory Joseph,0,15,15,15
1650047492092,CSE 11,A01,084005,Miranda; Gregory Joseph,0,22,55,55
1650047498119,CSE 20,A01,084007,Staff,0,5,20,20
1650047504143,CSE 21,A01,084009,Staff,0,32,50,50
1650047510169,CSE 30,A01,083370,Cao; Yingjun,0,65,40,40
1650047516196,CSE 100,A01,083372,Cao; Yingjun,0,46,40,40
1650047522220,CSE 101,A01,084011,Staff,0,54,40,40
1650047528246,CSE 141,A01,083374,Eldon; John,0,65,75,75
1650047534277,CSE 141L,A01,083376,Eldon; John,0,71,75,75
1650047540309,CSE 175,A01,084013,Kumar; Rakesh,22,0,25,3
1650047546332,CSE 190,A00,092508,Dubnov; Shlomo,19,0,20,1
1650047552359,ECE 5,A01,084049,Morris; Karcher William,12,0,20,8
1650047558404,ECE 100,A01,084051,Baghdadchi; Saharnaz,0,0,20,20
1650047558404,ECE 100,A02,091916,Baghdadchi; Saharnaz,13,0,20,7
1650047564444,ECE 101,A01,084053,Baghdadchi; Saharnaz,0,0,37,37
1650047564444,ECE 101,A02,084054,Baghdadchi; Saharnaz,29,0,37,8
1650047570466,ECE 107,A01,083390,Staff,26,0,40,14
1650047576492,ECE 148,A01,084056,Silberman; Jack,8,0,12,4
1650047582532,ECE 180,A00,083391,Abi Samra; Nicholas Camill,25,0,30,5
1650047582532,ECE 180,B00,083392,Abi Samra; Nicholas Camill,21,0,30,9
1650047588556,MATH 10B,A01,084110,Staff,0,0,30,30
1650047588556,MATH 10B,A02,084111,Staff,17,0,30,13
1650047588556,MATH 10B,A03,084112,Staff,24,0,30,6
1650047594582,MATH 10C,A01,083443,Staff,0,17,30,30
1650047594582,MATH 10C,A02,083444,Staff,0,16,30,30
1650047594582,MATH 10C,B01,084114,Staff,19,0,30,11
1650047594582,MATH 10C,B02,084115,Staff,25,0,30,5
1650047600605,MATH 18,A01,084117,Harel; Guershon,12,0,30,18
1650047600605,MATH 18,A02,084119,Harel; Guershon,27,0,30,3
1650047600605,MATH 18,A03,084120,Harel; Guershon,30,0,30,0
1650047600605,MATH 18,A04,084121,Harel; Guershon,29,0,30,1
1650047606634,MATH 20B,A01,084124,Um; Ko Woon,11,0,35,24
1650047606634,MATH 20B,B01,084126,Um; Ko Woon,24,0,35,11
1650047612664,MATH 20C,A01,083446,Hammock; Frances H,0,0,30,30
1650047612664,MATH 20C,A02,083447,Hammock; Frances H,14,0,30,16
1650047612664,MATH 20C,A03,083448,Hammock; Frances H,19,0,30,11
1650047612664,MATH 20C,A04,083449,Hammock; Frances H,20,0,30,10
1650047612664,MATH 20C,B01,083451,Hammock; Frances H,0,0,30,30
1650047612664,MATH 20C,B02,083452,Hammock; Frances H,18,0,30,12
1650047612664,MATH 20C,B03,083453,Hammock; Frances H,21,0,30,9
1650047612664,MATH 20C,B04,083454,Hammock; Frances H,23,0,30,7
1650047618692,MATH 20D,A01,084128,Staff,14,0,30,16
1650047618692,MATH 20D,A02,084129,Staff,29,0,30,1
1650047618692,MATH 20D,A03,084130,Staff,27,0,30,3
1650047618692,MATH 20D,B01,084133,Staff,1,0,30,29
1650047618692,MATH 20D,B02,084134,Staff,23,0,30,7
1650047618692,MATH 20D,B03,084135,Staff,28,0,30,2
1650047624718,MATH 20E,A01,084138,Staff,13,0,30,17
1650047624718,MATH 20E,A02,084139,Staff,6,0,30,24
1650047624718,MATH 20E,A03,084140,Staff,15,0,30,15
1650047624718,MATH 20E,A04,084141,Staff,20,0,30,10
1650047630749,MATH 102,A01,084143,Harel; Guershon,12,0,30,18
1650047630749,MATH 102,A02,084144,Harel; Guershon,19,0,30,11
1650047636773,MATH 103B,A01,083456,Staff,0,13,30,30
1650047636773,MATH 103B,A02,083457,Staff,0,14,30,30
1650047642796,MATH 109,A01,084146,Salehi Golsefidy; Alireza,17,0,30,13
1650047642796,MATH 109,A02,084147,Salehi Golsefidy; Alireza,15,0,30,15
1650047648829,MATH 120A,A01,085445,Eggers; John Dietrich,10,0,35,25
1650047648829,MATH 120A,A02,085446,Eggers; John Dietrich,27,0,35,8
1650047654856,MATH 142B,A01,084149,Verstraete; Jacques Allan,0,12,30,30
1650047654856,MATH 142B,A02,084150,Verstraete; Jacques Allan,0,12,30,30
1650047660880,MATH 170A,A01,083459,Nie; Jiawang,0,9,30,30
1650047660880,MATH 170A,A02,083460,Nie; Jiawang,0,8,30,30
1650047660880,MATH 170A,A03,083461,Nie; Jiawang,0,9,30,30
1650047666904,MATH 193B,A01,083463,Staff,1,0,30,29
1650047666904,MATH 193B,A02,083464,Staff,9,0,30,21
1650047666904,MATH 193B,A03,083465,Staff,18,0,30,12
1650047672964,COGS 2,A01,083966,Boyle; Mary E. T.,10,0,30,20
1650047678989,COGS 9,A01,083968,Staff,7,0,60,53
1650047685020,COGS 14B,A01,083970,Staff,9,0,50,41
1650047691055,COGS 17,A01,092679,Staff,50,0,75,25
1650047697081,COGS 100,A01,083972,Staff,0,16,60,60
1650047709135,COGS 101C,A01,083976,Staff,12,0,30,18
1650047715164,COGS 102A,A01,083978,Johnson; Christine M.,13,0,30,17
1650047721206,COGS 107B,A01,083980,Staff,0,7,50,50
1650047727229,COGS 115,A01,083982,Staff,10,0,30,20
1650047733254,COGS 118B,A01,083367,Staff,0,15,40,40
1650047739281,COGS 172,A01,083984,Provenzano; Emily Kara,15,0,30,15
1650047745305,COGS 177,A00,083368,Staff,0,20,30,30
1650047751329,COGS 186,A01,083986,Staff,21,0,40,19
1650047757356,COGS 187A,A01,083988,Boyle; Mary E. T.,20,0,60,40
1650047763493,CSE 8A,A50,084003,Miranda; Gregory Joseph,0,15,15,15
1650047769518,CSE 11,A01,084005,Miranda; Gregory Joseph,0,22,55,55
1650047775544,CSE 20,A01,084007,Staff,0,5,20,20
1650047781572,CSE 21,A01,084009,Staff,0,32,50,50
1650047787602,CSE 30,A01,083370,Cao; Yingjun,0,65,40,40
1650047793624,CSE 100,A01,083372,Cao; Yingjun,0,46,40,40
1650047799651,CSE 101,A01,084011,Staff,0,54,40,40
1650047805673,CSE 141,A01,083374,Eldon; John,0,65,75,75
1650047811697,CSE 141L,A01,083376,Eldon; John,0,71,75,75
1650047817720,CSE 175,A01,084013,Kumar; Rakesh,22,0,25,3
1650047823743,CSE 190,A00,092508,Dubnov; Shlomo,19,0,20,1
1650047829770,ECE 5,A01,084049,Morris; Karcher William,12,0,20,8
1650047835797,ECE 100,A01,084051,Baghdadchi; Saharnaz,0,0,20,20
1650047835797,ECE 100,A02,091916,Baghdadchi; Saharnaz,13,0,20,7
1650047841821,ECE 101,A01,084053,Baghdadchi; Saharnaz,0,0,37,37
1650047841821,ECE 101,A02,084054,Baghdadchi; Saharnaz,29,0,37,8
1650047847845,ECE 107,A01,083390,Staff,26,0,40,14
1650047853877,ECE 148,A01,084056,Silberman; Jack,8,0,12,4
1650047859901,ECE 180,A00,083391,Abi Samra; Nicholas Camill,25,0,30,5
1650047859901,ECE 180,B00,083392,Abi Samra; Nicholas Camill,21,0,30,9
1650047865923,MATH 10B,A01,084110,Staff,0,0,30,30
1650047865923,MATH 10B,A02,084111,Staff,17,0,30,13
1650047865923,MATH 10B,A03,084112,Staff,24,0,30,6
1650047871956,MATH 10C,A01,083443,Staff,0,17,30,30
1650047871956,MATH 10C,A02,083444,Staff,0,16,30,30
1650047871956,MATH 10C,B01,084114,Staff,19,0,30,11
1650047871956,MATH 10C,B02,084115,Staff,25,0,30,5
1650047877979,MATH 18,A01,084117,Harel; Guershon,12,0,30,18
1650047877979,MATH 18,A02,084119,Harel; Guershon,27,0,30,3
1650047877979,MATH 18,A03,084120,Harel; Guershon,30,0,30,0
1650047877979,MATH 18,A04,084121,Harel; Guershon,29,0,30,1
1650047884006,MATH 20B,A01,084124,Um; Ko Woon,11,0,35,24
1650047884006,MATH 20B,B01,084126,Um; Ko Woon,24,0,35,11
1650047890042,MATH 20C,A01,083446,Hammock; Frances H,0,0,30,30
1650047890042,MATH 20C,A02,083447,Hammock; Frances H,14,0,30,16
1650047890042,MATH 20C,A03,083448,Hammock; Frances H,19,0,30,11
1650047890042,MATH 20C,A04,083449,Hammock; Frances H,20,0,30,10
1650047890042,MATH 20C,B01,083451,Hammock; Frances H,0,0,30,30
1650047890042,MATH 20C,B02,083452,Hammock; Frances H,17,0,30,13
1650047890042,MATH 20C,B03,083453,Hammock; Frances H,21,0,30,9
1650047890042,MATH 20C,B04,083454,Hammock; Frances H,23,0,30,7
1650047896066,MATH 20D,A01,084128,Staff,14,0,30,16
1650047896066,MATH 20D,A02,084129,Staff,29,0,30,1
1650047896066,MATH 20D,A03,084130,Staff,27,0,30,3
1650047896066,MATH 20D,B01,084133,Staff,1,0,30,29
1650047896066,MATH 20D,B02,084134,Staff,23,0,30,7
1650047896066,MATH 20D,B03,084135,Staff,28,0,30,2
1650047902090,MATH 20E,A01,084138,Staff,13,0,30,17
1650047902090,MATH 20E,A02,084139,Staff,6,0,30,24
1650047902090,MATH 20E,A03,084140,Staff,15,0,30,15
1650047902090,MATH 20E,A04,084141,Staff,20,0,30,10
1650047908113,MATH 102,A01,084143,Harel; Guershon,12,0,30,18
1650047908113,MATH 102,A02,084144,Harel; Guershon,19,0,30,11
1650047914142,MATH 103B,A01,083456,Staff,0,13,30,30
1650047914142,MATH 103B,A02,083457,Staff,0,14,30,30
1650047920167,MATH 109,A01,084146,Salehi Golsefidy; Alireza,17,0,30,13
1650047920167,MATH 109,A02,084147,Salehi Golsefidy; Alireza,15,0,30,15
1650047926197,MATH 120A,A01,085445,Eggers; John Dietrich,10,0,35,25
1650047926197,MATH 120A,A02,085446,Eggers; John Dietrich,27,0,35,8
1650047932218,MATH 142B,A01,084149,Verstraete; Jacques Allan,0,12,30,30
1650047932218,MATH 142B,A02,084150,Verstraete; Jacques Allan,0,12,30,30
1650047938246,MATH 170A,A01,083459,Nie; Jiawang,0,9,30,30
1650047938246,MATH 170A,A02,083460,Nie; Jiawang,0,8,30,30
1650047938246,MATH 170A,A03,083461,Nie; Jiawang,0,9,30,30
1650047944276,MATH 193B,A01,083463,Staff,1,0,30,29
1650047944276,MATH 193B,A02,083464,Staff,9,0,30,21
1650047944276,MATH 193B,A03,083465,Staff,18,0,30,12
1650047950337,COGS 2,A01,083966,Boyle; Mary E. T.,10,0,30,20
1650047956363,COGS 9,A01,083968,Staff,7,0,60,53
1650047962387,COGS 14B,A01,083970,Staff,9,0,50,41
1650047968411,COGS 17,A01,092679,Staff,50,0,75,25
1650047974436,COGS 100,A01,083972,Staff,0,16,60,60
1650047986487,COGS 101C,A01,083976,Staff,12,0,30,18
1650047992509,COGS 102A,A01,083978,Johnson; Christine M.,13,0,30,17
1650047998533,COGS 107B,A01,083980,Staff,0,7,50,50
1650048004558,COGS 115,A01,083982,Staff,10,0,30,20
1650048010591,COGS 118B,A01,083367,Staff,0,15,40,40
1650048016615,COGS 172,A01,083984,Provenzano; Emily Kara,15,0,30,15
1650048022638,COGS 177,A00,083368,Staff,0,20,30,30
1650048028661,COGS 186,A01,083986,Staff,21,0,40,19
1650048034689,COGS 187A,A01,083988,Boyle; Mary E. T.,20,0,60,40
1650048040716,CSE 8A,A50,084003,Miranda; Gregory Joseph,0,15,15,15
1650048046750,CSE 11,A01,084005,Miranda; Gregory Joseph,0,22,55,55
1650048052778,CSE 20,A01,084007,Staff,0,5,20,20
1650048058815,CSE 21,A01,084009,Staff,0,32,50,50
1650048064839,CSE 30,A01,083370,Cao; Yingjun,0,65,40,40
1650048070870,CSE 100,A01,083372,Cao; Yingjun,0,46,40,40
1650048076894,CSE 101,A01,084011,Staff,0,54,40,40
1650048082923,CSE 141,A01,083374,Eldon; John,0,65,75,75
1650048088949,CSE 141L,A01,083376,Eldon; John,0,71,75,75
1650048094987,CSE 175,A01,084013,Kumar; Rakesh,22,0,25,3
1650048101011,CSE 190,A00,092508,Dubnov; Shlomo,19,0,20,1
1650048107038,ECE 5,A01,084049,Morris; Karcher William,12,0,20,8
1650048113073,ECE 100,A01,084051,Baghdadchi; Saharnaz,0,0,20,20
1650048113073,ECE 100,A02,091916,Baghdadchi; Saharnaz,13,0,20,7
1650048119101,ECE 101,A01,084053,Baghdadchi; Saharnaz,0,0,37,37
1650048119101,ECE 101,A02,084054,Baghdadchi; Saharnaz,29,0,37,8
1650048125133,ECE 107,A01,083390,Staff,26,0,40,14
1650048131168,ECE 148,A01,084056,Silberman; Jack,8,0,12,4
1650048137195,ECE 180,A00,083391,Abi Samra; Nicholas Camill,25,0,30,5
1650048137195,ECE 180,B00,083392,Abi Samra; Nicholas Camill,21,0,30,9
1650048143222,MATH 10B,A01,084110,Staff,0,0,30,30
1650048143222,MATH 10B,A02,084111,Staff,17,0,30,13
1650048143222,MATH 10B,A03,084112,Staff,24,0,30,6
1650048149246,MATH 10C,A01,083443,Staff,0,17,30,30
1650048149246,MATH 10C,A02,083444,Staff,0,16,30,30
1650048149246,MATH 10C,B01,084114,Staff,19,0,30,11
1650048149246,MATH 10C,B02,084115,Staff,25,0,30,5
1650048155283,MATH 18,A01,084117,Harel; Guershon,12,0,30,18
1650048155283,MATH 18,A02,084119,Harel; Guershon,27,0,30,3
1650048155283,MATH 18,A03,084120,Harel; Guershon,30,0,30,0
1650048155283,MATH 18,A04,084121,Harel; Guershon,29,0,30,1
1650048161336,MATH 20B,A01,084124,Um; Ko Woon,11,0,35,24
1650048161336,MATH 20B,B01,084126,Um; Ko Woon,24,0,35,11
1650048167376,MATH 20C,A01,083446,Hammock; Frances H,0,0,30,30
1650048167376,MATH 20C,A02,083447,Hammock; Frances H,14,0,30,16
1650048167376,MATH 20C,A03,083448,Hammock; Frances H,19,0,30,11
1650048167376,MATH 20C,A04,083449,Hammock; Frances H,20,0,30,10
1650048167376,MATH 20C,B01,083451,Hammock; Frances H,0,0,30,30
1650048167376,MATH 20C,B02,083452,Hammock; Frances H,17,0,30,13
1650048167376,MATH 20C,B03,083453,Hammock; Frances H,21,0,30,9
1650048167376,MATH 20C,B04,083454,Hammock; Frances H,23,0,30,7
1650048173398,MATH 20D,A01,084128,Staff,14,0,30,16
1650048173398,MATH 20D,A02,084129,Staff,29,0,30,1
1650048173398,MATH 20D,A03,084130,Staff,27,0,30,3
1650048173398,MATH 20D,B01,084133,Staff,1,0,30,29
1650048173398,MATH 20D,B02,084134,Staff,23,0,30,7
1650048173398,MATH 20D,B03,084135,Staff,28,0,30,2
1650048179422,MATH 20E,A01,084138,Staff,13,0,30,17
1650048179422,MATH 20E,A02,084139,Staff,6,0,30,24
1650048179422,MATH 20E,A03,084140,Staff,15,0,30,15
1650048179422,MATH 20E,A04,084141,Staff,20,0,30,10
1650048185453,MATH 102,A01,084143,Harel; Guershon,12,0,30,18
1650048185453,MATH 102,A02,084144,Harel; Guershon,19,0,30,11
1650048191490,MATH 103B,A01,083456,Staff,0,13,30,30
1650048191490,MATH 103B,A02,083457,Staff,0,14,30,30
1650048197516,MATH 109,A01,084146,Salehi Golsefidy; Alireza,17,0,30,13
1650048197516,MATH 109,A02,084147,Salehi Golsefidy; Alireza,15,0,30,15
1650048203542,MATH 120A,A01,085445,Eggers; John Dietrich,10,0,35,25
1650048203542,MATH 120A,A02,085446,Eggers; John Dietrich,27,0,35,8
1650048209577,MATH 142B,A01,084149,Verstraete; Jacques Allan,0,12,30,30
1650048209577,MATH 142B,A02,084150,Verstraete; Jacques Allan,0,12,30,30
1650048215601,MATH 170A,A01,083459,Nie; Jiawang,0,9,30,30
1650048215601,MATH 170A,A02,083460,Nie; Jiawang,0,9,30,30
1650048215601,MATH 170A,A03,083461,Nie; Jiawang,0,9,30,30
1650048221628,MATH 193B,A01,083463,Staff,1,0,30,29
1650048221628,MATH 193B,A02,083464,Staff,9,0,30,21
1650048221628,MATH 193B,A03,083465,Staff,18,0,30,12
1650048227691,COGS 2,A01,083966,Boyle; Mary E. T.,10,0,30,20
1650048233719,COGS 9,A01,083968,Staff,7,0,60,53
1650048239760,COGS 14B,A01,083970,Staff,9,0,50,41
1650048245784,COGS 17,A01,092679,Staff,50,0,75,25
1650048251812,COGS 100,A01,083972,Staff,0,16,60,60
1650048263867,COGS 101C,A01,083976,Staff,12,0,30,18
1650048269892,COGS 102A,A01,083978,Johnson; Christine M.,13,0,30,17
1650048275919,COGS 107B,A01,083980,Staff,0,7,50,50
1650048281943,COGS 115,A01,083982,Staff,10,0,30,20
1650048287969,COGS 118B,A01,083367,Staff,0,15,40,40
1650048293996,COGS 172,A01,083984,Provenzano; Emily Kara,15,0,30,15
1650048300023,COGS 177,A00,083368,Staff,0,20,30,30
1650048306051,COGS 186,A01,083986,Staff,21,0,40,19
1650048312074,COGS 187A,A01,083988,Boyle; Mary E. T.,20,0,60,40
1650048318099,CSE 8A,A50,084003,Miranda; Gregory Joseph,0,15,15,15
1650048324125,CSE 11,A01,084005,Miranda; Gregory Joseph,0,22,55,55
1650048330149,CSE 20,A01,084007,Staff,0,5,20,20
1650048336171,CSE 21,A01,084009,Staff,0,32,50,50
1650048342194,CSE 30,A01,083370,Cao; Yingjun,0,65,40,40
1650048348221,CSE 100,A01,083372,Cao; Yingjun,0,46,40,40
1650048354244,CSE 101,A01,084011,Staff,0,54,40,40
1650048360367,CSE 141,A01,083374,Eldon; John,0,65,75,75
1650048366389,CSE 141L,A01,083376,Eldon; John,0,71,75,75
1650048372416,CSE 175,A01,084013,Kumar; Rakesh,22,0,25,3
1650048378437,CSE 190,A00,092508,Dubnov; Shlomo,19,0,20,1
1650048384469,ECE 5,A01,084049,Morris; Karcher William,12,0,20,8
1650048390505,ECE 100,A01,084051,Baghdadchi; Saharnaz,0,0,20,20
1650048390505,ECE 100,A02,091916,Baghdadchi; Saharnaz,13,0,20,7
1650048396533,ECE 101,A01,084053,Baghdadchi; Saharnaz,0,0,37,37
1650048396533,ECE 101,A02,084054,Baghdadchi; Saharnaz,29,0,37,8
1650048402563,ECE 107,A01,083390,Staff,26,0,40,14
1650048408587,ECE 148,A01,084056,Silberman; Jack,8,0,12,4
1650048414611,ECE 180,A00,083391,Abi Samra; Nicholas Camill,25,0,30,5
1650048414611,ECE 180,B00,083392,Abi Samra; Nicholas Camill,21,0,30,9
1650048420637,MATH 10B,A01,084110,Staff,0,0,30,30
1650048420637,MATH 10B,A02,084111,Staff,17,0,30,13
1650048420637,MATH 10B,A03,084112,Staff,24,0,30,6
1650048426670,MATH 10C,A01,083443,Staff,0,17,30,31
1650048426670,MATH 10C,A02,083444,Staff,0,16,30,30
1650048426670,MATH 10C,B01,084114,Staff,19,0,30,11
1650048426670,MATH 10C,B02,084115,Staff,25,0,30,5
1650048432694,MATH 18,A01,084117,Harel; Guershon,12,0,30,18
1650048432694,MATH 18,A02,084119,Harel; Guershon,27,0,30,3
1650048432694,MATH 18,A03,084120,Harel; Guershon,30,0,30,0
1650048432694,MATH 18,A04,084121,Harel; Guershon,29,0,30,1
1650048438723,MATH 20B,A01,084124,Um; Ko Woon,11,0,35,24
1650048438723,MATH 20B,B01,084126,Um; Ko Woon,24,0,35,11
1650048444746,MATH 20C,A01,083446,Hammock; Frances H,0,0,30,30
1650048444746,MATH 20C,A02,083447,Hammock; Frances H,14,0,30,16
1650048444746,MATH 20C,A03,083448,Hammock; Frances H,19,0,30,11
1650048444746,MATH 20C,A04,083449,Hammock; Frances H,20,0,30,10
1650048444746,MATH 20C,B01,083451,Hammock; Frances H,0,0,30,30
1650048444746,MATH 20C,B02,083452,Hammock; Frances H,17,0,30,13
1650048444746,MATH 20C,B03,083453,Hammock; Frances H,21,0,30,9
1650048444746,MATH 20C,B04,083454,Hammock; Frances H,23,0,30,7
1650048450771,MATH 20D,A01,084128,Staff,14,0,30,16
1650048450771,MATH 20D,A02,084129,Staff,29,0,30,1
1650048450771,MATH 20D,A03,084130,Staff,27,0,30,3
1650048450771,MATH 20D,B01,084133,Staff,1,0,30,29
1650048450771,MATH 20D,B02,084134,Staff,23,0,30,7
1650048450771,MATH 20D,B03,084135,Staff,28,0,30,2
1650048456801,MATH 20E,A01,084138,Staff,13,0,30,17
1650048456801,MATH 20E,A02,084139,Staff,6,0,30,24
1650048456801,MATH 20E,A03,084140,Staff,15,0,30,15
1650048456801,MATH 20E,A04,084141,Staff,20,0,30,10
1650048462837,MATH 102,A01,084143,Harel; Guershon,12,0,30,18
1650048462837,MATH 102,A02,084144,Harel; Guershon,19,0,30,11
1650048468867,MATH 103B,A01,083456,Staff,0,13,30,30
1650048468867,MATH 103B,A02,083457,Staff,0,14,30,30
1650048474891,MATH 109,A01,084146,Salehi Golsefidy; Alireza,17,0,30,13
1650048474891,MATH 109,A02,084147,Salehi Golsefidy; Alireza,15,0,30,15
1650048480913,MATH 120A,A01,085445,Eggers; John Dietrich,10,0,35,25
1650048480913,MATH 120A,A02,085446,Eggers; John Dietrich,27,0,35,8
1650048486945,MATH 142B,A01,084149,Verstraete; Jacques Allan,0,12,30,30
1650048486945,MATH 142B,A02,084150,Verstraete; Jacques Allan,0,12,30,30
1650048492982,MATH 170A,A01,083459,Nie; Jiawang,0,9,30,30
1650048492982,MATH 170A,A02,083460,Nie; Jiawang,0,9,30,30
1650048492982,MATH 170A,A03,083461,Nie; Jiawang,0,9,30,30
1650048499007,MATH 193B,A01,083463,Staff,1,0,30,29
1650048499007,MATH 193B,A02,083464,Staff,9,0,30,21
1650048499007,MATH 193B,A03,083465,Staff,18,0,30,12
1650048505060,COGS 2,A01,083966,Boyle; Mary E. T.,10,0,30,20
1650048511084,COGS 9,A01,083968,Staff,7,0,60,53
1650048517112,COGS 14B,A01,083970,Staff,9,0,50,41
1650048523147,COGS 17,A01,092679,Staff,50,0,75,25
1650048529186,COGS 100,A01,083972,Staff,0,16,60,60
1650048541266,COGS 101C,A01,083976,Staff,12,0,30,18
1650048547289,COGS 102A,A01,083978,Johnson; Christine M.,13,0,30,17
1650048553316,COGS 107B,A01,083980,Staff,0,7,50,50
1650048559338,COGS 115,A01,083982,Staff,10,0,30,20
1650048565364,COGS 118B,A01,083367,Staff,0,15,40,40
1650048571389,COGS 172,A01,083984,Provenzano; Emily Kara,15,0,30,15
1650048577417,COGS 177,A00,083368,Staff,0,20,30,30
1650048583440,COGS 186,A01,083986,Staff,21,0,40,19
1650048589463,COGS 187A,A01,083988,Boyle; Mary E. T.,20,0,60,40
1650048595486,CSE 8A,A50,084003,Miranda; Gregory Joseph,0,15,15,15
1650048601512,CSE 11,A01,084005,Miranda; Gregory Joseph,0,22,55,55
1650048607541,CSE 20,A01,084007,Staff,0,5,20,20
1650048613563,CSE 21,A01,084009,Staff,0,32,50,50
1650048619589,CSE 30,A01,083370,Cao; Yingjun,0,65,40,40
1650048625612,CSE 100,A01,083372,Cao; Yingjun,0,46,40,40
1650048631635,CSE 101,A01,084011,Staff,0,54,40,40
1650048637663,CSE 141,A01,083374,Eldon; John,0,65,75,75
1650048643700,CSE 141L,A01,083376,Eldon; John,0,71,75,75
1650048649728,CSE 175,A01,084013,Kumar; Rakesh,22,0,25,3
1650048655754,CSE 190,A00,092508,Dubnov; Shlomo,19,0,20,1
1650048661781,ECE 5,A01,084049,Morris; Karcher William,12,0,20,8
1650048667806,ECE 100,A01,084051,Baghdadchi; Saharnaz,0,0,20,20
1650048667806,ECE 100,A02,091916,Baghdadchi; Saharnaz,13,0,20,7
1650048673834,ECE 101,A01,084053,Baghdadchi; Saharnaz,0,0,37,37
1650048673834,ECE 101,A02,084054,Baghdadchi; Saharnaz,29,0,37,8
1650048679866,ECE 107,A01,083390,Staff,26,0,40,14
1650048685897,ECE 148,A01,084056,Silberman; Jack,8,0,12,4
1650048691924,ECE 180,A00,083391,Abi Samra; Nicholas Camill,25,0,30,5
1650048691924,ECE 180,B00,083392,Abi Samra; Nicholas Camill,21,0,30,9
1650048697962,MATH 10B,A01,084110,Staff,0,0,30,30
1650048697962,MATH 10B,A02,084111,Staff,17,0,30,13
1650048697962,MATH 10B,A03,084112,Staff,24,0,30,6
1650048703989,MATH 10C,A01,083443,Staff,0,17,30,31
1650048703989,MATH 10C,A02,083444,Staff,0,16,30,30
1650048703989,MATH 10C,B01,084114,Staff,19,0,30,11
1650048703989,MATH 10C,B02,084115,Staff,25,0,30,5
1650048710013,MATH 18,A01,084117,Harel; Guershon,12,0,30,18
1650048710013,MATH 18,A02,084119,Harel; Guershon,27,0,30,3
1650048710013,MATH 18,A03,084120,Harel; Guershon,30,0,30,0
1650048710013,MATH 18,A04,084121,Harel; Guershon,29,0,30,1
1650048716038,MATH 20B,A01,084124,Um; Ko Woon,11,0,35,24
1650048716038,MATH 20B,B01,084126,Um; Ko Woon,24,0,35,11
1650048722073,MATH 20C,A01,083446,Hammock; Frances H,0,0,30,30
1650048722073,MATH 20C,A02,083447,Hammock; Frances H,14,0,30,16
1650048722073,MATH 20C,A03,083448,Hammock; Frances H,19,0,30,11
1650048722073,MATH 20C,A04,083449,Hammock; Frances H,20,0,30,10
1650048722073,MATH 20C,B01,083451,Hammock; Frances H,0,0,30,30
1650048722073,MATH 20C,B02,083452,Hammock; Frances H,17,0,30,13
1650048722073,MATH 20C,B03,083453,Hammock; Frances H,21,0,30,9
1650048722073,MATH 20C,B04,083454,Hammock; Frances H,23,0,30,7
1650048728101,MATH 20D,A01,084128,Staff,14,0,30,16
1650048728101,MATH 20D,A02,084129,Staff,29,0,30,1
1650048728101,MATH 20D,A03,084130,Staff,27,0,30,3
1650048728101,MATH 20D,B01,084133,Staff,1,0,30,29
1650048728101,MATH 20D,B02,084134,Staff,23,0,30,7
1650048728101,MATH 20D,B03,084135,Staff,28,0,30,2
1650048734131,MATH 20E,A01,084138,Staff,13,0,30,17
1650048734131,MATH 20E,A02,084139,Staff,6,0,30,24
1650048734131,MATH 20E,A03,084140,Staff,15,0,30,15
1650048734131,MATH 20E,A04,084141,Staff,20,0,30,10
1650048740161,MATH 102,A01,084143,Harel; Guershon,12,0,30,18
1650048740161,MATH 102,A02,084144,Harel; Guershon,19,0,30,11
1650048746185,MATH 103B,A01,083456,Staff,0,13,30,30
1650048746185,MATH 103B,A02,083457,Staff,0,14,30,30
1650048752210,MATH 109,A01,084146,Salehi Golsefidy; Alireza,17,0,30,13
1650048752210,MATH 109,A02,084147,Salehi Golsefidy; Alireza,15,0,30,15
1650048758237,MATH 120A,A01,085445,Eggers; John Dietrich,10,0,35,25
1650048758237,MATH 120A,A02,085446,Eggers; John Dietrich,27,0,35,8
1650048764261,MATH 142B,A01,084149,Verstraete; Jacques Allan,0,12,30,30
1650048764261,MATH 142B,A02,084150,Verstraete; Jacques Allan,0,12,30,30
1650048770293,MATH 170A,A01,083459,Nie; Jiawang,0,9,30,30
1650048770293,MATH 170A,A02,083460,Nie; Jiawang,0,9,30,30
1650048770293,MATH 170A,A03,083461,Nie; Jiawang,0,9,30,30
1650048776357,MATH 193B,A01,083463,Staff,1,0,30,29
1650048776357,MATH 193B,A02,083464,Staff,9,0,30,21
1650048776357,MATH 193B,A03,083465,Staff,18,0,30,12
1650048782425,COGS 2,A01,083966,Boyle; Mary E. T.,10,0,30,20
1650048788452,COGS 9,A01,083968,Staff,7,0,60,53
1650048794479,COGS 14B,A01,083970,Staff,9,0,50,41
1650048800504,COGS 17,A01,092679,Staff,50,0,75,25
1650048806527,COGS 100,A01,083972,Staff,0,16,60,60
1650048818574,COGS 101C,A01,083976,Staff,12,0,30,18
1650048824610,COGS 102A,A01,083978,Johnson; Christine M.,13,0,30,17
1650048830644,COGS 107B,A01,083980,Staff,0,7,50,50
1650048836668,COGS 115,A01,083982,Staff,10,0,30,20
1650048842691,COGS 118B,A01,083367,Staff,0,15,40,40
1650048848722,COGS 172,A01,083984,Provenzano; Emily Kara,15,0,30,15
1650048854749,COGS 177,A00,083368,Staff,0,20,30,30
1650048860772,COGS 186,A01,083986,Staff,21,0,40,19
1650048866807,COGS 187A,A01,083988,Boyle; Mary E. T.,20,0,60,40
1650048872834,CSE 8A,A50,084003,Miranda; Gregory Joseph,0,15,15,15
1650048878861,CSE 11,A01,084005,Miranda; Gregory Joseph,0,22,55,55
1650048884884,CSE 20,A01,084007,Staff,0,5,20,20
1650048890907,CSE 21,A01,084009,Staff,0,32,50,50
1650048896934,CSE 30,A01,083370,Cao; Yingjun,0,65,40,40
1650048902963,CSE 100,A01,083372,Cao; Yingjun,0,46,40,40
1650048908986,CSE 101,A01,084011,Staff,0,54,40,40
1650048915007,CSE 141,A01,083374,Eldon; John,0,65,75,75
1650048921030,CSE 141L,A01,083376,Eldon; John,0,71,75,75
1650048927054,CSE 175,A01,084013,Kumar; Rakesh,22,0,25,3
1650048933079,CSE 190,A00,092508,Dubnov; Shlomo,19,0,20,1
1650048939110,ECE 5,A01,084049,Morris; Karcher William,12,0,20,8
1650048945138,ECE 100,A01,084051,Baghdadchi; Saharnaz,0,0,20,20
1650048945138,ECE 100,A02,091916,Baghdadchi; Saharnaz,13,0,20,7
1650048951165,ECE 101,A01,084053,Baghdadchi; Saharnaz,0,0,37,37
1650048951165,ECE 101,A02,084054,Baghdadchi; Saharnaz,29,0,37,8
1650048957282,ECE 107,A01,083390,Staff,26,0,40,14
1650048963317,ECE 148,A01,084056,Silberman; Jack,8,0,12,4
1650048969341,ECE 180,A00,083391,Abi Samra; Nicholas Camill,25,0,30,5
1650048969341,ECE 180,B00,083392,Abi Samra; Nicholas Camill,21,0,30,9
1650048975367,MATH 10B,A01,084110,Staff,0,0,30,30
1650048975367,MATH 10B,A02,084111,Staff,17,0,30,13
1650048975367,MATH 10B,A03,084112,Staff,24,0,30,6
1650048981394,MATH 10C,A01,083443,Staff,0,17,30,31
1650048981394,MATH 10C,A02,083444,Staff,0,16,30,30
1650048981394,MATH 10C,B01,084114,Staff,19,0,30,11
1650048981394,MATH 10C,B02,084115,Staff,25,0,30,5
1650048987417,MATH 18,A01,084117,Harel; Guershon,12,0,30,18
1650048987417,MATH 18,A02,084119,Harel; Guershon,27,0,30,3
1650048987417,MATH 18,A03,084120,Harel; Guershon,30,0,30,0
1650048987417,MATH 18,A04,084121,Harel; Guershon,29,0,30,1
1650048993446,MATH 20B,A01,084124,Um; Ko Woon,11,0,35,24
1650048993446,MATH 20B,B01,084126,Um; Ko Woon,24,0,35,11
1650048999470,MATH 20C,A01,083446,Hammock; Frances H,0,0,30,30
1650048999470,MATH 20C,A02,083447,Hammock; Frances H,14,0,30,16
1650048999470,MATH 20C,A03,083448,Hammock; Frances H,19,0,30,11
1650048999470,MATH 20C,A04,083449,Hammock; Frances H,20,0,30,10
1650048999470,MATH 20C,B01,083451,Hammock; Frances H,0,0,30,30
1650048999470,MATH 20C,B02,083452,Hammock; Frances H,17,0,30,13
1650048999470,MATH 20C,B03,083453,Hammock; Frances H,21,0,30,9
1650048999470,MATH 20C,B04,083454,Hammock; Frances H,23,0,30,7
1650049005496,MATH 20D,A01,084128,Staff,14,0,30,16
1650049005496,MATH 20D,A02,084129,Staff,29,0,30,1
1650049005496,MATH 20D,A03,084130,Staff,27,0,30,3
1650049005496,MATH 20D,B01,084133,Staff,1,0,30,29
1650049005496,MATH 20D,B02,084134,Staff,23,0,30,7
1650049005496,MATH 20D,B03,084135,Staff,28,0,30,2
1650049011534,MATH 20E,A01,084138,Staff,13,0,30,17
1650049011534,MATH 20E,A02,084139,Staff,6,0,30,24
1650049011534,MATH 20E,A03,084140,Staff,15,0,30,15
1650049011534,MATH 20E,A04,084141,Staff,20,0,30,10
1650049017564,MATH 102,A01,084143,Harel; Guershon,12,0,30,18
1650049017564,MATH 102,A02,084144,Harel; Guershon,19,0,30,11
1650049023591,MATH 103B,A01,083456,Staff,0,13,30,30
1650049023591,MATH 103B,A02,083457,Staff,0,14,30,30
1650049029622,MATH 109,A01,084146,Salehi Golsefidy; Alireza,17,0,30,13
1650049029622,MATH 109,A02,084147,Salehi Golsefidy; Alireza,15,0,30,15
1650049035649,MATH 120A,A01,085445,Eggers; John Dietrich,10,0,35,25
1650049035649,MATH 120A,A02,085446,Eggers; John Dietrich,27,0,35,8
1650049041672,MATH 142B,A01,084149,Verstraete; Jacques Allan,0,12,30,30
1650049041672,MATH 142B,A02,084150,Verstraete; Jacques Allan,0,12,30,30
1650049047700,MATH 170A,A01,083459,Nie; Jiawang,0,9,30,30
1650049047700,MATH 170A,A02,083460,Nie; Jiawang,0,9,30,30
1650049047700,MATH 170A,A03,083461,Nie; Jiawang,0,9,30,30
1650049053725,MATH 193B,A01,083463,Staff,1,0,30,29
1650049053725,MATH 193B,A02,083464,Staff,9,0,30,21
1650049053725,MATH 193B,A03,083465,Staff,18,0,30,12
1650049059779,COGS 2,A01,083966,Boyle; Mary E. T.,10,0,30,20
1650049065808,COGS 9,A01,083968,Staff,7,0,60,53
1650049071842,COGS 14B,A01,083970,Staff,9,0,50,41
1650049077866,COGS 17,A01,092679,Staff,50,0,75,25
1650049083893,COGS 100,A01,083972,Staff,0,16,60,60
1650049095951,COGS 101C,A01,083976,Staff,12,0,30,18
1650049101982,COGS 102A,A01,083978,Johnson; Christine M.,13,0,30,17
1650049108004,COGS 107B,A01,083980,Staff,0,7,50,50
1650049114054,COGS 115,A01,083982,Staff,10,0,30,20
1650049120082,COGS 118B,A01,083367,Staff,0,15,40,40
1650049126106,COGS 172,A01,083984,Provenzano; Emily Kara,15,0,30,15
1650049132133,COGS 177,A00,083368,Staff,0,20,30,30
1650049138157,COGS 186,A01,083986,Staff,21,0,40,19
1650049144184,COGS 187A,A01,083988,Boyle; Mary E. T.,20,0,60,40
1650049150214,CSE 8A,A50,084003,Miranda; Gregory Joseph,0,15,15,15
1650049156241,CSE 11,A01,084005,Miranda; Gregory Joseph,0,22,55,55
1650049162264,CSE 20,A01,084007,Staff,0,5,20,20
1650049168299,CSE 21,A01,084009,Staff,0,32,50,50
1650049174333,CSE 30,A01,083370,Cao; Yingjun,0,65,40,40
1650049180360,CSE 100,A01,083372,Cao; Yingjun,0,46,40,40
1650049186382,CSE 101,A01,084011,Staff,0,54,40,40
1650049192404,CSE 141,A01,083374,Eldon; John,0,65,75,75
1650049198428,CSE 141L,A01,083376,Eldon; John,0,71,75,75
1650049204454,CSE 175,A01,084013,Kumar; Rakesh,22,0,25,3
1650049210481,CSE 190,A00,092508,Dubnov; Shlomo,19,0,20,1
1650049216508,ECE 5,A01,084049,Morris; Karcher William,12,0,20,8
1650049222531,ECE 100,A01,084051,Baghdadchi; Saharnaz,0,0,20,20
1650049222531,ECE 100,A02,091916,Baghdadchi; Saharnaz,13,0,20,7
1650049228557,ECE 101,A01,084053,Baghdadchi; Saharnaz,0,0,37,37
1650049228557,ECE 101,A02,084054,Baghdadchi; Saharnaz,29,0,37,8
1650049234594,ECE 107,A01,083390,Staff,26,0,40,14
1650049240616,ECE 148,A01,084056,Silberman; Jack,8,0,12,4
1650049246639,ECE 180,A00,083391,Abi Samra; Nicholas Camill,25,0,30,5
1650049246639,ECE 180,B00,083392,Abi Samra; Nicholas Camill,21,0,30,9
1650049252668,MATH 10B,A01,084110,Staff,0,0,30,30
1650049252668,MATH 10B,A02,084111,Staff,17,0,30,13
1650049252668,MATH 10B,A03,084112,Staff,24,0,30,6
1650049258697,MATH 10C,A01,083443,Staff,0,17,30,31
1650049258697,MATH 10C,A02,083444,Staff,0,16,30,30
1650049258697,MATH 10C,B01,084114,Staff,18,0,30,12
1650049258697,MATH 10C,B02,084115,Staff,25,0,30,5
1650049264720,MATH 18,A01,084117,Harel; Guershon,12,0,30,18
1650049264720,MATH 18,A02,084119,Harel; Guershon,27,0,30,3
1650049264720,MATH 18,A03,084120,Harel; Guershon,30,0,30,0
1650049264720,MATH 18,A04,084121,Harel; Guershon,29,0,30,1
1650049270743,MATH 20B,A01,084124,Um; Ko Woon,11,0,35,24
1650049270743,MATH 20B,B01,084126,Um; Ko Woon,24,0,35,11
1650049276775,MATH 20C,A01,083446,Hammock; Frances H,0,0,30,30
1650049276775,MATH 20C,A02,083447,Hammock; Frances H,14,0,30,16
1650049276775,MATH 20C,A03,083448,Hammock; Frances H,19,0,30,11
1650049276775,MATH 20C,A04,083449,Hammock; Frances H,20,0,30,10
1650049276775,MATH 20C,B01,083451,Hammock; Frances H,0,0,30,30
1650049276775,MATH 20C,B02,083452,Hammock; Frances H,17,0,30,13
1650049276775,MATH 20C,B03,083453,Hammock; Frances H,21,0,30,9
1650049276775,MATH 20C,B04,083454,Hammock; Frances H,23,0,30,7
1650049282803,MATH 20D,A01,084128,Staff,14,0,30,16
1650049282803,MATH 20D,A02,084129,Staff,29,0,30,1
1650049282803,MATH 20D,A03,084130,Staff,27,0,30,3
1650049282803,MATH 20D,B01,084133,Staff,1,0,30,29
1650049282803,MATH 20D,B02,084134,Staff,23,0,30,7
1650049282803,MATH 20D,B03,084135,Staff,28,0,30,2
1650049288827,MATH 20E,A01,084138,Staff,13,0,30,17
1650049288827,MATH 20E,A02,084139,Staff,6,0,30,24
1650049288827,MATH 20E,A03,084140,Staff,15,0,30,15
1650049288827,MATH 20E,A04,084141,Staff,20,0,30,10
1650049294856,MATH 102,A01,084143,Harel; Guershon,12,0,30,18
1650049294856,MATH 102,A02,084144,Harel; Guershon,19,0,30,11
1650049300881,MATH 103B,A01,083456,Staff,0,13,30,30
1650049300881,MATH 103B,A02,083457,Staff,0,14,30,30
1650049306904,MATH 109,A01,084146,Salehi Golsefidy; Alireza,17,0,30,13
1650049306904,MATH 109,A02,084147,Salehi Golsefidy; Alireza,15,0,30,15
1650049312931,MATH 120A,A01,085445,Eggers; John Dietrich,10,0,35,25
1650049312931,MATH 120A,A02,085446,Eggers; John Dietrich,27,0,35,8
1650049318955,MATH 142B,A01,084149,Verstraete; Jacques Allan,0,12,30,30
1650049318955,MATH 142B,A02,084150,Verstraete; Jacques Allan,0,12,30,30
1650049324979,MATH 170A,A01,083459,Nie; Jiawang,0,9,30,30
1650049324979,MATH 170A,A02,083460,Nie; Jiawang,0,9,30,30
1650049324979,MATH 170A,A03,083461,Nie; Jiawang,0,9,30,30
1650049331004,MATH 193B,A01,083463,Staff,1,0,30,29
1650049331004,MATH 193B,A02,083464,Staff,9,0,30,21
1650049331004,MATH 193B,A03,083465,Staff,18,0,30,12
1650049337078,COGS 2,A01,083966,Boyle; Mary E. T.,10,0,30,20
1650049343105,COGS 9,A01,083968,Staff,7,0,60,53
1650049349128,COGS 14B,A01,083970,Staff,9,0,50,41
1650049355157,COGS 17,A01,092679,Staff,50,0,75,25
1650049361186,COGS 100,A01,083972,Staff,0,16,60,60
1650049373235,COGS 101C,A01,083976,Staff,12,0,30,18
1650049379258,COGS 102A,A01,083978,Johnson; Christine M.,13,0,30,17
1650049385282,COGS 107B,A01,083980,Staff,0,7,50,50
1650049391305,COGS 115,A01,083982,Staff,10,0,30,20
1650049397345,COGS 118B,A01,083367,Staff,0,15,40,40
1650049403371,COGS 172,A01,083984,Provenzano; Emily Kara,15,0,30,15
1650049409397,COGS 177,A00,083368,Staff,0,20,30,30
1650049415427,COGS 186,A01,083986,Staff,21,0,40,19
1650049421461,COGS 187A,A01,083988,Boyle; Mary E. T.,20,0,60,40
1650049427483,CSE 8A,A50,084003,Miranda; Gregory Joseph,0,15,15,15
1650049433514,CSE 11,A01,084005,Miranda; Gregory Joseph,0,22,55,55
1650049439541,CSE 20,A01,084007,Staff,0,5,20,20
1650049445565,CSE 21,A01,084009,Staff,0,32,50,50
1650049451593,CSE 30,A01,083370,Cao; Yingjun,0,65,40,40
1650049457632,CSE 100,A01,083372,Cao; Yingjun,0,46,40,40
1650049463661,CSE 101,A01,084011,Staff,0,54,40,40
1650049469690,CSE 141,A01,083374,Eldon; John,0,65,75,75
1650049475718,CSE 141L,A01,083376,Eldon; John,0,71,75,75
1650049481764,CSE 175,A01,084013,Kumar; Rakesh,22,0,25,3
1650049487785,CSE 190,A00,092508,Dubnov; Shlomo,19,0,20,1
1650049493807,ECE 5,A01,084049,Morris; Karcher William,12,0,20,8
1650049499829,ECE 100,A01,084051,Baghdadchi; Saharnaz,0,0,20,20
1650049499829,ECE 100,A02,091916,Baghdadchi; Saharnaz,13,0,20,7
1650049505862,ECE 101,A01,084053,Baghdadchi; Saharnaz,0,0,37,37
1650049505862,ECE 101,A02,084054,Baghdadchi; Saharnaz,29,0,37,8
1650049511886,ECE 107,A01,083390,Staff,26,0,40,14
1650049517909,ECE 148,A01,084056,Silberman; Jack,8,0,12,4
1650049523932,ECE 180,A00,083391,Abi Samra; Nicholas Camill,25,0,30,5
1650049523932,ECE 180,B00,083392,Abi Samra; Nicholas Camill,21,0,30,9
1650049529955,MATH 10B,A01,084110,Staff,0,0,30,30
1650049529955,MATH 10B,A02,084111,Staff,17,0,30,13
1650049529955,MATH 10B,A03,084112,Staff,24,0,30,6
1650049535983,MATH 10C,A01,083443,Staff,0,17,30,31
1650049535983,MATH 10C,A02,083444,Staff,0,16,30,30
1650049535983,MATH 10C,B01,084114,Staff,18,0,30,12
1650049535983,MATH 10C,B02,084115,Staff,25,0,30,5
1650049542006,MATH 18,A01,084117,Harel; Guershon,12,0,30,18
1650049542006,MATH 18,A02,084119,Harel; Guershon,27,0,30,3
1650049542006,MATH 18,A03,084120,Harel; Guershon,30,0,30,0
1650049542006,MATH 18,A04,084121,Harel; Guershon,29,0,30,1
1650049548031,MATH 20B,A01,084124,Um; Ko Woon,11,0,35,24
1650049548031,MATH 20B,B01,084126,Um; Ko Woon,24,0,35,11
1650049554148,MATH 20C,A01,083446,Hammock; Frances H,0,0,30,30
1650049554148,MATH 20C,A02,083447,Hammock; Frances H,14,0,30,16
1650049554148,MATH 20C,A03,083448,Hammock; Frances H,19,0,30,11
1650049554148,MATH 20C,A04,083449,Hammock; Frances H,20,0,30,10
1650049554148,MATH 20C,B01,083451,Hammock; Frances H,0,0,30,30
1650049554148,MATH 20C,B02,083452,Hammock; Frances H,17,0,30,13
1650049554148,MATH 20C,B03,083453,Hammock; Frances H,21,0,30,9
1650049554148,MATH 20C,B04,083454,Hammock; Frances H,23,0,30,7
1650049560184,MATH 20D,A01,084128,Staff,14,0,30,16
1650049560184,MATH 20D,A02,084129,Staff,29,0,30,1
1650049560184,MATH 20D,A03,084130,Staff,27,0,30,3
1650049560184,MATH 20D,B01,084133,Staff,1,0,30,29
1650049560184,MATH 20D,B02,084134,Staff,23,0,30,7
1650049560184,MATH 20D,B03,084135,Staff,28,0,30,2
1650049566207,MATH 20E,A01,084138,Staff,13,0,30,17
1650049566207,MATH 20E,A02,084139,Staff,6,0,30,24
1650049566207,MATH 20E,A03,084140,Staff,15,0,30,15
1650049566207,MATH 20E,A04,084141,Staff,20,0,30,10
1650049572234,MATH 102,A01,084143,Harel; Guershon,12,0,30,18
1650049572234,MATH 102,A02,084144,Harel; Guershon,19,0,30,11
1650049578257,MATH 103B,A01,083456,Staff,0,13,30,30
1650049578257,MATH 103B,A02,083457,Staff,0,14,30,30
1650049584283,MATH 109,A01,084146,Salehi Golsefidy; Alireza,17,0,30,13
1650049584283,MATH 109,A02,084147,Salehi Golsefidy; Alireza,15,0,30,15
1650049590307,MATH 120A,A01,085445,Eggers; John Dietrich,10,0,35,25
1650049590307,MATH 120A,A02,085446,Eggers; John Dietrich,27,0,35,8
1650049596333,MATH 142B,A01,084149,Verstraete; Jacques Allan,0,12,30,30
1650049596333,MATH 142B,A02,084150,Verstraete; Jacques Allan,0,12,30,30
1650049602357,MATH 170A,A01,083459,Nie; Jiawang,0,9,30,30
1650049602357,MATH 170A,A02,083460,Nie; Jiawang,0,9,30,30
1650049602357,MATH 170A,A03,083461,Nie; Jiawang,0,9,30,30
1650049608388,MATH 193B,A01,083463,Staff,1,0,30,29
1650049608388,MATH 193B,A02,083464,Staff,9,0,30,21
1650049608388,MATH 193B,A03,083465,Staff,18,0,30,12
1650049614439,COGS 2,A01,083966,Boyle; Mary E. T.,10,0,30,20
1650049620465,COGS 9,A01,083968,Staff,7,0,60,53
1650049626493,COGS 14B,A01,083970,Staff,9,0,50,41
1650049632522,COGS 17,A01,092679,Staff,50,0,75,25
1650049638546,COGS 100,A01,083972,Staff,0,16,60,60
1650049650600,COGS 101C,A01,083976,Staff,12,0,30,18
1650049656622,COGS 102A,A01,083978,Johnson; Christine M.,13,0,30,17
1650049662645,COGS 107B,A01,083980,Staff,0,7,50,50
1650049668683,COGS 115,A01,083982,Staff,10,0,30,20
1650049674710,COGS 118B,A01,083367,Staff,0,15,40,40
1650049680744,COGS 172,A01,083984,Provenzano; Emily Kara,15,0,30,15
1650049686770,COGS 177,A00,083368,Staff,0,20,30,30
1650049692794,COGS 186,A01,083986,Staff,21,0,40,19
1650049698819,COGS 187A,A01,083988,Boyle; Mary E. T.,20,0,60,40
1650049704847,CSE 8A,A50,084003,Miranda; Gregory Joseph,0,16,15,15
1650049710877,CSE 11,A01,084005,Miranda; Gregory Joseph,0,22,55,55
1650049716901,CSE 20,A01,084007,Staff,0,5,20,20
1650049722934,CSE 21,A01,084009,Staff,0,32,50,50
1650049728960,CSE 30,A01,083370,Cao; Yingjun,0,65,40,40
1650049734984,CSE 100,A01,083372,Cao; Yingjun,0,46,40,40
1650049741009,CSE 101,A01,084011,Staff,0,54,40,40
1650049747032,CSE 141,A01,083374,Eldon; John,0,65,75,75
1650049753058,CSE 141L,A01,083376,Eldon; John,0,71,75,75
1650049759082,CSE 175,A01,084013,Kumar; Rakesh,22,0,25,3
1650049765111,CSE 190,A00,092508,Dubnov; Shlomo,18,0,20,2
1650049771135,ECE 5,A01,084049,Morris; Karcher William,12,0,20,8
1650049777167,ECE 100,A01,084051,Baghdadchi; Saharnaz,0,0,20,20
1650049777167,ECE 100,A02,091916,Baghdadchi; Saharnaz,13,0,20,7
1650049783196,ECE 101,A01,084053,Baghdadchi; Saharnaz,0,0,37,37
1650049783196,ECE 101,A02,084054,Baghdadchi; Saharnaz,29,0,37,8
1650049789223,ECE 107,A01,083390,Staff,26,0,40,14
1650049795250,ECE 148,A01,084056,Silberman; Jack,8,0,12,4
1650049801274,ECE 180,A00,083391,Abi Samra; Nicholas Camill,25,0,30,5
1650049801274,ECE 180,B00,083392,Abi Samra; Nicholas Camill,21,0,30,9
1650049807299,MATH 10B,A01,084110,Staff,0,0,30,30
1650049807299,MATH 10B,A02,084111,Staff,17,0,30,13
1650049807299,MATH 10B,A03,084112,Staff,24,0,30,6
1650049813330,MATH 10C,A01,083443,Staff,0,17,30,31
1650049813330,MATH 10C,A02,083444,Staff,0,16,30,30
1650049813330,MATH 10C,B01,084114,Staff,18,0,30,12
1650049813330,MATH 10C,B02,084115,Staff,25,0,30,5
1650049819357,MATH 18,A01,084117,Harel; Guershon,12,0,30,18
1650049819357,MATH 18,A02,084119,Harel; Guershon,27,0,30,3
1650049819357,MATH 18,A03,084120,Harel; Guershon,30,0,30,0
1650049819357,MATH 18,A04,084121,Harel; Guershon,29,0,30,1
1650049825385,MATH 20B,A01,084124,Um; Ko Woon,11,0,35,24
1650049825385,MATH 20B,B01,084126,Um; Ko Woon,24,0,35,11
1650049831411,MATH 20C,A01,083446,Hammock; Frances H,0,0,30,30
1650049831411,MATH 20C,A02,083447,Hammock; Frances H,14,0,30,16
1650049831411,MATH 20C,A03,083448,Hammock; Frances H,19,0,30,11
1650049831411,MATH 20C,A04,083449,Hammock; Frances H,20,0,30,10
1650049831411,MATH 20C,B01,083451,Hammock; Frances H,0,0,30,30
1650049831411,MATH 20C,B02,083452,Hammock; Frances H,17,0,30,13
1650049831411,MATH 20C,B03,083453,Hammock; Frances H,21,0,30,9
1650049831411,MATH 20C,B04,083454,Hammock; Frances H,23,0,30,7
1650049837440,MATH 20D,A01,084128,Staff,14,0,30,16
1650049837440,MATH 20D,A02,084129,Staff,29,0,30,1
1650049837440,MATH 20D,A03,084130,Staff,27,0,30,3
1650049837440,MATH 20D,B01,084133,Staff,1,0,30,29
1650049837440,MATH 20D,B02,084134,Staff,23,0,30,7
1650049837440,MATH 20D,B03,084135,Staff,28,0,30,2
1650049843463,MATH 20E,A01,084138,Staff,13,0,30,17
1650049843463,MATH 20E,A02,084139,Staff,6,0,30,24
1650049843463,MATH 20E,A03,084140,Staff,15,0,30,15
1650049843463,MATH 20E,A04,084141,Staff,20,0,30,10
1650049849499,MATH 102,A01,084143,Harel; Guershon,12,0,30,18
1650049849499,MATH 102,A02,084144,Harel; Guershon,19,0,30,11
1650049855527,MATH 103B,A01,083456,Staff,0,13,30,30
1650049855527,MATH 103B,A02,083457,Staff,0,14,30,30
1650049861559,MATH 109,A01,084146,Salehi Golsefidy; Alireza,17,0,30,13
1650049861559,MATH 109,A02,084147,Salehi Golsefidy; Alireza,15,0,30,15
1650049867584,MATH 120A,A01,085445,Eggers; John Dietrich,10,0,35,25
1650049867584,MATH 120A,A02,085446,Eggers; John Dietrich,27,0,35,8
1650049873610,MATH 142B,A01,084149,Verstraete; Jacques Allan,0,12,30,30
1650049873610,MATH 142B,A02,084150,Verstraete; Jacques Allan,0,12,30,30
1650049879638,MATH 170A,A01,083459,Nie; Jiawang,0,9,30,30
1650049879638,MATH 170A,A02,083460,Nie; Jiawang,0,9,30,30
1650049879638,MATH 170A,A03,083461,Nie; Jiawang,0,9,30,30
1650049885662,MATH 193B,A01,083463,Staff,1,0,30,29
1650049885662,MATH 193B,A02,083464,Staff,9,0,30,21
1650049885662,MATH 193B,A03,083465,Staff,18,0,30,12
1650049891724,COGS 2,A01,083966,Boyle; Mary E. T.,10,0,30,20
1650049897749,COGS 9,A01,083968,Staff,7,0,60,53
1650049903771,COGS 14B,A01,083970,Staff,9,0,50,41
1650049909800,COGS 17,A01,092679,Staff,50,0,75,25
1650049915838,COGS 100,A01,083972,Staff,0,17,60,60
1650049927886,COGS 101C,A01,083976,Staff,12,0,30,18
1650049933915,COGS 102A,A01,083978,Johnson; Christine M.,13,0,30,17
1650049939940,COGS 107B,A01,083980,Staff,0,7,50,50
1650049945968,COGS 115,A01,083982,Staff,10,0,30,20
1650049951994,COGS 118B,A01,083367,Staff,0,15,40,40
1650049958024,COGS 172,A01,083984,Provenzano; Emily Kara,15,0,30,15
1650049964052,COGS 177,A00,083368,Staff,0,20,30,30
1650049970075,COGS 186,A01,083986,Staff,21,0,40,19
1650049976098,COGS 187A,A01,083988,Boyle; Mary E. T.,20,0,60,40
1650049982122,CSE 8A,A50,084003,Miranda; Gregory Joseph,0,16,15,15
1650049988149,CSE 11,A01,084005,Miranda; Gregory Joseph,0,22,55,55
1650049994175,CSE 20,A01,084007,Staff,0,5,20,20
1650050000199,CSE 21,A01,084009,Staff,0,32,50,50
1650050006227,CSE 30,A01,083370,Cao; Yingjun,0,65,40,40
1650050012255,CSE 100,A01,083372,Cao; Yingjun,0,46,40,40
1650050018277,CSE 101,A01,084011,Staff,0,54,40,40
1650050024302,CSE 141,A01,083374,Eldon; John,0,65,75,75
1650050030332,CSE 141L,A01,083376,Eldon; John,0,71,75,75
1650050036357,CSE 175,A01,084013,Kumar; Rakesh,22,0,25,3
1650050042384,CSE 190,A00,092508,Dubnov; Shlomo,18,0,20,2
1650050048414,ECE 5,A01,084049,Morris; Karcher William,12,0,20,8
1650050054439,ECE 100,A01,084051,Baghdadchi; Saharnaz,0,0,20,20
1650050054439,ECE 100,A02,091916,Baghdadchi; Saharnaz,13,0,20,7
1650050060462,ECE 101,A01,084053,Baghdadchi; Saharnaz,0,0,37,37
1650050060462,ECE 101,A02,084054,Baghdadchi; Saharnaz,29,0,37,8
1650050066486,ECE 107,A01,083390,Staff,26,0,40,14
1650050072525,ECE 148,A01,084056,Silberman; Jack,8,0,12,4
1650050078552,ECE 180,A00,083391,Abi Samra; Nicholas Camill,25,0,30,5
1650050078552,ECE 180,B00,083392,Abi Samra; Nicholas Camill,21,0,30,9
1650050084579,MATH 10B,A01,084110,Staff,0,0,30,30
1650050084579,MATH 10B,A02,084111,Staff,17,0,30,13
1650050084579,MATH 10B,A03,084112,Staff,24,0,30,6
1650050090615,MATH 10C,A01,083443,Staff,0,17,30,31
1650050090615,MATH 10C,A02,083444,Staff,0,16,30,30
1650050090615,MATH 10C,B01,084114,Staff,18,0,30,12
1650050090615,MATH 10C,B02,084115,Staff,25,0,30,5
1650050096667,MATH 18,A01,084117,Harel; Guershon,12,0,30,18
1650050096667,MATH 18,A02,084119,Harel; Guershon,27,0,30,3
1650050096667,MATH 18,A03,084120,Harel; Guershon,30,0,30,0
1650050096667,MATH 18,A04,084121,Harel; Guershon,29,0,30,1
1650050102690,MATH 20B,A01,084124,Um; Ko Woon,11,0,35,24
1650050102690,MATH 20B,B01,084126,Um; Ko Woon,24,0,35,11
1650050108716,MATH 20C,A01,083446,Hammock; Frances H,0,0,30,30
1650050108716,MATH 20C,A02,083447,Hammock; Frances H,14,0,30,16
1650050108716,MATH 20C,A03,083448,Hammock; Frances H,19,0,30,11
1650050108716,MATH 20C,A04,083449,Hammock; Frances H,20,0,30,10
1650050108716,MATH 20C,B01,083451,Hammock; Frances H,0,0,30,30
1650050108716,MATH 20C,B02,083452,Hammock; Frances H,17,0,30,13
1650050108716,MATH 20C,B03,083453,Hammock; Frances H,21,0,30,9
1650050108716,MATH 20C,B04,083454,Hammock; Frances H,23,0,30,7
1650050114744,MATH 20D,A01,084128,Staff,14,0,30,16
1650050114744,MATH 20D,A02,084129,Staff,29,0,30,1
1650050114744,MATH 20D,A03,084130,Staff,27,0,30,3
1650050114744,MATH 20D,B01,084133,Staff,1,0,30,29
1650050114744,MATH 20D,B02,084134,Staff,23,0,30,7
1650050114744,MATH 20D,B03,084135,Staff,28,0,30,2
1650050120768,MATH 20E,A01,084138,Staff,13,0,30,17
1650050120768,MATH 20E,A02,084139,Staff,6,0,30,24
1650050120768,MATH 20E,A03,084140,Staff,15,0,30,15
1650050120768,MATH 20E,A04,084141,Staff,20,0,30,10
1650050126794,MATH 102,A01,084143,Harel; Guershon,12,0,30,18
1650050126794,MATH 102,A02,084144,Harel; Guershon,19,0,30,11
1650050132823,MATH 103B,A01,083456,Staff,0,13,30,30
1650050132823,MATH 103B,A02,083457,Staff,0,14,30,30
1650050138846,MATH 109,A01,084146,Salehi Golsefidy; Alireza,17,0,30,13
1650050138846,MATH 109,A02,084147,Salehi Golsefidy; Alireza,15,0,30,15
1650050144873,MATH 120A,A01,085445,Eggers; John Dietrich,10,0,35,25
1650050144873,MATH 120A,A02,085446,Eggers; John Dietrich,27,0,35,8
1650050150990,MATH 142B,A01,084149,Verstraete; Jacques Allan,0,12,30,30
1650050150990,MATH 142B,A02,084150,Verstraete; Jacques Allan,0,12,30,30
1650050157015,MATH 170A,A01,083459,Nie; Jiawang,0,9,30,30
1650050157015,MATH 170A,A02,083460,Nie; Jiawang,0,9,30,30
1650050157015,MATH 170A,A03,083461,Nie; Jiawang,0,9,30,30
1650050163043,MATH 193B,A01,083463,Staff,1,0,30,29
1650050163043,MATH 193B,A02,083464,Staff,9,0,30,21
1650050163043,MATH 193B,A03,083465,Staff,18,0,30,12
1650050169102,COGS 2,A01,083966,Boyle; Mary E. T.,10,0,30,20
1650050175123,COGS 9,A01,083968,Staff,7,0,60,53
1650050181145,COGS 14B,A01,083970,Staff,9,0,50,41
1650050187172,COGS 17,A01,092679,Staff,50,0,75,25
1650050193202,COGS 100,A01,083972,Staff,0,17,60,60
1650050205247,COGS 101C,A01,083976,Staff,12,0,30,18
1650050211277,COGS 102A,A01,083978,Johnson; Christine M.,13,0,30,17
1650050217300,COGS 107B,A01,083980,Staff,0,8,50,50
1650050223327,COGS 115,A01,083982,Staff,10,0,30,20
1650050229352,COGS 118B,A01,083367,Staff,0,15,40,40
1650050235377,COGS 172,A01,083984,Provenzano; Emily Kara,15,0,30,15
1650050241408,COGS 177,A00,083368,Staff,0,20,30,30
1650050247436,COGS 186,A01,083986,Staff,21,0,40,19
1650050253464,COGS 187A,A01,083988,Boyle; Mary E. T.,20,0,60,40
1650050259488,CSE 8A,A50,084003,Miranda; Gregory Joseph,0,16,15,15
1650050265520,CSE 11,A01,084005,Miranda; Gregory Joseph,0,22,55,55
1650050271547,CSE 20,A01,084007,Staff,0,5,20,20
1650050277574,CSE 21,A01,084009,Staff,0,32,50,50
1650050283597,CSE 30,A01,083370,Cao; Yingjun,0,65,40,40
1650050289620,CSE 100,A01,083372,Cao; Yingjun,0,46,40,40
1650050295644,CSE 101,A01,084011,Staff,0,54,40,40
1650050301675,CSE 141,A01,083374,Eldon; John,0,65,75,75
1650050307702,CSE 141L,A01,083376,Eldon; John,0,71,75,75
1650050313726,CSE 175,A01,084013,Kumar; Rakesh,22,0,25,3
1650050319748,CSE 190,A00,092508,Dubnov; Shlomo,18,0,20,2
1650050325774,ECE 5,A01,084049,Morris; Karcher William,12,0,20,8
1650050331797,ECE 100,A01,084051,Baghdadchi; Saharnaz,0,0,20,20
1650050331797,ECE 100,A02,091916,Baghdadchi; Saharnaz,13,0,20,7
1650050337821,ECE 101,A01,084053,Baghdadchi; Saharnaz,0,0,37,37
1650050337821,ECE 101,A02,084054,Baghdadchi; Saharnaz,29,0,37,8
1650050343850,ECE 107,A01,083390,Staff,26,0,40,14
1650050349884,ECE 148,A01,084056,Silberman; Jack,8,0,12,4
1650050355908,ECE 180,A00,083391,Abi Samra; Nicholas Camill,25,0,30,5
1650050355908,ECE 180,B00,083392,Abi Samra; Nicholas Camill,21,0,30,9
1650050361936,MATH 10B,A01,084110,Staff,0,0,30,30
1650050361936,MATH 10B,A02,084111,Staff,17,0,30,13
1650050361936,MATH 10B,A03,084112,Staff,24,0,30,6
1650050367960,MATH 10C,A01,083443,Staff,0,17,30,31
1650050367960,MATH 10C,A02,083444,Staff,0,16,30,30
1650050367960,MATH 10C,B01,084114,Staff,18,0,30,12
1650050367960,MATH 10C,B02,084115,Staff,25,0,30,5
1650050373987,MATH 18,A01,084117,Harel; Guershon,12,0,30,18
1650050373987,MATH 18,A02,084119,Harel; Guershon,27,0,30,3
1650050373987,MATH 18,A03,084120,Harel; Guershon,30,0,30,0
1650050373987,MATH 18,A04,084121,Harel; Guershon,29,0,30,1
1650050380012,MATH 20B,A01,084124,Um; Ko Woon,11,0,35,24
1650050380012,MATH 20B,B01,084126,Um; Ko Woon,24,0,35,11
1650050386049,MATH 20C,A01,083446,Hammock; Frances H,0,0,30,30
1650050386049,MATH 20C,A02,083447,Hammock; Frances H,14,0,30,16
1650050386049,MATH 20C,A03,083448,Hammock; Frances H,19,0,30,11
1650050386049,MATH 20C,A04,083449,Hammock; Frances H,20,0,30,10
1650050386049,MATH 20C,B01,083451,Hammock; Frances H,0,0,30,30
1650050386049,MATH 20C,B02,083452,Hammock; Frances H,16,0,30,14
1650050386049,MATH 20C,B03,083453,Hammock; Frances H,21,0,30,9
1650050386049,MATH 20C,B04,083454,Hammock; Frances H,23,0,30,7
1650050392077,MATH 20D,A01,084128,Staff,14,0,30,16
1650050392077,MATH 20D,A02,084129,Staff,29,0,30,1
1650050392077,MATH 20D,A03,084130,Staff,27,0,30,3
1650050392077,MATH 20D,B01,084133,Staff,1,0,30,29
1650050392077,MATH 20D,B02,084134,Staff,23,0,30,7
1650050392077,MATH 20D,B03,084135,Staff,28,0,30,2
1650050398104,MATH 20E,A01,084138,Staff,13,0,30,17
1650050398104,MATH 20E,A02,084139,Staff,6,0,30,24
1650050398104,MATH 20E,A03,084140,Staff,15,0,30,15
1650050398104,MATH 20E,A04,084141,Staff,20,0,30,10
1650050404132,MATH 102,A01,084143,Harel; Guershon,12,0,30,18
1650050404132,MATH 102,A02,084144,Harel; Guershon,19,0,30,11
1650050410155,MATH 103B,A01,083456,Staff,0,13,30,30
1650050410155,MATH 103B,A02,083457,Staff,0,14,30,30
1650050416180,MATH 109,A01,084146,Salehi Golsefidy; Alireza,17,0,30,13
1650050416180,MATH 109,A02,084147,Salehi Golsefidy; Alireza,15,0,30,15
1650050422213,MATH 120A,A01,085445,Eggers; John Dietrich,10,0,35,25
1650050422213,MATH 120A,A02,085446,Eggers; John Dietrich,27,0,35,8
1650050428238,MATH 142B,A01,084149,Verstraete; Jacques Allan,0,12,30,30
1650050428238,MATH 142B,A02,084150,Verstraete; Jacques Allan,0,12,30,30
1650050434266,MATH 170A,A01,083459,Nie; Jiawang,0,9,30,30
1650050434266,MATH 170A,A02,083460,Nie; Jiawang,0,9,30,30
1650050434266,MATH 170A,A03,083461,Nie; Jiawang,0,9,30,30
1650050440301,MATH 193B,A01,083463,Staff,1,0,30,29
1650050440301,MATH 193B,A02,083464,Staff,9,0,30,21
1650050440301,MATH 193B,A03,083465,Staff,18,0,30,12
1650050446355,COGS 2,A01,083966,Boyle; Mary E. T.,10,0,30,20
1650050452382,COGS 9,A01,083968,Staff,7,0,60,53
1650050458421,COGS 14B,A01,083970,Staff,9,0,50,41
1650050464445,COGS 17,A01,092679,Staff,50,0,75,25
1650050470468,COGS 100,A01,083972,Staff,0,17,60,60
1650050482526,COGS 101C,A01,083976,Staff,12,0,30,18
1650050488553,COGS 102A,A01,083978,Johnson; Christine M.,13,0,30,17
1650050494579,COGS 107B,A01,083980,Staff,0,8,50,50
1650050500606,COGS 115,A01,083982,Staff,10,0,30,20
1650050506636,COGS 118B,A01,083367,Staff,0,15,40,40
1650050512665,COGS 172,A01,083984,Provenzano; Emily Kara,15,0,30,15
1650050518688,COGS 177,A00,083368,Staff,0,20,30,30
1650050524716,COGS 186,A01,083986,Staff,21,0,40,19
1650050530743,COGS 187A,A01,083988,Boyle; Mary E. T.,20,0,60,40
1650050536768,CSE 8A,A50,084003,Miranda; Gregory Joseph,0,16,15,15
1650050542796,CSE 11,A01,084005,Miranda; Gregory Joseph,0,22,55,55
1650050548825,CSE 20,A01,084007,Staff,0,5,20,20
1650050554847,CSE 21,A01,084009,Staff,0,32,50,50
1650050560875,CSE 30,A01,083370,Cao; Yingjun,0,65,40,40
1650050566899,CSE 100,A01,083372,Cao; Yingjun,0,46,40,40
1650050572926,CSE 101,A01,084011,Staff,0,54,40,40
1650050578954,CSE 141,A01,083374,Eldon; John,0,65,75,75
1650050584978,CSE 141L,A01,083376,Eldon; John,0,71,75,75
1650050591005,CSE 175,A01,084013,Kumar; Rakesh,22,0,25,3
1650050597027,CSE 190,A00,092508,Dubnov; Shlomo,18,0,20,2
1650050603051,ECE 5,A01,084049,Morris; Karcher William,12,0,20,8
1650050609076,ECE 100,A01,084051,Baghdadchi; Saharnaz,0,0,20,20
1650050609076,ECE 100,A02,091916,Baghdadchi; Saharnaz,13,0,20,7
1650050615102,ECE 101,A01,084053,Baghdadchi; Saharnaz,0,0,37,37
1650050615102,ECE 101,A02,084054,Baghdadchi; Saharnaz,29,0,37,8
1650050621128,ECE 107,A01,083390,Staff,26,0,40,14
1650050627152,ECE 148,A01,084056,Silberman; Jack,8,0,12,4
1650050633182,ECE 180,A00,083391,Abi Samra; Nicholas Camill,25,0,30,5
1650050633182,ECE 180,B00,083392,Abi Samra; Nicholas Camill,21,0,30,9
1650050639219,MATH 10B,A01,084110,Staff,0,0,30,30
1650050639219,MATH 10B,A02,084111,Staff,17,0,30,13
1650050639219,MATH 10B,A03,084112,Staff,24,0,30,6
1650050645253,MATH 10C,A01,083443,Staff,0,17,30,31
1650050645253,MATH 10C,A02,083444,Staff,0,16,30,30
1650050645253,MATH 10C,B01,084114,Staff,18,0,30,12
1650050645253,MATH 10C,B02,084115,Staff,25,0,30,5
1650050651277,MATH 18,A01,084117,Harel; Guershon,12,0,30,18
1650050651277,MATH 18,A02,084119,Harel; Guershon,27,0,30,3
1650050651277,MATH 18,A03,084120,Harel; Guershon,30,0,30,0
1650050651277,MATH 18,A04,084121,Harel; Guershon,29,0,30,1
1650050657300,MATH 20B,A01,084124,Um; Ko Woon,11,0,35,24
1650050657300,MATH 20B,B01,084126,Um; Ko Woon,24,0,35,11
1650050663326,MATH 20C,A01,083446,Hammock; Frances H,0,0,30,30
1650050663326,MATH 20C,A02,083447,Hammock; Frances H,14,0,30,16
1650050663326,MATH 20C,A03,083448,Hammock; Frances H,19,0,30,11
1650050663326,MATH 20C,A04,083449,Hammock; Frances H,20,0,30,10
1650050663326,MATH 20C,B01,083451,Hammock; Frances H,0,0,30,30
1650050663326,MATH 20C,B02,083452,Hammock; Frances H,16,0,30,14
1650050663326,MATH 20C,B03,083453,Hammock; Frances H,21,0,30,9
1650050663326,MATH 20C,B04,083454,Hammock; Frances H,23,0,30,7
1650050669350,MATH 20D,A01,084128,Staff,14,0,30,16
1650050669350,MATH 20D,A02,084129,Staff,29,0,30,1
1650050669350,MATH 20D,A03,084130,Staff,27,0,30,3
1650050669350,MATH 20D,B01,084133,Staff,1,0,30,29
1650050669350,MATH 20D,B02,084134,Staff,23,0,30,7
1650050669350,MATH 20D,B03,084135,Staff,28,0,30,2
1650050675378,MATH 20E,A01,084138,Staff,13,0,30,17
1650050675378,MATH 20E,A02,084139,Staff,6,0,30,24
1650050675378,MATH 20E,A03,084140,Staff,15,0,30,15
1650050675378,MATH 20E,A04,084141,Staff,20,0,30,10
1650050681406,MATH 102,A01,084143,Harel; Guershon,12,0,30,18
1650050681406,MATH 102,A02,084144,Harel; Guershon,19,0,30,11
1650050687434,MATH 103B,A01,083456,Staff,0,13,30,30
1650050687434,MATH 103B,A02,083457,Staff,0,14,30,30
1650050693472,MATH 109,A01,084146,Salehi Golsefidy; Alireza,17,0,30,13
1650050693472,MATH 109,A02,084147,Salehi Golsefidy; Alireza,15,0,30,15
1650050699514,MATH 120A,A01,085445,Eggers; John Dietrich,10,0,35,25
1650050699514,MATH 120A,A02,085446,Eggers; John Dietrich,27,0,35,8
1650050705538,MATH 142B,A01,084149,Verstraete; Jacques Allan,0,12,30,30
1650050705538,MATH 142B,A02,084150,Verstraete; Jacques Allan,0,12,30,30
1650050711566,MATH 170A,A01,083459,Nie; Jiawang,0,9,30,30
1650050711566,MATH 170A,A02,083460,Nie; Jiawang,0,9,30,30
1650050711566,MATH 170A,A03,083461,Nie; Jiawang,0,9,30,30
1650050717590,MATH 193B,A01,083463,Staff,1,0,30,29
1650050717590,MATH 193B,A02,083464,Staff,9,0,30,21
1650050717590,MATH 193B,A03,083465,Staff,18,0,30,12
1650050723659,COGS 2,A01,083966,Boyle; Mary E. T.,10,0,30,20
1650050729685,COGS 9,A01,083968,Staff,7,0,60,53
1650050735717,COGS 14B,A01,083970,Staff,9,0,50,41
1650050741836,COGS 17,A01,092679,Staff,50,0,75,25
1650050747870,COGS 100,A01,083972,Staff,0,17,60,60
1650050759922,COGS 101C,A01,083976,Staff,12,0,30,18
1650050765946,COGS 102A,A01,083978,Johnson; Christine M.,13,0,30,17
1650050771974,COGS 107B,A01,083980,Staff,0,8,50,50
1650050778004,COGS 115,A01,083982,Staff,10,0,30,20
1650050784031,COGS 118B,A01,083367,Staff,0,15,40,40
1650050790056,COGS 172,A01,083984,Provenzano; Emily Kara,15,0,30,15
1650050796086,COGS 177,A00,083368,Staff,0,20,30,30
1650050802116,COGS 186,A01,083986,Staff,21,0,40,19
1650050808147,COGS 187A,A01,083988,Boyle; Mary E. T.,20,0,60,40
1650050814173,CSE 8A,A50,084003,Miranda; Gregory Joseph,0,16,15,15
1650050820201,CSE 11,A01,084005,Miranda; Gregory Joseph,0,22,55,55
1650050826224,CSE 20,A01,084007,Staff,0,5,20,20
1650050832254,CSE 21,A01,084009,Staff,0,32,50,50
1650050838278,CSE 30,A01,083370,Cao; Yingjun,0,65,40,40
1650050844300,CSE 100,A01,083372,Cao; Yingjun,0,46,40,40
1650050850323,CSE 101,A01,084011,Staff,0,54,40,40
1650050856347,CSE 141,A01,083374,Eldon; John,0,65,75,75
1650050862370,CSE 141L,A01,083376,Eldon; John,0,71,75,75
1650050868398,CSE 175,A01,084013,Kumar; Rakesh,22,0,25,3
1650050874422,CSE 190,A00,092508,Dubnov; Shlomo,18,0,20,2
1650050880452,ECE 5,A01,084049,Morris; Karcher William,12,0,20,8
1650050886475,ECE 100,A01,084051,Baghdadchi; Saharnaz,0,0,20,20
1650050886475,ECE 100,A02,091916,Baghdadchi; Saharnaz,13,0,20,7
1650050892501,ECE 101,A01,084053,Baghdadchi; Saharnaz,0,0,37,37
1650050892501,ECE 101,A02,084054,Baghdadchi; Saharnaz,29,0,37,8
1650050898525,ECE 107,A01,083390,Staff,26,0,40,14
1650050904548,ECE 148,A01,084056,Silberman; Jack,8,0,12,4
1650050910593,ECE 180,A00,083391,Abi Samra; Nicholas Camill,25,0,30,5
1650050910593,ECE 180,B00,083392,Abi Samra; Nicholas Camill,21,0,30,9
1650050916616,MATH 10B,A01,084110,Staff,0,0,30,30
1650050916616,MATH 10B,A02,084111,Staff,17,0,30,13
1650050916616,MATH 10B,A03,084112,Staff,24,0,30,6
1650050922643,MATH 10C,A01,083443,Staff,0,17,30,31
1650050922643,MATH 10C,A02,083444,Staff,0,16,30,30
1650050922643,MATH 10C,B01,084114,Staff,18,0,30,12
1650050922643,MATH 10C,B02,084115,Staff,25,0,30,5
1650050928666,MATH 18,A01,084117,Harel; Guershon,12,0,30,18
1650050928666,MATH 18,A02,084119,Harel; Guershon,27,0,30,3
1650050928666,MATH 18,A03,084120,Harel; Guershon,30,0,30,0
1650050928666,MATH 18,A04,084121,Harel; Guershon,29,0,30,1
1650050934693,MATH 20B,A01,084124,Um; Ko Woon,11,0,35,24
1650050934693,MATH 20B,B01,084126,Um; Ko Woon,24,0,35,11
1650050940724,MATH 20C,A01,083446,Hammock; Frances H,0,0,30,30
1650050940724,MATH 20C,A02,083447,Hammock; Frances H,14,0,30,16
1650050940724,MATH 20C,A03,083448,Hammock; Frances H,19,0,30,11
1650050940724,MATH 20C,A04,083449,Hammock; Frances H,20,0,30,10
1650050940724,MATH 20C,B01,083451,Hammock; Frances H,0,0,30,30
1650050940724,MATH 20C,B02,083452,Hammock; Frances H,16,0,30,14
1650050940724,MATH 20C,B03,083453,Hammock; Frances H,21,0,30,9
1650050940724,MATH 20C,B04,083454,Hammock; Frances H,23,0,30,7
1650050946755,MATH 20D,A01,084128,Staff,14,0,30,16
1650050946755,MATH 20D,A02,084129,Staff,29,0,30,1
1650050946755,MATH 20D,A03,084130,Staff,27,0,30,3
1650050946755,MATH 20D,B01,084133,Staff,1,0,30,29
1650050946755,MATH 20D,B02,084134,Staff,23,0,30,7
1650050946755,MATH 20D,B03,084135,Staff,28,0,30,2
1650050952784,MATH 20E,A01,084138,Staff,13,0,30,17
1650050952784,MATH 20E,A02,084139,Staff,6,0,30,24
1650050952784,MATH 20E,A03,084140,Staff,15,0,30,15
1650050952784,MATH 20E,A04,084141,Staff,20,0,30,10
1650050958806,MATH 102,A01,084143,Harel; Guershon,12,0,30,18
1650050958806,MATH 102,A02,084144,Harel; Guershon,19,0,30,11
1650050964835,MATH 103B,A01,083456,Staff,0,13,30,30
1650050964835,MATH 103B,A02,083457,Staff,0,14,30,30
1650050970867,MATH 109,A01,084146,Salehi Golsefidy; Alireza,17,0,30,13
1650050970867,MATH 109,A02,084147,Salehi Golsefidy; Alireza,15,0,30,15
1650050976895,MATH 120A,A01,085445,Eggers; John Dietrich,10,0,35,25
1650050976895,MATH 120A,A02,085446,Eggers; John Dietrich,27,0,35,8
1650050982923,MATH 142B,A01,084149,Verstraete; Jacques Allan,0,12,30,30
1650050982923,MATH 142B,A02,084150,Verstraete; Jacques Allan,0,12,30,30
1650050988953,MATH 170A,A01,083459,Nie; Jiawang,0,9,30,30
1650050988953,MATH 170A,A02,083460,Nie; Jiawang,0,9,30,30
1650050988953,MATH 170A,A03,083461,Nie; Jiawang,0,9,30,30
1650050994979,MATH 193B,A01,083463,Staff,1,0,30,29
1650050994979,MATH 193B,A02,083464,Staff,9,0,30,21
1650050994979,MATH 193B,A03,083465,Staff,18,0,30,12
1650051001030,COGS 2,A01,083966,Boyle; Mary E. T.,10,0,30,20
1650051007053,COGS 9,A01,083968,Staff,7,0,60,53
1650051013083,COGS 14B,A01,083970,Staff,9,0,50,41
1650051019110,COGS 17,A01,092679,Staff,50,0,75,25
1650051025133,COGS 100,A01,083972,Staff,0,17,60,60
1650051037179,COGS 101C,A01,083976,Staff,12,0,30,18
1650051043202,COGS 102A,A01,083978,Johnson; Christine M.,13,0,30,17
1650051049245,COGS 107B,A01,083980,Staff,0,8,50,50
1650051055269,COGS 115,A01,083982,Staff,10,0,30,20
1650051061302,COGS 118B,A01,083367,Staff,0,15,40,40
1650051067326,COGS 172,A01,083984,Provenzano; Emily Kara,15,0,30,15
1650051073350,COGS 177,A00,083368,Staff,0,21,30,30
1650051079377,COGS 186,A01,083986,Staff,21,0,40,19
1650051085406,COGS 187A,A01,083988,Boyle; Mary E. T.,20,0,60,40
1650051091430,CSE 8A,A50,084003,Miranda; Gregory Joseph,0,16,15,15
1650051097455,CSE 11,A01,084005,Miranda; Gregory Joseph,0,22,55,55
1650051103479,CSE 20,A01,084007,Staff,0,5,20,20
1650051109507,CSE 21,A01,084009,Staff,0,32,50,50
1650051115529,CSE 30,A01,083370,Cao; Yingjun,0,65,40,40
1650051121557,CSE 100,A01,083372,Cao; Yingjun,0,46,40,40
1650051127594,CSE 101,A01,084011,Staff,0,54,40,40
1650051133622,CSE 141,A01,083374,Eldon; John,0,65,75,75
1650051139651,CSE 141L,A01,083376,Eldon; John,0,71,75,75
1650051145678,CSE 175,A01,084013,Kumar; Rakesh,22,0,25,3
1650051151716,CSE 190,A00,092508,Dubnov; Shlomo,18,0,20,2
1650051157740,ECE 5,A01,084049,Morris; Karcher William,12,0,20,8
1650051163762,ECE 100,A01,084051,Baghdadchi; Saharnaz,0,0,20,20
1650051163762,ECE 100,A02,091916,Baghdadchi; Saharnaz,13,0,20,7
1650051169786,ECE 101,A01,084053,Baghdadchi; Saharnaz,0,0,37,37
1650051169786,ECE 101,A02,084054,Baghdadchi; Saharnaz,29,0,37,8
1650051175810,ECE 107,A01,083390,Staff,26,0,40,14
1650051181845,ECE 148,A01,084056,Silberman; Jack,8,0,12,4
1650051187872,ECE 180,A00,083391,Abi Samra; Nicholas Camill,25,0,30,5
1650051187872,ECE 180,B00,083392,Abi Samra; Nicholas Camill,21,0,30,9
1650051193907,MATH 10B,A01,084110,Staff,0,0,30,30
1650051193907,MATH 10B,A02,084111,Staff,17,0,30,13
1650051193907,MATH 10B,A03,084112,Staff,24,0,30,6
1650051199931,MATH 10C,A01,083443,Staff,0,17,30,31
1650051199931,MATH 10C,A02,083444,Staff,0,16,30,30
1650051199931,MATH 10C,B01,084114,Staff,18,0,30,12
1650051199931,MATH 10C,B02,084115,Staff,25,0,30,5
1650051205974,MATH 18,A01,084117,Harel; Guershon,12,0,30,18
1650051205974,MATH 18,A02,084119,Harel; Guershon,27,0,30,3
1650051205974,MATH 18,A03,084120,Harel; Guershon,30,0,30,0
1650051205974,MATH 18,A04,084121,Harel; Guershon,29,0,30,1
1650051212007,MATH 20B,A01,084124,Um; Ko Woon,11,0,35,24
1650051212007,MATH 20B,B01,084126,Um; Ko Woon,24,0,35,11
1650051218031,MATH 20C,A01,083446,Hammock; Frances H,0,0,30,30
1650051218031,MATH 20C,A02,083447,Hammock; Frances H,14,0,30,16
1650051218031,MATH 20C,A03,083448,Hammock; Frances H,19,0,30,11
1650051218031,MATH 20C,A04,083449,Hammock; Frances H,20,0,30,10
1650051218031,MATH 20C,B01,083451,Hammock; Frances H,0,0,30,30
1650051218031,MATH 20C,B02,083452,Hammock; Frances H,16,0,30,14
1650051218031,MATH 20C,B03,083453,Hammock; Frances H,21,0,30,9
1650051218031,MATH 20C,B04,083454,Hammock; Frances H,23,0,30,7
1650051224061,MATH 20D,A01,084128,Staff,14,0,30,16
1650051224061,MATH 20D,A02,084129,Staff,29,0,30,1
1650051224061,MATH 20D,A03,084130,Staff,27,0,30,3
1650051224061,MATH 20D,B01,084133,Staff,1,0,30,29
1650051224061,MATH 20D,B02,084134,Staff,23,0,30,7
1650051224061,MATH 20D,B03,084135,Staff,28,0,30,2
1650051230088,MATH 20E,A01,084138,Staff,13,0,30,17
1650051230088,MATH 20E,A02,084139,Staff,6,0,30,24
1650051230088,MATH 20E,A03,084140,Staff,15,0,30,15
1650051230088,MATH 20E,A04,084141,Staff,20,0,30,10
1650051236116,MATH 102,A01,084143,Harel; Guershon,12,0,30,18
1650051236116,MATH 102,A02,084144,Harel; Guershon,19,0,30,11
1650051242140,MATH 103B,A01,083456,Staff,0,13,30,30
1650051242140,MATH 103B,A02,083457,Staff,0,14,30,30
1650051248177,MATH 109,A01,084146,Salehi Golsefidy; Alireza,17,0,30,13
1650051248177,MATH 109,A02,084147,Salehi Golsefidy; Alireza,15,0,30,15
1650051254205,MATH 120A,A01,085445,Eggers; John Dietrich,10,0,35,25
1650051254205,MATH 120A,A02,085446,Eggers; John Dietrich,27,0,35,8
1650051260243,MATH 142B,A01,084149,Verstraete; Jacques Allan,0,12,30,30
1650051260243,MATH 142B,A02,084150,Verstraete; Jacques Allan,0,12,30,30
1650051266267,MATH 170A,A01,083459,Nie; Jiawang,0,9,30,30
1650051266267,MATH 170A,A02,083460,Nie; Jiawang,0,9,30,30
1650051266267,MATH 170A,A03,083461,Nie; Jiawang,0,9,30,30
1650051272304,MATH 193B,A01,083463,Staff,1,0,30,29
1650051272304,MATH 193B,A02,083464,Staff,9,0,30,21
1650051272304,MATH 193B,A03,083465,Staff,18,0,30,12
1650051278354,COGS 2,A01,083966,Boyle; Mary E. T.,10,0,30,20
1650051284378,COGS 9,A01,083968,Staff,7,0,60,53
1650051290405,COGS 14B,A01,083970,Staff,9,0,50,41
1650051296439,COGS 17,A01,092679,Staff,50,0,75,25
1650051302474,COGS 100,A01,083972,Staff,0,17,60,60
1650051314525,COGS 101C,A01,083976,Staff,12,0,30,18
1650051320548,COGS 102A,A01,083978,Johnson; Christine M.,13,0,30,17
1650051326571,COGS 107B,A01,083980,Staff,0,8,50,50
1650051332609,COGS 115,A01,083982,Staff,10,0,30,20
1650051338724,COGS 118B,A01,083367,Staff,0,15,40,40
1650051344758,COGS 172,A01,083984,Provenzano; Emily Kara,15,0,30,15
1650051350781,COGS 177,A00,083368,Staff,0,21,30,30
1650051356804,COGS 186,A01,083986,Staff,21,0,40,19
1650051362842,COGS 187A,A01,083988,Boyle; Mary E. T.,20,0,60,40
1650051368874,CSE 8A,A50,084003,Miranda; Gregory Joseph,0,16,15,15
1650051374898,CSE 11,A01,084005,Miranda; Gregory Joseph,0,22,55,55
1650051380925,CSE 20,A01,084007,Staff,0,5,20,20
1650051386949,CSE 21,A01,084009,Staff,0,32,50,50
1650051392972,CSE 30,A01,083370,Cao; Yingjun,0,65,40,40
1650051399003,CSE 100,A01,083372,Cao; Yingjun,0,46,40,40
1650051405025,CSE 101,A01,084011,Staff,0,54,40,40
1650051411047,CSE 141,A01,083374,Eldon; John,0,65,75,75
1650051417073,CSE 141L,A01,083376,Eldon; John,0,71,75,75
1650051423098,CSE 175,A01,084013,Kumar; Rakesh,22,0,25,3
1650051429124,CSE 190,A00,092508,Dubnov; Shlomo,18,0,20,2
1650051435150,ECE 5,A01,084049,Morris; Karcher William,12,0,20,8
1650051441173,ECE 100,A01,084051,Baghdadchi; Saharnaz,0,0,20,20
1650051441173,ECE 100,A02,091916,Baghdadchi; Saharnaz,13,0,20,7
1650051447195,ECE 101,A01,084053,Baghdadchi; Saharnaz,0,0,37,37
1650051447195,ECE 101,A02,084054,Baghdadchi; Saharnaz,29,0,37,8
1650051453222,ECE 107,A01,083390,Staff,26,0,40,14
1650051459251,ECE 148,A01,084056,Silberman; Jack,8,0,12,4
1650051465277,ECE 180,A00,083391,Abi Samra; Nicholas Camill,25,0,30,5
1650051465277,ECE 180,B00,083392,Abi Samra; Nicholas Camill,21,0,30,9
1650051471304,MATH 10B,A01,084110,Staff,0,0,30,30
1650051471304,MATH 10B,A02,084111,Staff,17,0,30,13
1650051471304,MATH 10B,A03,084112,Staff,24,0,30,6
1650051477328,MATH 10C,A01,083443,Staff,0,17,30,31
1650051477328,MATH 10C,A02,083444,Staff,0,16,30,30
1650051477328,MATH 10C,B01,084114,Staff,18,0,30,12
1650051477328,MATH 10C,B02,084115,Staff,25,0,30,5
1650051483357,MATH 18,A01,084117,Harel; Guershon,12,0,30,18
1650051483357,MATH 18,A02,084119,Harel; Guershon,27,0,30,3
1650051483357,MATH 18,A03,084120,Harel; Guershon,30,0,30,0
1650051483357,MATH 18,A04,084121,Harel; Guershon,29,0,30,1
1650051489381,MATH 20B,A01,084124,Um; Ko Woon,11,0,35,24
1650051489381,MATH 20B,B01,084126,Um; Ko Woon,24,0,35,11
1650051495406,MATH 20C,A01,083446,Hammock; Frances H,0,0,30,30
1650051495406,MATH 20C,A02,083447,Hammock; Frances H,14,0,30,16
1650051495406,MATH 20C,A03,083448,Hammock; Frances H,19,0,30,11
1650051495406,MATH 20C,A04,083449,Hammock; Frances H,20,0,30,10
1650051495406,MATH 20C,B01,083451,Hammock; Frances H,0,0,30,30
1650051495406,MATH 20C,B02,083452,Hammock; Frances H,16,0,30,14
1650051495406,MATH 20C,B03,083453,Hammock; Frances H,21,0,30,9
1650051495406,MATH 20C,B04,083454,Hammock; Frances H,23,0,30,7
1650051501449,MATH 20D,A01,084128,Staff,14,0,30,16
1650051501449,MATH 20D,A02,084129,Staff,29,0,30,1
1650051501449,MATH 20D,A03,084130,Staff,27,0,30,3
1650051501449,MATH 20D,B01,084133,Staff,1,0,30,29
1650051501449,MATH 20D,B02,084134,Staff,23,0,30,7
1650051501449,MATH 20D,B03,084135,Staff,28,0,30,2
1650051507479,MATH 20E,A01,084138,Staff,13,0,30,17
1650051507479,MATH 20E,A02,084139,Staff,6,0,30,24
1650051507479,MATH 20E,A03,084140,Staff,15,0,30,15
1650051507479,MATH 20E,A04,084141,Staff,20,0,30,10
1650051513511,MATH 102,A01,084143,Harel; Guershon,12,0,30,18
1650051513511,MATH 102,A02,084144,Harel; Guershon,19,0,30,11
1650051519547,MATH 103B,A01,083456,Staff,0,13,30,30
1650051519547,MATH 103B,A02,083457,Staff,0,14,30,30
1650051525575,MATH 109,A01,084146,Salehi Golsefidy; Alireza,17,0,30,13
1650051525575,MATH 109,A02,084147,Salehi Golsefidy; Alireza,15,0,30,15
1650051531601,MATH 120A,A01,085445,Eggers; John Dietrich,10,0,35,25
1650051531601,MATH 120A,A02,085446,Eggers; John Dietrich,27,0,35,8
1650051537628,MATH 142B,A01,084149,Verstraete; Jacques Allan,0,12,30,30
1650051537628,MATH 142B,A02,084150,Verstraete; Jacques Allan,0,12,30,30
1650051543657,MATH 170A,A01,083459,Nie; Jiawang,0,9,30,30
1650051543657,MATH 170A,A02,083460,Nie; Jiawang,0,9,30,30
1650051543657,MATH 170A,A03,083461,Nie; Jiawang,0,9,30,30
1650051549685,MATH 193B,A01,083463,Staff,1,0,30,29
1650051549685,MATH 193B,A02,083464,Staff,9,0,30,21
1650051549685,MATH 193B,A03,083465,Staff,18,0,30,12
1650051555746,COGS 2,A01,083966,Boyle; Mary E. T.,10,0,30,20
1650051561770,COGS 9,A01,083968,Staff,7,0,60,53
1650051567794,COGS 14B,A01,083970,Staff,9,0,50,41
1650051573825,COGS 17,A01,092679,Staff,50,0,75,25
1650051579851,COGS 100,A01,083972,Staff,0,17,60,60
1650051591900,COGS 101C,A01,083976,Staff,12,0,30,18
1650051597923,COGS 102A,A01,083978,Johnson; Christine M.,13,0,30,17
1650051603952,COGS 107B,A01,083980,Staff,0,8,50,50
1650051609983,COGS 115,A01,083982,Staff,10,0,30,20
1650051616014,COGS 118B,A01,083367,Staff,0,15,40,40
1650051622039,COGS 172,A01,083984,Provenzano; Emily Kara,15,0,30,15
1650051628062,COGS 177,A00,083368,Staff,0,21,30,30
1650051634088,COGS 186,A01,083986,Staff,21,0,40,19
1650051640109,COGS 187A,A01,083988,Boyle; Mary E. T.,20,0,60,40
1650051646137,CSE 8A,A50,084003,Miranda; Gregory Joseph,0,16,15,15
1650051652161,CSE 11,A01,084005,Miranda; Gregory Joseph,0,22,55,55
1650051658184,CSE 20,A01,084007,Staff,0,5,20,20
1650051664208,CSE 21,A01,084009,Staff,0,32,50,50
1650051670231,CSE 30,A01,083370,Cao; Yingjun,0,65,40,40
1650051676258,CSE 100,A01,083372,Cao; Yingjun,0,46,40,40
1650051682289,CSE 101,A01,084011,Staff,0,54,40,40
1650051688314,CSE 141,A01,083374,Eldon; John,0,65,75,75
1650051694346,CSE 141L,A01,083376,Eldon; John,0,71,75,75
1650051700370,CSE 175,A01,084013,Kumar; Rakesh,22,0,25,3
1650051706400,CSE 190,A00,092508,Dubnov; Shlomo,18,0,20,2
1650051712429,ECE 5,A01,084049,Morris; Karcher William,12,0,20,8
1650051718455,ECE 100,A01,084051,Baghdadchi; Saharnaz,0,0,20,20
1650051718455,ECE 100,A02,091916,Baghdadchi; Saharnaz,12,0,20,8
1650051724485,ECE 101,A01,084053,Baghdadchi; Saharnaz,0,0,37,37
1650051724485,ECE 101,A02,084054,Baghdadchi; Saharnaz,29,0,37,8
1650051730509,ECE 107,A01,083390,Staff,26,0,40,14
1650051736535,ECE 148,A01,084056,Silberman; Jack,8,0,12,4
1650051742562,ECE 180,A00,083391,Abi Samra; Nicholas Camill,25,0,30,5
1650051742562,ECE 180,B00,083392,Abi Samra; Nicholas Camill,21,0,30,9
1650051748586,MATH 10B,A01,084110,Staff,0,0,30,30
1650051748586,MATH 10B,A02,084111,Staff,17,0,30,13
1650051748586,MATH 10B,A03,084112,Staff,24,0,30,6
1650051754617,MATH 10C,A01,083443,Staff,0,17,30,31
1650051754617,MATH 10C,A02,083444,Staff,0,16,30,30
1650051754617,MATH 10C,B01,084114,Staff,18,0,30,12
1650051754617,MATH 10C,B02,084115,Staff,25,0,30,5
1650051760645,MATH 18,A01,084117,Harel; Guershon,12,0,30,18
1650051760645,MATH 18,A02,084119,Harel; Guershon,27,0,30,3
1650051760645,MATH 18,A03,084120,Harel; Guershon,30,0,30,0
1650051760645,MATH 18,A04,084121,Harel; Guershon,29,0,30,1
1650051766673,MATH 20B,A01,084124,Um; Ko Woon,11,0,35,24
1650051766673,MATH 20B,B01,084126,Um; Ko Woon,24,0,35,11
1650051772701,MATH 20C,A01,083446,Hammock; Frances H,0,0,30,30
1650051772701,MATH 20C,A02,083447,Hammock; Frances H,14,0,30,16
1650051772701,MATH 20C,A03,083448,Hammock; Frances H,19,0,30,11
1650051772701,MATH 20C,A04,083449,Hammock; Frances H,20,0,30,10
1650051772701,MATH 20C,B01,083451,Hammock; Frances H,0,0,30,30
1650051772701,MATH 20C,B02,083452,Hammock; Frances H,16,0,30,14
1650051772701,MATH 20C,B03,083453,Hammock; Frances H,21,0,30,9
1650051772701,MATH 20C,B04,083454,Hammock; Frances H,23,0,30,7
1650051778726,MATH 20D,A01,084128,Staff,14,0,30,16
1650051778726,MATH 20D,A02,084129,Staff,29,0,30,1
1650051778726,MATH 20D,A03,084130,Staff,27,0,30,3
1650051778726,MATH 20D,B01,084133,Staff,1,0,30,29
1650051778726,MATH 20D,B02,084134,Staff,23,0,30,7
1650051778726,MATH 20D,B03,084135,Staff,28,0,30,2
1650051784748,MATH 20E,A01,084138,Staff,13,0,30,17
1650051784748,MATH 20E,A02,084139,Staff,6,0,30,24
1650051784748,MATH 20E,A03,084140,Staff,15,0,30,15
1650051784748,MATH 20E,A04,084141,Staff,20,0,30,10
1650051790778,MATH 102,A01,084143,Harel; Guershon,12,0,30,18
1650051790778,MATH 102,A02,084144,Harel; Guershon,19,0,30,11
1650051796803,MATH 103B,A01,083456,Staff,0,13,30,30
1650051796803,MATH 103B,A02,083457,Staff,0,14,30,30
1650051802827,MATH 109,A01,084146,Salehi Golsefidy; Alireza,17,0,30,13
1650051802827,MATH 109,A02,084147,Salehi Golsefidy; Alireza,15,0,30,15
1650051808855,MATH 120A,A01,085445,Eggers; John Dietrich,10,0,35,25
1650051808855,MATH 120A,A02,085446,Eggers; John Dietrich,27,0,35,8
1650051814885,MATH 142B,A01,084149,Verstraete; Jacques Allan,0,12,30,30
1650051814885,MATH 142B,A02,084150,Verstraete; Jacques Allan,0,12,30,30
1650051820915,MATH 170A,A01,083459,Nie; Jiawang,0,9,30,30
1650051820915,MATH 170A,A02,083460,Nie; Jiawang,0,9,30,30
1650051820915,MATH 170A,A03,083461,Nie; Jiawang,0,9,30,30
1650051826938,MATH 193B,A01,083463,Staff,1,0,30,29
1650051826938,MATH 193B,A02,083464,Staff,9,0,30,21
1650051826938,MATH 193B,A03,083465,Staff,18,0,30,12
1650051833004,COGS 2,A01,083966,Boyle; Mary E. T.,10,0,30,20
1650051839028,COGS 9,A01,083968,Staff,7,0,60,53
1650051845054,COGS 14B,A01,083970,Staff,9,0,50,41
1650051851089,COGS 17,A01,092679,Staff,50,0,75,25
1650051857119,COGS 100,A01,083972,Staff,0,17,60,60
1650051869168,COGS 101C,A01,083976,Staff,12,0,30,18
1650051875192,COGS 102A,A01,083978,Johnson; Christine M.,13,0,30,17
1650051881219,COGS 107B,A01,083980,Staff,0,8,50,50
1650051887242,COGS 115,A01,083982,Staff,10,0,30,20
1650051893266,COGS 118B,A01,083367,Staff,0,15,40,40
1650051899294,COGS 172,A01,083984,Provenzano; Emily Kara,15,0,30,15
1650051905316,COGS 177,A00,083368,Staff,0,21,30,30
1650051911340,COGS 186,A01,083986,Staff,21,0,40,19
1650051917363,COGS 187A,A01,083988,Boyle; Mary E. T.,20,0,60,40
1650051923392,CSE 8A,A50,084003,Miranda; Gregory Joseph,0,16,15,15
1650051929427,CSE 11,A01,084005,Miranda; Gregory Joseph,0,22,55,55
1650051935571,CSE 20,A01,084007,Staff,0,5,20,20
1650051941595,CSE 21,A01,084009,Staff,0,32,50,50
1650051947619,CSE 30,A01,083370,Cao; Yingjun,0,65,40,40
1650051953653,CSE 100,A01,083372,Cao; Yingjun,0,46,40,40
1650051959696,CSE 101,A01,084011,Staff,0,54,40,40
1650051965724,CSE 141,A01,083374,Eldon; John,0,65,75,75
1650051971748,CSE 141L,A01,083376,Eldon; John,0,71,75,75
1650051977770,CSE 175,A01,084013,Kumar; Rakesh,22,0,25,3
1650051983798,CSE 190,A00,092508,Dubnov; Shlomo,18,0,20,2
1650051989824,ECE 5,A01,084049,Morris; Karcher William,12,0,20,8
1650051995848,ECE 100,A01,084051,Baghdadchi; Saharnaz,0,0,20,20
1650051995848,ECE 100,A02,091916,Baghdadchi; Saharnaz,12,0,20,8
1650052001873,ECE 101,A01,084053,Baghdadchi; Saharnaz,0,0,37,37
1650052001873,ECE 101,A02,084054,Baghdadchi; Saharnaz,29,0,37,8
1650052007897,ECE 107,A01,083390,Staff,26,0,40,14
1650052013921,ECE 148,A01,084056,Silberman; Jack,8,0,12,4
1650052019944,ECE 180,A00,083391,Abi Samra; Nicholas Camill,25,0,30,5
1650052019944,ECE 180,B00,083392,Abi Samra; Nicholas Camill,21,0,30,9
1650052025967,MATH 10B,A01,084110,Staff,0,0,30,30
1650052025967,MATH 10B,A02,084111,Staff,17,0,30,13
1650052025967,MATH 10B,A03,084112,Staff,24,0,30,6
1650052031998,MATH 10C,A01,083443,Staff,0,17,30,31
1650052031998,MATH 10C,A02,083444,Staff,0,16,30,30
1650052031998,MATH 10C,B01,084114,Staff,18,0,30,12
1650052031998,MATH 10C,B02,084115,Staff,25,0,30,5
1650052038022,MATH 18,A01,084117,Harel; Guershon,12,0,30,18
1650052038022,MATH 18,A02,084119,Harel; Guershon,27,0,30,3
1650052038022,MATH 18,A03,084120,Harel; Guershon,30,0,30,0
1650052038022,MATH 18,A04,084121,Harel; Guershon,29,0,30,1
1650052044046,MATH 20B,A01,084124,Um; Ko Woon,11,0,35,24
1650052044046,MATH 20B,B01,084126,Um; Ko Woon,24,0,35,11
1650052050072,MATH 20C,A01,083446,Hammock; Frances H,0,0,30,30
1650052050072,MATH 20C,A02,083447,Hammock; Frances H,14,0,30,16
1650052050072,MATH 20C,A03,083448,Hammock; Frances H,19,0,30,11
1650052050072,MATH 20C,A04,083449,Hammock; Frances H,20,0,30,10
1650052050072,MATH 20C,B01,083451,Hammock; Frances H,0,0,30,30
1650052050072,MATH 20C,B02,083452,Hammock; Frances H,16,0,30,14
1650052050072,MATH 20C,B03,083453,Hammock; Frances H,21,0,30,9
1650052050072,MATH 20C,B04,083454,Hammock; Frances H,23,0,30,7
1650052056100,MATH 20D,A01,084128,Staff,14,0,30,16
1650052056100,MATH 20D,A02,084129,Staff,29,0,30,1
1650052056100,MATH 20D,A03,084130,Staff,27,0,30,3
1650052056100,MATH 20D,B01,084133,Staff,1,0,30,29
1650052056100,MATH 20D,B02,084134,Staff,23,0,30,7
1650052056100,MATH 20D,B03,084135,Staff,28,0,30,2
1650052062122,MATH 20E,A01,084138,Staff,12,0,30,18
1650052062122,MATH 20E,A02,084139,Staff,6,0,30,24
1650052062122,MATH 20E,A03,084140,Staff,15,0,30,15
1650052062122,MATH 20E,A04,084141,Staff,20,0,30,10
1650052068149,MATH 102,A01,084143,Harel; Guershon,12,0,30,18
1650052068149,MATH 102,A02,084144,Harel; Guershon,19,0,30,11
1650052074174,MATH 103B,A01,083456,Staff,0,13,30,30
1650052074174,MATH 103B,A02,083457,Staff,0,14,30,30
1650052080198,MATH 109,A01,084146,Salehi Golsefidy; Alireza,17,0,30,13
1650052080198,MATH 109,A02,084147,Salehi Golsefidy; Alireza,15,0,30,15
1650052086219,MATH 120A,A01,085445,Eggers; John Dietrich,10,0,35,25
1650052086219,MATH 120A,A02,085446,Eggers; John Dietrich,27,0,35,8
1650052092255,MATH 142B,A01,084149,Verstraete; Jacques Allan,0,12,30,30
1650052092255,MATH 142B,A02,084150,Verstraete; Jacques Allan,0,12,30,30
1650052098282,MATH 170A,A01,083459,Nie; Jiawang,0,9,30,30
1650052098282,MATH 170A,A02,083460,Nie; Jiawang,0,9,30,30
1650052098282,MATH 170A,A03,083461,Nie; Jiawang,0,9,30,30
1650052104306,MATH 193B,A01,083463,Staff,1,0,30,29
1650052104306,MATH 193B,A02,083464,Staff,9,0,30,21
1650052104306,MATH 193B,A03,083465,Staff,18,0,30,12
1650052110365,COGS 2,A01,083966,Boyle; Mary E. T.,10,0,30,20
1650052116389,COGS 9,A01,083968,Staff,7,0,60,53
1650052122413,COGS 14B,A01,083970,Staff,9,0,50,41
1650052128440,COGS 17,A01,092679,Staff,50,0,75,25
1650052134498,COGS 100,A01,083972,Staff,0,17,60,60
1650052146563,COGS 101C,A01,083976,Staff,12,0,30,18
1650052152596,COGS 102A,A01,083978,Johnson; Christine M.,13,0,30,17
1650052158626,COGS 107B,A01,083980,Staff,0,8,50,50
1650052164650,COGS 115,A01,083982,Staff,10,0,30,20
1650052170674,COGS 118B,A01,083367,Staff,0,15,40,40
1650052176699,COGS 172,A01,083984,Provenzano; Emily Kara,15,0,30,15
1650052182722,COGS 177,A00,083368,Staff,0,21,30,30
1650052188752,COGS 186,A01,083986,Staff,21,0,40,19
1650052194783,COGS 187A,A01,083988,Boyle; Mary E. T.,20,0,60,40
1650052200814,CSE 8A,A50,084003,Miranda; Gregory Joseph,0,16,15,15
1650052206838,CSE 11,A01,084005,Miranda; Gregory Joseph,0,22,55,55
1650052212862,CSE 20,A01,084007,Staff,0,5,20,20
1650052218885,CSE 21,A01,084009,Staff,0,32,50,50
1650052224909,CSE 30,A01,083370,Cao; Yingjun,0,65,40,40
1650052230935,CSE 100,A01,083372,Cao; Yingjun,0,46,40,40
1650052236968,CSE 101,A01,084011,Staff,0,54,40,40
1650052243004,CSE 141,A01,083374,Eldon; John,0,65,75,75
1650052249027,CSE 141L,A01,083376,Eldon; John,0,71,75,75
1650052255050,CSE 175,A01,084013,Kumar; Rakesh,22,0,25,3
1650052261081,CSE 190,A00,092508,Dubnov; Shlomo,18,0,20,2
1650052267105,ECE 5,A01,084049,Morris; Karcher William,12,0,20,8
1650052273132,ECE 100,A01,084051,Baghdadchi; Saharnaz,0,0,20,20
1650052273132,ECE 100,A02,091916,Baghdadchi; Saharnaz,12,0,20,8
1650052279160,ECE 101,A01,084053,Baghdadchi; Saharnaz,0,0,37,37
1650052279160,ECE 101,A02,084054,Baghdadchi; Saharnaz,29,0,37,8
1650052285194,ECE 107,A01,083390,Staff,26,0,40,14
1650052291220,ECE 148,A01,084056,Silberman; Jack,8,0,12,4
1650052297249,ECE 180,A00,083391,Abi Samra; Nicholas Camill,25,0,30,5
1650052297249,ECE 180,B00,083392,Abi Samra; Nicholas Camill,21,0,30,9
1650052303276,MATH 10B,A01,084110,Staff,0,0,30,30
1650052303276,MATH 10B,A02,084111,Staff,17,0,30,13
1650052303276,MATH 10B,A03,084112,Staff,24,0,30,6
1650052309303,MATH 10C,A01,083443,Staff,0,17,30,31
1650052309303,MATH 10C,A02,083444,Staff,0,17,30,30
1650052309303,MATH 10C,B01,084114,Staff,18,0,30,12
1650052309303,MATH 10C,B02,084115,Staff,25,0,30,5
1650052315328,MATH 18,A01,084117,Harel; Guershon,12,0,30,18
1650052315328,MATH 18,A02,084119,Harel; Guershon,27,0,30,3
1650052315328,MATH 18,A03,084120,Harel; Guershon,30,0,30,0
1650052315328,MATH 18,A04,084121,Harel; Guershon,29,0,30,1
1650052321351,MATH 20B,A01,084124,Um; Ko Woon,11,0,35,24
1650052321351,MATH 20B,B01,084126,Um; Ko Woon,24,0,35,11
1650052327382,MATH 20C,A01,083446,Hammock; Frances H,0,0,30,30
1650052327382,MATH 20C,A02,083447,Hammock; Frances H,14,0,30,16
1650052327382,MATH 20C,A03,083448,Hammock; Frances H,19,0,30,11
1650052327382,MATH 20C,A04,083449,Hammock; Frances H,20,0,30,10
1650052327382,MATH 20C,B01,083451,Hammock; Frances H,0,0,30,30
1650052327382,MATH 20C,B02,083452,Hammock; Frances H,16,0,30,14
1650052327382,MATH 20C,B03,083453,Hammock; Frances H,21,0,30,9
1650052327382,MATH 20C,B04,083454,Hammock; Frances H,23,0,30,7
1650052333409,MATH 20D,A01,084128,Staff,14,0,30,16
1650052333409,MATH 20D,A02,084129,Staff,29,0,30,1
1650052333409,MATH 20D,A03,084130,Staff,27,0,30,3
1650052333409,MATH 20D,B01,084133,Staff,1,0,30,29
1650052333409,MATH 20D,B02,084134,Staff,23,0,30,7
1650052333409,MATH 20D,B03,084135,Staff,28,0,30,2
1650052339433,MATH 20E,A01,084138,Staff,12,0,30,18
1650052339433,MATH 20E,A02,084139,Staff,6,0,30,24
1650052339433,MATH 20E,A03,084140,Staff,15,0,30,15
1650052339433,MATH 20E,A04,084141,Staff,20,0,30,10
1650052345463,MATH 102,A01,084143,Harel; Guershon,12,0,30,18
1650052345463,MATH 102,A02,084144,Harel; Guershon,19,0,30,11
1650052351500,MATH 103B,A01,083456,Staff,0,13,30,30
1650052351500,MATH 103B,A02,083457,Staff,0,14,30,30
1650052357526,MATH 109,A01,084146,Salehi Golsefidy; Alireza,17,0,30,13
1650052357526,MATH 109,A02,084147,Salehi Golsefidy; Alireza,15,0,30,15
1650052363551,MATH 120A,A01,085445,Eggers; John Dietrich,10,0,35,25
1650052363551,MATH 120A,A02,085446,Eggers; John Dietrich,27,0,35,8
1650052369580,MATH 142B,A01,084149,Verstraete; Jacques Allan,0,12,30,30
1650052369580,MATH 142B,A02,084150,Verstraete; Jacques Allan,0,12,30,30
1650052375604,MATH 170A,A01,083459,Nie; Jiawang,0,9,30,30
1650052375604,MATH 170A,A02,083460,Nie; Jiawang,0,9,30,30
1650052375604,MATH 170A,A03,083461,Nie; Jiawang,0,9,30,30
1650052381634,MATH 193B,A01,083463,Staff,1,0,30,29
1650052381634,MATH 193B,A02,083464,Staff,9,0,30,21
1650052381634,MATH 193B,A03,083465,Staff,18,0,30,12
1650052387696,COGS 2,A01,083966,Boyle; Mary E. T.,10,0,30,20
1650052393723,COGS 9,A01,083968,Staff,7,0,60,53
1650052399748,COGS 14B,A01,083970,Staff,9,0,50,41
1650052405780,COGS 17,A01,092679,Staff,50,0,75,25
1650052411811,COGS 100,A01,083972,Staff,0,17,60,60
1650052423871,COGS 101C,A01,083976,Staff,12,0,30,18
1650052429896,COGS 102A,A01,083978,Johnson; Christine M.,13,0,30,17
1650052435919,COGS 107B,A01,083980,Staff,0,8,50,50
1650052441945,COGS 115,A01,083982,Staff,10,0,30,20
1650052447970,COGS 118B,A01,083367,Staff,0,15,40,40
1650052454002,COGS 172,A01,083984,Provenzano; Emily Kara,15,0,30,15
1650052460033,COGS 177,A00,083368,Staff,0,21,30,30
1650052466059,COGS 186,A01,083986,Staff,21,0,40,19
1650052472087,COGS 187A,A01,083988,Boyle; Mary E. T.,20,0,60,40
1650052478113,CSE 8A,A50,084003,Miranda; Gregory Joseph,0,16,15,15
1650052484144,CSE 11,A01,084005,Miranda; Gregory Joseph,0,22,55,55
1650052490168,CSE 20,A01,084007,Staff,0,5,20,20
1650052496194,CSE 21,A01,084009,Staff,0,32,50,50
1650052502221,CSE 30,A01,083370,Cao; Yingjun,0,65,40,40
1650052508257,CSE 100,A01,083372,Cao; Yingjun,0,46,40,40
1650052514281,CSE 101,A01,084011,Staff,0,54,40,40
1650052520309,CSE 141,A01,083374,Eldon; John,0,65,75,75
1650052526337,CSE 141L,A01,083376,Eldon; John,0,71,75,75
1650052532435,CSE 175,A01,084013,Kumar; Rakesh,22,0,25,3
1650052538479,CSE 190,A00,092508,Dubnov; Shlomo,18,0,20,2
1650052544511,ECE 5,A01,084049,Morris; Karcher William,12,0,20,8
1650052550536,ECE 100,A01,084051,Baghdadchi; Saharnaz,0,0,20,20
1650052550536,ECE 100,A02,091916,Baghdadchi; Saharnaz,12,0,20,8
1650052556560,ECE 101,A01,084053,Baghdadchi; Saharnaz,0,0,37,37
1650052556560,ECE 101,A02,084054,Baghdadchi; Saharnaz,29,0,37,8
1650052562585,ECE 107,A01,083390,Staff,26,0,40,14
1650052568613,ECE 148,A01,084056,Silberman; Jack,8,0,12,4
1650052574641,ECE 180,A00,083391,Abi Samra; Nicholas Camill,25,0,30,5
1650052574641,ECE 180,B00,083392,Abi Samra; Nicholas Camill,21,0,30,9
1650052580665,MATH 10B,A01,084110,Staff,0,0,30,30
1650052580665,MATH 10B,A02,084111,Staff,17,0,30,13
1650052580665,MATH 10B,A03,084112,Staff,24,0,30,6
1650052586697,MATH 10C,A01,083443,Staff,0,17,30,31
1650052586697,MATH 10C,A02,083444,Staff,0,17,30,30
1650052586697,MATH 10C,B01,084114,Staff,18,0,30,12
1650052586697,MATH 10C,B02,084115,Staff,25,0,30,5
1650052592723,MATH 18,A01,084117,Harel; Guershon,12,0,30,18
1650052592723,MATH 18,A02,084119,Harel; Guershon,27,0,30,3
1650052592723,MATH 18,A03,084120,Harel; Guershon,30,0,30,0
1650052592723,MATH 18,A04,084121,Harel; Guershon,29,0,30,1
1650052598767,MATH 20B,A01,084124,Um; Ko Woon,11,0,35,24
1650052598767,MATH 20B,B01,084126,Um; Ko Woon,24,0,35,11
1650052604804,MATH 20C,A01,083446,Hammock; Frances H,0,0,30,30
1650052604804,MATH 20C,A02,083447,Hammock; Frances H,14,0,30,16
1650052604804,MATH 20C,A03,083448,Hammock; Frances H,19,0,30,11
1650052604804,MATH 20C,A04,083449,Hammock; Frances H,20,0,30,10
1650052604804,MATH 20C,B01,083451,Hammock; Frances H,0,0,30,30
1650052604804,MATH 20C,B02,083452,Hammock; Frances H,16,0,30,14
1650052604804,MATH 20C,B03,083453,Hammock; Frances H,21,0,30,9
1650052604804,MATH 20C,B04,083454,Hammock; Frances H,23,0,30,7
1650052610829,MATH 20D,A01,084128,Staff,14,0,30,16
1650052610829,MATH 20D,A02,084129,Staff,29,0,30,1
1650052610829,MATH 20D,A03,084130,Staff,27,0,30,3
1650052610829,MATH 20D,B01,084133,Staff,1,0,30,29
1650052610829,MATH 20D,B02,084134,Staff,23,0,30,7
1650052610829,MATH 20D,B03,084135,Staff,28,0,30,2
1650052616853,MATH 20E,A01,084138,Staff,12,0,30,18
1650052616853,MATH 20E,A02,084139,Staff,6,0,30,24
1650052616853,MATH 20E,A03,084140,Staff,15,0,30,15
1650052616853,MATH 20E,A04,084141,Staff,20,0,30,10
1650052622883,MATH 102,A01,084143,Harel; Guershon,12,0,30,18
1650052622883,MATH 102,A02,084144,Harel; Guershon,19,0,30,11
1650052628906,MATH 103B,A01,083456,Staff,0,13,30,30
1650052628906,MATH 103B,A02,083457,Staff,0,14,30,30
1650052634930,MATH 109,A01,084146,Salehi Golsefidy; Alireza,17,0,30,13
1650052634930,MATH 109,A02,084147,Salehi Golsefidy; Alireza,15,0,30,15
1650052640958,MATH 120A,A01,085445,Eggers; John Dietrich,10,0,35,25
1650052640958,MATH 120A,A02,085446,Eggers; John Dietrich,27,0,35,8
1650052646984,MATH 142B,A01,084149,Verstraete; Jacques Allan,0,12,30,30
1650052646984,MATH 142B,A02,084150,Verstraete; Jacques Allan,0,12,30,30
1650052653013,MATH 170A,A01,083459,Nie; Jiawang,0,9,30,30
1650052653013,MATH 170A,A02,083460,Nie; Jiawang,0,9,30,30
1650052653013,MATH 170A,A03,083461,Nie; Jiawang,0,9,30,30
1650052659040,MATH 193B,A01,083463,Staff,1,0,30,29
1650052659040,MATH 193B,A02,083464,Staff,9,0,30,21
1650052659040,MATH 193B,A03,083465,Staff,18,0,30,12
1650052665101,COGS 2,A01,083966,Boyle; Mary E. T.,10,0,30,20
1650052671127,COGS 9,A01,083968,Staff,7,0,60,53
1650052677152,COGS 14B,A01,083970,Staff,9,0,50,41
1650052683176,COGS 17,A01,092679,Staff,50,0,75,25
1650052689197,COGS 100,A01,083972,Staff,0,17,60,60
1650052701256,COGS 101C,A01,083976,Staff,12,0,30,18
1650052707292,COGS 102A,A01,083978,Johnson; Christine M.,13,0,30,17
1650052713319,COGS 107B,A01,083980,Staff,0,8,50,50
1650052719351,COGS 115,A01,083982,Staff,10,0,30,20
1650052725373,COGS 118B,A01,083367,Staff,0,15,40,40
1650052731396,COGS 172,A01,083984,Provenzano; Emily Kara,15,0,30,15
1650052737419,COGS 177,A00,083368,Staff,0,21,30,30
1650052743445,COGS 186,A01,083986,Staff,21,0,40,19
1650052749472,COGS 187A,A01,083988,Boyle; Mary E. T.,20,0,60,40
1650052755524,CSE 8A,A50,084003,Miranda; Gregory Joseph,0,16,15,15
1650052761558,CSE 11,A01,084005,Miranda; Gregory Joseph,0,22,55,55
1650052767589,CSE 20,A01,084007,Staff,0,5,20,20
1650052773619,CSE 21,A01,084009,Staff,0,32,50,50
1650052779644,CSE 30,A01,083370,Cao; Yingjun,0,65,40,40
1650052785678,CSE 100,A01,083372,Cao; Yingjun,0,46,40,40
1650052791706,CSE 101,A01,084011,Staff,0,54,40,40
1650052797740,CSE 141,A01,083374,Eldon; John,0,65,75,75
1650052803768,CSE 141L,A01,083376,Eldon; John,0,71,75,75
1650052809800,CSE 175,A01,084013,Kumar; Rakesh,22,0,25,3
1650052815824,CSE 190,A00,092508,Dubnov; Shlomo,18,0,20,2
1650052821856,ECE 5,A01,084049,Morris; Karcher William,12,0,20,8
1650052827884,ECE 100,A01,084051,Baghdadchi; Saharnaz,0,0,20,20
1650052827884,ECE 100,A02,091916,Baghdadchi; Saharnaz,12,0,20,8
1650052833925,ECE 101,A01,084053,Baghdadchi; Saharnaz,0,0,37,37
1650052833925,ECE 101,A02,084054,Baghdadchi; Saharnaz,29,0,37,8
1650052839952,ECE 107,A01,083390,Staff,26,0,40,14
1650052845991,ECE 148,A01,084056,Silberman; Jack,8,0,12,4
1650052852026,ECE 180,A00,083391,Abi Samra; Nicholas Camill,25,0,30,5
1650052852026,ECE 180,B00,083392,Abi Samra; Nicholas Camill,21,0,30,9
1650052858054,MATH 10B,A01,084110,Staff,0,0,30,30
1650052858054,MATH 10B,A02,084111,Staff,17,0,30,13
1650052858054,MATH 10B,A03,084112,Staff,24,0,30,6
1650052864092,MATH 10C,A01,083443,Staff,0,17,30,31
1650052864092,MATH 10C,A02,083444,Staff,0,17,30,30
1650052864092,MATH 10C,B01,084114,Staff,18,0,30,12
1650052864092,MATH 10C,B02,084115,Staff,25,0,30,5
1650052870128,MATH 18,A01,084117,Harel; Guershon,12,0,30,18
1650052870128,MATH 18,A02,084119,Harel; Guershon,27,0,30,3
1650052870128,MATH 18,A03,084120,Harel; Guershon,30,0,30,0
1650052870128,MATH 18,A04,084121,Harel; Guershon,29,0,30,1
1650052876156,MATH 20B,A01,084124,Um; Ko Woon,11,0,35,24
1650052876156,MATH 20B,B01,084126,Um; Ko Woon,24,0,35,11
1650052882185,MATH 20C,A01,083446,Hammock; Frances H,0,0,30,30
1650052882185,MATH 20C,A02,083447,Hammock; Frances H,14,0,30,16
1650052882185,MATH 20C,A03,083448,Hammock; Frances H,19,0,30,11
1650052882185,MATH 20C,A04,083449,Hammock; Frances H,20,0,30,10
1650052882185,MATH 20C,B01,083451,Hammock; Frances H,0,0,30,30
1650052882185,MATH 20C,B02,083452,Hammock; Frances H,17,0,30,13
1650052882185,MATH 20C,B03,083453,Hammock; Frances H,20,0,30,10
1650052882185,MATH 20C,B04,083454,Hammock; Frances H,23,0,30,7
1650052888208,MATH 20D,A01,084128,Staff,14,0,30,16
1650052888208,MATH 20D,A02,084129,Staff,29,0,30,1
1650052888208,MATH 20D,A03,084130,Staff,27,0,30,3
1650052888208,MATH 20D,B01,084133,Staff,1,0,30,29
1650052888208,MATH 20D,B02,084134,Staff,23,0,30,7
1650052888208,MATH 20D,B03,084135,Staff,28,0,30,2
1650052894232,MATH 20E,A01,084138,Staff,12,0,30,18
1650052894232,MATH 20E,A02,084139,Staff,6,0,30,24
1650052894232,MATH 20E,A03,084140,Staff,15,0,30,15
1650052894232,MATH 20E,A04,084141,Staff,20,0,30,10
1650052900256,MATH 102,A01,084143,Harel; Guershon,12,0,30,18
1650052900256,MATH 102,A02,084144,Harel; Guershon,19,0,30,11
1650052906280,MATH 103B,A01,083456,Staff,0,13,30,30
1650052906280,MATH 103B,A02,083457,Staff,0,14,30,30
1650052912305,MATH 109,A01,084146,Salehi Golsefidy; Alireza,17,0,30,13
1650052912305,MATH 109,A02,084147,Salehi Golsefidy; Alireza,15,0,30,15
1650052918329,MATH 120A,A01,085445,Eggers; John Dietrich,10,0,35,25
1650052918329,MATH 120A,A02,085446,Eggers; John Dietrich,27,0,35,8
1650052924371,MATH 142B,A01,084149,Verstraete; Jacques Allan,0,12,30,30
1650052924371,MATH 142B,A02,084150,Verstraete; Jacques Allan,0,12,30,30
1650052930410,MATH 170A,A01,083459,Nie; Jiawang,0,9,30,30
1650052930410,MATH 170A,A02,083460,Nie; Jiawang,0,9,30,30
1650052930410,MATH 170A,A03,083461,Nie; Jiawang,0,9,30,30
1650052936439,MATH 193B,A01,083463,Staff,1,0,30,29
1650052936439,MATH 193B,A02,083464,Staff,9,0,30,21
1650052936439,MATH 193B,A03,083465,Staff,18,0,30,12
1650052942497,COGS 2,A01,083966,Boyle; Mary E. T.,10,0,30,20
1650052948523,COGS 9,A01,083968,Staff,7,0,60,53
1650052954568,COGS 14B,A01,083970,Staff,9,0,50,41
1650052960592,COGS 17,A01,092679,Staff,50,0,75,25
1650052966616,COGS 100,A01,083972,Staff,0,17,60,60
1650052978685,COGS 101C,A01,083976,Staff,12,0,30,18
1650052984712,COGS 102A,A01,083978,Johnson; Christine M.,13,0,30,17
1650052990736,COGS 107B,A01,083980,Staff,0,8,50,50
1650052996761,COGS 115,A01,083982,Staff,10,0,30,20
1650053002786,COGS 118B,A01,083367,Staff,0,15,40,40
1650053008819,COGS 172,A01,083984,Provenzano; Emily Kara,15,0,30,15
1650053014844,COGS 177,A00,083368,Staff,0,21,30,30
1650053020874,COGS 186,A01,083986,Staff,21,0,40,19
1650053026896,COGS 187A,A01,083988,Boyle; Mary E. T.,20,0,60,40
1650053032921,CSE 8A,A50,084003,Miranda; Gregory Joseph,0,16,15,15
1650053038947,CSE 11,A01,084005,Miranda; Gregory Joseph,0,22,55,55
1650053044974,CSE 20,A01,084007,Staff,0,5,20,20
1650053051002,CSE 21,A01,084009,Staff,0,32,50,50
1650053057029,CSE 30,A01,083370,Cao; Yingjun,0,65,40,40
1650053063055,CSE 100,A01,083372,Cao; Yingjun,0,46,40,40
1650053069078,CSE 101,A01,084011,Staff,0,54,40,40
1650053075105,CSE 141,A01,083374,Eldon; John,0,65,75,75
1650053081129,CSE 141L,A01,083376,Eldon; John,0,71,75,75
1650053087155,CSE 175,A01,084013,Kumar; Rakesh,22,0,25,3
1650053093179,CSE 190,A00,092508,Dubnov; Shlomo,18,0,20,2
1650053099217,ECE 5,A01,084049,Morris; Karcher William,12,0,20,8
1650053105241,ECE 100,A01,084051,Baghdadchi; Saharnaz,0,0,20,20
1650053105241,ECE 100,A02,091916,Baghdadchi; Saharnaz,12,0,20,8
1650053111267,ECE 101,A01,084053,Baghdadchi; Saharnaz,0,0,37,37
1650053111267,ECE 101,A02,084054,Baghdadchi; Saharnaz,29,0,37,8
1650053117292,ECE 107,A01,083390,Staff,26,0,40,14
1650053123332,ECE 148,A01,084056,Silberman; Jack,8,0,12,4
1650053129488,ECE 180,A00,083391,Abi Samra; Nicholas Camill,25,0,30,5
1650053129488,ECE 180,B00,083392,Abi Samra; Nicholas Camill,21,0,30,9
1650053135513,MATH 10B,A01,084110,Staff,0,0,30,30
1650053135513,MATH 10B,A02,084111,Staff,17,0,30,13
1650053135513,MATH 10B,A03,084112,Staff,24,0,30,6
1650053141544,MATH 10C,A01,083443,Staff,0,17,30,31
1650053141544,MATH 10C,A02,083444,Staff,0,17,30,30
1650053141544,MATH 10C,B01,084114,Staff,18,0,30,12
1650053141544,MATH 10C,B02,084115,Staff,25,0,30,5
1650053147573,MATH 18,A01,084117,Harel; Guershon,12,0,30,18
1650053147573,MATH 18,A02,084119,Harel; Guershon,27,0,30,3
1650053147573,MATH 18,A03,084120,Harel; Guershon,30,0,30,0
1650053147573,MATH 18,A04,084121,Harel; Guershon,29,0,30,1
1650053153606,MATH 20B,A01,084124,Um; Ko Woon,11,0,35,24
1650053153606,MATH 20B,B01,084126,Um; Ko Woon,24,0,35,11
1650053159629,MATH 20C,A01,083446,Hammock; Frances H,0,0,30,30
1650053159629,MATH 20C,A02,083447,Hammock; Frances H,14,0,30,16
1650053159629,MATH 20C,A03,083448,Hammock; Frances H,19,0,30,11
1650053159629,MATH 20C,A04,083449,Hammock; Frances H,20,0,30,10
1650053159629,MATH 20C,B01,083451,Hammock; Frances H,0,0,30,30
1650053159629,MATH 20C,B02,083452,Hammock; Frances H,17,0,30,13
1650053159629,MATH 20C,B03,083453,Hammock; Frances H,20,0,30,10
1650053159629,MATH 20C,B04,083454,Hammock; Frances H,23,0,30,7
1650053165662,MATH 20D,A01,084128,Staff,14,0,30,16
1650053165662,MATH 20D,A02,084129,Staff,29,0,30,1
1650053165662,MATH 20D,A03,084130,Staff,27,0,30,3
1650053165662,MATH 20D,B01,084133,Staff,1,0,30,29
1650053165662,MATH 20D,B02,084134,Staff,23,0,30,7
1650053165662,MATH 20D,B03,084135,Staff,28,0,30,2
1650053171691,MATH 20E,A01,084138,Staff,12,0,30,18
1650053171691,MATH 20E,A02,084139,Staff,6,0,30,24
1650053171691,MATH 20E,A03,084140,Staff,15,0,30,15
1650053171691,MATH 20E,A04,084141,Staff,20,0,30,10
1650053177720,MATH 102,A01,084143,Harel; Guershon,12,0,30,18
1650053177720,MATH 102,A02,084144,Harel; Guershon,19,0,30,11
1650053183743,MATH 103B,A01,083456,Staff,0,13,30,30
1650053183743,MATH 103B,A02,083457,Staff,0,14,30,30
1650053189786,MATH 109,A01,084146,Salehi Golsefidy; Alireza,17,0,30,13
1650053189786,MATH 109,A02,084147,Salehi Golsefidy; Alireza,15,0,30,15
1650053195812,MATH 120A,A01,085445,Eggers; John Dietrich,10,0,35,25
1650053195812,MATH 120A,A02,085446,Eggers; John Dietrich,27,0,35,8
1650053201841,MATH 142B,A01,084149,Verstraete; Jacques Allan,0,12,30,30
1650053201841,MATH 142B,A02,084150,Verstraete; Jacques Allan,0,12,30,30
1650053207869,MATH 170A,A01,083459,Nie; Jiawang,0,9,30,30
1650053207869,MATH 170A,A02,083460,Nie; Jiawang,0,9,30,30
1650053207869,MATH 170A,A03,083461,Nie; Jiawang,0,9,30,30
1650053213905,MATH 193B,A01,083463,Staff,1,0,30,29
1650053213905,MATH 193B,A02,083464,Staff,9,0,30,21
1650053213905,MATH 193B,A03,083465,Staff,17,0,30,13
1650053219962,COGS 2,A01,083966,Boyle; Mary E. T.,10,0,30,20
1650053226000,COGS 9,A01,083968,Staff,7,0,60,53
1650053232025,COGS 14B,A01,083970,Staff,9,0,50,41
1650053238050,COGS 17,A01,092679,Staff,50,0,75,25
1650053244075,COGS 100,A01,083972,Staff,0,17,60,60
1650053256121,COGS 101C,A01,083976,Staff,12,0,30,18
1650053262160,COGS 102A,A01,083978,Johnson; Christine M.,13,0,30,17
1650053268184,COGS 107B,A01,083980,Staff,0,8,50,50
1650053274207,COGS 115,A01,083982,Staff,10,0,30,20
1650053280233,COGS 118B,A01,083367,Staff,0,15,40,40
1650053286261,COGS 172,A01,083984,Provenzano; Emily Kara,15,0,30,15
1650053292290,COGS 177,A00,083368,Staff,0,21,30,30
1650053298321,COGS 186,A01,083986,Staff,21,0,40,19
1650053304345,COGS 187A,A01,083988,Boyle; Mary E. T.,20,0,60,40
1650053310368,CSE 8A,A50,084003,Miranda; Gregory Joseph,0,16,15,15
1650053316394,CSE 11,A01,084005,Miranda; Gregory Joseph,0,22,55,55
1650053322417,CSE 20,A01,084007,Staff,0,5,20,20
1650053328444,CSE 21,A01,084009,Staff,0,33,50,50
1650053334466,CSE 30,A01,083370,Cao; Yingjun,0,65,40,40
1650053340496,CSE 100,A01,083372,Cao; Yingjun,0,46,40,40
1650053346544,CSE 101,A01,084011,Staff,0,54,40,40
1650053352570,CSE 141,A01,083374,Eldon; John,0,65,75,75
1650053358593,CSE 141L,A01,083376,Eldon; John,0,71,75,75
1650053364617,CSE 175,A01,084013,Kumar; Rakesh,22,0,25,3
1650053370640,CSE 190,A00,092508,Dubnov; Shlomo,18,0,20,2
1650053376664,ECE 5,A01,084049,Morris; Karcher William,12,0,20,8
1650053382692,ECE 100,A01,084051,Baghdadchi; Saharnaz,0,0,20,20
1650053382692,ECE 100,A02,091916,Baghdadchi; Saharnaz,12,0,20,8
1650053388721,ECE 101,A01,084053,Baghdadchi; Saharnaz,0,0,37,37
1650053388721,ECE 101,A02,084054,Baghdadchi; Saharnaz,29,0,37,8
1650053394748,ECE 107,A01,083390,Staff,26,0,40,14
1650053400777,ECE 148,A01,084056,Silberman; Jack,8,0,12,4
1650053406819,ECE 180,A00,083391,Abi Samra; Nicholas Camill,25,0,30,5
1650053406819,ECE 180,B00,083392,Abi Samra; Nicholas Camill,21,0,30,9
1650053412847,MATH 10B,A01,084110,Staff,0,0,30,30
1650053412847,MATH 10B,A02,084111,Staff,17,0,30,13
1650053412847,MATH 10B,A03,084112,Staff,24,0,30,6
1650053418877,MATH 10C,A01,083443,Staff,0,17,30,31
1650053418877,MATH 10C,A02,083444,Staff,0,16,30,30
1650053418877,MATH 10C,B01,084114,Staff,18,0,30,12
1650053418877,MATH 10C,B02,084115,Staff,25,0,30,5
1650053424908,MATH 18,A01,084117,Harel; Guershon,12,0,30,18
1650053424908,MATH 18,A02,084119,Harel; Guershon,27,0,30,3
1650053424908,MATH 18,A03,084120,Harel; Guershon,30,0,30,0
1650053424908,MATH 18,A04,084121,Harel; Guershon,29,0,30,1
1650053430933,MATH 20B,A01,084124,Um; Ko Woon,11,0,35,24
1650053430933,MATH 20B,B01,084126,Um; Ko Woon,24,0,35,11
1650053436965,MATH 20C,A01,083446,Hammock; Frances H,0,0,30,30
1650053436965,MATH 20C,A02,083447,Hammock; Frances H,14,0,30,16
1650053436965,MATH 20C,A03,083448,Hammock; Frances H,19,0,30,11
1650053436965,MATH 20C,A04,083449,Hammock; Frances H,20,0,30,10
1650053436965,MATH 20C,B01,083451,Hammock; Frances H,0,0,30,30
1650053436965,MATH 20C,B02,083452,Hammock; Frances H,17,0,30,13
1650053436965,MATH 20C,B03,083453,Hammock; Frances H,20,0,30,10
1650053436965,MATH 20C,B04,083454,Hammock; Frances H,23,0,30,7
1650053442992,MATH 20D,A01,084128,Staff,14,0,30,16
1650053442992,MATH 20D,A02,084129,Staff,29,0,30,1
1650053442992,MATH 20D,A03,084130,Staff,27,0,30,3
1650053442992,MATH 20D,B01,084133,Staff,0,0,30,30
1650053442992,MATH 20D,B02,084134,Staff,23,0,30,7
1650053442992,MATH 20D,B03,084135,Staff,28,0,30,2
1650053449018,MATH 20E,A01,084138,Staff,12,0,30,18
1650053449018,MATH 20E,A02,084139,Staff,6,0,30,24
1650053449018,MATH 20E,A03,084140,Staff,15,0,30,15
1650053449018,MATH 20E,A04,084141,Staff,20,0,30,10
1650053455042,MATH 102,A01,084143,Harel; Guershon,12,0,30,18
1650053455042,MATH 102,A02,084144,Harel; Guershon,19,0,30,11
1650053461074,MATH 103B,A01,083456,Staff,0,13,30,30
1650053461074,MATH 103B,A02,083457,Staff,0,14,30,30
1650053467098,MATH 109,A01,084146,Salehi Golsefidy; Alireza,17,0,30,13
1650053467098,MATH 109,A02,084147,Salehi Golsefidy; Alireza,15,0,30,15
1650053473132,MATH 120A,A01,085445,Eggers; John Dietrich,10,0,35,25
1650053473132,MATH 120A,A02,085446,Eggers; John Dietrich,27,0,35,8
1650053479155,MATH 142B,A01,084149,Verstraete; Jacques Allan,0,12,30,30
1650053479155,MATH 142B,A02,084150,Verstraete; Jacques Allan,0,12,30,30
1650053485198,MATH 170A,A01,083459,Nie; Jiawang,0,9,30,30
1650053485198,MATH 170A,A02,083460,Nie; Jiawang,0,9,30,30
1650053485198,MATH 170A,A03,083461,Nie; Jiawang,0,9,30,30
1650053491221,MATH 193B,A01,083463,Staff,1,0,30,29
1650053491221,MATH 193B,A02,083464,Staff,9,0,30,21
1650053491221,MATH 193B,A03,083465,Staff,17,0,30,13
1650053497280,COGS 2,A01,083966,Boyle; Mary E. T.,10,0,30,20
1650053503304,COGS 9,A01,083968,Staff,7,0,60,53
1650053509327,COGS 14B,A01,083970,Staff,9,0,50,41
1650053515358,COGS 17,A01,092679,Staff,50,0,75,25
1650053521398,COGS 100,A01,083972,Staff,0,17,60,60
1650053533456,COGS 101C,A01,083976,Staff,12,0,30,18
1650053539481,COGS 102A,A01,083978,Johnson; Christine M.,13,0,30,17
1650053545506,COGS 107B,A01,083980,Staff,0,8,50,50
1650053551536,COGS 115,A01,083982,Staff,10,0,30,20
1650053557558,COGS 118B,A01,083367,Staff,0,15,40,40
1650053563590,COGS 172,A01,083984,Provenzano; Emily Kara,15,0,30,15
1650053569624,COGS 177,A00,083368,Staff,0,21,30,30
1650053575651,COGS 186,A01,083986,Staff,21,0,40,19
1650053581674,COGS 187A,A01,083988,Boyle; Mary E. T.,20,0,60,40
1650053587704,CSE 8A,A50,084003,Miranda; Gregory Joseph,0,16,15,15
1650053593741,CSE 11,A01,084005,Miranda; Gregory Joseph,0,22,55,55
1650053599768,CSE 20,A01,084007,Staff,0,5,20,20
1650053605805,CSE 21,A01,084009,Staff,0,33,50,50
1650053611829,CSE 30,A01,083370,Cao; Yingjun,0,65,40,40
1650053617862,CSE 100,A01,083372,Cao; Yingjun,0,46,40,40
1650053623885,CSE 101,A01,084011,Staff,0,54,40,40
1650053629912,CSE 141,A01,083374,Eldon; John,0,65,75,75
1650053635935,CSE 141L,A01,083376,Eldon; John,0,71,75,75
1650053641960,CSE 175,A01,084013,Kumar; Rakesh,22,0,25,3
1650053647993,CSE 190,A00,092508,Dubnov; Shlomo,18,0,20,2
1650053654022,ECE 5,A01,084049,Morris; Karcher William,12,0,20,8
1650053660048,ECE 100,A01,084051,Baghdadchi; Saharnaz,0,0,20,20
1650053660048,ECE 100,A02,091916,Baghdadchi; Saharnaz,12,0,20,8
1650053666072,ECE 101,A01,084053,Baghdadchi; Saharnaz,0,0,37,37
1650053666072,ECE 101,A02,084054,Baghdadchi; Saharnaz,29,0,37,8
1650053672097,ECE 107,A01,083390,Staff,26,0,40,14
1650053678121,ECE 148,A01,084056,Silberman; Jack,8,0,12,4
1650053684159,ECE 180,A00,083391,Abi Samra; Nicholas Camill,25,0,30,5
1650053684159,ECE 180,B00,083392,Abi Samra; Nicholas Camill,21,0,30,9
1650053690187,MATH 10B,A01,084110,Staff,0,0,30,30
1650053690187,MATH 10B,A02,084111,Staff,17,0,30,13
1650053690187,MATH 10B,A03,084112,Staff,24,0,30,6
1650053696212,MATH 10C,A01,083443,Staff,0,17,30,31
1650053696212,MATH 10C,A02,083444,Staff,0,16,30,30
1650053696212,MATH 10C,B01,084114,Staff,18,0,30,12
1650053696212,MATH 10C,B02,084115,Staff,25,0,30,5
1650053702243,MATH 18,A01,084117,Harel; Guershon,12,0,30,18
1650053702243,MATH 18,A02,084119,Harel; Guershon,27,0,30,3
1650053702243,MATH 18,A03,084120,Harel; Guershon,30,0,30,0
1650053702243,MATH 18,A04,084121,Harel; Guershon,29,0,30,1
1650053708272,MATH 20B,A01,084124,Um; Ko Woon,11,0,35,24
1650053708272,MATH 20B,B01,084126,Um; Ko Woon,24,0,35,11
1650053714307,MATH 20C,A01,083446,Hammock; Frances H,0,0,30,30
1650053714307,MATH 20C,A02,083447,Hammock; Frances H,14,0,30,16
1650053714307,MATH 20C,A03,083448,Hammock; Frances H,19,0,30,11
1650053714307,MATH 20C,A04,083449,Hammock; Frances H,20,0,30,10
1650053714307,MATH 20C,B01,083451,Hammock; Frances H,0,0,30,30
1650053714307,MATH 20C,B02,083452,Hammock; Frances H,17,0,30,13
1650053714307,MATH 20C,B03,083453,Hammock; Frances H,20,0,30,10
1650053714307,MATH 20C,B04,083454,Hammock; Frances H,23,0,30,7
1650053720339,MATH 20D,A01,084128,Staff,14,0,30,16
1650053720339,MATH 20D,A02,084129,Staff,29,0,30,1
1650053720339,MATH 20D,A03,084130,Staff,27,0,30,3
1650053720339,MATH 20D,B01,084133,Staff,0,0,30,30
1650053720339,MATH 20D,B02,084134,Staff,23,0,30,7
1650053720339,MATH 20D,B03,084135,Staff,28,0,30,2
1650053726470,MATH 20E,A01,084138,Staff,12,0,30,18
1650053726470,MATH 20E,A02,084139,Staff,6,0,30,24
1650053726470,MATH 20E,A03,084140,Staff,15,0,30,15
1650053726470,MATH 20E,A04,084141,Staff,20,0,30,10
1650053732494,MATH 102,A01,084143,Harel; Guershon,12,0,30,18
1650053732494,MATH 102,A02,084144,Harel; Guershon,19,0,30,11
1650053738520,MATH 103B,A01,083456,Staff,0,13,30,30
1650053738520,MATH 103B,A02,083457,Staff,0,14,30,30
1650053744543,MATH 109,A01,084146,Salehi Golsefidy; Alireza,17,0,30,13
1650053744543,MATH 109,A02,084147,Salehi Golsefidy; Alireza,15,0,30,15
1650053750577,MATH 120A,A01,085445,Eggers; John Dietrich,10,0,35,25
1650053750577,MATH 120A,A02,085446,Eggers; John Dietrich,27,0,35,8
1650053756613,MATH 142B,A01,084149,Verstraete; Jacques Allan,0,12,30,30
1650053756613,MATH 142B,A02,084150,Verstraete; Jacques Allan,0,12,30,30
1650053762650,MATH 170A,A01,083459,Nie; Jiawang,0,9,30,30
1650053762650,MATH 170A,A02,083460,Nie; Jiawang,0,9,30,30
1650053762650,MATH 170A,A03,083461,Nie; Jiawang,0,9,30,30
1650053768683,MATH 193B,A01,083463,Staff,1,0,30,29
1650053768683,MATH 193B,A02,083464,Staff,9,0,30,21
1650053768683,MATH 193B,A03,083465,Staff,17,0,30,13
1650053774746,COGS 2,A01,083966,Boyle; Mary E. T.,10,0,30,20
1650053780769,COGS 9,A01,083968,Staff,7,0,60,53
1650053786793,COGS 14B,A01,083970,Staff,9,0,50,41
1650053792821,COGS 17,A01,092679,Staff,50,0,75,25
1650053798843,COGS 100,A01,083972,Staff,0,17,60,60
1650053810893,COGS 101C,A01,083976,Staff,12,0,30,18
1650053816919,COGS 102A,A01,083978,Johnson; Christine M.,13,0,30,17
1650053822946,COGS 107B,A01,083980,Staff,0,8,50,50
1650053828970,COGS 115,A01,083982,Staff,10,0,30,20
1650053834994,COGS 118B,A01,083367,Staff,0,15,40,40
1650053841031,COGS 172,A01,083984,Provenzano; Emily Kara,15,0,30,15
1650053847085,COGS 177,A00,083368,Staff,0,21,30,30
1650053853110,COGS 186,A01,083986,Staff,21,0,40,19
1650053859137,COGS 187A,A01,083988,Boyle; Mary E. T.,20,0,60,40
1650053865160,CSE 8A,A50,084003,Miranda; Gregory Joseph,0,16,15,15
1650053871195,CSE 11,A01,084005,Miranda; Gregory Joseph,0,22,55,55
1650053877226,CSE 20,A01,084007,Staff,0,5,20,20
1650053883253,CSE 21,A01,084009,Staff,0,33,50,50
1650053889285,CSE 30,A01,083370,Cao; Yingjun,0,65,40,40
1650053895321,CSE 100,A01,083372,Cao; Yingjun,0,47,40,40
1650053901345,CSE 101,A01,084011,Staff,0,54,40,40
1650053907367,CSE 141,A01,083374,Eldon; John,0,65,75,75
1650053913398,CSE 141L,A01,083376,Eldon; John,0,71,75,75
1650053919426,CSE 175,A01,084013,Kumar; Rakesh,22,0,25,3
1650053925460,CSE 190,A00,092508,Dubnov; Shlomo,18,0,20,2
1650053931483,ECE 5,A01,084049,Morris; Karcher William,12,0,20,8
1650053937512,ECE 100,A01,084051,Baghdadchi; Saharnaz,0,0,20,20
1650053937512,ECE 100,A02,091916,Baghdadchi; Saharnaz,12,0,20,8
1650053943564,ECE 101,A01,084053,Baghdadchi; Saharnaz,0,0,37,37
1650053943564,ECE 101,A02,084054,Baghdadchi; Saharnaz,29,0,37,8
1650053949592,ECE 107,A01,083390,Staff,26,0,40,14
1650053955619,ECE 148,A01,084056,Silberman; Jack,8,0,12,4
1650053961657,ECE 180,A00,083391,Abi Samra; Nicholas Camill,25,0,30,5
1650053961657,ECE 180,B00,083392,Abi Samra; Nicholas Camill,21,0,30,9
1650053967690,MATH 10B,A01,084110,Staff,0,0,30,30
1650053967690,MATH 10B,A02,084111,Staff,17,0,30,13
1650053967690,MATH 10B,A03,084112,Staff,24,0,30,6
1650053973729,MATH 10C,A01,083443,Staff,0,17,30,31
1650053973729,MATH 10C,A02,083444,Staff,0,16,30,30
1650053973729,MATH 10C,B01,084114,Staff,18,0,30,12
1650053973729,MATH 10C,B02,084115,Staff,25,0,30,5
1650053979758,MATH 18,A01,084117,Harel; Guershon,12,0,30,18
1650053979758,MATH 18,A02,084119,Harel; Guershon,27,0,30,3
1650053979758,MATH 18,A03,084120,Harel; Guershon,30,0,30,0
1650053979758,MATH 18,A04,084121,Harel; Guershon,29,0,30,1
1650053985793,MATH 20B,A01,084124,Um; Ko Woon,11,0,35,24
1650053985793,MATH 20B,B01,084126,Um; Ko Woon,24,0,35,11
1650053991819,MATH 20C,A01,083446,Hammock; Frances H,0,0,30,30
1650053991819,MATH 20C,A02,083447,Hammock; Frances H,14,0,30,16
1650053991819,MATH 20C,A03,083448,Hammock; Frances H,19,0,30,11
1650053991819,MATH 20C,A04,083449,Hammock; Frances H,20,0,30,10
1650053991819,MATH 20C,B01,083451,Hammock; Frances H,0,0,30,30
1650053991819,MATH 20C,B02,083452,Hammock; Frances H,17,0,30,13
1650053991819,MATH 20C,B03,083453,Hammock; Frances H,20,0,30,10
1650053991819,MATH 20C,B04,083454,Hammock; Frances H,23,0,30,7
1650053997847,MATH 20D,A01,084128,Staff,14,0,30,16
1650053997847,MATH 20D,A02,084129,Staff,29,0,30,1
1650053997847,MATH 20D,A03,084130,Staff,27,0,30,3
1650053997847,MATH 20D,B01,084133,Staff,0,0,30,30
1650053997847,MATH 20D,B02,084134,Staff,23,0,30,7
1650053997847,MATH 20D,B03,084135,Staff,28,0,30,2
1650054003871,MATH 20E,A01,084138,Staff,12,0,30,18
1650054003871,MATH 20E,A02,084139,Staff,6,0,30,24
1650054003871,MATH 20E,A03,084140,Staff,15,0,30,15
1650054003871,MATH 20E,A04,084141,Staff,20,0,30,10
1650054009896,MATH 102,A01,084143,Harel; Guershon,12,0,30,18
1650054009896,MATH 102,A02,084144,Harel; Guershon,19,0,30,11
1650054015925,MATH 103B,A01,083456,Staff,0,13,30,30
1650054015925,MATH 103B,A02,083457,Staff,0,14,30,30
1650054021954,MATH 109,A01,084146,Salehi Golsefidy; Alireza,17,0,30,13
1650054021954,MATH 109,A02,084147,Salehi Golsefidy; Alireza,15,0,30,15
1650054027981,MATH 120A,A01,085445,Eggers; John Dietrich,10,0,35,25
1650054027981,MATH 120A,A02,085446,Eggers; John Dietrich,27,0,35,8
1650054034003,MATH 142B,A01,084149,Verstraete; Jacques Allan,0,12,30,30
1650054034003,MATH 142B,A02,084150,Verstraete; Jacques Allan,0,12,30,30
1650054040027,MATH 170A,A01,083459,Nie; Jiawang,0,9,30,30
1650054040027,MATH 170A,A02,083460,Nie; Jiawang,0,9,30,30
1650054040027,MATH 170A,A03,083461,Nie; Jiawang,0,9,30,30
1650054046056,MATH 193B,A01,083463,Staff,1,0,30,29
1650054046056,MATH 193B,A02,083464,Staff,9,0,30,21
1650054046056,MATH 193B,A03,083465,Staff,17,0,30,13
1650054052121,COGS 2,A01,083966,Boyle; Mary E. T.,10,0,30,20
1650054058148,COGS 9,A01,083968,Staff,7,0,60,53
1650054064175,COGS 14B,A01,083970,Staff,9,0,50,41
1650054070200,COGS 17,A01,092679,Staff,50,0,75,25
1650054076224,COGS 100,A01,083972,Staff,0,17,60,60
1650054088275,COGS 101C,A01,083976,Staff,12,0,30,18
1650054094303,COGS 102A,A01,083978,Johnson; Christine M.,13,0,30,17
1650054100341,COGS 107B,A01,083980,Staff,0,8,50,50
1650054106372,COGS 115,A01,083982,Staff,10,0,30,20
1650054112403,COGS 118B,A01,083367,Staff,0,15,40,40
1650054118431,COGS 172,A01,083984,Provenzano; Emily Kara,15,0,30,15
1650054124456,COGS 177,A00,083368,Staff,0,21,30,30
1650054130497,COGS 186,A01,083986,Staff,21,0,40,19
1650054136523,COGS 187A,A01,083988,Boyle; Mary E. T.,20,0,60,40
1650054142548,CSE 8A,A50,084003,Miranda; Gregory Joseph,0,17,15,15
1650054148577,CSE 11,A01,084005,Miranda; Gregory Joseph,0,22,55,55
1650054154604,CSE 20,A01,084007,Staff,0,5,20,20
1650054160634,CSE 21,A01,084009,Staff,0,33,50,50
1650054166661,CSE 30,A01,083370,Cao; Yingjun,0,65,40,40
1650054172687,CSE 100,A01,083372,Cao; Yingjun,0,47,40,40
1650054178717,CSE 101,A01,084011,Staff,0,54,40,40
1650054184742,CSE 141,A01,083374,Eldon; John,0,65,75,75
1650054190769,CSE 141L,A01,083376,Eldon; John,0,71,75,75
1650054196792,CSE 175,A01,084013,Kumar; Rakesh,22,0,25,3
1650054202819,CSE 190,A00,092508,Dubnov; Shlomo,18,0,20,2
1650054208844,ECE 5,A01,084049,Morris; Karcher William,12,0,20,8
1650054214868,ECE 100,A01,084051,Baghdadchi; Saharnaz,0,0,20,20
1650054214868,ECE 100,A02,091916,Baghdadchi; Saharnaz,12,0,20,8
1650054220891,ECE 101,A01,084053,Baghdadchi; Saharnaz,0,0,37,37
1650054220891,ECE 101,A02,084054,Baghdadchi; Saharnaz,29,0,37,8
1650054226918,ECE 107,A01,083390,Staff,26,0,40,14
1650054232961,ECE 148,A01,084056,Silberman; Jack,8,0,12,4
1650054238985,ECE 180,A00,083391,Abi Samra; Nicholas Camill,25,0,30,5
1650054238985,ECE 180,B00,083392,Abi Samra; Nicholas Camill,21,0,30,9
1650054245007,MATH 10B,A01,084110,Staff,0,0,30,30
1650054245007,MATH 10B,A02,084111,Staff,17,0,30,13
1650054245007,MATH 10B,A03,084112,Staff,24,0,30,6
1650054251035,MATH 10C,A01,083443,Staff,0,17,30,31
1650054251035,MATH 10C,A02,083444,Staff,0,16,30,30
1650054251035,MATH 10C,B01,084114,Staff,18,0,30,12
1650054251035,MATH 10C,B02,084115,Staff,25,0,30,5
1650054257060,MATH 18,A01,084117,Harel; Guershon,12,0,30,18
1650054257060,MATH 18,A02,084119,Harel; Guershon,27,0,30,3
1650054257060,MATH 18,A03,084120,Harel; Guershon,30,0,30,0
1650054257060,MATH 18,A04,084121,Harel; Guershon,29,0,30,1
1650054263090,MATH 20B,A01,084124,Um; Ko Woon,11,0,35,24
1650054263090,MATH 20B,B01,084126,Um; Ko Woon,24,0,35,11
1650054269116,MATH 20C,A01,083446,Hammock; Frances H,0,0,30,30
1650054269116,MATH 20C,A02,083447,Hammock; Frances H,14,0,30,16
1650054269116,MATH 20C,A03,083448,Hammock; Frances H,19,0,30,11
1650054269116,MATH 20C,A04,083449,Hammock; Frances H,20,0,30,10
1650054269116,MATH 20C,B01,083451,Hammock; Frances H,0,0,30,30
1650054269116,MATH 20C,B02,083452,Hammock; Frances H,17,0,30,13
1650054269116,MATH 20C,B03,083453,Hammock; Frances H,20,0,30,10
1650054269116,MATH 20C,B04,083454,Hammock; Frances H,23,0,30,7
1650054275139,MATH 20D,A01,084128,Staff,14,0,30,16
1650054275139,MATH 20D,A02,084129,Staff,29,0,30,1
1650054275139,MATH 20D,A03,084130,Staff,27,0,30,3
1650054275139,MATH 20D,B01,084133,Staff,0,0,30,30
1650054275139,MATH 20D,B02,084134,Staff,23,0,30,7
1650054275139,MATH 20D,B03,084135,Staff,28,0,30,2
1650054281165,MATH 20E,A01,084138,Staff,12,0,30,18
1650054281165,MATH 20E,A02,084139,Staff,6,0,30,24
1650054281165,MATH 20E,A03,084140,Staff,15,0,30,15
1650054281165,MATH 20E,A04,084141,Staff,20,0,30,10
1650054287189,MATH 102,A01,084143,Harel; Guershon,12,0,30,18
1650054287189,MATH 102,A02,084144,Harel; Guershon,19,0,30,11
1650054293213,MATH 103B,A01,083456,Staff,0,13,30,30
1650054293213,MATH 103B,A02,083457,Staff,0,14,30,30
1650054299237,MATH 109,A01,084146,Salehi Golsefidy; Alireza,17,0,30,13
1650054299237,MATH 109,A02,084147,Salehi Golsefidy; Alireza,15,0,30,15
1650054305261,MATH 120A,A01,085445,Eggers; John Dietrich,10,0,35,25
1650054305261,MATH 120A,A02,085446,Eggers; John Dietrich,27,0,35,8
1650054311285,MATH 142B,A01,084149,Verstraete; Jacques Allan,0,12,30,30
1650054311285,MATH 142B,A02,084150,Verstraete; Jacques Allan,0,12,30,30
1650054317316,MATH 170A,A01,083459,Nie; Jiawang,0,9,30,30
1650054317316,MATH 170A,A02,083460,Nie; Jiawang,0,9,30,30
1650054317316,MATH 170A,A03,083461,Nie; Jiawang,0,9,30,30
1650054323431,MATH 193B,A01,083463,Staff,1,0,30,29
1650054323431,MATH 193B,A02,083464,Staff,9,0,30,21
1650054323431,MATH 193B,A03,083465,Staff,17,0,30,13
1650054329488,COGS 2,A01,083966,Boyle; Mary E. T.,10,0,30,20
1650054335513,COGS 9,A01,083968,Staff,7,0,60,53
1650054341536,COGS 14B,A01,083970,Staff,9,0,50,41
1650054347559,COGS 17,A01,092679,Staff,50,0,75,25
1650054353586,COGS 100,A01,083972,Staff,0,17,60,60
1650054365633,COGS 101C,A01,083976,Staff,12,0,30,18
1650054371659,COGS 102A,A01,083978,Johnson; Christine M.,13,0,30,17
1650054377683,COGS 107B,A01,083980,Staff,0,8,50,50
1650054383706,COGS 115,A01,083982,Staff,10,0,30,20
1650054389729,COGS 118B,A01,083367,Staff,0,15,40,40
1650054395752,COGS 172,A01,083984,Provenzano; Emily Kara,15,0,30,15
1650054401778,COGS 177,A00,083368,Staff,0,21,30,30
1650054407817,COGS 186,A01,083986,Staff,21,0,40,19
1650054413852,COGS 187A,A01,083988,Boyle; Mary E. T.,20,0,60,40
1650054419875,CSE 8A,A50,084003,Miranda; Gregory Joseph,0,17,15,15
1650054425901,CSE 11,A01,084005,Miranda; Gregory Joseph,0,22,55,55
1650054431933,CSE 20,A01,084007,Staff,0,5,20,20
1650054437955,CSE 21,A01,084009,Staff,0,33,50,50
1650054443983,CSE 30,A01,083370,Cao; Yingjun,0,65,40,40
1650054450007,CSE 100,A01,083372,Cao; Yingjun,0,47,40,40
1650054456031,CSE 101,A01,084011,Staff,0,54,40,40
1650054462055,CSE 141,A01,083374,Eldon; John,0,65,75,75
1650054468078,CSE 141L,A01,083376,Eldon; John,0,71,75,75
1650054474103,CSE 175,A01,084013,Kumar; Rakesh,22,0,25,3
1650054480125,CSE 190,A00,092508,Dubnov; Shlomo,18,0,20,2
1650054486148,ECE 5,A01,084049,Morris; Karcher William,12,0,20,8
1650054492170,ECE 100,A01,084051,Baghdadchi; Saharnaz,0,0,20,20
1650054492170,ECE 100,A02,091916,Baghdadchi; Saharnaz,12,0,20,8
1650054498193,ECE 101,A01,084053,Baghdadchi; Saharnaz,0,0,37,37
1650054498193,ECE 101,A02,084054,Baghdadchi; Saharnaz,29,0,37,8
1650054504218,ECE 107,A01,083390,Staff,26,0,40,14
1650054510242,ECE 148,A01,084056,Silberman; Jack,8,0,12,4
1650054516267,ECE 180,A00,083391,Abi Samra; Nicholas Camill,25,0,30,5
1650054516267,ECE 180,B00,083392,Abi Samra; Nicholas Camill,21,0,30,9
1650054522289,MATH 10B,A01,084110,Staff,0,0,30,30
1650054522289,MATH 10B,A02,084111,Staff,17,0,30,13
1650054522289,MATH 10B,A03,084112,Staff,23,0,30,7
1650054528314,MATH 10C,A01,083443,Staff,0,17,30,31
1650054528314,MATH 10C,A02,083444,Staff,0,16,30,30
1650054528314,MATH 10C,B01,084114,Staff,18,0,30,12
1650054528314,MATH 10C,B02,084115,Staff,25,0,30,5
1650054534341,MATH 18,A01,084117,Harel; Guershon,12,0,30,18
1650054534341,MATH 18,A02,084119,Harel; Guershon,27,0,30,3
1650054534341,MATH 18,A03,084120,Harel; Guershon,30,0,30,0
1650054534341,MATH 18,A04,084121,Harel; Guershon,29,0,30,1
1650054540365,MATH 20B,A01,084124,Um; Ko Woon,11,0,35,24
1650054540365,MATH 20B,B01,084126,Um; Ko Woon,24,0,35,11
1650054546396,MATH 20C,A01,083446,Hammock; Frances H,0,0,30,30
1650054546396,MATH 20C,A02,083447,Hammock; Frances H,14,0,30,16
1650054546396,MATH 20C,A03,083448,Hammock; Frances H,19,0,30,11
1650054546396,MATH 20C,A04,083449,Hammock; Frances H,20,0,30,10
1650054546396,MATH 20C,B01,083451,Hammock; Frances H,0,0,30,30
1650054546396,MATH 20C,B02,083452,Hammock; Frances H,17,0,30,13
1650054546396,MATH 20C,B03,083453,Hammock; Frances H,20,0,30,10
1650054546396,MATH 20C,B04,083454,Hammock; Frances H,23,0,30,7
1650054552421,MATH 20D,A01,084128,Staff,14,0,30,16
1650054552421,MATH 20D,A02,084129,Staff,29,0,30,1
1650054552421,MATH 20D,A03,084130,Staff,27,0,30,3
1650054552421,MATH 20D,B01,084133,Staff,0,0,30,30
1650054552421,MATH 20D,B02,084134,Staff,23,0,30,7
1650054552421,MATH 20D,B03,084135,Staff,28,0,30,2
1650054558445,MATH 20E,A01,084138,Staff,12,0,30,18
1650054558445,MATH 20E,A02,084139,Staff,6,0,30,24
1650054558445,MATH 20E,A03,084140,Staff,15,0,30,15
1650054558445,MATH 20E,A04,084141,Staff,20,0,30,10
1650054564472,MATH 102,A01,084143,Harel; Guershon,12,0,30,18
1650054564472,MATH 102,A02,084144,Harel; Guershon,19,0,30,11
1650054570501,MATH 103B,A01,083456,Staff,0,13,30,30
1650054570501,MATH 103B,A02,083457,Staff,0,14,30,30
1650054576529,MATH 109,A01,084146,Salehi Golsefidy; Alireza,17,0,30,13
1650054576529,MATH 109,A02,084147,Salehi Golsefidy; Alireza,15,0,30,15
1650054582552,MATH 120A,A01,085445,Eggers; John Dietrich,10,0,35,25
1650054582552,MATH 120A,A02,085446,Eggers; John Dietrich,27,0,35,8
1650054588575,MATH 142B,A01,084149,Verstraete; Jacques Allan,0,12,30,30
1650054588575,MATH 142B,A02,084150,Verstraete; Jacques Allan,0,12,30,30
1650054594600,MATH 170A,A01,083459,Nie; Jiawang,0,10,30,30
1650054594600,MATH 170A,A02,083460,Nie; Jiawang,0,9,30,30
1650054594600,MATH 170A,A03,083461,Nie; Jiawang,0,9,30,30
1650054600626,MATH 193B,A01,083463,Staff,1,0,30,29
1650054600626,MATH 193B,A02,083464,Staff,9,0,30,21
1650054600626,MATH 193B,A03,083465,Staff,17,0,30,13
1650054606703,COGS 2,A01,083966,Boyle; Mary E. T.,10,0,30,20
1650054612732,COGS 9,A01,083968,Staff,7,0,60,53
1650054618763,COGS 14B,A01,083970,Staff,9,0,50,41
1650054624787,COGS 17,A01,092679,Staff,50,0,75,25
1650054630810,COGS 100,A01,083972,Staff,0,17,60,60
1650054642877,COGS 101C,A01,083976,Staff,12,0,30,18
1650054648910,COGS 102A,A01,083978,Johnson; Christine M.,13,0,30,17
1650054654932,COGS 107B,A01,083980,Staff,0,8,50,50
1650054660956,COGS 115,A01,083982,Staff,10,0,30,20
1650054666984,COGS 118B,A01,083367,Staff,0,15,40,40
1650054673010,COGS 172,A01,083984,Provenzano; Emily Kara,15,0,30,15
1650054679043,COGS 177,A00,083368,Staff,0,21,30,30
1650054685067,COGS 186,A01,083986,Staff,21,0,40,19
1650054691091,COGS 187A,A01,083988,Boyle; Mary E. T.,20,0,60,40
1650054697118,CSE 8A,A50,084003,Miranda; Gregory Joseph,0,17,15,15
1650054703147,CSE 11,A01,084005,Miranda; Gregory Joseph,0,22,55,55
1650054709170,CSE 20,A01,084007,Staff,0,5,20,20
1650054715197,CSE 21,A01,084009,Staff,0,33,50,50
1650054721221,CSE 30,A01,083370,Cao; Yingjun,0,65,40,40
1650054727249,CSE 100,A01,083372,Cao; Yingjun,0,47,40,40
1650054733271,CSE 101,A01,084011,Staff,0,55,40,40
1650054739297,CSE 141,A01,083374,Eldon; John,0,65,75,75
1650054745333,CSE 141L,A01,083376,Eldon; John,0,71,75,75
1650054751358,CSE 175,A01,084013,Kumar; Rakesh,22,0,25,3
1650054757384,CSE 190,A00,092508,Dubnov; Shlomo,18,0,20,2
1650054763409,ECE 5,A01,084049,Morris; Karcher William,12,0,20,8
1650054769435,ECE 100,A01,084051,Baghdadchi; Saharnaz,0,0,20,20
1650054769435,ECE 100,A02,091916,Baghdadchi; Saharnaz,12,0,20,8
1650054775459,ECE 101,A01,084053,Baghdadchi; Saharnaz,0,0,37,37
1650054775459,ECE 101,A02,084054,Baghdadchi; Saharnaz,29,0,37,8
1650054781483,ECE 107,A01,083390,Staff,26,0,40,14
1650054787511,ECE 148,A01,084056,Silberman; Jack,8,0,12,4
1650054793535,ECE 180,A00,083391,Abi Samra; Nicholas Camill,25,0,30,5
1650054793535,ECE 180,B00,083392,Abi Samra; Nicholas Camill,21,0,30,9
1650054799558,MATH 10B,A01,084110,Staff,0,0,30,30
1650054799558,MATH 10B,A02,084111,Staff,17,0,30,13
1650054799558,MATH 10B,A03,084112,Staff,23,0,30,7
1650054805584,MATH 10C,A01,083443,Staff,0,17,30,31
1650054805584,MATH 10C,A02,083444,Staff,0,16,30,30
1650054805584,MATH 10C,B01,084114,Staff,18,0,30,12
1650054805584,MATH 10C,B02,084115,Staff,25,0,30,5
1650054811609,MATH 18,A01,084117,Harel; Guershon,12,0,30,18
1650054811609,MATH 18,A02,084119,Harel; Guershon,27,0,30,3
1650054811609,MATH 18,A03,084120,Harel; Guershon,30,0,30,0
1650054811609,MATH 18,A04,084121,Harel; Guershon,29,0,30,1
1650054817637,MATH 20B,A01,084124,Um; Ko Woon,11,0,35,24
1650054817637,MATH 20B,B01,084126,Um; Ko Woon,24,0,35,11
1650054823662,MATH 20C,A01,083446,Hammock; Frances H,0,0,30,30
1650054823662,MATH 20C,A02,083447,Hammock; Frances H,14,0,30,16
1650054823662,MATH 20C,A03,083448,Hammock; Frances H,19,0,30,11
1650054823662,MATH 20C,A04,083449,Hammock; Frances H,20,0,30,10
1650054823662,MATH 20C,B01,083451,Hammock; Frances H,0,0,30,30
1650054823662,MATH 20C,B02,083452,Hammock; Frances H,17,0,30,13
1650054823662,MATH 20C,B03,083453,Hammock; Frances H,20,0,30,10
1650054823662,MATH 20C,B04,083454,Hammock; Frances H,23,0,30,7
1650054829690,MATH 20D,A01,084128,Staff,13,0,30,17
1650054829690,MATH 20D,A02,084129,Staff,29,0,30,1
1650054829690,MATH 20D,A03,084130,Staff,27,0,30,3
1650054829690,MATH 20D,B01,084133,Staff,0,0,30,30
1650054829690,MATH 20D,B02,084134,Staff,23,0,30,7
1650054829690,MATH 20D,B03,084135,Staff,28,0,30,2
1650054835715,MATH 20E,A01,084138,Staff,12,0,30,18
1650054835715,MATH 20E,A02,084139,Staff,6,0,30,24
1650054835715,MATH 20E,A03,084140,Staff,15,0,30,15
1650054835715,MATH 20E,A04,084141,Staff,20,0,30,10
1650054841738,MATH 102,A01,084143,Harel; Guershon,12,0,30,18
1650054841738,MATH 102,A02,084144,Harel; Guershon,19,0,30,11
1650054847764,MATH 103B,A01,083456,Staff,0,13,30,30
1650054847764,MATH 103B,A02,083457,Staff,0,14,30,30
1650054853793,MATH 109,A01,084146,Salehi Golsefidy; Alireza,17,0,30,13
1650054853793,MATH 109,A02,084147,Salehi Golsefidy; Alireza,15,0,30,15
1650054859838,MATH 120A,A01,085445,Eggers; John Dietrich,10,0,35,25
1650054859838,MATH 120A,A02,085446,Eggers; John Dietrich,27,0,35,8
1650054865861,MATH 142B,A01,084149,Verstraete; Jacques Allan,0,12,30,30
1650054865861,MATH 142B,A02,084150,Verstraete; Jacques Allan,0,12,30,30
1650054871885,MATH 170A,A01,083459,Nie; Jiawang,0,10,30,30
1650054871885,MATH 170A,A02,083460,Nie; Jiawang,0,9,30,30
1650054871885,MATH 170A,A03,083461,Nie; Jiawang,0,9,30,30
1650054877912,MATH 193B,A01,083463,Staff,1,0,30,29
1650054877912,MATH 193B,A02,083464,Staff,9,0,30,21
1650054877912,MATH 193B,A03,083465,Staff,17,0,30,13
1650054883969,COGS 2,A01,083966,Boyle; Mary E. T.,10,0,30,20
1650054889992,COGS 9,A01,083968,Staff,7,0,60,53
1650054896022,COGS 14B,A01,083970,Staff,9,0,50,41
1650054902050,COGS 17,A01,092679,Staff,50,0,75,25
1650054908075,COGS 100,A01,083972,Staff,0,17,60,60
1650054920231,COGS 101C,A01,083976,Staff,12,0,30,18
1650054926263,COGS 102A,A01,083978,Johnson; Christine M.,13,0,30,17
1650054932286,COGS 107B,A01,083980,Staff,0,8,50,50
1650054938311,COGS 115,A01,083982,Staff,10,0,30,20
1650054944343,COGS 118B,A01,083367,Staff,0,15,40,40
1650054950368,COGS 172,A01,083984,Provenzano; Emily Kara,15,0,30,15
1650054956404,COGS 177,A00,083368,Staff,0,21,30,30
1650054962429,COGS 186,A01,083986,Staff,21,0,40,19
1650054968453,COGS 187A,A01,083988,Boyle; Mary E. T.,20,0,60,40
1650054974486,CSE 8A,A50,084003,Miranda; Gregory Joseph,0,17,15,15
1650054980510,CSE 11,A01,084005,Miranda; Gregory Joseph,0,22,55,55
1650054986540,CSE 20,A01,084007,Staff,0,5,20,20
1650054992566,CSE 21,A01,084009,Staff,0,33,50,50
1650054998588,CSE 30,A01,083370,Cao; Yingjun,0,65,40,40
1650055004620,CSE 100,A01,083372,Cao; Yingjun,0,47,40,40
1650055010648,CSE 101,A01,084011,Staff,0,55,40,40
1650055016677,CSE 141,A01,083374,Eldon; John,0,65,75,75
1650055022703,CSE 141L,A01,083376,Eldon; John,0,71,75,75
1650055028726,CSE 175,A01,084013,Kumar; Rakesh,22,0,25,3
1650055034758,CSE 190,A00,092508,Dubnov; Shlomo,18,0,20,2
1650055040782,ECE 5,A01,084049,Morris; Karcher William,12,0,20,8
1650055046804,ECE 100,A01,084051,Baghdadchi; Saharnaz,0,0,20,20
1650055046804,ECE 100,A02,091916,Baghdadchi; Saharnaz,12,0,20,8
1650055052828,ECE 101,A01,084053,Baghdadchi; Saharnaz,0,0,37,37
1650055052828,ECE 101,A02,084054,Baghdadchi; Saharnaz,29,0,37,8
1650055058859,ECE 107,A01,083390,Staff,26,0,40,14
1650055064886,ECE 148,A01,084056,Silberman; Jack,8,0,12,4
1650055070918,ECE 180,A00,083391,Abi Samra; Nicholas Camill,25,0,30,5
1650055070918,ECE 180,B00,083392,Abi Samra; Nicholas Camill,21,0,30,9
1650055076946,MATH 10B,A01,084110,Staff,0,0,30,30
1650055076946,MATH 10B,A02,084111,Staff,17,0,30,13
1650055076946,MATH 10B,A03,084112,Staff,23,0,30,7
1650055082970,MATH 10C,A01,083443,Staff,0,17,30,31
1650055082970,MATH 10C,A02,083444,Staff,0,17,30,30
1650055082970,MATH 10C,B01,084114,Staff,18,0,30,12
1650055082970,MATH 10C,B02,084115,Staff,25,0,30,5
1650055089001,MATH 18,A01,084117,Harel; Guershon,12,0,30,18
1650055089001,MATH 18,A02,084119,Harel; Guershon,27,0,30,3
1650055089001,MATH 18,A03,084120,Harel; Guershon,30,0,30,0
1650055089001,MATH 18,A04,084121,Harel; Guershon,29,0,30,1
1650055095025,MATH 20B,A01,084124,Um; Ko Woon,11,0,35,24
1650055095025,MATH 20B,B01,084126,Um; Ko Woon,24,0,35,11
1650055101054,MATH 20C,A01,083446,Hammock; Frances H,0,0,30,30
1650055101054,MATH 20C,A02,083447,Hammock; Frances H,14,0,30,16
1650055101054,MATH 20C,A03,083448,Hammock; Frances H,19,0,30,11
1650055101054,MATH 20C,A04,083449,Hammock; Frances H,20,0,30,10
1650055101054,MATH 20C,B01,083451,Hammock; Frances H,0,0,30,30
1650055101054,MATH 20C,B02,083452,Hammock; Frances H,17,0,30,13
1650055101054,MATH 20C,B03,083453,Hammock; Frances H,20,0,30,10
1650055101054,MATH 20C,B04,083454,Hammock; Frances H,23,0,30,7
1650055107086,MATH 20D,A01,084128,Staff,14,0,30,16
1650055107086,MATH 20D,A02,084129,Staff,29,0,30,1
1650055107086,MATH 20D,A03,084130,Staff,27,0,30,3
1650055107086,MATH 20D,B01,084133,Staff,0,0,30,30
1650055107086,MATH 20D,B02,084134,Staff,23,0,30,7
1650055107086,MATH 20D,B03,084135,Staff,28,0,30,2
1650055113109,MATH 20E,A01,084138,Staff,12,0,30,18
1650055113109,MATH 20E,A02,084139,Staff,6,0,30,24
1650055113109,MATH 20E,A03,084140,Staff,15,0,30,15
1650055113109,MATH 20E,A04,084141,Staff,20,0,30,10
1650055119135,MATH 102,A01,084143,Harel; Guershon,12,0,30,18
1650055119135,MATH 102,A02,084144,Harel; Guershon,19,0,30,11
1650055125163,MATH 103B,A01,083456,Staff,0,13,30,30
1650055125163,MATH 103B,A02,083457,Staff,0,14,30,30
1650055131187,MATH 109,A01,084146,Salehi Golsefidy; Alireza,17,0,30,13
1650055131187,MATH 109,A02,084147,Salehi Golsefidy; Alireza,15,0,30,15
1650055137213,MATH 120A,A01,085445,Eggers; John Dietrich,10,0,35,25
1650055137213,MATH 120A,A02,085446,Eggers; John Dietrich,27,0,35,8
1650055143247,MATH 142B,A01,084149,Verstraete; Jacques Allan,0,12,30,30
1650055143247,MATH 142B,A02,084150,Verstraete; Jacques Allan,0,12,30,30
1650055149269,MATH 170A,A01,083459,Nie; Jiawang,0,10,30,30
1650055149269,MATH 170A,A02,083460,Nie; Jiawang,0,9,30,30
1650055149269,MATH 170A,A03,083461,Nie; Jiawang,0,9,30,30
1650055155295,MATH 193B,A01,083463,Staff,1,0,30,29
1650055155295,MATH 193B,A02,083464,Staff,9,0,30,21
1650055155295,MATH 193B,A03,083465,Staff,17,0,30,13
1650055161350,COGS 2,A01,083966,Boyle; Mary E. T.,10,0,30,20
1650055167373,COGS 9,A01,083968,Staff,7,0,60,53
1650055173400,COGS 14B,A01,083970,Staff,9,0,50,41
1650055179426,COGS 17,A01,092679,Staff,50,0,75,25
1650055185450,COGS 100,A01,083972,Staff,0,17,60,60
1650055197509,COGS 101C,A01,083976,Staff,12,0,30,18
1650055203536,COGS 102A,A01,083978,Johnson; Christine M.,13,0,30,17
1650055209559,COGS 107B,A01,083980,Staff,0,8,50,50
1650055215590,COGS 115,A01,083982,Staff,10,0,30,20
1650055221617,COGS 118B,A01,083367,Staff,0,15,40,40
1650055227644,COGS 172,A01,083984,Provenzano; Emily Kara,15,0,30,15
1650055233677,COGS 177,A00,083368,Staff,0,21,30,30
1650055239713,COGS 186,A01,083986,Staff,21,0,40,19
1650055245736,COGS 187A,A01,083988,Boyle; Mary E. T.,20,0,60,40
1650055251763,CSE 8A,A50,084003,Miranda; Gregory Joseph,0,17,15,15
1650055257792,CSE 11,A01,084005,Miranda; Gregory Joseph,0,22,55,55
1650055263818,CSE 20,A01,084007,Staff,0,5,20,20
1650055269842,CSE 21,A01,084009,Staff,0,33,50,50
1650055275866,CSE 30,A01,083370,Cao; Yingjun,0,65,40,40
1650055281888,CSE 100,A01,083372,Cao; Yingjun,0,47,40,40
1650055287912,CSE 101,A01,084011,Staff,0,55,40,40
1650055293938,CSE 141,A01,083374,Eldon; John,0,65,75,75
1650055299967,CSE 141L,A01,083376,Eldon; John,0,71,75,75
1650055305989,CSE 175,A01,084013,Kumar; Rakesh,22,0,25,3
1650055312012,CSE 190,A00,092508,Dubnov; Shlomo,18,0,20,2
1650055318046,ECE 5,A01,084049,Morris; Karcher William,12,0,20,8
1650055324071,ECE 100,A01,084051,Baghdadchi; Saharnaz,0,0,20,20
1650055324071,ECE 100,A02,091916,Baghdadchi; Saharnaz,12,0,20,8
1650055330106,ECE 101,A01,084053,Baghdadchi; Saharnaz,0,0,37,37
1650055330106,ECE 101,A02,084054,Baghdadchi; Saharnaz,29,0,37,8
1650055336130,ECE 107,A01,083390,Staff,26,0,40,14
1650055342152,ECE 148,A01,084056,Silberman; Jack,8,0,12,4
1650055348176,ECE 180,A00,083391,Abi Samra; Nicholas Camill,25,0,30,5
1650055348176,ECE 180,B00,083392,Abi Samra; Nicholas Camill,21,0,30,9
1650055354200,MATH 10B,A01,084110,Staff,0,0,30,30
1650055354200,MATH 10B,A02,084111,Staff,17,0,30,13
1650055354200,MATH 10B,A03,084112,Staff,23,0,30,7
1650055360228,MATH 10C,A01,083443,Staff,0,17,30,31
1650055360228,MATH 10C,A02,083444,Staff,0,17,30,30
1650055360228,MATH 10C,B01,084114,Staff,18,0,30,12
1650055360228,MATH 10C,B02,084115,Staff,25,0,30,5
1650055366257,MATH 18,A01,084117,Harel; Guershon,12,0,30,18
1650055366257,MATH 18,A02,084119,Harel; Guershon,27,0,30,3
1650055366257,MATH 18,A03,084120,Harel; Guershon,30,0,30,0
1650055366257,MATH 18,A04,084121,Harel; Guershon,29,0,30,1
1650055372282,MATH 20B,A01,084124,Um; Ko Woon,11,0,35,24
1650055372282,MATH 20B,B01,084126,Um; Ko Woon,24,0,35,11
1650055378312,MATH 20C,A01,083446,Hammock; Frances H,0,0,30,30
1650055378312,MATH 20C,A02,083447,Hammock; Frances H,14,0,30,16
1650055378312,MATH 20C,A03,083448,Hammock; Frances H,19,0,30,11
1650055378312,MATH 20C,A04,083449,Hammock; Frances H,20,0,30,10
1650055378312,MATH 20C,B01,083451,Hammock; Frances H,0,0,30,30
1650055378312,MATH 20C,B02,083452,Hammock; Frances H,17,0,30,13
1650055378312,MATH 20C,B03,083453,Hammock; Frances H,20,0,30,10
1650055378312,MATH 20C,B04,083454,Hammock; Frances H,23,0,30,7
1650055384336,MATH 20D,A01,084128,Staff,14,0,30,16
1650055384336,MATH 20D,A02,084129,Staff,29,0,30,1
1650055384336,MATH 20D,A03,084130,Staff,27,0,30,3
1650055384336,MATH 20D,B01,084133,Staff,0,0,30,30
1650055384336,MATH 20D,B02,084134,Staff,23,0,30,7
1650055384336,MATH 20D,B03,084135,Staff,28,0,30,2
1650055390359,MATH 20E,A01,084138,Staff,12,0,30,18
1650055390359,MATH 20E,A02,084139,Staff,6,0,30,24
1650055390359,MATH 20E,A03,084140,Staff,15,0,30,15
1650055390359,MATH 20E,A04,084141,Staff,20,0,30,10
1650055396386,MATH 102,A01,084143,Harel; Guershon,12,0,30,18
1650055396386,MATH 102,A02,084144,Harel; Guershon,19,0,30,11
1650055402411,MATH 103B,A01,083456,Staff,0,13,30,30
1650055402411,MATH 103B,A02,083457,Staff,0,14,30,30
1650055408436,MATH 109,A01,084146,Salehi Golsefidy; Alireza,17,0,30,13
1650055408436,MATH 109,A02,084147,Salehi Golsefidy; Alireza,15,0,30,15
1650055414473,MATH 120A,A01,085445,Eggers; John Dietrich,10,0,35,25
1650055414473,MATH 120A,A02,085446,Eggers; John Dietrich,27,0,35,8
1650055420496,MATH 142B,A01,084149,Verstraete; Jacques Allan,0,12,30,30
1650055420496,MATH 142B,A02,084150,Verstraete; Jacques Allan,0,12,30,30
1650055426518,MATH 170A,A01,083459,Nie; Jiawang,0,10,30,30
1650055426518,MATH 170A,A02,083460,Nie; Jiawang,0,9,30,30
1650055426518,MATH 170A,A03,083461,Nie; Jiawang,0,9,30,30
1650055432559,MATH 193B,A01,083463,Staff,1,0,30,29
1650055432559,MATH 193B,A02,083464,Staff,9,0,30,21
1650055432559,MATH 193B,A03,083465,Staff,17,0,30,13
1650055438620,COGS 2,A01,083966,Boyle; Mary E. T.,10,0,30,20
1650055444654,COGS 9,A01,083968,Staff,7,0,60,53
1650055450679,COGS 14B,A01,083970,Staff,9,0,50,41
1650055456717,COGS 17,A01,092679,Staff,50,0,75,25
1650055462741,COGS 100,A01,083972,Staff,0,17,60,60
1650055474796,COGS 101C,A01,083976,Staff,12,0,30,18
1650055480820,COGS 102A,A01,083978,Johnson; Christine M.,13,0,30,17
1650055486843,COGS 107B,A01,083980,Staff,0,8,50,50
1650055492867,COGS 115,A01,083982,Staff,10,0,30,20
1650055498890,COGS 118B,A01,083367,Staff,0,15,40,40
1650055504917,COGS 172,A01,083984,Provenzano; Emily Kara,15,0,30,15
1650055511047,COGS 177,A00,083368,Staff,0,21,30,30
1650055517073,COGS 186,A01,083986,Staff,21,0,40,19
1650055523097,COGS 187A,A01,083988,Boyle; Mary E. T.,20,0,60,40
1650055529124,CSE 8A,A50,084003,Miranda; Gregory Joseph,0,17,15,15
1650055535160,CSE 11,A01,084005,Miranda; Gregory Joseph,0,23,55,55
1650055541183,CSE 20,A01,084007,Staff,0,5,20,20
1650055547214,CSE 21,A01,084009,Staff,0,33,50,50
1650055553240,CSE 30,A01,083370,Cao; Yingjun,0,65,40,40
1650055559263,CSE 100,A01,083372,Cao; Yingjun,0,47,40,40
1650055565286,CSE 101,A01,084011,Staff,0,55,40,40
1650055571322,CSE 141,A01,083374,Eldon; John,0,65,75,75
1650055577349,CSE 141L,A01,083376,Eldon; John,0,71,75,75
1650055583371,CSE 175,A01,084013,Kumar; Rakesh,22,0,25,3
1650055589398,CSE 190,A00,092508,Dubnov; Shlomo,18,0,20,2
1650055595421,ECE 5,A01,084049,Morris; Karcher William,12,0,20,8
1650055601451,ECE 100,A01,084051,Baghdadchi; Saharnaz,0,0,20,20
1650055601451,ECE 100,A02,091916,Baghdadchi; Saharnaz,12,0,20,8
1650055607476,ECE 101,A01,084053,Baghdadchi; Saharnaz,0,0,37,37
1650055607476,ECE 101,A02,084054,Baghdadchi; Saharnaz,29,0,37,8
1650055613500,ECE 107,A01,083390,Staff,26,0,40,14
1650055619527,ECE 148,A01,084056,Silberman; Jack,8,0,12,4
1650055625551,ECE 180,A00,083391,Abi Samra; Nicholas Camill,25,0,30,5
1650055625551,ECE 180,B00,083392,Abi Samra; Nicholas Camill,21,0,30,9
1650055631575,MATH 10B,A01,084110,Staff,0,0,30,30
1650055631575,MATH 10B,A02,084111,Staff,17,0,30,13
1650055631575,MATH 10B,A03,084112,Staff,23,0,30,7
1650055637603,MATH 10C,A01,083443,Staff,0,17,30,31
1650055637603,MATH 10C,A02,083444,Staff,1,17,30,29
1650055637603,MATH 10C,B01,084114,Staff,18,0,30,12
1650055637603,MATH 10C,B02,084115,Staff,25,0,30,5
1650055643642,MATH 18,A01,084117,Harel; Guershon,12,0,30,18
1650055643642,MATH 18,A02,084119,Harel; Guershon,27,0,30,3
1650055643642,MATH 18,A03,084120,Harel; Guershon,30,0,30,0
1650055643642,MATH 18,A04,084121,Harel; Guershon,29,0,30,1
1650055649671,MATH 20B,A01,084124,Um; Ko Woon,11,0,35,24
1650055649671,MATH 20B,B01,084126,Um; Ko Woon,24,0,35,11
1650055655717,MATH 20C,A01,083446,Hammock; Frances H,0,0,30,30
1650055655717,MATH 20C,A02,083447,Hammock; Frances H,14,0,30,16
1650055655717,MATH 20C,A03,083448,Hammock; Frances H,19,0,30,11
1650055655717,MATH 20C,A04,083449,Hammock; Frances H,20,0,30,10
1650055655717,MATH 20C,B01,083451,Hammock; Frances H,0,0,30,30
1650055655717,MATH 20C,B02,083452,Hammock; Frances H,17,0,30,13
1650055655717,MATH 20C,B03,083453,Hammock; Frances H,20,0,30,10
1650055655717,MATH 20C,B04,083454,Hammock; Frances H,23,0,30,7
1650055661757,MATH 20D,A01,084128,Staff,14,0,30,16
1650055661757,MATH 20D,A02,084129,Staff,29,0,30,1
1650055661757,MATH 20D,A03,084130,Staff,27,0,30,3
1650055661757,MATH 20D,B01,084133,Staff,0,0,30,30
1650055661757,MATH 20D,B02,084134,Staff,23,0,30,7
1650055661757,MATH 20D,B03,084135,Staff,28,0,30,2
1650055667781,MATH 20E,A01,084138,Staff,12,0,30,18
1650055667781,MATH 20E,A02,084139,Staff,6,0,30,24
1650055667781,MATH 20E,A03,084140,Staff,15,0,30,15
1650055667781,MATH 20E,A04,084141,Staff,20,0,30,10
1650055673808,MATH 102,A01,084143,Harel; Guershon,12,0,30,18
1650055673808,MATH 102,A02,084144,Harel; Guershon,19,0,30,11
1650055679835,MATH 103B,A01,083456,Staff,0,13,30,30
1650055679835,MATH 103B,A02,083457,Staff,0,14,30,30
1650055685862,MATH 109,A01,084146,Salehi Golsefidy; Alireza,17,0,30,13
1650055685862,MATH 109,A02,084147,Salehi Golsefidy; Alireza,15,0,30,15
1650055691887,MATH 120A,A01,085445,Eggers; John Dietrich,10,0,35,25
1650055691887,MATH 120A,A02,085446,Eggers; John Dietrich,27,0,35,8
1650055697917,MATH 142B,A01,084149,Verstraete; Jacques Allan,0,12,30,30
1650055697917,MATH 142B,A02,084150,Verstraete; Jacques Allan,0,12,30,30
1650055703943,MATH 170A,A01,083459,Nie; Jiawang,0,10,30,30
1650055703943,MATH 170A,A02,083460,Nie; Jiawang,0,9,30,30
1650055703943,MATH 170A,A03,083461,Nie; Jiawang,0,9,30,30
1650055709974,MATH 193B,A01,083463,Staff,1,0,30,29
1650055709974,MATH 193B,A02,083464,Staff,9,0,30,21
1650055709974,MATH 193B,A03,083465,Staff,17,0,30,13
1650055716043,COGS 2,A01,083966,Boyle; Mary E. T.,10,0,30,20
1650055722069,COGS 9,A01,083968,Staff,7,0,60,53
1650055728099,COGS 14B,A01,083970,Staff,9,0,50,41
1650055734119,COGS 17,A01,092679,Staff,50,0,75,25
1650055740154,COGS 100,A01,083972,Staff,0,17,60,60
1650055752204,COGS 101C,A01,083976,Staff,12,0,30,18
1650055758229,COGS 102A,A01,083978,Johnson; Christine M.,13,0,30,17
1650055764251,COGS 107B,A01,083980,Staff,0,8,50,50
1650055770274,COGS 115,A01,083982,Staff,10,0,30,20
1650055776296,COGS 118B,A01,083367,Staff,0,15,40,40
1650055782322,COGS 172,A01,083984,Provenzano; Emily Kara,15,0,30,15
1650055788345,COGS 177,A00,083368,Staff,0,21,30,30
1650055794368,COGS 186,A01,083986,Staff,21,0,40,19
1650055800406,COGS 187A,A01,083988,Boyle; Mary E. T.,20,0,60,40
1650055806435,CSE 8A,A50,084003,Miranda; Gregory Joseph,0,17,15,15
1650055812460,CSE 11,A01,084005,Miranda; Gregory Joseph,0,23,55,55
1650055818483,CSE 20,A01,084007,Staff,0,5,20,20
1650055824511,CSE 21,A01,084009,Staff,0,33,50,50
1650055830535,CSE 30,A01,083370,Cao; Yingjun,0,65,40,40
1650055836568,CSE 100,A01,083372,Cao; Yingjun,0,47,40,40
1650055842601,CSE 101,A01,084011,Staff,0,55,40,40
1650055848625,CSE 141,A01,083374,Eldon; John,0,65,75,75
1650055854647,CSE 141L,A01,083376,Eldon; John,0,71,75,75
1650055860672,CSE 175,A01,084013,Kumar; Rakesh,22,0,25,3
1650055866696,CSE 190,A00,092508,Dubnov; Shlomo,18,0,20,2
1650055872718,ECE 5,A01,084049,Morris; Karcher William,12,0,20,8
1650055878743,ECE 100,A01,084051,Baghdadchi; Saharnaz,0,0,20,20
1650055878743,ECE 100,A02,091916,Baghdadchi; Saharnaz,12,0,20,8
1650055884769,ECE 101,A01,084053,Baghdadchi; Saharnaz,0,0,37,37
1650055884769,ECE 101,A02,084054,Baghdadchi; Saharnaz,29,0,37,8
1650055890794,ECE 107,A01,083390,Staff,26,0,40,14
1650055896817,ECE 148,A01,084056,Silberman; Jack,8,0,12,4
1650055902840,ECE 180,A00,083391,Abi Samra; Nicholas Camill,25,0,30,5
1650055902840,ECE 180,B00,083392,Abi Samra; Nicholas Camill,21,0,30,9
1650055908864,MATH 10B,A01,084110,Staff,0,0,30,30
1650055908864,MATH 10B,A02,084111,Staff,17,0,30,13
1650055908864,MATH 10B,A03,084112,Staff,23,0,30,7
1650055914891,MATH 10C,A01,083443,Staff,0,17,30,31
1650055914891,MATH 10C,A02,083444,Staff,1,17,30,29
1650055914891,MATH 10C,B01,084114,Staff,18,0,30,12
1650055914891,MATH 10C,B02,084115,Staff,25,0,30,5
1650055920920,MATH 18,A01,084117,Harel; Guershon,12,0,30,18
1650055920920,MATH 18,A02,084119,Harel; Guershon,27,0,30,3
1650055920920,MATH 18,A03,084120,Harel; Guershon,30,0,30,0
1650055920920,MATH 18,A04,084121,Harel; Guershon,29,0,30,1
1650055926949,MATH 20B,A01,084124,Um; Ko Woon,11,0,35,24
1650055926949,MATH 20B,B01,084126,Um; Ko Woon,24,0,35,11
1650055932997,MATH 20C,A01,083446,Hammock; Frances H,0,0,30,30
1650055932997,MATH 20C,A02,083447,Hammock; Frances H,14,0,30,16
1650055932997,MATH 20C,A03,083448,Hammock; Frances H,19,0,30,11
1650055932997,MATH 20C,A04,083449,Hammock; Frances H,20,0,30,10
1650055932997,MATH 20C,B01,083451,Hammock; Frances H,0,0,30,30
1650055932997,MATH 20C,B02,083452,Hammock; Frances H,17,0,30,13
1650055932997,MATH 20C,B03,083453,Hammock; Frances H,20,0,30,10
1650055932997,MATH 20C,B04,083454,Hammock; Frances H,23,0,30,7
1650055939025,MATH 20D,A01,084128,Staff,14,0,30,16
1650055939025,MATH 20D,A02,084129,Staff,29,0,30,1
1650055939025,MATH 20D,A03,084130,Staff,27,0,30,3
1650055939025,MATH 20D,B01,084133,Staff,0,0,30,30
1650055939025,MATH 20D,B02,084134,Staff,23,0,30,7
1650055939025,MATH 20D,B03,084135,Staff,28,0,30,2
1650055945047,MATH 20E,A01,084138,Staff,12,0,30,18
1650055945047,MATH 20E,A02,084139,Staff,6,0,30,24
1650055945047,MATH 20E,A03,084140,Staff,15,0,30,15
1650055945047,MATH 20E,A04,084141,Staff,20,0,30,10
1650055951071,MATH 102,A01,084143,Harel; Guershon,12,0,30,18
1650055951071,MATH 102,A02,084144,Harel; Guershon,19,0,30,11
1650055957095,MATH 103B,A01,083456,Staff,0,13,30,30
1650055957095,MATH 103B,A02,083457,Staff,0,14,30,30
1650055963117,MATH 109,A01,084146,Salehi Golsefidy; Alireza,17,0,30,13
1650055963117,MATH 109,A02,084147,Salehi Golsefidy; Alireza,15,0,30,15
1650055969141,MATH 120A,A01,085445,Eggers; John Dietrich,10,0,35,25
1650055969141,MATH 120A,A02,085446,Eggers; John Dietrich,27,0,35,8
1650055975167,MATH 142B,A01,084149,Verstraete; Jacques Allan,0,12,30,30
1650055975167,MATH 142B,A02,084150,Verstraete; Jacques Allan,0,12,30,30
1650055981191,MATH 170A,A01,083459,Nie; Jiawang,0,10,30,30
1650055981191,MATH 170A,A02,083460,Nie; Jiawang,0,9,30,30
1650055981191,MATH 170A,A03,083461,Nie; Jiawang,0,9,30,30
1650055987233,MATH 193B,A01,083463,Staff,1,0,30,29
1650055987233,MATH 193B,A02,083464,Staff,9,0,30,21
1650055987233,MATH 193B,A03,083465,Staff,17,0,30,13
1650055993306,COGS 2,A01,083966,Boyle; Mary E. T.,10,0,30,20
1650055999330,COGS 9,A01,083968,Staff,7,0,60,53
1650056005357,COGS 14B,A01,083970,Staff,9,0,50,41
1650056011379,COGS 17,A01,092679,Staff,50,0,75,25
1650056017414,COGS 100,A01,083972,Staff,0,17,60,60
1650056029463,COGS 101C,A01,083976,Staff,12,0,30,18
1650056035490,COGS 102A,A01,083978,Johnson; Christine M.,13,0,30,17
1650056041520,COGS 107B,A01,083980,Staff,0,8,50,50
1650056047546,COGS 115,A01,083982,Staff,10,0,30,20
1650056053574,COGS 118B,A01,083367,Staff,0,15,40,40
1650056059602,COGS 172,A01,083984,Provenzano; Emily Kara,15,0,30,15
1650056065629,COGS 177,A00,083368,Staff,0,21,30,30
1650056071652,COGS 186,A01,083986,Staff,21,0,40,19
1650056077677,COGS 187A,A01,083988,Boyle; Mary E. T.,20,0,60,40
1650056083709,CSE 8A,A50,084003,Miranda; Gregory Joseph,0,17,15,15
1650056089741,CSE 11,A01,084005,Miranda; Gregory Joseph,0,23,55,55
1650056095770,CSE 20,A01,084007,Staff,0,5,20,20
1650056101794,CSE 21,A01,084009,Staff,0,33,50,50
1650056107905,CSE 30,A01,083370,Cao; Yingjun,0,65,40,40
1650056113930,CSE 100,A01,083372,Cao; Yingjun,0,47,40,40
1650056119961,CSE 101,A01,084011,Staff,0,55,40,40
1650056126003,CSE 141,A01,083374,Eldon; John,0,65,75,75
1650056132030,CSE 141L,A01,083376,Eldon; John,0,71,75,75
1650056138054,CSE 175,A01,084013,Kumar; Rakesh,22,0,25,3
1650056144077,CSE 190,A00,092508,Dubnov; Shlomo,18,0,20,2
1650056150106,ECE 5,A01,084049,Morris; Karcher William,12,0,20,8
1650056156134,ECE 100,A01,084051,Baghdadchi; Saharnaz,0,0,20,20
1650056156134,ECE 100,A02,091916,Baghdadchi; Saharnaz,12,0,20,8
1650056162163,ECE 101,A01,084053,Baghdadchi; Saharnaz,0,0,37,37
1650056162163,ECE 101,A02,084054,Baghdadchi; Saharnaz,29,0,37,8
1650056168190,ECE 107,A01,083390,Staff,26,0,40,14
1650056174230,ECE 148,A01,084056,Silberman; Jack,8,0,12,4
1650056180258,ECE 180,A00,083391,Abi Samra; Nicholas Camill,25,0,30,5
1650056180258,ECE 180,B00,083392,Abi Samra; Nicholas Camill,21,0,30,9
1650056186279,MATH 10B,A01,084110,Staff,0,0,30,30
1650056186279,MATH 10B,A02,084111,Staff,17,0,30,13
1650056186279,MATH 10B,A03,084112,Staff,23,0,30,7
1650056192309,MATH 10C,A01,083443,Staff,0,17,30,31
1650056192309,MATH 10C,A02,083444,Staff,1,17,30,29
1650056192309,MATH 10C,B01,084114,Staff,18,0,30,12
1650056192309,MATH 10C,B02,084115,Staff,25,0,30,5
1650056198337,MATH 18,A01,084117,Harel; Guershon,12,0,30,18
1650056198337,MATH 18,A02,084119,Harel; Guershon,27,0,30,3
1650056198337,MATH 18,A03,084120,Harel; Guershon,30,0,30,0
1650056198337,MATH 18,A04,084121,Harel; Guershon,29,0,30,1
1650056204360,MATH 20B,A01,084124,Um; Ko Woon,10,0,35,25
1650056204360,MATH 20B,B01,084126,Um; Ko Woon,24,0,35,11
1650056210395,MATH 20C,A01,083446,Hammock; Frances H,0,0,30,30
1650056210395,MATH 20C,A02,083447,Hammock; Frances H,14,0,30,16
1650056210395,MATH 20C,A03,083448,Hammock; Frances H,19,0,30,11
1650056210395,MATH 20C,A04,083449,Hammock; Frances H,20,0,30,10
1650056210395,MATH 20C,B01,083451,Hammock; Frances H,0,0,30,30
1650056210395,MATH 20C,B02,083452,Hammock; Frances H,17,0,30,13
1650056210395,MATH 20C,B03,083453,Hammock; Frances H,20,0,30,10
1650056210395,MATH 20C,B04,083454,Hammock; Frances H,23,0,30,7
1650056216431,MATH 20D,A01,084128,Staff,14,0,30,16
1650056216431,MATH 20D,A02,084129,Staff,29,0,30,1
1650056216431,MATH 20D,A03,084130,Staff,27,0,30,3
1650056216431,MATH 20D,B01,084133,Staff,0,0,30,30
1650056216431,MATH 20D,B02,084134,Staff,23,0,30,7
1650056216431,MATH 20D,B03,084135,Staff,28,0,30,2
1650056222461,MATH 20E,A01,084138,Staff,12,0,30,18
1650056222461,MATH 20E,A02,084139,Staff,6,0,30,24
1650056222461,MATH 20E,A03,084140,Staff,15,0,30,15
1650056222461,MATH 20E,A04,084141,Staff,20,0,30,10
1650056228484,MATH 102,A01,084143,Harel; Guershon,12,0,30,18
1650056228484,MATH 102,A02,084144,Harel; Guershon,19,0,30,11
1650056234521,MATH 103B,A01,083456,Staff,0,13,30,30
1650056234521,MATH 103B,A02,083457,Staff,0,14,30,30
1650056240552,MATH 109,A01,084146,Salehi Golsefidy; Alireza,17,0,30,13
1650056240552,MATH 109,A02,084147,Salehi Golsefidy; Alireza,15,0,30,15
1650056246581,MATH 120A,A01,085445,Eggers; John Dietrich,10,0,35,25
1650056246581,MATH 120A,A02,085446,Eggers; John Dietrich,27,0,35,8
1650056252609,MATH 142B,A01,084149,Verstraete; Jacques Allan,0,12,30,30
1650056252609,MATH 142B,A02,084150,Verstraete; Jacques Allan,0,12,30,30
1650056258634,MATH 170A,A01,083459,Nie; Jiawang,0,10,30,30
1650056258634,MATH 170A,A02,083460,Nie; Jiawang,0,9,30,30
1650056258634,MATH 170A,A03,083461,Nie; Jiawang,0,9,30,30
1650056264659,MATH 193B,A01,083463,Staff,1,0,30,29
1650056264659,MATH 193B,A02,083464,Staff,9,0,30,21
1650056264659,MATH 193B,A03,083465,Staff,17,0,30,13
1650056270721,COGS 2,A01,083966,Boyle; Mary E. T.,10,0,30,20
1650056276751,COGS 9,A01,083968,Staff,7,0,60,53
1650056282778,COGS 14B,A01,083970,Staff,9,0,50,41
1650056288805,COGS 17,A01,092679,Staff,50,0,75,25
1650056294835,COGS 100,A01,083972,Staff,0,17,60,60
1650056306892,COGS 101C,A01,083976,Staff,12,0,30,18
1650056312929,COGS 102A,A01,083978,Johnson; Christine M.,13,0,30,17
1650056318955,COGS 107B,A01,083980,Staff,0,8,50,50
1650056324981,COGS 115,A01,083982,Staff,10,0,30,20
1650056331012,COGS 118B,A01,083367,Staff,0,15,40,40
1650056337036,COGS 172,A01,083984,Provenzano; Emily Kara,15,0,30,15
1650056343060,COGS 177,A00,083368,Staff,0,21,30,30
1650056349082,COGS 186,A01,083986,Staff,21,0,40,19
1650056355109,COGS 187A,A01,083988,Boyle; Mary E. T.,20,0,60,40
1650056361136,CSE 8A,A50,084003,Miranda; Gregory Joseph,0,17,15,15
1650056367168,CSE 11,A01,084005,Miranda; Gregory Joseph,0,23,55,55
1650056373197,CSE 20,A01,084007,Staff,0,5,20,20
1650056379218,CSE 21,A01,084009,Staff,0,33,50,50
1650056385249,CSE 30,A01,083370,Cao; Yingjun,0,65,40,40
1650056391274,CSE 100,A01,083372,Cao; Yingjun,0,47,40,40
1650056397306,CSE 101,A01,084011,Staff,0,55,40,40
1650056403331,CSE 141,A01,083374,Eldon; John,0,65,75,75
1650056409367,CSE 141L,A01,083376,Eldon; John,0,71,75,75
1650056415393,CSE 175,A01,084013,Kumar; Rakesh,22,0,25,3
1650056421426,CSE 190,A00,092508,Dubnov; Shlomo,18,0,20,2
1650056427468,ECE 5,A01,084049,Morris; Karcher William,12,0,20,8
1650056433503,ECE 100,A01,084051,Baghdadchi; Saharnaz,0,0,20,20
1650056433503,ECE 100,A02,091916,Baghdadchi; Saharnaz,12,0,20,8
1650056439530,ECE 101,A01,084053,Baghdadchi; Saharnaz,0,0,37,37
1650056439530,ECE 101,A02,084054,Baghdadchi; Saharnaz,29,0,37,8
1650056445560,ECE 107,A01,083390,Staff,26,0,40,14
1650056451591,ECE 148,A01,084056,Silberman; Jack,8,0,12,4
1650056457624,ECE 180,A00,083391,Abi Samra; Nicholas Camill,25,0,30,5
1650056457624,ECE 180,B00,083392,Abi Samra; Nicholas Camill,21,0,30,9
1650056463663,MATH 10B,A01,084110,Staff,0,0,30,30
1650056463663,MATH 10B,A02,084111,Staff,17,0,30,13
1650056463663,MATH 10B,A03,084112,Staff,23,0,30,7
1650056469688,MATH 10C,A01,083443,Staff,0,17,30,31
1650056469688,MATH 10C,A02,083444,Staff,1,17,30,29
1650056469688,MATH 10C,B01,084114,Staff,18,0,30,12
1650056469688,MATH 10C,B02,084115,Staff,25,0,30,5
1650056475718,MATH 18,A01,084117,Harel; Guershon,12,0,30,18
1650056475718,MATH 18,A02,084119,Harel; Guershon,27,0,30,3
1650056475718,MATH 18,A03,084120,Harel; Guershon,30,0,30,0
1650056475718,MATH 18,A04,084121,Harel; Guershon,29,0,30,1
1650056481751,MATH 20B,A01,084124,Um; Ko Woon,10,0,35,25
1650056481751,MATH 20B,B01,084126,Um; Ko Woon,24,0,35,11
1650056487778,MATH 20C,A01,083446,Hammock; Frances H,0,0,30,30
1650056487778,MATH 20C,A02,083447,Hammock; Frances H,14,0,30,16
1650056487778,MATH 20C,A03,083448,Hammock; Frances H,19,0,30,11
1650056487778,MATH 20C,A04,083449,Hammock; Frances H,20,0,30,10
1650056487778,MATH 20C,B01,083451,Hammock; Frances H,0,0,30,30
1650056487778,MATH 20C,B02,083452,Hammock; Frances H,17,0,30,13
1650056487778,MATH 20C,B03,083453,Hammock; Frances H,20,0,30,10
1650056487778,MATH 20C,B04,083454,Hammock; Frances H,23,0,30,7
1650056493806,MATH 20D,A01,084128,Staff,14,0,30,16
1650056493806,MATH 20D,A02,084129,Staff,29,0,30,1
1650056493806,MATH 20D,A03,084130,Staff,27,0,30,3
1650056493806,MATH 20D,B01,084133,Staff,0,0,30,30
1650056493806,MATH 20D,B02,084134,Staff,23,0,30,7
1650056493806,MATH 20D,B03,084135,Staff,28,0,30,2
1650056499839,MATH 20E,A01,084138,Staff,12,0,30,18
1650056499839,MATH 20E,A02,084139,Staff,6,0,30,24
1650056499839,MATH 20E,A03,084140,Staff,14,0,30,16
1650056499839,MATH 20E,A04,084141,Staff,20,0,30,10
1650056505866,MATH 102,A01,084143,Harel; Guershon,12,0,30,18
1650056505866,MATH 102,A02,084144,Harel; Guershon,19,0,30,11
1650056511901,MATH 103B,A01,083456,Staff,0,13,30,30
1650056511901,MATH 103B,A02,083457,Staff,0,14,30,30
1650056517938,MATH 109,A01,084146,Salehi Golsefidy; Alireza,17,0,30,13
1650056517938,MATH 109,A02,084147,Salehi Golsefidy; Alireza,15,0,30,15
1650056523975,MATH 120A,A01,085445,Eggers; John Dietrich,10,0,35,25
1650056523975,MATH 120A,A02,085446,Eggers; John Dietrich,27,0,35,8
1650056529999,MATH 142B,A01,084149,Verstraete; Jacques Allan,0,12,30,30
1650056529999,MATH 142B,A02,084150,Verstraete; Jacques Allan,0,12,30,30
1650056536023,MATH 170A,A01,083459,Nie; Jiawang,0,10,30,30
1650056536023,MATH 170A,A02,083460,Nie; Jiawang,0,9,30,30
1650056536023,MATH 170A,A03,083461,Nie; Jiawang,0,9,30,30
1650056542062,MATH 193B,A01,083463,Staff,1,0,30,29
1650056542062,MATH 193B,A02,083464,Staff,9,0,30,21
1650056542062,MATH 193B,A03,083465,Staff,17,0,30,13
1650056548124,COGS 2,A01,083966,Boyle; Mary E. T.,10,0,30,20
1650056554148,COGS 9,A01,083968,Staff,7,0,60,53
1650056560172,COGS 14B,A01,083970,Staff,9,0,50,41
1650056566199,COGS 17,A01,092679,Staff,50,0,75,25
1650056572222,COGS 100,A01,083972,Staff,0,17,60,60
1650056584268,COGS 101C,A01,083976,Staff,12,0,30,18
1650056590292,COGS 102A,A01,083978,Johnson; Christine M.,13,0,30,17
1650056596316,COGS 107B,A01,083980,Staff,0,8,50,50
1650056602344,COGS 115,A01,083982,Staff,10,0,30,20
1650056608368,COGS 118B,A01,083367,Staff,0,15,40,40
1650056614416,COGS 172,A01,083984,Provenzano; Emily Kara,15,0,30,15
1650056620444,COGS 177,A00,083368,Staff,0,21,30,30
1650056626473,COGS 186,A01,083986,Staff,21,0,40,19
1650056632503,COGS 187A,A01,083988,Boyle; Mary E. T.,20,0,60,40
1650056638527,CSE 8A,A50,084003,Miranda; Gregory Joseph,0,18,15,15
1650056644555,CSE 11,A01,084005,Miranda; Gregory Joseph,0,23,55,55
1650056650581,CSE 20,A01,084007,Staff,0,5,20,20
1650056656605,CSE 21,A01,084009,Staff,0,33,50,50
1650056662628,CSE 30,A01,083370,Cao; Yingjun,0,65,40,40
1650056668657,CSE 100,A01,083372,Cao; Yingjun,0,47,40,40
1650056674685,CSE 101,A01,084011,Staff,0,55,40,40
1650056680711,CSE 141,A01,083374,Eldon; John,0,65,75,75
1650056686736,CSE 141L,A01,083376,Eldon; John,0,71,75,75
1650056692765,CSE 175,A01,084013,Kumar; Rakesh,22,0,25,3
1650056698789,CSE 190,A00,092508,Dubnov; Shlomo,18,0,20,2
1650056704907,ECE 5,A01,084049,Morris; Karcher William,12,0,20,8
1650056710947,ECE 100,A01,084051,Baghdadchi; Saharnaz,0,0,20,20
1650056710947,ECE 100,A02,091916,Baghdadchi; Saharnaz,12,0,20,8
1650056716977,ECE 101,A01,084053,Baghdadchi; Saharnaz,0,0,37,37
1650056716977,ECE 101,A02,084054,Baghdadchi; Saharnaz,29,0,37,8
1650056723003,ECE 107,A01,083390,Staff,26,0,40,14
1650056729026,ECE 148,A01,084056,Silberman; Jack,8,0,12,4
1650056735059,ECE 180,A00,083391,Abi Samra; Nicholas Camill,25,0,30,5
1650056735059,ECE 180,B00,083392,Abi Samra; Nicholas Camill,21,0,30,9
1650056741086,MATH 10B,A01,084110,Staff,0,0,30,30
1650056741086,MATH 10B,A02,084111,Staff,17,0,30,13
1650056741086,MATH 10B,A03,084112,Staff,23,0,30,7
1650056747108,MATH 10C,A01,083443,Staff,0,17,30,31
1650056747108,MATH 10C,A02,083444,Staff,1,17,30,29
1650056747108,MATH 10C,B01,084114,Staff,18,0,30,12
1650056747108,MATH 10C,B02,084115,Staff,25,0,30,5
1650056753136,MATH 18,A01,084117,Harel; Guershon,12,0,30,18
1650056753136,MATH 18,A02,084119,Harel; Guershon,27,0,30,3
1650056753136,MATH 18,A03,084120,Harel; Guershon,30,0,30,0
1650056753136,MATH 18,A04,084121,Harel; Guershon,29,0,30,1
1650056759165,MATH 20B,A01,084124,Um; Ko Woon,10,0,35,25
1650056759165,MATH 20B,B01,084126,Um; Ko Woon,24,0,35,11
1650056765189,MATH 20C,A01,083446,Hammock; Frances H,0,0,30,30
1650056765189,MATH 20C,A02,083447,Hammock; Frances H,14,0,30,16
1650056765189,MATH 20C,A03,083448,Hammock; Frances H,19,0,30,11
1650056765189,MATH 20C,A04,083449,Hammock; Frances H,20,0,30,10
1650056765189,MATH 20C,B01,083451,Hammock; Frances H,0,0,30,30
1650056765189,MATH 20C,B02,083452,Hammock; Frances H,17,0,30,13
1650056765189,MATH 20C,B03,083453,Hammock; Frances H,20,0,30,10
1650056765189,MATH 20C,B04,083454,Hammock; Frances H,23,0,30,7
1650056771212,MATH 20D,A01,084128,Staff,14,0,30,16
1650056771212,MATH 20D,A02,084129,Staff,29,0,30,1
1650056771212,MATH 20D,A03,084130,Staff,27,0,30,3
1650056771212,MATH 20D,B01,084133,Staff,0,0,30,30
1650056771212,MATH 20D,B02,084134,Staff,23,0,30,7
1650056771212,MATH 20D,B03,084135,Staff,28,0,30,2
1650056777237,MATH 20E,A01,084138,Staff,12,0,30,18
1650056777237,MATH 20E,A02,084139,Staff,6,0,30,24
1650056777237,MATH 20E,A03,084140,Staff,14,0,30,16
1650056777237,MATH 20E,A04,084141,Staff,20,0,30,10
1650056783269,MATH 102,A01,084143,Harel; Guershon,12,0,30,18
1650056783269,MATH 102,A02,084144,Harel; Guershon,19,0,30,11
1650056789292,MATH 103B,A01,083456,Staff,0,13,30,30
1650056789292,MATH 103B,A02,083457,Staff,0,14,30,30
1650056795319,MATH 109,A01,084146,Salehi Golsefidy; Alireza,17,0,30,13
1650056795319,MATH 109,A02,084147,Salehi Golsefidy; Alireza,15,0,30,15
1650056801348,MATH 120A,A01,085445,Eggers; John Dietrich,10,0,35,25
1650056801348,MATH 120A,A02,085446,Eggers; John Dietrich,27,0,35,8
1650056807375,MATH 142B,A01,084149,Verstraete; Jacques Allan,0,12,30,30
1650056807375,MATH 142B,A02,084150,Verstraete; Jacques Allan,0,12,30,30
1650056813398,MATH 170A,A01,083459,Nie; Jiawang,0,10,30,30
1650056813398,MATH 170A,A02,083460,Nie; Jiawang,0,9,30,30
1650056813398,MATH 170A,A03,083461,Nie; Jiawang,0,9,30,30
1650056819432,MATH 193B,A01,083463,Staff,1,0,30,29
1650056819432,MATH 193B,A02,083464,Staff,9,0,30,21
1650056819432,MATH 193B,A03,083465,Staff,17,0,30,13
1650056825516,COGS 2,A01,083966,Boyle; Mary E. T.,10,0,30,20
1650056831538,COGS 9,A01,083968,Staff,7,0,60,53
1650056837575,COGS 14B,A01,083970,Staff,9,0,50,41
1650056843599,COGS 17,A01,092679,Staff,50,0,75,25
1650056849631,COGS 100,A01,083972,Staff,0,17,60,60
1650056861690,COGS 101C,A01,083976,Staff,12,0,30,18
1650056867718,COGS 102A,A01,083978,Johnson; Christine M.,13,0,30,17
1650056873746,COGS 107B,A01,083980,Staff,0,8,50,50
1650056879780,COGS 115,A01,083982,Staff,10,0,30,20
1650056885808,COGS 118B,A01,083367,Staff,0,15,40,40
1650056891831,COGS 172,A01,083984,Provenzano; Emily Kara,15,0,30,15
1650056897858,COGS 177,A00,083368,Staff,0,21,30,30
1650056903885,COGS 186,A01,083986,Staff,21,0,40,19
1650056909908,COGS 187A,A01,083988,Boyle; Mary E. T.,20,0,60,40
1650056915930,CSE 8A,A50,084003,Miranda; Gregory Joseph,0,18,15,15
1650056921956,CSE 11,A01,084005,Miranda; Gregory Joseph,0,23,55,55
1650056927979,CSE 20,A01,084007,Staff,0,5,20,20
1650056934005,CSE 21,A01,084009,Staff,0,33,50,50
1650056940028,CSE 30,A01,083370,Cao; Yingjun,0,65,40,40
1650056946052,CSE 100,A01,083372,Cao; Yingjun,0,47,40,40
1650056952074,CSE 101,A01,084011,Staff,0,55,40,40
1650056958108,CSE 141,A01,083374,Eldon; John,0,65,75,75
1650056964132,CSE 141L,A01,083376,Eldon; John,0,71,75,75
1650056970163,CSE 175,A01,084013,Kumar; Rakesh,22,0,25,3
1650056976192,CSE 190,A00,092508,Dubnov; Shlomo,18,0,20,2
1650056982233,ECE 5,A01,084049,Morris; Karcher William,12,0,20,8
1650056988264,ECE 100,A01,084051,Baghdadchi; Saharnaz,0,0,20,20
1650056988264,ECE 100,A02,091916,Baghdadchi; Saharnaz,12,0,20,8
1650056994294,ECE 101,A01,084053,Baghdadchi; Saharnaz,0,0,37,37
1650056994294,ECE 101,A02,084054,Baghdadchi; Saharnaz,29,0,37,8
1650057000331,ECE 107,A01,083390,Staff,26,0,40,14
1650057006356,ECE 148,A01,084056,Silberman; Jack,8,0,12,4
1650057012379,ECE 180,A00,083391,Abi Samra; Nicholas Camill,25,0,30,5
1650057012379,ECE 180,B00,083392,Abi Samra; Nicholas Camill,21,0,30,9
1650057018407,MATH 10B,A01,084110,Staff,0,0,30,30
1650057018407,MATH 10B,A02,084111,Staff,17,0,30,13
1650057018407,MATH 10B,A03,084112,Staff,23,0,30,7
1650057024434,MATH 10C,A01,083443,Staff,0,17,30,31
1650057024434,MATH 10C,A02,083444,Staff,1,17,30,29
1650057024434,MATH 10C,B01,084114,Staff,18,0,30,12
1650057024434,MATH 10C,B02,084115,Staff,25,0,30,5
1650057030457,MATH 18,A01,084117,Harel; Guershon,12,0,30,18
1650057030457,MATH 18,A02,084119,Harel; Guershon,27,0,30,3
1650057030457,MATH 18,A03,084120,Harel; Guershon,30,0,30,0
1650057030457,MATH 18,A04,084121,Harel; Guershon,29,0,30,1
1650057036498,MATH 20B,A01,084124,Um; Ko Woon,10,0,35,25
1650057036498,MATH 20B,B01,084126,Um; Ko Woon,24,0,35,11
1650057042522,MATH 20C,A01,083446,Hammock; Frances H,0,0,30,30
1650057042522,MATH 20C,A02,083447,Hammock; Frances H,14,0,30,16
1650057042522,MATH 20C,A03,083448,Hammock; Frances H,19,0,30,11
1650057042522,MATH 20C,A04,083449,Hammock; Frances H,20,0,30,10
1650057042522,MATH 20C,B01,083451,Hammock; Frances H,0,0,30,30
1650057042522,MATH 20C,B02,083452,Hammock; Frances H,17,0,30,13
1650057042522,MATH 20C,B03,083453,Hammock; Frances H,20,0,30,10
1650057042522,MATH 20C,B04,083454,Hammock; Frances H,23,0,30,7
1650057048552,MATH 20D,A01,084128,Staff,14,0,30,16
1650057048552,MATH 20D,A02,084129,Staff,29,0,30,1
1650057048552,MATH 20D,A03,084130,Staff,27,0,30,3
1650057048552,MATH 20D,B01,084133,Staff,0,0,30,30
1650057048552,MATH 20D,B02,084134,Staff,23,0,30,7
1650057048552,MATH 20D,B03,084135,Staff,28,0,30,2
1650057054584,MATH 20E,A01,084138,Staff,12,0,30,18
1650057054584,MATH 20E,A02,084139,Staff,6,0,30,24
1650057054584,MATH 20E,A03,084140,Staff,14,0,30,16
1650057054584,MATH 20E,A04,084141,Staff,20,0,30,10
1650057060608,MATH 102,A01,084143,Harel; Guershon,12,0,30,18
1650057060608,MATH 102,A02,084144,Harel; Guershon,19,0,30,11
1650057066636,MATH 103B,A01,083456,Staff,0,13,30,30
1650057066636,MATH 103B,A02,083457,Staff,0,14,30,30
1650057072675,MATH 109,A01,084146,Salehi Golsefidy; Alireza,17,0,30,13
1650057072675,MATH 109,A02,084147,Salehi Golsefidy; Alireza,15,0,30,15
1650057078704,MATH 120A,A01,085445,Eggers; John Dietrich,10,0,35,25
1650057078704,MATH 120A,A02,085446,Eggers; John Dietrich,27,0,35,8
1650057084732,MATH 142B,A01,084149,Verstraete; Jacques Allan,0,12,30,30
1650057084732,MATH 142B,A02,084150,Verstraete; Jacques Allan,0,12,30,30
1650057090767,MATH 170A,A01,083459,Nie; Jiawang,0,10,30,30
1650057090767,MATH 170A,A02,083460,Nie; Jiawang,0,9,30,30
1650057090767,MATH 170A,A03,083461,Nie; Jiawang,0,9,30,30
1650057096795,MATH 193B,A01,083463,Staff,1,0,30,29
1650057096795,MATH 193B,A02,083464,Staff,9,0,30,21
1650057096795,MATH 193B,A03,083465,Staff,17,0,30,13
1650057102847,COGS 2,A01,083966,Boyle; Mary E. T.,10,0,30,20
1650057108871,COGS 9,A01,083968,Staff,7,0,60,53
1650057114905,COGS 14B,A01,083970,Staff,9,0,50,41
1650057120931,COGS 17,A01,092679,Staff,50,0,75,25
1650057126955,COGS 100,A01,083972,Staff,0,17,60,60
1650057139005,COGS 101C,A01,083976,Staff,12,0,30,18
1650057145030,COGS 102A,A01,083978,Johnson; Christine M.,13,0,30,17
1650057151068,COGS 107B,A01,083980,Staff,0,8,50,50
1650057157095,COGS 115,A01,083982,Staff,10,0,30,20
1650057163122,COGS 118B,A01,083367,Staff,0,15,40,40
1650057169155,COGS 172,A01,083984,Provenzano; Emily Kara,15,0,30,15
1650057175180,COGS 177,A00,083368,Staff,0,21,30,30
1650057181205,COGS 186,A01,083986,Staff,21,0,40,19
1650057187228,COGS 187A,A01,083988,Boyle; Mary E. T.,20,0,60,40
1650057193252,CSE 8A,A50,084003,Miranda; Gregory Joseph,0,18,15,15
1650057199280,CSE 11,A01,084005,Miranda; Gregory Joseph,0,23,55,55
1650057205311,CSE 20,A01,084007,Staff,0,5,20,20
1650057211356,CSE 21,A01,084009,Staff,0,33,50,50
1650057217380,CSE 30,A01,083370,Cao; Yingjun,0,65,40,40
1650057223406,CSE 100,A01,083372,Cao; Yingjun,0,47,40,40
1650057229433,CSE 101,A01,084011,Staff,0,55,40,40
1650057235471,CSE 141,A01,083374,Eldon; John,0,65,75,75
1650057241496,CSE 141L,A01,083376,Eldon; John,0,71,75,75
1650057247524,CSE 175,A01,084013,Kumar; Rakesh,22,0,25,3
1650057253551,CSE 190,A00,092508,Dubnov; Shlomo,18,0,20,2
1650057259577,ECE 5,A01,084049,Morris; Karcher William,12,0,20,8
1650057265607,ECE 100,A01,084051,Baghdadchi; Saharnaz,0,0,20,20
1650057265607,ECE 100,A02,091916,Baghdadchi; Saharnaz,12,0,20,8
1650057271634,ECE 101,A01,084053,Baghdadchi; Saharnaz,0,0,37,37
1650057271634,ECE 101,A02,084054,Baghdadchi; Saharnaz,29,0,37,8
1650057277661,ECE 107,A01,083390,Staff,26,0,40,14
1650057283687,ECE 148,A01,084056,Silberman; Jack,8,0,12,4
1650057289736,ECE 180,A00,083391,Abi Samra; Nicholas Camill,25,0,30,5
1650057289736,ECE 180,B00,083392,Abi Samra; Nicholas Camill,21,0,30,9
1650057295768,MATH 10B,A01,084110,Staff,0,0,30,30
1650057295768,MATH 10B,A02,084111,Staff,17,0,30,13
1650057295768,MATH 10B,A03,084112,Staff,23,0,30,7
1650057301965,MATH 10C,A01,083443,Staff,0,17,30,31
1650057301965,MATH 10C,A02,083444,Staff,1,17,30,29
1650057301965,MATH 10C,B01,084114,Staff,18,0,30,12
1650057301965,MATH 10C,B02,084115,Staff,25,0,30,5
1650057307990,MATH 18,A01,084117,Harel; Guershon,12,0,30,18
1650057307990,MATH 18,A02,084119,Harel; Guershon,27,0,30,3
1650057307990,MATH 18,A03,084120,Harel; Guershon,30,0,30,0
1650057307990,MATH 18,A04,084121,Harel; Guershon,29,0,30,1
1650057314022,MATH 20B,A01,084124,Um; Ko Woon,10,0,35,25
1650057314022,MATH 20B,B01,084126,Um; Ko Woon,24,0,35,11
1650057320055,MATH 20C,A01,083446,Hammock; Frances H,0,0,30,30
1650057320055,MATH 20C,A02,083447,Hammock; Frances H,14,0,30,16
1650057320055,MATH 20C,A03,083448,Hammock; Frances H,19,0,30,11
1650057320055,MATH 20C,A04,083449,Hammock; Frances H,20,0,30,10
1650057320055,MATH 20C,B01,083451,Hammock; Frances H,0,0,30,30
1650057320055,MATH 20C,B02,083452,Hammock; Frances H,17,0,30,13
1650057320055,MATH 20C,B03,083453,Hammock; Frances H,20,0,30,10
1650057320055,MATH 20C,B04,083454,Hammock; Frances H,23,0,30,7
1650057326089,MATH 20D,A01,084128,Staff,14,0,30,16
1650057326089,MATH 20D,A02,084129,Staff,29,0,30,1
1650057326089,MATH 20D,A03,084130,Staff,27,0,30,3
1650057326089,MATH 20D,B01,084133,Staff,0,0,30,30
1650057326089,MATH 20D,B02,084134,Staff,23,0,30,7
1650057326089,MATH 20D,B03,084135,Staff,28,0,30,2
1650057332119,MATH 20E,A01,084138,Staff,12,0,30,18
1650057332119,MATH 20E,A02,084139,Staff,6,0,30,24
1650057332119,MATH 20E,A03,084140,Staff,14,0,30,16
1650057332119,MATH 20E,A04,084141,Staff,20,0,30,10
1650057338146,MATH 102,A01,084143,Harel; Guershon,12,0,30,18
1650057338146,MATH 102,A02,084144,Harel; Guershon,19,0,30,11
1650057344172,MATH 103B,A01,083456,Staff,0,13,30,30
1650057344172,MATH 103B,A02,083457,Staff,0,14,30,30
1650057350200,MATH 109,A01,084146,Salehi Golsefidy; Alireza,17,0,30,13
1650057350200,MATH 109,A02,084147,Salehi Golsefidy; Alireza,15,0,30,15
1650057356223,MATH 120A,A01,085445,Eggers; John Dietrich,10,0,35,25
1650057356223,MATH 120A,A02,085446,Eggers; John Dietrich,27,0,35,8
1650057362252,MATH 142B,A01,084149,Verstraete; Jacques Allan,0,12,30,30
1650057362252,MATH 142B,A02,084150,Verstraete; Jacques Allan,0,12,30,30
1650057368281,MATH 170A,A01,083459,Nie; Jiawang,0,10,30,30
1650057368281,MATH 170A,A02,083460,Nie; Jiawang,0,9,30,30
1650057368281,MATH 170A,A03,083461,Nie; Jiawang,0,9,30,30
1650057374308,MATH 193B,A01,083463,Staff,1,0,30,29
1650057374308,MATH 193B,A02,083464,Staff,9,0,30,21
1650057374308,MATH 193B,A03,083465,Staff,17,0,30,13
1650057380374,COGS 2,A01,083966,Boyle; Mary E. T.,10,0,30,20
1650057386400,COGS 9,A01,083968,Staff,7,0,60,53
1650057392424,COGS 14B,A01,083970,Staff,9,0,50,41
1650057398450,COGS 17,A01,092679,Staff,50,0,75,25
1650057404481,COGS 100,A01,083972,Staff,0,17,60,60
1650057416527,COGS 101C,A01,083976,Staff,12,0,30,18
1650057422553,COGS 102A,A01,083978,Johnson; Christine M.,13,0,30,17
1650057428581,COGS 107B,A01,083980,Staff,0,8,50,50
1650057434615,COGS 115,A01,083982,Staff,10,0,30,20
1650057440648,COGS 118B,A01,083367,Staff,0,15,40,40
1650057446674,COGS 172,A01,083984,Provenzano; Emily Kara,15,0,30,15
1650057452701,COGS 177,A00,083368,Staff,0,21,30,30
1650057458725,COGS 186,A01,083986,Staff,21,0,40,19
1650057464753,COGS 187A,A01,083988,Boyle; Mary E. T.,20,0,60,40
1650057470782,CSE 8A,A50,084003,Miranda; Gregory Joseph,0,18,15,15
1650057476809,CSE 11,A01,084005,Miranda; Gregory Joseph,0,23,55,55
1650057482833,CSE 20,A01,084007,Staff,0,5,20,20
1650057488856,CSE 21,A01,084009,Staff,0,33,50,50
1650057494883,CSE 30,A01,083370,Cao; Yingjun,0,65,40,40
1650057500915,CSE 100,A01,083372,Cao; Yingjun,0,47,40,40
1650057506941,CSE 101,A01,084011,Staff,0,55,40,40
1650057512980,CSE 141,A01,083374,Eldon; John,0,65,75,75
1650057519004,CSE 141L,A01,083376,Eldon; John,0,71,75,75
1650057525043,CSE 175,A01,084013,Kumar; Rakesh,22,0,25,3
1650057531070,CSE 190,A00,092508,Dubnov; Shlomo,18,0,20,2
1650057537100,ECE 5,A01,084049,Morris; Karcher William,12,0,20,8
1650057543136,ECE 100,A01,084051,Baghdadchi; Saharnaz,0,0,20,20
1650057543136,ECE 100,A02,091916,Baghdadchi; Saharnaz,12,0,20,8
1650057549160,ECE 101,A01,084053,Baghdadchi; Saharnaz,0,0,37,37
1650057549160,ECE 101,A02,084054,Baghdadchi; Saharnaz,29,0,37,8
1650057555187,ECE 107,A01,083390,Staff,26,0,40,14
1650057561218,ECE 148,A01,084056,Silberman; Jack,8,0,12,4
1650057567241,ECE 180,A00,083391,Abi Samra; Nicholas Camill,25,0,30,5
1650057567241,ECE 180,B00,083392,Abi Samra; Nicholas Camill,21,0,30,9
1650057573267,MATH 10B,A01,084110,Staff,0,0,30,30
1650057573267,MATH 10B,A02,084111,Staff,17,0,30,13
1650057573267,MATH 10B,A03,084112,Staff,23,0,30,7
1650057579297,MATH 10C,A01,083443,Staff,0,17,30,31
1650057579297,MATH 10C,A02,083444,Staff,1,17,30,29
1650057579297,MATH 10C,B01,084114,Staff,18,0,30,12
1650057579297,MATH 10C,B02,084115,Staff,25,0,30,5
1650057585321,MATH 18,A01,084117,Harel; Guershon,12,0,30,18
1650057585321,MATH 18,A02,084119,Harel; Guershon,27,0,30,3
1650057585321,MATH 18,A03,084120,Harel; Guershon,30,0,30,0
1650057585321,MATH 18,A04,084121,Harel; Guershon,29,0,30,1
1650057591345,MATH 20B,A01,084124,Um; Ko Woon,10,0,35,25
1650057591345,MATH 20B,B01,084126,Um; Ko Woon,24,0,35,11
1650057597377,MATH 20C,A01,083446,Hammock; Frances H,0,0,30,30
1650057597377,MATH 20C,A02,083447,Hammock; Frances H,14,0,30,16
1650057597377,MATH 20C,A03,083448,Hammock; Frances H,19,0,30,11
1650057597377,MATH 20C,A04,083449,Hammock; Frances H,20,0,30,10
1650057597377,MATH 20C,B01,083451,Hammock; Frances H,0,0,30,30
1650057597377,MATH 20C,B02,083452,Hammock; Frances H,17,0,30,13
1650057597377,MATH 20C,B03,083453,Hammock; Frances H,20,0,30,10
1650057597377,MATH 20C,B04,083454,Hammock; Frances H,23,0,30,7
1650057603400,MATH 20D,A01,084128,Staff,14,0,30,16
1650057603400,MATH 20D,A02,084129,Staff,29,0,30,1
1650057603400,MATH 20D,A03,084130,Staff,27,0,30,3
1650057603400,MATH 20D,B01,084133,Staff,0,0,30,30
1650057603400,MATH 20D,B02,084134,Staff,23,0,30,7
1650057603400,MATH 20D,B03,084135,Staff,28,0,30,2
1650057609428,MATH 20E,A01,084138,Staff,12,0,30,18
1650057609428,MATH 20E,A02,084139,Staff,6,0,30,24
1650057609428,MATH 20E,A03,084140,Staff,14,0,30,16
1650057609428,MATH 20E,A04,084141,Staff,20,0,30,10
1650057615454,MATH 102,A01,084143,Harel; Guershon,12,0,30,18
1650057615454,MATH 102,A02,084144,Harel; Guershon,19,0,30,11
1650057621480,MATH 103B,A01,083456,Staff,0,13,30,30
1650057621480,MATH 103B,A02,083457,Staff,0,14,30,30
1650057627509,MATH 109,A01,084146,Salehi Golsefidy; Alireza,17,0,30,13
1650057627509,MATH 109,A02,084147,Salehi Golsefidy; Alireza,15,0,30,15
1650057633536,MATH 120A,A01,085445,Eggers; John Dietrich,10,0,35,25
1650057633536,MATH 120A,A02,085446,Eggers; John Dietrich,27,0,35,8
1650057639560,MATH 142B,A01,084149,Verstraete; Jacques Allan,0,12,30,30
1650057639560,MATH 142B,A02,084150,Verstraete; Jacques Allan,0,12,30,30
1650057645589,MATH 170A,A01,083459,Nie; Jiawang,0,10,30,30
1650057645589,MATH 170A,A02,083460,Nie; Jiawang,0,9,30,30
1650057645589,MATH 170A,A03,083461,Nie; Jiawang,0,9,30,30
1650057651620,MATH 193B,A01,083463,Staff,1,0,30,29
1650057651620,MATH 193B,A02,083464,Staff,9,0,30,21
1650057651620,MATH 193B,A03,083465,Staff,17,0,30,13
1650057657704,COGS 2,A01,083966,Boyle; Mary E. T.,10,0,30,20
1650057663736,COGS 9,A01,083968,Staff,6,0,60,54
1650057669766,COGS 14B,A01,083970,Staff,9,0,50,41
1650057675797,COGS 17,A01,092679,Staff,50,0,75,25
1650057681819,COGS 100,A01,083972,Staff,0,17,60,60
1650057693870,COGS 101C,A01,083976,Staff,12,0,30,18
1650057699896,COGS 102A,A01,083978,Johnson; Christine M.,13,0,30,17
1650057705929,COGS 107B,A01,083980,Staff,0,8,50,50
1650057711955,COGS 115,A01,083982,Staff,10,0,30,20
1650057717978,COGS 118B,A01,083367,Staff,0,15,40,40
1650057724017,COGS 172,A01,083984,Provenzano; Emily Kara,15,0,30,15
1650057730048,COGS 177,A00,083368,Staff,0,21,30,30
1650057736085,COGS 186,A01,083986,Staff,21,0,40,19
1650057742122,COGS 187A,A01,083988,Boyle; Mary E. T.,20,0,60,40
1650057748146,CSE 8A,A50,084003,Miranda; Gregory Joseph,0,18,15,15
1650057754170,CSE 11,A01,084005,Miranda; Gregory Joseph,0,23,55,55
1650057760193,CSE 20,A01,084007,Staff,0,5,20,20
1650057766224,CSE 21,A01,084009,Staff,0,33,50,50
1650057772247,CSE 30,A01,083370,Cao; Yingjun,0,65,40,40
1650057778270,CSE 100,A01,083372,Cao; Yingjun,0,47,40,40
1650057784295,CSE 101,A01,084011,Staff,0,55,40,40
1650057790322,CSE 141,A01,083374,Eldon; John,0,65,75,75
1650057796349,CSE 141L,A01,083376,Eldon; John,0,71,75,75
1650057802376,CSE 175,A01,084013,Kumar; Rakesh,22,0,25,3
1650057808408,CSE 190,A00,092508,Dubnov; Shlomo,18,0,20,2
1650057814430,ECE 5,A01,084049,Morris; Karcher William,12,0,20,8
1650057820459,ECE 100,A01,084051,Baghdadchi; Saharnaz,0,0,20,20
1650057820459,ECE 100,A02,091916,Baghdadchi; Saharnaz,12,0,20,8
1650057826482,ECE 101,A01,084053,Baghdadchi; Saharnaz,0,0,37,37
1650057826482,ECE 101,A02,084054,Baghdadchi; Saharnaz,29,0,37,8
1650057832517,ECE 107,A01,083390,Staff,26,0,40,14
1650057838541,ECE 148,A01,084056,Silberman; Jack,8,0,12,4
1650057844564,ECE 180,A00,083391,Abi Samra; Nicholas Camill,25,0,30,5
1650057844564,ECE 180,B00,083392,Abi Samra; Nicholas Camill,21,0,30,9
1650057850588,MATH 10B,A01,084110,Staff,0,0,30,30
1650057850588,MATH 10B,A02,084111,Staff,17,0,30,13
1650057850588,MATH 10B,A03,084112,Staff,23,0,30,7
1650057856614,MATH 10C,A01,083443,Staff,0,17,30,31
1650057856614,MATH 10C,A02,083444,Staff,1,17,30,29
1650057856614,MATH 10C,B01,084114,Staff,18,0,30,12
1650057856614,MATH 10C,B02,084115,Staff,25,0,30,5
1650057862641,MATH 18,A01,084117,Harel; Guershon,12,0,30,18
1650057862641,MATH 18,A02,084119,Harel; Guershon,27,0,30,3
1650057862641,MATH 18,A03,084120,Harel; Guershon,30,0,30,0
1650057862641,MATH 18,A04,084121,Harel; Guershon,29,0,30,1
1650057868672,MATH 20B,A01,084124,Um; Ko Woon,10,0,35,25
1650057868672,MATH 20B,B01,084126,Um; Ko Woon,24,0,35,11
1650057874696,MATH 20C,A01,083446,Hammock; Frances H,0,0,30,30
1650057874696,MATH 20C,A02,083447,Hammock; Frances H,14,0,30,16
1650057874696,MATH 20C,A03,083448,Hammock; Frances H,19,0,30,11
1650057874696,MATH 20C,A04,083449,Hammock; Frances H,20,0,30,10
1650057874696,MATH 20C,B01,083451,Hammock; Frances H,0,0,30,30
1650057874696,MATH 20C,B02,083452,Hammock; Frances H,17,0,30,13
1650057874696,MATH 20C,B03,083453,Hammock; Frances H,20,0,30,10
1650057874696,MATH 20C,B04,083454,Hammock; Frances H,23,0,30,7
1650057880732,MATH 20D,A01,084128,Staff,14,0,30,16
1650057880732,MATH 20D,A02,084129,Staff,29,0,30,1
1650057880732,MATH 20D,A03,084130,Staff,27,0,30,3
1650057880732,MATH 20D,B01,084133,Staff,0,0,30,30
1650057880732,MATH 20D,B02,084134,Staff,23,0,30,7
1650057880732,MATH 20D,B03,084135,Staff,28,0,30,2
1650057886760,MATH 20E,A01,084138,Staff,12,0,30,18
1650057886760,MATH 20E,A02,084139,Staff,6,0,30,24
1650057886760,MATH 20E,A03,084140,Staff,14,0,30,16
1650057886760,MATH 20E,A04,084141,Staff,20,0,30,10
1650057892782,MATH 102,A01,084143,Harel; Guershon,12,0,30,18
1650057892782,MATH 102,A02,084144,Harel; Guershon,19,0,30,11
1650057898899,MATH 103B,A01,083456,Staff,0,13,30,30
1650057898899,MATH 103B,A02,083457,Staff,0,14,30,30
1650057904928,MATH 109,A01,084146,Salehi Golsefidy; Alireza,17,0,30,13
1650057904928,MATH 109,A02,084147,Salehi Golsefidy; Alireza,15,0,30,15
1650057910959,MATH 120A,A01,085445,Eggers; John Dietrich,10,0,35,25
1650057910959,MATH 120A,A02,085446,Eggers; John Dietrich,27,0,35,8
1650057916987,MATH 142B,A01,084149,Verstraete; Jacques Allan,0,12,30,30
1650057916987,MATH 142B,A02,084150,Verstraete; Jacques Allan,0,12,30,30
1650057923011,MATH 170A,A01,083459,Nie; Jiawang,0,10,30,30
1650057923011,MATH 170A,A02,083460,Nie; Jiawang,0,9,30,30
1650057923011,MATH 170A,A03,083461,Nie; Jiawang,0,9,30,30
1650057929034,MATH 193B,A01,083463,Staff,1,0,30,29
1650057929034,MATH 193B,A02,083464,Staff,9,0,30,21
1650057929034,MATH 193B,A03,083465,Staff,17,0,30,13
1650057935122,COGS 2,A01,083966,Boyle; Mary E. T.,10,0,30,20
1650057941151,COGS 9,A01,083968,Staff,6,0,60,54
1650057947174,COGS 14B,A01,083970,Staff,9,0,50,41
1650057953208,COGS 17,A01,092679,Staff,50,0,75,25
1650057959239,COGS 100,A01,083972,Staff,0,17,60,60
1650057971296,COGS 101C,A01,083976,Staff,12,0,30,18
1650057977320,COGS 102A,A01,083978,Johnson; Christine M.,13,0,30,17
1650057983346,COGS 107B,A01,083980,Staff,0,8,50,50
1650057989372,COGS 115,A01,083982,Staff,10,0,30,20
1650057995398,COGS 118B,A01,083367,Staff,0,15,40,40
1650058001426,COGS 172,A01,083984,Provenzano; Emily Kara,15,0,30,15
1650058007454,COGS 177,A00,083368,Staff,0,21,30,30
1650058013479,COGS 186,A01,083986,Staff,21,0,40,19
1650058019512,COGS 187A,A01,083988,Boyle; Mary E. T.,20,0,60,40
1650058025536,CSE 8A,A50,084003,Miranda; Gregory Joseph,0,18,15,15
1650058031564,CSE 11,A01,084005,Miranda; Gregory Joseph,0,23,55,55
1650058037614,CSE 20,A01,084007,Staff,0,5,20,20
1650058043644,CSE 21,A01,084009,Staff,0,33,50,50
1650058049670,CSE 30,A01,083370,Cao; Yingjun,0,65,40,40
1650058055692,CSE 100,A01,083372,Cao; Yingjun,0,47,40,40
1650058061715,CSE 101,A01,084011,Staff,0,55,40,40
1650058067745,CSE 141,A01,083374,Eldon; John,0,65,75,75
1650058073771,CSE 141L,A01,083376,Eldon; John,0,71,75,75
1650058079802,CSE 175,A01,084013,Kumar; Rakesh,22,0,25,3
1650058085825,CSE 190,A00,092508,Dubnov; Shlomo,18,0,20,2
1650058091849,ECE 5,A01,084049,Morris; Karcher William,12,0,20,8
1650058097880,ECE 100,A01,084051,Baghdadchi; Saharnaz,0,0,20,20
1650058097880,ECE 100,A02,091916,Baghdadchi; Saharnaz,12,0,20,8
1650058103903,ECE 101,A01,084053,Baghdadchi; Saharnaz,0,0,37,37
1650058103903,ECE 101,A02,084054,Baghdadchi; Saharnaz,29,0,37,8
1650058109929,ECE 107,A01,083390,Staff,26,0,40,14
1650058115954,ECE 148,A01,084056,Silberman; Jack,8,0,12,4
1650058121977,ECE 180,A00,083391,Abi Samra; Nicholas Camill,25,0,30,5
1650058121977,ECE 180,B00,083392,Abi Samra; Nicholas Camill,21,0,30,9
1650058128003,MATH 10B,A01,084110,Staff,0,0,30,30
1650058128003,MATH 10B,A02,084111,Staff,17,0,30,13
1650058128003,MATH 10B,A03,084112,Staff,23,0,30,7
1650058134037,MATH 10C,A01,083443,Staff,0,17,30,31
1650058134037,MATH 10C,A02,083444,Staff,1,17,30,29
1650058134037,MATH 10C,B01,084114,Staff,18,0,30,12
1650058134037,MATH 10C,B02,084115,Staff,25,0,30,5
1650058140066,MATH 18,A01,084117,Harel; Guershon,12,0,30,18
1650058140066,MATH 18,A02,084119,Harel; Guershon,27,0,30,3
1650058140066,MATH 18,A03,084120,Harel; Guershon,30,0,30,0
1650058140066,MATH 18,A04,084121,Harel; Guershon,29,0,30,1
1650058146091,MATH 20B,A01,084124,Um; Ko Woon,10,0,35,25
1650058146091,MATH 20B,B01,084126,Um; Ko Woon,24,0,35,11
1650058152117,MATH 20C,A01,083446,Hammock; Frances H,0,0,30,30
1650058152117,MATH 20C,A02,083447,Hammock; Frances H,14,0,30,16
1650058152117,MATH 20C,A03,083448,Hammock; Frances H,19,0,30,11
1650058152117,MATH 20C,A04,083449,Hammock; Frances H,20,0,30,10
1650058152117,MATH 20C,B01,083451,Hammock; Frances H,0,0,30,30
1650058152117,MATH 20C,B02,083452,Hammock; Frances H,17,0,30,13
1650058152117,MATH 20C,B03,083453,Hammock; Frances H,20,0,30,10
1650058152117,MATH 20C,B04,083454,Hammock; Frances H,23,0,30,7
1650058158141,MATH 20D,A01,084128,Staff,14,0,30,16
1650058158141,MATH 20D,A02,084129,Staff,29,0,30,1
1650058158141,MATH 20D,A03,084130,Staff,27,0,30,3
1650058158141,MATH 20D,B01,084133,Staff,0,0,30,30
1650058158141,MATH 20D,B02,084134,Staff,23,0,30,7
1650058158141,MATH 20D,B03,084135,Staff,28,0,30,2
1650058164173,MATH 20E,A01,084138,Staff,12,0,30,18
1650058164173,MATH 20E,A02,084139,Staff,6,0,30,24
1650058164173,MATH 20E,A03,084140,Staff,14,0,30,16
1650058164173,MATH 20E,A04,084141,Staff,20,0,30,10
1650058170206,MATH 102,A01,084143,Harel; Guershon,12,0,30,18
1650058170206,MATH 102,A02,084144,Harel; Guershon,19,0,30,11
1650058176228,MATH 103B,A01,083456,Staff,0,13,30,30
1650058176228,MATH 103B,A02,083457,Staff,0,14,30,30
1650058182251,MATH 109,A01,084146,Salehi Golsefidy; Alireza,17,0,30,13
1650058182251,MATH 109,A02,084147,Salehi Golsefidy; Alireza,15,0,30,15
1650058188281,MATH 120A,A01,085445,Eggers; John Dietrich,9,0,35,26
1650058188281,MATH 120A,A02,085446,Eggers; John Dietrich,27,0,35,8
1650058194326,MATH 142B,A01,084149,Verstraete; Jacques Allan,0,12,30,30
1650058194326,MATH 142B,A02,084150,Verstraete; Jacques Allan,0,12,30,30
1650058200355,MATH 170A,A01,083459,Nie; Jiawang,0,10,30,30
1650058200355,MATH 170A,A02,083460,Nie; Jiawang,0,9,30,30
1650058200355,MATH 170A,A03,083461,Nie; Jiawang,0,9,30,30
1650058206384,MATH 193B,A01,083463,Staff,1,0,30,29
1650058206384,MATH 193B,A02,083464,Staff,9,0,30,21
1650058206384,MATH 193B,A03,083465,Staff,17,0,30,13
1650058212456,COGS 2,A01,083966,Boyle; Mary E. T.,10,0,30,20
1650058218487,COGS 9,A01,083968,Staff,6,0,60,54
1650058224516,COGS 14B,A01,083970,Staff,9,0,50,41
1650058230544,COGS 17,A01,092679,Staff,50,0,75,25
1650058236571,COGS 100,A01,083972,Staff,0,17,60,60
1650058248619,COGS 101C,A01,083976,Staff,12,0,30,18
1650058254644,COGS 102A,A01,083978,Johnson; Christine M.,13,0,30,17
1650058260678,COGS 107B,A01,083980,Staff,0,8,50,50
1650058266702,COGS 115,A01,083982,Staff,10,0,30,20
1650058272730,COGS 118B,A01,083367,Staff,0,15,40,40
1650058278757,COGS 172,A01,083984,Provenzano; Emily Kara,15,0,30,15
1650058284784,COGS 177,A00,083368,Staff,0,21,30,30
1650058290818,COGS 186,A01,083986,Staff,21,0,40,19
1650058296845,COGS 187A,A01,083988,Boyle; Mary E. T.,20,0,60,40
1650058302869,CSE 8A,A50,084003,Miranda; Gregory Joseph,0,18,15,15
1650058308909,CSE 11,A01,084005,Miranda; Gregory Joseph,0,23,55,55
1650058314931,CSE 20,A01,084007,Staff,0,5,20,20
1650058320960,CSE 21,A01,084009,Staff,0,33,50,50
1650058326983,CSE 30,A01,083370,Cao; Yingjun,0,65,40,40
1650058333021,CSE 100,A01,083372,Cao; Yingjun,0,47,40,40
1650058339045,CSE 101,A01,084011,Staff,0,55,40,40
1650058345068,CSE 141,A01,083374,Eldon; John,0,65,75,75
1650058351097,CSE 141L,A01,083376,Eldon; John,0,71,75,75
1650058357125,CSE 175,A01,084013,Kumar; Rakesh,22,0,25,3
1650058363148,CSE 190,A00,092508,Dubnov; Shlomo,18,0,20,2
1650058369178,ECE 5,A01,084049,Morris; Karcher William,12,0,20,8
1650058375205,ECE 100,A01,084051,Baghdadchi; Saharnaz,0,0,20,20
1650058375205,ECE 100,A02,091916,Baghdadchi; Saharnaz,12,0,20,8
1650058381237,ECE 101,A01,084053,Baghdadchi; Saharnaz,0,0,37,37
1650058381237,ECE 101,A02,084054,Baghdadchi; Saharnaz,29,0,37,8
1650058387262,ECE 107,A01,083390,Staff,26,0,40,14
1650058393287,ECE 148,A01,084056,Silberman; Jack,8,0,12,4
1650058399318,ECE 180,A00,083391,Abi Samra; Nicholas Camill,25,0,30,5
1650058399318,ECE 180,B00,083392,Abi Samra; Nicholas Camill,21,0,30,9
1650058405343,MATH 10B,A01,084110,Staff,0,0,30,30
1650058405343,MATH 10B,A02,084111,Staff,17,0,30,13
1650058405343,MATH 10B,A03,084112,Staff,23,0,30,7
1650058411373,MATH 10C,A01,083443,Staff,0,17,30,31
1650058411373,MATH 10C,A02,083444,Staff,1,17,30,29
1650058411373,MATH 10C,B01,084114,Staff,18,0,30,12
1650058411373,MATH 10C,B02,084115,Staff,25,0,30,5
1650058417397,MATH 18,A01,084117,Harel; Guershon,12,0,30,18
1650058417397,MATH 18,A02,084119,Harel; Guershon,27,0,30,3
1650058417397,MATH 18,A03,084120,Harel; Guershon,30,0,30,0
1650058417397,MATH 18,A04,084121,Harel; Guershon,29,0,30,1
1650058423420,MATH 20B,A01,084124,Um; Ko Woon,10,0,35,25
1650058423420,MATH 20B,B01,084126,Um; Ko Woon,24,0,35,11
1650058429449,MATH 20C,A01,083446,Hammock; Frances H,0,0,30,30
1650058429449,MATH 20C,A02,083447,Hammock; Frances H,14,0,30,16
1650058429449,MATH 20C,A03,083448,Hammock; Frances H,19,0,30,11
1650058429449,MATH 20C,A04,083449,Hammock; Frances H,20,0,30,10
1650058429449,MATH 20C,B01,083451,Hammock; Frances H,0,0,30,30
1650058429449,MATH 20C,B02,083452,Hammock; Frances H,17,0,30,13
1650058429449,MATH 20C,B03,083453,Hammock; Frances H,20,0,30,10
1650058429449,MATH 20C,B04,083454,Hammock; Frances H,23,0,30,7
1650058435474,MATH 20D,A01,084128,Staff,14,0,30,16
1650058435474,MATH 20D,A02,084129,Staff,29,0,30,1
1650058435474,MATH 20D,A03,084130,Staff,27,0,30,3
1650058435474,MATH 20D,B01,084133,Staff,0,0,30,30
1650058435474,MATH 20D,B02,084134,Staff,23,0,30,7
1650058435474,MATH 20D,B03,084135,Staff,28,0,30,2
1650058441498,MATH 20E,A01,084138,Staff,12,0,30,18
1650058441498,MATH 20E,A02,084139,Staff,6,0,30,24
1650058441498,MATH 20E,A03,084140,Staff,14,0,30,16
1650058441498,MATH 20E,A04,084141,Staff,20,0,30,10
1650058447533,MATH 102,A01,084143,Harel; Guershon,12,0,30,18
1650058447533,MATH 102,A02,084144,Harel; Guershon,19,0,30,11
1650058453561,MATH 103B,A01,083456,Staff,0,13,30,30
1650058453561,MATH 103B,A02,083457,Staff,0,14,30,30
1650058459587,MATH 109,A01,084146,Salehi Golsefidy; Alireza,17,0,30,13
1650058459587,MATH 109,A02,084147,Salehi Golsefidy; Alireza,15,0,30,15
1650058465611,MATH 120A,A01,085445,Eggers; John Dietrich,9,0,35,26
1650058465611,MATH 120A,A02,085446,Eggers; John Dietrich,27,0,35,8
1650058471639,MATH 142B,A01,084149,Verstraete; Jacques Allan,0,12,30,30
1650058471639,MATH 142B,A02,084150,Verstraete; Jacques Allan,0,12,30,30
1650058477672,MATH 170A,A01,083459,Nie; Jiawang,0,10,30,30
1650058477672,MATH 170A,A02,083460,Nie; Jiawang,0,9,30,30
1650058477672,MATH 170A,A03,083461,Nie; Jiawang,0,9,30,30
1650058483704,MATH 193B,A01,083463,Staff,1,0,30,29
1650058483704,MATH 193B,A02,083464,Staff,9,0,30,21
1650058483704,MATH 193B,A03,083465,Staff,17,0,30,13
1650058489852,COGS 2,A01,083966,Boyle; Mary E. T.,10,0,30,20
1650058495881,COGS 9,A01,083968,Staff,6,0,60,54
1650058501904,COGS 14B,A01,083970,Staff,9,0,50,41
1650058507932,COGS 17,A01,092679,Staff,50,0,75,25
1650058513957,COGS 100,A01,083972,Staff,0,17,60,60
1650058526009,COGS 101C,A01,083976,Staff,12,0,30,18
1650058532033,COGS 102A,A01,083978,Johnson; Christine M.,13,0,30,17
1650058538066,COGS 107B,A01,083980,Staff,0,8,50,50
1650058544094,COGS 115,A01,083982,Staff,10,0,30,20
1650058550129,COGS 118B,A01,083367,Staff,0,15,40,40
1650058556154,COGS 172,A01,083984,Provenzano; Emily Kara,15,0,30,15
1650058562177,COGS 177,A00,083368,Staff,0,21,30,30
1650058568204,COGS 186,A01,083986,Staff,21,0,40,19
1650058574233,COGS 187A,A01,083988,Boyle; Mary E. T.,20,0,60,40
1650058580270,CSE 8A,A50,084003,Miranda; Gregory Joseph,0,18,15,15
1650058586295,CSE 11,A01,084005,Miranda; Gregory Joseph,0,23,55,55
1650058592322,CSE 20,A01,084007,Staff,0,5,20,20
1650058598348,CSE 21,A01,084009,Staff,0,33,50,50
1650058604371,CSE 30,A01,083370,Cao; Yingjun,0,65,40,40
1650058610394,CSE 100,A01,083372,Cao; Yingjun,0,47,40,40
1650058616417,CSE 101,A01,084011,Staff,0,55,40,40
1650058622444,CSE 141,A01,083374,Eldon; John,0,65,75,75
1650058628475,CSE 141L,A01,083376,Eldon; John,0,71,75,75
1650058634511,CSE 175,A01,084013,Kumar; Rakesh,22,0,25,3
1650058640535,CSE 190,A00,092508,Dubnov; Shlomo,18,0,20,2
1650058646561,ECE 5,A01,084049,Morris; Karcher William,12,0,20,8
1650058652589,ECE 100,A01,084051,Baghdadchi; Saharnaz,0,0,20,20
1650058652589,ECE 100,A02,091916,Baghdadchi; Saharnaz,12,0,20,8
1650058658619,ECE 101,A01,084053,Baghdadchi; Saharnaz,0,0,37,37
1650058658619,ECE 101,A02,084054,Baghdadchi; Saharnaz,29,0,37,8
1650058664654,ECE 107,A01,083390,Staff,26,0,40,14
1650058670686,ECE 148,A01,084056,Silberman; Jack,8,0,12,4
1650058676721,ECE 180,A00,083391,Abi Samra; Nicholas Camill,25,0,30,5
1650058676721,ECE 180,B00,083392,Abi Samra; Nicholas Camill,21,0,30,9
1650058682744,MATH 10B,A01,084110,Staff,0,0,30,30
1650058682744,MATH 10B,A02,084111,Staff,17,0,30,13
1650058682744,MATH 10B,A03,084112,Staff,23,0,30,7
1650058688767,MATH 10C,A01,083443,Staff,0,17,30,31
1650058688767,MATH 10C,A02,083444,Staff,1,17,30,29
1650058688767,MATH 10C,B01,084114,Staff,18,0,30,12
1650058688767,MATH 10C,B02,084115,Staff,25,0,30,5
1650058694798,MATH 18,A01,084117,Harel; Guershon,12,0,30,18
1650058694798,MATH 18,A02,084119,Harel; Guershon,27,0,30,3
1650058694798,MATH 18,A03,084120,Harel; Guershon,30,0,30,0
1650058694798,MATH 18,A04,084121,Harel; Guershon,29,0,30,1
1650058700827,MATH 20B,A01,084124,Um; Ko Woon,10,0,35,25
1650058700827,MATH 20B,B01,084126,Um; Ko Woon,24,0,35,11
1650058706851,MATH 20C,A01,083446,Hammock; Frances H,0,0,30,30
1650058706851,MATH 20C,A02,083447,Hammock; Frances H,14,0,30,16
1650058706851,MATH 20C,A03,083448,Hammock; Frances H,19,0,30,11
1650058706851,MATH 20C,A04,083449,Hammock; Frances H,20,0,30,10
1650058706851,MATH 20C,B01,083451,Hammock; Frances H,0,0,30,30
1650058706851,MATH 20C,B02,083452,Hammock; Frances H,16,0,30,14
1650058706851,MATH 20C,B03,083453,Hammock; Frances H,20,0,30,10
1650058706851,MATH 20C,B04,083454,Hammock; Frances H,23,0,30,7
1650058712875,MATH 20D,A01,084128,Staff,14,0,30,16
1650058712875,MATH 20D,A02,084129,Staff,29,0,30,1
1650058712875,MATH 20D,A03,084130,Staff,27,0,30,3
1650058712875,MATH 20D,B01,084133,Staff,0,0,30,30
1650058712875,MATH 20D,B02,084134,Staff,23,0,30,7
1650058712875,MATH 20D,B03,084135,Staff,28,0,30,2
1650058718899,MATH 20E,A01,084138,Staff,12,0,30,18
1650058718899,MATH 20E,A02,084139,Staff,6,0,30,24
1650058718899,MATH 20E,A03,084140,Staff,14,0,30,16
1650058718899,MATH 20E,A04,084141,Staff,20,0,30,10
1650058724926,MATH 102,A01,084143,Harel; Guershon,12,0,30,18
1650058724926,MATH 102,A02,084144,Harel; Guershon,19,0,30,11
1650058730953,MATH 103B,A01,083456,Staff,0,13,30,30
1650058730953,MATH 103B,A02,083457,Staff,0,14,30,30
1650058736982,MATH 109,A01,084146,Salehi Golsefidy; Alireza,17,0,30,13
1650058736982,MATH 109,A02,084147,Salehi Golsefidy; Alireza,15,0,30,15
1650058743010,MATH 120A,A01,085445,Eggers; John Dietrich,9,0,35,26
1650058743010,MATH 120A,A02,085446,Eggers; John Dietrich,27,0,35,8
1650058749036,MATH 142B,A01,084149,Verstraete; Jacques Allan,0,12,30,30
1650058749036,MATH 142B,A02,084150,Verstraete; Jacques Allan,0,12,30,30
1650058755061,MATH 170A,A01,083459,Nie; Jiawang,0,10,30,30
1650058755061,MATH 170A,A02,083460,Nie; Jiawang,0,9,30,30
1650058755061,MATH 170A,A03,083461,Nie; Jiawang,0,9,30,30
1650058761084,MATH 193B,A01,083463,Staff,1,0,30,29
1650058761084,MATH 193B,A02,083464,Staff,9,0,30,21
1650058761084,MATH 193B,A03,083465,Staff,17,0,30,13
1650058767145,COGS 2,A01,083966,Boyle; Mary E. T.,10,0,30,20
1650058773173,COGS 9,A01,083968,Staff,6,0,60,54
1650058779198,COGS 14B,A01,083970,Staff,9,0,50,41
1650058785222,COGS 17,A01,092679,Staff,50,0,75,25
1650058791246,COGS 100,A01,083972,Staff,0,17,60,60
1650058803300,COGS 101C,A01,083976,Staff,12,0,30,18
1650058809325,COGS 102A,A01,083978,Johnson; Christine M.,13,0,30,17
1650058815352,COGS 107B,A01,083980,Staff,0,8,50,50
1650058821387,COGS 115,A01,083982,Staff,10,0,30,20
1650058827411,COGS 118B,A01,083367,Staff,0,15,40,40
1650058833442,COGS 172,A01,083984,Provenzano; Emily Kara,15,0,30,15
1650058839465,COGS 177,A00,083368,Staff,0,21,30,30
1650058845505,COGS 186,A01,083986,Staff,21,0,40,19
1650058851545,COGS 187A,A01,083988,Boyle; Mary E. T.,20,0,60,40
1650058857570,CSE 8A,A50,084003,Miranda; Gregory Joseph,0,18,15,15
1650058863606,CSE 11,A01,084005,Miranda; Gregory Joseph,0,23,55,55
1650058869630,CSE 20,A01,084007,Staff,0,5,20,20
1650058875654,CSE 21,A01,084009,Staff,0,33,50,50
1650058881680,CSE 30,A01,083370,Cao; Yingjun,0,65,40,40
1650058887722,CSE 100,A01,083372,Cao; Yingjun,0,47,40,40
1650058893759,CSE 101,A01,084011,Staff,0,55,40,40
1650058899782,CSE 141,A01,083374,Eldon; John,0,65,75,75
1650058905806,CSE 141L,A01,083376,Eldon; John,0,71,75,75
1650058911831,CSE 175,A01,084013,Kumar; Rakesh,22,0,25,3
1650058917857,CSE 190,A00,092508,Dubnov; Shlomo,18,0,20,2
1650058923885,ECE 5,A01,084049,Morris; Karcher William,12,0,20,8
1650058929923,ECE 100,A01,084051,Baghdadchi; Saharnaz,0,0,20,20
1650058929923,ECE 100,A02,091916,Baghdadchi; Saharnaz,12,0,20,8
1650058935950,ECE 101,A01,084053,Baghdadchi; Saharnaz,0,0,37,37
1650058935950,ECE 101,A02,084054,Baghdadchi; Saharnaz,29,0,37,8
1650058941973,ECE 107,A01,083390,Staff,26,0,40,14
1650058948000,ECE 148,A01,084056,Silberman; Jack,8,0,12,4
1650058954025,ECE 180,A00,083391,Abi Samra; Nicholas Camill,25,0,30,5
1650058954025,ECE 180,B00,083392,Abi Samra; Nicholas Camill,21,0,30,9
1650058960053,MATH 10B,A01,084110,Staff,0,0,30,30
1650058960053,MATH 10B,A02,084111,Staff,17,0,30,13
1650058960053,MATH 10B,A03,084112,Staff,23,0,30,7
1650058966078,MATH 10C,A01,083443,Staff,0,17,30,31
1650058966078,MATH 10C,A02,083444,Staff,1,17,30,29
1650058966078,MATH 10C,B01,084114,Staff,18,0,30,12
1650058966078,MATH 10C,B02,084115,Staff,25,0,30,5
1650058972108,MATH 18,A01,084117,Harel; Guershon,12,0,30,18
1650058972108,MATH 18,A02,084119,Harel; Guershon,27,0,30,3
1650058972108,MATH 18,A03,084120,Harel; Guershon,30,0,30,0
1650058972108,MATH 18,A04,084121,Harel; Guershon,29,0,30,1
1650058978135,MATH 20B,A01,084124,Um; Ko Woon,10,0,35,25
1650058978135,MATH 20B,B01,084126,Um; Ko Woon,24,0,35,11
1650058984174,MATH 20C,A01,083446,Hammock; Frances H,0,0,30,30
1650058984174,MATH 20C,A02,083447,Hammock; Frances H,14,0,30,16
1650058984174,MATH 20C,A03,083448,Hammock; Frances H,19,0,30,11
1650058984174,MATH 20C,A04,083449,Hammock; Frances H,20,0,30,10
1650058984174,MATH 20C,B01,083451,Hammock; Frances H,0,0,30,30
1650058984174,MATH 20C,B02,083452,Hammock; Frances H,16,0,30,14
1650058984174,MATH 20C,B03,083453,Hammock; Frances H,20,0,30,10
1650058984174,MATH 20C,B04,083454,Hammock; Frances H,23,0,30,7
1650058990200,MATH 20D,A01,084128,Staff,14,0,30,16
1650058990200,MATH 20D,A02,084129,Staff,29,0,30,1
1650058990200,MATH 20D,A03,084130,Staff,27,0,30,3
1650058990200,MATH 20D,B01,084133,Staff,0,0,30,30
1650058990200,MATH 20D,B02,084134,Staff,23,0,30,7
1650058990200,MATH 20D,B03,084135,Staff,28,0,30,2
1650058996224,MATH 20E,A01,084138,Staff,12,0,30,18
1650058996224,MATH 20E,A02,084139,Staff,6,0,30,24
1650058996224,MATH 20E,A03,084140,Staff,14,0,30,16
1650058996224,MATH 20E,A04,084141,Staff,20,0,30,10
1650059002252,MATH 102,A01,084143,Harel; Guershon,12,0,30,18
1650059002252,MATH 102,A02,084144,Harel; Guershon,19,0,30,11
1650059008278,MATH 103B,A01,083456,Staff,0,13,30,30
1650059008278,MATH 103B,A02,083457,Staff,0,14,30,30
1650059014301,MATH 109,A01,084146,Salehi Golsefidy; Alireza,17,0,30,13
1650059014301,MATH 109,A02,084147,Salehi Golsefidy; Alireza,15,0,30,15
1650059020329,MATH 120A,A01,085445,Eggers; John Dietrich,9,0,35,26
1650059020329,MATH 120A,A02,085446,Eggers; John Dietrich,27,0,35,8
1650059026359,MATH 142B,A01,084149,Verstraete; Jacques Allan,0,12,30,30
1650059026359,MATH 142B,A02,084150,Verstraete; Jacques Allan,0,12,30,30
1650059032383,MATH 170A,A01,083459,Nie; Jiawang,0,10,30,30
1650059032383,MATH 170A,A02,083460,Nie; Jiawang,0,9,30,30
1650059032383,MATH 170A,A03,083461,Nie; Jiawang,0,9,30,30
1650059038407,MATH 193B,A01,083463,Staff,1,0,30,29
1650059038407,MATH 193B,A02,083464,Staff,9,0,30,21
1650059038407,MATH 193B,A03,083465,Staff,17,0,30,13
1650059044459,COGS 2,A01,083966,Boyle; Mary E. T.,10,0,30,20
1650059050486,COGS 9,A01,083968,Staff,6,0,60,54
1650059056528,COGS 14B,A01,083970,Staff,9,0,50,41
1650059062554,COGS 17,A01,092679,Staff,50,0,75,25
1650059068581,COGS 100,A01,083972,Staff,0,17,60,60
1650059080641,COGS 101C,A01,083976,Staff,12,0,30,18
1650059086753,COGS 102A,A01,083978,Johnson; Christine M.,13,0,30,17
1650059092782,COGS 107B,A01,083980,Staff,0,8,50,50
1650059098814,COGS 115,A01,083982,Staff,10,0,30,20
1650059104836,COGS 118B,A01,083367,Staff,0,15,40,40
1650059110863,COGS 172,A01,083984,Provenzano; Emily Kara,15,0,30,15
1650059116886,COGS 177,A00,083368,Staff,0,21,30,30
1650059122914,COGS 186,A01,083986,Staff,21,0,40,19
1650059128942,COGS 187A,A01,083988,Boyle; Mary E. T.,20,0,60,40
1650059134966,CSE 8A,A50,084003,Miranda; Gregory Joseph,0,18,15,15
1650059140990,CSE 11,A01,084005,Miranda; Gregory Joseph,0,23,55,55
1650059147027,CSE 20,A01,084007,Staff,0,5,20,20
1650059153051,CSE 21,A01,084009,Staff,1,33,50,49
1650059159074,CSE 30,A01,083370,Cao; Yingjun,0,64,40,40
1650059165107,CSE 100,A01,083372,Cao; Yingjun,0,47,40,40
1650059171129,CSE 101,A01,084011,Staff,0,55,40,40
1650059177155,CSE 141,A01,083374,Eldon; John,0,65,75,75
1650059183181,CSE 141L,A01,083376,Eldon; John,0,71,75,75
1650059189205,CSE 175,A01,084013,Kumar; Rakesh,22,0,25,3
1650059195229,CSE 190,A00,092508,Dubnov; Shlomo,18,0,20,2
1650059201268,ECE 5,A01,084049,Morris; Karcher William,12,0,20,8
1650059207292,ECE 100,A01,084051,Baghdadchi; Saharnaz,0,0,20,20
1650059207292,ECE 100,A02,091916,Baghdadchi; Saharnaz,12,0,20,8
1650059213324,ECE 101,A01,084053,Baghdadchi; Saharnaz,0,0,37,37
1650059213324,ECE 101,A02,084054,Baghdadchi; Saharnaz,29,0,37,8
1650059219348,ECE 107,A01,083390,Staff,26,0,40,14
1650059225380,ECE 148,A01,084056,Silberman; Jack,8,0,12,4
1650059231401,ECE 180,A00,083391,Abi Samra; Nicholas Camill,25,0,30,5
1650059231401,ECE 180,B00,083392,Abi Samra; Nicholas Camill,21,0,30,9
1650059237424,MATH 10B,A01,084110,Staff,0,0,30,30
1650059237424,MATH 10B,A02,084111,Staff,17,0,30,13
1650059237424,MATH 10B,A03,084112,Staff,23,0,30,7
1650059243452,MATH 10C,A01,083443,Staff,0,17,30,31
1650059243452,MATH 10C,A02,083444,Staff,1,17,30,29
1650059243452,MATH 10C,B01,084114,Staff,18,0,30,12
1650059243452,MATH 10C,B02,084115,Staff,25,0,30,5
1650059249476,MATH 18,A01,084117,Harel; Guershon,12,0,30,18
1650059249476,MATH 18,A02,084119,Harel; Guershon,27,0,30,3
1650059249476,MATH 18,A03,084120,Harel; Guershon,30,0,30,0
1650059249476,MATH 18,A04,084121,Harel; Guershon,29,0,30,1
1650059255500,MATH 20B,A01,084124,Um; Ko Woon,10,0,35,25
1650059255500,MATH 20B,B01,084126,Um; Ko Woon,24,0,35,11
1650059261540,MATH 20C,A01,083446,Hammock; Frances H,0,0,30,30
1650059261540,MATH 20C,A02,083447,Hammock; Frances H,14,0,30,16
1650059261540,MATH 20C,A03,083448,Hammock; Frances H,19,0,30,11
1650059261540,MATH 20C,A04,083449,Hammock; Frances H,20,0,30,10
1650059261540,MATH 20C,B01,083451,Hammock; Frances H,0,0,30,30
1650059261540,MATH 20C,B02,083452,Hammock; Frances H,16,0,30,14
1650059261540,MATH 20C,B03,083453,Hammock; Frances H,20,0,30,10
1650059261540,MATH 20C,B04,083454,Hammock; Frances H,23,0,30,7
1650059267575,MATH 20D,A01,084128,Staff,14,0,30,16
1650059267575,MATH 20D,A02,084129,Staff,29,0,30,1
1650059267575,MATH 20D,A03,084130,Staff,27,0,30,3
1650059267575,MATH 20D,B01,084133,Staff,0,0,30,30
1650059267575,MATH 20D,B02,084134,Staff,23,0,30,7
1650059267575,MATH 20D,B03,084135,Staff,28,0,30,2
1650059273615,MATH 20E,A01,084138,Staff,12,0,30,18
1650059273615,MATH 20E,A02,084139,Staff,6,0,30,24
1650059273615,MATH 20E,A03,084140,Staff,14,0,30,16
1650059273615,MATH 20E,A04,084141,Staff,20,0,30,10
1650059279641,MATH 102,A01,084143,Harel; Guershon,12,0,30,18
1650059279641,MATH 102,A02,084144,Harel; Guershon,19,0,30,11
1650059285663,MATH 103B,A01,083456,Staff,0,13,30,30
1650059285663,MATH 103B,A02,083457,Staff,0,14,30,30
1650059291696,MATH 109,A01,084146,Salehi Golsefidy; Alireza,17,0,30,13
1650059291696,MATH 109,A02,084147,Salehi Golsefidy; Alireza,15,0,30,15
1650059297725,MATH 120A,A01,085445,Eggers; John Dietrich,9,0,35,26
1650059297725,MATH 120A,A02,085446,Eggers; John Dietrich,27,0,35,8
1650059303747,MATH 142B,A01,084149,Verstraete; Jacques Allan,0,12,30,30
1650059303747,MATH 142B,A02,084150,Verstraete; Jacques Allan,0,12,30,30
1650059309773,MATH 170A,A01,083459,Nie; Jiawang,0,10,30,30
1650059309773,MATH 170A,A02,083460,Nie; Jiawang,0,9,30,30
1650059309773,MATH 170A,A03,083461,Nie; Jiawang,0,9,30,30
1650059315797,MATH 193B,A01,083463,Staff,1,0,30,29
1650059315797,MATH 193B,A02,083464,Staff,9,0,30,21
1650059315797,MATH 193B,A03,083465,Staff,17,0,30,13
1650059321921,COGS 2,A01,083966,Boyle; Mary E. T.,10,0,30,20
1650059327947,COGS 9,A01,083968,Staff,6,0,60,54
1650059333978,COGS 14B,A01,083970,Staff,9,0,50,41
1650059340012,COGS 17,A01,092679,Staff,50,0,75,25
1650059346046,COGS 100,A01,083972,Staff,0,17,60,60
1650059358107,COGS 101C,A01,083976,Staff,12,0,30,18
1650059364130,COGS 102A,A01,083978,Johnson; Christine M.,13,0,30,17
1650059370164,COGS 107B,A01,083980,Staff,0,8,50,50
1650059376186,COGS 115,A01,083982,Staff,10,0,30,20
1650059382209,COGS 118B,A01,083367,Staff,0,15,40,40
1650059388242,COGS 172,A01,083984,Provenzano; Emily Kara,15,0,30,15
1650059394267,COGS 177,A00,083368,Staff,0,21,30,30
1650059400303,COGS 186,A01,083986,Staff,21,0,40,19
1650059406326,COGS 187A,A01,083988,Boyle; Mary E. T.,20,0,60,40
1650059412352,CSE 8A,A50,084003,Miranda; Gregory Joseph,0,18,15,15
1650059418378,CSE 11,A01,084005,Miranda; Gregory Joseph,0,23,55,55
1650059424405,CSE 20,A01,084007,Staff,0,5,20,20
1650059430432,CSE 21,A01,084009,Staff,1,33,50,49
1650059436460,CSE 30,A01,083370,Cao; Yingjun,0,64,40,40
1650059442494,CSE 100,A01,083372,Cao; Yingjun,0,47,40,40
1650059448520,CSE 101,A01,084011,Staff,0,55,40,40
1650059454547,CSE 141,A01,083374,Eldon; John,0,65,75,75
1650059460575,CSE 141L,A01,083376,Eldon; John,0,71,75,75
1650059466601,CSE 175,A01,084013,Kumar; Rakesh,22,0,25,3
1650059472625,CSE 190,A00,092508,Dubnov; Shlomo,18,0,20,2
1650059478649,ECE 5,A01,084049,Morris; Karcher William,12,0,20,8
1650059484676,ECE 100,A01,084051,Baghdadchi; Saharnaz,0,0,20,20
1650059484676,ECE 100,A02,091916,Baghdadchi; Saharnaz,12,0,20,8
1650059490714,ECE 101,A01,084053,Baghdadchi; Saharnaz,0,0,37,37
1650059490714,ECE 101,A02,084054,Baghdadchi; Saharnaz,29,0,37,8
1650059496738,ECE 107,A01,083390,Staff,26,0,40,14
1650059502771,ECE 148,A01,084056,Silberman; Jack,8,0,12,4
1650059508794,ECE 180,A00,083391,Abi Samra; Nicholas Camill,25,0,30,5
1650059508794,ECE 180,B00,083392,Abi Samra; Nicholas Camill,21,0,30,9
1650059514818,MATH 10B,A01,084110,Staff,0,0,30,30
1650059514818,MATH 10B,A02,084111,Staff,17,0,30,13
1650059514818,MATH 10B,A03,084112,Staff,23,0,30,7
1650059520840,MATH 10C,A01,083443,Staff,0,17,30,31
1650059520840,MATH 10C,A02,083444,Staff,1,17,30,29
1650059520840,MATH 10C,B01,084114,Staff,18,0,30,12
1650059520840,MATH 10C,B02,084115,Staff,25,0,30,5
1650059526880,MATH 18,A01,084117,Harel; Guershon,12,0,30,18
1650059526880,MATH 18,A02,084119,Harel; Guershon,27,0,30,3
1650059526880,MATH 18,A03,084120,Harel; Guershon,30,0,30,0
1650059526880,MATH 18,A04,084121,Harel; Guershon,29,0,30,1
1650059532904,MATH 20B,A01,084124,Um; Ko Woon,10,0,35,25
1650059532904,MATH 20B,B01,084126,Um; Ko Woon,24,0,35,11
1650059538935,MATH 20C,A01,083446,Hammock; Frances H,0,0,30,30
1650059538935,MATH 20C,A02,083447,Hammock; Frances H,14,0,30,16
1650059538935,MATH 20C,A03,083448,Hammock; Frances H,19,0,30,11
1650059538935,MATH 20C,A04,083449,Hammock; Frances H,20,0,30,10
1650059538935,MATH 20C,B01,083451,Hammock; Frances H,0,0,30,30
1650059538935,MATH 20C,B02,083452,Hammock; Frances H,16,0,30,14
1650059538935,MATH 20C,B03,083453,Hammock; Frances H,20,0,30,10
1650059538935,MATH 20C,B04,083454,Hammock; Frances H,23,0,30,7
1650059544957,MATH 20D,A01,084128,Staff,14,0,30,16
1650059544957,MATH 20D,A02,084129,Staff,29,0,30,1
1650059544957,MATH 20D,A03,084130,Staff,27,0,30,3
1650059544957,MATH 20D,B01,084133,Staff,0,0,30,30
1650059544957,MATH 20D,B02,084134,Staff,23,0,30,7
1650059544957,MATH 20D,B03,084135,Staff,28,0,30,2
1650059550984,MATH 20E,A01,084138,Staff,12,0,30,18
1650059550984,MATH 20E,A02,084139,Staff,6,0,30,24
1650059550984,MATH 20E,A03,084140,Staff,14,0,30,16
1650059550984,MATH 20E,A04,084141,Staff,20,0,30,10
1650059557015,MATH 102,A01,084143,Harel; Guershon,12,0,30,18
1650059557015,MATH 102,A02,084144,Harel; Guershon,19,0,30,11
1650059563049,MATH 103B,A01,083456,Staff,0,13,30,30
1650059563049,MATH 103B,A02,083457,Staff,0,14,30,30
1650059569075,MATH 109,A01,084146,Salehi Golsefidy; Alireza,17,0,30,13
1650059569075,MATH 109,A02,084147,Salehi Golsefidy; Alireza,15,0,30,15
1650059575097,MATH 120A,A01,085445,Eggers; John Dietrich,9,0,35,26
1650059575097,MATH 120A,A02,085446,Eggers; John Dietrich,27,0,35,8
1650059581123,MATH 142B,A01,084149,Verstraete; Jacques Allan,0,12,30,30
1650059581123,MATH 142B,A02,084150,Verstraete; Jacques Allan,0,12,30,30
1650059587150,MATH 170A,A01,083459,Nie; Jiawang,0,10,30,30
1650059587150,MATH 170A,A02,083460,Nie; Jiawang,0,9,30,30
1650059587150,MATH 170A,A03,083461,Nie; Jiawang,0,9,30,30
1650059593179,MATH 193B,A01,083463,Staff,1,0,30,29
1650059593179,MATH 193B,A02,083464,Staff,9,0,30,21
1650059593179,MATH 193B,A03,083465,Staff,17,0,30,13
1650059599237,COGS 2,A01,083966,Boyle; Mary E. T.,10,0,30,20
1650059605263,COGS 9,A01,083968,Staff,6,0,60,54
1650059611289,COGS 14B,A01,083970,Staff,9,0,50,41
1650059617323,COGS 17,A01,092679,Staff,50,0,75,25
1650059623350,COGS 100,A01,083972,Staff,0,17,60,60
1650059635409,COGS 101C,A01,083976,Staff,12,0,30,18
1650059641443,COGS 102A,A01,083978,Johnson; Christine M.,13,0,30,17
1650059647473,COGS 107B,A01,083980,Staff,0,8,50,50
1650059653496,COGS 115,A01,083982,Staff,10,0,30,20
1650059659520,COGS 118B,A01,083367,Staff,0,15,40,40
1650059665548,COGS 172,A01,083984,Provenzano; Emily Kara,15,0,30,15
1650059671572,COGS 177,A00,083368,Staff,0,21,30,30
1650059677604,COGS 186,A01,083986,Staff,21,0,40,19
1650059683736,COGS 187A,A01,083988,Boyle; Mary E. T.,20,0,60,40
1650059689770,CSE 8A,A50,084003,Miranda; Gregory Joseph,0,18,15,15
1650059695801,CSE 11,A01,084005,Miranda; Gregory Joseph,0,23,55,55
1650059701827,CSE 20,A01,084007,Staff,0,5,20,20
1650059707853,CSE 21,A01,084009,Staff,1,33,50,49
1650059713876,CSE 30,A01,083370,Cao; Yingjun,0,64,40,40
1650059719914,CSE 100,A01,083372,Cao; Yingjun,0,47,40,40
1650059725939,CSE 101,A01,084011,Staff,0,55,40,40
1650059731963,CSE 141,A01,083374,Eldon; John,0,65,75,75
1650059737989,CSE 141L,A01,083376,Eldon; John,0,71,75,75
1650059744013,CSE 175,A01,084013,Kumar; Rakesh,22,0,25,3
1650059750040,CSE 190,A00,092508,Dubnov; Shlomo,18,0,20,2
1650059756066,ECE 5,A01,084049,Morris; Karcher William,12,0,20,8
1650059762099,ECE 100,A01,084051,Baghdadchi; Saharnaz,0,0,20,20
1650059762099,ECE 100,A02,091916,Baghdadchi; Saharnaz,12,0,20,8
1650059768131,ECE 101,A01,084053,Baghdadchi; Saharnaz,0,0,37,37
1650059768131,ECE 101,A02,084054,Baghdadchi; Saharnaz,29,0,37,8
1650059774162,ECE 107,A01,083390,Staff,26,0,40,14
1650059780191,ECE 148,A01,084056,Silberman; Jack,8,0,12,4
1650059786228,ECE 180,A00,083391,Abi Samra; Nicholas Camill,25,0,30,5
1650059786228,ECE 180,B00,083392,Abi Samra; Nicholas Camill,21,0,30,9
1650059792252,MATH 10B,A01,084110,Staff,0,0,30,30
1650059792252,MATH 10B,A02,084111,Staff,17,0,30,13
1650059792252,MATH 10B,A03,084112,Staff,23,0,30,7
1650059798284,MATH 10C,A01,083443,Staff,0,17,30,31
1650059798284,MATH 10C,A02,083444,Staff,1,17,30,29
1650059798284,MATH 10C,B01,084114,Staff,18,0,30,12
1650059798284,MATH 10C,B02,084115,Staff,25,0,30,5
1650059804308,MATH 18,A01,084117,Harel; Guershon,12,0,30,18
1650059804308,MATH 18,A02,084119,Harel; Guershon,27,0,30,3
1650059804308,MATH 18,A03,084120,Harel; Guershon,30,0,30,0
1650059804308,MATH 18,A04,084121,Harel; Guershon,29,0,30,1
1650059810336,MATH 20B,A01,084124,Um; Ko Woon,10,0,35,25
1650059810336,MATH 20B,B01,084126,Um; Ko Woon,24,0,35,11
1650059816360,MATH 20C,A01,083446,Hammock; Frances H,0,0,30,30
1650059816360,MATH 20C,A02,083447,Hammock; Frances H,14,0,30,16
1650059816360,MATH 20C,A03,083448,Hammock; Frances H,19,0,30,11
1650059816360,MATH 20C,A04,083449,Hammock; Frances H,20,0,30,10
1650059816360,MATH 20C,B01,083451,Hammock; Frances H,0,0,30,30
1650059816360,MATH 20C,B02,083452,Hammock; Frances H,16,0,30,14
1650059816360,MATH 20C,B03,083453,Hammock; Frances H,20,0,30,10
1650059816360,MATH 20C,B04,083454,Hammock; Frances H,23,0,30,7
1650059822386,MATH 20D,A01,084128,Staff,14,0,30,16
1650059822386,MATH 20D,A02,084129,Staff,29,0,30,1
1650059822386,MATH 20D,A03,084130,Staff,27,0,30,3
1650059822386,MATH 20D,B01,084133,Staff,0,0,30,30
1650059822386,MATH 20D,B02,084134,Staff,23,0,30,7
1650059822386,MATH 20D,B03,084135,Staff,28,0,30,2
1650059828413,MATH 20E,A01,084138,Staff,12,0,30,18
1650059828413,MATH 20E,A02,084139,Staff,6,0,30,24
1650059828413,MATH 20E,A03,084140,Staff,14,0,30,16
1650059828413,MATH 20E,A04,084141,Staff,20,0,30,10
1650059834441,MATH 102,A01,084143,Harel; Guershon,12,0,30,18
1650059834441,MATH 102,A02,084144,Harel; Guershon,19,0,30,11
1650059840471,MATH 103B,A01,083456,Staff,0,13,30,30
1650059840471,MATH 103B,A02,083457,Staff,0,14,30,30
1650059846496,MATH 109,A01,084146,Salehi Golsefidy; Alireza,17,0,30,13
1650059846496,MATH 109,A02,084147,Salehi Golsefidy; Alireza,15,0,30,15
1650059852521,MATH 120A,A01,085445,Eggers; John Dietrich,9,0,35,26
1650059852521,MATH 120A,A02,085446,Eggers; John Dietrich,27,0,35,8
1650059858548,MATH 142B,A01,084149,Verstraete; Jacques Allan,0,12,30,30
1650059858548,MATH 142B,A02,084150,Verstraete; Jacques Allan,0,12,30,30
1650059864571,MATH 170A,A01,083459,Nie; Jiawang,0,10,30,30
1650059864571,MATH 170A,A02,083460,Nie; Jiawang,0,9,30,30
1650059864571,MATH 170A,A03,083461,Nie; Jiawang,0,9,30,30
1650059870598,MATH 193B,A01,083463,Staff,1,0,30,29
1650059870598,MATH 193B,A02,083464,Staff,9,0,30,21
1650059870598,MATH 193B,A03,083465,Staff,17,0,30,13
1650059876676,COGS 2,A01,083966,Boyle; Mary E. T.,10,0,30,20
1650059882706,COGS 9,A01,083968,Staff,6,0,60,54
1650059888733,COGS 14B,A01,083970,Staff,9,0,50,41
1650059894758,COGS 17,A01,092679,Staff,50,0,75,25
1650059900781,COGS 100,A01,083972,Staff,0,17,60,60
1650059912833,COGS 101C,A01,083976,Staff,12,0,30,18
1650059918861,COGS 102A,A01,083978,Johnson; Christine M.,13,0,30,17
1650059924886,COGS 107B,A01,083980,Staff,0,8,50,50
1650059930915,COGS 115,A01,083982,Staff,10,0,30,20
1650059936939,COGS 118B,A01,083367,Staff,0,15,40,40
1650059942970,COGS 172,A01,083984,Provenzano; Emily Kara,15,0,30,15
1650059948994,COGS 177,A00,083368,Staff,0,21,30,30
1650059955020,COGS 186,A01,083986,Staff,21,0,40,19
1650059961054,COGS 187A,A01,083988,Boyle; Mary E. T.,20,0,60,40
1650059967090,CSE 8A,A50,084003,Miranda; Gregory Joseph,0,18,15,15
1650059973112,CSE 11,A01,084005,Miranda; Gregory Joseph,0,23,55,55
1650059979138,CSE 20,A01,084007,Staff,0,5,20,20
1650059985162,CSE 21,A01,084009,Staff,1,33,50,49
1650059991189,CSE 30,A01,083370,Cao; Yingjun,0,64,40,40
1650059997226,CSE 100,A01,083372,Cao; Yingjun,0,47,40,40
1650060003248,CSE 101,A01,084011,Staff,0,55,40,40
1650060009280,CSE 141,A01,083374,Eldon; John,0,65,75,75
1650060015309,CSE 141L,A01,083376,Eldon; John,0,71,75,75
1650060021347,CSE 175,A01,084013,Kumar; Rakesh,22,0,25,3
1650060027373,CSE 190,A00,092508,Dubnov; Shlomo,18,0,20,2
1650060033398,ECE 5,A01,084049,Morris; Karcher William,12,0,20,8
1650060039421,ECE 100,A01,084051,Baghdadchi; Saharnaz,0,0,20,20
1650060039421,ECE 100,A02,091916,Baghdadchi; Saharnaz,12,0,20,8
1650060045444,ECE 101,A01,084053,Baghdadchi; Saharnaz,0,0,37,37
1650060045444,ECE 101,A02,084054,Baghdadchi; Saharnaz,29,0,37,8
1650060051491,ECE 107,A01,083390,Staff,26,0,40,14
1650060057514,ECE 148,A01,084056,Silberman; Jack,8,0,12,4
1650060063539,ECE 180,A00,083391,Abi Samra; Nicholas Camill,25,0,30,5
1650060063539,ECE 180,B00,083392,Abi Samra; Nicholas Camill,21,0,30,9
1650060069563,MATH 10B,A01,084110,Staff,0,0,30,30
1650060069563,MATH 10B,A02,084111,Staff,17,0,30,13
1650060069563,MATH 10B,A03,084112,Staff,23,0,30,7
1650060075604,MATH 10C,A01,083443,Staff,0,17,30,31
1650060075604,MATH 10C,A02,083444,Staff,1,17,30,29
1650060075604,MATH 10C,B01,084114,Staff,18,0,30,12
1650060075604,MATH 10C,B02,084115,Staff,25,0,30,5
1650060081645,MATH 18,A01,084117,Harel; Guershon,12,0,30,18
1650060081645,MATH 18,A02,084119,Harel; Guershon,27,0,30,3
1650060081645,MATH 18,A03,084120,Harel; Guershon,30,0,30,0
1650060081645,MATH 18,A04,084121,Harel; Guershon,29,0,30,1
1650060087677,MATH 20B,A01,084124,Um; Ko Woon,10,0,35,25
1650060087677,MATH 20B,B01,084126,Um; Ko Woon,24,0,35,11
1650060093715,MATH 20C,A01,083446,Hammock; Frances H,0,0,30,30
1650060093715,MATH 20C,A02,083447,Hammock; Frances H,14,0,30,16
1650060093715,MATH 20C,A03,083448,Hammock; Frances H,19,0,30,11
1650060093715,MATH 20C,A04,083449,Hammock; Frances H,20,0,30,10
1650060093715,MATH 20C,B01,083451,Hammock; Frances H,0,0,30,30
1650060093715,MATH 20C,B02,083452,Hammock; Frances H,16,0,30,14
1650060093715,MATH 20C,B03,083453,Hammock; Frances H,20,0,30,10
1650060093715,MATH 20C,B04,083454,Hammock; Frances H,23,0,30,7
1650060099740,MATH 20D,A01,084128,Staff,14,0,30,16
1650060099740,MATH 20D,A02,084129,Staff,29,0,30,1
1650060099740,MATH 20D,A03,084130,Staff,27,0,30,3
1650060099740,MATH 20D,B01,084133,Staff,0,0,30,30
1650060099740,MATH 20D,B02,084134,Staff,23,0,30,7
1650060099740,MATH 20D,B03,084135,Staff,28,0,30,2
1650060105767,MATH 20E,A01,084138,Staff,12,0,30,18
1650060105767,MATH 20E,A02,084139,Staff,6,0,30,24
1650060105767,MATH 20E,A03,084140,Staff,14,0,30,16
1650060105767,MATH 20E,A04,084141,Staff,20,0,30,10
1650060111791,MATH 102,A01,084143,Harel; Guershon,12,0,30,18
1650060111791,MATH 102,A02,084144,Harel; Guershon,19,0,30,11
1650060117813,MATH 103B,A01,083456,Staff,0,13,30,30
1650060117813,MATH 103B,A02,083457,Staff,0,14,30,30
1650060123837,MATH 109,A01,084146,Salehi Golsefidy; Alireza,17,0,30,13
1650060123837,MATH 109,A02,084147,Salehi Golsefidy; Alireza,15,0,30,15
1650060129860,MATH 120A,A01,085445,Eggers; John Dietrich,9,0,35,26
1650060129860,MATH 120A,A02,085446,Eggers; John Dietrich,27,0,35,8
1650060135883,MATH 142B,A01,084149,Verstraete; Jacques Allan,0,12,30,30
1650060135883,MATH 142B,A02,084150,Verstraete; Jacques Allan,0,12,30,30
1650060141907,MATH 170A,A01,083459,Nie; Jiawang,0,10,30,30
1650060141907,MATH 170A,A02,083460,Nie; Jiawang,0,9,30,30
1650060141907,MATH 170A,A03,083461,Nie; Jiawang,0,9,30,30
1650060147931,MATH 193B,A01,083463,Staff,1,0,30,29
1650060147931,MATH 193B,A02,083464,Staff,9,0,30,21
1650060147931,MATH 193B,A03,083465,Staff,17,0,30,13
1650060153981,COGS 2,A01,083966,Boyle; Mary E. T.,10,0,30,20
1650060160007,COGS 9,A01,083968,Staff,6,0,60,54
1650060166029,COGS 14B,A01,083970,Staff,9,0,50,41
1650060172066,COGS 17,A01,092679,Staff,50,0,75,25
1650060178087,COGS 100,A01,083972,Staff,0,17,60,60
1650060190138,COGS 101C,A01,083976,Staff,12,0,30,18
1650060196163,COGS 102A,A01,083978,Johnson; Christine M.,13,0,30,17
1650060202186,COGS 107B,A01,083980,Staff,0,8,50,50
1650060208211,COGS 115,A01,083982,Staff,10,0,30,20
1650060214238,COGS 118B,A01,083367,Staff,0,15,40,40
1650060220261,COGS 172,A01,083984,Provenzano; Emily Kara,15,0,30,15
1650060226289,COGS 177,A00,083368,Staff,0,21,30,30
1650060232311,COGS 186,A01,083986,Staff,21,0,40,19
1650060238335,COGS 187A,A01,083988,Boyle; Mary E. T.,20,0,60,40
1650060244372,CSE 8A,A50,084003,Miranda; Gregory Joseph,0,18,15,15
1650060250395,CSE 11,A01,084005,Miranda; Gregory Joseph,0,23,55,55
1650060256419,CSE 20,A01,084007,Staff,0,5,20,20
1650060262445,CSE 21,A01,084009,Staff,1,33,50,49
1650060268469,CSE 30,A01,083370,Cao; Yingjun,0,64,40,40
1650060274504,CSE 100,A01,083372,Cao; Yingjun,0,47,40,40
1650060280618,CSE 101,A01,084011,Staff,0,55,40,40
1650060286644,CSE 141,A01,083374,Eldon; John,0,65,75,75
1650060292673,CSE 141L,A01,083376,Eldon; John,0,71,75,75
1650060298708,CSE 175,A01,084013,Kumar; Rakesh,22,0,25,3
1650060304739,CSE 190,A00,092508,Dubnov; Shlomo,18,0,20,2
1650060310776,ECE 5,A01,084049,Morris; Karcher William,12,0,20,8
1650060316803,ECE 100,A01,084051,Baghdadchi; Saharnaz,0,0,20,20
1650060316803,ECE 100,A02,091916,Baghdadchi; Saharnaz,12,0,20,8
1650060322832,ECE 101,A01,084053,Baghdadchi; Saharnaz,0,0,37,37
1650060322832,ECE 101,A02,084054,Baghdadchi; Saharnaz,29,0,37,8
1650060328866,ECE 107,A01,083390,Staff,26,0,40,14
1650060334895,ECE 148,A01,084056,Silberman; Jack,8,0,12,4
1650060340923,ECE 180,A00,083391,Abi Samra; Nicholas Camill,25,0,30,5
1650060340923,ECE 180,B00,083392,Abi Samra; Nicholas Camill,21,0,30,9
1650060346946,MATH 10B,A01,084110,Staff,0,0,30,30
1650060346946,MATH 10B,A02,084111,Staff,17,0,30,13
1650060346946,MATH 10B,A03,084112,Staff,23,0,30,7
1650060352972,MATH 10C,A01,083443,Staff,0,17,30,31
1650060352972,MATH 10C,A02,083444,Staff,1,17,30,29
1650060352972,MATH 10C,B01,084114,Staff,18,0,30,12
1650060352972,MATH 10C,B02,084115,Staff,25,0,30,5
1650060359001,MATH 18,A01,084117,Harel; Guershon,12,0,30,18
1650060359001,MATH 18,A02,084119,Harel; Guershon,27,0,30,3
1650060359001,MATH 18,A03,084120,Harel; Guershon,30,0,30,0
1650060359001,MATH 18,A04,084121,Harel; Guershon,29,0,30,1
1650060365031,MATH 20B,A01,084124,Um; Ko Woon,10,0,35,25
1650060365031,MATH 20B,B01,084126,Um; Ko Woon,24,0,35,11
1650060371065,MATH 20C,A01,083446,Hammock; Frances H,0,0,30,30
1650060371065,MATH 20C,A02,083447,Hammock; Frances H,14,0,30,16
1650060371065,MATH 20C,A03,083448,Hammock; Frances H,19,0,30,11
1650060371065,MATH 20C,A04,083449,Hammock; Frances H,20,0,30,10
1650060371065,MATH 20C,B01,083451,Hammock; Frances H,0,0,30,30
1650060371065,MATH 20C,B02,083452,Hammock; Frances H,16,0,30,14
1650060371065,MATH 20C,B03,083453,Hammock; Frances H,20,0,30,10
1650060371065,MATH 20C,B04,083454,Hammock; Frances H,23,0,30,7
1650060377096,MATH 20D,A01,084128,Staff,14,0,30,16
1650060377096,MATH 20D,A02,084129,Staff,29,0,30,1
1650060377096,MATH 20D,A03,084130,Staff,27,0,30,3
1650060377096,MATH 20D,B01,084133,Staff,0,0,30,30
1650060377096,MATH 20D,B02,084134,Staff,23,0,30,7
1650060377096,MATH 20D,B03,084135,Staff,28,0,30,2
1650060383127,MATH 20E,A01,084138,Staff,12,0,30,18
1650060383127,MATH 20E,A02,084139,Staff,6,0,30,24
1650060383127,MATH 20E,A03,084140,Staff,14,0,30,16
1650060383127,MATH 20E,A04,084141,Staff,20,0,30,10
1650060389155,MATH 102,A01,084143,Harel; Guershon,12,0,30,18
1650060389155,MATH 102,A02,084144,Harel; Guershon,19,0,30,11
1650060395177,MATH 103B,A01,083456,Staff,0,13,30,30
1650060395177,MATH 103B,A02,083457,Staff,0,14,30,30
1650060401209,MATH 109,A01,084146,Salehi Golsefidy; Alireza,17,0,30,13
1650060401209,MATH 109,A02,084147,Salehi Golsefidy; Alireza,15,0,30,15
1650060407244,MATH 120A,A01,085445,Eggers; John Dietrich,9,0,35,26
1650060407244,MATH 120A,A02,085446,Eggers; John Dietrich,27,0,35,8
1650060413267,MATH 142B,A01,084149,Verstraete; Jacques Allan,0,12,30,30
1650060413267,MATH 142B,A02,084150,Verstraete; Jacques Allan,0,12,30,30
1650060419298,MATH 170A,A01,083459,Nie; Jiawang,0,10,30,30
1650060419298,MATH 170A,A02,083460,Nie; Jiawang,0,9,30,30
1650060419298,MATH 170A,A03,083461,Nie; Jiawang,0,9,30,30
1650060425321,MATH 193B,A01,083463,Staff,1,0,30,29
1650060425321,MATH 193B,A02,083464,Staff,9,0,30,21
1650060425321,MATH 193B,A03,083465,Staff,17,0,30,13
1650060431395,COGS 2,A01,083966,Boyle; Mary E. T.,10,0,30,20
1650060437419,COGS 9,A01,083968,Staff,5,0,60,55
1650060443444,COGS 14B,A01,083970,Staff,9,0,50,41
1650060449468,COGS 17,A01,092679,Staff,50,0,75,25
1650060455495,COGS 100,A01,083972,Staff,0,17,60,60
1650060467549,COGS 101C,A01,083976,Staff,12,0,30,18
1650060473576,COGS 102A,A01,083978,Johnson; Christine M.,13,0,30,17
1650060479599,COGS 107B,A01,083980,Staff,0,8,50,50
1650060485625,COGS 115,A01,083982,Staff,10,0,30,20
1650060491665,COGS 118B,A01,083367,Staff,0,15,40,40
1650060497693,COGS 172,A01,083984,Provenzano; Emily Kara,15,0,30,15
1650060503727,COGS 177,A00,083368,Staff,0,21,30,30
1650060509753,COGS 186,A01,083986,Staff,21,0,40,19
1650060515776,COGS 187A,A01,083988,Boyle; Mary E. T.,20,0,60,40
1650060521803,CSE 8A,A50,084003,Miranda; Gregory Joseph,0,18,15,15
1650060527830,CSE 11,A01,084005,Miranda; Gregory Joseph,0,23,55,55
1650060533857,CSE 20,A01,084007,Staff,0,5,20,20
1650060539888,CSE 21,A01,084009,Staff,1,33,50,49
1650060545929,CSE 30,A01,083370,Cao; Yingjun,0,64,40,40
1650060551951,CSE 100,A01,083372,Cao; Yingjun,0,47,40,40
1650060557974,CSE 101,A01,084011,Staff,0,55,40,40
1650060564012,CSE 141,A01,083374,Eldon; John,0,65,75,75
1650060570034,CSE 141L,A01,083376,Eldon; John,0,71,75,75
1650060576067,CSE 175,A01,084013,Kumar; Rakesh,22,0,25,3
1650060582093,CSE 190,A00,092508,Dubnov; Shlomo,18,0,20,2
1650060588121,ECE 5,A01,084049,Morris; Karcher William,12,0,20,8
1650060594148,ECE 100,A01,084051,Baghdadchi; Saharnaz,0,0,20,20
1650060594148,ECE 100,A02,091916,Baghdadchi; Saharnaz,12,0,20,8
1650060600169,ECE 101,A01,084053,Baghdadchi; Saharnaz,0,0,37,37
1650060600169,ECE 101,A02,084054,Baghdadchi; Saharnaz,29,0,37,8
1650060606196,ECE 107,A01,083390,Staff,26,0,40,14
1650060612220,ECE 148,A01,084056,Silberman; Jack,8,0,12,4
1650060618253,ECE 180,A00,083391,Abi Samra; Nicholas Camill,25,0,30,5
1650060618253,ECE 180,B00,083392,Abi Samra; Nicholas Camill,21,0,30,9
1650060624287,MATH 10B,A01,084110,Staff,0,0,30,30
1650060624287,MATH 10B,A02,084111,Staff,17,0,30,13
1650060624287,MATH 10B,A03,084112,Staff,23,0,30,7
1650060630310,MATH 10C,A01,083443,Staff,0,17,30,31
1650060630310,MATH 10C,A02,083444,Staff,1,17,30,29
1650060630310,MATH 10C,B01,084114,Staff,18,0,30,12
1650060630310,MATH 10C,B02,084115,Staff,25,0,30,5
1650060636340,MATH 18,A01,084117,Harel; Guershon,12,0,30,18
1650060636340,MATH 18,A02,084119,Harel; Guershon,27,0,30,3
1650060636340,MATH 18,A03,084120,Harel; Guershon,30,0,30,0
1650060636340,MATH 18,A04,084121,Harel; Guershon,29,0,30,1
1650060642372,MATH 20B,A01,084124,Um; Ko Woon,10,0,35,25
1650060642372,MATH 20B,B01,084126,Um; Ko Woon,24,0,35,11
1650060648397,MATH 20C,A01,083446,Hammock; Frances H,0,0,30,30
1650060648397,MATH 20C,A02,083447,Hammock; Frances H,14,0,30,16
1650060648397,MATH 20C,A03,083448,Hammock; Frances H,19,0,30,11
1650060648397,MATH 20C,A04,083449,Hammock; Frances H,20,0,30,10
1650060648397,MATH 20C,B01,083451,Hammock; Frances H,0,0,30,30
1650060648397,MATH 20C,B02,083452,Hammock; Frances H,16,0,30,14
1650060648397,MATH 20C,B03,083453,Hammock; Frances H,20,0,30,10
1650060648397,MATH 20C,B04,083454,Hammock; Frances H,23,0,30,7
1650060654424,MATH 20D,A01,084128,Staff,14,0,30,16
1650060654424,MATH 20D,A02,084129,Staff,29,0,30,1
1650060654424,MATH 20D,A03,084130,Staff,27,0,30,3
1650060654424,MATH 20D,B01,084133,Staff,0,0,30,30
1650060654424,MATH 20D,B02,084134,Staff,23,0,30,7
1650060654424,MATH 20D,B03,084135,Staff,28,0,30,2
1650060660451,MATH 20E,A01,084138,Staff,12,0,30,18
1650060660451,MATH 20E,A02,084139,Staff,6,0,30,24
1650060660451,MATH 20E,A03,084140,Staff,14,0,30,16
1650060660451,MATH 20E,A04,084141,Staff,20,0,30,10
1650060666482,MATH 102,A01,084143,Harel; Guershon,12,0,30,18
1650060666482,MATH 102,A02,084144,Harel; Guershon,19,0,30,11
1650060672511,MATH 103B,A01,083456,Staff,0,13,30,30
1650060672511,MATH 103B,A02,083457,Staff,0,14,30,30
1650060678546,MATH 109,A01,084146,Salehi Golsefidy; Alireza,17,0,30,13
1650060678546,MATH 109,A02,084147,Salehi Golsefidy; Alireza,15,0,30,15
1650060684569,MATH 120A,A01,085445,Eggers; John Dietrich,9,0,35,26
1650060684569,MATH 120A,A02,085446,Eggers; John Dietrich,27,0,35,8
1650060690593,MATH 142B,A01,084149,Verstraete; Jacques Allan,0,12,30,30
1650060690593,MATH 142B,A02,084150,Verstraete; Jacques Allan,0,12,30,30
1650060696617,MATH 170A,A01,083459,Nie; Jiawang,0,10,30,30
1650060696617,MATH 170A,A02,083460,Nie; Jiawang,0,9,30,30
1650060696617,MATH 170A,A03,083461,Nie; Jiawang,0,9,30,30
1650060702641,MATH 193B,A01,083463,Staff,1,0,30,29
1650060702641,MATH 193B,A02,083464,Staff,8,0,30,22
1650060702641,MATH 193B,A03,083465,Staff,17,0,30,13
1650060708704,COGS 2,A01,083966,Boyle; Mary E. T.,10,0,30,20
1650060714740,COGS 9,A01,083968,Staff,5,0,60,55
1650060720765,COGS 14B,A01,083970,Staff,9,0,50,41
1650060726791,COGS 17,A01,092679,Staff,50,0,75,25
1650060732818,COGS 100,A01,083972,Staff,0,17,60,60
1650060744867,COGS 101C,A01,083976,Staff,12,0,30,18
1650060750932,COGS 102A,A01,083978,Johnson; Christine M.,13,0,30,17
1650060756958,COGS 107B,A01,083980,Staff,0,8,50,50
1650060762981,COGS 115,A01,083982,Staff,10,0,30,20
1650060769010,COGS 118B,A01,083367,Staff,0,15,40,40
1650060775034,COGS 172,A01,083984,Provenzano; Emily Kara,15,0,30,15
1650060781056,COGS 177,A00,083368,Staff,0,21,30,30
1650060787080,COGS 186,A01,083986,Staff,21,0,40,19
1650060793101,COGS 187A,A01,083988,Boyle; Mary E. T.,20,0,60,40
1650060799125,CSE 8A,A50,084003,Miranda; Gregory Joseph,0,18,15,15
1650060805149,CSE 11,A01,084005,Miranda; Gregory Joseph,0,23,55,55
1650060811175,CSE 20,A01,084007,Staff,0,5,20,20
1650060817202,CSE 21,A01,084009,Staff,1,33,50,49
1650060823225,CSE 30,A01,083370,Cao; Yingjun,0,64,40,40
1650060829247,CSE 100,A01,083372,Cao; Yingjun,0,47,40,40
1650060835272,CSE 101,A01,084011,Staff,0,55,40,40
1650060841302,CSE 141,A01,083374,Eldon; John,0,65,75,75
1650060847331,CSE 141L,A01,083376,Eldon; John,0,71,75,75
1650060853358,CSE 175,A01,084013,Kumar; Rakesh,22,0,25,3
1650060859385,CSE 190,A00,092508,Dubnov; Shlomo,18,0,20,2
1650060865413,ECE 5,A01,084049,Morris; Karcher William,12,0,20,8
1650060871437,ECE 100,A01,084051,Baghdadchi; Saharnaz,0,0,20,20
1650060871437,ECE 100,A02,091916,Baghdadchi; Saharnaz,12,0,20,8
1650060877537,ECE 101,A01,084053,Baghdadchi; Saharnaz,0,0,37,37
1650060877537,ECE 101,A02,084054,Baghdadchi; Saharnaz,29,0,37,8
1650060883565,ECE 107,A01,083390,Staff,26,0,40,14
1650060889589,ECE 148,A01,084056,Silberman; Jack,8,0,12,4
1650060895624,ECE 180,A00,083391,Abi Samra; Nicholas Camill,25,0,30,5
1650060895624,ECE 180,B00,083392,Abi Samra; Nicholas Camill,21,0,30,9
1650060901653,MATH 10B,A01,084110,Staff,0,0,30,30
1650060901653,MATH 10B,A02,084111,Staff,17,0,30,13
1650060901653,MATH 10B,A03,084112,Staff,23,0,30,7
1650060907689,MATH 10C,A01,083443,Staff,0,17,30,31
1650060907689,MATH 10C,A02,083444,Staff,1,17,30,29
1650060907689,MATH 10C,B01,084114,Staff,18,0,30,12
1650060907689,MATH 10C,B02,084115,Staff,25,0,30,5
1650060913717,MATH 18,A01,084117,Harel; Guershon,12,0,30,18
1650060913717,MATH 18,A02,084119,Harel; Guershon,27,0,30,3
1650060913717,MATH 18,A03,084120,Harel; Guershon,30,0,30,0
1650060913717,MATH 18,A04,084121,Harel; Guershon,29,0,30,1
1650060919741,MATH 20B,A01,084124,Um; Ko Woon,10,0,35,25
1650060919741,MATH 20B,B01,084126,Um; Ko Woon,24,0,35,11
1650060925771,MATH 20C,A01,083446,Hammock; Frances H,0,0,30,30
1650060925771,MATH 20C,A02,083447,Hammock; Frances H,14,0,30,16
1650060925771,MATH 20C,A03,083448,Hammock; Frances H,19,0,30,11
1650060925771,MATH 20C,A04,083449,Hammock; Frances H,20,0,30,10
1650060925771,MATH 20C,B01,083451,Hammock; Frances H,0,0,30,30
1650060925771,MATH 20C,B02,083452,Hammock; Frances H,16,0,30,14
1650060925771,MATH 20C,B03,083453,Hammock; Frances H,20,0,30,10
1650060925771,MATH 20C,B04,083454,Hammock; Frances H,23,0,30,7
1650060931795,MATH 20D,A01,084128,Staff,14,0,30,16
1650060931795,MATH 20D,A02,084129,Staff,29,0,30,1
1650060931795,MATH 20D,A03,084130,Staff,27,0,30,3
1650060931795,MATH 20D,B01,084133,Staff,0,0,30,30
1650060931795,MATH 20D,B02,084134,Staff,23,0,30,7
1650060931795,MATH 20D,B03,084135,Staff,28,0,30,2
1650060937821,MATH 20E,A01,084138,Staff,12,0,30,18
1650060937821,MATH 20E,A02,084139,Staff,6,0,30,24
1650060937821,MATH 20E,A03,084140,Staff,14,0,30,16
1650060937821,MATH 20E,A04,084141,Staff,20,0,30,10
1650060943854,MATH 102,A01,084143,Harel; Guershon,12,0,30,18
1650060943854,MATH 102,A02,084144,Harel; Guershon,19,0,30,11
1650060949878,MATH 103B,A01,083456,Staff,0,13,30,30
1650060949878,MATH 103B,A02,083457,Staff,0,14,30,30
1650060955901,MATH 109,A01,084146,Salehi Golsefidy; Alireza,17,0,30,13
1650060955901,MATH 109,A02,084147,Salehi Golsefidy; Alireza,15,0,30,15
1650060961930,MATH 120A,A01,085445,Eggers; John Dietrich,9,0,35,26
1650060961930,MATH 120A,A02,085446,Eggers; John Dietrich,27,0,35,8
1650060967968,MATH 142B,A01,084149,Verstraete; Jacques Allan,0,12,30,30
1650060967968,MATH 142B,A02,084150,Verstraete; Jacques Allan,0,12,30,30
1650060974000,MATH 170A,A01,083459,Nie; Jiawang,0,10,30,30
1650060974000,MATH 170A,A02,083460,Nie; Jiawang,0,9,30,30
1650060974000,MATH 170A,A03,083461,Nie; Jiawang,0,9,30,30
1650060980024,MATH 193B,A01,083463,Staff,1,0,30,29
1650060980024,MATH 193B,A02,083464,Staff,8,0,30,22
1650060980024,MATH 193B,A03,083465,Staff,17,0,30,13
1650060986078,COGS 2,A01,083966,Boyle; Mary E. T.,10,0,30,20
1650060992102,COGS 9,A01,083968,Staff,5,0,60,55
1650060998125,COGS 14B,A01,083970,Staff,9,0,50,41
1650061004149,COGS 17,A01,092679,Staff,50,0,75,25
1650061010175,COGS 100,A01,083972,Staff,0,18,60,60
1650061022240,COGS 101C,A01,083976,Staff,12,0,30,18
1650061028276,COGS 102A,A01,083978,Johnson; Christine M.,13,0,30,17
1650061034306,COGS 107B,A01,083980,Staff,0,8,50,50
1650061040330,COGS 115,A01,083982,Staff,10,0,30,20
1650061046357,COGS 118B,A01,083367,Staff,0,15,40,40
1650061052380,COGS 172,A01,083984,Provenzano; Emily Kara,15,0,30,15
1650061058404,COGS 177,A00,083368,Staff,0,21,30,30
1650061064430,COGS 186,A01,083986,Staff,21,0,40,19
1650061070462,COGS 187A,A01,083988,Boyle; Mary E. T.,20,0,60,40
1650061076485,CSE 8A,A50,084003,Miranda; Gregory Joseph,0,18,15,15
1650061082508,CSE 11,A01,084005,Miranda; Gregory Joseph,0,23,55,55
1650061088536,CSE 20,A01,084007,Staff,0,5,20,20
1650061094562,CSE 21,A01,084009,Staff,1,33,50,49
1650061100589,CSE 30,A01,083370,Cao; Yingjun,0,64,40,40
1650061106615,CSE 100,A01,083372,Cao; Yingjun,0,47,40,40
1650061112642,CSE 101,A01,084011,Staff,0,55,40,40
1650061118666,CSE 141,A01,083374,Eldon; John,0,65,75,75
1650061124693,CSE 141L,A01,083376,Eldon; John,0,71,75,75
1650061130718,CSE 175,A01,084013,Kumar; Rakesh,22,0,25,3
1650061136752,CSE 190,A00,092508,Dubnov; Shlomo,18,0,20,2
1650061142775,ECE 5,A01,084049,Morris; Karcher William,12,0,20,8
1650061148799,ECE 100,A01,084051,Baghdadchi; Saharnaz,0,0,20,20
1650061148799,ECE 100,A02,091916,Baghdadchi; Saharnaz,12,0,20,8
1650061154826,ECE 101,A01,084053,Baghdadchi; Saharnaz,0,0,37,37
1650061154826,ECE 101,A02,084054,Baghdadchi; Saharnaz,29,0,37,8
1650061160853,ECE 107,A01,083390,Staff,26,0,40,14
1650061166899,ECE 148,A01,084056,Silberman; Jack,8,0,12,4
1650061172922,ECE 180,A00,083391,Abi Samra; Nicholas Camill,25,0,30,5
1650061172922,ECE 180,B00,083392,Abi Samra; Nicholas Camill,21,0,30,9
1650061178962,MATH 10B,A01,084110,Staff,0,0,30,30
1650061178962,MATH 10B,A02,084111,Staff,17,0,30,13
1650061178962,MATH 10B,A03,084112,Staff,23,0,30,7
1650061184986,MATH 10C,A01,083443,Staff,0,17,30,31
1650061184986,MATH 10C,A02,083444,Staff,1,17,30,29
1650061184986,MATH 10C,B01,084114,Staff,18,0,30,12
1650061184986,MATH 10C,B02,084115,Staff,25,0,30,5
1650061191008,MATH 18,A01,084117,Harel; Guershon,12,0,30,18
1650061191008,MATH 18,A02,084119,Harel; Guershon,27,0,30,3
1650061191008,MATH 18,A03,084120,Harel; Guershon,30,0,30,0
1650061191008,MATH 18,A04,084121,Harel; Guershon,29,0,30,1
1650061197030,MATH 20B,A01,084124,Um; Ko Woon,10,0,35,25
1650061197030,MATH 20B,B01,084126,Um; Ko Woon,24,0,35,11
1650061203065,MATH 20C,A01,083446,Hammock; Frances H,0,0,30,30
1650061203065,MATH 20C,A02,083447,Hammock; Frances H,14,0,30,16
1650061203065,MATH 20C,A03,083448,Hammock; Frances H,19,0,30,11
1650061203065,MATH 20C,A04,083449,Hammock; Frances H,20,0,30,10
1650061203065,MATH 20C,B01,083451,Hammock; Frances H,0,0,30,30
1650061203065,MATH 20C,B02,083452,Hammock; Frances H,16,0,30,14
1650061203065,MATH 20C,B03,083453,Hammock; Frances H,20,0,30,10
1650061203065,MATH 20C,B04,083454,Hammock; Frances H,23,0,30,7
1650061209088,MATH 20D,A01,084128,Staff,14,0,30,16
1650061209088,MATH 20D,A02,084129,Staff,29,0,30,1
1650061209088,MATH 20D,A03,084130,Staff,27,0,30,3
1650061209088,MATH 20D,B01,084133,Staff,0,0,30,30
1650061209088,MATH 20D,B02,084134,Staff,23,0,30,7
1650061209088,MATH 20D,B03,084135,Staff,28,0,30,2
1650061215126,MATH 20E,A01,084138,Staff,12,0,30,18
1650061215126,MATH 20E,A02,084139,Staff,6,0,30,24
1650061215126,MATH 20E,A03,084140,Staff,14,0,30,16
1650061215126,MATH 20E,A04,084141,Staff,20,0,30,10
1650061221150,MATH 102,A01,084143,Harel; Guershon,12,0,30,18
1650061221150,MATH 102,A02,084144,Harel; Guershon,19,0,30,11
1650061227177,MATH 103B,A01,083456,Staff,0,13,30,30
1650061227177,MATH 103B,A02,083457,Staff,0,14,30,30
1650061233200,MATH 109,A01,084146,Salehi Golsefidy; Alireza,17,0,30,13
1650061233200,MATH 109,A02,084147,Salehi Golsefidy; Alireza,15,0,30,15
1650061239225,MATH 120A,A01,085445,Eggers; John Dietrich,9,0,35,26
1650061239225,MATH 120A,A02,085446,Eggers; John Dietrich,27,0,35,8
1650061245251,MATH 142B,A01,084149,Verstraete; Jacques Allan,0,12,30,30
1650061245251,MATH 142B,A02,084150,Verstraete; Jacques Allan,0,12,30,30
1650061251276,MATH 170A,A01,083459,Nie; Jiawang,0,10,30,30
1650061251276,MATH 170A,A02,083460,Nie; Jiawang,0,9,30,30
1650061251276,MATH 170A,A03,083461,Nie; Jiawang,0,9,30,30
1650061257300,MATH 193B,A01,083463,Staff,1,0,30,29
1650061257300,MATH 193B,A02,083464,Staff,8,0,30,22
1650061257300,MATH 193B,A03,083465,Staff,17,0,30,13
1650061263347,COGS 2,A01,083966,Boyle; Mary E. T.,10,0,30,20
1650061269374,COGS 9,A01,083968,Staff,5,0,60,55
1650061275398,COGS 14B,A01,083970,Staff,9,0,50,41
1650061281420,COGS 17,A01,092679,Staff,50,0,75,25
1650061287443,COGS 100,A01,083972,Staff,0,18,60,60
1650061299501,COGS 101C,A01,083976,Staff,12,0,30,18
1650061305529,COGS 102A,A01,083978,Johnson; Christine M.,13,0,30,17
1650061311555,COGS 107B,A01,083980,Staff,0,8,50,50
1650061317581,COGS 115,A01,083982,Staff,10,0,30,20
1650061323605,COGS 118B,A01,083367,Staff,0,15,40,40
1650061329629,COGS 172,A01,083984,Provenzano; Emily Kara,15,0,30,15
1650061335655,COGS 177,A00,083368,Staff,0,21,30,30
1650061341682,COGS 186,A01,083986,Staff,21,0,40,19
1650061347704,COGS 187A,A01,083988,Boyle; Mary E. T.,20,0,60,40
1650061353729,CSE 8A,A50,084003,Miranda; Gregory Joseph,0,18,15,15
1650061359757,CSE 11,A01,084005,Miranda; Gregory Joseph,0,23,55,55
1650061365781,CSE 20,A01,084007,Staff,0,5,20,20
1650061371808,CSE 21,A01,084009,Staff,1,33,50,49
1650061377834,CSE 30,A01,083370,Cao; Yingjun,0,64,40,40
1650061383861,CSE 100,A01,083372,Cao; Yingjun,0,47,40,40
1650061389884,CSE 101,A01,084011,Staff,0,55,40,40
1650061395916,CSE 141,A01,083374,Eldon; John,0,65,75,75
1650061401938,CSE 141L,A01,083376,Eldon; John,0,71,75,75
1650061407979,CSE 175,A01,084013,Kumar; Rakesh,22,0,25,3
1650061414007,CSE 190,A00,092508,Dubnov; Shlomo,18,0,20,2
1650061420031,ECE 5,A01,084049,Morris; Karcher William,12,0,20,8
1650061426060,ECE 100,A01,084051,Baghdadchi; Saharnaz,0,0,20,20
1650061426060,ECE 100,A02,091916,Baghdadchi; Saharnaz,12,0,20,8
1650061432082,ECE 101,A01,084053,Baghdadchi; Saharnaz,0,0,37,37
1650061432082,ECE 101,A02,084054,Baghdadchi; Saharnaz,29,0,37,8
1650061438113,ECE 107,A01,083390,Staff,26,0,40,14
1650061444136,ECE 148,A01,084056,Silberman; Jack,8,0,12,4
1650061460058,ECE 180,A00,083391,Abi Samra; Nicholas Camill,25,0,30,5
1650061460058,ECE 180,B00,083392,Abi Samra; Nicholas Camill,21,0,30,9
1650061466081,MATH 10B,A01,084110,Staff,0,0,30,30
1650061466081,MATH 10B,A02,084111,Staff,17,0,30,13
1650061466081,MATH 10B,A03,084112,Staff,23,0,30,7
1650061472109,MATH 10C,A01,083443,Staff,0,17,30,31
1650061472109,MATH 10C,A02,083444,Staff,1,17,30,29
1650061472109,MATH 10C,B01,084114,Staff,18,0,30,12
1650061472109,MATH 10C,B02,084115,Staff,25,0,30,5
1650061478152,MATH 18,A01,084117,Harel; Guershon,12,0,30,18
1650061478152,MATH 18,A02,084119,Harel; Guershon,27,0,30,3
1650061478152,MATH 18,A03,084120,Harel; Guershon,30,0,30,0
1650061478152,MATH 18,A04,084121,Harel; Guershon,29,0,30,1
1650061484271,MATH 20B,A01,084124,Um; Ko Woon,10,0,35,25
1650061484271,MATH 20B,B01,084126,Um; Ko Woon,24,0,35,11
1650061490296,MATH 20C,A01,083446,Hammock; Frances H,0,0,30,30
1650061490296,MATH 20C,A02,083447,Hammock; Frances H,14,0,30,16
1650061490296,MATH 20C,A03,083448,Hammock; Frances H,19,0,30,11
1650061490296,MATH 20C,A04,083449,Hammock; Frances H,20,0,30,10
1650061490296,MATH 20C,B01,083451,Hammock; Frances H,0,0,30,30
1650061490296,MATH 20C,B02,083452,Hammock; Frances H,15,0,30,15
1650061490296,MATH 20C,B03,083453,Hammock; Frances H,20,0,30,10
1650061490296,MATH 20C,B04,083454,Hammock; Frances H,23,0,30,7
1650061496324,MATH 20D,A01,084128,Staff,14,0,30,16
1650061496324,MATH 20D,A02,084129,Staff,29,0,30,1
1650061496324,MATH 20D,A03,084130,Staff,27,0,30,3
1650061496324,MATH 20D,B01,084133,Staff,0,0,30,30
1650061496324,MATH 20D,B02,084134,Staff,23,0,30,7
1650061496324,MATH 20D,B03,084135,Staff,28,0,30,2
1650061502360,MATH 20E,A01,084138,Staff,12,0,30,18
1650061502360,MATH 20E,A02,084139,Staff,6,0,30,24
1650061502360,MATH 20E,A03,084140,Staff,14,0,30,16
1650061502360,MATH 20E,A04,084141,Staff,19,0,30,11
1650061508384,MATH 102,A01,084143,Harel; Guershon,12,0,30,18
1650061508384,MATH 102,A02,084144,Harel; Guershon,19,0,30,11
1650061514418,MATH 103B,A01,083456,Staff,0,13,30,30
1650061514418,MATH 103B,A02,083457,Staff,0,14,30,30
1650061520448,MATH 109,A01,084146,Salehi Golsefidy; Alireza,16,0,30,14
1650061520448,MATH 109,A02,084147,Salehi Golsefidy; Alireza,15,0,30,15
1650061526471,MATH 120A,A01,085445,Eggers; John Dietrich,9,0,35,26
1650061526471,MATH 120A,A02,085446,Eggers; John Dietrich,27,0,35,8
1650061532510,MATH 142B,A01,084149,Verstraete; Jacques Allan,0,12,30,30
1650061532510,MATH 142B,A02,084150,Verstraete; Jacques Allan,0,12,30,30
1650061538546,MATH 170A,A01,083459,Nie; Jiawang,0,10,30,30
1650061538546,MATH 170A,A02,083460,Nie; Jiawang,0,9,30,30
1650061538546,MATH 170A,A03,083461,Nie; Jiawang,0,9,30,30
1650061544570,MATH 193B,A01,083463,Staff,1,0,30,29
1650061544570,MATH 193B,A02,083464,Staff,8,0,30,22
1650061544570,MATH 193B,A03,083465,Staff,17,0,30,13
1650061550644,COGS 2,A01,083966,Boyle; Mary E. T.,10,0,30,20
1650061556678,COGS 9,A01,083968,Staff,5,0,60,55
1650061562715,COGS 14B,A01,083970,Staff,9,0,50,41
1650061568741,COGS 17,A01,092679,Staff,50,0,75,25
1650061574782,COGS 100,A01,083972,Staff,0,18,60,60
1650061586836,COGS 101C,A01,083976,Staff,12,0,30,18
1650061592866,COGS 102A,A01,083978,Johnson; Christine M.,13,0,30,17
1650061598889,COGS 107B,A01,083980,Staff,0,8,50,50
1650061604918,COGS 115,A01,083982,Staff,10,0,30,20
1650061610940,COGS 118B,A01,083367,Staff,0,15,40,40
1650061616963,COGS 172,A01,083984,Provenzano; Emily Kara,15,0,30,15
1650061622998,COGS 177,A00,083368,Staff,0,21,30,30
1650061629025,COGS 186,A01,083986,Staff,21,0,40,19
1650061635052,COGS 187A,A01,083988,Boyle; Mary E. T.,20,0,60,40
1650061641081,CSE 8A,A50,084003,Miranda; Gregory Joseph,0,18,15,15
1650061647112,CSE 11,A01,084005,Miranda; Gregory Joseph,0,23,55,55
1650061653142,CSE 20,A01,084007,Staff,0,5,20,20
1650061659166,CSE 21,A01,084009,Staff,1,33,50,49
1650061665208,CSE 30,A01,083370,Cao; Yingjun,0,64,40,40
1650061671232,CSE 100,A01,083372,Cao; Yingjun,0,47,40,40
1650061677255,CSE 101,A01,084011,Staff,0,55,40,40
1650061683292,CSE 141,A01,083374,Eldon; John,0,65,75,75
1650061689315,CSE 141L,A01,083376,Eldon; John,0,71,75,75
1650061695338,CSE 175,A01,084013,Kumar; Rakesh,22,0,25,3
1650061701366,CSE 190,A00,092508,Dubnov; Shlomo,18,0,20,2
1650061707392,ECE 5,A01,084049,Morris; Karcher William,12,0,20,8
1650061713423,ECE 100,A01,084051,Baghdadchi; Saharnaz,0,0,20,20
1650061713423,ECE 100,A02,091916,Baghdadchi; Saharnaz,12,0,20,8
1650061719453,ECE 101,A01,084053,Baghdadchi; Saharnaz,0,0,37,37
1650061719453,ECE 101,A02,084054,Baghdadchi; Saharnaz,28,0,37,9
1650061725483,ECE 107,A01,083390,Staff,26,0,40,14
1650061731512,ECE 148,A01,084056,Silberman; Jack,8,0,12,4
1650061737546,ECE 180,A00,083391,Abi Samra; Nicholas Camill,25,0,30,5
1650061737546,ECE 180,B00,083392,Abi Samra; Nicholas Camill,21,0,30,9
1650061743570,MATH 10B,A01,084110,Staff,0,0,30,30
1650061743570,MATH 10B,A02,084111,Staff,17,0,30,13
1650061743570,MATH 10B,A03,084112,Staff,23,0,30,7
1650061749592,MATH 10C,A01,083443,Staff,0,17,30,31
1650061749592,MATH 10C,A02,083444,Staff,1,17,30,29
1650061749592,MATH 10C,B01,084114,Staff,18,0,30,12
1650061749592,MATH 10C,B02,084115,Staff,25,0,30,5
1650061755616,MATH 18,A01,084117,Harel; Guershon,12,0,30,18
1650061755616,MATH 18,A02,084119,Harel; Guershon,27,0,30,3
1650061755616,MATH 18,A03,084120,Harel; Guershon,30,0,30,0
1650061755616,MATH 18,A04,084121,Harel; Guershon,29,0,30,1
1650061761647,MATH 20B,A01,084124,Um; Ko Woon,10,0,35,25
1650061761647,MATH 20B,B01,084126,Um; Ko Woon,24,0,35,11
1650061767684,MATH 20C,A01,083446,Hammock; Frances H,0,0,30,30
1650061767684,MATH 20C,A02,083447,Hammock; Frances H,14,0,30,16
1650061767684,MATH 20C,A03,083448,Hammock; Frances H,19,0,30,11
1650061767684,MATH 20C,A04,083449,Hammock; Frances H,20,0,30,10
1650061767684,MATH 20C,B01,083451,Hammock; Frances H,0,0,30,30
1650061767684,MATH 20C,B02,083452,Hammock; Frances H,15,0,30,15
1650061767684,MATH 20C,B03,083453,Hammock; Frances H,20,0,30,10
1650061767684,MATH 20C,B04,083454,Hammock; Frances H,23,0,30,7
1650061773707,MATH 20D,A01,084128,Staff,14,0,30,16
1650061773707,MATH 20D,A02,084129,Staff,29,0,30,1
1650061773707,MATH 20D,A03,084130,Staff,27,0,30,3
1650061773707,MATH 20D,B01,084133,Staff,0,0,30,30
1650061773707,MATH 20D,B02,084134,Staff,23,0,30,7
1650061773707,MATH 20D,B03,084135,Staff,28,0,30,2
1650061779730,MATH 20E,A01,084138,Staff,12,0,30,18
1650061779730,MATH 20E,A02,084139,Staff,6,0,30,24
1650061779730,MATH 20E,A03,084140,Staff,14,0,30,16
1650061779730,MATH 20E,A04,084141,Staff,19,0,30,11
1650061785755,MATH 102,A01,084143,Harel; Guershon,11,0,30,19
1650061785755,MATH 102,A02,084144,Harel; Guershon,19,0,30,11
1650061791781,MATH 103B,A01,083456,Staff,0,13,30,30
1650061791781,MATH 103B,A02,083457,Staff,0,14,30,30
1650061797808,MATH 109,A01,084146,Salehi Golsefidy; Alireza,16,0,30,14
1650061797808,MATH 109,A02,084147,Salehi Golsefidy; Alireza,15,0,30,15
1650061803833,MATH 120A,A01,085445,Eggers; John Dietrich,9,0,35,26
1650061803833,MATH 120A,A02,085446,Eggers; John Dietrich,27,0,35,8
1650061809862,MATH 142B,A01,084149,Verstraete; Jacques Allan,0,12,30,30
1650061809862,MATH 142B,A02,084150,Verstraete; Jacques Allan,0,12,30,30
1650061815886,MATH 170A,A01,083459,Nie; Jiawang,0,10,30,30
1650061815886,MATH 170A,A02,083460,Nie; Jiawang,0,9,30,30
1650061815886,MATH 170A,A03,083461,Nie; Jiawang,0,9,30,30
1650061821918,MATH 193B,A01,083463,Staff,1,0,30,29
1650061821918,MATH 193B,A02,083464,Staff,8,0,30,22
1650061821918,MATH 193B,A03,083465,Staff,17,0,30,13
1650061827979,COGS 2,A01,083966,Boyle; Mary E. T.,10,0,30,20
1650061834015,COGS 9,A01,083968,Staff,5,0,60,55
1650061840051,COGS 14B,A01,083970,Staff,9,0,50,41
1650061846083,COGS 17,A01,092679,Staff,50,0,75,25
1650061852107,COGS 100,A01,083972,Staff,0,18,60,60
1650061864162,COGS 101C,A01,083976,Staff,12,0,30,18
1650061870192,COGS 102A,A01,083978,Johnson; Christine M.,13,0,30,17
1650061876227,COGS 107B,A01,083980,Staff,0,8,50,50
1650061882251,COGS 115,A01,083982,Staff,10,0,30,20
1650061888277,COGS 118B,A01,083367,Staff,0,15,40,40
1650061894311,COGS 172,A01,083984,Provenzano; Emily Kara,15,0,30,15
1650061900334,COGS 177,A00,083368,Staff,0,21,30,30
1650061906361,COGS 186,A01,083986,Staff,21,0,40,19
1650061912387,COGS 187A,A01,083988,Boyle; Mary E. T.,20,0,60,40
1650061918420,CSE 8A,A50,084003,Miranda; Gregory Joseph,0,18,15,15
1650061924444,CSE 11,A01,084005,Miranda; Gregory Joseph,0,23,55,55
1650061930468,CSE 20,A01,084007,Staff,0,5,20,20
1650061936495,CSE 21,A01,084009,Staff,1,33,50,49
1650061942527,CSE 30,A01,083370,Cao; Yingjun,0,64,40,40
1650061948554,CSE 100,A01,083372,Cao; Yingjun,0,47,40,40
1650061954582,CSE 101,A01,084011,Staff,0,55,40,40
1650061960605,CSE 141,A01,083374,Eldon; John,0,65,75,75
1650061966630,CSE 141L,A01,083376,Eldon; John,0,71,75,75
1650061972653,CSE 175,A01,084013,Kumar; Rakesh,22,0,25,3
1650061978681,CSE 190,A00,092508,Dubnov; Shlomo,18,0,20,2
1650061984705,ECE 5,A01,084049,Morris; Karcher William,12,0,20,8
1650061990730,ECE 100,A01,084051,Baghdadchi; Saharnaz,0,0,20,20
1650061990730,ECE 100,A02,091916,Baghdadchi; Saharnaz,12,0,20,8
1650061996761,ECE 101,A01,084053,Baghdadchi; Saharnaz,0,0,37,37
1650061996761,ECE 101,A02,084054,Baghdadchi; Saharnaz,28,0,37,9
1650062002784,ECE 107,A01,083390,Staff,26,0,40,14
1650062008810,ECE 148,A01,084056,Silberman; Jack,8,0,12,4
1650062014841,ECE 180,A00,083391,Abi Samra; Nicholas Camill,25,0,30,5
1650062014841,ECE 180,B00,083392,Abi Samra; Nicholas Camill,21,0,30,9
1650062020867,MATH 10B,A01,084110,Staff,0,0,30,30
1650062020867,MATH 10B,A02,084111,Staff,17,0,30,13
1650062020867,MATH 10B,A03,084112,Staff,23,0,30,7
1650062026895,MATH 10C,A01,083443,Staff,0,17,30,31
1650062026895,MATH 10C,A02,083444,Staff,1,17,30,29
1650062026895,MATH 10C,B01,084114,Staff,18,0,30,12
1650062026895,MATH 10C,B02,084115,Staff,25,0,30,5
1650062032924,MATH 18,A01,084117,Harel; Guershon,12,0,30,18
1650062032924,MATH 18,A02,084119,Harel; Guershon,27,0,30,3
1650062032924,MATH 18,A03,084120,Harel; Guershon,30,0,30,0
1650062032924,MATH 18,A04,084121,Harel; Guershon,29,0,30,1
1650062038952,MATH 20B,A01,084124,Um; Ko Woon,10,0,35,25
1650062038952,MATH 20B,B01,084126,Um; Ko Woon,24,0,35,11
1650062044980,MATH 20C,A01,083446,Hammock; Frances H,0,0,30,30
1650062044980,MATH 20C,A02,083447,Hammock; Frances H,14,0,30,16
1650062044980,MATH 20C,A03,083448,Hammock; Frances H,19,0,30,11
1650062044980,MATH 20C,A04,083449,Hammock; Frances H,20,0,30,10
1650062044980,MATH 20C,B01,083451,Hammock; Frances H,0,0,30,30
1650062044980,MATH 20C,B02,083452,Hammock; Frances H,15,0,30,15
1650062044980,MATH 20C,B03,083453,Hammock; Frances H,20,0,30,10
1650062044980,MATH 20C,B04,083454,Hammock; Frances H,23,0,30,7
1650062051004,MATH 20D,A01,084128,Staff,14,0,30,16
1650062051004,MATH 20D,A02,084129,Staff,29,0,30,1
1650062051004,MATH 20D,A03,084130,Staff,27,0,30,3
1650062051004,MATH 20D,B01,084133,Staff,0,0,30,30
1650062051004,MATH 20D,B02,084134,Staff,23,0,30,7
1650062051004,MATH 20D,B03,084135,Staff,28,0,30,2
1650062057028,MATH 20E,A01,084138,Staff,12,0,30,18
1650062057028,MATH 20E,A02,084139,Staff,6,0,30,24
1650062057028,MATH 20E,A03,084140,Staff,14,0,30,16
1650062057028,MATH 20E,A04,084141,Staff,19,0,30,11
1650062063053,MATH 102,A01,084143,Harel; Guershon,11,0,30,19
1650062063053,MATH 102,A02,084144,Harel; Guershon,19,0,30,11
1650062069096,MATH 103B,A01,083456,Staff,0,13,30,30
1650062069096,MATH 103B,A02,083457,Staff,0,14,30,30
1650062075122,MATH 109,A01,084146,Salehi Golsefidy; Alireza,16,0,30,14
1650062075122,MATH 109,A02,084147,Salehi Golsefidy; Alireza,15,0,30,15
1650062081243,MATH 120A,A01,085445,Eggers; John Dietrich,9,0,35,26
1650062081243,MATH 120A,A02,085446,Eggers; John Dietrich,27,0,35,8
1650062087269,MATH 142B,A01,084149,Verstraete; Jacques Allan,0,12,30,30
1650062087269,MATH 142B,A02,084150,Verstraete; Jacques Allan,0,12,30,30
1650062093301,MATH 170A,A01,083459,Nie; Jiawang,0,10,30,30
1650062093301,MATH 170A,A02,083460,Nie; Jiawang,0,9,30,30
1650062093301,MATH 170A,A03,083461,Nie; Jiawang,0,9,30,30
1650062099344,MATH 193B,A01,083463,Staff,1,0,30,29
1650062099344,MATH 193B,A02,083464,Staff,8,0,30,22
1650062099344,MATH 193B,A03,083465,Staff,17,0,30,13
1650062105393,COGS 2,A01,083966,Boyle; Mary E. T.,10,0,30,20
1650062111420,COGS 9,A01,083968,Staff,5,0,60,55
1650062117445,COGS 14B,A01,083970,Staff,9,0,50,41
1650062123468,COGS 17,A01,092679,Staff,50,0,75,25
1650062129495,COGS 100,A01,083972,Staff,0,18,60,60
1650062141542,COGS 101C,A01,083976,Staff,12,0,30,18
1650062147566,COGS 102A,A01,083978,Johnson; Christine M.,13,0,30,17
1650062153590,COGS 107B,A01,083980,Staff,0,8,50,50
1650062159614,COGS 115,A01,083982,Staff,10,0,30,20
1650062165638,COGS 118B,A01,083367,Staff,0,15,40,40
1650062171671,COGS 172,A01,083984,Provenzano; Emily Kara,15,0,30,15
1650062177698,COGS 177,A00,083368,Staff,0,21,30,30
1650062183720,COGS 186,A01,083986,Staff,21,0,40,19
1650062189743,COGS 187A,A01,083988,Boyle; Mary E. T.,20,0,60,40
1650062195767,CSE 8A,A50,084003,Miranda; Gregory Joseph,0,18,15,15
1650062201790,CSE 11,A01,084005,Miranda; Gregory Joseph,0,23,55,55
1650062207815,CSE 20,A01,084007,Staff,0,5,20,20
1650062213845,CSE 21,A01,084009,Staff,1,33,50,49
1650062219876,CSE 30,A01,083370,Cao; Yingjun,0,64,40,40
1650062225904,CSE 100,A01,083372,Cao; Yingjun,0,47,40,40
1650062231928,CSE 101,A01,084011,Staff,0,55,40,40
1650062237954,CSE 141,A01,083374,Eldon; John,0,65,75,75
1650062243978,CSE 141L,A01,083376,Eldon; John,0,71,75,75
1650062250005,CSE 175,A01,084013,Kumar; Rakesh,22,0,25,3
1650062256034,CSE 190,A00,092508,Dubnov; Shlomo,18,0,20,2
1650062262062,ECE 5,A01,084049,Morris; Karcher William,12,0,20,8
1650062268083,ECE 100,A01,084051,Baghdadchi; Saharnaz,0,0,20,20
1650062268083,ECE 100,A02,091916,Baghdadchi; Saharnaz,12,0,20,8
1650062274127,ECE 101,A01,084053,Baghdadchi; Saharnaz,0,0,37,37
1650062274127,ECE 101,A02,084054,Baghdadchi; Saharnaz,28,0,37,9
1650062280153,ECE 107,A01,083390,Staff,26,0,40,14
1650062286175,ECE 148,A01,084056,Silberman; Jack,8,0,12,4
1650062292200,ECE 180,A00,083391,Abi Samra; Nicholas Camill,25,0,30,5
1650062292200,ECE 180,B00,083392,Abi Samra; Nicholas Camill,21,0,30,9
1650062298227,MATH 10B,A01,084110,Staff,0,0,30,30
1650062298227,MATH 10B,A02,084111,Staff,17,0,30,13
1650062298227,MATH 10B,A03,084112,Staff,23,0,30,7
1650062304250,MATH 10C,A01,083443,Staff,0,17,30,31
1650062304250,MATH 10C,A02,083444,Staff,1,17,30,29
1650062304250,MATH 10C,B01,084114,Staff,18,0,30,12
1650062304250,MATH 10C,B02,084115,Staff,25,0,30,5
1650062310277,MATH 18,A01,084117,Harel; Guershon,12,0,30,18
1650062310277,MATH 18,A02,084119,Harel; Guershon,27,0,30,3
1650062310277,MATH 18,A03,084120,Harel; Guershon,30,0,30,0
1650062310277,MATH 18,A04,084121,Harel; Guershon,29,0,30,1
1650062316319,MATH 20B,A01,084124,Um; Ko Woon,10,0,35,25
1650062316319,MATH 20B,B01,084126,Um; Ko Woon,24,0,35,11
1650062322343,MATH 20C,A01,083446,Hammock; Frances H,0,0,30,30
1650062322343,MATH 20C,A02,083447,Hammock; Frances H,14,0,30,16
1650062322343,MATH 20C,A03,083448,Hammock; Frances H,19,0,30,11
1650062322343,MATH 20C,A04,083449,Hammock; Frances H,20,0,30,10
1650062322343,MATH 20C,B01,083451,Hammock; Frances H,0,0,30,30
1650062322343,MATH 20C,B02,083452,Hammock; Frances H,15,0,30,15
1650062322343,MATH 20C,B03,083453,Hammock; Frances H,20,0,30,10
1650062322343,MATH 20C,B04,083454,Hammock; Frances H,23,0,30,7
1650062328367,MATH 20D,A01,084128,Staff,14,0,30,16
1650062328367,MATH 20D,A02,084129,Staff,29,0,30,1
1650062328367,MATH 20D,A03,084130,Staff,27,0,30,3
1650062328367,MATH 20D,B01,084133,Staff,0,0,30,30
1650062328367,MATH 20D,B02,084134,Staff,23,0,30,7
1650062328367,MATH 20D,B03,084135,Staff,28,0,30,2
1650062334392,MATH 20E,A01,084138,Staff,12,0,30,18
1650062334392,MATH 20E,A02,084139,Staff,6,0,30,24
1650062334392,MATH 20E,A03,084140,Staff,14,0,30,16
1650062334392,MATH 20E,A04,084141,Staff,19,0,30,11
1650062340424,MATH 102,A01,084143,Harel; Guershon,11,0,30,19
1650062340424,MATH 102,A02,084144,Harel; Guershon,19,0,30,11
1650062346450,MATH 103B,A01,083456,Staff,0,13,30,30
1650062346450,MATH 103B,A02,083457,Staff,0,14,30,30
1650062352473,MATH 109,A01,084146,Salehi Golsefidy; Alireza,16,0,30,14
1650062352473,MATH 109,A02,084147,Salehi Golsefidy; Alireza,15,0,30,15
1650062358502,MATH 120A,A01,085445,Eggers; John Dietrich,9,0,35,26
1650062358502,MATH 120A,A02,085446,Eggers; John Dietrich,27,0,35,8
1650062364534,MATH 142B,A01,084149,Verstraete; Jacques Allan,0,12,30,30
1650062364534,MATH 142B,A02,084150,Verstraete; Jacques Allan,0,12,30,30
1650062370559,MATH 170A,A01,083459,Nie; Jiawang,0,10,30,30
1650062370559,MATH 170A,A02,083460,Nie; Jiawang,0,9,30,30
1650062370559,MATH 170A,A03,083461,Nie; Jiawang,0,9,30,30
1650062376583,MATH 193B,A01,083463,Staff,1,0,30,29
1650062376583,MATH 193B,A02,083464,Staff,8,0,30,22
1650062376583,MATH 193B,A03,083465,Staff,17,0,30,13
1650062382641,COGS 2,A01,083966,Boyle; Mary E. T.,10,0,30,20
1650062388664,COGS 9,A01,083968,Staff,5,0,60,55
1650062394686,COGS 14B,A01,083970,Staff,9,0,50,41
1650062400710,COGS 17,A01,092679,Staff,50,0,75,25
1650062406740,COGS 100,A01,083972,Staff,0,18,60,60
1650062418797,COGS 101C,A01,083976,Staff,12,0,30,18
1650062424823,COGS 102A,A01,083978,Johnson; Christine M.,12,0,30,18
1650062430847,COGS 107B,A01,083980,Staff,0,8,50,50
1650062436871,COGS 115,A01,083982,Staff,10,0,30,20
1650062442895,COGS 118B,A01,083367,Staff,0,15,40,40
1650062448921,COGS 172,A01,083984,Provenzano; Emily Kara,15,0,30,15
1650062454943,COGS 177,A00,083368,Staff,0,21,30,30
1650062460970,COGS 186,A01,083986,Staff,21,0,40,19
1650062466993,COGS 187A,A01,083988,Boyle; Mary E. T.,19,0,60,41
1650062473017,CSE 8A,A50,084003,Miranda; Gregory Joseph,0,18,15,15
1650062479041,CSE 11,A01,084005,Miranda; Gregory Joseph,0,23,55,55
1650062485086,CSE 20,A01,084007,Staff,0,5,20,20
1650062491109,CSE 21,A01,084009,Staff,1,33,50,49
1650062497135,CSE 30,A01,083370,Cao; Yingjun,0,64,40,40
1650062503158,CSE 100,A01,083372,Cao; Yingjun,0,47,40,40
1650062509191,CSE 101,A01,084011,Staff,0,55,40,40
1650062515214,CSE 141,A01,083374,Eldon; John,0,65,75,75
1650062521241,CSE 141L,A01,083376,Eldon; John,0,71,75,75
1650062527266,CSE 175,A01,084013,Kumar; Rakesh,22,0,25,3
1650062533295,CSE 190,A00,092508,Dubnov; Shlomo,18,0,20,2
1650062539319,ECE 5,A01,084049,Morris; Karcher William,12,0,20,8
1650062545345,ECE 100,A01,084051,Baghdadchi; Saharnaz,0,0,20,20
1650062545345,ECE 100,A02,091916,Baghdadchi; Saharnaz,12,0,20,8
1650062551377,ECE 101,A01,084053,Baghdadchi; Saharnaz,0,0,37,37
1650062551377,ECE 101,A02,084054,Baghdadchi; Saharnaz,28,0,37,9
1650062557400,ECE 107,A01,083390,Staff,26,0,40,14
1650062563428,ECE 148,A01,084056,Silberman; Jack,8,0,12,4
1650062569455,ECE 180,A00,083391,Abi Samra; Nicholas Camill,25,0,30,5
1650062569455,ECE 180,B00,083392,Abi Samra; Nicholas Camill,21,0,30,9
1650062575483,MATH 10B,A01,084110,Staff,0,0,30,30
1650062575483,MATH 10B,A02,084111,Staff,17,0,30,13
1650062575483,MATH 10B,A03,084112,Staff,23,0,30,7
1650062581507,MATH 10C,A01,083443,Staff,0,17,30,31
1650062581507,MATH 10C,A02,083444,Staff,1,17,30,29
1650062581507,MATH 10C,B01,084114,Staff,18,0,30,12
1650062581507,MATH 10C,B02,084115,Staff,25,0,30,5
1650062587530,MATH 18,A01,084117,Harel; Guershon,12,0,30,18
1650062587530,MATH 18,A02,084119,Harel; Guershon,27,0,30,3
1650062587530,MATH 18,A03,084120,Harel; Guershon,30,0,30,0
1650062587530,MATH 18,A04,084121,Harel; Guershon,29,0,30,1
1650062593554,MATH 20B,A01,084124,Um; Ko Woon,10,0,35,25
1650062593554,MATH 20B,B01,084126,Um; Ko Woon,24,0,35,11
1650062599586,MATH 20C,A01,083446,Hammock; Frances H,0,0,30,30
1650062599586,MATH 20C,A02,083447,Hammock; Frances H,14,0,30,16
1650062599586,MATH 20C,A03,083448,Hammock; Frances H,19,0,30,11
1650062599586,MATH 20C,A04,083449,Hammock; Frances H,20,0,30,10
1650062599586,MATH 20C,B01,083451,Hammock; Frances H,0,0,30,30
1650062599586,MATH 20C,B02,083452,Hammock; Frances H,15,0,30,15
1650062599586,MATH 20C,B03,083453,Hammock; Frances H,19,0,30,11
1650062599586,MATH 20C,B04,083454,Hammock; Frances H,23,0,30,7
1650062605612,MATH 20D,A01,084128,Staff,14,0,30,16
1650062605612,MATH 20D,A02,084129,Staff,29,0,30,1
1650062605612,MATH 20D,A03,084130,Staff,27,0,30,3
1650062605612,MATH 20D,B01,084133,Staff,0,0,30,30
1650062605612,MATH 20D,B02,084134,Staff,23,0,30,7
1650062605612,MATH 20D,B03,084135,Staff,28,0,30,2
1650062611642,MATH 20E,A01,084138,Staff,12,0,30,18
1650062611642,MATH 20E,A02,084139,Staff,6,0,30,24
1650062611642,MATH 20E,A03,084140,Staff,14,0,30,16
1650062611642,MATH 20E,A04,084141,Staff,19,0,30,11
1650062617672,MATH 102,A01,084143,Harel; Guershon,11,0,30,19
1650062617672,MATH 102,A02,084144,Harel; Guershon,19,0,30,11
1650062623696,MATH 103B,A01,083456,Staff,0,13,30,30
1650062623696,MATH 103B,A02,083457,Staff,0,14,30,30
1650062629720,MATH 109,A01,084146,Salehi Golsefidy; Alireza,16,0,30,14
1650062629720,MATH 109,A02,084147,Salehi Golsefidy; Alireza,15,0,30,15
1650062635743,MATH 120A,A01,085445,Eggers; John Dietrich,9,0,35,26
1650062635743,MATH 120A,A02,085446,Eggers; John Dietrich,27,0,35,8
1650062641774,MATH 142B,A01,084149,Verstraete; Jacques Allan,0,12,30,30
1650062641774,MATH 142B,A02,084150,Verstraete; Jacques Allan,0,12,30,30
1650062647798,MATH 170A,A01,083459,Nie; Jiawang,0,10,30,30
1650062647798,MATH 170A,A02,083460,Nie; Jiawang,0,9,30,30
1650062647798,MATH 170A,A03,083461,Nie; Jiawang,0,9,30,30
1650062653836,MATH 193B,A01,083463,Staff,1,0,30,29
1650062653836,MATH 193B,A02,083464,Staff,8,0,30,22
1650062653836,MATH 193B,A03,083465,Staff,17,0,30,13
1650062659882,COGS 2,A01,083966,Boyle; Mary E. T.,10,0,30,20
1650062665911,COGS 9,A01,083968,Staff,5,0,60,55
1650062672036,COGS 14B,A01,083970,Staff,9,0,50,41
1650062678062,COGS 17,A01,092679,Staff,50,0,75,25
1650062684085,COGS 100,A01,083972,Staff,0,18,60,60
1650062696136,COGS 101C,A01,083976,Staff,12,0,30,18
1650062702166,COGS 102A,A01,083978,Johnson; Christine M.,12,0,30,18
1650062708195,COGS 107B,A01,083980,Staff,0,8,50,50
1650062714223,COGS 115,A01,083982,Staff,10,0,30,20
1650062720247,COGS 118B,A01,083367,Staff,0,15,40,40
1650062726274,COGS 172,A01,083984,Provenzano; Emily Kara,15,0,30,15
1650062732301,COGS 177,A00,083368,Staff,0,21,30,30
1650062738324,COGS 186,A01,083986,Staff,21,0,40,19
1650062744348,COGS 187A,A01,083988,Boyle; Mary E. T.,19,0,60,41
1650062750384,CSE 8A,A50,084003,Miranda; Gregory Joseph,0,18,15,15
1650062756411,CSE 11,A01,084005,Miranda; Gregory Joseph,0,23,55,55
1650062762434,CSE 20,A01,084007,Staff,0,5,20,20
1650062768468,CSE 21,A01,084009,Staff,1,33,50,49
1650062774498,CSE 30,A01,083370,Cao; Yingjun,0,64,40,40
1650062780535,CSE 100,A01,083372,Cao; Yingjun,0,47,40,40
1650062786561,CSE 101,A01,084011,Staff,0,55,40,40
1650062792588,CSE 141,A01,083374,Eldon; John,0,65,75,75
1650062798616,CSE 141L,A01,083376,Eldon; John,0,71,75,75
1650062804645,CSE 175,A01,084013,Kumar; Rakesh,22,0,25,3
1650062810669,CSE 190,A00,092508,Dubnov; Shlomo,18,0,20,2
1650062816692,ECE 5,A01,084049,Morris; Karcher William,12,0,20,8
1650062822717,ECE 100,A01,084051,Baghdadchi; Saharnaz,0,0,20,20
1650062822717,ECE 100,A02,091916,Baghdadchi; Saharnaz,12,0,20,8
1650062828741,ECE 101,A01,084053,Baghdadchi; Saharnaz,0,0,37,37
1650062828741,ECE 101,A02,084054,Baghdadchi; Saharnaz,28,0,37,9
1650062834774,ECE 107,A01,083390,Staff,26,0,40,14
1650062840798,ECE 148,A01,084056,Silberman; Jack,8,0,12,4
1650062846822,ECE 180,A00,083391,Abi Samra; Nicholas Camill,25,0,30,5
1650062846822,ECE 180,B00,083392,Abi Samra; Nicholas Camill,21,0,30,9
1650062852848,MATH 10B,A01,084110,Staff,0,0,30,30
1650062852848,MATH 10B,A02,084111,Staff,17,0,30,13
1650062852848,MATH 10B,A03,084112,Staff,23,0,30,7
1650062858872,MATH 10C,A01,083443,Staff,0,17,30,31
1650062858872,MATH 10C,A02,083444,Staff,1,17,30,29
1650062858872,MATH 10C,B01,084114,Staff,18,0,30,12
1650062858872,MATH 10C,B02,084115,Staff,25,0,30,5
1650062864904,MATH 18,A01,084117,Harel; Guershon,12,0,30,18
1650062864904,MATH 18,A02,084119,Harel; Guershon,27,0,30,3
1650062864904,MATH 18,A03,084120,Harel; Guershon,30,0,30,0
1650062864904,MATH 18,A04,084121,Harel; Guershon,29,0,30,1
1650062870927,MATH 20B,A01,084124,Um; Ko Woon,10,0,35,25
1650062870927,MATH 20B,B01,084126,Um; Ko Woon,24,0,35,11
1650062876957,MATH 20C,A01,083446,Hammock; Frances H,0,0,30,30
1650062876957,MATH 20C,A02,083447,Hammock; Frances H,14,0,30,16
1650062876957,MATH 20C,A03,083448,Hammock; Frances H,19,0,30,11
1650062876957,MATH 20C,A04,083449,Hammock; Frances H,20,0,30,10
1650062876957,MATH 20C,B01,083451,Hammock; Frances H,0,0,30,30
1650062876957,MATH 20C,B02,083452,Hammock; Frances H,15,0,30,15
1650062876957,MATH 20C,B03,083453,Hammock; Frances H,19,0,30,11
1650062876957,MATH 20C,B04,083454,Hammock; Frances H,23,0,30,7
1650062882980,MATH 20D,A01,084128,Staff,14,0,30,16
1650062882980,MATH 20D,A02,084129,Staff,29,0,30,1
1650062882980,MATH 20D,A03,084130,Staff,27,0,30,3
1650062882980,MATH 20D,B01,084133,Staff,0,0,30,30
1650062882980,MATH 20D,B02,084134,Staff,23,0,30,7
1650062882980,MATH 20D,B03,084135,Staff,28,0,30,2
1650062889023,MATH 20E,A01,084138,Staff,12,0,30,18
1650062889023,MATH 20E,A02,084139,Staff,6,0,30,24
1650062889023,MATH 20E,A03,084140,Staff,14,0,30,16
1650062889023,MATH 20E,A04,084141,Staff,19,0,30,11
1650062895047,MATH 102,A01,084143,Harel; Guershon,11,0,30,19
1650062895047,MATH 102,A02,084144,Harel; Guershon,19,0,30,11
1650062901073,MATH 103B,A01,083456,Staff,0,13,30,30
1650062901073,MATH 103B,A02,083457,Staff,0,14,30,30
1650062907096,MATH 109,A01,084146,Salehi Golsefidy; Alireza,16,0,30,14
1650062907096,MATH 109,A02,084147,Salehi Golsefidy; Alireza,15,0,30,15
1650062913119,MATH 120A,A01,085445,Eggers; John Dietrich,9,0,35,26
1650062913119,MATH 120A,A02,085446,Eggers; John Dietrich,27,0,35,8
1650062919150,MATH 142B,A01,084149,Verstraete; Jacques Allan,0,12,30,30
1650062919150,MATH 142B,A02,084150,Verstraete; Jacques Allan,0,12,30,30
1650062925186,MATH 170A,A01,083459,Nie; Jiawang,0,10,30,30
1650062925186,MATH 170A,A02,083460,Nie; Jiawang,0,9,30,30
1650062925186,MATH 170A,A03,083461,Nie; Jiawang,0,9,30,30
1650062931215,MATH 193B,A01,083463,Staff,1,0,30,29
1650062931215,MATH 193B,A02,083464,Staff,8,0,30,22
1650062931215,MATH 193B,A03,083465,Staff,17,0,30,13
1650062937267,COGS 2,A01,083966,Boyle; Mary E. T.,10,0,30,20
1650062943290,COGS 9,A01,083968,Staff,5,0,60,55
1650062949320,COGS 14B,A01,083970,Staff,9,0,50,41
1650062955342,COGS 17,A01,092679,Staff,50,0,75,25
1650062961368,COGS 100,A01,083972,Staff,0,18,60,60
1650062973418,COGS 101C,A01,083976,Staff,12,0,30,18
1650062979442,COGS 102A,A01,083978,Johnson; Christine M.,12,0,30,18
1650062985465,COGS 107B,A01,083980,Staff,0,8,50,50
1650062991489,COGS 115,A01,083982,Staff,10,0,30,20
1650062997512,COGS 118B,A01,083367,Staff,0,15,40,40
1650063003547,COGS 172,A01,083984,Provenzano; Emily Kara,15,0,30,15
1650063009579,COGS 177,A00,083368,Staff,0,21,30,30
1650063015606,COGS 186,A01,083986,Staff,21,0,40,19
1650063021629,COGS 187A,A01,083988,Boyle; Mary E. T.,19,0,60,41
1650063027660,CSE 8A,A50,084003,Miranda; Gregory Joseph,0,18,15,15
1650063033694,CSE 11,A01,084005,Miranda; Gregory Joseph,0,23,55,55
1650063039720,CSE 20,A01,084007,Staff,0,5,20,20
1650063045761,CSE 21,A01,084009,Staff,1,33,50,49
1650063051797,CSE 30,A01,083370,Cao; Yingjun,0,64,40,40
1650063057821,CSE 100,A01,083372,Cao; Yingjun,0,47,40,40
1650063063845,CSE 101,A01,084011,Staff,0,56,40,40
1650063069872,CSE 141,A01,083374,Eldon; John,0,65,75,75
1650063075895,CSE 141L,A01,083376,Eldon; John,0,71,75,75
1650063081923,CSE 175,A01,084013,Kumar; Rakesh,22,0,25,3
1650063087947,CSE 190,A00,092508,Dubnov; Shlomo,18,0,20,2
1650063094006,ECE 5,A01,084049,Morris; Karcher William,12,0,20,8
1650063100039,ECE 100,A01,084051,Baghdadchi; Saharnaz,0,0,20,20
1650063100039,ECE 100,A02,091916,Baghdadchi; Saharnaz,12,0,20,8
1650063106060,ECE 101,A01,084053,Baghdadchi; Saharnaz,0,0,37,37
1650063106060,ECE 101,A02,084054,Baghdadchi; Saharnaz,28,0,37,9
1650063112085,ECE 107,A01,083390,Staff,26,0,40,14
1650063118109,ECE 148,A01,084056,Silberman; Jack,8,0,12,4
1650063124139,ECE 180,A00,083391,Abi Samra; Nicholas Camill,25,0,30,5
1650063124139,ECE 180,B00,083392,Abi Samra; Nicholas Camill,21,0,30,9
1650063130169,MATH 10B,A01,084110,Staff,0,0,30,30
1650063130169,MATH 10B,A02,084111,Staff,17,0,30,13
1650063130169,MATH 10B,A03,084112,Staff,23,0,30,7
1650063136193,MATH 10C,A01,083443,Staff,0,17,30,31
1650063136193,MATH 10C,A02,083444,Staff,1,17,30,29
1650063136193,MATH 10C,B01,084114,Staff,18,0,30,12
1650063136193,MATH 10C,B02,084115,Staff,25,0,30,5
1650063142215,MATH 18,A01,084117,Harel; Guershon,12,0,30,18
1650063142215,MATH 18,A02,084119,Harel; Guershon,27,0,30,3
1650063142215,MATH 18,A03,084120,Harel; Guershon,30,0,30,0
1650063142215,MATH 18,A04,084121,Harel; Guershon,29,0,30,1
1650063148244,MATH 20B,A01,084124,Um; Ko Woon,10,0,35,25
1650063148244,MATH 20B,B01,084126,Um; Ko Woon,24,0,35,11
1650063154274,MATH 20C,A01,083446,Hammock; Frances H,0,0,30,30
1650063154274,MATH 20C,A02,083447,Hammock; Frances H,13,0,30,17
1650063154274,MATH 20C,A03,083448,Hammock; Frances H,19,0,30,11
1650063154274,MATH 20C,A04,083449,Hammock; Frances H,20,0,30,10
1650063154274,MATH 20C,B01,083451,Hammock; Frances H,0,0,30,30
1650063154274,MATH 20C,B02,083452,Hammock; Frances H,15,0,30,15
1650063154274,MATH 20C,B03,083453,Hammock; Frances H,19,0,30,11
1650063154274,MATH 20C,B04,083454,Hammock; Frances H,23,0,30,7
1650063160298,MATH 20D,A01,084128,Staff,14,0,30,16
1650063160298,MATH 20D,A02,084129,Staff,29,0,30,1
1650063160298,MATH 20D,A03,084130,Staff,27,0,30,3
1650063160298,MATH 20D,B01,084133,Staff,0,0,30,30
1650063160298,MATH 20D,B02,084134,Staff,23,0,30,7
1650063160298,MATH 20D,B03,084135,Staff,28,0,30,2
1650063166323,MATH 20E,A01,084138,Staff,12,0,30,18
1650063166323,MATH 20E,A02,084139,Staff,6,0,30,24
1650063166323,MATH 20E,A03,084140,Staff,14,0,30,16
1650063166323,MATH 20E,A04,084141,Staff,19,0,30,11
1650063172345,MATH 102,A01,084143,Harel; Guershon,11,0,30,19
1650063172345,MATH 102,A02,084144,Harel; Guershon,19,0,30,11
1650063178372,MATH 103B,A01,083456,Staff,0,13,30,30
1650063178372,MATH 103B,A02,083457,Staff,0,14,30,30
1650063184396,MATH 109,A01,084146,Salehi Golsefidy; Alireza,16,0,30,14
1650063184396,MATH 109,A02,084147,Salehi Golsefidy; Alireza,15,0,30,15
1650063190420,MATH 120A,A01,085445,Eggers; John Dietrich,9,0,35,26
1650063190420,MATH 120A,A02,085446,Eggers; John Dietrich,26,0,35,9
1650063196447,MATH 142B,A01,084149,Verstraete; Jacques Allan,0,12,30,30
1650063196447,MATH 142B,A02,084150,Verstraete; Jacques Allan,0,12,30,30
1650063202478,MATH 170A,A01,083459,Nie; Jiawang,0,10,30,30
1650063202478,MATH 170A,A02,083460,Nie; Jiawang,0,9,30,30
1650063202478,MATH 170A,A03,083461,Nie; Jiawang,0,9,30,30
1650063208504,MATH 193B,A01,083463,Staff,1,0,30,29
1650063208504,MATH 193B,A02,083464,Staff,8,0,30,22
1650063208504,MATH 193B,A03,083465,Staff,17,0,30,13
1650063214566,COGS 2,A01,083966,Boyle; Mary E. T.,10,0,30,20
1650063220595,COGS 9,A01,083968,Staff,5,0,60,55
1650063226625,COGS 14B,A01,083970,Staff,9,0,50,41
1650063232655,COGS 17,A01,092679,Staff,50,0,75,25
1650063238681,COGS 100,A01,083972,Staff,0,18,60,60
1650063250732,COGS 101C,A01,083976,Staff,12,0,30,18
1650063256771,COGS 102A,A01,083978,Johnson; Christine M.,12,0,30,18
1650063262798,COGS 107B,A01,083980,Staff,0,8,50,50
1650063268910,COGS 115,A01,083982,Staff,10,0,30,20
1650063274934,COGS 118B,A01,083367,Staff,0,15,40,40
1650063280959,COGS 172,A01,083984,Provenzano; Emily Kara,15,0,30,15
1650063286987,COGS 177,A00,083368,Staff,0,21,30,30
1650063293010,COGS 186,A01,083986,Staff,21,0,40,19
1650063299033,COGS 187A,A01,083988,Boyle; Mary E. T.,19,0,60,41
1650063305064,CSE 8A,A50,084003,Miranda; Gregory Joseph,0,18,15,15
1650063311103,CSE 11,A01,084005,Miranda; Gregory Joseph,0,23,55,55
1650063317127,CSE 20,A01,084007,Staff,0,5,20,20
1650063323151,CSE 21,A01,084009,Staff,1,33,50,49
1650063329183,CSE 30,A01,083370,Cao; Yingjun,0,64,40,40
1650063335217,CSE 100,A01,083372,Cao; Yingjun,0,47,40,40
1650063341244,CSE 101,A01,084011,Staff,0,56,40,40
1650063347277,CSE 141,A01,083374,Eldon; John,0,65,75,75
1650063353302,CSE 141L,A01,083376,Eldon; John,0,71,75,75
1650063359325,CSE 175,A01,084013,Kumar; Rakesh,22,0,25,3
1650063365348,CSE 190,A00,092508,Dubnov; Shlomo,18,0,20,2
1650063371372,ECE 5,A01,084049,Morris; Karcher William,12,0,20,8
1650063377401,ECE 100,A01,084051,Baghdadchi; Saharnaz,0,0,20,20
1650063377401,ECE 100,A02,091916,Baghdadchi; Saharnaz,12,0,20,8
1650063383424,ECE 101,A01,084053,Baghdadchi; Saharnaz,0,0,37,37
1650063383424,ECE 101,A02,084054,Baghdadchi; Saharnaz,28,0,37,9
1650063389451,ECE 107,A01,083390,Staff,26,0,40,14
1650063395475,ECE 148,A01,084056,Silberman; Jack,8,0,12,4
1650063401499,ECE 180,A00,083391,Abi Samra; Nicholas Camill,25,0,30,5
1650063401499,ECE 180,B00,083392,Abi Samra; Nicholas Camill,21,0,30,9
1650063407527,MATH 10B,A01,084110,Staff,0,0,30,30
1650063407527,MATH 10B,A02,084111,Staff,17,0,30,13
1650063407527,MATH 10B,A03,084112,Staff,23,0,30,7
1650063413551,MATH 10C,A01,083443,Staff,0,17,30,31
1650063413551,MATH 10C,A02,083444,Staff,1,17,30,29
1650063413551,MATH 10C,B01,084114,Staff,18,0,30,12
1650063413551,MATH 10C,B02,084115,Staff,25,0,30,5
1650063419576,MATH 18,A01,084117,Harel; Guershon,12,0,30,18
1650063419576,MATH 18,A02,084119,Harel; Guershon,27,0,30,3
1650063419576,MATH 18,A03,084120,Harel; Guershon,30,0,30,0
1650063419576,MATH 18,A04,084121,Harel; Guershon,29,0,30,1
1650063425600,MATH 20B,A01,084124,Um; Ko Woon,10,0,35,25
1650063425600,MATH 20B,B01,084126,Um; Ko Woon,24,0,35,11
1650063431636,MATH 20C,A01,083446,Hammock; Frances H,0,0,30,30
1650063431636,MATH 20C,A02,083447,Hammock; Frances H,13,0,30,17
1650063431636,MATH 20C,A03,083448,Hammock; Frances H,19,0,30,11
1650063431636,MATH 20C,A04,083449,Hammock; Frances H,20,0,30,10
1650063431636,MATH 20C,B01,083451,Hammock; Frances H,0,0,30,30
1650063431636,MATH 20C,B02,083452,Hammock; Frances H,15,0,30,15
1650063431636,MATH 20C,B03,083453,Hammock; Frances H,19,0,30,11
1650063431636,MATH 20C,B04,083454,Hammock; Frances H,23,0,30,7
1650063437660,MATH 20D,A01,084128,Staff,14,0,30,16
1650063437660,MATH 20D,A02,084129,Staff,29,0,30,1
1650063437660,MATH 20D,A03,084130,Staff,27,0,30,3
1650063437660,MATH 20D,B01,084133,Staff,0,0,30,30
1650063437660,MATH 20D,B02,084134,Staff,23,0,30,7
1650063437660,MATH 20D,B03,084135,Staff,28,0,30,2
1650063443693,MATH 20E,A01,084138,Staff,12,0,30,18
1650063443693,MATH 20E,A02,084139,Staff,6,0,30,24
1650063443693,MATH 20E,A03,084140,Staff,14,0,30,16
1650063443693,MATH 20E,A04,084141,Staff,19,0,30,11
1650063449715,MATH 102,A01,084143,Harel; Guershon,11,0,30,19
1650063449715,MATH 102,A02,084144,Harel; Guershon,19,0,30,11
1650063455756,MATH 103B,A01,083456,Staff,0,13,30,30
1650063455756,MATH 103B,A02,083457,Staff,0,14,30,30
1650063461781,MATH 109,A01,084146,Salehi Golsefidy; Alireza,16,0,30,14
1650063461781,MATH 109,A02,084147,Salehi Golsefidy; Alireza,15,0,30,15
1650063467808,MATH 120A,A01,085445,Eggers; John Dietrich,9,0,35,26
1650063467808,MATH 120A,A02,085446,Eggers; John Dietrich,26,0,35,9
1650063473837,MATH 142B,A01,084149,Verstraete; Jacques Allan,0,12,30,30
1650063473837,MATH 142B,A02,084150,Verstraete; Jacques Allan,0,12,30,30
1650063479860,MATH 170A,A01,083459,Nie; Jiawang,0,10,30,30
1650063479860,MATH 170A,A02,083460,Nie; Jiawang,0,9,30,30
1650063479860,MATH 170A,A03,083461,Nie; Jiawang,0,9,30,30
1650063485886,MATH 193B,A01,083463,Staff,1,0,30,29
1650063485886,MATH 193B,A02,083464,Staff,8,0,30,22
1650063485886,MATH 193B,A03,083465,Staff,17,0,30,13
1650063491943,COGS 2,A01,083966,Boyle; Mary E. T.,10,0,30,20
1650063497974,COGS 9,A01,083968,Staff,5,0,60,55
1650063503996,COGS 14B,A01,083970,Staff,9,0,50,41
1650063510040,COGS 17,A01,092679,Staff,50,0,75,25
1650063516065,COGS 100,A01,083972,Staff,0,18,60,60
1650063528123,COGS 101C,A01,083976,Staff,12,0,30,18
1650063534150,COGS 102A,A01,083978,Johnson; Christine M.,12,0,30,18
1650063540173,COGS 107B,A01,083980,Staff,0,8,50,50
1650063546196,COGS 115,A01,083982,Staff,10,0,30,20
1650063552219,COGS 118B,A01,083367,Staff,0,15,40,40
1650063558245,COGS 172,A01,083984,Provenzano; Emily Kara,15,0,30,15
1650063564269,COGS 177,A00,083368,Staff,0,21,30,30
1650063570295,COGS 186,A01,083986,Staff,21,0,40,19
1650063576321,COGS 187A,A01,083988,Boyle; Mary E. T.,19,0,60,41
1650063582353,CSE 8A,A50,084003,Miranda; Gregory Joseph,0,18,15,15
1650063588378,CSE 11,A01,084005,Miranda; Gregory Joseph,0,23,55,55
1650063594401,CSE 20,A01,084007,Staff,0,5,20,20
1650063600423,CSE 21,A01,084009,Staff,1,33,50,49
1650063606447,CSE 30,A01,083370,Cao; Yingjun,0,64,40,40
1650063612483,CSE 100,A01,083372,Cao; Yingjun,0,47,40,40
1650063618506,CSE 101,A01,084011,Staff,0,56,40,40
1650063624530,CSE 141,A01,083374,Eldon; John,0,65,75,75
1650063630553,CSE 141L,A01,083376,Eldon; John,0,71,75,75
1650063636589,CSE 175,A01,084013,Kumar; Rakesh,22,0,25,3
1650063642613,CSE 190,A00,092508,Dubnov; Shlomo,18,0,20,2
1650063648637,ECE 5,A01,084049,Morris; Karcher William,12,0,20,8
1650063654663,ECE 100,A01,084051,Baghdadchi; Saharnaz,0,0,20,20
1650063654663,ECE 100,A02,091916,Baghdadchi; Saharnaz,12,0,20,8
1650063660695,ECE 101,A01,084053,Baghdadchi; Saharnaz,0,0,37,37
1650063660695,ECE 101,A02,084054,Baghdadchi; Saharnaz,28,0,37,9
1650063666729,ECE 107,A01,083390,Staff,26,0,40,14
1650063672753,ECE 148,A01,084056,Silberman; Jack,8,0,12,4
1650063678789,ECE 180,A00,083391,Abi Samra; Nicholas Camill,25,0,30,5
1650063678789,ECE 180,B00,083392,Abi Samra; Nicholas Camill,21,0,30,9
1650063684818,MATH 10B,A01,084110,Staff,0,0,30,30
1650063684818,MATH 10B,A02,084111,Staff,17,0,30,13
1650063684818,MATH 10B,A03,084112,Staff,23,0,30,7
1650063690860,MATH 10C,A01,083443,Staff,0,17,30,31
1650063690860,MATH 10C,A02,083444,Staff,1,17,30,29
1650063690860,MATH 10C,B01,084114,Staff,18,0,30,12
1650063690860,MATH 10C,B02,084115,Staff,25,0,30,5
1650063696884,MATH 18,A01,084117,Harel; Guershon,12,0,30,18
1650063696884,MATH 18,A02,084119,Harel; Guershon,27,0,30,3
1650063696884,MATH 18,A03,084120,Harel; Guershon,30,0,30,0
1650063696884,MATH 18,A04,084121,Harel; Guershon,29,0,30,1
1650063702919,MATH 20B,A01,084124,Um; Ko Woon,10,0,35,25
1650063702919,MATH 20B,B01,084126,Um; Ko Woon,24,0,35,11
1650063708944,MATH 20C,A01,083446,Hammock; Frances H,0,0,30,30
1650063708944,MATH 20C,A02,083447,Hammock; Frances H,13,0,30,17
1650063708944,MATH 20C,A03,083448,Hammock; Frances H,19,0,30,11
1650063708944,MATH 20C,A04,083449,Hammock; Frances H,20,0,30,10
1650063708944,MATH 20C,B01,083451,Hammock; Frances H,0,0,30,30
1650063708944,MATH 20C,B02,083452,Hammock; Frances H,15,0,30,15
1650063708944,MATH 20C,B03,083453,Hammock; Frances H,19,0,30,11
1650063708944,MATH 20C,B04,083454,Hammock; Frances H,23,0,30,7
1650063714967,MATH 20D,A01,084128,Staff,14,0,30,16
1650063714967,MATH 20D,A02,084129,Staff,29,0,30,1
1650063714967,MATH 20D,A03,084130,Staff,27,0,30,3
1650063714967,MATH 20D,B01,084133,Staff,0,0,30,30
1650063714967,MATH 20D,B02,084134,Staff,23,0,30,7
1650063714967,MATH 20D,B03,084135,Staff,28,0,30,2
1650063720990,MATH 20E,A01,084138,Staff,12,0,30,18
1650063720990,MATH 20E,A02,084139,Staff,6,0,30,24
1650063720990,MATH 20E,A03,084140,Staff,14,0,30,16
1650063720990,MATH 20E,A04,084141,Staff,19,0,30,11
1650063727021,MATH 102,A01,084143,Harel; Guershon,11,0,30,19
1650063727021,MATH 102,A02,084144,Harel; Guershon,19,0,30,11
1650063733055,MATH 103B,A01,083456,Staff,0,13,30,30
1650063733055,MATH 103B,A02,083457,Staff,0,14,30,30
1650063739079,MATH 109,A01,084146,Salehi Golsefidy; Alireza,16,0,30,14
1650063739079,MATH 109,A02,084147,Salehi Golsefidy; Alireza,15,0,30,15
1650063745115,MATH 120A,A01,085445,Eggers; John Dietrich,9,0,35,26
1650063745115,MATH 120A,A02,085446,Eggers; John Dietrich,26,0,35,9
1650063751143,MATH 142B,A01,084149,Verstraete; Jacques Allan,0,12,30,30
1650063751143,MATH 142B,A02,084150,Verstraete; Jacques Allan,0,12,30,30
1650063757166,MATH 170A,A01,083459,Nie; Jiawang,0,10,30,30
1650063757166,MATH 170A,A02,083460,Nie; Jiawang,0,9,30,30
1650063757166,MATH 170A,A03,083461,Nie; Jiawang,0,9,30,30
1650063763193,MATH 193B,A01,083463,Staff,1,0,30,29
1650063763193,MATH 193B,A02,083464,Staff,8,0,30,22
1650063763193,MATH 193B,A03,083465,Staff,17,0,30,13
1650063769241,COGS 2,A01,083966,Boyle; Mary E. T.,10,0,30,20
1650063775264,COGS 9,A01,083968,Staff,5,0,60,55
1650063781287,COGS 14B,A01,083970,Staff,9,0,50,41
1650063787311,COGS 17,A01,092679,Staff,50,0,75,25
1650063793337,COGS 100,A01,083972,Staff,0,18,60,60
1650063805388,COGS 101C,A01,083976,Staff,12,0,30,18
1650063811426,COGS 102A,A01,083978,Johnson; Christine M.,12,0,30,18
1650063817451,COGS 107B,A01,083980,Staff,0,8,50,50
1650063823481,COGS 115,A01,083982,Staff,10,0,30,20
1650063829508,COGS 118B,A01,083367,Staff,0,15,40,40
1650063835531,COGS 172,A01,083984,Provenzano; Emily Kara,15,0,30,15
1650063841555,COGS 177,A00,083368,Staff,0,21,30,30
1650063847580,COGS 186,A01,083986,Staff,21,0,40,19
1650063853602,COGS 187A,A01,083988,Boyle; Mary E. T.,19,0,60,41
1650063859636,CSE 8A,A50,084003,Miranda; Gregory Joseph,0,18,15,15
1650063865761,CSE 11,A01,084005,Miranda; Gregory Joseph,0,23,55,55
1650063871785,CSE 20,A01,084007,Staff,0,5,20,20
1650063877813,CSE 21,A01,084009,Staff,1,33,50,49
1650063883837,CSE 30,A01,083370,Cao; Yingjun,0,64,40,40
1650063889863,CSE 100,A01,083372,Cao; Yingjun,0,47,40,40
1650063895889,CSE 101,A01,084011,Staff,0,56,40,40
1650063901916,CSE 141,A01,083374,Eldon; John,0,65,75,75
1650063907940,CSE 141L,A01,083376,Eldon; John,0,71,75,75
1650063913973,CSE 175,A01,084013,Kumar; Rakesh,22,0,25,3
1650063919995,CSE 190,A00,092508,Dubnov; Shlomo,18,0,20,2
1650063926022,ECE 5,A01,084049,Morris; Karcher William,12,0,20,8
1650063932045,ECE 100,A01,084051,Baghdadchi; Saharnaz,0,0,20,20
1650063932045,ECE 100,A02,091916,Baghdadchi; Saharnaz,12,0,20,8
1650063938093,ECE 101,A01,084053,Baghdadchi; Saharnaz,0,0,37,37
1650063938093,ECE 101,A02,084054,Baghdadchi; Saharnaz,28,0,37,9
1650063944116,ECE 107,A01,083390,Staff,26,0,40,14
1650063950143,ECE 148,A01,084056,Silberman; Jack,8,0,12,4
1650063956170,ECE 180,A00,083391,Abi Samra; Nicholas Camill,25,0,30,5
1650063956170,ECE 180,B00,083392,Abi Samra; Nicholas Camill,21,0,30,9
1650063962209,MATH 10B,A01,084110,Staff,0,0,30,30
1650063962209,MATH 10B,A02,084111,Staff,17,0,30,13
1650063962209,MATH 10B,A03,084112,Staff,23,0,30,7
1650063968234,MATH 10C,A01,083443,Staff,0,17,30,31
1650063968234,MATH 10C,A02,083444,Staff,1,17,30,29
1650063968234,MATH 10C,B01,084114,Staff,18,0,30,12
1650063968234,MATH 10C,B02,084115,Staff,25,0,30,5
1650063974257,MATH 18,A01,084117,Harel; Guershon,12,0,30,18
1650063974257,MATH 18,A02,084119,Harel; Guershon,27,0,30,3
1650063974257,MATH 18,A03,084120,Harel; Guershon,30,0,30,0
1650063974257,MATH 18,A04,084121,Harel; Guershon,29,0,30,1
1650063980289,MATH 20B,A01,084124,Um; Ko Woon,10,0,35,25
1650063980289,MATH 20B,B01,084126,Um; Ko Woon,24,0,35,11
1650063986316,MATH 20C,A01,083446,Hammock; Frances H,0,0,30,30
1650063986316,MATH 20C,A02,083447,Hammock; Frances H,13,0,30,17
1650063986316,MATH 20C,A03,083448,Hammock; Frances H,19,0,30,11
1650063986316,MATH 20C,A04,083449,Hammock; Frances H,20,0,30,10
1650063986316,MATH 20C,B01,083451,Hammock; Frances H,0,0,30,30
1650063986316,MATH 20C,B02,083452,Hammock; Frances H,15,0,30,15
1650063986316,MATH 20C,B03,083453,Hammock; Frances H,19,0,30,11
1650063986316,MATH 20C,B04,083454,Hammock; Frances H,23,0,30,7
1650063992341,MATH 20D,A01,084128,Staff,14,0,30,16
1650063992341,MATH 20D,A02,084129,Staff,29,0,30,1
1650063992341,MATH 20D,A03,084130,Staff,27,0,30,3
1650063992341,MATH 20D,B01,084133,Staff,0,0,30,30
1650063992341,MATH 20D,B02,084134,Staff,23,0,30,7
1650063992341,MATH 20D,B03,084135,Staff,28,0,30,2
1650063998365,MATH 20E,A01,084138,Staff,12,0,30,18
1650063998365,MATH 20E,A02,084139,Staff,6,0,30,24
1650063998365,MATH 20E,A03,084140,Staff,14,0,30,16
1650063998365,MATH 20E,A04,084141,Staff,19,0,30,11
1650064004392,MATH 102,A01,084143,Harel; Guershon,11,0,30,19
1650064004392,MATH 102,A02,084144,Harel; Guershon,19,0,30,11
1650064010418,MATH 103B,A01,083456,Staff,0,13,30,30
1650064010418,MATH 103B,A02,083457,Staff,0,14,30,30
1650064016443,MATH 109,A01,084146,Salehi Golsefidy; Alireza,16,0,30,14
1650064016443,MATH 109,A02,084147,Salehi Golsefidy; Alireza,15,0,30,15
1650064022477,MATH 120A,A01,085445,Eggers; John Dietrich,9,0,35,26
1650064022477,MATH 120A,A02,085446,Eggers; John Dietrich,26,0,35,9
1650064028505,MATH 142B,A01,084149,Verstraete; Jacques Allan,0,12,30,30
1650064028505,MATH 142B,A02,084150,Verstraete; Jacques Allan,0,12,30,30
1650064034528,MATH 170A,A01,083459,Nie; Jiawang,0,10,30,30
1650064034528,MATH 170A,A02,083460,Nie; Jiawang,0,9,30,30
1650064034528,MATH 170A,A03,083461,Nie; Jiawang,0,9,30,30
1650064040554,MATH 193B,A01,083463,Staff,1,0,30,29
1650064040554,MATH 193B,A02,083464,Staff,8,0,30,22
1650064040554,MATH 193B,A03,083465,Staff,17,0,30,13
1650064046618,COGS 2,A01,083966,Boyle; Mary E. T.,10,0,30,20
1650064052643,COGS 9,A01,083968,Staff,5,0,60,55
1650064058667,COGS 14B,A01,083970,Staff,9,0,50,41
1650064064698,COGS 17,A01,092679,Staff,50,0,75,25
1650064070725,COGS 100,A01,083972,Staff,0,18,60,60
1650064082781,COGS 101C,A01,083976,Staff,12,0,30,18
1650064088810,COGS 102A,A01,083978,Johnson; Christine M.,12,0,30,18
1650064094837,COGS 107B,A01,083980,Staff,0,8,50,50
1650064100861,COGS 115,A01,083982,Staff,10,0,30,20
1650064106886,COGS 118B,A01,083367,Staff,0,15,40,40
1650064112914,COGS 172,A01,083984,Provenzano; Emily Kara,15,0,30,15
1650064118938,COGS 177,A00,083368,Staff,0,21,30,30
1650064124963,COGS 186,A01,083986,Staff,21,0,40,19
1650064130986,COGS 187A,A01,083988,Boyle; Mary E. T.,19,0,60,41
1650064137010,CSE 8A,A50,084003,Miranda; Gregory Joseph,0,18,15,15
1650064143037,CSE 11,A01,084005,Miranda; Gregory Joseph,0,23,55,55
1650064149059,CSE 20,A01,084007,Staff,0,5,20,20
1650064155081,CSE 21,A01,084009,Staff,1,33,50,49
1650064161105,CSE 30,A01,083370,Cao; Yingjun,0,64,40,40
1650064167127,CSE 100,A01,083372,Cao; Yingjun,0,47,40,40
1650064173149,CSE 101,A01,084011,Staff,0,56,40,40
1650064179174,CSE 141,A01,083374,Eldon; John,0,65,75,75
1650064185200,CSE 141L,A01,083376,Eldon; John,0,71,75,75
1650064191232,CSE 175,A01,084013,Kumar; Rakesh,22,0,25,3
1650064197265,CSE 190,A00,092508,Dubnov; Shlomo,18,0,20,2
1650064203289,ECE 5,A01,084049,Morris; Karcher William,12,0,20,8
1650064209319,ECE 100,A01,084051,Baghdadchi; Saharnaz,0,0,20,20
1650064209319,ECE 100,A02,091916,Baghdadchi; Saharnaz,12,0,20,8
1650064215351,ECE 101,A01,084053,Baghdadchi; Saharnaz,0,0,37,37
1650064215351,ECE 101,A02,084054,Baghdadchi; Saharnaz,28,0,37,9
1650064221379,ECE 107,A01,083390,Staff,26,0,40,14
1650064227404,ECE 148,A01,084056,Silberman; Jack,8,0,12,4
1650064233427,ECE 180,A00,083391,Abi Samra; Nicholas Camill,25,0,30,5
1650064233427,ECE 180,B00,083392,Abi Samra; Nicholas Camill,21,0,30,9
1650064239450,MATH 10B,A01,084110,Staff,0,0,30,30
1650064239450,MATH 10B,A02,084111,Staff,17,0,30,13
1650064239450,MATH 10B,A03,084112,Staff,23,0,30,7
1650064245474,MATH 10C,A01,083443,Staff,0,17,30,31
1650064245474,MATH 10C,A02,083444,Staff,1,17,30,29
1650064245474,MATH 10C,B01,084114,Staff,18,0,30,12
1650064245474,MATH 10C,B02,084115,Staff,25,0,30,5
1650064251497,MATH 18,A01,084117,Harel; Guershon,12,0,30,18
1650064251497,MATH 18,A02,084119,Harel; Guershon,27,0,30,3
1650064251497,MATH 18,A03,084120,Harel; Guershon,30,0,30,0
1650064251497,MATH 18,A04,084121,Harel; Guershon,29,0,30,1
1650064257523,MATH 20B,A01,084124,Um; Ko Woon,10,0,35,25
1650064257523,MATH 20B,B01,084126,Um; Ko Woon,24,0,35,11
1650064263554,MATH 20C,A01,083446,Hammock; Frances H,0,0,30,30
1650064263554,MATH 20C,A02,083447,Hammock; Frances H,13,0,30,17
1650064263554,MATH 20C,A03,083448,Hammock; Frances H,19,0,30,11
1650064263554,MATH 20C,A04,083449,Hammock; Frances H,20,0,30,10
1650064263554,MATH 20C,B01,083451,Hammock; Frances H,0,0,30,30
1650064263554,MATH 20C,B02,083452,Hammock; Frances H,15,0,30,15
1650064263554,MATH 20C,B03,083453,Hammock; Frances H,19,0,30,11
1650064263554,MATH 20C,B04,083454,Hammock; Frances H,23,0,30,7
1650064269583,MATH 20D,A01,084128,Staff,14,0,30,16
1650064269583,MATH 20D,A02,084129,Staff,29,0,30,1
1650064269583,MATH 20D,A03,084130,Staff,27,0,30,3
1650064269583,MATH 20D,B01,084133,Staff,0,0,30,30
1650064269583,MATH 20D,B02,084134,Staff,23,0,30,7
1650064269583,MATH 20D,B03,084135,Staff,28,0,30,2
1650064275617,MATH 20E,A01,084138,Staff,12,0,30,18
1650064275617,MATH 20E,A02,084139,Staff,6,0,30,24
1650064275617,MATH 20E,A03,084140,Staff,14,0,30,16
1650064275617,MATH 20E,A04,084141,Staff,19,0,30,11
1650064281651,MATH 102,A01,084143,Harel; Guershon,11,0,30,19
1650064281651,MATH 102,A02,084144,Harel; Guershon,19,0,30,11
1650064287674,MATH 103B,A01,083456,Staff,0,13,30,30
1650064287674,MATH 103B,A02,083457,Staff,0,14,30,30
1650064293702,MATH 109,A01,084146,Salehi Golsefidy; Alireza,16,0,30,14
1650064293702,MATH 109,A02,084147,Salehi Golsefidy; Alireza,15,0,30,15
1650064299725,MATH 120A,A01,085445,Eggers; John Dietrich,9,0,35,26
1650064299725,MATH 120A,A02,085446,Eggers; John Dietrich,26,0,35,9
1650064305753,MATH 142B,A01,084149,Verstraete; Jacques Allan,0,12,30,30
1650064305753,MATH 142B,A02,084150,Verstraete; Jacques Allan,0,12,30,30
1650064311781,MATH 170A,A01,083459,Nie; Jiawang,0,10,30,30
1650064311781,MATH 170A,A02,083460,Nie; Jiawang,0,9,30,30
1650064311781,MATH 170A,A03,083461,Nie; Jiawang,0,9,30,30
1650064317808,MATH 193B,A01,083463,Staff,1,0,30,29
1650064317808,MATH 193B,A02,083464,Staff,8,0,30,22
1650064317808,MATH 193B,A03,083465,Staff,17,0,30,13
1650064323875,COGS 2,A01,083966,Boyle; Mary E. T.,10,0,30,20
1650064329899,COGS 9,A01,083968,Staff,5,0,60,55
1650064335923,COGS 14B,A01,083970,Staff,9,0,50,41
1650064341949,COGS 17,A01,092679,Staff,50,0,75,25
1650064347975,COGS 100,A01,083972,Staff,0,18,60,60
1650064360036,COGS 101C,A01,083976,Staff,12,0,30,18
1650064366063,COGS 102A,A01,083978,Johnson; Christine M.,12,0,30,18
1650064372089,COGS 107B,A01,083980,Staff,0,8,50,50
1650064378114,COGS 115,A01,083982,Staff,10,0,30,20
1650064384137,COGS 118B,A01,083367,Staff,0,15,40,40
1650064390159,COGS 172,A01,083984,Provenzano; Emily Kara,15,0,30,15
1650064396185,COGS 177,A00,083368,Staff,0,21,30,30
1650064402212,COGS 186,A01,083986,Staff,21,0,40,19
1650064408245,COGS 187A,A01,083988,Boyle; Mary E. T.,19,0,60,41
1650064414272,CSE 8A,A50,084003,Miranda; Gregory Joseph,0,18,15,15
1650064420296,CSE 11,A01,084005,Miranda; Gregory Joseph,0,23,55,55
1650064426320,CSE 20,A01,084007,Staff,0,5,20,20
1650064432343,CSE 21,A01,084009,Staff,1,33,50,49
1650064438367,CSE 30,A01,083370,Cao; Yingjun,0,64,40,40
1650064444394,CSE 100,A01,083372,Cao; Yingjun,0,47,40,40
1650064450416,CSE 101,A01,084011,Staff,0,56,40,40
1650064456444,CSE 141,A01,083374,Eldon; John,0,65,75,75
1650064462562,CSE 141L,A01,083376,Eldon; John,0,71,75,75
1650064468589,CSE 175,A01,084013,Kumar; Rakesh,22,0,25,3
1650064474615,CSE 190,A00,092508,Dubnov; Shlomo,18,0,20,2
1650064480641,ECE 5,A01,084049,Morris; Karcher William,12,0,20,8
1650064486668,ECE 100,A01,084051,Baghdadchi; Saharnaz,0,0,20,20
1650064486668,ECE 100,A02,091916,Baghdadchi; Saharnaz,12,0,20,8
1650064492694,ECE 101,A01,084053,Baghdadchi; Saharnaz,0,0,37,37
1650064492694,ECE 101,A02,084054,Baghdadchi; Saharnaz,28,0,37,9
1650064498725,ECE 107,A01,083390,Staff,26,0,40,14
1650064504754,ECE 148,A01,084056,Silberman; Jack,8,0,12,4
1650064510786,ECE 180,A00,083391,Abi Samra; Nicholas Camill,25,0,30,5
1650064510786,ECE 180,B00,083392,Abi Samra; Nicholas Camill,21,0,30,9
1650064516810,MATH 10B,A01,084110,Staff,0,0,30,30
1650064516810,MATH 10B,A02,084111,Staff,17,0,30,13
1650064516810,MATH 10B,A03,084112,Staff,23,0,30,7
1650064522835,MATH 10C,A01,083443,Staff,0,17,30,31
1650064522835,MATH 10C,A02,083444,Staff,1,17,30,29
1650064522835,MATH 10C,B01,084114,Staff,18,0,30,12
1650064522835,MATH 10C,B02,084115,Staff,25,0,30,5
1650064528859,MATH 18,A01,084117,Harel; Guershon,12,0,30,18
1650064528859,MATH 18,A02,084119,Harel; Guershon,27,0,30,3
1650064528859,MATH 18,A03,084120,Harel; Guershon,30,0,30,0
1650064528859,MATH 18,A04,084121,Harel; Guershon,29,0,30,1
1650064534883,MATH 20B,A01,084124,Um; Ko Woon,10,0,35,25
1650064534883,MATH 20B,B01,084126,Um; Ko Woon,24,0,35,11
1650064540908,MATH 20C,A01,083446,Hammock; Frances H,0,0,30,30
1650064540908,MATH 20C,A02,083447,Hammock; Frances H,13,0,30,17
1650064540908,MATH 20C,A03,083448,Hammock; Frances H,19,0,30,11
1650064540908,MATH 20C,A04,083449,Hammock; Frances H,20,0,30,10
1650064540908,MATH 20C,B01,083451,Hammock; Frances H,0,0,30,30
1650064540908,MATH 20C,B02,083452,Hammock; Frances H,15,0,30,15
1650064540908,MATH 20C,B03,083453,Hammock; Frances H,19,0,30,11
1650064540908,MATH 20C,B04,083454,Hammock; Frances H,23,0,30,7
1650064546936,MATH 20D,A01,084128,Staff,14,0,30,16
1650064546936,MATH 20D,A02,084129,Staff,29,0,30,1
1650064546936,MATH 20D,A03,084130,Staff,27,0,30,3
1650064546936,MATH 20D,B01,084133,Staff,0,0,30,30
1650064546936,MATH 20D,B02,084134,Staff,23,0,30,7
1650064546936,MATH 20D,B03,084135,Staff,28,0,30,2
1650064552964,MATH 20E,A01,084138,Staff,12,0,30,18
1650064552964,MATH 20E,A02,084139,Staff,6,0,30,24
1650064552964,MATH 20E,A03,084140,Staff,14,0,30,16
1650064552964,MATH 20E,A04,084141,Staff,19,0,30,11
1650064558990,MATH 102,A01,084143,Harel; Guershon,11,0,30,19
1650064558990,MATH 102,A02,084144,Harel; Guershon,19,0,30,11
1650064565017,MATH 103B,A01,083456,Staff,0,13,30,30
1650064565017,MATH 103B,A02,083457,Staff,0,14,30,30
1650064571044,MATH 109,A01,084146,Salehi Golsefidy; Alireza,16,0,30,14
1650064571044,MATH 109,A02,084147,Salehi Golsefidy; Alireza,15,0,30,15
1650064577072,MATH 120A,A01,085445,Eggers; John Dietrich,9,0,35,26
1650064577072,MATH 120A,A02,085446,Eggers; John Dietrich,26,0,35,9
1650064583099,MATH 142B,A01,084149,Verstraete; Jacques Allan,0,12,30,30
1650064583099,MATH 142B,A02,084150,Verstraete; Jacques Allan,0,12,30,30
1650064589123,MATH 170A,A01,083459,Nie; Jiawang,0,10,30,30
1650064589123,MATH 170A,A02,083460,Nie; Jiawang,0,9,30,30
1650064589123,MATH 170A,A03,083461,Nie; Jiawang,0,9,30,30
1650064595147,MATH 193B,A01,083463,Staff,1,0,30,29
1650064595147,MATH 193B,A02,083464,Staff,8,0,30,22
1650064595147,MATH 193B,A03,083465,Staff,17,0,30,13
1650064601205,COGS 2,A01,083966,Boyle; Mary E. T.,10,0,30,20
1650064607246,COGS 9,A01,083968,Staff,5,0,60,55
1650064613272,COGS 14B,A01,083970,Staff,9,0,50,41
1650064619295,COGS 17,A01,092679,Staff,49,0,75,26
1650064625368,COGS 100,A01,083972,Staff,0,18,60,60
1650064637423,COGS 101C,A01,083976,Staff,12,0,30,18
1650064643447,COGS 102A,A01,083978,Johnson; Christine M.,12,0,30,18
1650064649472,COGS 107B,A01,083980,Staff,0,8,50,50
1650064655496,COGS 115,A01,083982,Staff,10,0,30,20
1650064661532,COGS 118B,A01,083367,Staff,0,15,40,40
1650064667558,COGS 172,A01,083984,Provenzano; Emily Kara,15,0,30,15
1650064673582,COGS 177,A00,083368,Staff,0,21,30,30
1650064679623,COGS 186,A01,083986,Staff,21,0,40,19
1650064685649,COGS 187A,A01,083988,Boyle; Mary E. T.,19,0,60,41
1650064691677,CSE 8A,A50,084003,Miranda; Gregory Joseph,0,18,15,15
1650064697700,CSE 11,A01,084005,Miranda; Gregory Joseph,0,23,55,55
1650064703727,CSE 20,A01,084007,Staff,0,5,20,20
1650064709754,CSE 21,A01,084009,Staff,1,33,50,49
1650064715781,CSE 30,A01,083370,Cao; Yingjun,0,64,40,40
1650064721811,CSE 100,A01,083372,Cao; Yingjun,0,47,40,40
1650064727840,CSE 101,A01,084011,Staff,0,56,40,40
1650064733867,CSE 141,A01,083374,Eldon; John,0,65,75,75
1650064739894,CSE 141L,A01,083376,Eldon; John,0,71,75,75
1650064745920,CSE 175,A01,084013,Kumar; Rakesh,22,0,25,3
1650064751957,CSE 190,A00,092508,Dubnov; Shlomo,18,0,20,2
1650064757981,ECE 5,A01,084049,Morris; Karcher William,12,0,20,8
1650064764009,ECE 100,A01,084051,Baghdadchi; Saharnaz,0,0,20,20
1650064764009,ECE 100,A02,091916,Baghdadchi; Saharnaz,12,0,20,8
1650064770040,ECE 101,A01,084053,Baghdadchi; Saharnaz,0,0,37,37
1650064770040,ECE 101,A02,084054,Baghdadchi; Saharnaz,28,0,37,9
1650064776065,ECE 107,A01,083390,Staff,26,0,40,14
1650064782087,ECE 148,A01,084056,Silberman; Jack,8,0,12,4
1650064788112,ECE 180,A00,083391,Abi Samra; Nicholas Camill,25,0,30,5
1650064788112,ECE 180,B00,083392,Abi Samra; Nicholas Camill,21,0,30,9
1650064794137,MATH 10B,A01,084110,Staff,0,0,30,30
1650064794137,MATH 10B,A02,084111,Staff,17,0,30,13
1650064794137,MATH 10B,A03,084112,Staff,23,0,30,7
1650064800165,MATH 10C,A01,083443,Staff,0,17,30,31
1650064800165,MATH 10C,A02,083444,Staff,1,17,30,29
1650064800165,MATH 10C,B01,084114,Staff,18,0,30,12
1650064800165,MATH 10C,B02,084115,Staff,25,0,30,5
1650064806192,MATH 18,A01,084117,Harel; Guershon,12,0,30,18
1650064806192,MATH 18,A02,084119,Harel; Guershon,27,0,30,3
1650064806192,MATH 18,A03,084120,Harel; Guershon,30,0,30,0
1650064806192,MATH 18,A04,084121,Harel; Guershon,29,0,30,1
1650064812221,MATH 20B,A01,084124,Um; Ko Woon,10,0,35,25
1650064812221,MATH 20B,B01,084126,Um; Ko Woon,24,0,35,11
1650064818248,MATH 20C,A01,083446,Hammock; Frances H,0,0,30,30
1650064818248,MATH 20C,A02,083447,Hammock; Frances H,13,0,30,17
1650064818248,MATH 20C,A03,083448,Hammock; Frances H,19,0,30,11
1650064818248,MATH 20C,A04,083449,Hammock; Frances H,20,0,30,10
1650064818248,MATH 20C,B01,083451,Hammock; Frances H,0,0,30,30
1650064818248,MATH 20C,B02,083452,Hammock; Frances H,15,0,30,15
1650064818248,MATH 20C,B03,083453,Hammock; Frances H,19,0,30,11
1650064818248,MATH 20C,B04,083454,Hammock; Frances H,23,0,30,7
1650064824271,MATH 20D,A01,084128,Staff,14,0,30,16
1650064824271,MATH 20D,A02,084129,Staff,29,0,30,1
1650064824271,MATH 20D,A03,084130,Staff,27,0,30,3
1650064824271,MATH 20D,B01,084133,Staff,0,0,30,30
1650064824271,MATH 20D,B02,084134,Staff,23,0,30,7
1650064824271,MATH 20D,B03,084135,Staff,28,0,30,2
1650064830295,MATH 20E,A01,084138,Staff,12,0,30,18
1650064830295,MATH 20E,A02,084139,Staff,6,0,30,24
1650064830295,MATH 20E,A03,084140,Staff,14,0,30,16
1650064830295,MATH 20E,A04,084141,Staff,19,0,30,11
1650064836321,MATH 102,A01,084143,Harel; Guershon,11,0,30,19
1650064836321,MATH 102,A02,084144,Harel; Guershon,19,0,30,11
1650064842344,MATH 103B,A01,083456,Staff,0,13,30,30
1650064842344,MATH 103B,A02,083457,Staff,0,14,30,30
1650064848375,MATH 109,A01,084146,Salehi Golsefidy; Alireza,16,0,30,14
1650064848375,MATH 109,A02,084147,Salehi Golsefidy; Alireza,15,0,30,15
1650064854399,MATH 120A,A01,085445,Eggers; John Dietrich,9,0,35,26
1650064854399,MATH 120A,A02,085446,Eggers; John Dietrich,26,0,35,9
1650064860424,MATH 142B,A01,084149,Verstraete; Jacques Allan,0,12,30,30
1650064860424,MATH 142B,A02,084150,Verstraete; Jacques Allan,0,12,30,30
1650064866449,MATH 170A,A01,083459,Nie; Jiawang,0,10,30,30
1650064866449,MATH 170A,A02,083460,Nie; Jiawang,0,9,30,30
1650064866449,MATH 170A,A03,083461,Nie; Jiawang,0,9,30,30
1650064872472,MATH 193B,A01,083463,Staff,1,0,30,29
1650064872472,MATH 193B,A02,083464,Staff,8,0,30,22
1650064872472,MATH 193B,A03,083465,Staff,17,0,30,13
1650064878551,COGS 2,A01,083966,Boyle; Mary E. T.,10,0,30,20
1650064884578,COGS 9,A01,083968,Staff,5,0,60,55
1650064890605,COGS 14B,A01,083970,Staff,9,0,50,41
1650064896646,COGS 17,A01,092679,Staff,49,0,75,26
1650064902679,COGS 100,A01,083972,Staff,0,18,60,60
1650064914726,COGS 101C,A01,083976,Staff,12,0,30,18
1650064920760,COGS 102A,A01,083978,Johnson; Christine M.,12,0,30,18
1650064926794,COGS 107B,A01,083980,Staff,0,8,50,50
1650064932817,COGS 115,A01,083982,Staff,10,0,30,20
1650064938842,COGS 118B,A01,083367,Staff,0,15,40,40
1650064944865,COGS 172,A01,083984,Provenzano; Emily Kara,15,0,30,15
1650064950889,COGS 177,A00,083368,Staff,0,21,30,30
1650064956912,COGS 186,A01,083986,Staff,21,0,40,19
1650064962935,COGS 187A,A01,083988,Boyle; Mary E. T.,19,0,60,41
1650064968959,CSE 8A,A50,084003,Miranda; Gregory Joseph,0,18,15,15
1650064974991,CSE 11,A01,084005,Miranda; Gregory Joseph,0,23,55,55
1650064981018,CSE 20,A01,084007,Staff,0,5,20,20
1650064987045,CSE 21,A01,084009,Staff,1,33,50,49
1650064993069,CSE 30,A01,083370,Cao; Yingjun,0,64,40,40
1650064999097,CSE 100,A01,083372,Cao; Yingjun,0,47,40,40
1650065005133,CSE 101,A01,084011,Staff,0,56,40,40
1650065011164,CSE 141,A01,083374,Eldon; John,0,65,75,75
1650065017187,CSE 141L,A01,083376,Eldon; John,0,71,75,75
1650065023210,CSE 175,A01,084013,Kumar; Rakesh,22,0,25,3
1650065029232,CSE 190,A00,092508,Dubnov; Shlomo,18,0,20,2
1650065035259,ECE 5,A01,084049,Morris; Karcher William,12,0,20,8
1650065041281,ECE 100,A01,084051,Baghdadchi; Saharnaz,0,0,20,20
1650065041281,ECE 100,A02,091916,Baghdadchi; Saharnaz,12,0,20,8
1650065047302,ECE 101,A01,084053,Baghdadchi; Saharnaz,0,0,37,37
1650065047302,ECE 101,A02,084054,Baghdadchi; Saharnaz,28,0,37,9
1650065053338,ECE 107,A01,083390,Staff,26,0,40,14
1650065059448,ECE 148,A01,084056,Silberman; Jack,8,0,12,4
1650065065470,ECE 180,A00,083391,Abi Samra; Nicholas Camill,25,0,30,5
1650065065470,ECE 180,B00,083392,Abi Samra; Nicholas Camill,21,0,30,9
1650065071495,MATH 10B,A01,084110,Staff,0,0,30,30
1650065071495,MATH 10B,A02,084111,Staff,17,0,30,13
1650065071495,MATH 10B,A03,084112,Staff,23,0,30,7
1650065077519,MATH 10C,A01,083443,Staff,0,17,30,31
1650065077519,MATH 10C,A02,083444,Staff,1,17,30,29
1650065077519,MATH 10C,B01,084114,Staff,18,0,30,12
1650065077519,MATH 10C,B02,084115,Staff,25,0,30,5
1650065083543,MATH 18,A01,084117,Harel; Guershon,12,0,30,18
1650065083543,MATH 18,A02,084119,Harel; Guershon,27,0,30,3
1650065083543,MATH 18,A03,084120,Harel; Guershon,30,0,30,0
1650065083543,MATH 18,A04,084121,Harel; Guershon,29,0,30,1
1650065089572,MATH 20B,A01,084124,Um; Ko Woon,10,0,35,25
1650065089572,MATH 20B,B01,084126,Um; Ko Woon,24,0,35,11
1650065095596,MATH 20C,A01,083446,Hammock; Frances H,0,0,30,30
1650065095596,MATH 20C,A02,083447,Hammock; Frances H,13,0,30,17
1650065095596,MATH 20C,A03,083448,Hammock; Frances H,19,0,30,11
1650065095596,MATH 20C,A04,083449,Hammock; Frances H,20,0,30,10
1650065095596,MATH 20C,B01,083451,Hammock; Frances H,0,0,30,30
1650065095596,MATH 20C,B02,083452,Hammock; Frances H,15,0,30,15
1650065095596,MATH 20C,B03,083453,Hammock; Frances H,19,0,30,11
1650065095596,MATH 20C,B04,083454,Hammock; Frances H,23,0,30,7
1650065101637,MATH 20D,A01,084128,Staff,14,0,30,16
1650065101637,MATH 20D,A02,084129,Staff,29,0,30,1
1650065101637,MATH 20D,A03,084130,Staff,27,0,30,3
1650065101637,MATH 20D,B01,084133,Staff,0,0,30,30
1650065101637,MATH 20D,B02,084134,Staff,23,0,30,7
1650065101637,MATH 20D,B03,084135,Staff,28,0,30,2
1650065107662,MATH 20E,A01,084138,Staff,12,0,30,18
1650065107662,MATH 20E,A02,084139,Staff,6,0,30,24
1650065107662,MATH 20E,A03,084140,Staff,14,0,30,16
1650065107662,MATH 20E,A04,084141,Staff,19,0,30,11
1650065113684,MATH 102,A01,084143,Harel; Guershon,11,0,30,19
1650065113684,MATH 102,A02,084144,Harel; Guershon,19,0,30,11
1650065119707,MATH 103B,A01,083456,Staff,0,13,30,30
1650065119707,MATH 103B,A02,083457,Staff,0,14,30,30
1650065125734,MATH 109,A01,084146,Salehi Golsefidy; Alireza,16,0,30,14
1650065125734,MATH 109,A02,084147,Salehi Golsefidy; Alireza,15,0,30,15
1650065131757,MATH 120A,A01,085445,Eggers; John Dietrich,9,0,35,26
1650065131757,MATH 120A,A02,085446,Eggers; John Dietrich,26,0,35,9
1650065137781,MATH 142B,A01,084149,Verstraete; Jacques Allan,0,12,30,30
1650065137781,MATH 142B,A02,084150,Verstraete; Jacques Allan,0,12,30,30
1650065143805,MATH 170A,A01,083459,Nie; Jiawang,0,10,30,30
1650065143805,MATH 170A,A02,083460,Nie; Jiawang,0,9,30,30
1650065143805,MATH 170A,A03,083461,Nie; Jiawang,0,9,30,30
1650065149831,MATH 193B,A01,083463,Staff,1,0,30,29
1650065149831,MATH 193B,A02,083464,Staff,8,0,30,22
1650065149831,MATH 193B,A03,083465,Staff,17,0,30,13
1650065155881,COGS 2,A01,083966,Boyle; Mary E. T.,10,0,30,20
1650065161905,COGS 9,A01,083968,Staff,5,0,60,55
1650065167932,COGS 14B,A01,083970,Staff,9,0,50,41
1650065173956,COGS 17,A01,092679,Staff,49,0,75,26
1650065179983,COGS 100,A01,083972,Staff,0,18,60,60
1650065192038,COGS 101C,A01,083976,Staff,12,0,30,18
1650065198064,COGS 102A,A01,083978,Johnson; Christine M.,12,0,30,18
1650065204095,COGS 107B,A01,083980,Staff,0,8,50,50
1650065210118,COGS 115,A01,083982,Staff,10,0,30,20
1650065216141,COGS 118B,A01,083367,Staff,0,15,40,40
1650065222168,COGS 172,A01,083984,Provenzano; Emily Kara,15,0,30,15
1650065228202,COGS 177,A00,083368,Staff,0,21,30,30
1650065234228,COGS 186,A01,083986,Staff,21,0,40,19
1650065240253,COGS 187A,A01,083988,Boyle; Mary E. T.,19,0,60,41
1650065246279,CSE 8A,A50,084003,Miranda; Gregory Joseph,0,18,15,15
1650065252308,CSE 11,A01,084005,Miranda; Gregory Joseph,0,23,55,55
1650065258331,CSE 20,A01,084007,Staff,0,5,20,20
1650065264359,CSE 21,A01,084009,Staff,1,33,50,49
1650065270381,CSE 30,A01,083370,Cao; Yingjun,0,64,40,40
1650065276408,CSE 100,A01,083372,Cao; Yingjun,0,47,40,40
1650065282432,CSE 101,A01,084011,Staff,0,56,40,40
1650065288454,CSE 141,A01,083374,Eldon; John,0,65,75,75
1650065294478,CSE 141L,A01,083376,Eldon; John,0,71,75,75
1650065300503,CSE 175,A01,084013,Kumar; Rakesh,22,0,25,3
1650065306535,CSE 190,A00,092508,Dubnov; Shlomo,18,0,20,2
1650065312562,ECE 5,A01,084049,Morris; Karcher William,12,0,20,8
1650065318587,ECE 100,A01,084051,Baghdadchi; Saharnaz,0,0,20,20
1650065318587,ECE 100,A02,091916,Baghdadchi; Saharnaz,12,0,20,8
1650065324609,ECE 101,A01,084053,Baghdadchi; Saharnaz,0,0,37,37
1650065324609,ECE 101,A02,084054,Baghdadchi; Saharnaz,28,0,37,9
1650065330632,ECE 107,A01,083390,Staff,26,0,40,14
1650065336666,ECE 148,A01,084056,Silberman; Jack,8,0,12,4
1650065342688,ECE 180,A00,083391,Abi Samra; Nicholas Camill,25,0,30,5
1650065342688,ECE 180,B00,083392,Abi Samra; Nicholas Camill,21,0,30,9
1650065348721,MATH 10B,A01,084110,Staff,0,0,30,30
1650065348721,MATH 10B,A02,084111,Staff,17,0,30,13
1650065348721,MATH 10B,A03,084112,Staff,23,0,30,7
1650065354747,MATH 10C,A01,083443,Staff,0,17,30,31
1650065354747,MATH 10C,A02,083444,Staff,1,17,30,29
1650065354747,MATH 10C,B01,084114,Staff,18,0,30,12
1650065354747,MATH 10C,B02,084115,Staff,25,0,30,5
1650065360773,MATH 18,A01,084117,Harel; Guershon,12,0,30,18
1650065360773,MATH 18,A02,084119,Harel; Guershon,27,0,30,3
1650065360773,MATH 18,A03,084120,Harel; Guershon,30,0,30,0
1650065360773,MATH 18,A04,084121,Harel; Guershon,29,0,30,1
1650065366800,MATH 20B,A01,084124,Um; Ko Woon,10,0,35,25
1650065366800,MATH 20B,B01,084126,Um; Ko Woon,24,0,35,11
1650065372827,MATH 20C,A01,083446,Hammock; Frances H,0,0,30,30
1650065372827,MATH 20C,A02,083447,Hammock; Frances H,13,0,30,17
1650065372827,MATH 20C,A03,083448,Hammock; Frances H,19,0,30,11
1650065372827,MATH 20C,A04,083449,Hammock; Frances H,20,0,30,10
1650065372827,MATH 20C,B01,083451,Hammock; Frances H,0,0,30,30
1650065372827,MATH 20C,B02,083452,Hammock; Frances H,15,0,30,15
1650065372827,MATH 20C,B03,083453,Hammock; Frances H,19,0,30,11
1650065372827,MATH 20C,B04,083454,Hammock; Frances H,23,0,30,7
1650065378850,MATH 20D,A01,084128,Staff,14,0,30,16
1650065378850,MATH 20D,A02,084129,Staff,29,0,30,1
1650065378850,MATH 20D,A03,084130,Staff,27,0,30,3
1650065378850,MATH 20D,B01,084133,Staff,0,0,30,30
1650065378850,MATH 20D,B02,084134,Staff,23,0,30,7
1650065378850,MATH 20D,B03,084135,Staff,28,0,30,2
1650065384874,MATH 20E,A01,084138,Staff,12,0,30,18
1650065384874,MATH 20E,A02,084139,Staff,6,0,30,24
1650065384874,MATH 20E,A03,084140,Staff,14,0,30,16
1650065384874,MATH 20E,A04,084141,Staff,19,0,30,11
1650065390897,MATH 102,A01,084143,Harel; Guershon,11,0,30,19
1650065390897,MATH 102,A02,084144,Harel; Guershon,19,0,30,11
1650065396921,MATH 103B,A01,083456,Staff,0,13,30,30
1650065396921,MATH 103B,A02,083457,Staff,0,14,30,30
1650065402948,MATH 109,A01,084146,Salehi Golsefidy; Alireza,16,0,30,14
1650065402948,MATH 109,A02,084147,Salehi Golsefidy; Alireza,15,0,30,15
1650065408981,MATH 120A,A01,085445,Eggers; John Dietrich,9,0,35,26
1650065408981,MATH 120A,A02,085446,Eggers; John Dietrich,26,0,35,9
1650065415012,MATH 142B,A01,084149,Verstraete; Jacques Allan,0,12,30,30
1650065415012,MATH 142B,A02,084150,Verstraete; Jacques Allan,0,12,30,30
1650065421041,MATH 170A,A01,083459,Nie; Jiawang,0,10,30,30
1650065421041,MATH 170A,A02,083460,Nie; Jiawang,0,9,30,30
1650065421041,MATH 170A,A03,083461,Nie; Jiawang,0,9,30,30
1650065427069,MATH 193B,A01,083463,Staff,1,0,30,29
1650065427069,MATH 193B,A02,083464,Staff,8,0,30,22
1650065427069,MATH 193B,A03,083465,Staff,17,0,30,13
1650065433138,COGS 2,A01,083966,Boyle; Mary E. T.,10,0,30,20
1650065439161,COGS 9,A01,083968,Staff,4,0,60,56
1650065445186,COGS 14B,A01,083970,Staff,9,0,50,41
1650065451209,COGS 17,A01,092679,Staff,49,0,75,26
1650065457234,COGS 100,A01,083972,Staff,0,18,60,60
1650065469289,COGS 101C,A01,083976,Staff,12,0,30,18
1650065475317,COGS 102A,A01,083978,Johnson; Christine M.,12,0,30,18
1650065481355,COGS 107B,A01,083980,Staff,0,8,50,50
1650065487385,COGS 115,A01,083982,Staff,10,0,30,20
1650065493422,COGS 118B,A01,083367,Staff,0,15,40,40
1650065499457,COGS 172,A01,083984,Provenzano; Emily Kara,15,0,30,15
1650065505484,COGS 177,A00,083368,Staff,0,21,30,30
1650065511514,COGS 186,A01,083986,Staff,21,0,40,19
1650065517536,COGS 187A,A01,083988,Boyle; Mary E. T.,19,0,60,41
1650065523577,CSE 8A,A50,084003,Miranda; Gregory Joseph,0,18,15,15
1650065529605,CSE 11,A01,084005,Miranda; Gregory Joseph,0,23,55,55
1650065535634,CSE 20,A01,084007,Staff,0,5,20,20
1650065541668,CSE 21,A01,084009,Staff,1,33,50,49
1650065547703,CSE 30,A01,083370,Cao; Yingjun,0,64,40,40
1650065553728,CSE 100,A01,083372,Cao; Yingjun,0,47,40,40
1650065559752,CSE 101,A01,084011,Staff,0,56,40,40
1650065565778,CSE 141,A01,083374,Eldon; John,0,66,75,75
1650065571805,CSE 141L,A01,083376,Eldon; John,0,72,75,75
1650065577829,CSE 175,A01,084013,Kumar; Rakesh,22,0,25,3
1650065583853,CSE 190,A00,092508,Dubnov; Shlomo,18,0,20,2
1650065589875,ECE 5,A01,084049,Morris; Karcher William,12,0,20,8
1650065595908,ECE 100,A01,084051,Baghdadchi; Saharnaz,0,0,20,20
1650065595908,ECE 100,A02,091916,Baghdadchi; Saharnaz,12,0,20,8
1650065601943,ECE 101,A01,084053,Baghdadchi; Saharnaz,0,0,37,37
1650065601943,ECE 101,A02,084054,Baghdadchi; Saharnaz,28,0,37,9
1650065607966,ECE 107,A01,083390,Staff,26,0,40,14
1650065613989,ECE 148,A01,084056,Silberman; Jack,8,0,12,4
1650065620023,ECE 180,A00,083391,Abi Samra; Nicholas Camill,25,0,30,5
1650065620023,ECE 180,B00,083392,Abi Samra; Nicholas Camill,21,0,30,9
1650065626057,MATH 10B,A01,084110,Staff,0,0,30,30
1650065626057,MATH 10B,A02,084111,Staff,17,0,30,13
1650065626057,MATH 10B,A03,084112,Staff,23,0,30,7
1650065632080,MATH 10C,A01,083443,Staff,0,17,30,31
1650065632080,MATH 10C,A02,083444,Staff,1,17,30,29
1650065632080,MATH 10C,B01,084114,Staff,17,0,30,13
1650065632080,MATH 10C,B02,084115,Staff,25,0,30,5
1650065638103,MATH 18,A01,084117,Harel; Guershon,11,0,30,19
1650065638103,MATH 18,A02,084119,Harel; Guershon,27,0,30,3
1650065638103,MATH 18,A03,084120,Harel; Guershon,30,0,30,0
1650065638103,MATH 18,A04,084121,Harel; Guershon,29,0,30,1
1650065644125,MATH 20B,A01,084124,Um; Ko Woon,10,0,35,25
1650065644125,MATH 20B,B01,084126,Um; Ko Woon,24,0,35,11
1650065650159,MATH 20C,A01,083446,Hammock; Frances H,0,0,30,30
1650065650159,MATH 20C,A02,083447,Hammock; Frances H,13,0,30,17
1650065650159,MATH 20C,A03,083448,Hammock; Frances H,19,0,30,11
1650065650159,MATH 20C,A04,083449,Hammock; Frances H,20,0,30,10
1650065650159,MATH 20C,B01,083451,Hammock; Frances H,0,0,30,30
1650065650159,MATH 20C,B02,083452,Hammock; Frances H,15,0,30,15
1650065650159,MATH 20C,B03,083453,Hammock; Frances H,19,0,30,11
1650065650159,MATH 20C,B04,083454,Hammock; Frances H,23,0,30,7
1650065656275,MATH 20D,A01,084128,Staff,14,0,30,16
1650065656275,MATH 20D,A02,084129,Staff,29,0,30,1
1650065656275,MATH 20D,A03,084130,Staff,27,0,30,3
1650065656275,MATH 20D,B01,084133,Staff,0,0,30,30
1650065656275,MATH 20D,B02,084134,Staff,23,0,30,7
1650065656275,MATH 20D,B03,084135,Staff,28,0,30,2
1650065662298,MATH 20E,A01,084138,Staff,12,0,30,18
1650065662298,MATH 20E,A02,084139,Staff,6,0,30,24
1650065662298,MATH 20E,A03,084140,Staff,14,0,30,16
1650065662298,MATH 20E,A04,084141,Staff,19,0,30,11
1650065668333,MATH 102,A01,084143,Harel; Guershon,11,0,30,19
1650065668333,MATH 102,A02,084144,Harel; Guershon,19,0,30,11
1650065674357,MATH 103B,A01,083456,Staff,0,13,30,30
1650065674357,MATH 103B,A02,083457,Staff,0,14,30,30
1650065680380,MATH 109,A01,084146,Salehi Golsefidy; Alireza,16,0,30,14
1650065680380,MATH 109,A02,084147,Salehi Golsefidy; Alireza,15,0,30,15
1650065686404,MATH 120A,A01,085445,Eggers; John Dietrich,9,0,35,26
1650065686404,MATH 120A,A02,085446,Eggers; John Dietrich,26,0,35,9
1650065692428,MATH 142B,A01,084149,Verstraete; Jacques Allan,0,12,30,30
1650065692428,MATH 142B,A02,084150,Verstraete; Jacques Allan,0,12,30,30
1650065698455,MATH 170A,A01,083459,Nie; Jiawang,0,10,30,30
1650065698455,MATH 170A,A02,083460,Nie; Jiawang,0,9,30,30
1650065698455,MATH 170A,A03,083461,Nie; Jiawang,0,9,30,30
1650065704479,MATH 193B,A01,083463,Staff,1,0,30,29
1650065704479,MATH 193B,A02,083464,Staff,8,0,30,22
1650065704479,MATH 193B,A03,083465,Staff,17,0,30,13
1650065710544,COGS 2,A01,083966,Boyle; Mary E. T.,10,0,30,20
1650065716568,COGS 9,A01,083968,Staff,4,0,60,56
1650065722592,COGS 14B,A01,083970,Staff,9,0,50,41
1650065728618,COGS 17,A01,092679,Staff,49,0,75,26
1650065734641,COGS 100,A01,083972,Staff,0,18,60,60
1650065746691,COGS 101C,A01,083976,Staff,12,0,30,18
1650065752731,COGS 102A,A01,083978,Johnson; Christine M.,12,0,30,18
1650065758755,COGS 107B,A01,083980,Staff,0,8,50,50
1650065764779,COGS 115,A01,083982,Staff,10,0,30,20
1650065770804,COGS 118B,A01,083367,Staff,0,15,40,40
1650065776828,COGS 172,A01,083984,Provenzano; Emily Kara,15,0,30,15
1650065782854,COGS 177,A00,083368,Staff,0,21,30,30
1650065788878,COGS 186,A01,083986,Staff,21,0,40,19
1650065794914,COGS 187A,A01,083988,Boyle; Mary E. T.,19,0,60,41
1650065800943,CSE 8A,A50,084003,Miranda; Gregory Joseph,0,18,15,15
1650065806966,CSE 11,A01,084005,Miranda; Gregory Joseph,1,23,55,54
1650065813004,CSE 20,A01,084007,Staff,0,5,20,20
1650065819028,CSE 21,A01,084009,Staff,1,33,50,49
1650065825055,CSE 30,A01,083370,Cao; Yingjun,0,64,40,40
1650065831093,CSE 100,A01,083372,Cao; Yingjun,0,47,40,40
1650065837121,CSE 101,A01,084011,Staff,0,56,40,40
1650065843144,CSE 141,A01,083374,Eldon; John,0,66,75,75
1650065849186,CSE 141L,A01,083376,Eldon; John,0,72,75,75
1650065855212,CSE 175,A01,084013,Kumar; Rakesh,22,0,25,3
1650065861241,CSE 190,A00,092508,Dubnov; Shlomo,18,0,20,2
1650065867268,ECE 5,A01,084049,Morris; Karcher William,12,0,20,8
1650065873300,ECE 100,A01,084051,Baghdadchi; Saharnaz,0,0,20,20
1650065873300,ECE 100,A02,091916,Baghdadchi; Saharnaz,12,0,20,8
1650065879328,ECE 101,A01,084053,Baghdadchi; Saharnaz,0,0,37,37
1650065879328,ECE 101,A02,084054,Baghdadchi; Saharnaz,28,0,37,9
1650065885354,ECE 107,A01,083390,Staff,26,0,40,14
1650065891378,ECE 148,A01,084056,Silberman; Jack,8,0,12,4
1650065897409,ECE 180,A00,083391,Abi Samra; Nicholas Camill,25,0,30,5
1650065897409,ECE 180,B00,083392,Abi Samra; Nicholas Camill,21,0,30,9
1650065903432,MATH 10B,A01,084110,Staff,0,0,30,30
1650065903432,MATH 10B,A02,084111,Staff,17,0,30,13
1650065903432,MATH 10B,A03,084112,Staff,23,0,30,7
1650065909472,MATH 10C,A01,083443,Staff,0,17,30,31
1650065909472,MATH 10C,A02,083444,Staff,1,17,30,29
1650065909472,MATH 10C,B01,084114,Staff,17,0,30,13
1650065909472,MATH 10C,B02,084115,Staff,25,0,30,5
1650065915504,MATH 18,A01,084117,Harel; Guershon,11,0,30,19
1650065915504,MATH 18,A02,084119,Harel; Guershon,27,0,30,3
1650065915504,MATH 18,A03,084120,Harel; Guershon,30,0,30,0
1650065915504,MATH 18,A04,084121,Harel; Guershon,29,0,30,1
1650065921528,MATH 20B,A01,084124,Um; Ko Woon,10,0,35,25
1650065921528,MATH 20B,B01,084126,Um; Ko Woon,24,0,35,11
1650065927552,MATH 20C,A01,083446,Hammock; Frances H,0,0,30,30
1650065927552,MATH 20C,A02,083447,Hammock; Frances H,13,0,30,17
1650065927552,MATH 20C,A03,083448,Hammock; Frances H,19,0,30,11
1650065927552,MATH 20C,A04,083449,Hammock; Frances H,20,0,30,10
1650065927552,MATH 20C,B01,083451,Hammock; Frances H,0,0,30,30
1650065927552,MATH 20C,B02,083452,Hammock; Frances H,15,0,30,15
1650065927552,MATH 20C,B03,083453,Hammock; Frances H,19,0,30,11
1650065927552,MATH 20C,B04,083454,Hammock; Frances H,23,0,30,7
1650065933585,MATH 20D,A01,084128,Staff,14,0,30,16
1650065933585,MATH 20D,A02,084129,Staff,29,0,30,1
1650065933585,MATH 20D,A03,084130,Staff,27,0,30,3
1650065933585,MATH 20D,B01,084133,Staff,0,0,30,30
1650065933585,MATH 20D,B02,084134,Staff,23,0,30,7
1650065933585,MATH 20D,B03,084135,Staff,28,0,30,2
1650065939612,MATH 20E,A01,084138,Staff,12,0,30,18
1650065939612,MATH 20E,A02,084139,Staff,6,0,30,24
1650065939612,MATH 20E,A03,084140,Staff,14,0,30,16
1650065939612,MATH 20E,A04,084141,Staff,19,0,30,11
1650065945640,MATH 102,A01,084143,Harel; Guershon,11,0,30,19
1650065945640,MATH 102,A02,084144,Harel; Guershon,19,0,30,11
1650065951663,MATH 103B,A01,083456,Staff,0,13,30,30
1650065951663,MATH 103B,A02,083457,Staff,0,14,30,30
1650065957687,MATH 109,A01,084146,Salehi Golsefidy; Alireza,16,0,30,14
1650065957687,MATH 109,A02,084147,Salehi Golsefidy; Alireza,15,0,30,15
1650065963716,MATH 120A,A01,085445,Eggers; John Dietrich,9,0,35,26
1650065963716,MATH 120A,A02,085446,Eggers; John Dietrich,26,0,35,9
1650065969739,MATH 142B,A01,084149,Verstraete; Jacques Allan,0,12,30,30
1650065969739,MATH 142B,A02,084150,Verstraete; Jacques Allan,0,12,30,30
1650065975766,MATH 170A,A01,083459,Nie; Jiawang,0,10,30,30
1650065975766,MATH 170A,A02,083460,Nie; Jiawang,0,9,30,30
1650065975766,MATH 170A,A03,083461,Nie; Jiawang,0,10,30,30
1650065981791,MATH 193B,A01,083463,Staff,1,0,30,29
1650065981791,MATH 193B,A02,083464,Staff,8,0,30,22
1650065981791,MATH 193B,A03,083465,Staff,17,0,30,13
1650065987843,COGS 2,A01,083966,Boyle; Mary E. T.,10,0,30,20
1650065993870,COGS 9,A01,083968,Staff,4,0,60,56
1650065999892,COGS 14B,A01,083970,Staff,9,0,50,41
1650066005916,COGS 17,A01,092679,Staff,49,0,75,26
1650066011939,COGS 100,A01,083972,Staff,0,18,60,60
1650066024025,COGS 101C,A01,083976,Staff,12,0,30,18
1650066030047,COGS 102A,A01,083978,Johnson; Christine M.,12,0,30,18
1650066036074,COGS 107B,A01,083980,Staff,0,8,50,50
1650066042098,COGS 115,A01,083982,Staff,10,0,30,20
1650066048127,COGS 118B,A01,083367,Staff,0,15,40,40
1650066054154,COGS 172,A01,083984,Provenzano; Emily Kara,15,0,30,15
1650066060179,COGS 177,A00,083368,Staff,0,21,30,30
1650066066204,COGS 186,A01,083986,Staff,21,0,40,19
1650066072234,COGS 187A,A01,083988,Boyle; Mary E. T.,19,0,60,41
1650066078267,CSE 8A,A50,084003,Miranda; Gregory Joseph,0,18,15,15
1650066084291,CSE 11,A01,084005,Miranda; Gregory Joseph,1,23,55,54
1650066090333,CSE 20,A01,084007,Staff,0,5,20,20
1650066096365,CSE 21,A01,084009,Staff,1,33,50,49
1650066102391,CSE 30,A01,083370,Cao; Yingjun,0,64,40,40
1650066108417,CSE 100,A01,083372,Cao; Yingjun,0,47,40,40
1650066114456,CSE 101,A01,084011,Staff,0,56,40,40
1650066120479,CSE 141,A01,083374,Eldon; John,0,66,75,75
1650066126505,CSE 141L,A01,083376,Eldon; John,0,72,75,75
1650066132532,CSE 175,A01,084013,Kumar; Rakesh,22,0,25,3
1650066138566,CSE 190,A00,092508,Dubnov; Shlomo,18,0,20,2
1650066144591,ECE 5,A01,084049,Morris; Karcher William,12,0,20,8
1650066150617,ECE 100,A01,084051,Baghdadchi; Saharnaz,0,0,20,20
1650066150617,ECE 100,A02,091916,Baghdadchi; Saharnaz,12,0,20,8
1650066156655,ECE 101,A01,084053,Baghdadchi; Saharnaz,0,0,37,37
1650066156655,ECE 101,A02,084054,Baghdadchi; Saharnaz,28,0,37,9
1650066162682,ECE 107,A01,083390,Staff,26,0,40,14
1650066168710,ECE 148,A01,084056,Silberman; Jack,8,0,12,4
1650066174737,ECE 180,A00,083391,Abi Samra; Nicholas Camill,25,0,30,5
1650066174737,ECE 180,B00,083392,Abi Samra; Nicholas Camill,21,0,30,9
1650066180772,MATH 10B,A01,084110,Staff,0,0,30,30
1650066180772,MATH 10B,A02,084111,Staff,17,0,30,13
1650066180772,MATH 10B,A03,084112,Staff,23,0,30,7
1650066186800,MATH 10C,A01,083443,Staff,0,17,30,31
1650066186800,MATH 10C,A02,083444,Staff,1,17,30,29
1650066186800,MATH 10C,B01,084114,Staff,17,0,30,13
1650066186800,MATH 10C,B02,084115,Staff,25,0,30,5
1650066192826,MATH 18,A01,084117,Harel; Guershon,11,0,30,19
1650066192826,MATH 18,A02,084119,Harel; Guershon,27,0,30,3
1650066192826,MATH 18,A03,084120,Harel; Guershon,30,0,30,0
1650066192826,MATH 18,A04,084121,Harel; Guershon,29,0,30,1
1650066198853,MATH 20B,A01,084124,Um; Ko Woon,10,0,35,25
1650066198853,MATH 20B,B01,084126,Um; Ko Woon,24,0,35,11
1650066204877,MATH 20C,A01,083446,Hammock; Frances H,0,0,30,30
1650066204877,MATH 20C,A02,083447,Hammock; Frances H,13,0,30,17
1650066204877,MATH 20C,A03,083448,Hammock; Frances H,19,0,30,11
1650066204877,MATH 20C,A04,083449,Hammock; Frances H,20,0,30,10
1650066204877,MATH 20C,B01,083451,Hammock; Frances H,0,0,30,30
1650066204877,MATH 20C,B02,083452,Hammock; Frances H,15,0,30,15
1650066204877,MATH 20C,B03,083453,Hammock; Frances H,19,0,30,11
1650066204877,MATH 20C,B04,083454,Hammock; Frances H,23,0,30,7
1650066210906,MATH 20D,A01,084128,Staff,14,0,30,16
1650066210906,MATH 20D,A02,084129,Staff,29,0,30,1
1650066210906,MATH 20D,A03,084130,Staff,27,0,30,3
1650066210906,MATH 20D,B01,084133,Staff,0,0,30,30
1650066210906,MATH 20D,B02,084134,Staff,23,0,30,7
1650066210906,MATH 20D,B03,084135,Staff,28,0,30,2
1650066216935,MATH 20E,A01,084138,Staff,12,0,30,18
1650066216935,MATH 20E,A02,084139,Staff,6,0,30,24
1650066216935,MATH 20E,A03,084140,Staff,14,0,30,16
1650066216935,MATH 20E,A04,084141,Staff,19,0,30,11
1650066222960,MATH 102,A01,084143,Harel; Guershon,11,0,30,19
1650066222960,MATH 102,A02,084144,Harel; Guershon,19,0,30,11
1650066228987,MATH 103B,A01,083456,Staff,0,13,30,30
1650066228987,MATH 103B,A02,083457,Staff,0,14,30,30
1650066235009,MATH 109,A01,084146,Salehi Golsefidy; Alireza,16,0,30,14
1650066235009,MATH 109,A02,084147,Salehi Golsefidy; Alireza,15,0,30,15
1650066241039,MATH 120A,A01,085445,Eggers; John Dietrich,9,0,35,26
1650066241039,MATH 120A,A02,085446,Eggers; John Dietrich,26,0,35,9
1650066247063,MATH 142B,A01,084149,Verstraete; Jacques Allan,0,12,30,30
1650066247063,MATH 142B,A02,084150,Verstraete; Jacques Allan,0,12,30,30
1650066253161,MATH 170A,A01,083459,Nie; Jiawang,0,10,30,30
1650066253161,MATH 170A,A02,083460,Nie; Jiawang,0,9,30,30
1650066253161,MATH 170A,A03,083461,Nie; Jiawang,0,10,30,30
1650066259186,MATH 193B,A01,083463,Staff,1,0,30,29
1650066259186,MATH 193B,A02,083464,Staff,8,0,30,22
1650066259186,MATH 193B,A03,083465,Staff,17,0,30,13
1650066265247,COGS 2,A01,083966,Boyle; Mary E. T.,10,0,30,20
1650066271271,COGS 9,A01,083968,Staff,4,0,60,56
1650066277295,COGS 14B,A01,083970,Staff,9,0,50,41
1650066283318,COGS 17,A01,092679,Staff,49,0,75,26
1650066289342,COGS 100,A01,083972,Staff,0,18,60,60
1650066301393,COGS 101C,A01,083976,Staff,12,0,30,18
1650066307419,COGS 102A,A01,083978,Johnson; Christine M.,12,0,30,18
1650066313442,COGS 107B,A01,083980,Staff,0,8,50,50
1650066319469,COGS 115,A01,083982,Staff,10,0,30,20
1650066325496,COGS 118B,A01,083367,Staff,0,15,40,40
1650066331520,COGS 172,A01,083984,Provenzano; Emily Kara,15,0,30,15
1650066337544,COGS 177,A00,083368,Staff,0,21,30,30
1650066343570,COGS 186,A01,083986,Staff,21,0,40,19
1650066349593,COGS 187A,A01,083988,Boyle; Mary E. T.,19,0,60,41
1650066355617,CSE 8A,A50,084003,Miranda; Gregory Joseph,0,18,15,15
1650066361641,CSE 11,A01,084005,Miranda; Gregory Joseph,1,23,55,54
1650066367665,CSE 20,A01,084007,Staff,0,5,20,20
1650066373695,CSE 21,A01,084009,Staff,1,33,50,49
1650066379718,CSE 30,A01,083370,Cao; Yingjun,0,64,40,40
1650066385745,CSE 100,A01,083372,Cao; Yingjun,0,47,40,40
1650066391775,CSE 101,A01,084011,Staff,0,56,40,40
1650066397809,CSE 141,A01,083374,Eldon; John,0,66,75,75
1650066403840,CSE 141L,A01,083376,Eldon; John,0,72,75,75
1650066409867,CSE 175,A01,084013,Kumar; Rakesh,22,0,25,3
1650066415891,CSE 190,A00,092508,Dubnov; Shlomo,18,0,20,2
1650066421917,ECE 5,A01,084049,Morris; Karcher William,12,0,20,8
1650066427953,ECE 100,A01,084051,Baghdadchi; Saharnaz,0,0,20,20
1650066427953,ECE 100,A02,091916,Baghdadchi; Saharnaz,12,0,20,8
1650066433987,ECE 101,A01,084053,Baghdadchi; Saharnaz,0,0,37,37
1650066433987,ECE 101,A02,084054,Baghdadchi; Saharnaz,28,0,37,9
1650066440012,ECE 107,A01,083390,Staff,26,0,40,14
1650066446042,ECE 148,A01,084056,Silberman; Jack,8,0,12,4
1650066452064,ECE 180,A00,083391,Abi Samra; Nicholas Camill,25,0,30,5
1650066452064,ECE 180,B00,083392,Abi Samra; Nicholas Camill,21,0,30,9
1650066458088,MATH 10B,A01,084110,Staff,0,0,30,30
1650066458088,MATH 10B,A02,084111,Staff,17,0,30,13
1650066458088,MATH 10B,A03,084112,Staff,23,0,30,7
1650066464116,MATH 10C,A01,083443,Staff,0,17,30,31
1650066464116,MATH 10C,A02,083444,Staff,1,17,30,29
1650066464116,MATH 10C,B01,084114,Staff,17,0,30,13
1650066464116,MATH 10C,B02,084115,Staff,25,0,30,5
1650066470139,MATH 18,A01,084117,Harel; Guershon,11,0,30,19
1650066470139,MATH 18,A02,084119,Harel; Guershon,27,0,30,3
1650066470139,MATH 18,A03,084120,Harel; Guershon,30,0,30,0
1650066470139,MATH 18,A04,084121,Harel; Guershon,29,0,30,1
1650066476168,MATH 20B,A01,084124,Um; Ko Woon,10,0,35,25
1650066476168,MATH 20B,B01,084126,Um; Ko Woon,24,0,35,11
1650066482197,MATH 20C,A01,083446,Hammock; Frances H,0,0,30,30
1650066482197,MATH 20C,A02,083447,Hammock; Frances H,13,0,30,17
1650066482197,MATH 20C,A03,083448,Hammock; Frances H,19,0,30,11
1650066482197,MATH 20C,A04,083449,Hammock; Frances H,20,0,30,10
1650066482197,MATH 20C,B01,083451,Hammock; Frances H,0,0,30,30
1650066482197,MATH 20C,B02,083452,Hammock; Frances H,15,0,30,15
1650066482197,MATH 20C,B03,083453,Hammock; Frances H,19,0,30,11
1650066482197,MATH 20C,B04,083454,Hammock; Frances H,23,0,30,7
1650066488223,MATH 20D,A01,084128,Staff,14,0,30,16
1650066488223,MATH 20D,A02,084129,Staff,29,0,30,1
1650066488223,MATH 20D,A03,084130,Staff,27,0,30,3
1650066488223,MATH 20D,B01,084133,Staff,0,0,30,30
1650066488223,MATH 20D,B02,084134,Staff,23,0,30,7
1650066488223,MATH 20D,B03,084135,Staff,28,0,30,2
1650066494248,MATH 20E,A01,084138,Staff,12,0,30,18
1650066494248,MATH 20E,A02,084139,Staff,6,0,30,24
1650066494248,MATH 20E,A03,084140,Staff,14,0,30,16
1650066494248,MATH 20E,A04,084141,Staff,19,0,30,11
1650066500271,MATH 102,A01,084143,Harel; Guershon,11,0,30,19
1650066500271,MATH 102,A02,084144,Harel; Guershon,19,0,30,11
1650066506294,MATH 103B,A01,083456,Staff,0,13,30,30
1650066506294,MATH 103B,A02,083457,Staff,0,14,30,30
1650066512318,MATH 109,A01,084146,Salehi Golsefidy; Alireza,16,0,30,14
1650066512318,MATH 109,A02,084147,Salehi Golsefidy; Alireza,15,0,30,15
1650066518342,MATH 120A,A01,085445,Eggers; John Dietrich,9,0,35,26
1650066518342,MATH 120A,A02,085446,Eggers; John Dietrich,26,0,35,9
1650066524377,MATH 142B,A01,084149,Verstraete; Jacques Allan,0,12,30,30
1650066524377,MATH 142B,A02,084150,Verstraete; Jacques Allan,0,12,30,30
1650066530401,MATH 170A,A01,083459,Nie; Jiawang,0,10,30,30
1650066530401,MATH 170A,A02,083460,Nie; Jiawang,0,9,30,30
1650066530401,MATH 170A,A03,083461,Nie; Jiawang,0,10,30,30
1650066536425,MATH 193B,A01,083463,Staff,1,0,30,29
1650066536425,MATH 193B,A02,083464,Staff,8,0,30,22
1650066536425,MATH 193B,A03,083465,Staff,17,0,30,13
1650066542495,COGS 2,A01,083966,Boyle; Mary E. T.,10,0,30,20
1650066548523,COGS 9,A01,083968,Staff,4,0,60,56
1650066554547,COGS 14B,A01,083970,Staff,9,0,50,41
1650066560574,COGS 17,A01,092679,Staff,49,0,75,26
1650066566598,COGS 100,A01,083972,Staff,0,18,60,60
1650066578654,COGS 101C,A01,083976,Staff,12,0,30,18
1650066584680,COGS 102A,A01,083978,Johnson; Christine M.,12,0,30,18
1650066590709,COGS 107B,A01,083980,Staff,0,8,50,50
1650066596736,COGS 115,A01,083982,Staff,10,0,30,20
1650066602763,COGS 118B,A01,083367,Staff,0,15,40,40
1650066608802,COGS 172,A01,083984,Provenzano; Emily Kara,15,0,30,15
1650066614831,COGS 177,A00,083368,Staff,0,21,30,30
1650066620854,COGS 186,A01,083986,Staff,21,0,40,19
1650066626890,COGS 187A,A01,083988,Boyle; Mary E. T.,19,0,60,41
1650066632914,CSE 8A,A50,084003,Miranda; Gregory Joseph,0,18,15,15
1650066638941,CSE 11,A01,084005,Miranda; Gregory Joseph,1,24,55,54
1650066644968,CSE 20,A01,084007,Staff,0,5,20,20
1650066650999,CSE 21,A01,084009,Staff,1,33,50,49
1650066657024,CSE 30,A01,083370,Cao; Yingjun,0,64,40,40
1650066663048,CSE 100,A01,083372,Cao; Yingjun,0,47,40,40
1650066669074,CSE 101,A01,084011,Staff,0,56,40,40
1650066675098,CSE 141,A01,083374,Eldon; John,0,66,75,75
1650066681127,CSE 141L,A01,083376,Eldon; John,0,72,75,75
1650066687153,CSE 175,A01,084013,Kumar; Rakesh,22,0,25,3
1650066693180,CSE 190,A00,092508,Dubnov; Shlomo,18,0,20,2
1650066699207,ECE 5,A01,084049,Morris; Karcher William,12,0,20,8
1650066705229,ECE 100,A01,084051,Baghdadchi; Saharnaz,0,0,20,20
1650066705229,ECE 100,A02,091916,Baghdadchi; Saharnaz,12,0,20,8
1650066711262,ECE 101,A01,084053,Baghdadchi; Saharnaz,0,0,37,37
1650066711262,ECE 101,A02,084054,Baghdadchi; Saharnaz,28,0,37,9
1650066717285,ECE 107,A01,083390,Staff,26,0,40,14
1650066723312,ECE 148,A01,084056,Silberman; Jack,8,0,12,4
1650066729349,ECE 180,A00,083391,Abi Samra; Nicholas Camill,25,0,30,5
1650066729349,ECE 180,B00,083392,Abi Samra; Nicholas Camill,21,0,30,9
1650066735376,MATH 10B,A01,084110,Staff,0,0,30,30
1650066735376,MATH 10B,A02,084111,Staff,17,0,30,13
1650066735376,MATH 10B,A03,084112,Staff,23,0,30,7
1650066741399,MATH 10C,A01,083443,Staff,0,17,30,31
1650066741399,MATH 10C,A02,083444,Staff,1,17,30,29
1650066741399,MATH 10C,B01,084114,Staff,17,0,30,13
1650066741399,MATH 10C,B02,084115,Staff,25,0,30,5
1650066747429,MATH 18,A01,084117,Harel; Guershon,11,0,30,19
1650066747429,MATH 18,A02,084119,Harel; Guershon,27,0,30,3
1650066747429,MATH 18,A03,084120,Harel; Guershon,30,0,30,0
1650066747429,MATH 18,A04,084121,Harel; Guershon,29,0,30,1
1650066753452,MATH 20B,A01,084124,Um; Ko Woon,10,0,35,25
1650066753452,MATH 20B,B01,084126,Um; Ko Woon,24,0,35,11
1650066759477,MATH 20C,A01,083446,Hammock; Frances H,0,0,30,30
1650066759477,MATH 20C,A02,083447,Hammock; Frances H,13,0,30,17
1650066759477,MATH 20C,A03,083448,Hammock; Frances H,19,0,30,11
1650066759477,MATH 20C,A04,083449,Hammock; Frances H,20,0,30,10
1650066759477,MATH 20C,B01,083451,Hammock; Frances H,0,0,30,30
1650066759477,MATH 20C,B02,083452,Hammock; Frances H,15,0,30,15
1650066759477,MATH 20C,B03,083453,Hammock; Frances H,19,0,30,11
1650066759477,MATH 20C,B04,083454,Hammock; Frances H,23,0,30,7
1650066765507,MATH 20D,A01,084128,Staff,14,0,30,16
1650066765507,MATH 20D,A02,084129,Staff,29,0,30,1
1650066765507,MATH 20D,A03,084130,Staff,27,0,30,3
1650066765507,MATH 20D,B01,084133,Staff,0,0,30,30
1650066765507,MATH 20D,B02,084134,Staff,23,0,30,7
1650066765507,MATH 20D,B03,084135,Staff,28,0,30,2
1650066771531,MATH 20E,A01,084138,Staff,12,0,30,18
1650066771531,MATH 20E,A02,084139,Staff,6,0,30,24
1650066771531,MATH 20E,A03,084140,Staff,14,0,30,16
1650066771531,MATH 20E,A04,084141,Staff,19,0,30,11
1650066777556,MATH 102,A01,084143,Harel; Guershon,11,0,30,19
1650066777556,MATH 102,A02,084144,Harel; Guershon,19,0,30,11
1650066783581,MATH 103B,A01,083456,Staff,0,13,30,30
1650066783581,MATH 103B,A02,083457,Staff,0,14,30,30
1650066789604,MATH 109,A01,084146,Salehi Golsefidy; Alireza,16,0,30,14
1650066789604,MATH 109,A02,084147,Salehi Golsefidy; Alireza,15,0,30,15
1650066795628,MATH 120A,A01,085445,Eggers; John Dietrich,9,0,35,26
1650066795628,MATH 120A,A02,085446,Eggers; John Dietrich,26,0,35,9
1650066801652,MATH 142B,A01,084149,Verstraete; Jacques Allan,0,12,30,30
1650066801652,MATH 142B,A02,084150,Verstraete; Jacques Allan,0,12,30,30
1650066807681,MATH 170A,A01,083459,Nie; Jiawang,0,10,30,30
1650066807681,MATH 170A,A02,083460,Nie; Jiawang,0,9,30,30
1650066807681,MATH 170A,A03,083461,Nie; Jiawang,0,10,30,30
1650066813704,MATH 193B,A01,083463,Staff,1,0,30,29
1650066813704,MATH 193B,A02,083464,Staff,8,0,30,22
1650066813704,MATH 193B,A03,083465,Staff,17,0,30,13
1650066819756,COGS 2,A01,083966,Boyle; Mary E. T.,10,0,30,20
1650066825785,COGS 9,A01,083968,Staff,4,0,60,56
1650066831810,COGS 14B,A01,083970,Staff,9,0,50,41
1650066837841,COGS 17,A01,092679,Staff,49,0,75,26
1650066843964,COGS 100,A01,083972,Staff,0,19,60,60
1650066856019,COGS 101C,A01,083976,Staff,12,0,30,18
1650066862045,COGS 102A,A01,083978,Johnson; Christine M.,12,0,30,18
1650066868071,COGS 107B,A01,083980,Staff,0,8,50,50
1650066874096,COGS 115,A01,083982,Staff,10,0,30,20
1650066880123,COGS 118B,A01,083367,Staff,0,15,40,40
1650066886150,COGS 172,A01,083984,Provenzano; Emily Kara,15,0,30,15
1650066892174,COGS 177,A00,083368,Staff,0,21,30,30
1650066898206,COGS 186,A01,083986,Staff,21,0,40,19
1650066904233,COGS 187A,A01,083988,Boyle; Mary E. T.,19,0,60,41
1650066910261,CSE 8A,A50,084003,Miranda; Gregory Joseph,0,18,15,15
1650066916285,CSE 11,A01,084005,Miranda; Gregory Joseph,1,24,55,54
1650066922315,CSE 20,A01,084007,Staff,0,5,20,20
1650066928342,CSE 21,A01,084009,Staff,1,33,50,49
1650066934372,CSE 30,A01,083370,Cao; Yingjun,0,63,40,40
1650066940395,CSE 100,A01,083372,Cao; Yingjun,0,47,40,40
1650066946422,CSE 101,A01,084011,Staff,0,56,40,40
1650066952458,CSE 141,A01,083374,Eldon; John,0,66,75,75
1650066958489,CSE 141L,A01,083376,Eldon; John,0,72,75,75
1650066964512,CSE 175,A01,084013,Kumar; Rakesh,22,0,25,3
1650066970536,CSE 190,A00,092508,Dubnov; Shlomo,18,0,20,2
1650066976566,ECE 5,A01,084049,Morris; Karcher William,12,0,20,8
1650066982590,ECE 100,A01,084051,Baghdadchi; Saharnaz,0,0,20,20
1650066982590,ECE 100,A02,091916,Baghdadchi; Saharnaz,12,0,20,8
1650066988614,ECE 101,A01,084053,Baghdadchi; Saharnaz,0,0,37,37
1650066988614,ECE 101,A02,084054,Baghdadchi; Saharnaz,28,0,37,9
1650066994641,ECE 107,A01,083390,Staff,26,0,40,14
1650067000671,ECE 148,A01,084056,Silberman; Jack,8,0,12,4
1650067006707,ECE 180,A00,083391,Abi Samra; Nicholas Camill,25,0,30,5
1650067006707,ECE 180,B00,083392,Abi Samra; Nicholas Camill,21,0,30,9
1650067012734,MATH 10B,A01,084110,Staff,0,0,30,30
1650067012734,MATH 10B,A02,084111,Staff,17,0,30,13
1650067012734,MATH 10B,A03,084112,Staff,23,0,30,7
1650067018757,MATH 10C,A01,083443,Staff,0,17,30,31
1650067018757,MATH 10C,A02,083444,Staff,1,17,30,29
1650067018757,MATH 10C,B01,084114,Staff,17,0,30,13
1650067018757,MATH 10C,B02,084115,Staff,25,0,30,5
1650067024784,MATH 18,A01,084117,Harel; Guershon,11,0,30,19
1650067024784,MATH 18,A02,084119,Harel; Guershon,27,0,30,3
1650067024784,MATH 18,A03,084120,Harel; Guershon,30,0,30,0
1650067024784,MATH 18,A04,084121,Harel; Guershon,29,0,30,1
1650067030813,MATH 20B,A01,084124,Um; Ko Woon,10,0,35,25
1650067030813,MATH 20B,B01,084126,Um; Ko Woon,24,0,35,11
1650067036844,MATH 20C,A01,083446,Hammock; Frances H,0,0,30,30
1650067036844,MATH 20C,A02,083447,Hammock; Frances H,13,0,30,17
1650067036844,MATH 20C,A03,083448,Hammock; Frances H,19,0,30,11
1650067036844,MATH 20C,A04,083449,Hammock; Frances H,20,0,30,10
1650067036844,MATH 20C,B01,083451,Hammock; Frances H,0,0,30,30
1650067036844,MATH 20C,B02,083452,Hammock; Frances H,15,0,30,15
1650067036844,MATH 20C,B03,083453,Hammock; Frances H,19,0,30,11
1650067036844,MATH 20C,B04,083454,Hammock; Frances H,23,0,30,7
1650067042873,MATH 20D,A01,084128,Staff,14,0,30,16
1650067042873,MATH 20D,A02,084129,Staff,29,0,30,1
1650067042873,MATH 20D,A03,084130,Staff,27,0,30,3
1650067042873,MATH 20D,B01,084133,Staff,0,0,30,30
1650067042873,MATH 20D,B02,084134,Staff,23,0,30,7
1650067042873,MATH 20D,B03,084135,Staff,28,0,30,2
1650067048900,MATH 20E,A01,084138,Staff,12,0,30,18
1650067048900,MATH 20E,A02,084139,Staff,6,0,30,24
1650067048900,MATH 20E,A03,084140,Staff,14,0,30,16
1650067048900,MATH 20E,A04,084141,Staff,19,0,30,11
1650067054927,MATH 102,A01,084143,Harel; Guershon,11,0,30,19
1650067054927,MATH 102,A02,084144,Harel; Guershon,19,0,30,11
1650067060953,MATH 103B,A01,083456,Staff,0,13,30,30
1650067060953,MATH 103B,A02,083457,Staff,0,14,30,30
1650067066976,MATH 109,A01,084146,Salehi Golsefidy; Alireza,16,0,30,14
1650067066976,MATH 109,A02,084147,Salehi Golsefidy; Alireza,15,0,30,15
1650067073007,MATH 120A,A01,085445,Eggers; John Dietrich,9,0,35,26
1650067073007,MATH 120A,A02,085446,Eggers; John Dietrich,26,0,35,9
1650067079033,MATH 142B,A01,084149,Verstraete; Jacques Allan,0,12,30,30
1650067079033,MATH 142B,A02,084150,Verstraete; Jacques Allan,0,12,30,30
1650067085057,MATH 170A,A01,083459,Nie; Jiawang,0,10,30,30
1650067085057,MATH 170A,A02,083460,Nie; Jiawang,0,9,30,30
1650067085057,MATH 170A,A03,083461,Nie; Jiawang,0,10,30,30
1650067091080,MATH 193B,A01,083463,Staff,1,0,30,29
1650067091080,MATH 193B,A02,083464,Staff,8,0,30,22
1650067091080,MATH 193B,A03,083465,Staff,17,0,30,13
1650067097202,COGS 2,A01,083966,Boyle; Mary E. T.,10,0,30,20
1650067103228,COGS 9,A01,083968,Staff,4,0,60,56
1650067109252,COGS 14B,A01,083970,Staff,9,0,50,41
1650067115276,COGS 17,A01,092679,Staff,49,0,75,26
1650067121299,COGS 100,A01,083972,Staff,0,19,60,60
1650067133345,COGS 101C,A01,083976,Staff,12,0,30,18
1650067139375,COGS 102A,A01,083978,Johnson; Christine M.,12,0,30,18
1650067145401,COGS 107B,A01,083980,Staff,0,8,50,50
1650067151425,COGS 115,A01,083982,Staff,10,0,30,20
1650067157457,COGS 118B,A01,083367,Staff,0,15,40,40
1650067163480,COGS 172,A01,083984,Provenzano; Emily Kara,15,0,30,15
1650067169503,COGS 177,A00,083368,Staff,0,21,30,30
1650067175526,COGS 186,A01,083986,Staff,21,0,40,19
1650067181554,COGS 187A,A01,083988,Boyle; Mary E. T.,19,0,60,41
1650067187583,CSE 8A,A50,084003,Miranda; Gregory Joseph,0,18,15,15
1650067193607,CSE 11,A01,084005,Miranda; Gregory Joseph,1,24,55,54
1650067199640,CSE 20,A01,084007,Staff,0,5,20,20
1650067205665,CSE 21,A01,084009,Staff,1,33,50,49
1650067211717,CSE 30,A01,083370,Cao; Yingjun,0,63,40,40
1650067217741,CSE 100,A01,083372,Cao; Yingjun,0,47,40,40
1650067223767,CSE 101,A01,084011,Staff,0,56,40,40
1650067229796,CSE 141,A01,083374,Eldon; John,0,67,75,75
1650067235823,CSE 141L,A01,083376,Eldon; John,0,73,75,75
1650067241849,CSE 175,A01,084013,Kumar; Rakesh,22,0,25,3
1650067247872,CSE 190,A00,092508,Dubnov; Shlomo,18,0,20,2
1650067253908,ECE 5,A01,084049,Morris; Karcher William,12,0,20,8
1650067259932,ECE 100,A01,084051,Baghdadchi; Saharnaz,0,0,20,20
1650067259932,ECE 100,A02,091916,Baghdadchi; Saharnaz,12,0,20,8
1650067265965,ECE 101,A01,084053,Baghdadchi; Saharnaz,0,0,37,37
1650067265965,ECE 101,A02,084054,Baghdadchi; Saharnaz,28,0,37,9
1650067271996,ECE 107,A01,083390,Staff,26,0,40,14
1650067278028,ECE 148,A01,084056,Silberman; Jack,8,0,12,4
1650067284052,ECE 180,A00,083391,Abi Samra; Nicholas Camill,25,0,30,5
1650067284052,ECE 180,B00,083392,Abi Samra; Nicholas Camill,21,0,30,9
1650067290077,MATH 10B,A01,084110,Staff,0,0,30,30
1650067290077,MATH 10B,A02,084111,Staff,17,0,30,13
1650067290077,MATH 10B,A03,084112,Staff,23,0,30,7
1650067296101,MATH 10C,A01,083443,Staff,0,17,30,31
1650067296101,MATH 10C,A02,083444,Staff,1,17,30,29
1650067296101,MATH 10C,B01,084114,Staff,17,0,30,13
1650067296101,MATH 10C,B02,084115,Staff,25,0,30,5
1650067302130,MATH 18,A01,084117,Harel; Guershon,11,0,30,19
1650067302130,MATH 18,A02,084119,Harel; Guershon,27,0,30,3
1650067302130,MATH 18,A03,084120,Harel; Guershon,30,0,30,0
1650067302130,MATH 18,A04,084121,Harel; Guershon,29,0,30,1
1650067308157,MATH 20B,A01,084124,Um; Ko Woon,10,0,35,25
1650067308157,MATH 20B,B01,084126,Um; Ko Woon,24,0,35,11
1650067314184,MATH 20C,A01,083446,Hammock; Frances H,0,0,30,30
1650067314184,MATH 20C,A02,083447,Hammock; Frances H,13,0,30,17
1650067314184,MATH 20C,A03,083448,Hammock; Frances H,19,0,30,11
1650067314184,MATH 20C,A04,083449,Hammock; Frances H,20,0,30,10
1650067314184,MATH 20C,B01,083451,Hammock; Frances H,0,0,30,30
1650067314184,MATH 20C,B02,083452,Hammock; Frances H,15,0,30,15
1650067314184,MATH 20C,B03,083453,Hammock; Frances H,19,0,30,11
1650067314184,MATH 20C,B04,083454,Hammock; Frances H,23,0,30,7
1650067320214,MATH 20D,A01,084128,Staff,14,0,30,16
1650067320214,MATH 20D,A02,084129,Staff,29,0,30,1
1650067320214,MATH 20D,A03,084130,Staff,27,0,30,3
1650067320214,MATH 20D,B01,084133,Staff,0,0,30,30
1650067320214,MATH 20D,B02,084134,Staff,23,0,30,7
1650067320214,MATH 20D,B03,084135,Staff,28,0,30,2
1650067326239,MATH 20E,A01,084138,Staff,12,0,30,18
1650067326239,MATH 20E,A02,084139,Staff,6,0,30,24
1650067326239,MATH 20E,A03,084140,Staff,14,0,30,16
1650067326239,MATH 20E,A04,084141,Staff,19,0,30,11
1650067332267,MATH 102,A01,084143,Harel; Guershon,11,0,30,19
1650067332267,MATH 102,A02,084144,Harel; Guershon,19,0,30,11
1650067338290,MATH 103B,A01,083456,Staff,0,13,30,30
1650067338290,MATH 103B,A02,083457,Staff,0,14,30,30
1650067344315,MATH 109,A01,084146,Salehi Golsefidy; Alireza,16,0,30,14
1650067344315,MATH 109,A02,084147,Salehi Golsefidy; Alireza,15,0,30,15
1650067350344,MATH 120A,A01,085445,Eggers; John Dietrich,9,0,35,26
1650067350344,MATH 120A,A02,085446,Eggers; John Dietrich,26,0,35,9
1650067356367,MATH 142B,A01,084149,Verstraete; Jacques Allan,0,12,30,30
1650067356367,MATH 142B,A02,084150,Verstraete; Jacques Allan,0,12,30,30
1650067362390,MATH 170A,A01,083459,Nie; Jiawang,0,10,30,30
1650067362390,MATH 170A,A02,083460,Nie; Jiawang,0,9,30,30
1650067362390,MATH 170A,A03,083461,Nie; Jiawang,0,10,30,30
1650067368416,MATH 193B,A01,083463,Staff,1,0,30,29
1650067368416,MATH 193B,A02,083464,Staff,8,0,30,22
1650067368416,MATH 193B,A03,083465,Staff,17,0,30,13
1650067374471,COGS 2,A01,083966,Boyle; Mary E. T.,10,0,30,20
1650067380499,COGS 9,A01,083968,Staff,4,0,60,56
1650067386523,COGS 14B,A01,083970,Staff,9,0,50,41
1650067392545,COGS 17,A01,092679,Staff,49,0,75,26
1650067398574,COGS 100,A01,083972,Staff,0,19,60,60
1650067410625,COGS 101C,A01,083976,Staff,12,0,30,18
1650067416649,COGS 102A,A01,083978,Johnson; Christine M.,12,0,30,18
1650067422673,COGS 107B,A01,083980,Staff,0,8,50,50
1650067428700,COGS 115,A01,083982,Staff,10,0,30,20
1650067434729,COGS 118B,A01,083367,Staff,0,15,40,40
1650067440847,COGS 172,A01,083984,Provenzano; Emily Kara,15,0,30,15
1650067446874,COGS 177,A00,083368,Staff,0,21,30,30
1650067452903,COGS 186,A01,083986,Staff,21,0,40,19
1650067458930,COGS 187A,A01,083988,Boyle; Mary E. T.,19,0,60,41
1650067464963,CSE 8A,A50,084003,Miranda; Gregory Joseph,0,18,15,15
1650067470991,CSE 11,A01,084005,Miranda; Gregory Joseph,1,24,55,54
1650067477015,CSE 20,A01,084007,Staff,0,5,20,20
1650067483040,CSE 21,A01,084009,Staff,1,33,50,49
1650067489075,CSE 30,A01,083370,Cao; Yingjun,0,63,40,40
1650067495105,CSE 100,A01,083372,Cao; Yingjun,0,47,40,40
1650067501133,CSE 101,A01,084011,Staff,0,56,40,40
1650067507161,CSE 141,A01,083374,Eldon; John,0,67,75,75
1650067513188,CSE 141L,A01,083376,Eldon; John,0,73,75,75
1650067519211,CSE 175,A01,084013,Kumar; Rakesh,22,0,25,3
1650067525235,CSE 190,A00,092508,Dubnov; Shlomo,18,0,20,2
1650067531264,ECE 5,A01,084049,Morris; Karcher William,12,0,20,8
1650067537288,ECE 100,A01,084051,Baghdadchi; Saharnaz,0,0,20,20
1650067537288,ECE 100,A02,091916,Baghdadchi; Saharnaz,12,0,20,8
1650067543320,ECE 101,A01,084053,Baghdadchi; Saharnaz,0,0,37,37
1650067543320,ECE 101,A02,084054,Baghdadchi; Saharnaz,28,0,37,9
1650067549344,ECE 107,A01,083390,Staff,26,0,40,14
1650067555373,ECE 148,A01,084056,Silberman; Jack,8,0,12,4
1650067561401,ECE 180,A00,083391,Abi Samra; Nicholas Camill,25,0,30,5
1650067561401,ECE 180,B00,083392,Abi Samra; Nicholas Camill,21,0,30,9
1650067567426,MATH 10B,A01,084110,Staff,0,0,30,30
1650067567426,MATH 10B,A02,084111,Staff,17,0,30,13
1650067567426,MATH 10B,A03,084112,Staff,23,0,30,7
1650067573455,MATH 10C,A01,083443,Staff,0,17,30,31
1650067573455,MATH 10C,A02,083444,Staff,1,17,30,29
1650067573455,MATH 10C,B01,084114,Staff,17,0,30,13
1650067573455,MATH 10C,B02,084115,Staff,25,0,30,5
1650067579485,MATH 18,A01,084117,Harel; Guershon,11,0,30,19
1650067579485,MATH 18,A02,084119,Harel; Guershon,27,0,30,3
1650067579485,MATH 18,A03,084120,Harel; Guershon,30,0,30,0
1650067579485,MATH 18,A04,084121,Harel; Guershon,29,0,30,1
1650067585508,MATH 20B,A01,084124,Um; Ko Woon,10,0,35,25
1650067585508,MATH 20B,B01,084126,Um; Ko Woon,24,0,35,11
1650067591534,MATH 20C,A01,083446,Hammock; Frances H,0,0,30,30
1650067591534,MATH 20C,A02,083447,Hammock; Frances H,13,0,30,17
1650067591534,MATH 20C,A03,083448,Hammock; Frances H,19,0,30,11
1650067591534,MATH 20C,A04,083449,Hammock; Frances H,20,0,30,10
1650067591534,MATH 20C,B01,083451,Hammock; Frances H,0,0,30,30
1650067591534,MATH 20C,B02,083452,Hammock; Frances H,15,0,30,15
1650067591534,MATH 20C,B03,083453,Hammock; Frances H,19,0,30,11
1650067591534,MATH 20C,B04,083454,Hammock; Frances H,23,0,30,7
1650067597559,MATH 20D,A01,084128,Staff,14,0,30,16
1650067597559,MATH 20D,A02,084129,Staff,29,0,30,1
1650067597559,MATH 20D,A03,084130,Staff,27,0,30,3
1650067597559,MATH 20D,B01,084133,Staff,0,0,30,30
1650067597559,MATH 20D,B02,084134,Staff,23,0,30,7
1650067597559,MATH 20D,B03,084135,Staff,28,0,30,2
1650067603582,MATH 20E,A01,084138,Staff,12,0,30,18
1650067603582,MATH 20E,A02,084139,Staff,6,0,30,24
1650067603582,MATH 20E,A03,084140,Staff,14,0,30,16
1650067603582,MATH 20E,A04,084141,Staff,19,0,30,11
1650067609611,MATH 102,A01,084143,Harel; Guershon,11,0,30,19
1650067609611,MATH 102,A02,084144,Harel; Guershon,19,0,30,11
1650067615636,MATH 103B,A01,083456,Staff,0,13,30,30
1650067615636,MATH 103B,A02,083457,Staff,0,14,30,30
1650067621665,MATH 109,A01,084146,Salehi Golsefidy; Alireza,16,0,30,14
1650067621665,MATH 109,A02,084147,Salehi Golsefidy; Alireza,15,0,30,15
1650067627689,MATH 120A,A01,085445,Eggers; John Dietrich,9,0,35,26
1650067627689,MATH 120A,A02,085446,Eggers; John Dietrich,26,0,35,9
1650067633713,MATH 142B,A01,084149,Verstraete; Jacques Allan,0,12,30,30
1650067633713,MATH 142B,A02,084150,Verstraete; Jacques Allan,0,12,30,30
1650067639737,MATH 170A,A01,083459,Nie; Jiawang,0,10,30,30
1650067639737,MATH 170A,A02,083460,Nie; Jiawang,0,10,30,30
1650067639737,MATH 170A,A03,083461,Nie; Jiawang,0,10,30,30
1650067645771,MATH 193B,A01,083463,Staff,1,0,30,29
1650067645771,MATH 193B,A02,083464,Staff,8,0,30,22
1650067645771,MATH 193B,A03,083465,Staff,16,0,30,14
1650067651824,COGS 2,A01,083966,Boyle; Mary E. T.,10,0,30,20
1650067657850,COGS 9,A01,083968,Staff,4,0,60,56
1650067663874,COGS 14B,A01,083970,Staff,9,0,50,41
1650067669898,COGS 17,A01,092679,Staff,49,0,75,26
1650067675922,COGS 100,A01,083972,Staff,0,19,60,60
1650067687984,COGS 101C,A01,083976,Staff,12,0,30,18
1650067694013,COGS 102A,A01,083978,Johnson; Christine M.,12,0,30,18
1650067700038,COGS 107B,A01,083980,Staff,0,8,50,50
1650067706064,COGS 115,A01,083982,Staff,10,0,30,20
1650067712091,COGS 118B,A01,083367,Staff,0,15,40,40
1650067718125,COGS 172,A01,083984,Provenzano; Emily Kara,15,0,30,15
1650067724153,COGS 177,A00,083368,Staff,0,21,30,30
1650067730184,COGS 186,A01,083986,Staff,21,0,40,19
1650067736207,COGS 187A,A01,083988,Boyle; Mary E. T.,19,0,60,41
1650067742235,CSE 8A,A50,084003,Miranda; Gregory Joseph,0,18,15,15
1650067748265,CSE 11,A01,084005,Miranda; Gregory Joseph,1,24,55,54
1650067754292,CSE 20,A01,084007,Staff,0,5,20,20
1650067760321,CSE 21,A01,084009,Staff,1,33,50,49
1650067766345,CSE 30,A01,083370,Cao; Yingjun,0,63,40,40
1650067772373,CSE 100,A01,083372,Cao; Yingjun,0,47,40,40
1650067778401,CSE 101,A01,084011,Staff,0,56,40,40
1650067784432,CSE 141,A01,083374,Eldon; John,0,67,75,75
1650067790469,CSE 141L,A01,083376,Eldon; John,0,73,75,75
1650067796497,CSE 175,A01,084013,Kumar; Rakesh,22,0,25,3
1650067802522,CSE 190,A00,092508,Dubnov; Shlomo,18,0,20,2
1650067808553,ECE 5,A01,084049,Morris; Karcher William,12,0,20,8
1650067814577,ECE 100,A01,084051,Baghdadchi; Saharnaz,0,0,20,20
1650067814577,ECE 100,A02,091916,Baghdadchi; Saharnaz,12,0,20,8
1650067820602,ECE 101,A01,084053,Baghdadchi; Saharnaz,0,0,37,37
1650067820602,ECE 101,A02,084054,Baghdadchi; Saharnaz,28,0,37,9
1650067826636,ECE 107,A01,083390,Staff,26,0,40,14
1650067832663,ECE 148,A01,084056,Silberman; Jack,8,0,12,4
1650067838692,ECE 180,A00,083391,Abi Samra; Nicholas Camill,25,0,30,5
1650067838692,ECE 180,B00,083392,Abi Samra; Nicholas Camill,21,0,30,9
1650067844718,MATH 10B,A01,084110,Staff,0,0,30,30
1650067844718,MATH 10B,A02,084111,Staff,17,0,30,13
1650067844718,MATH 10B,A03,084112,Staff,23,0,30,7
1650067850747,MATH 10C,A01,083443,Staff,0,17,30,31
1650067850747,MATH 10C,A02,083444,Staff,1,17,30,29
1650067850747,MATH 10C,B01,084114,Staff,17,0,30,13
1650067850747,MATH 10C,B02,084115,Staff,25,0,30,5
1650067856771,MATH 18,A01,084117,Harel; Guershon,11,0,30,19
1650067856771,MATH 18,A02,084119,Harel; Guershon,27,0,30,3
1650067856771,MATH 18,A03,084120,Harel; Guershon,30,0,30,0
1650067856771,MATH 18,A04,084121,Harel; Guershon,29,0,30,1
1650067862795,MATH 20B,A01,084124,Um; Ko Woon,10,0,35,25
1650067862795,MATH 20B,B01,084126,Um; Ko Woon,24,0,35,11
1650067868829,MATH 20C,A01,083446,Hammock; Frances H,0,0,30,30
1650067868829,MATH 20C,A02,083447,Hammock; Frances H,13,0,30,17
1650067868829,MATH 20C,A03,083448,Hammock; Frances H,19,0,30,11
1650067868829,MATH 20C,A04,083449,Hammock; Frances H,20,0,30,10
1650067868829,MATH 20C,B01,083451,Hammock; Frances H,0,0,30,30
1650067868829,MATH 20C,B02,083452,Hammock; Frances H,15,0,30,15
1650067868829,MATH 20C,B03,083453,Hammock; Frances H,19,0,30,11
1650067868829,MATH 20C,B04,083454,Hammock; Frances H,23,0,30,7
1650067874855,MATH 20D,A01,084128,Staff,14,0,30,16
1650067874855,MATH 20D,A02,084129,Staff,29,0,30,1
1650067874855,MATH 20D,A03,084130,Staff,27,0,30,3
1650067874855,MATH 20D,B01,084133,Staff,0,0,30,30
1650067874855,MATH 20D,B02,084134,Staff,23,0,30,7
1650067874855,MATH 20D,B03,084135,Staff,28,0,30,2
1650067880881,MATH 20E,A01,084138,Staff,12,0,30,18
1650067880881,MATH 20E,A02,084139,Staff,6,0,30,24
1650067880881,MATH 20E,A03,084140,Staff,14,0,30,16
1650067880881,MATH 20E,A04,084141,Staff,19,0,30,11
1650067886912,MATH 102,A01,084143,Harel; Guershon,11,0,30,19
1650067886912,MATH 102,A02,084144,Harel; Guershon,19,0,30,11
1650067892937,MATH 103B,A01,083456,Staff,0,13,30,30
1650067892937,MATH 103B,A02,083457,Staff,0,14,30,30
1650067898965,MATH 109,A01,084146,Salehi Golsefidy; Alireza,16,0,30,14
1650067898965,MATH 109,A02,084147,Salehi Golsefidy; Alireza,15,0,30,15
1650067904994,MATH 120A,A01,085445,Eggers; John Dietrich,9,0,35,26
1650067904994,MATH 120A,A02,085446,Eggers; John Dietrich,26,0,35,9
1650067911018,MATH 142B,A01,084149,Verstraete; Jacques Allan,0,12,30,30
1650067911018,MATH 142B,A02,084150,Verstraete; Jacques Allan,0,12,30,30
1650067917049,MATH 170A,A01,083459,Nie; Jiawang,0,11,30,30
1650067917049,MATH 170A,A02,083460,Nie; Jiawang,0,10,30,30
1650067917049,MATH 170A,A03,083461,Nie; Jiawang,0,10,30,30
1650067923075,MATH 193B,A01,083463,Staff,1,0,30,29
1650067923075,MATH 193B,A02,083464,Staff,8,0,30,22
1650067923075,MATH 193B,A03,083465,Staff,16,0,30,14
1650067929129,COGS 2,A01,083966,Boyle; Mary E. T.,10,0,30,20
1650067935153,COGS 9,A01,083968,Staff,4,0,60,56
1650067941176,COGS 14B,A01,083970,Staff,9,0,50,41
1650067947202,COGS 17,A01,092679,Staff,49,0,75,26
1650067953228,COGS 100,A01,083972,Staff,0,19,60,60
1650067965277,COGS 101C,A01,083976,Staff,12,0,30,18
1650067971310,COGS 102A,A01,083978,Johnson; Christine M.,12,0,30,18
1650067977338,COGS 107B,A01,083980,Staff,0,8,50,50
1650067983367,COGS 115,A01,083982,Staff,10,0,30,20
1650067989399,COGS 118B,A01,083367,Staff,0,15,40,40
1650067995425,COGS 172,A01,083984,Provenzano; Emily Kara,15,0,30,15
1650068001460,COGS 177,A00,083368,Staff,0,21,30,30
1650068007488,COGS 186,A01,083986,Staff,21,0,40,19
1650068013511,COGS 187A,A01,083988,Boyle; Mary E. T.,19,0,60,41
1650068019535,CSE 8A,A50,084003,Miranda; Gregory Joseph,0,18,15,15
1650068025564,CSE 11,A01,084005,Miranda; Gregory Joseph,1,24,55,54
1650068031589,CSE 20,A01,084007,Staff,0,5,20,20
1650068037715,CSE 21,A01,084009,Staff,1,33,50,49
1650068043740,CSE 30,A01,083370,Cao; Yingjun,0,63,40,40
1650068049764,CSE 100,A01,083372,Cao; Yingjun,0,47,40,40
1650068055791,CSE 101,A01,084011,Staff,0,56,40,40
1650068061814,CSE 141,A01,083374,Eldon; John,0,67,75,75
1650068067840,CSE 141L,A01,083376,Eldon; John,0,73,75,75
1650068073875,CSE 175,A01,084013,Kumar; Rakesh,22,0,25,3
1650068079908,CSE 190,A00,092508,Dubnov; Shlomo,18,0,20,2
1650068085930,ECE 5,A01,084049,Morris; Karcher William,12,0,20,8
1650068091957,ECE 100,A01,084051,Baghdadchi; Saharnaz,0,0,20,20
1650068091957,ECE 100,A02,091916,Baghdadchi; Saharnaz,12,0,20,8
1650068097984,ECE 101,A01,084053,Baghdadchi; Saharnaz,0,0,37,37
1650068097984,ECE 101,A02,084054,Baghdadchi; Saharnaz,28,0,37,9
1650068104006,ECE 107,A01,083390,Staff,26,0,40,14
1650068110033,ECE 148,A01,084056,Silberman; Jack,8,0,12,4
1650068116063,ECE 180,A00,083391,Abi Samra; Nicholas Camill,25,0,30,5
1650068116063,ECE 180,B00,083392,Abi Samra; Nicholas Camill,21,0,30,9
1650068122091,MATH 10B,A01,084110,Staff,0,0,30,30
1650068122091,MATH 10B,A02,084111,Staff,17,0,30,13
1650068122091,MATH 10B,A03,084112,Staff,23,0,30,7
1650068128120,MATH 10C,A01,083443,Staff,0,17,30,31
1650068128120,MATH 10C,A02,083444,Staff,1,17,30,29
1650068128120,MATH 10C,B01,084114,Staff,17,0,30,13
1650068128120,MATH 10C,B02,084115,Staff,25,0,30,5
1650068134145,MATH 18,A01,084117,Harel; Guershon,11,0,30,19
1650068134145,MATH 18,A02,084119,Harel; Guershon,27,0,30,3
1650068134145,MATH 18,A03,084120,Harel; Guershon,30,0,30,0
1650068134145,MATH 18,A04,084121,Harel; Guershon,29,0,30,1
1650068140168,MATH 20B,A01,084124,Um; Ko Woon,10,0,35,25
1650068140168,MATH 20B,B01,084126,Um; Ko Woon,24,0,35,11
1650068146201,MATH 20C,A01,083446,Hammock; Frances H,0,0,30,30
1650068146201,MATH 20C,A02,083447,Hammock; Frances H,13,0,30,17
1650068146201,MATH 20C,A03,083448,Hammock; Frances H,19,0,30,11
1650068146201,MATH 20C,A04,083449,Hammock; Frances H,20,0,30,10
1650068146201,MATH 20C,B01,083451,Hammock; Frances H,0,0,30,30
1650068146201,MATH 20C,B02,083452,Hammock; Frances H,15,0,30,15
1650068146201,MATH 20C,B03,083453,Hammock; Frances H,19,0,30,11
1650068146201,MATH 20C,B04,083454,Hammock; Frances H,23,0,30,7
1650068152224,MATH 20D,A01,084128,Staff,14,0,30,16
1650068152224,MATH 20D,A02,084129,Staff,29,0,30,1
1650068152224,MATH 20D,A03,084130,Staff,27,0,30,3
1650068152224,MATH 20D,B01,084133,Staff,0,0,30,30
1650068152224,MATH 20D,B02,084134,Staff,23,0,30,7
1650068152224,MATH 20D,B03,084135,Staff,28,0,30,2
1650068158248,MATH 20E,A01,084138,Staff,12,0,30,18
1650068158248,MATH 20E,A02,084139,Staff,6,0,30,24
1650068158248,MATH 20E,A03,084140,Staff,14,0,30,16
1650068158248,MATH 20E,A04,084141,Staff,19,0,30,11
1650068164272,MATH 102,A01,084143,Harel; Guershon,11,0,30,19
1650068164272,MATH 102,A02,084144,Harel; Guershon,19,0,30,11
1650068170295,MATH 103B,A01,083456,Staff,0,13,30,30
1650068170295,MATH 103B,A02,083457,Staff,0,14,30,30
1650068176326,MATH 109,A01,084146,Salehi Golsefidy; Alireza,16,0,30,14
1650068176326,MATH 109,A02,084147,Salehi Golsefidy; Alireza,15,0,30,15
1650068182353,MATH 120A,A01,085445,Eggers; John Dietrich,9,0,35,26
1650068182353,MATH 120A,A02,085446,Eggers; John Dietrich,26,0,35,9
1650068188377,MATH 142B,A01,084149,Verstraete; Jacques Allan,0,12,30,30
1650068188377,MATH 142B,A02,084150,Verstraete; Jacques Allan,0,12,30,30
1650068194410,MATH 170A,A01,083459,Nie; Jiawang,0,11,30,30
1650068194410,MATH 170A,A02,083460,Nie; Jiawang,0,10,30,30
1650068194410,MATH 170A,A03,083461,Nie; Jiawang,0,10,30,30
1650068200434,MATH 193B,A01,083463,Staff,1,0,30,29
1650068200434,MATH 193B,A02,083464,Staff,8,0,30,22
1650068200434,MATH 193B,A03,083465,Staff,16,0,30,14
1650068206490,COGS 2,A01,083966,Boyle; Mary E. T.,10,0,30,20
1650068212512,COGS 9,A01,083968,Staff,4,0,60,56
1650068218542,COGS 14B,A01,083970,Staff,9,0,50,41
1650068224569,COGS 17,A01,092679,Staff,49,0,75,26
1650068230593,COGS 100,A01,083972,Staff,0,19,60,60
1650068242639,COGS 101C,A01,083976,Staff,12,0,30,18
1650068248664,COGS 102A,A01,083978,Johnson; Christine M.,12,0,30,18
1650068254690,COGS 107B,A01,083980,Staff,0,8,50,50
1650068260719,COGS 115,A01,083982,Staff,10,0,30,20
1650068266750,COGS 118B,A01,083367,Staff,0,15,40,40
1650068272774,COGS 172,A01,083984,Provenzano; Emily Kara,15,0,30,15
1650068278799,COGS 177,A00,083368,Staff,0,21,30,30
1650068284827,COGS 186,A01,083986,Staff,21,0,40,19
1650068290850,COGS 187A,A01,083988,Boyle; Mary E. T.,19,0,60,41
1650068296875,CSE 8A,A50,084003,Miranda; Gregory Joseph,0,18,15,15
1650068302901,CSE 11,A01,084005,Miranda; Gregory Joseph,1,24,55,54
1650068308925,CSE 20,A01,084007,Staff,0,5,20,20
1650068314955,CSE 21,A01,084009,Staff,1,33,50,49
1650068320982,CSE 30,A01,083370,Cao; Yingjun,0,63,40,40
1650068327015,CSE 100,A01,083372,Cao; Yingjun,0,47,40,40
1650068333039,CSE 101,A01,084011,Staff,0,56,40,40
1650068339063,CSE 141,A01,083374,Eldon; John,0,67,75,75
1650068345087,CSE 141L,A01,083376,Eldon; John,0,73,75,75
1650068351111,CSE 175,A01,084013,Kumar; Rakesh,22,0,25,3
1650068357135,CSE 190,A00,092508,Dubnov; Shlomo,18,0,20,2
1650068363176,ECE 5,A01,084049,Morris; Karcher William,12,0,20,8
1650068369200,ECE 100,A01,084051,Baghdadchi; Saharnaz,0,0,20,20
1650068369200,ECE 100,A02,091916,Baghdadchi; Saharnaz,12,0,20,8
1650068375227,ECE 101,A01,084053,Baghdadchi; Saharnaz,0,0,37,37
1650068375227,ECE 101,A02,084054,Baghdadchi; Saharnaz,28,0,37,9
1650068381257,ECE 107,A01,083390,Staff,26,0,40,14
1650068387280,ECE 148,A01,084056,Silberman; Jack,8,0,12,4
1650068393301,ECE 180,A00,083391,Abi Samra; Nicholas Camill,25,0,30,5
1650068393301,ECE 180,B00,083392,Abi Samra; Nicholas Camill,21,0,30,9
1650068399339,MATH 10B,A01,084110,Staff,0,0,30,30
1650068399339,MATH 10B,A02,084111,Staff,17,0,30,13
1650068399339,MATH 10B,A03,084112,Staff,23,0,30,7
1650068405363,MATH 10C,A01,083443,Staff,0,17,30,31
1650068405363,MATH 10C,A02,083444,Staff,1,17,30,29
1650068405363,MATH 10C,B01,084114,Staff,17,0,30,13
1650068405363,MATH 10C,B02,084115,Staff,25,0,30,5
1650068411392,MATH 18,A01,084117,Harel; Guershon,11,0,30,19
1650068411392,MATH 18,A02,084119,Harel; Guershon,27,0,30,3
1650068411392,MATH 18,A03,084120,Harel; Guershon,30,0,30,0
1650068411392,MATH 18,A04,084121,Harel; Guershon,29,0,30,1
1650068417419,MATH 20B,A01,084124,Um; Ko Woon,10,0,35,25
1650068417419,MATH 20B,B01,084126,Um; Ko Woon,24,0,35,11
1650068423456,MATH 20C,A01,083446,Hammock; Frances H,0,0,30,30
1650068423456,MATH 20C,A02,083447,Hammock; Frances H,13,0,30,17
1650068423456,MATH 20C,A03,083448,Hammock; Frances H,19,0,30,11
1650068423456,MATH 20C,A04,083449,Hammock; Frances H,20,0,30,10
1650068423456,MATH 20C,B01,083451,Hammock; Frances H,0,0,30,30
1650068423456,MATH 20C,B02,083452,Hammock; Frances H,15,0,30,15
1650068423456,MATH 20C,B03,083453,Hammock; Frances H,19,0,30,11
1650068423456,MATH 20C,B04,083454,Hammock; Frances H,23,0,30,7
1650068429483,MATH 20D,A01,084128,Staff,14,0,30,16
1650068429483,MATH 20D,A02,084129,Staff,29,0,30,1
1650068429483,MATH 20D,A03,084130,Staff,27,0,30,3
1650068429483,MATH 20D,B01,084133,Staff,0,0,30,30
1650068429483,MATH 20D,B02,084134,Staff,23,0,30,7
1650068429483,MATH 20D,B03,084135,Staff,28,0,30,2
1650068435532,MATH 20E,A01,084138,Staff,12,0,30,18
1650068435532,MATH 20E,A02,084139,Staff,6,0,30,24
1650068435532,MATH 20E,A03,084140,Staff,14,0,30,16
1650068435532,MATH 20E,A04,084141,Staff,19,0,30,11
1650068441559,MATH 102,A01,084143,Harel; Guershon,11,0,30,19
1650068441559,MATH 102,A02,084144,Harel; Guershon,19,0,30,11
1650068447583,MATH 103B,A01,083456,Staff,0,13,30,30
1650068447583,MATH 103B,A02,083457,Staff,0,14,30,30
1650068453607,MATH 109,A01,084146,Salehi Golsefidy; Alireza,16,0,30,14
1650068453607,MATH 109,A02,084147,Salehi Golsefidy; Alireza,15,0,30,15
1650068459635,MATH 120A,A01,085445,Eggers; John Dietrich,9,0,35,26
1650068459635,MATH 120A,A02,085446,Eggers; John Dietrich,26,0,35,9
1650068465662,MATH 142B,A01,084149,Verstraete; Jacques Allan,0,12,30,30
1650068465662,MATH 142B,A02,084150,Verstraete; Jacques Allan,0,12,30,30
1650068471689,MATH 170A,A01,083459,Nie; Jiawang,0,11,30,30
1650068471689,MATH 170A,A02,083460,Nie; Jiawang,0,10,30,30
1650068471689,MATH 170A,A03,083461,Nie; Jiawang,0,10,30,30
1650068477724,MATH 193B,A01,083463,Staff,1,0,30,29
1650068477724,MATH 193B,A02,083464,Staff,8,0,30,22
1650068477724,MATH 193B,A03,083465,Staff,16,0,30,14
1650068483799,COGS 2,A01,083966,Boyle; Mary E. T.,10,0,30,20
1650068489824,COGS 9,A01,083968,Staff,4,0,60,56
1650068495859,COGS 14B,A01,083970,Staff,9,0,50,41
1650068501894,COGS 17,A01,092679,Staff,49,0,75,26
1650068507918,COGS 100,A01,083972,Staff,0,19,60,60
1650068519980,COGS 101C,A01,083976,Staff,12,0,30,18
1650068526014,COGS 102A,A01,083978,Johnson; Christine M.,12,0,30,18
1650068532037,COGS 107B,A01,083980,Staff,0,8,50,50
1650068538063,COGS 115,A01,083982,Staff,10,0,30,20
1650068544085,COGS 118B,A01,083367,Staff,0,15,40,40
1650068550110,COGS 172,A01,083984,Provenzano; Emily Kara,15,0,30,15
1650068556133,COGS 177,A00,083368,Staff,0,21,30,30
1650068562155,COGS 186,A01,083986,Staff,21,0,40,19
1650068568189,COGS 187A,A01,083988,Boyle; Mary E. T.,19,0,60,41
1650068574212,CSE 8A,A50,084003,Miranda; Gregory Joseph,0,18,15,15
1650068580240,CSE 11,A01,084005,Miranda; Gregory Joseph,1,24,55,54
1650068586275,CSE 20,A01,084007,Staff,0,5,20,20
1650068592298,CSE 21,A01,084009,Staff,1,33,50,49
1650068598333,CSE 30,A01,083370,Cao; Yingjun,0,63,40,40
1650068604367,CSE 100,A01,083372,Cao; Yingjun,0,47,40,40
1650068610392,CSE 101,A01,084011,Staff,0,56,40,40
1650068616417,CSE 141,A01,083374,Eldon; John,0,67,75,75
1650068622443,CSE 141L,A01,083376,Eldon; John,0,73,75,75
1650068628473,CSE 175,A01,084013,Kumar; Rakesh,22,0,25,3
1650068634589,CSE 190,A00,092508,Dubnov; Shlomo,18,0,20,2
1650068640628,ECE 5,A01,084049,Morris; Karcher William,12,0,20,8
1650068646649,ECE 100,A01,084051,Baghdadchi; Saharnaz,0,0,20,20
1650068646649,ECE 100,A02,091916,Baghdadchi; Saharnaz,12,0,20,8
1650068652674,ECE 101,A01,084053,Baghdadchi; Saharnaz,0,0,37,37
1650068652674,ECE 101,A02,084054,Baghdadchi; Saharnaz,28,0,37,9
1650068658700,ECE 107,A01,083390,Staff,26,0,40,14
1650068664724,ECE 148,A01,084056,Silberman; Jack,8,0,12,4
1650068670749,ECE 180,A00,083391,Abi Samra; Nicholas Camill,25,0,30,5
1650068670749,ECE 180,B00,083392,Abi Samra; Nicholas Camill,21,0,30,9
1650068676776,MATH 10B,A01,084110,Staff,0,0,30,30
1650068676776,MATH 10B,A02,084111,Staff,17,0,30,13
1650068676776,MATH 10B,A03,084112,Staff,23,0,30,7
1650068682800,MATH 10C,A01,083443,Staff,0,17,30,31
1650068682800,MATH 10C,A02,083444,Staff,1,17,30,29
1650068682800,MATH 10C,B01,084114,Staff,17,0,30,13
1650068682800,MATH 10C,B02,084115,Staff,25,0,30,5
1650068688832,MATH 18,A01,084117,Harel; Guershon,11,0,30,19
1650068688832,MATH 18,A02,084119,Harel; Guershon,27,0,30,3
1650068688832,MATH 18,A03,084120,Harel; Guershon,30,0,30,0
1650068688832,MATH 18,A04,084121,Harel; Guershon,29,0,30,1
1650068694856,MATH 20B,A01,084124,Um; Ko Woon,10,0,35,25
1650068694856,MATH 20B,B01,084126,Um; Ko Woon,24,0,35,11
1650068700882,MATH 20C,A01,083446,Hammock; Frances H,0,0,30,30
1650068700882,MATH 20C,A02,083447,Hammock; Frances H,13,0,30,17
1650068700882,MATH 20C,A03,083448,Hammock; Frances H,19,0,30,11
1650068700882,MATH 20C,A04,083449,Hammock; Frances H,20,0,30,10
1650068700882,MATH 20C,B01,083451,Hammock; Frances H,0,0,30,30
1650068700882,MATH 20C,B02,083452,Hammock; Frances H,15,0,30,15
1650068700882,MATH 20C,B03,083453,Hammock; Frances H,19,0,30,11
1650068700882,MATH 20C,B04,083454,Hammock; Frances H,23,0,30,7
1650068706906,MATH 20D,A01,084128,Staff,14,0,30,16
1650068706906,MATH 20D,A02,084129,Staff,29,0,30,1
1650068706906,MATH 20D,A03,084130,Staff,27,0,30,3
1650068706906,MATH 20D,B01,084133,Staff,0,0,30,30
1650068706906,MATH 20D,B02,084134,Staff,23,0,30,7
1650068706906,MATH 20D,B03,084135,Staff,28,0,30,2
1650068712931,MATH 20E,A01,084138,Staff,12,0,30,18
1650068712931,MATH 20E,A02,084139,Staff,6,0,30,24
1650068712931,MATH 20E,A03,084140,Staff,14,0,30,16
1650068712931,MATH 20E,A04,084141,Staff,19,0,30,11
1650068718954,MATH 102,A01,084143,Harel; Guershon,11,0,30,19
1650068718954,MATH 102,A02,084144,Harel; Guershon,19,0,30,11
1650068724980,MATH 103B,A01,083456,Staff,0,13,30,30
1650068724980,MATH 103B,A02,083457,Staff,0,14,30,30
1650068731007,MATH 109,A01,084146,Salehi Golsefidy; Alireza,16,0,30,14
1650068731007,MATH 109,A02,084147,Salehi Golsefidy; Alireza,15,0,30,15
1650068737035,MATH 120A,A01,085445,Eggers; John Dietrich,9,0,35,26
1650068737035,MATH 120A,A02,085446,Eggers; John Dietrich,26,0,35,9
1650068743058,MATH 142B,A01,084149,Verstraete; Jacques Allan,0,12,30,30
1650068743058,MATH 142B,A02,084150,Verstraete; Jacques Allan,0,12,30,30
1650068749086,MATH 170A,A01,083459,Nie; Jiawang,0,11,30,30
1650068749086,MATH 170A,A02,083460,Nie; Jiawang,0,10,30,30
1650068749086,MATH 170A,A03,083461,Nie; Jiawang,0,10,30,30
1650068755112,MATH 193B,A01,083463,Staff,1,0,30,29
1650068755112,MATH 193B,A02,083464,Staff,8,0,30,22
1650068755112,MATH 193B,A03,083465,Staff,16,0,30,14
1650068761176,COGS 2,A01,083966,Boyle; Mary E. T.,10,0,30,20
1650068767204,COGS 9,A01,083968,Staff,4,0,60,56
1650068773236,COGS 14B,A01,083970,Staff,9,0,50,41
1650068779262,COGS 17,A01,092679,Staff,49,0,75,26
1650068785286,COGS 100,A01,083972,Staff,0,19,60,60
1650068797340,COGS 101C,A01,083976,Staff,12,0,30,18
1650068803366,COGS 102A,A01,083978,Johnson; Christine M.,12,0,30,18
1650068809390,COGS 107B,A01,083980,Staff,0,8,50,50
1650068815412,COGS 115,A01,083982,Staff,10,0,30,20
1650068821443,COGS 118B,A01,083367,Staff,0,15,40,40
1650068827471,COGS 172,A01,083984,Provenzano; Emily Kara,15,0,30,15
1650068833498,COGS 177,A00,083368,Staff,0,21,30,30
1650068839521,COGS 186,A01,083986,Staff,21,0,40,19
1650068845544,COGS 187A,A01,083988,Boyle; Mary E. T.,19,0,60,41
1650068851575,CSE 8A,A50,084003,Miranda; Gregory Joseph,0,18,15,15
1650068857602,CSE 11,A01,084005,Miranda; Gregory Joseph,1,24,55,54
1650068863625,CSE 20,A01,084007,Staff,0,5,20,20
1650068869650,CSE 21,A01,084009,Staff,1,33,50,49
1650068875683,CSE 30,A01,083370,Cao; Yingjun,0,63,40,40
1650068881710,CSE 100,A01,083372,Cao; Yingjun,0,47,40,40
1650068887733,CSE 101,A01,084011,Staff,0,56,40,40
1650068893757,CSE 141,A01,083374,Eldon; John,0,67,75,75
1650068899780,CSE 141L,A01,083376,Eldon; John,0,73,75,75
1650068905804,CSE 175,A01,084013,Kumar; Rakesh,22,0,25,3
1650068911831,CSE 190,A00,092508,Dubnov; Shlomo,18,0,20,2
1650068917854,ECE 5,A01,084049,Morris; Karcher William,12,0,20,8
1650068923880,ECE 100,A01,084051,Baghdadchi; Saharnaz,0,0,20,20
1650068923880,ECE 100,A02,091916,Baghdadchi; Saharnaz,12,0,20,8
1650068929911,ECE 101,A01,084053,Baghdadchi; Saharnaz,0,0,37,37
1650068929911,ECE 101,A02,084054,Baghdadchi; Saharnaz,28,0,37,9
1650068935946,ECE 107,A01,083390,Staff,26,0,40,14
1650068941969,ECE 148,A01,084056,Silberman; Jack,8,0,12,4
1650068947996,ECE 180,A00,083391,Abi Samra; Nicholas Camill,25,0,30,5
1650068947996,ECE 180,B00,083392,Abi Samra; Nicholas Camill,21,0,30,9
1650068954024,MATH 10B,A01,084110,Staff,0,0,30,30
1650068954024,MATH 10B,A02,084111,Staff,17,0,30,13
1650068954024,MATH 10B,A03,084112,Staff,23,0,30,7
1650068960047,MATH 10C,A01,083443,Staff,0,17,30,31
1650068960047,MATH 10C,A02,083444,Staff,1,17,30,29
1650068960047,MATH 10C,B01,084114,Staff,17,0,30,13
1650068960047,MATH 10C,B02,084115,Staff,24,0,30,6
1650068966071,MATH 18,A01,084117,Harel; Guershon,11,0,30,19
1650068966071,MATH 18,A02,084119,Harel; Guershon,27,0,30,3
1650068966071,MATH 18,A03,084120,Harel; Guershon,30,0,30,0
1650068966071,MATH 18,A04,084121,Harel; Guershon,29,0,30,1
1650068972095,MATH 20B,A01,084124,Um; Ko Woon,10,0,35,25
1650068972095,MATH 20B,B01,084126,Um; Ko Woon,24,0,35,11
1650068978120,MATH 20C,A01,083446,Hammock; Frances H,0,0,30,30
1650068978120,MATH 20C,A02,083447,Hammock; Frances H,13,0,30,17
1650068978120,MATH 20C,A03,083448,Hammock; Frances H,19,0,30,11
1650068978120,MATH 20C,A04,083449,Hammock; Frances H,20,0,30,10
1650068978120,MATH 20C,B01,083451,Hammock; Frances H,0,0,30,30
1650068978120,MATH 20C,B02,083452,Hammock; Frances H,15,0,30,15
1650068978120,MATH 20C,B03,083453,Hammock; Frances H,19,0,30,11
1650068978120,MATH 20C,B04,083454,Hammock; Frances H,23,0,30,7
1650068984145,MATH 20D,A01,084128,Staff,14,0,30,16
1650068984145,MATH 20D,A02,084129,Staff,29,0,30,1
1650068984145,MATH 20D,A03,084130,Staff,27,0,30,3
1650068984145,MATH 20D,B01,084133,Staff,0,0,30,30
1650068984145,MATH 20D,B02,084134,Staff,23,0,30,7
1650068984145,MATH 20D,B03,084135,Staff,28,0,30,2
1650068990171,MATH 20E,A01,084138,Staff,12,0,30,18
1650068990171,MATH 20E,A02,084139,Staff,6,0,30,24
1650068990171,MATH 20E,A03,084140,Staff,14,0,30,16
1650068990171,MATH 20E,A04,084141,Staff,19,0,30,11
1650068996199,MATH 102,A01,084143,Harel; Guershon,11,0,30,19
1650068996199,MATH 102,A02,084144,Harel; Guershon,19,0,30,11
1650069002221,MATH 103B,A01,083456,Staff,0,13,30,30
1650069002221,MATH 103B,A02,083457,Staff,0,14,30,30
1650069008249,MATH 109,A01,084146,Salehi Golsefidy; Alireza,16,0,30,14
1650069008249,MATH 109,A02,084147,Salehi Golsefidy; Alireza,15,0,30,15
1650069014273,MATH 120A,A01,085445,Eggers; John Dietrich,8,0,35,27
1650069014273,MATH 120A,A02,085446,Eggers; John Dietrich,26,0,35,9
1650069020300,MATH 142B,A01,084149,Verstraete; Jacques Allan,0,12,30,30
1650069020300,MATH 142B,A02,084150,Verstraete; Jacques Allan,0,12,30,30
1650069026327,MATH 170A,A01,083459,Nie; Jiawang,0,11,30,30
1650069026327,MATH 170A,A02,083460,Nie; Jiawang,0,10,30,30
1650069026327,MATH 170A,A03,083461,Nie; Jiawang,0,10,30,30
1650069032350,MATH 193B,A01,083463,Staff,1,0,30,29
1650069032350,MATH 193B,A02,083464,Staff,8,0,30,22
1650069032350,MATH 193B,A03,083465,Staff,16,0,30,14
1650069038420,COGS 2,A01,083966,Boyle; Mary E. T.,10,0,30,20
1650069044443,COGS 9,A01,083968,Staff,4,0,60,56
1650069050470,COGS 14B,A01,083970,Staff,9,0,50,41
1650069056493,COGS 17,A01,092679,Staff,49,0,75,26
1650069062523,COGS 100,A01,083972,Staff,0,19,60,60
1650069074571,COGS 101C,A01,083976,Staff,12,0,30,18
1650069080602,COGS 102A,A01,083978,Johnson; Christine M.,12,0,30,18
1650069086630,COGS 107B,A01,083980,Staff,0,8,50,50
1650069092655,COGS 115,A01,083982,Staff,10,0,30,20
1650069098685,COGS 118B,A01,083367,Staff,0,15,40,40
1650069104709,COGS 172,A01,083984,Provenzano; Emily Kara,15,0,30,15
1650069110733,COGS 177,A00,083368,Staff,0,21,30,30
1650069116767,COGS 186,A01,083986,Staff,21,0,40,19
1650069122792,COGS 187A,A01,083988,Boyle; Mary E. T.,19,0,60,41
1650069128820,CSE 8A,A50,084003,Miranda; Gregory Joseph,0,18,15,15
1650069134847,CSE 11,A01,084005,Miranda; Gregory Joseph,1,24,55,54
1650069140874,CSE 20,A01,084007,Staff,0,5,20,20
1650069146898,CSE 21,A01,084009,Staff,1,33,50,49
1650069152923,CSE 30,A01,083370,Cao; Yingjun,0,63,40,40
1650069158953,CSE 100,A01,083372,Cao; Yingjun,0,47,40,40
1650069164989,CSE 101,A01,084011,Staff,0,56,40,40
1650069171012,CSE 141,A01,083374,Eldon; John,0,67,75,75
1650069177036,CSE 141L,A01,083376,Eldon; John,0,73,75,75
1650069183067,CSE 175,A01,084013,Kumar; Rakesh,22,0,25,3
1650069189092,CSE 190,A00,092508,Dubnov; Shlomo,18,0,20,2
1650069195116,ECE 5,A01,084049,Morris; Karcher William,12,0,20,8
1650069201139,ECE 100,A01,084051,Baghdadchi; Saharnaz,0,0,20,20
1650069201139,ECE 100,A02,091916,Baghdadchi; Saharnaz,12,0,20,8
1650069207162,ECE 101,A01,084053,Baghdadchi; Saharnaz,0,0,37,37
1650069207162,ECE 101,A02,084054,Baghdadchi; Saharnaz,28,0,37,9
1650069213186,ECE 107,A01,083390,Staff,26,0,40,14
1650069219207,ECE 148,A01,084056,Silberman; Jack,8,0,12,4
1650069225234,ECE 180,A00,083391,Abi Samra; Nicholas Camill,25,0,30,5
1650069225234,ECE 180,B00,083392,Abi Samra; Nicholas Camill,21,0,30,9
1650069231352,MATH 10B,A01,084110,Staff,0,0,30,30
1650069231352,MATH 10B,A02,084111,Staff,17,0,30,13
1650069231352,MATH 10B,A03,084112,Staff,23,0,30,7
1650069237375,MATH 10C,A01,083443,Staff,0,17,30,31
1650069237375,MATH 10C,A02,083444,Staff,1,17,30,29
1650069237375,MATH 10C,B01,084114,Staff,17,0,30,13
1650069237375,MATH 10C,B02,084115,Staff,24,0,30,6
1650069243405,MATH 18,A01,084117,Harel; Guershon,11,0,30,19
1650069243405,MATH 18,A02,084119,Harel; Guershon,27,0,30,3
1650069243405,MATH 18,A03,084120,Harel; Guershon,30,0,30,0
1650069243405,MATH 18,A04,084121,Harel; Guershon,29,0,30,1
1650069249429,MATH 20B,A01,084124,Um; Ko Woon,10,0,35,25
1650069249429,MATH 20B,B01,084126,Um; Ko Woon,24,0,35,11
1650069255454,MATH 20C,A01,083446,Hammock; Frances H,0,0,30,30
1650069255454,MATH 20C,A02,083447,Hammock; Frances H,13,0,30,17
1650069255454,MATH 20C,A03,083448,Hammock; Frances H,19,0,30,11
1650069255454,MATH 20C,A04,083449,Hammock; Frances H,20,0,30,10
1650069255454,MATH 20C,B01,083451,Hammock; Frances H,0,0,30,30
1650069255454,MATH 20C,B02,083452,Hammock; Frances H,15,0,30,15
1650069255454,MATH 20C,B03,083453,Hammock; Frances H,19,0,30,11
1650069255454,MATH 20C,B04,083454,Hammock; Frances H,23,0,30,7
1650069261480,MATH 20D,A01,084128,Staff,14,0,30,16
1650069261480,MATH 20D,A02,084129,Staff,29,0,30,1
1650069261480,MATH 20D,A03,084130,Staff,27,0,30,3
1650069261480,MATH 20D,B01,084133,Staff,0,0,30,30
1650069261480,MATH 20D,B02,084134,Staff,23,0,30,7
1650069261480,MATH 20D,B03,084135,Staff,28,0,30,2
1650069267504,MATH 20E,A01,084138,Staff,12,0,30,18
1650069267504,MATH 20E,A02,084139,Staff,6,0,30,24
1650069267504,MATH 20E,A03,084140,Staff,14,0,30,16
1650069267504,MATH 20E,A04,084141,Staff,19,0,30,11
1650069273531,MATH 102,A01,084143,Harel; Guershon,11,0,30,19
1650069273531,MATH 102,A02,084144,Harel; Guershon,19,0,30,11
1650069279559,MATH 103B,A01,083456,Staff,0,13,30,30
1650069279559,MATH 103B,A02,083457,Staff,0,14,30,30
1650069285604,MATH 109,A01,084146,Salehi Golsefidy; Alireza,16,0,30,14
1650069285604,MATH 109,A02,084147,Salehi Golsefidy; Alireza,15,0,30,15
1650069291630,MATH 120A,A01,085445,Eggers; John Dietrich,8,0,35,27
1650069291630,MATH 120A,A02,085446,Eggers; John Dietrich,26,0,35,9
1650069297659,MATH 142B,A01,084149,Verstraete; Jacques Allan,0,12,30,30
1650069297659,MATH 142B,A02,084150,Verstraete; Jacques Allan,0,12,30,30
1650069303682,MATH 170A,A01,083459,Nie; Jiawang,0,11,30,30
1650069303682,MATH 170A,A02,083460,Nie; Jiawang,0,10,30,30
1650069303682,MATH 170A,A03,083461,Nie; Jiawang,0,10,30,30
1650069309709,MATH 193B,A01,083463,Staff,1,0,30,29
1650069309709,MATH 193B,A02,083464,Staff,8,0,30,22
1650069309709,MATH 193B,A03,083465,Staff,16,0,30,14
1650069315780,COGS 2,A01,083966,Boyle; Mary E. T.,10,0,30,20
1650069321803,COGS 9,A01,083968,Staff,4,0,60,56
1650069327827,COGS 14B,A01,083970,Staff,9,0,50,41
1650069333852,COGS 17,A01,092679,Staff,49,0,75,26
1650069339878,COGS 100,A01,083972,Staff,0,19,60,60
1650069351929,COGS 101C,A01,083976,Staff,12,0,30,18
1650069357956,COGS 102A,A01,083978,Johnson; Christine M.,12,0,30,18
1650069363983,COGS 107B,A01,083980,Staff,0,8,50,50
1650069370011,COGS 115,A01,083982,Staff,10,0,30,20
1650069376033,COGS 118B,A01,083367,Staff,0,15,40,40
1650069382067,COGS 172,A01,083984,Provenzano; Emily Kara,15,0,30,15
1650069388090,COGS 177,A00,083368,Staff,0,21,30,30
1650069394111,COGS 186,A01,083986,Staff,21,0,40,19
1650069400134,COGS 187A,A01,083988,Boyle; Mary E. T.,19,0,60,41
1650069406157,CSE 8A,A50,084003,Miranda; Gregory Joseph,0,18,15,15
1650069412184,CSE 11,A01,084005,Miranda; Gregory Joseph,1,24,55,54
1650069418210,CSE 20,A01,084007,Staff,0,5,20,20
1650069424237,CSE 21,A01,084009,Staff,1,33,50,49
1650069430268,CSE 30,A01,083370,Cao; Yingjun,0,63,40,40
1650069436293,CSE 100,A01,083372,Cao; Yingjun,0,47,40,40
1650069442320,CSE 101,A01,084011,Staff,0,56,40,40
1650069448346,CSE 141,A01,083374,Eldon; John,0,67,75,75
1650069454372,CSE 141L,A01,083376,Eldon; John,0,73,75,75
1650069460399,CSE 175,A01,084013,Kumar; Rakesh,22,0,25,3
1650069466425,CSE 190,A00,092508,Dubnov; Shlomo,18,0,20,2
1650069472448,ECE 5,A01,084049,Morris; Karcher William,12,0,20,8
1650069478471,ECE 100,A01,084051,Baghdadchi; Saharnaz,0,0,20,20
1650069478471,ECE 100,A02,091916,Baghdadchi; Saharnaz,12,0,20,8
1650069484499,ECE 101,A01,084053,Baghdadchi; Saharnaz,0,0,37,37
1650069484499,ECE 101,A02,084054,Baghdadchi; Saharnaz,28,0,37,9
1650069490526,ECE 107,A01,083390,Staff,26,0,40,14
1650069496552,ECE 148,A01,084056,Silberman; Jack,8,0,12,4
1650069502582,ECE 180,A00,083391,Abi Samra; Nicholas Camill,25,0,30,5
1650069502582,ECE 180,B00,083392,Abi Samra; Nicholas Camill,21,0,30,9
1650069508606,MATH 10B,A01,084110,Staff,0,0,30,30
1650069508606,MATH 10B,A02,084111,Staff,17,0,30,13
1650069508606,MATH 10B,A03,084112,Staff,23,0,30,7
1650069514630,MATH 10C,A01,083443,Staff,0,17,30,31
1650069514630,MATH 10C,A02,083444,Staff,1,17,30,29
1650069514630,MATH 10C,B01,084114,Staff,17,0,30,13
1650069514630,MATH 10C,B02,084115,Staff,24,0,30,6
1650069520658,MATH 18,A01,084117,Harel; Guershon,11,0,30,19
1650069520658,MATH 18,A02,084119,Harel; Guershon,27,0,30,3
1650069520658,MATH 18,A03,084120,Harel; Guershon,30,0,30,0
1650069520658,MATH 18,A04,084121,Harel; Guershon,29,0,30,1
1650069526692,MATH 20B,A01,084124,Um; Ko Woon,10,0,35,25
1650069526692,MATH 20B,B01,084126,Um; Ko Woon,24,0,35,11
1650069532718,MATH 20C,A01,083446,Hammock; Frances H,0,0,30,30
1650069532718,MATH 20C,A02,083447,Hammock; Frances H,13,0,30,17
1650069532718,MATH 20C,A03,083448,Hammock; Frances H,19,0,30,11
1650069532718,MATH 20C,A04,083449,Hammock; Frances H,20,0,30,10
1650069532718,MATH 20C,B01,083451,Hammock; Frances H,0,0,30,30
1650069532718,MATH 20C,B02,083452,Hammock; Frances H,15,0,30,15
1650069532718,MATH 20C,B03,083453,Hammock; Frances H,19,0,30,11
1650069532718,MATH 20C,B04,083454,Hammock; Frances H,23,0,30,7
1650069538746,MATH 20D,A01,084128,Staff,14,0,30,16
1650069538746,MATH 20D,A02,084129,Staff,29,0,30,1
1650069538746,MATH 20D,A03,084130,Staff,27,0,30,3
1650069538746,MATH 20D,B01,084133,Staff,0,0,30,30
1650069538746,MATH 20D,B02,084134,Staff,23,0,30,7
1650069538746,MATH 20D,B03,084135,Staff,28,0,30,2
1650069544774,MATH 20E,A01,084138,Staff,12,0,30,18
1650069544774,MATH 20E,A02,084139,Staff,6,0,30,24
1650069544774,MATH 20E,A03,084140,Staff,14,0,30,16
1650069544774,MATH 20E,A04,084141,Staff,19,0,30,11
1650069550798,MATH 102,A01,084143,Harel; Guershon,11,0,30,19
1650069550798,MATH 102,A02,084144,Harel; Guershon,19,0,30,11
1650069556831,MATH 103B,A01,083456,Staff,0,13,30,30
1650069556831,MATH 103B,A02,083457,Staff,0,14,30,30
1650069562856,MATH 109,A01,084146,Salehi Golsefidy; Alireza,16,0,30,14
1650069562856,MATH 109,A02,084147,Salehi Golsefidy; Alireza,15,0,30,15
1650069568883,MATH 120A,A01,085445,Eggers; John Dietrich,8,0,35,27
1650069568883,MATH 120A,A02,085446,Eggers; John Dietrich,26,0,35,9
1650069574918,MATH 142B,A01,084149,Verstraete; Jacques Allan,0,12,30,30
1650069574918,MATH 142B,A02,084150,Verstraete; Jacques Allan,0,12,30,30
1650069580954,MATH 170A,A01,083459,Nie; Jiawang,0,12,30,30
1650069580954,MATH 170A,A02,083460,Nie; Jiawang,0,10,30,30
1650069580954,MATH 170A,A03,083461,Nie; Jiawang,0,10,30,30
1650069586981,MATH 193B,A01,083463,Staff,1,0,30,29
1650069586981,MATH 193B,A02,083464,Staff,8,0,30,22
1650069586981,MATH 193B,A03,083465,Staff,16,0,30,14
1650069593043,COGS 2,A01,083966,Boyle; Mary E. T.,10,0,30,20
1650069599069,COGS 9,A01,083968,Staff,4,0,60,56
1650069605096,COGS 14B,A01,083970,Staff,9,0,50,41
1650069611120,COGS 17,A01,092679,Staff,49,0,75,26
1650069617151,COGS 100,A01,083972,Staff,0,19,60,60
1650069629211,COGS 101C,A01,083976,Staff,12,0,30,18
1650069635237,COGS 102A,A01,083978,Johnson; Christine M.,12,0,30,18
1650069641261,COGS 107B,A01,083980,Staff,0,8,50,50
1650069647286,COGS 115,A01,083982,Staff,10,0,30,20
1650069653310,COGS 118B,A01,083367,Staff,0,15,40,40
1650069659333,COGS 172,A01,083984,Provenzano; Emily Kara,15,0,30,15
1650069665357,COGS 177,A00,083368,Staff,0,21,30,30
1650069671382,COGS 186,A01,083986,Staff,21,0,40,19
1650069677410,COGS 187A,A01,083988,Boyle; Mary E. T.,19,0,60,41
1650069683439,CSE 8A,A50,084003,Miranda; Gregory Joseph,0,18,15,15
1650069689464,CSE 11,A01,084005,Miranda; Gregory Joseph,1,24,55,54
1650069695499,CSE 20,A01,084007,Staff,0,5,20,20
1650069701523,CSE 21,A01,084009,Staff,1,33,50,49
1650069707548,CSE 30,A01,083370,Cao; Yingjun,0,63,40,40
1650069713572,CSE 100,A01,083372,Cao; Yingjun,0,47,40,40
1650069719603,CSE 101,A01,084011,Staff,0,56,40,40
1650069725625,CSE 141,A01,083374,Eldon; John,0,67,75,75
1650069731649,CSE 141L,A01,083376,Eldon; John,0,73,75,75
1650069737671,CSE 175,A01,084013,Kumar; Rakesh,22,0,25,3
1650069743698,CSE 190,A00,092508,Dubnov; Shlomo,18,0,20,2
1650069749728,ECE 5,A01,084049,Morris; Karcher William,12,0,20,8
1650069755752,ECE 100,A01,084051,Baghdadchi; Saharnaz,0,0,20,20
1650069755752,ECE 100,A02,091916,Baghdadchi; Saharnaz,12,0,20,8
1650069761776,ECE 101,A01,084053,Baghdadchi; Saharnaz,0,0,37,37
1650069761776,ECE 101,A02,084054,Baghdadchi; Saharnaz,28,0,37,9
1650069767800,ECE 107,A01,083390,Staff,26,0,40,14
1650069773826,ECE 148,A01,084056,Silberman; Jack,8,0,12,4
1650069779854,ECE 180,A00,083391,Abi Samra; Nicholas Camill,25,0,30,5
1650069779854,ECE 180,B00,083392,Abi Samra; Nicholas Camill,21,0,30,9
1650069785879,MATH 10B,A01,084110,Staff,0,0,30,30
1650069785879,MATH 10B,A02,084111,Staff,17,0,30,13
1650069785879,MATH 10B,A03,084112,Staff,23,0,30,7
1650069791904,MATH 10C,A01,083443,Staff,0,17,30,31
1650069791904,MATH 10C,A02,083444,Staff,1,17,30,29
1650069791904,MATH 10C,B01,084114,Staff,17,0,30,13
1650069791904,MATH 10C,B02,084115,Staff,24,0,30,6
1650069797929,MATH 18,A01,084117,Harel; Guershon,11,0,30,19
1650069797929,MATH 18,A02,084119,Harel; Guershon,27,0,30,3
1650069797929,MATH 18,A03,084120,Harel; Guershon,30,0,30,0
1650069797929,MATH 18,A04,084121,Harel; Guershon,29,0,30,1
1650069803952,MATH 20B,A01,084124,Um; Ko Woon,10,0,35,25
1650069803952,MATH 20B,B01,084126,Um; Ko Woon,24,0,35,11
1650069809979,MATH 20C,A01,083446,Hammock; Frances H,0,0,30,30
1650069809979,MATH 20C,A02,083447,Hammock; Frances H,13,0,30,17
1650069809979,MATH 20C,A03,083448,Hammock; Frances H,19,0,30,11
1650069809979,MATH 20C,A04,083449,Hammock; Frances H,20,0,30,10
1650069809979,MATH 20C,B01,083451,Hammock; Frances H,0,0,30,30
1650069809979,MATH 20C,B02,083452,Hammock; Frances H,15,0,30,15
1650069809979,MATH 20C,B03,083453,Hammock; Frances H,19,0,30,11
1650069809979,MATH 20C,B04,083454,Hammock; Frances H,23,0,30,7
1650069816003,MATH 20D,A01,084128,Staff,14,0,30,16
1650069816003,MATH 20D,A02,084129,Staff,29,0,30,1
1650069816003,MATH 20D,A03,084130,Staff,27,0,30,3
1650069816003,MATH 20D,B01,084133,Staff,0,0,30,30
1650069816003,MATH 20D,B02,084134,Staff,23,0,30,7
1650069816003,MATH 20D,B03,084135,Staff,28,0,30,2
1650069822026,MATH 20E,A01,084138,Staff,12,0,30,18
1650069822026,MATH 20E,A02,084139,Staff,6,0,30,24
1650069822026,MATH 20E,A03,084140,Staff,14,0,30,16
1650069822026,MATH 20E,A04,084141,Staff,19,0,30,11
1650069828141,MATH 102,A01,084143,Harel; Guershon,11,0,30,19
1650069828141,MATH 102,A02,084144,Harel; Guershon,19,0,30,11
1650069834165,MATH 103B,A01,083456,Staff,0,13,30,30
1650069834165,MATH 103B,A02,083457,Staff,0,14,30,30
1650069840187,MATH 109,A01,084146,Salehi Golsefidy; Alireza,16,0,30,14
1650069840187,MATH 109,A02,084147,Salehi Golsefidy; Alireza,15,0,30,15
1650069846224,MATH 120A,A01,085445,Eggers; John Dietrich,8,0,35,27
1650069846224,MATH 120A,A02,085446,Eggers; John Dietrich,25,0,35,10
1650069852253,MATH 142B,A01,084149,Verstraete; Jacques Allan,0,12,30,30
1650069852253,MATH 142B,A02,084150,Verstraete; Jacques Allan,0,12,30,30
1650069858281,MATH 170A,A01,083459,Nie; Jiawang,0,11,30,30
1650069858281,MATH 170A,A02,083460,Nie; Jiawang,0,10,30,30
1650069858281,MATH 170A,A03,083461,Nie; Jiawang,0,11,30,30
1650069864304,MATH 193B,A01,083463,Staff,1,0,30,29
1650069864304,MATH 193B,A02,083464,Staff,8,0,30,22
1650069864304,MATH 193B,A03,083465,Staff,16,0,30,14
1650069870356,COGS 2,A01,083966,Boyle; Mary E. T.,10,0,30,20
1650069876380,COGS 9,A01,083968,Staff,4,0,60,56
1650069882406,COGS 14B,A01,083970,Staff,9,0,50,41
1650069888433,COGS 17,A01,092679,Staff,49,0,75,26
1650069894455,COGS 100,A01,083972,Staff,0,19,60,60
1650069906510,COGS 101C,A01,083976,Staff,12,0,30,18
1650069912538,COGS 102A,A01,083978,Johnson; Christine M.,12,0,30,18
1650069918565,COGS 107B,A01,083980,Staff,0,8,50,50
1650069924605,COGS 115,A01,083982,Staff,10,0,30,20
1650069930631,COGS 118B,A01,083367,Staff,0,15,40,40
1650069936669,COGS 172,A01,083984,Provenzano; Emily Kara,15,0,30,15
1650069942701,COGS 177,A00,083368,Staff,0,21,30,30
1650069948735,COGS 186,A01,083986,Staff,21,0,40,19
1650069954768,COGS 187A,A01,083988,Boyle; Mary E. T.,19,0,60,41
1650069960795,CSE 8A,A50,084003,Miranda; Gregory Joseph,0,18,15,15
1650069966818,CSE 11,A01,084005,Miranda; Gregory Joseph,1,24,55,54
1650069972842,CSE 20,A01,084007,Staff,0,5,20,20
1650069978868,CSE 21,A01,084009,Staff,1,33,50,49
1650069984891,CSE 30,A01,083370,Cao; Yingjun,0,63,40,40
1650069990918,CSE 100,A01,083372,Cao; Yingjun,0,47,40,40
1650069996942,CSE 101,A01,084011,Staff,0,56,40,40
1650070002966,CSE 141,A01,083374,Eldon; John,0,67,75,75
1650070008988,CSE 141L,A01,083376,Eldon; John,0,73,75,75
1650070015011,CSE 175,A01,084013,Kumar; Rakesh,22,0,25,3
1650070021037,CSE 190,A00,092508,Dubnov; Shlomo,18,0,20,2
1650070027064,ECE 5,A01,084049,Morris; Karcher William,12,0,20,8
1650070033098,ECE 100,A01,084051,Baghdadchi; Saharnaz,0,0,20,20
1650070033098,ECE 100,A02,091916,Baghdadchi; Saharnaz,12,0,20,8
1650070039126,ECE 101,A01,084053,Baghdadchi; Saharnaz,0,0,37,37
1650070039126,ECE 101,A02,084054,Baghdadchi; Saharnaz,28,0,37,9
1650070045153,ECE 107,A01,083390,Staff,26,0,40,14
1650070051175,ECE 148,A01,084056,Silberman; Jack,8,0,12,4
1650070057197,ECE 180,A00,083391,Abi Samra; Nicholas Camill,25,0,30,5
1650070057197,ECE 180,B00,083392,Abi Samra; Nicholas Camill,21,0,30,9
1650070063227,MATH 10B,A01,084110,Staff,0,0,30,30
1650070063227,MATH 10B,A02,084111,Staff,17,0,30,13
1650070063227,MATH 10B,A03,084112,Staff,23,0,30,7
1650070069255,MATH 10C,A01,083443,Staff,0,17,30,31
1650070069255,MATH 10C,A02,083444,Staff,1,17,30,29
1650070069255,MATH 10C,B01,084114,Staff,17,0,30,13
1650070069255,MATH 10C,B02,084115,Staff,24,0,30,6
1650070075282,MATH 18,A01,084117,Harel; Guershon,11,0,30,19
1650070075282,MATH 18,A02,084119,Harel; Guershon,27,0,30,3
1650070075282,MATH 18,A03,084120,Harel; Guershon,30,0,30,0
1650070075282,MATH 18,A04,084121,Harel; Guershon,29,0,30,1
1650070081306,MATH 20B,A01,084124,Um; Ko Woon,10,0,35,25
1650070081306,MATH 20B,B01,084126,Um; Ko Woon,24,0,35,11
1650070087334,MATH 20C,A01,083446,Hammock; Frances H,0,0,30,30
1650070087334,MATH 20C,A02,083447,Hammock; Frances H,13,0,30,17
1650070087334,MATH 20C,A03,083448,Hammock; Frances H,19,0,30,11
1650070087334,MATH 20C,A04,083449,Hammock; Frances H,20,0,30,10
1650070087334,MATH 20C,B01,083451,Hammock; Frances H,0,0,30,30
1650070087334,MATH 20C,B02,083452,Hammock; Frances H,15,0,30,15
1650070087334,MATH 20C,B03,083453,Hammock; Frances H,19,0,30,11
1650070087334,MATH 20C,B04,083454,Hammock; Frances H,23,0,30,7
1650070093358,MATH 20D,A01,084128,Staff,14,0,30,16
1650070093358,MATH 20D,A02,084129,Staff,29,0,30,1
1650070093358,MATH 20D,A03,084130,Staff,27,0,30,3
1650070093358,MATH 20D,B01,084133,Staff,0,0,30,30
1650070093358,MATH 20D,B02,084134,Staff,23,0,30,7
1650070093358,MATH 20D,B03,084135,Staff,28,0,30,2
1650070099398,MATH 20E,A01,084138,Staff,12,0,30,18
1650070099398,MATH 20E,A02,084139,Staff,6,0,30,24
1650070099398,MATH 20E,A03,084140,Staff,14,0,30,16
1650070099398,MATH 20E,A04,084141,Staff,19,0,30,11
1650070105422,MATH 102,A01,084143,Harel; Guershon,11,0,30,19
1650070105422,MATH 102,A02,084144,Harel; Guershon,19,0,30,11
1650070111453,MATH 103B,A01,083456,Staff,0,13,30,30
1650070111453,MATH 103B,A02,083457,Staff,0,14,30,30
1650070117482,MATH 109,A01,084146,Salehi Golsefidy; Alireza,16,0,30,14
1650070117482,MATH 109,A02,084147,Salehi Golsefidy; Alireza,15,0,30,15
1650070123540,MATH 120A,A01,085445,Eggers; John Dietrich,8,0,35,27
1650070123540,MATH 120A,A02,085446,Eggers; John Dietrich,25,0,35,10
1650070129564,MATH 142B,A01,084149,Verstraete; Jacques Allan,0,12,30,30
1650070129564,MATH 142B,A02,084150,Verstraete; Jacques Allan,0,12,30,30
1650070135598,MATH 170A,A01,083459,Nie; Jiawang,0,11,30,30
1650070135598,MATH 170A,A02,083460,Nie; Jiawang,0,10,30,30
1650070135598,MATH 170A,A03,083461,Nie; Jiawang,0,11,30,30
1650070141622,MATH 193B,A01,083463,Staff,1,0,30,29
1650070141622,MATH 193B,A02,083464,Staff,8,0,30,22
1650070141622,MATH 193B,A03,083465,Staff,16,0,30,14
1650070147686,COGS 2,A01,083966,Boyle; Mary E. T.,10,0,30,20
1650070153709,COGS 9,A01,083968,Staff,4,0,60,56
1650070159732,COGS 14B,A01,083970,Staff,9,0,50,41
1650070165771,COGS 17,A01,092679,Staff,49,0,75,26
1650070171794,COGS 100,A01,083972,Staff,0,19,60,60
1650070183844,COGS 101C,A01,083976,Staff,12,0,30,18
1650070189877,COGS 102A,A01,083978,Johnson; Christine M.,12,0,30,18
1650070195911,COGS 107B,A01,083980,Staff,0,8,50,50
1650070201942,COGS 115,A01,083982,Staff,10,0,30,20
1650070207965,COGS 118B,A01,083367,Staff,0,15,40,40
1650070213992,COGS 172,A01,083984,Provenzano; Emily Kara,15,0,30,15
1650070220015,COGS 177,A00,083368,Staff,0,21,30,30
1650070226041,COGS 186,A01,083986,Staff,21,0,40,19
1650070232065,COGS 187A,A01,083988,Boyle; Mary E. T.,19,0,60,41
1650070238093,CSE 8A,A50,084003,Miranda; Gregory Joseph,0,18,15,15
1650070244115,CSE 11,A01,084005,Miranda; Gregory Joseph,1,24,55,54
1650070250147,CSE 20,A01,084007,Staff,0,5,20,20
1650070256171,CSE 21,A01,084009,Staff,1,33,50,49
1650070262198,CSE 30,A01,083370,Cao; Yingjun,0,63,40,40
1650070268225,CSE 100,A01,083372,Cao; Yingjun,0,47,40,40
1650070274248,CSE 101,A01,084011,Staff,0,56,40,40
1650070280277,CSE 141,A01,083374,Eldon; John,0,67,75,75
1650070286305,CSE 141L,A01,083376,Eldon; John,0,73,75,75
1650070292334,CSE 175,A01,084013,Kumar; Rakesh,22,0,25,3
1650070298360,CSE 190,A00,092508,Dubnov; Shlomo,18,0,20,2
1650070304396,ECE 5,A01,084049,Morris; Karcher William,12,0,20,8
1650070310422,ECE 100,A01,084051,Baghdadchi; Saharnaz,0,0,20,20
1650070310422,ECE 100,A02,091916,Baghdadchi; Saharnaz,12,0,20,8
1650070316446,ECE 101,A01,084053,Baghdadchi; Saharnaz,0,0,37,37
1650070316446,ECE 101,A02,084054,Baghdadchi; Saharnaz,28,0,37,9
1650070322473,ECE 107,A01,083390,Staff,26,0,40,14
1650070328514,ECE 148,A01,084056,Silberman; Jack,8,0,12,4
1650070334538,ECE 180,A00,083391,Abi Samra; Nicholas Camill,25,0,30,5
1650070334538,ECE 180,B00,083392,Abi Samra; Nicholas Camill,21,0,30,9
1650070340565,MATH 10B,A01,084110,Staff,0,0,30,30
1650070340565,MATH 10B,A02,084111,Staff,17,0,30,13
1650070340565,MATH 10B,A03,084112,Staff,23,0,30,7
1650070346590,MATH 10C,A01,083443,Staff,0,17,30,31
1650070346590,MATH 10C,A02,083444,Staff,1,17,30,29
1650070346590,MATH 10C,B01,084114,Staff,17,0,30,13
1650070346590,MATH 10C,B02,084115,Staff,24,0,30,6
1650070352615,MATH 18,A01,084117,Harel; Guershon,11,0,30,19
1650070352615,MATH 18,A02,084119,Harel; Guershon,27,0,30,3
1650070352615,MATH 18,A03,084120,Harel; Guershon,30,0,30,0
1650070352615,MATH 18,A04,084121,Harel; Guershon,29,0,30,1
1650070358646,MATH 20B,A01,084124,Um; Ko Woon,10,0,35,25
1650070358646,MATH 20B,B01,084126,Um; Ko Woon,24,0,35,11
1650070364671,MATH 20C,A01,083446,Hammock; Frances H,0,0,30,30
1650070364671,MATH 20C,A02,083447,Hammock; Frances H,13,0,30,17
1650070364671,MATH 20C,A03,083448,Hammock; Frances H,19,0,30,11
1650070364671,MATH 20C,A04,083449,Hammock; Frances H,20,0,30,10
1650070364671,MATH 20C,B01,083451,Hammock; Frances H,0,0,30,30
1650070364671,MATH 20C,B02,083452,Hammock; Frances H,15,0,30,15
1650070364671,MATH 20C,B03,083453,Hammock; Frances H,19,0,30,11
1650070364671,MATH 20C,B04,083454,Hammock; Frances H,23,0,30,7
1650070370699,MATH 20D,A01,084128,Staff,14,0,30,16
1650070370699,MATH 20D,A02,084129,Staff,29,0,30,1
1650070370699,MATH 20D,A03,084130,Staff,27,0,30,3
1650070370699,MATH 20D,B01,084133,Staff,0,0,30,30
1650070370699,MATH 20D,B02,084134,Staff,23,0,30,7
1650070370699,MATH 20D,B03,084135,Staff,28,0,30,2
1650070376724,MATH 20E,A01,084138,Staff,12,0,30,18
1650070376724,MATH 20E,A02,084139,Staff,6,0,30,24
1650070376724,MATH 20E,A03,084140,Staff,14,0,30,16
1650070376724,MATH 20E,A04,084141,Staff,19,0,30,11
1650070382748,MATH 102,A01,084143,Harel; Guershon,11,0,30,19
1650070382748,MATH 102,A02,084144,Harel; Guershon,19,0,30,11
1650070388783,MATH 103B,A01,083456,Staff,0,13,30,30
1650070388783,MATH 103B,A02,083457,Staff,0,14,30,30
1650070394806,MATH 109,A01,084146,Salehi Golsefidy; Alireza,16,0,30,14
1650070394806,MATH 109,A02,084147,Salehi Golsefidy; Alireza,15,0,30,15
1650070400847,MATH 120A,A01,085445,Eggers; John Dietrich,7,0,35,28
1650070400847,MATH 120A,A02,085446,Eggers; John Dietrich,26,0,35,9
1650070406870,MATH 142B,A01,084149,Verstraete; Jacques Allan,0,12,30,30
1650070406870,MATH 142B,A02,084150,Verstraete; Jacques Allan,0,12,30,30
1650070412898,MATH 170A,A01,083459,Nie; Jiawang,0,11,30,30
1650070412898,MATH 170A,A02,083460,Nie; Jiawang,0,10,30,30
1650070412898,MATH 170A,A03,083461,Nie; Jiawang,0,11,30,30
1650070418930,MATH 193B,A01,083463,Staff,1,0,30,29
1650070418930,MATH 193B,A02,083464,Staff,8,0,30,22
1650070418930,MATH 193B,A03,083465,Staff,16,0,30,14
1650070425092,COGS 2,A01,083966,Boyle; Mary E. T.,10,0,30,20
1650070431130,COGS 9,A01,083968,Staff,4,0,60,56
1650070437152,COGS 14B,A01,083970,Staff,9,0,50,41
1650070443176,COGS 17,A01,092679,Staff,49,0,75,26
1650070449201,COGS 100,A01,083972,Staff,0,19,60,60
1650070461263,COGS 101C,A01,083976,Staff,12,0,30,18
1650070467286,COGS 102A,A01,083978,Johnson; Christine M.,12,0,30,18
1650070473321,COGS 107B,A01,083980,Staff,0,8,50,50
1650070479346,COGS 115,A01,083982,Staff,10,0,30,20
1650070485372,COGS 118B,A01,083367,Staff,0,15,40,40
1650070491408,COGS 172,A01,083984,Provenzano; Emily Kara,15,0,30,15
1650070497431,COGS 177,A00,083368,Staff,0,21,30,30
1650070503455,COGS 186,A01,083986,Staff,21,0,40,19
1650070509482,COGS 187A,A01,083988,Boyle; Mary E. T.,19,0,60,41
1650070515506,CSE 8A,A50,084003,Miranda; Gregory Joseph,0,18,15,15
1650070521534,CSE 11,A01,084005,Miranda; Gregory Joseph,1,24,55,54
1650070527559,CSE 20,A01,084007,Staff,0,5,20,20
1650070533586,CSE 21,A01,084009,Staff,1,33,50,49
1650070539613,CSE 30,A01,083370,Cao; Yingjun,0,63,40,40
1650070545640,CSE 100,A01,083372,Cao; Yingjun,0,47,40,40
1650070551665,CSE 101,A01,084011,Staff,0,56,40,40
1650070557689,CSE 141,A01,083374,Eldon; John,0,67,75,75
1650070563717,CSE 141L,A01,083376,Eldon; John,0,73,75,75
1650070569751,CSE 175,A01,084013,Kumar; Rakesh,22,0,25,3
1650070575783,CSE 190,A00,092508,Dubnov; Shlomo,18,0,20,2
1650070581813,ECE 5,A01,084049,Morris; Karcher William,12,0,20,8
1650070587846,ECE 100,A01,084051,Baghdadchi; Saharnaz,0,0,20,20
1650070587846,ECE 100,A02,091916,Baghdadchi; Saharnaz,12,0,20,8
1650070593876,ECE 101,A01,084053,Baghdadchi; Saharnaz,0,0,37,37
1650070593876,ECE 101,A02,084054,Baghdadchi; Saharnaz,28,0,37,9
1650070599907,ECE 107,A01,083390,Staff,26,0,40,14
1650070605930,ECE 148,A01,084056,Silberman; Jack,8,0,12,4
1650070611954,ECE 180,A00,083391,Abi Samra; Nicholas Camill,25,0,30,5
1650070611954,ECE 180,B00,083392,Abi Samra; Nicholas Camill,21,0,30,9
1650070617993,MATH 10B,A01,084110,Staff,0,0,30,30
1650070617993,MATH 10B,A02,084111,Staff,17,0,30,13
1650070617993,MATH 10B,A03,084112,Staff,23,0,30,7
1650070624029,MATH 10C,A01,083443,Staff,0,17,30,31
1650070624029,MATH 10C,A02,083444,Staff,1,17,30,29
1650070624029,MATH 10C,B01,084114,Staff,17,0,30,13
1650070624029,MATH 10C,B02,084115,Staff,24,0,30,6
1650070630063,MATH 18,A01,084117,Harel; Guershon,11,0,30,19
1650070630063,MATH 18,A02,084119,Harel; Guershon,27,0,30,3
1650070630063,MATH 18,A03,084120,Harel; Guershon,30,0,30,0
1650070630063,MATH 18,A04,084121,Harel; Guershon,29,0,30,1
1650070636096,MATH 20B,A01,084124,Um; Ko Woon,10,0,35,25
1650070636096,MATH 20B,B01,084126,Um; Ko Woon,24,0,35,11
1650070642122,MATH 20C,A01,083446,Hammock; Frances H,0,0,30,30
1650070642122,MATH 20C,A02,083447,Hammock; Frances H,13,0,30,17
1650070642122,MATH 20C,A03,083448,Hammock; Frances H,19,0,30,11
1650070642122,MATH 20C,A04,083449,Hammock; Frances H,20,0,30,10
1650070642122,MATH 20C,B01,083451,Hammock; Frances H,0,0,30,30
1650070642122,MATH 20C,B02,083452,Hammock; Frances H,15,0,30,15
1650070642122,MATH 20C,B03,083453,Hammock; Frances H,19,0,30,11
1650070642122,MATH 20C,B04,083454,Hammock; Frances H,23,0,30,7
1650070648147,MATH 20D,A01,084128,Staff,14,0,30,16
1650070648147,MATH 20D,A02,084129,Staff,29,0,30,1
1650070648147,MATH 20D,A03,084130,Staff,27,0,30,3
1650070648147,MATH 20D,B01,084133,Staff,0,0,30,30
1650070648147,MATH 20D,B02,084134,Staff,23,0,30,7
1650070648147,MATH 20D,B03,084135,Staff,28,0,30,2
1650070654177,MATH 20E,A01,084138,Staff,12,0,30,18
1650070654177,MATH 20E,A02,084139,Staff,6,0,30,24
1650070654177,MATH 20E,A03,084140,Staff,14,0,30,16
1650070654177,MATH 20E,A04,084141,Staff,19,0,30,11
1650070660205,MATH 102,A01,084143,Harel; Guershon,11,0,30,19
1650070660205,MATH 102,A02,084144,Harel; Guershon,19,0,30,11
1650070666238,MATH 103B,A01,083456,Staff,0,13,30,30
1650070666238,MATH 103B,A02,083457,Staff,0,14,30,30
1650070672262,MATH 109,A01,084146,Salehi Golsefidy; Alireza,16,0,30,14
1650070672262,MATH 109,A02,084147,Salehi Golsefidy; Alireza,15,0,30,15
1650070678294,MATH 120A,A01,085445,Eggers; John Dietrich,7,0,35,28
1650070678294,MATH 120A,A02,085446,Eggers; John Dietrich,26,0,35,9
1650070684322,MATH 142B,A01,084149,Verstraete; Jacques Allan,0,12,30,30
1650070684322,MATH 142B,A02,084150,Verstraete; Jacques Allan,0,12,30,30
1650070690349,MATH 170A,A01,083459,Nie; Jiawang,0,11,30,30
1650070690349,MATH 170A,A02,083460,Nie; Jiawang,0,10,30,30
1650070690349,MATH 170A,A03,083461,Nie; Jiawang,0,11,30,30
1650070696372,MATH 193B,A01,083463,Staff,1,0,30,29
1650070696372,MATH 193B,A02,083464,Staff,8,0,30,22
1650070696372,MATH 193B,A03,083465,Staff,16,0,30,14
1650070702435,COGS 2,A01,083966,Boyle; Mary E. T.,10,0,30,20
1650070708468,COGS 9,A01,083968,Staff,4,0,60,56
1650070714492,COGS 14B,A01,083970,Staff,9,0,50,41
1650070720518,COGS 17,A01,092679,Staff,49,0,75,26
1650070726543,COGS 100,A01,083972,Staff,0,19,60,60
1650070738588,COGS 101C,A01,083976,Staff,12,0,30,18
1650070744623,COGS 102A,A01,083978,Johnson; Christine M.,12,0,30,18
1650070750654,COGS 107B,A01,083980,Staff,0,8,50,50
1650070756682,COGS 115,A01,083982,Staff,10,0,30,20
1650070762707,COGS 118B,A01,083367,Staff,0,15,40,40
1650070768731,COGS 172,A01,083984,Provenzano; Emily Kara,15,0,30,15
1650070774759,COGS 177,A00,083368,Staff,0,21,30,30
1650070780782,COGS 186,A01,083986,Staff,21,0,40,19
1650070786818,COGS 187A,A01,083988,Boyle; Mary E. T.,19,0,60,41
1650070792840,CSE 8A,A50,084003,Miranda; Gregory Joseph,0,18,15,15
1650070798870,CSE 11,A01,084005,Miranda; Gregory Joseph,1,24,55,54
1650070804894,CSE 20,A01,084007,Staff,0,5,20,20
1650070810924,CSE 21,A01,084009,Staff,1,33,50,49
1650070816952,CSE 30,A01,083370,Cao; Yingjun,0,63,40,40
1650070822976,CSE 100,A01,083372,Cao; Yingjun,0,47,40,40
1650070829004,CSE 101,A01,084011,Staff,0,56,40,40
1650070835031,CSE 141,A01,083374,Eldon; John,0,67,75,75
1650070841055,CSE 141L,A01,083376,Eldon; John,0,73,75,75
1650070847078,CSE 175,A01,084013,Kumar; Rakesh,22,0,25,3
1650070853103,CSE 190,A00,092508,Dubnov; Shlomo,18,0,20,2
1650070859126,ECE 5,A01,084049,Morris; Karcher William,12,0,20,8
1650070865154,ECE 100,A01,084051,Baghdadchi; Saharnaz,0,0,20,20
1650070865154,ECE 100,A02,091916,Baghdadchi; Saharnaz,12,0,20,8
1650070871179,ECE 101,A01,084053,Baghdadchi; Saharnaz,0,0,37,37
1650070871179,ECE 101,A02,084054,Baghdadchi; Saharnaz,28,0,37,9
1650070877209,ECE 107,A01,083390,Staff,26,0,40,14
1650070883232,ECE 148,A01,084056,Silberman; Jack,8,0,12,4
1650070889260,ECE 180,A00,083391,Abi Samra; Nicholas Camill,25,0,30,5
1650070889260,ECE 180,B00,083392,Abi Samra; Nicholas Camill,21,0,30,9
1650070895285,MATH 10B,A01,084110,Staff,0,0,30,30
1650070895285,MATH 10B,A02,084111,Staff,17,0,30,13
1650070895285,MATH 10B,A03,084112,Staff,23,0,30,7
1650070901309,MATH 10C,A01,083443,Staff,0,17,30,31
1650070901309,MATH 10C,A02,083444,Staff,1,18,30,29
1650070901309,MATH 10C,B01,084114,Staff,17,0,30,13
1650070901309,MATH 10C,B02,084115,Staff,24,0,30,6
1650070907375,MATH 18,A01,084117,Harel; Guershon,11,0,30,19
1650070907375,MATH 18,A02,084119,Harel; Guershon,27,0,30,3
1650070907375,MATH 18,A03,084120,Harel; Guershon,30,0,30,0
1650070907375,MATH 18,A04,084121,Harel; Guershon,29,0,30,1
1650070913399,MATH 20B,A01,084124,Um; Ko Woon,10,0,35,25
1650070913399,MATH 20B,B01,084126,Um; Ko Woon,24,0,35,11
1650070919443,MATH 20C,A01,083446,Hammock; Frances H,0,0,30,30
1650070919443,MATH 20C,A02,083447,Hammock; Frances H,13,0,30,17
1650070919443,MATH 20C,A03,083448,Hammock; Frances H,19,0,30,11
1650070919443,MATH 20C,A04,083449,Hammock; Frances H,20,0,30,10
1650070919443,MATH 20C,B01,083451,Hammock; Frances H,0,0,30,30
1650070919443,MATH 20C,B02,083452,Hammock; Frances H,15,0,30,15
1650070919443,MATH 20C,B03,083453,Hammock; Frances H,19,0,30,11
1650070919443,MATH 20C,B04,083454,Hammock; Frances H,23,0,30,7
1650070925471,MATH 20D,A01,084128,Staff,14,0,30,16
1650070925471,MATH 20D,A02,084129,Staff,29,0,30,1
1650070925471,MATH 20D,A03,084130,Staff,27,0,30,3
1650070925471,MATH 20D,B01,084133,Staff,0,0,30,30
1650070925471,MATH 20D,B02,084134,Staff,23,0,30,7
1650070925471,MATH 20D,B03,084135,Staff,28,0,30,2
1650070931498,MATH 20E,A01,084138,Staff,12,0,30,18
1650070931498,MATH 20E,A02,084139,Staff,6,0,30,24
1650070931498,MATH 20E,A03,084140,Staff,14,0,30,16
1650070931498,MATH 20E,A04,084141,Staff,19,0,30,11
1650070937532,MATH 102,A01,084143,Harel; Guershon,11,0,30,19
1650070937532,MATH 102,A02,084144,Harel; Guershon,19,0,30,11
1650070943558,MATH 103B,A01,083456,Staff,0,13,30,30
1650070943558,MATH 103B,A02,083457,Staff,0,14,30,30
1650070949586,MATH 109,A01,084146,Salehi Golsefidy; Alireza,16,0,30,14
1650070949586,MATH 109,A02,084147,Salehi Golsefidy; Alireza,15,0,30,15
1650070955613,MATH 120A,A01,085445,Eggers; John Dietrich,7,0,35,28
1650070955613,MATH 120A,A02,085446,Eggers; John Dietrich,26,0,35,9
1650070961641,MATH 142B,A01,084149,Verstraete; Jacques Allan,0,12,30,30
1650070961641,MATH 142B,A02,084150,Verstraete; Jacques Allan,0,12,30,30
1650070967664,MATH 170A,A01,083459,Nie; Jiawang,0,11,30,30
1650070967664,MATH 170A,A02,083460,Nie; Jiawang,0,10,30,30
1650070967664,MATH 170A,A03,083461,Nie; Jiawang,0,11,30,30
1650070973687,MATH 193B,A01,083463,Staff,1,0,30,29
1650070973687,MATH 193B,A02,083464,Staff,8,0,30,22
1650070973687,MATH 193B,A03,083465,Staff,16,0,30,14
1650070979743,COGS 2,A01,083966,Boyle; Mary E. T.,10,0,30,20
1650070985790,COGS 9,A01,083968,Staff,4,0,60,56
1650070991813,COGS 14B,A01,083970,Staff,9,0,50,41
1650070997839,COGS 17,A01,092679,Staff,49,0,75,26
1650071003862,COGS 100,A01,083972,Staff,0,19,60,60
1650071015986,COGS 101C,A01,083976,Staff,12,0,30,18
1650071022009,COGS 102A,A01,083978,Johnson; Christine M.,12,0,30,18
1650071028032,COGS 107B,A01,083980,Staff,0,8,50,50
1650071034060,COGS 115,A01,083982,Staff,10,0,30,20
1650071040084,COGS 118B,A01,083367,Staff,0,15,40,40
1650071046107,COGS 172,A01,083984,Provenzano; Emily Kara,15,0,30,15
1650071052133,COGS 177,A00,083368,Staff,0,21,30,30
1650071058155,COGS 186,A01,083986,Staff,21,0,40,19
1650071064177,COGS 187A,A01,083988,Boyle; Mary E. T.,19,0,60,41
1650071070205,CSE 8A,A50,084003,Miranda; Gregory Joseph,0,18,15,15
1650071076255,CSE 11,A01,084005,Miranda; Gregory Joseph,1,24,55,54
1650071082281,CSE 20,A01,084007,Staff,0,5,20,20
1650071088303,CSE 21,A01,084009,Staff,1,33,50,49
1650071094330,CSE 30,A01,083370,Cao; Yingjun,0,63,40,40
1650071100357,CSE 100,A01,083372,Cao; Yingjun,0,47,40,40
1650071106390,CSE 101,A01,084011,Staff,0,56,40,40
1650071112413,CSE 141,A01,083374,Eldon; John,0,67,75,75
1650071118437,CSE 141L,A01,083376,Eldon; John,0,73,75,75
1650071124461,CSE 175,A01,084013,Kumar; Rakesh,22,0,25,3
1650071130485,CSE 190,A00,092508,Dubnov; Shlomo,18,0,20,2
1650071136513,ECE 5,A01,084049,Morris; Karcher William,12,0,20,8
1650071142536,ECE 100,A01,084051,Baghdadchi; Saharnaz,0,0,20,20
1650071142536,ECE 100,A02,091916,Baghdadchi; Saharnaz,12,0,20,8
1650071148559,ECE 101,A01,084053,Baghdadchi; Saharnaz,0,0,37,37
1650071148559,ECE 101,A02,084054,Baghdadchi; Saharnaz,28,0,37,9
1650071154589,ECE 107,A01,083390,Staff,26,0,40,14
1650071160614,ECE 148,A01,084056,Silberman; Jack,8,0,12,4
1650071166640,ECE 180,A00,083391,Abi Samra; Nicholas Camill,25,0,30,5
1650071166640,ECE 180,B00,083392,Abi Samra; Nicholas Camill,21,0,30,9
1650071172663,MATH 10B,A01,084110,Staff,0,0,30,30
1650071172663,MATH 10B,A02,084111,Staff,17,0,30,13
1650071172663,MATH 10B,A03,084112,Staff,23,0,30,7
1650071178708,MATH 10C,A01,083443,Staff,0,17,30,31
1650071178708,MATH 10C,A02,083444,Staff,1,18,30,29
1650071178708,MATH 10C,B01,084114,Staff,17,0,30,13
1650071178708,MATH 10C,B02,084115,Staff,24,0,30,6
1650071184732,MATH 18,A01,084117,Harel; Guershon,11,0,30,19
1650071184732,MATH 18,A02,084119,Harel; Guershon,27,0,30,3
1650071184732,MATH 18,A03,084120,Harel; Guershon,30,0,30,0
1650071184732,MATH 18,A04,084121,Harel; Guershon,29,0,30,1
1650071190762,MATH 20B,A01,084124,Um; Ko Woon,10,0,35,25
1650071190762,MATH 20B,B01,084126,Um; Ko Woon,24,0,35,11
1650071196789,MATH 20C,A01,083446,Hammock; Frances H,0,0,30,30
1650071196789,MATH 20C,A02,083447,Hammock; Frances H,13,0,30,17
1650071196789,MATH 20C,A03,083448,Hammock; Frances H,19,0,30,11
1650071196789,MATH 20C,A04,083449,Hammock; Frances H,20,0,30,10
1650071196789,MATH 20C,B01,083451,Hammock; Frances H,0,0,30,30
1650071196789,MATH 20C,B02,083452,Hammock; Frances H,15,0,30,15
1650071196789,MATH 20C,B03,083453,Hammock; Frances H,19,0,30,11
1650071196789,MATH 20C,B04,083454,Hammock; Frances H,23,0,30,7
1650071202821,MATH 20D,A01,084128,Staff,14,0,30,16
1650071202821,MATH 20D,A02,084129,Staff,29,0,30,1
1650071202821,MATH 20D,A03,084130,Staff,27,0,30,3
1650071202821,MATH 20D,B01,084133,Staff,0,0,30,30
1650071202821,MATH 20D,B02,084134,Staff,23,0,30,7
1650071202821,MATH 20D,B03,084135,Staff,28,0,30,2
1650071208846,MATH 20E,A01,084138,Staff,12,0,30,18
1650071208846,MATH 20E,A02,084139,Staff,6,0,30,24
1650071208846,MATH 20E,A03,084140,Staff,14,0,30,16
1650071208846,MATH 20E,A04,084141,Staff,19,0,30,11
1650071214876,MATH 102,A01,084143,Harel; Guershon,11,0,30,19
1650071214876,MATH 102,A02,084144,Harel; Guershon,19,0,30,11
1650071220909,MATH 103B,A01,083456,Staff,0,13,30,30
1650071220909,MATH 103B,A02,083457,Staff,0,14,30,30
1650071226933,MATH 109,A01,084146,Salehi Golsefidy; Alireza,16,0,30,14
1650071226933,MATH 109,A02,084147,Salehi Golsefidy; Alireza,15,0,30,15
1650071232960,MATH 120A,A01,085445,Eggers; John Dietrich,7,0,35,28
1650071232960,MATH 120A,A02,085446,Eggers; John Dietrich,26,0,35,9
1650071238987,MATH 142B,A01,084149,Verstraete; Jacques Allan,0,12,30,30
1650071238987,MATH 142B,A02,084150,Verstraete; Jacques Allan,0,12,30,30
1650071245012,MATH 170A,A01,083459,Nie; Jiawang,0,11,30,30
1650071245012,MATH 170A,A02,083460,Nie; Jiawang,0,10,30,30
1650071245012,MATH 170A,A03,083461,Nie; Jiawang,0,11,30,30
1650071251034,MATH 193B,A01,083463,Staff,1,0,30,29
1650071251034,MATH 193B,A02,083464,Staff,8,0,30,22
1650071251034,MATH 193B,A03,083465,Staff,16,0,30,14
1650071257086,COGS 2,A01,083966,Boyle; Mary E. T.,10,0,30,20
1650071263110,COGS 9,A01,083968,Staff,4,0,60,56
1650071269133,COGS 14B,A01,083970,Staff,9,0,50,41
1650071275160,COGS 17,A01,092679,Staff,49,0,75,26
1650071281187,COGS 100,A01,083972,Staff,0,19,60,60
1650071293239,COGS 101C,A01,083976,Staff,12,0,30,18
1650071299261,COGS 102A,A01,083978,Johnson; Christine M.,12,0,30,18
1650071305287,COGS 107B,A01,083980,Staff,0,8,50,50
1650071311314,COGS 115,A01,083982,Staff,10,0,30,20
1650071317349,COGS 118B,A01,083367,Staff,0,15,40,40
1650071323376,COGS 172,A01,083984,Provenzano; Emily Kara,15,0,30,15
1650071329398,COGS 177,A00,083368,Staff,0,21,30,30
1650071335426,COGS 186,A01,083986,Staff,21,0,40,19
1650071341453,COGS 187A,A01,083988,Boyle; Mary E. T.,19,0,60,41
1650071347481,CSE 8A,A50,084003,Miranda; Gregory Joseph,0,18,15,15
1650071353506,CSE 11,A01,084005,Miranda; Gregory Joseph,1,24,55,54
1650071359534,CSE 20,A01,084007,Staff,0,5,20,20
1650071365558,CSE 21,A01,084009,Staff,1,33,50,49
1650071371584,CSE 30,A01,083370,Cao; Yingjun,0,63,40,40
1650071377613,CSE 100,A01,083372,Cao; Yingjun,0,47,40,40
1650071383640,CSE 101,A01,084011,Staff,0,56,40,40
1650071389663,CSE 141,A01,083374,Eldon; John,0,68,75,75
1650071395687,CSE 141L,A01,083376,Eldon; John,0,74,75,75
1650071401727,CSE 175,A01,084013,Kumar; Rakesh,22,0,25,3
1650071407751,CSE 190,A00,092508,Dubnov; Shlomo,18,0,20,2
1650071413775,ECE 5,A01,084049,Morris; Karcher William,12,0,20,8
1650071419798,ECE 100,A01,084051,Baghdadchi; Saharnaz,0,0,20,20
1650071419798,ECE 100,A02,091916,Baghdadchi; Saharnaz,12,0,20,8
1650071425821,ECE 101,A01,084053,Baghdadchi; Saharnaz,0,0,37,37
1650071425821,ECE 101,A02,084054,Baghdadchi; Saharnaz,28,0,37,9
1650071431864,ECE 107,A01,083390,Staff,26,0,40,14
1650071437889,ECE 148,A01,084056,Silberman; Jack,8,0,12,4
1650071443913,ECE 180,A00,083391,Abi Samra; Nicholas Camill,25,0,30,5
1650071443913,ECE 180,B00,083392,Abi Samra; Nicholas Camill,21,0,30,9
1650071449941,MATH 10B,A01,084110,Staff,0,0,30,30
1650071449941,MATH 10B,A02,084111,Staff,17,0,30,13
1650071449941,MATH 10B,A03,084112,Staff,23,0,30,7
1650071455969,MATH 10C,A01,083443,Staff,0,17,30,31
1650071455969,MATH 10C,A02,083444,Staff,1,18,30,29
1650071455969,MATH 10C,B01,084114,Staff,17,0,30,13
1650071455969,MATH 10C,B02,084115,Staff,24,0,30,6
1650071461994,MATH 18,A01,084117,Harel; Guershon,11,0,30,19
1650071461994,MATH 18,A02,084119,Harel; Guershon,27,0,30,3
1650071461994,MATH 18,A03,084120,Harel; Guershon,30,0,30,0
1650071461994,MATH 18,A04,084121,Harel; Guershon,29,0,30,1
1650071468023,MATH 20B,A01,084124,Um; Ko Woon,10,0,35,25
1650071468023,MATH 20B,B01,084126,Um; Ko Woon,24,0,35,11
1650071474052,MATH 20C,A01,083446,Hammock; Frances H,0,0,30,30
1650071474052,MATH 20C,A02,083447,Hammock; Frances H,13,0,30,17
1650071474052,MATH 20C,A03,083448,Hammock; Frances H,19,0,30,11
1650071474052,MATH 20C,A04,083449,Hammock; Frances H,20,0,30,10
1650071474052,MATH 20C,B01,083451,Hammock; Frances H,0,0,30,30
1650071474052,MATH 20C,B02,083452,Hammock; Frances H,15,0,30,15
1650071474052,MATH 20C,B03,083453,Hammock; Frances H,19,0,30,11
1650071474052,MATH 20C,B04,083454,Hammock; Frances H,23,0,30,7
1650071480089,MATH 20D,A01,084128,Staff,14,0,30,16
1650071480089,MATH 20D,A02,084129,Staff,29,0,30,1
1650071480089,MATH 20D,A03,084130,Staff,27,0,30,3
1650071480089,MATH 20D,B01,084133,Staff,0,0,30,30
1650071480089,MATH 20D,B02,084134,Staff,23,0,30,7
1650071480089,MATH 20D,B03,084135,Staff,28,0,30,2
1650071486111,MATH 20E,A01,084138,Staff,12,0,30,18
1650071486111,MATH 20E,A02,084139,Staff,6,0,30,24
1650071486111,MATH 20E,A03,084140,Staff,14,0,30,16
1650071486111,MATH 20E,A04,084141,Staff,19,0,30,11
1650071492137,MATH 102,A01,084143,Harel; Guershon,11,0,30,19
1650071492137,MATH 102,A02,084144,Harel; Guershon,19,0,30,11
1650071498165,MATH 103B,A01,083456,Staff,0,13,30,30
1650071498165,MATH 103B,A02,083457,Staff,0,14,30,30
1650071504189,MATH 109,A01,084146,Salehi Golsefidy; Alireza,16,0,30,14
1650071504189,MATH 109,A02,084147,Salehi Golsefidy; Alireza,15,0,30,15
1650071510215,MATH 120A,A01,085445,Eggers; John Dietrich,7,0,35,28
1650071510215,MATH 120A,A02,085446,Eggers; John Dietrich,26,0,35,9
1650071516237,MATH 142B,A01,084149,Verstraete; Jacques Allan,0,12,30,30
1650071516237,MATH 142B,A02,084150,Verstraete; Jacques Allan,0,12,30,30
1650071522266,MATH 170A,A01,083459,Nie; Jiawang,0,11,30,30
1650071522266,MATH 170A,A02,083460,Nie; Jiawang,0,10,30,30
1650071522266,MATH 170A,A03,083461,Nie; Jiawang,0,11,30,30
1650071528291,MATH 193B,A01,083463,Staff,1,0,30,29
1650071528291,MATH 193B,A02,083464,Staff,8,0,30,22
1650071528291,MATH 193B,A03,083465,Staff,16,0,30,14
1650071534351,COGS 2,A01,083966,Boyle; Mary E. T.,10,0,30,20
1650071540378,COGS 9,A01,083968,Staff,4,0,60,56
1650071546413,COGS 14B,A01,083970,Staff,9,0,50,41
1650071552435,COGS 17,A01,092679,Staff,49,0,75,26
1650071558477,COGS 100,A01,083972,Staff,0,19,60,60
1650071570528,COGS 101C,A01,083976,Staff,12,0,30,18
1650071576556,COGS 102A,A01,083978,Johnson; Christine M.,12,0,30,18
1650071582579,COGS 107B,A01,083980,Staff,0,8,50,50
1650071588610,COGS 115,A01,083982,Staff,10,0,30,20
1650071594637,COGS 118B,A01,083367,Staff,0,15,40,40
1650071600661,COGS 172,A01,083984,Provenzano; Emily Kara,15,0,30,15
1650071606738,COGS 177,A00,083368,Staff,0,21,30,30
1650071612838,COGS 186,A01,083986,Staff,21,0,40,19
1650071618859,COGS 187A,A01,083988,Boyle; Mary E. T.,19,0,60,41
1650071624894,CSE 8A,A50,084003,Miranda; Gregory Joseph,0,18,15,15
1650071630929,CSE 11,A01,084005,Miranda; Gregory Joseph,1,24,55,54
1650071636960,CSE 20,A01,084007,Staff,0,5,20,20
1650071642984,CSE 21,A01,084009,Staff,1,33,50,49
1650071649007,CSE 30,A01,083370,Cao; Yingjun,0,63,40,40
1650071655029,CSE 100,A01,083372,Cao; Yingjun,0,47,40,40
1650071661055,CSE 101,A01,084011,Staff,0,56,40,40
1650071667079,CSE 141,A01,083374,Eldon; John,0,68,75,75
1650071673104,CSE 141L,A01,083376,Eldon; John,0,74,75,75
1650071679127,CSE 175,A01,084013,Kumar; Rakesh,22,0,25,3
1650071685152,CSE 190,A00,092508,Dubnov; Shlomo,18,0,20,2
1650071691174,ECE 5,A01,084049,Morris; Karcher William,12,0,20,8
1650071697198,ECE 100,A01,084051,Baghdadchi; Saharnaz,0,0,20,20
1650071697198,ECE 100,A02,091916,Baghdadchi; Saharnaz,12,0,20,8
1650071703225,ECE 101,A01,084053,Baghdadchi; Saharnaz,0,0,37,37
1650071703225,ECE 101,A02,084054,Baghdadchi; Saharnaz,28,0,37,9
1650071709266,ECE 107,A01,083390,Staff,26,0,40,14
1650071715290,ECE 148,A01,084056,Silberman; Jack,8,0,12,4
1650071721319,ECE 180,A00,083391,Abi Samra; Nicholas Camill,25,0,30,5
1650071721319,ECE 180,B00,083392,Abi Samra; Nicholas Camill,21,0,30,9
1650071727345,MATH 10B,A01,084110,Staff,0,0,30,30
1650071727345,MATH 10B,A02,084111,Staff,17,0,30,13
1650071727345,MATH 10B,A03,084112,Staff,23,0,30,7
1650071733372,MATH 10C,A01,083443,Staff,0,17,30,31
1650071733372,MATH 10C,A02,083444,Staff,1,18,30,29
1650071733372,MATH 10C,B01,084114,Staff,17,0,30,13
1650071733372,MATH 10C,B02,084115,Staff,24,0,30,6
1650071739395,MATH 18,A01,084117,Harel; Guershon,11,0,30,19
1650071739395,MATH 18,A02,084119,Harel; Guershon,27,0,30,3
1650071739395,MATH 18,A03,084120,Harel; Guershon,30,0,30,0
1650071739395,MATH 18,A04,084121,Harel; Guershon,29,0,30,1
1650071745420,MATH 20B,A01,084124,Um; Ko Woon,10,0,35,25
1650071745420,MATH 20B,B01,084126,Um; Ko Woon,24,0,35,11
1650071751451,MATH 20C,A01,083446,Hammock; Frances H,0,0,30,30
1650071751451,MATH 20C,A02,083447,Hammock; Frances H,13,0,30,17
1650071751451,MATH 20C,A03,083448,Hammock; Frances H,19,0,30,11
1650071751451,MATH 20C,A04,083449,Hammock; Frances H,20,0,30,10
1650071751451,MATH 20C,B01,083451,Hammock; Frances H,0,0,30,30
1650071751451,MATH 20C,B02,083452,Hammock; Frances H,15,0,30,15
1650071751451,MATH 20C,B03,083453,Hammock; Frances H,19,0,30,11
1650071751451,MATH 20C,B04,083454,Hammock; Frances H,23,0,30,7
1650071757483,MATH 20D,A01,084128,Staff,14,0,30,16
1650071757483,MATH 20D,A02,084129,Staff,29,0,30,1
1650071757483,MATH 20D,A03,084130,Staff,27,0,30,3
1650071757483,MATH 20D,B01,084133,Staff,0,0,30,30
1650071757483,MATH 20D,B02,084134,Staff,23,0,30,7
1650071757483,MATH 20D,B03,084135,Staff,28,0,30,2
1650071763515,MATH 20E,A01,084138,Staff,12,0,30,18
1650071763515,MATH 20E,A02,084139,Staff,6,0,30,24
1650071763515,MATH 20E,A03,084140,Staff,14,0,30,16
1650071763515,MATH 20E,A04,084141,Staff,19,0,30,11
1650071769537,MATH 102,A01,084143,Harel; Guershon,11,0,30,19
1650071769537,MATH 102,A02,084144,Harel; Guershon,19,0,30,11
1650071775559,MATH 103B,A01,083456,Staff,0,13,30,30
1650071775559,MATH 103B,A02,083457,Staff,0,14,30,30
1650071781588,MATH 109,A01,084146,Salehi Golsefidy; Alireza,16,0,30,14
1650071781588,MATH 109,A02,084147,Salehi Golsefidy; Alireza,15,0,30,15
1650071787616,MATH 120A,A01,085445,Eggers; John Dietrich,7,0,35,28
1650071787616,MATH 120A,A02,085446,Eggers; John Dietrich,26,0,35,9
1650071793642,MATH 142B,A01,084149,Verstraete; Jacques Allan,0,12,30,30
1650071793642,MATH 142B,A02,084150,Verstraete; Jacques Allan,0,12,30,30
1650071799665,MATH 170A,A01,083459,Nie; Jiawang,0,11,30,30
1650071799665,MATH 170A,A02,083460,Nie; Jiawang,0,10,30,30
1650071799665,MATH 170A,A03,083461,Nie; Jiawang,0,11,30,30
1650071805688,MATH 193B,A01,083463,Staff,1,0,30,29
1650071805688,MATH 193B,A02,083464,Staff,8,0,30,22
1650071805688,MATH 193B,A03,083465,Staff,16,0,30,14
1650071811738,COGS 2,A01,083966,Boyle; Mary E. T.,10,0,30,20
1650071817769,COGS 9,A01,083968,Staff,4,0,60,56
1650071823799,COGS 14B,A01,083970,Staff,9,0,50,41
1650071829820,COGS 17,A01,092679,Staff,49,0,75,26
1650071835855,COGS 100,A01,083972,Staff,0,19,60,60
1650071847923,COGS 101C,A01,083976,Staff,12,0,30,18
1650071853951,COGS 102A,A01,083978,Johnson; Christine M.,12,0,30,18
1650071859973,COGS 107B,A01,083980,Staff,0,8,50,50
1650071865996,COGS 115,A01,083982,Staff,10,0,30,20
1650071872023,COGS 118B,A01,083367,Staff,0,15,40,40
1650071878052,COGS 172,A01,083984,Provenzano; Emily Kara,15,0,30,15
1650071884077,COGS 177,A00,083368,Staff,0,21,30,30
1650071890107,COGS 186,A01,083986,Staff,21,0,40,19
1650071896132,COGS 187A,A01,083988,Boyle; Mary E. T.,19,0,60,41
1650071902165,CSE 8A,A50,084003,Miranda; Gregory Joseph,0,18,15,15
1650071908188,CSE 11,A01,084005,Miranda; Gregory Joseph,1,24,55,54
1650071914210,CSE 20,A01,084007,Staff,0,5,20,20
1650071920237,CSE 21,A01,084009,Staff,1,33,50,49
1650071926259,CSE 30,A01,083370,Cao; Yingjun,0,63,40,40
1650071932283,CSE 100,A01,083372,Cao; Yingjun,0,47,40,40
1650071938315,CSE 101,A01,084011,Staff,0,56,40,40
1650071944345,CSE 141,A01,083374,Eldon; John,0,68,75,75
1650071950372,CSE 141L,A01,083376,Eldon; John,0,74,75,75
1650071956395,CSE 175,A01,084013,Kumar; Rakesh,22,0,25,3
1650071962422,CSE 190,A00,092508,Dubnov; Shlomo,18,0,20,2
1650071968445,ECE 5,A01,084049,Morris; Karcher William,12,0,20,8
1650071974480,ECE 100,A01,084051,Baghdadchi; Saharnaz,0,0,20,20
1650071974480,ECE 100,A02,091916,Baghdadchi; Saharnaz,12,0,20,8
1650071980503,ECE 101,A01,084053,Baghdadchi; Saharnaz,0,0,37,37
1650071980503,ECE 101,A02,084054,Baghdadchi; Saharnaz,28,0,37,9
1650071986525,ECE 107,A01,083390,Staff,26,0,40,14
1650071992553,ECE 148,A01,084056,Silberman; Jack,8,0,12,4
1650071998580,ECE 180,A00,083391,Abi Samra; Nicholas Camill,25,0,30,5
1650071998580,ECE 180,B00,083392,Abi Samra; Nicholas Camill,21,0,30,9
1650072004602,MATH 10B,A01,084110,Staff,0,0,30,30
1650072004602,MATH 10B,A02,084111,Staff,17,0,30,13
1650072004602,MATH 10B,A03,084112,Staff,23,0,30,7
1650072010639,MATH 10C,A01,083443,Staff,0,17,30,31
1650072010639,MATH 10C,A02,083444,Staff,1,18,30,29
1650072010639,MATH 10C,B01,084114,Staff,17,0,30,13
1650072010639,MATH 10C,B02,084115,Staff,24,0,30,6
1650072016665,MATH 18,A01,084117,Harel; Guershon,11,0,30,19
1650072016665,MATH 18,A02,084119,Harel; Guershon,27,0,30,3
1650072016665,MATH 18,A03,084120,Harel; Guershon,30,0,30,0
1650072016665,MATH 18,A04,084121,Harel; Guershon,29,0,30,1
1650072022690,MATH 20B,A01,084124,Um; Ko Woon,10,0,35,25
1650072022690,MATH 20B,B01,084126,Um; Ko Woon,24,0,35,11
1650072028716,MATH 20C,A01,083446,Hammock; Frances H,0,0,30,30
1650072028716,MATH 20C,A02,083447,Hammock; Frances H,13,0,30,17
1650072028716,MATH 20C,A03,083448,Hammock; Frances H,19,0,30,11
1650072028716,MATH 20C,A04,083449,Hammock; Frances H,20,0,30,10
1650072028716,MATH 20C,B01,083451,Hammock; Frances H,0,0,30,30
1650072028716,MATH 20C,B02,083452,Hammock; Frances H,15,0,30,15
1650072028716,MATH 20C,B03,083453,Hammock; Frances H,19,0,30,11
1650072028716,MATH 20C,B04,083454,Hammock; Frances H,23,0,30,7
1650072034752,MATH 20D,A01,084128,Staff,14,0,30,16
1650072034752,MATH 20D,A02,084129,Staff,29,0,30,1
1650072034752,MATH 20D,A03,084130,Staff,27,0,30,3
1650072034752,MATH 20D,B01,084133,Staff,0,0,30,30
1650072034752,MATH 20D,B02,084134,Staff,23,0,30,7
1650072034752,MATH 20D,B03,084135,Staff,28,0,30,2
1650072040779,MATH 20E,A01,084138,Staff,12,0,30,18
1650072040779,MATH 20E,A02,084139,Staff,6,0,30,24
1650072040779,MATH 20E,A03,084140,Staff,14,0,30,16
1650072040779,MATH 20E,A04,084141,Staff,19,0,30,11
1650072046814,MATH 102,A01,084143,Harel; Guershon,11,0,30,19
1650072046814,MATH 102,A02,084144,Harel; Guershon,19,0,30,11
1650072052842,MATH 103B,A01,083456,Staff,0,13,30,30
1650072052842,MATH 103B,A02,083457,Staff,0,14,30,30
1650072058867,MATH 109,A01,084146,Salehi Golsefidy; Alireza,16,0,30,14
1650072058867,MATH 109,A02,084147,Salehi Golsefidy; Alireza,15,0,30,15
1650072064896,MATH 120A,A01,085445,Eggers; John Dietrich,7,0,35,28
1650072064896,MATH 120A,A02,085446,Eggers; John Dietrich,26,0,35,9
1650072070925,MATH 142B,A01,084149,Verstraete; Jacques Allan,0,12,30,30
1650072070925,MATH 142B,A02,084150,Verstraete; Jacques Allan,0,12,30,30
1650072076963,MATH 170A,A01,083459,Nie; Jiawang,0,11,30,30
1650072076963,MATH 170A,A02,083460,Nie; Jiawang,0,10,30,30
1650072076963,MATH 170A,A03,083461,Nie; Jiawang,0,11,30,30
1650072082988,MATH 193B,A01,083463,Staff,1,0,30,29
1650072082988,MATH 193B,A02,083464,Staff,8,0,30,22
1650072082988,MATH 193B,A03,083465,Staff,16,0,30,14
1650072089040,COGS 2,A01,083966,Boyle; Mary E. T.,10,0,30,20
1650072095066,COGS 9,A01,083968,Staff,4,0,60,56
1650072101090,COGS 14B,A01,083970,Staff,9,0,50,41
1650072107114,COGS 17,A01,092679,Staff,49,0,75,26
1650072113138,COGS 100,A01,083972,Staff,0,19,60,60
1650072125189,COGS 101C,A01,083976,Staff,12,0,30,18
1650072131221,COGS 102A,A01,083978,Johnson; Christine M.,12,0,30,18
1650072137245,COGS 107B,A01,083980,Staff,0,8,50,50
1650072143269,COGS 115,A01,083982,Staff,10,0,30,20
1650072149299,COGS 118B,A01,083367,Staff,0,15,40,40
1650072155333,COGS 172,A01,083984,Provenzano; Emily Kara,15,0,30,15
1650072161355,COGS 177,A00,083368,Staff,0,21,30,30
1650072167377,COGS 186,A01,083986,Staff,21,0,40,19
1650072173418,COGS 187A,A01,083988,Boyle; Mary E. T.,19,0,60,41
1650072179442,CSE 8A,A50,084003,Miranda; Gregory Joseph,0,18,15,15
1650072185469,CSE 11,A01,084005,Miranda; Gregory Joseph,1,24,55,54
1650072191496,CSE 20,A01,084007,Staff,0,5,20,20
1650072197523,CSE 21,A01,084009,Staff,1,33,50,49
1650072203551,CSE 30,A01,083370,Cao; Yingjun,0,63,40,40
1650072209652,CSE 100,A01,083372,Cao; Yingjun,0,47,40,40
1650072215676,CSE 101,A01,084011,Staff,0,56,40,40
1650072221709,CSE 141,A01,083374,Eldon; John,0,68,75,75
1650072227732,CSE 141L,A01,083376,Eldon; John,0,74,75,75
1650072233756,CSE 175,A01,084013,Kumar; Rakesh,22,0,25,3
1650072239782,CSE 190,A00,092508,Dubnov; Shlomo,18,0,20,2
1650072245805,ECE 5,A01,084049,Morris; Karcher William,12,0,20,8
1650072251835,ECE 100,A01,084051,Baghdadchi; Saharnaz,0,0,20,20
1650072251835,ECE 100,A02,091916,Baghdadchi; Saharnaz,12,0,20,8
1650072257877,ECE 101,A01,084053,Baghdadchi; Saharnaz,0,0,37,37
1650072257877,ECE 101,A02,084054,Baghdadchi; Saharnaz,28,0,37,9
1650072263903,ECE 107,A01,083390,Staff,26,0,40,14
1650072269928,ECE 148,A01,084056,Silberman; Jack,8,0,12,4
1650072275951,ECE 180,A00,083391,Abi Samra; Nicholas Camill,25,0,30,5
1650072275951,ECE 180,B00,083392,Abi Samra; Nicholas Camill,21,0,30,9
1650072281978,MATH 10B,A01,084110,Staff,0,0,30,30
1650072281978,MATH 10B,A02,084111,Staff,17,0,30,13
1650072281978,MATH 10B,A03,084112,Staff,23,0,30,7
1650072288003,MATH 10C,A01,083443,Staff,0,17,30,31
1650072288003,MATH 10C,A02,083444,Staff,1,18,30,29
1650072288003,MATH 10C,B01,084114,Staff,17,0,30,13
1650072288003,MATH 10C,B02,084115,Staff,24,0,30,6
1650072294031,MATH 18,A01,084117,Harel; Guershon,11,0,30,19
1650072294031,MATH 18,A02,084119,Harel; Guershon,27,0,30,3
1650072294031,MATH 18,A03,084120,Harel; Guershon,30,0,30,0
1650072294031,MATH 18,A04,084121,Harel; Guershon,29,0,30,1
1650072300059,MATH 20B,A01,084124,Um; Ko Woon,10,0,35,25
1650072300059,MATH 20B,B01,084126,Um; Ko Woon,24,0,35,11
1650072306094,MATH 20C,A01,083446,Hammock; Frances H,0,0,30,30
1650072306094,MATH 20C,A02,083447,Hammock; Frances H,13,0,30,17
1650072306094,MATH 20C,A03,083448,Hammock; Frances H,19,0,30,11
1650072306094,MATH 20C,A04,083449,Hammock; Frances H,20,0,30,10
1650072306094,MATH 20C,B01,083451,Hammock; Frances H,0,0,30,30
1650072306094,MATH 20C,B02,083452,Hammock; Frances H,15,0,30,15
1650072306094,MATH 20C,B03,083453,Hammock; Frances H,19,0,30,11
1650072306094,MATH 20C,B04,083454,Hammock; Frances H,23,0,30,7
1650072312118,MATH 20D,A01,084128,Staff,14,0,30,16
1650072312118,MATH 20D,A02,084129,Staff,29,0,30,1
1650072312118,MATH 20D,A03,084130,Staff,27,0,30,3
1650072312118,MATH 20D,B01,084133,Staff,0,0,30,30
1650072312118,MATH 20D,B02,084134,Staff,23,0,30,7
1650072312118,MATH 20D,B03,084135,Staff,28,0,30,2
1650072318140,MATH 20E,A01,084138,Staff,12,0,30,18
1650072318140,MATH 20E,A02,084139,Staff,6,0,30,24
1650072318140,MATH 20E,A03,084140,Staff,14,0,30,16
1650072318140,MATH 20E,A04,084141,Staff,19,0,30,11
1650072324166,MATH 102,A01,084143,Harel; Guershon,11,0,30,19
1650072324166,MATH 102,A02,084144,Harel; Guershon,19,0,30,11
1650072330201,MATH 103B,A01,083456,Staff,0,13,30,30
1650072330201,MATH 103B,A02,083457,Staff,0,14,30,30
1650072336225,MATH 109,A01,084146,Salehi Golsefidy; Alireza,16,0,30,14
1650072336225,MATH 109,A02,084147,Salehi Golsefidy; Alireza,15,0,30,15
1650072342248,MATH 120A,A01,085445,Eggers; John Dietrich,7,0,35,28
1650072342248,MATH 120A,A02,085446,Eggers; John Dietrich,26,0,35,9
1650072348272,MATH 142B,A01,084149,Verstraete; Jacques Allan,0,12,30,30
1650072348272,MATH 142B,A02,084150,Verstraete; Jacques Allan,0,12,30,30
1650072354300,MATH 170A,A01,083459,Nie; Jiawang,0,11,30,30
1650072354300,MATH 170A,A02,083460,Nie; Jiawang,0,10,30,30
1650072354300,MATH 170A,A03,083461,Nie; Jiawang,0,11,30,30
1650072360323,MATH 193B,A01,083463,Staff,1,0,30,29
1650072360323,MATH 193B,A02,083464,Staff,8,0,30,22
1650072360323,MATH 193B,A03,083465,Staff,16,0,30,14
1650072366380,COGS 2,A01,083966,Boyle; Mary E. T.,10,0,30,20
1650072372404,COGS 9,A01,083968,Staff,4,0,60,56
1650072378435,COGS 14B,A01,083970,Staff,9,0,50,41
1650072384458,COGS 17,A01,092679,Staff,49,0,75,26
1650072390482,COGS 100,A01,083972,Staff,0,19,60,60
1650072402531,COGS 101C,A01,083976,Staff,12,0,30,18
1650072408559,COGS 102A,A01,083978,Johnson; Christine M.,12,0,30,18
1650072414586,COGS 107B,A01,083980,Staff,0,8,50,50
1650072420622,COGS 115,A01,083982,Staff,10,0,30,20
1650072426650,COGS 118B,A01,083367,Staff,0,15,40,40
1650072432672,COGS 172,A01,083984,Provenzano; Emily Kara,15,0,30,15
1650072438695,COGS 177,A00,083368,Staff,0,21,30,30
1650072444719,COGS 186,A01,083986,Staff,21,0,40,19
1650072450742,COGS 187A,A01,083988,Boyle; Mary E. T.,19,0,60,41
1650072456766,CSE 8A,A50,084003,Miranda; Gregory Joseph,0,18,15,15
1650072462793,CSE 11,A01,084005,Miranda; Gregory Joseph,1,24,55,54
1650072468833,CSE 20,A01,084007,Staff,0,5,20,20
1650072474857,CSE 21,A01,084009,Staff,1,33,50,49
1650072480884,CSE 30,A01,083370,Cao; Yingjun,0,63,40,40
1650072486912,CSE 100,A01,083372,Cao; Yingjun,0,47,40,40
1650072492938,CSE 101,A01,084011,Staff,0,56,40,40
1650072498965,CSE 141,A01,083374,Eldon; John,0,68,75,75
1650072504992,CSE 141L,A01,083376,Eldon; John,0,74,75,75
1650072511020,CSE 175,A01,084013,Kumar; Rakesh,22,0,25,3
1650072517044,CSE 190,A00,092508,Dubnov; Shlomo,18,0,20,2
1650072523071,ECE 5,A01,084049,Morris; Karcher William,12,0,20,8
1650072529096,ECE 100,A01,084051,Baghdadchi; Saharnaz,0,0,20,20
1650072529096,ECE 100,A02,091916,Baghdadchi; Saharnaz,12,0,20,8
1650072535123,ECE 101,A01,084053,Baghdadchi; Saharnaz,0,0,37,37
1650072535123,ECE 101,A02,084054,Baghdadchi; Saharnaz,28,0,37,9
1650072541147,ECE 107,A01,083390,Staff,26,0,40,14
1650072547173,ECE 148,A01,084056,Silberman; Jack,8,0,12,4
1650072553200,ECE 180,A00,083391,Abi Samra; Nicholas Camill,25,0,30,5
1650072553200,ECE 180,B00,083392,Abi Samra; Nicholas Camill,21,0,30,9
1650072559222,MATH 10B,A01,084110,Staff,0,0,30,30
1650072559222,MATH 10B,A02,084111,Staff,17,0,30,13
1650072559222,MATH 10B,A03,084112,Staff,23,0,30,7
1650072565250,MATH 10C,A01,083443,Staff,0,17,30,31
1650072565250,MATH 10C,A02,083444,Staff,1,18,30,29
1650072565250,MATH 10C,B01,084114,Staff,17,0,30,13
1650072565250,MATH 10C,B02,084115,Staff,24,0,30,6
1650072571274,MATH 18,A01,084117,Harel; Guershon,11,0,30,19
1650072571274,MATH 18,A02,084119,Harel; Guershon,27,0,30,3
1650072571274,MATH 18,A03,084120,Harel; Guershon,30,0,30,0
1650072571274,MATH 18,A04,084121,Harel; Guershon,29,0,30,1
1650072577313,MATH 20B,A01,084124,Um; Ko Woon,10,0,35,25
1650072577313,MATH 20B,B01,084126,Um; Ko Woon,24,0,35,11
1650072583342,MATH 20C,A01,083446,Hammock; Frances H,0,0,30,30
1650072583342,MATH 20C,A02,083447,Hammock; Frances H,13,0,30,17
1650072583342,MATH 20C,A03,083448,Hammock; Frances H,19,0,30,11
1650072583342,MATH 20C,A04,083449,Hammock; Frances H,20,0,30,10
1650072583342,MATH 20C,B01,083451,Hammock; Frances H,0,0,30,30
1650072583342,MATH 20C,B02,083452,Hammock; Frances H,15,0,30,15
1650072583342,MATH 20C,B03,083453,Hammock; Frances H,19,0,30,11
1650072583342,MATH 20C,B04,083454,Hammock; Frances H,23,0,30,7
1650072589366,MATH 20D,A01,084128,Staff,14,0,30,16
1650072589366,MATH 20D,A02,084129,Staff,29,0,30,1
1650072589366,MATH 20D,A03,084130,Staff,27,0,30,3
1650072589366,MATH 20D,B01,084133,Staff,0,0,30,30
1650072589366,MATH 20D,B02,084134,Staff,23,0,30,7
1650072589366,MATH 20D,B03,084135,Staff,28,0,30,2
1650072595390,MATH 20E,A01,084138,Staff,12,0,30,18
1650072595390,MATH 20E,A02,084139,Staff,6,0,30,24
1650072595390,MATH 20E,A03,084140,Staff,14,0,30,16
1650072595390,MATH 20E,A04,084141,Staff,19,0,30,11
1650072601412,MATH 102,A01,084143,Harel; Guershon,11,0,30,19
1650072601412,MATH 102,A02,084144,Harel; Guershon,19,0,30,11
1650072607438,MATH 103B,A01,083456,Staff,0,13,30,30
1650072607438,MATH 103B,A02,083457,Staff,0,14,30,30
1650072613465,MATH 109,A01,084146,Salehi Golsefidy; Alireza,16,0,30,14
1650072613465,MATH 109,A02,084147,Salehi Golsefidy; Alireza,15,0,30,15
1650072619490,MATH 120A,A01,085445,Eggers; John Dietrich,7,0,35,28
1650072619490,MATH 120A,A02,085446,Eggers; John Dietrich,26,0,35,9
1650072625513,MATH 142B,A01,084149,Verstraete; Jacques Allan,0,12,30,30
1650072625513,MATH 142B,A02,084150,Verstraete; Jacques Allan,0,12,30,30
1650072631543,MATH 170A,A01,083459,Nie; Jiawang,0,11,30,30
1650072631543,MATH 170A,A02,083460,Nie; Jiawang,0,10,30,30
1650072631543,MATH 170A,A03,083461,Nie; Jiawang,0,11,30,30
1650072637569,MATH 193B,A01,083463,Staff,1,0,30,29
1650072637569,MATH 193B,A02,083464,Staff,8,0,30,22
1650072637569,MATH 193B,A03,083465,Staff,16,0,30,14
1650072643625,COGS 2,A01,083966,Boyle; Mary E. T.,10,0,30,20
1650072649650,COGS 9,A01,083968,Staff,4,0,60,56
1650072655678,COGS 14B,A01,083970,Staff,9,0,50,41
1650072661702,COGS 17,A01,092679,Staff,49,0,75,26
1650072667727,COGS 100,A01,083972,Staff,0,19,60,60
1650072679773,COGS 101C,A01,083976,Staff,12,0,30,18
1650072685799,COGS 102A,A01,083978,Johnson; Christine M.,12,0,30,18
1650072691824,COGS 107B,A01,083980,Staff,0,8,50,50
1650072697849,COGS 115,A01,083982,Staff,10,0,30,20
1650072703876,COGS 118B,A01,083367,Staff,0,15,40,40
1650072709898,COGS 172,A01,083984,Provenzano; Emily Kara,15,0,30,15
1650072715922,COGS 177,A00,083368,Staff,0,21,30,30
1650072721953,COGS 186,A01,083986,Staff,21,0,40,19
1650072727980,COGS 187A,A01,083988,Boyle; Mary E. T.,19,0,60,41
1650072734003,CSE 8A,A50,084003,Miranda; Gregory Joseph,0,18,15,15
1650072740034,CSE 11,A01,084005,Miranda; Gregory Joseph,1,24,55,54
1650072746061,CSE 20,A01,084007,Staff,0,5,20,20
1650072752086,CSE 21,A01,084009,Staff,1,33,50,49
1650072758113,CSE 30,A01,083370,Cao; Yingjun,0,63,40,40
1650072764141,CSE 100,A01,083372,Cao; Yingjun,0,47,40,40
1650072770171,CSE 101,A01,084011,Staff,0,56,40,40
1650072776198,CSE 141,A01,083374,Eldon; John,0,68,75,75
1650072782230,CSE 141L,A01,083376,Eldon; John,0,74,75,75
1650072788252,CSE 175,A01,084013,Kumar; Rakesh,22,0,25,3
1650072794279,CSE 190,A00,092508,Dubnov; Shlomo,18,0,20,2
1650072800304,ECE 5,A01,084049,Morris; Karcher William,12,0,20,8
1650072806407,ECE 100,A01,084051,Baghdadchi; Saharnaz,0,0,20,20
1650072806407,ECE 100,A02,091916,Baghdadchi; Saharnaz,12,0,20,8
1650072812430,ECE 101,A01,084053,Baghdadchi; Saharnaz,0,0,37,37
1650072812430,ECE 101,A02,084054,Baghdadchi; Saharnaz,28,0,37,9
1650072818456,ECE 107,A01,083390,Staff,26,0,40,14
1650072824479,ECE 148,A01,084056,Silberman; Jack,8,0,12,4
1650072830507,ECE 180,A00,083391,Abi Samra; Nicholas Camill,25,0,30,5
1650072830507,ECE 180,B00,083392,Abi Samra; Nicholas Camill,21,0,30,9
1650072836534,MATH 10B,A01,084110,Staff,0,0,30,30
1650072836534,MATH 10B,A02,084111,Staff,17,0,30,13
1650072836534,MATH 10B,A03,084112,Staff,23,0,30,7
1650072842562,MATH 10C,A01,083443,Staff,0,17,30,31
1650072842562,MATH 10C,A02,083444,Staff,1,18,30,29
1650072842562,MATH 10C,B01,084114,Staff,17,0,30,13
1650072842562,MATH 10C,B02,084115,Staff,24,0,30,6
1650072848596,MATH 18,A01,084117,Harel; Guershon,11,0,30,19
1650072848596,MATH 18,A02,084119,Harel; Guershon,27,0,30,3
1650072848596,MATH 18,A03,084120,Harel; Guershon,30,0,30,0
1650072848596,MATH 18,A04,084121,Harel; Guershon,29,0,30,1
1650072854620,MATH 20B,A01,084124,Um; Ko Woon,10,0,35,25
1650072854620,MATH 20B,B01,084126,Um; Ko Woon,24,0,35,11
1650072860658,MATH 20C,A01,083446,Hammock; Frances H,0,0,30,30
1650072860658,MATH 20C,A02,083447,Hammock; Frances H,13,0,30,17
1650072860658,MATH 20C,A03,083448,Hammock; Frances H,19,0,30,11
1650072860658,MATH 20C,A04,083449,Hammock; Frances H,20,0,30,10
1650072860658,MATH 20C,B01,083451,Hammock; Frances H,0,0,30,30
1650072860658,MATH 20C,B02,083452,Hammock; Frances H,15,0,30,15
1650072860658,MATH 20C,B03,083453,Hammock; Frances H,19,0,30,11
1650072860658,MATH 20C,B04,083454,Hammock; Frances H,23,0,30,7
1650072866689,MATH 20D,A01,084128,Staff,14,0,30,16
1650072866689,MATH 20D,A02,084129,Staff,29,0,30,1
1650072866689,MATH 20D,A03,084130,Staff,27,0,30,3
1650072866689,MATH 20D,B01,084133,Staff,0,0,30,30
1650072866689,MATH 20D,B02,084134,Staff,23,0,30,7
1650072866689,MATH 20D,B03,084135,Staff,28,0,30,2
1650072872713,MATH 20E,A01,084138,Staff,12,0,30,18
1650072872713,MATH 20E,A02,084139,Staff,6,0,30,24
1650072872713,MATH 20E,A03,084140,Staff,14,0,30,16
1650072872713,MATH 20E,A04,084141,Staff,19,0,30,11
1650072878741,MATH 102,A01,084143,Harel; Guershon,11,0,30,19
1650072878741,MATH 102,A02,084144,Harel; Guershon,19,0,30,11
1650072884767,MATH 103B,A01,083456,Staff,0,13,30,30
1650072884767,MATH 103B,A02,083457,Staff,0,14,30,30
1650072890792,MATH 109,A01,084146,Salehi Golsefidy; Alireza,16,0,30,14
1650072890792,MATH 109,A02,084147,Salehi Golsefidy; Alireza,15,0,30,15
1650072896818,MATH 120A,A01,085445,Eggers; John Dietrich,7,0,35,28
1650072896818,MATH 120A,A02,085446,Eggers; John Dietrich,26,0,35,9
1650072902846,MATH 142B,A01,084149,Verstraete; Jacques Allan,0,12,30,30
1650072902846,MATH 142B,A02,084150,Verstraete; Jacques Allan,0,12,30,30
1650072908870,MATH 170A,A01,083459,Nie; Jiawang,0,11,30,30
1650072908870,MATH 170A,A02,083460,Nie; Jiawang,0,10,30,30
1650072908870,MATH 170A,A03,083461,Nie; Jiawang,0,11,30,30
1650072914894,MATH 193B,A01,083463,Staff,1,0,30,29
1650072914894,MATH 193B,A02,083464,Staff,8,0,30,22
1650072914894,MATH 193B,A03,083465,Staff,16,0,30,14
1650072920945,COGS 2,A01,083966,Boyle; Mary E. T.,10,0,30,20
1650072926968,COGS 9,A01,083968,Staff,4,0,60,56
1650072932995,COGS 14B,A01,083970,Staff,9,0,50,41
1650072939021,COGS 17,A01,092679,Staff,49,0,75,26
1650072945048,COGS 100,A01,083972,Staff,1,19,60,59
1650072957097,COGS 101C,A01,083976,Staff,12,0,30,18
1650072963123,COGS 102A,A01,083978,Johnson; Christine M.,12,0,30,18
1650072969148,COGS 107B,A01,083980,Staff,0,8,50,50
1650072975174,COGS 115,A01,083982,Staff,10,0,30,20
1650072981199,COGS 118B,A01,083367,Staff,0,15,40,40
1650072987223,COGS 172,A01,083984,Provenzano; Emily Kara,15,0,30,15
1650072993245,COGS 177,A00,083368,Staff,0,21,30,30
1650072999266,COGS 186,A01,083986,Staff,21,0,40,19
1650073005294,COGS 187A,A01,083988,Boyle; Mary E. T.,19,0,60,41
1650073011318,CSE 8A,A50,084003,Miranda; Gregory Joseph,0,18,15,15
1650073017349,CSE 11,A01,084005,Miranda; Gregory Joseph,1,24,55,54
1650073023385,CSE 20,A01,084007,Staff,0,5,20,20
1650073029408,CSE 21,A01,084009,Staff,1,33,50,49
1650073035433,CSE 30,A01,083370,Cao; Yingjun,0,63,40,40
1650073041460,CSE 100,A01,083372,Cao; Yingjun,0,47,40,40
1650073047483,CSE 101,A01,084011,Staff,0,56,40,40
1650073053507,CSE 141,A01,083374,Eldon; John,0,68,75,75
1650073059530,CSE 141L,A01,083376,Eldon; John,0,74,75,75
1650073065562,CSE 175,A01,084013,Kumar; Rakesh,22,0,25,3
1650073071586,CSE 190,A00,092508,Dubnov; Shlomo,18,0,20,2
1650073077612,ECE 5,A01,084049,Morris; Karcher William,12,0,20,8
1650073083644,ECE 100,A01,084051,Baghdadchi; Saharnaz,0,0,20,20
1650073083644,ECE 100,A02,091916,Baghdadchi; Saharnaz,12,0,20,8
1650073089668,ECE 101,A01,084053,Baghdadchi; Saharnaz,0,0,37,37
1650073089668,ECE 101,A02,084054,Baghdadchi; Saharnaz,27,0,37,10
1650073095693,ECE 107,A01,083390,Staff,26,0,40,14
1650073101717,ECE 148,A01,084056,Silberman; Jack,8,0,12,4
1650073107742,ECE 180,A00,083391,Abi Samra; Nicholas Camill,25,0,30,5
1650073107742,ECE 180,B00,083392,Abi Samra; Nicholas Camill,21,0,30,9
1650073113768,MATH 10B,A01,084110,Staff,0,0,30,30
1650073113768,MATH 10B,A02,084111,Staff,17,0,30,13
1650073113768,MATH 10B,A03,084112,Staff,23,0,30,7
1650073119797,MATH 10C,A01,083443,Staff,0,17,30,31
1650073119797,MATH 10C,A02,083444,Staff,1,18,30,29
1650073119797,MATH 10C,B01,084114,Staff,17,0,30,13
1650073119797,MATH 10C,B02,084115,Staff,24,0,30,6
1650073125819,MATH 18,A01,084117,Harel; Guershon,11,0,30,19
1650073125819,MATH 18,A02,084119,Harel; Guershon,27,0,30,3
1650073125819,MATH 18,A03,084120,Harel; Guershon,30,0,30,0
1650073125819,MATH 18,A04,084121,Harel; Guershon,29,0,30,1
1650073131843,MATH 20B,A01,084124,Um; Ko Woon,10,0,35,25
1650073131843,MATH 20B,B01,084126,Um; Ko Woon,24,0,35,11
1650073137874,MATH 20C,A01,083446,Hammock; Frances H,0,0,30,30
1650073137874,MATH 20C,A02,083447,Hammock; Frances H,13,0,30,17
1650073137874,MATH 20C,A03,083448,Hammock; Frances H,19,0,30,11
1650073137874,MATH 20C,A04,083449,Hammock; Frances H,20,0,30,10
1650073137874,MATH 20C,B01,083451,Hammock; Frances H,0,0,30,30
1650073137874,MATH 20C,B02,083452,Hammock; Frances H,15,0,30,15
1650073137874,MATH 20C,B03,083453,Hammock; Frances H,19,0,30,11
1650073137874,MATH 20C,B04,083454,Hammock; Frances H,23,0,30,7
1650073143899,MATH 20D,A01,084128,Staff,14,0,30,16
1650073143899,MATH 20D,A02,084129,Staff,29,0,30,1
1650073143899,MATH 20D,A03,084130,Staff,27,0,30,3
1650073143899,MATH 20D,B01,084133,Staff,0,0,30,30
1650073143899,MATH 20D,B02,084134,Staff,23,0,30,7
1650073143899,MATH 20D,B03,084135,Staff,28,0,30,2
1650073149923,MATH 20E,A01,084138,Staff,12,0,30,18
1650073149923,MATH 20E,A02,084139,Staff,6,0,30,24
1650073149923,MATH 20E,A03,084140,Staff,14,0,30,16
1650073149923,MATH 20E,A04,084141,Staff,19,0,30,11
1650073155946,MATH 102,A01,084143,Harel; Guershon,11,0,30,19
1650073155946,MATH 102,A02,084144,Harel; Guershon,19,0,30,11
1650073161973,MATH 103B,A01,083456,Staff,0,13,30,30
1650073161973,MATH 103B,A02,083457,Staff,0,14,30,30
1650073168001,MATH 109,A01,084146,Salehi Golsefidy; Alireza,16,0,30,14
1650073168001,MATH 109,A02,084147,Salehi Golsefidy; Alireza,15,0,30,15
1650073174025,MATH 120A,A01,085445,Eggers; John Dietrich,7,0,35,28
1650073174025,MATH 120A,A02,085446,Eggers; John Dietrich,26,0,35,9
1650073180048,MATH 142B,A01,084149,Verstraete; Jacques Allan,0,12,30,30
1650073180048,MATH 142B,A02,084150,Verstraete; Jacques Allan,0,12,30,30
1650073186080,MATH 170A,A01,083459,Nie; Jiawang,0,11,30,30
1650073186080,MATH 170A,A02,083460,Nie; Jiawang,0,10,30,30
1650073186080,MATH 170A,A03,083461,Nie; Jiawang,0,11,30,30
1650073192106,MATH 193B,A01,083463,Staff,1,0,30,29
1650073192106,MATH 193B,A02,083464,Staff,8,0,30,22
1650073192106,MATH 193B,A03,083465,Staff,16,0,30,14
1650073198170,COGS 2,A01,083966,Boyle; Mary E. T.,10,0,30,20
1650073204193,COGS 9,A01,083968,Staff,4,0,60,56
1650073210220,COGS 14B,A01,083970,Staff,9,0,50,41
1650073216243,COGS 17,A01,092679,Staff,49,0,75,26
1650073222275,COGS 100,A01,083972,Staff,1,19,60,59
1650073234323,COGS 101C,A01,083976,Staff,12,0,30,18
1650073240346,COGS 102A,A01,083978,Johnson; Christine M.,12,0,30,18
1650073246369,COGS 107B,A01,083980,Staff,0,8,50,50
1650073252394,COGS 115,A01,083982,Staff,10,0,30,20
1650073258424,COGS 118B,A01,083367,Staff,0,15,40,40
1650073264449,COGS 172,A01,083984,Provenzano; Emily Kara,15,0,30,15
1650073270472,COGS 177,A00,083368,Staff,0,21,30,30
1650073276497,COGS 186,A01,083986,Staff,21,0,40,19
1650073282523,COGS 187A,A01,083988,Boyle; Mary E. T.,19,0,60,41
1650073288548,CSE 8A,A50,084003,Miranda; Gregory Joseph,0,18,15,15
1650073294575,CSE 11,A01,084005,Miranda; Gregory Joseph,1,24,55,54
1650073300611,CSE 20,A01,084007,Staff,0,5,20,20
1650073306637,CSE 21,A01,084009,Staff,1,33,50,49
1650073312661,CSE 30,A01,083370,Cao; Yingjun,0,63,40,40
1650073318692,CSE 100,A01,083372,Cao; Yingjun,0,47,40,40
1650073324719,CSE 101,A01,084011,Staff,0,56,40,40
1650073330751,CSE 141,A01,083374,Eldon; John,0,68,75,75
1650073336776,CSE 141L,A01,083376,Eldon; John,0,74,75,75
1650073342802,CSE 175,A01,084013,Kumar; Rakesh,22,0,25,3
1650073348826,CSE 190,A00,092508,Dubnov; Shlomo,18,0,20,2
1650073354858,ECE 5,A01,084049,Morris; Karcher William,12,0,20,8
1650073360879,ECE 100,A01,084051,Baghdadchi; Saharnaz,0,0,20,20
1650073360879,ECE 100,A02,091916,Baghdadchi; Saharnaz,12,0,20,8
1650073366903,ECE 101,A01,084053,Baghdadchi; Saharnaz,0,0,37,37
1650073366903,ECE 101,A02,084054,Baghdadchi; Saharnaz,27,0,37,10
1650073372926,ECE 107,A01,083390,Staff,26,0,40,14
1650073378947,ECE 148,A01,084056,Silberman; Jack,8,0,12,4
1650073384974,ECE 180,A00,083391,Abi Samra; Nicholas Camill,25,0,30,5
1650073384974,ECE 180,B00,083392,Abi Samra; Nicholas Camill,21,0,30,9
1650073390996,MATH 10B,A01,084110,Staff,0,0,30,30
1650073390996,MATH 10B,A02,084111,Staff,17,0,30,13
1650073390996,MATH 10B,A03,084112,Staff,23,0,30,7
1650073397024,MATH 10C,A01,083443,Staff,0,17,30,31
1650073397024,MATH 10C,A02,083444,Staff,1,18,30,29
1650073397024,MATH 10C,B01,084114,Staff,17,0,30,13
1650073397024,MATH 10C,B02,084115,Staff,24,0,30,6
1650073403141,MATH 18,A01,084117,Harel; Guershon,11,0,30,19
1650073403141,MATH 18,A02,084119,Harel; Guershon,27,0,30,3
1650073403141,MATH 18,A03,084120,Harel; Guershon,30,0,30,0
1650073403141,MATH 18,A04,084121,Harel; Guershon,29,0,30,1
1650073409169,MATH 20B,A01,084124,Um; Ko Woon,10,0,35,25
1650073409169,MATH 20B,B01,084126,Um; Ko Woon,24,0,35,11
1650073415198,MATH 20C,A01,083446,Hammock; Frances H,0,0,30,30
1650073415198,MATH 20C,A02,083447,Hammock; Frances H,13,0,30,17
1650073415198,MATH 20C,A03,083448,Hammock; Frances H,19,0,30,11
1650073415198,MATH 20C,A04,083449,Hammock; Frances H,20,0,30,10
1650073415198,MATH 20C,B01,083451,Hammock; Frances H,0,0,30,30
1650073415198,MATH 20C,B02,083452,Hammock; Frances H,15,0,30,15
1650073415198,MATH 20C,B03,083453,Hammock; Frances H,19,0,30,11
1650073415198,MATH 20C,B04,083454,Hammock; Frances H,23,0,30,7
1650073421231,MATH 20D,A01,084128,Staff,14,0,30,16
1650073421231,MATH 20D,A02,084129,Staff,29,0,30,1
1650073421231,MATH 20D,A03,084130,Staff,27,0,30,3
1650073421231,MATH 20D,B01,084133,Staff,0,0,30,30
1650073421231,MATH 20D,B02,084134,Staff,23,0,30,7
1650073421231,MATH 20D,B03,084135,Staff,28,0,30,2
1650073427258,MATH 20E,A01,084138,Staff,12,0,30,18
1650073427258,MATH 20E,A02,084139,Staff,6,0,30,24
1650073427258,MATH 20E,A03,084140,Staff,14,0,30,16
1650073427258,MATH 20E,A04,084141,Staff,19,0,30,11
1650073433287,MATH 102,A01,084143,Harel; Guershon,11,0,30,19
1650073433287,MATH 102,A02,084144,Harel; Guershon,19,0,30,11
1650073439319,MATH 103B,A01,083456,Staff,0,13,30,30
1650073439319,MATH 103B,A02,083457,Staff,0,14,30,30
1650073445347,MATH 109,A01,084146,Salehi Golsefidy; Alireza,16,0,30,14
1650073445347,MATH 109,A02,084147,Salehi Golsefidy; Alireza,15,0,30,15
1650073451370,MATH 120A,A01,085445,Eggers; John Dietrich,7,0,35,28
1650073451370,MATH 120A,A02,085446,Eggers; John Dietrich,26,0,35,9
1650073457393,MATH 142B,A01,084149,Verstraete; Jacques Allan,0,12,30,30
1650073457393,MATH 142B,A02,084150,Verstraete; Jacques Allan,0,12,30,30
1650073463416,MATH 170A,A01,083459,Nie; Jiawang,0,11,30,30
1650073463416,MATH 170A,A02,083460,Nie; Jiawang,0,10,30,30
1650073463416,MATH 170A,A03,083461,Nie; Jiawang,0,11,30,30
1650073469439,MATH 193B,A01,083463,Staff,1,0,30,29
1650073469439,MATH 193B,A02,083464,Staff,8,0,30,22
1650073469439,MATH 193B,A03,083465,Staff,16,0,30,14
1650073475498,COGS 2,A01,083966,Boyle; Mary E. T.,10,0,30,20
1650073481521,COGS 9,A01,083968,Staff,4,0,60,56
1650073487544,COGS 14B,A01,083970,Staff,9,0,50,41
1650073493566,COGS 17,A01,092679,Staff,49,0,75,26
1650073499592,COGS 100,A01,083972,Staff,1,19,60,59
1650073511643,COGS 101C,A01,083976,Staff,12,0,30,18
1650073517668,COGS 102A,A01,083978,Johnson; Christine M.,12,0,30,18
1650073523694,COGS 107B,A01,083980,Staff,0,8,50,50
1650073529721,COGS 115,A01,083982,Staff,10,0,30,20
1650073535745,COGS 118B,A01,083367,Staff,0,15,40,40
1650073541772,COGS 172,A01,083984,Provenzano; Emily Kara,15,0,30,15
1650073547798,COGS 177,A00,083368,Staff,0,21,30,30
1650073553821,COGS 186,A01,083986,Staff,21,0,40,19
1650073559855,COGS 187A,A01,083988,Boyle; Mary E. T.,19,0,60,41
1650073565887,CSE 8A,A50,084003,Miranda; Gregory Joseph,0,18,15,15
1650073571910,CSE 11,A01,084005,Miranda; Gregory Joseph,1,24,55,54
1650073577958,CSE 20,A01,084007,Staff,0,5,20,20
1650073583992,CSE 21,A01,084009,Staff,1,33,50,49
1650073590014,CSE 30,A01,083370,Cao; Yingjun,0,63,40,40
1650073596040,CSE 100,A01,083372,Cao; Yingjun,0,47,40,40
1650073602061,CSE 101,A01,084011,Staff,0,56,40,40
1650073608087,CSE 141,A01,083374,Eldon; John,0,68,75,75
1650073614112,CSE 141L,A01,083376,Eldon; John,0,74,75,75
1650073620134,CSE 175,A01,084013,Kumar; Rakesh,22,0,25,3
1650073626157,CSE 190,A00,092508,Dubnov; Shlomo,18,0,20,2
1650073632179,ECE 5,A01,084049,Morris; Karcher William,12,0,20,8
1650073638211,ECE 100,A01,084051,Baghdadchi; Saharnaz,0,0,20,20
1650073638211,ECE 100,A02,091916,Baghdadchi; Saharnaz,12,0,20,8
1650073644248,ECE 101,A01,084053,Baghdadchi; Saharnaz,0,0,37,37
1650073644248,ECE 101,A02,084054,Baghdadchi; Saharnaz,27,0,37,10
1650073650275,ECE 107,A01,083390,Staff,26,0,40,14
1650073656301,ECE 148,A01,084056,Silberman; Jack,8,0,12,4
1650073662324,ECE 180,A00,083391,Abi Samra; Nicholas Camill,25,0,30,5
1650073662324,ECE 180,B00,083392,Abi Samra; Nicholas Camill,21,0,30,9
1650073668347,MATH 10B,A01,084110,Staff,0,0,30,30
1650073668347,MATH 10B,A02,084111,Staff,17,0,30,13
1650073668347,MATH 10B,A03,084112,Staff,23,0,30,7
1650073674373,MATH 10C,A01,083443,Staff,0,17,30,31
1650073674373,MATH 10C,A02,083444,Staff,1,18,30,29
1650073674373,MATH 10C,B01,084114,Staff,17,0,30,13
1650073674373,MATH 10C,B02,084115,Staff,24,0,30,6
1650073680400,MATH 18,A01,084117,Harel; Guershon,11,0,30,19
1650073680400,MATH 18,A02,084119,Harel; Guershon,27,0,30,3
1650073680400,MATH 18,A03,084120,Harel; Guershon,30,0,30,0
1650073680400,MATH 18,A04,084121,Harel; Guershon,29,0,30,1
1650073686434,MATH 20B,A01,084124,Um; Ko Woon,10,0,35,25
1650073686434,MATH 20B,B01,084126,Um; Ko Woon,24,0,35,11
1650073692457,MATH 20C,A01,083446,Hammock; Frances H,0,0,30,30
1650073692457,MATH 20C,A02,083447,Hammock; Frances H,13,0,30,17
1650073692457,MATH 20C,A03,083448,Hammock; Frances H,19,0,30,11
1650073692457,MATH 20C,A04,083449,Hammock; Frances H,20,0,30,10
1650073692457,MATH 20C,B01,083451,Hammock; Frances H,0,0,30,30
1650073692457,MATH 20C,B02,083452,Hammock; Frances H,15,0,30,15
1650073692457,MATH 20C,B03,083453,Hammock; Frances H,19,0,30,11
1650073692457,MATH 20C,B04,083454,Hammock; Frances H,23,0,30,7
1650073698484,MATH 20D,A01,084128,Staff,14,0,30,16
1650073698484,MATH 20D,A02,084129,Staff,29,0,30,1
1650073698484,MATH 20D,A03,084130,Staff,27,0,30,3
1650073698484,MATH 20D,B01,084133,Staff,0,0,30,30
1650073698484,MATH 20D,B02,084134,Staff,23,0,30,7
1650073698484,MATH 20D,B03,084135,Staff,28,0,30,2
1650073704511,MATH 20E,A01,084138,Staff,12,0,30,18
1650073704511,MATH 20E,A02,084139,Staff,6,0,30,24
1650073704511,MATH 20E,A03,084140,Staff,14,0,30,16
1650073704511,MATH 20E,A04,084141,Staff,19,0,30,11
1650073710538,MATH 102,A01,084143,Harel; Guershon,11,0,30,19
1650073710538,MATH 102,A02,084144,Harel; Guershon,19,0,30,11
1650073716563,MATH 103B,A01,083456,Staff,0,13,30,30
1650073716563,MATH 103B,A02,083457,Staff,0,14,30,30
1650073722589,MATH 109,A01,084146,Salehi Golsefidy; Alireza,16,0,30,14
1650073722589,MATH 109,A02,084147,Salehi Golsefidy; Alireza,15,0,30,15
1650073728617,MATH 120A,A01,085445,Eggers; John Dietrich,7,0,35,28
1650073728617,MATH 120A,A02,085446,Eggers; John Dietrich,26,0,35,9
1650073734646,MATH 142B,A01,084149,Verstraete; Jacques Allan,0,12,30,30
1650073734646,MATH 142B,A02,084150,Verstraete; Jacques Allan,0,12,30,30
1650073740670,MATH 170A,A01,083459,Nie; Jiawang,0,11,30,30
1650073740670,MATH 170A,A02,083460,Nie; Jiawang,0,10,30,30
1650073740670,MATH 170A,A03,083461,Nie; Jiawang,0,11,30,30
1650073746697,MATH 193B,A01,083463,Staff,1,0,30,29
1650073746697,MATH 193B,A02,083464,Staff,8,0,30,22
1650073746697,MATH 193B,A03,083465,Staff,16,0,30,14
1650073752749,COGS 2,A01,083966,Boyle; Mary E. T.,10,0,30,20
1650073758774,COGS 9,A01,083968,Staff,4,0,60,56
1650073764797,COGS 14B,A01,083970,Staff,8,0,50,42
1650073770831,COGS 17,A01,092679,Staff,49,0,75,26
1650073776856,COGS 100,A01,083972,Staff,1,19,60,59
1650073788908,COGS 101C,A01,083976,Staff,12,0,30,18
1650073794934,COGS 102A,A01,083978,Johnson; Christine M.,12,0,30,18
1650073800961,COGS 107B,A01,083980,Staff,0,8,50,50
1650073806983,COGS 115,A01,083982,Staff,10,0,30,20
1650073813016,COGS 118B,A01,083367,Staff,0,15,40,40
1650073819044,COGS 172,A01,083984,Provenzano; Emily Kara,15,0,30,15
1650073825072,COGS 177,A00,083368,Staff,0,21,30,30
1650073831095,COGS 186,A01,083986,Staff,21,0,40,19
1650073837119,COGS 187A,A01,083988,Boyle; Mary E. T.,19,0,60,41
1650073843147,CSE 8A,A50,084003,Miranda; Gregory Joseph,0,18,15,15
1650073849171,CSE 11,A01,084005,Miranda; Gregory Joseph,1,24,55,54
1650073855194,CSE 20,A01,084007,Staff,0,5,20,20
1650073861218,CSE 21,A01,084009,Staff,1,33,50,49
1650073867244,CSE 30,A01,083370,Cao; Yingjun,0,63,40,40
1650073873283,CSE 100,A01,083372,Cao; Yingjun,0,47,40,40
1650073879308,CSE 101,A01,084011,Staff,0,56,40,40
1650073885335,CSE 141,A01,083374,Eldon; John,0,68,75,75
1650073891363,CSE 141L,A01,083376,Eldon; John,0,74,75,75
1650073897386,CSE 175,A01,084013,Kumar; Rakesh,22,0,25,3
1650073903415,CSE 190,A00,092508,Dubnov; Shlomo,18,0,20,2
1650073909443,ECE 5,A01,084049,Morris; Karcher William,12,0,20,8
1650073915467,ECE 100,A01,084051,Baghdadchi; Saharnaz,0,0,20,20
1650073915467,ECE 100,A02,091916,Baghdadchi; Saharnaz,12,0,20,8
1650073921491,ECE 101,A01,084053,Baghdadchi; Saharnaz,0,0,37,37
1650073921491,ECE 101,A02,084054,Baghdadchi; Saharnaz,27,0,37,10
1650073927530,ECE 107,A01,083390,Staff,26,0,40,14
1650073933556,ECE 148,A01,084056,Silberman; Jack,8,0,12,4
1650073939580,ECE 180,A00,083391,Abi Samra; Nicholas Camill,25,0,30,5
1650073939580,ECE 180,B00,083392,Abi Samra; Nicholas Camill,21,0,30,9
1650073945603,MATH 10B,A01,084110,Staff,0,0,30,30
1650073945603,MATH 10B,A02,084111,Staff,17,0,30,13
1650073945603,MATH 10B,A03,084112,Staff,23,0,30,7
1650073951632,MATH 10C,A01,083443,Staff,0,17,30,31
1650073951632,MATH 10C,A02,083444,Staff,1,18,30,29
1650073951632,MATH 10C,B01,084114,Staff,17,0,30,13
1650073951632,MATH 10C,B02,084115,Staff,24,0,30,6
1650073957658,MATH 18,A01,084117,Harel; Guershon,11,0,30,19
1650073957658,MATH 18,A02,084119,Harel; Guershon,27,0,30,3
1650073957658,MATH 18,A03,084120,Harel; Guershon,30,0,30,0
1650073957658,MATH 18,A04,084121,Harel; Guershon,29,0,30,1
1650073963682,MATH 20B,A01,084124,Um; Ko Woon,10,0,35,25
1650073963682,MATH 20B,B01,084126,Um; Ko Woon,24,0,35,11
1650073969716,MATH 20C,A01,083446,Hammock; Frances H,0,0,30,30
1650073969716,MATH 20C,A02,083447,Hammock; Frances H,13,0,30,17
1650073969716,MATH 20C,A03,083448,Hammock; Frances H,19,0,30,11
1650073969716,MATH 20C,A04,083449,Hammock; Frances H,20,0,30,10
1650073969716,MATH 20C,B01,083451,Hammock; Frances H,0,0,30,30
1650073969716,MATH 20C,B02,083452,Hammock; Frances H,15,0,30,15
1650073969716,MATH 20C,B03,083453,Hammock; Frances H,19,0,30,11
1650073969716,MATH 20C,B04,083454,Hammock; Frances H,23,0,30,7
1650073975741,MATH 20D,A01,084128,Staff,14,0,30,16
1650073975741,MATH 20D,A02,084129,Staff,29,0,30,1
1650073975741,MATH 20D,A03,084130,Staff,27,0,30,3
1650073975741,MATH 20D,B01,084133,Staff,0,0,30,30
1650073975741,MATH 20D,B02,084134,Staff,23,0,30,7
1650073975741,MATH 20D,B03,084135,Staff,28,0,30,2
1650073981767,MATH 20E,A01,084138,Staff,12,0,30,18
1650073981767,MATH 20E,A02,084139,Staff,6,0,30,24
1650073981767,MATH 20E,A03,084140,Staff,14,0,30,16
1650073981767,MATH 20E,A04,084141,Staff,19,0,30,11
1650073987791,MATH 102,A01,084143,Harel; Guershon,11,0,30,19
1650073987791,MATH 102,A02,084144,Harel; Guershon,19,0,30,11
1650073993821,MATH 103B,A01,083456,Staff,0,13,30,30
1650073993821,MATH 103B,A02,083457,Staff,0,14,30,30
1650073999940,MATH 109,A01,084146,Salehi Golsefidy; Alireza,16,0,30,14
1650073999940,MATH 109,A02,084147,Salehi Golsefidy; Alireza,15,0,30,15
1650074005964,MATH 120A,A01,085445,Eggers; John Dietrich,7,0,35,28
1650074005964,MATH 120A,A02,085446,Eggers; John Dietrich,26,0,35,9
1650074011987,MATH 142B,A01,084149,Verstraete; Jacques Allan,0,12,30,30
1650074011987,MATH 142B,A02,084150,Verstraete; Jacques Allan,0,12,30,30
1650074018015,MATH 170A,A01,083459,Nie; Jiawang,0,11,30,30
1650074018015,MATH 170A,A02,083460,Nie; Jiawang,0,10,30,30
1650074018015,MATH 170A,A03,083461,Nie; Jiawang,0,11,30,30
1650074024039,MATH 193B,A01,083463,Staff,1,0,30,29
1650074024039,MATH 193B,A02,083464,Staff,8,0,30,22
1650074024039,MATH 193B,A03,083465,Staff,16,0,30,14
1650074030100,COGS 2,A01,083966,Boyle; Mary E. T.,10,0,30,20
1650074036124,COGS 9,A01,083968,Staff,4,0,60,56
1650074042151,COGS 14B,A01,083970,Staff,8,0,50,42
1650074048187,COGS 17,A01,092679,Staff,49,0,75,26
1650074054221,COGS 100,A01,083972,Staff,1,19,60,59
1650074066270,COGS 101C,A01,083976,Staff,12,0,30,18
1650074072296,COGS 102A,A01,083978,Johnson; Christine M.,12,0,30,18
1650074078323,COGS 107B,A01,083980,Staff,0,9,50,50
1650074084347,COGS 115,A01,083982,Staff,9,0,30,21
1650074090371,COGS 118B,A01,083367,Staff,0,15,40,40
1650074096398,COGS 172,A01,083984,Provenzano; Emily Kara,14,0,30,16
1650074102424,COGS 177,A00,083368,Staff,0,21,30,30
1650074108457,COGS 186,A01,083986,Staff,21,0,40,19
1650074114484,COGS 187A,A01,083988,Boyle; Mary E. T.,19,0,60,41
1650074120518,CSE 8A,A50,084003,Miranda; Gregory Joseph,0,18,15,15
1650074126545,CSE 11,A01,084005,Miranda; Gregory Joseph,1,24,55,54
1650074132573,CSE 20,A01,084007,Staff,0,5,20,20
1650074138596,CSE 21,A01,084009,Staff,1,33,50,49
1650074144621,CSE 30,A01,083370,Cao; Yingjun,0,63,40,40
1650074150658,CSE 100,A01,083372,Cao; Yingjun,0,47,40,40
1650074156691,CSE 101,A01,084011,Staff,0,56,40,40
1650074162715,CSE 141,A01,083374,Eldon; John,0,68,75,75
1650074168741,CSE 141L,A01,083376,Eldon; John,0,74,75,75
1650074174765,CSE 175,A01,084013,Kumar; Rakesh,22,0,25,3
1650074180789,CSE 190,A00,092508,Dubnov; Shlomo,18,0,20,2
1650074186813,ECE 5,A01,084049,Morris; Karcher William,12,0,20,8
1650074192835,ECE 100,A01,084051,Baghdadchi; Saharnaz,0,0,20,20
1650074192835,ECE 100,A02,091916,Baghdadchi; Saharnaz,12,0,20,8
1650074198859,ECE 101,A01,084053,Baghdadchi; Saharnaz,0,0,37,37
1650074198859,ECE 101,A02,084054,Baghdadchi; Saharnaz,27,0,37,10
1650074204892,ECE 107,A01,083390,Staff,26,0,40,14
1650074210916,ECE 148,A01,084056,Silberman; Jack,8,0,12,4
1650074216944,ECE 180,A00,083391,Abi Samra; Nicholas Camill,25,0,30,5
1650074216944,ECE 180,B00,083392,Abi Samra; Nicholas Camill,21,0,30,9
1650074222970,MATH 10B,A01,084110,Staff,0,0,30,30
1650074222970,MATH 10B,A02,084111,Staff,17,0,30,13
1650074222970,MATH 10B,A03,084112,Staff,23,0,30,7
1650074228995,MATH 10C,A01,083443,Staff,0,17,30,31
1650074228995,MATH 10C,A02,083444,Staff,1,18,30,29
1650074228995,MATH 10C,B01,084114,Staff,17,0,30,13
1650074228995,MATH 10C,B02,084115,Staff,24,0,30,6
1650074235018,MATH 18,A01,084117,Harel; Guershon,11,0,30,19
1650074235018,MATH 18,A02,084119,Harel; Guershon,27,0,30,3
1650074235018,MATH 18,A03,084120,Harel; Guershon,30,0,30,0
1650074235018,MATH 18,A04,084121,Harel; Guershon,29,0,30,1
1650074241042,MATH 20B,A01,084124,Um; Ko Woon,10,0,35,25
1650074241042,MATH 20B,B01,084126,Um; Ko Woon,24,0,35,11
1650074247066,MATH 20C,A01,083446,Hammock; Frances H,0,0,30,30
1650074247066,MATH 20C,A02,083447,Hammock; Frances H,13,0,30,17
1650074247066,MATH 20C,A03,083448,Hammock; Frances H,19,0,30,11
1650074247066,MATH 20C,A04,083449,Hammock; Frances H,20,0,30,10
1650074247066,MATH 20C,B01,083451,Hammock; Frances H,0,0,30,30
1650074247066,MATH 20C,B02,083452,Hammock; Frances H,15,0,30,15
1650074247066,MATH 20C,B03,083453,Hammock; Frances H,19,0,30,11
1650074247066,MATH 20C,B04,083454,Hammock; Frances H,23,0,30,7
1650074253091,MATH 20D,A01,084128,Staff,14,0,30,16
1650074253091,MATH 20D,A02,084129,Staff,29,0,30,1
1650074253091,MATH 20D,A03,084130,Staff,27,0,30,3
1650074253091,MATH 20D,B01,084133,Staff,0,0,30,30
1650074253091,MATH 20D,B02,084134,Staff,23,0,30,7
1650074253091,MATH 20D,B03,084135,Staff,28,0,30,2
1650074259115,MATH 20E,A01,084138,Staff,12,0,30,18
1650074259115,MATH 20E,A02,084139,Staff,6,0,30,24
1650074259115,MATH 20E,A03,084140,Staff,14,0,30,16
1650074259115,MATH 20E,A04,084141,Staff,19,0,30,11
1650074265138,MATH 102,A01,084143,Harel; Guershon,11,0,30,19
1650074265138,MATH 102,A02,084144,Harel; Guershon,19,0,30,11
1650074271165,MATH 103B,A01,083456,Staff,0,13,30,30
1650074271165,MATH 103B,A02,083457,Staff,0,14,30,30
1650074277188,MATH 109,A01,084146,Salehi Golsefidy; Alireza,16,0,30,14
1650074277188,MATH 109,A02,084147,Salehi Golsefidy; Alireza,15,0,30,15
1650074283210,MATH 120A,A01,085445,Eggers; John Dietrich,7,0,35,28
1650074283210,MATH 120A,A02,085446,Eggers; John Dietrich,26,0,35,9
1650074289232,MATH 142B,A01,084149,Verstraete; Jacques Allan,0,12,30,30
1650074289232,MATH 142B,A02,084150,Verstraete; Jacques Allan,0,12,30,30
1650074295259,MATH 170A,A01,083459,Nie; Jiawang,0,11,30,30
1650074295259,MATH 170A,A02,083460,Nie; Jiawang,0,10,30,30
1650074295259,MATH 170A,A03,083461,Nie; Jiawang,0,11,30,30
1650074301282,MATH 193B,A01,083463,Staff,1,0,30,29
1650074301282,MATH 193B,A02,083464,Staff,8,0,30,22
1650074301282,MATH 193B,A03,083465,Staff,16,0,30,14
1650074307336,COGS 2,A01,083966,Boyle; Mary E. T.,10,0,30,20
1650074313362,COGS 9,A01,083968,Staff,4,0,60,56
1650074319388,COGS 14B,A01,083970,Staff,8,0,50,42
1650074325413,COGS 17,A01,092679,Staff,49,0,75,26
1650074331442,COGS 100,A01,083972,Staff,1,19,60,59
1650074343498,COGS 101C,A01,083976,Staff,12,0,30,18
1650074349523,COGS 102A,A01,083978,Johnson; Christine M.,12,0,30,18
1650074355546,COGS 107B,A01,083980,Staff,0,9,50,50
1650074361570,COGS 115,A01,083982,Staff,9,0,30,21
1650074367593,COGS 118B,A01,083367,Staff,0,15,40,40
1650074373621,COGS 172,A01,083984,Provenzano; Emily Kara,14,0,30,16
1650074379648,COGS 177,A00,083368,Staff,0,21,30,30
1650074385673,COGS 186,A01,083986,Staff,21,0,40,19
1650074391696,COGS 187A,A01,083988,Boyle; Mary E. T.,19,0,60,41
1650074397722,CSE 8A,A50,084003,Miranda; Gregory Joseph,0,18,15,15
1650074403747,CSE 11,A01,084005,Miranda; Gregory Joseph,1,24,55,54
1650074409776,CSE 20,A01,084007,Staff,0,5,20,20
1650074415803,CSE 21,A01,084009,Staff,1,33,50,49
1650074421827,CSE 30,A01,083370,Cao; Yingjun,0,63,40,40
1650074427849,CSE 100,A01,083372,Cao; Yingjun,0,47,40,40
1650074433873,CSE 101,A01,084011,Staff,0,56,40,40
1650074439896,CSE 141,A01,083374,Eldon; John,0,68,75,75
1650074445920,CSE 141L,A01,083376,Eldon; John,0,74,75,75
1650074451959,CSE 175,A01,084013,Kumar; Rakesh,22,0,25,3
1650074457985,CSE 190,A00,092508,Dubnov; Shlomo,18,0,20,2
1650074464009,ECE 5,A01,084049,Morris; Karcher William,12,0,20,8
1650074470039,ECE 100,A01,084051,Baghdadchi; Saharnaz,0,0,20,20
1650074470039,ECE 100,A02,091916,Baghdadchi; Saharnaz,12,0,20,8
1650074476063,ECE 101,A01,084053,Baghdadchi; Saharnaz,0,0,37,37
1650074476063,ECE 101,A02,084054,Baghdadchi; Saharnaz,27,0,37,10
1650074482088,ECE 107,A01,083390,Staff,26,0,40,14
1650074488112,ECE 148,A01,084056,Silberman; Jack,8,0,12,4
1650074494142,ECE 180,A00,083391,Abi Samra; Nicholas Camill,25,0,30,5
1650074494142,ECE 180,B00,083392,Abi Samra; Nicholas Camill,21,0,30,9
1650074500169,MATH 10B,A01,084110,Staff,0,0,30,30
1650074500169,MATH 10B,A02,084111,Staff,17,0,30,13
1650074500169,MATH 10B,A03,084112,Staff,23,0,30,7
1650074506201,MATH 10C,A01,083443,Staff,0,17,30,31
1650074506201,MATH 10C,A02,083444,Staff,1,18,30,29
1650074506201,MATH 10C,B01,084114,Staff,17,0,30,13
1650074506201,MATH 10C,B02,084115,Staff,24,0,30,6
1650074512231,MATH 18,A01,084117,Harel; Guershon,11,0,30,19
1650074512231,MATH 18,A02,084119,Harel; Guershon,27,0,30,3
1650074512231,MATH 18,A03,084120,Harel; Guershon,30,0,30,0
1650074512231,MATH 18,A04,084121,Harel; Guershon,29,0,30,1
1650074518255,MATH 20B,A01,084124,Um; Ko Woon,10,0,35,25
1650074518255,MATH 20B,B01,084126,Um; Ko Woon,24,0,35,11
1650074524286,MATH 20C,A01,083446,Hammock; Frances H,0,0,30,30
1650074524286,MATH 20C,A02,083447,Hammock; Frances H,13,0,30,17
1650074524286,MATH 20C,A03,083448,Hammock; Frances H,19,0,30,11
1650074524286,MATH 20C,A04,083449,Hammock; Frances H,20,0,30,10
1650074524286,MATH 20C,B01,083451,Hammock; Frances H,0,0,30,30
1650074524286,MATH 20C,B02,083452,Hammock; Frances H,15,0,30,15
1650074524286,MATH 20C,B03,083453,Hammock; Frances H,19,0,30,11
1650074524286,MATH 20C,B04,083454,Hammock; Frances H,23,0,30,7
1650074530310,MATH 20D,A01,084128,Staff,14,0,30,16
1650074530310,MATH 20D,A02,084129,Staff,29,0,30,1
1650074530310,MATH 20D,A03,084130,Staff,27,0,30,3
1650074530310,MATH 20D,B01,084133,Staff,0,0,30,30
1650074530310,MATH 20D,B02,084134,Staff,23,0,30,7
1650074530310,MATH 20D,B03,084135,Staff,28,0,30,2
1650074536338,MATH 20E,A01,084138,Staff,12,0,30,18
1650074536338,MATH 20E,A02,084139,Staff,6,0,30,24
1650074536338,MATH 20E,A03,084140,Staff,14,0,30,16
1650074536338,MATH 20E,A04,084141,Staff,19,0,30,11
1650074542366,MATH 102,A01,084143,Harel; Guershon,11,0,30,19
1650074542366,MATH 102,A02,084144,Harel; Guershon,19,0,30,11
1650074548388,MATH 103B,A01,083456,Staff,0,13,30,30
1650074548388,MATH 103B,A02,083457,Staff,0,14,30,30
1650074554412,MATH 109,A01,084146,Salehi Golsefidy; Alireza,16,0,30,14
1650074554412,MATH 109,A02,084147,Salehi Golsefidy; Alireza,15,0,30,15
1650074560436,MATH 120A,A01,085445,Eggers; John Dietrich,7,0,35,28
1650074560436,MATH 120A,A02,085446,Eggers; John Dietrich,26,0,35,9
1650074566461,MATH 142B,A01,084149,Verstraete; Jacques Allan,0,12,30,30
1650074566461,MATH 142B,A02,084150,Verstraete; Jacques Allan,0,12,30,30
1650074572489,MATH 170A,A01,083459,Nie; Jiawang,0,11,30,30
1650074572489,MATH 170A,A02,083460,Nie; Jiawang,0,10,30,30
1650074572489,MATH 170A,A03,083461,Nie; Jiawang,0,11,30,30
1650074578513,MATH 193B,A01,083463,Staff,1,0,30,29
1650074578513,MATH 193B,A02,083464,Staff,8,0,30,22
1650074578513,MATH 193B,A03,083465,Staff,16,0,30,14
1650074584565,COGS 2,A01,083966,Boyle; Mary E. T.,10,0,30,20
1650074590680,COGS 9,A01,083968,Staff,4,0,60,56
1650074596707,COGS 14B,A01,083970,Staff,8,0,50,42
1650074602734,COGS 17,A01,092679,Staff,49,0,75,26
1650074608757,COGS 100,A01,083972,Staff,1,19,60,59
1650074620809,COGS 101C,A01,083976,Staff,12,0,30,18
1650074626836,COGS 102A,A01,083978,Johnson; Christine M.,12,0,30,18
1650074632872,COGS 107B,A01,083980,Staff,0,9,50,50
1650074638897,COGS 115,A01,083982,Staff,9,0,30,21
1650074644921,COGS 118B,A01,083367,Staff,0,15,40,40
1650074650951,COGS 172,A01,083984,Provenzano; Emily Kara,14,0,30,16
1650074656979,COGS 177,A00,083368,Staff,0,21,30,30
1650074663012,COGS 186,A01,083986,Staff,21,0,40,19
1650074669039,COGS 187A,A01,083988,Boyle; Mary E. T.,19,0,60,41
1650074675062,CSE 8A,A50,084003,Miranda; Gregory Joseph,0,18,15,15
1650074681085,CSE 11,A01,084005,Miranda; Gregory Joseph,1,24,55,54
1650074687114,CSE 20,A01,084007,Staff,0,5,20,20
1650074693137,CSE 21,A01,084009,Staff,1,33,50,49
1650074699160,CSE 30,A01,083370,Cao; Yingjun,0,63,40,40
1650074705184,CSE 100,A01,083372,Cao; Yingjun,0,47,40,40
1650074711221,CSE 101,A01,084011,Staff,0,56,40,40
1650074717248,CSE 141,A01,083374,Eldon; John,0,68,75,75
1650074723282,CSE 141L,A01,083376,Eldon; John,0,74,75,75
1650074729306,CSE 175,A01,084013,Kumar; Rakesh,22,0,25,3
1650074735334,CSE 190,A00,092508,Dubnov; Shlomo,18,0,20,2
1650074741360,ECE 5,A01,084049,Morris; Karcher William,12,0,20,8
1650074747384,ECE 100,A01,084051,Baghdadchi; Saharnaz,0,0,20,20
1650074747384,ECE 100,A02,091916,Baghdadchi; Saharnaz,12,0,20,8
1650074753412,ECE 101,A01,084053,Baghdadchi; Saharnaz,0,0,37,37
1650074753412,ECE 101,A02,084054,Baghdadchi; Saharnaz,27,0,37,10
1650074759437,ECE 107,A01,083390,Staff,26,0,40,14
1650074765460,ECE 148,A01,084056,Silberman; Jack,8,0,12,4
1650074771485,ECE 180,A00,083391,Abi Samra; Nicholas Camill,25,0,30,5
1650074771485,ECE 180,B00,083392,Abi Samra; Nicholas Camill,21,0,30,9
1650074777516,MATH 10B,A01,084110,Staff,0,0,30,30
1650074777516,MATH 10B,A02,084111,Staff,17,0,30,13
1650074777516,MATH 10B,A03,084112,Staff,23,0,30,7
1650074783550,MATH 10C,A01,083443,Staff,0,17,30,31
1650074783550,MATH 10C,A02,083444,Staff,1,18,30,29
1650074783550,MATH 10C,B01,084114,Staff,17,0,30,13
1650074783550,MATH 10C,B02,084115,Staff,24,0,30,6
1650074789577,MATH 18,A01,084117,Harel; Guershon,11,0,30,19
1650074789577,MATH 18,A02,084119,Harel; Guershon,27,0,30,3
1650074789577,MATH 18,A03,084120,Harel; Guershon,30,0,30,0
1650074789577,MATH 18,A04,084121,Harel; Guershon,29,0,30,1
1650074795606,MATH 20B,A01,084124,Um; Ko Woon,10,0,35,25
1650074795606,MATH 20B,B01,084126,Um; Ko Woon,24,0,35,11
1650074801632,MATH 20C,A01,083446,Hammock; Frances H,0,0,30,30
1650074801632,MATH 20C,A02,083447,Hammock; Frances H,13,0,30,17
1650074801632,MATH 20C,A03,083448,Hammock; Frances H,19,0,30,11
1650074801632,MATH 20C,A04,083449,Hammock; Frances H,20,0,30,10
1650074801632,MATH 20C,B01,083451,Hammock; Frances H,0,0,30,30
1650074801632,MATH 20C,B02,083452,Hammock; Frances H,15,0,30,15
1650074801632,MATH 20C,B03,083453,Hammock; Frances H,19,0,30,11
1650074801632,MATH 20C,B04,083454,Hammock; Frances H,23,0,30,7
1650074807661,MATH 20D,A01,084128,Staff,14,0,30,16
1650074807661,MATH 20D,A02,084129,Staff,29,0,30,1
1650074807661,MATH 20D,A03,084130,Staff,27,0,30,3
1650074807661,MATH 20D,B01,084133,Staff,0,0,30,30
1650074807661,MATH 20D,B02,084134,Staff,23,0,30,7
1650074807661,MATH 20D,B03,084135,Staff,28,0,30,2
1650074813684,MATH 20E,A01,084138,Staff,12,0,30,18
1650074813684,MATH 20E,A02,084139,Staff,6,0,30,24
1650074813684,MATH 20E,A03,084140,Staff,14,0,30,16
1650074813684,MATH 20E,A04,084141,Staff,19,0,30,11
1650074819711,MATH 102,A01,084143,Harel; Guershon,11,0,30,19
1650074819711,MATH 102,A02,084144,Harel; Guershon,19,0,30,11
1650074825735,MATH 103B,A01,083456,Staff,0,13,30,30
1650074825735,MATH 103B,A02,083457,Staff,0,14,30,30
1650074831759,MATH 109,A01,084146,Salehi Golsefidy; Alireza,16,0,30,14
1650074831759,MATH 109,A02,084147,Salehi Golsefidy; Alireza,15,0,30,15
1650074837781,MATH 120A,A01,085445,Eggers; John Dietrich,7,0,35,28
1650074837781,MATH 120A,A02,085446,Eggers; John Dietrich,26,0,35,9
1650074843808,MATH 142B,A01,084149,Verstraete; Jacques Allan,0,12,30,30
1650074843808,MATH 142B,A02,084150,Verstraete; Jacques Allan,0,12,30,30
1650074849833,MATH 170A,A01,083459,Nie; Jiawang,0,11,30,30
1650074849833,MATH 170A,A02,083460,Nie; Jiawang,0,10,30,30
1650074849833,MATH 170A,A03,083461,Nie; Jiawang,0,11,30,30
1650074855856,MATH 193B,A01,083463,Staff,1,0,30,29
1650074855856,MATH 193B,A02,083464,Staff,8,0,30,22
1650074855856,MATH 193B,A03,083465,Staff,16,0,30,14
1650074861911,COGS 2,A01,083966,Boyle; Mary E. T.,10,0,30,20
1650074867946,COGS 9,A01,083968,Staff,4,0,60,56
1650074873971,COGS 14B,A01,083970,Staff,8,0,50,42
1650074879996,COGS 17,A01,092679,Staff,49,0,75,26
1650074886019,COGS 100,A01,083972,Staff,1,19,60,59
1650074898071,COGS 101C,A01,083976,Staff,12,0,30,18
1650074904093,COGS 102A,A01,083978,Johnson; Christine M.,12,0,30,18
1650074910116,COGS 107B,A01,083980,Staff,0,9,50,50
1650074916140,COGS 115,A01,083982,Staff,9,0,30,21
1650074922163,COGS 118B,A01,083367,Staff,0,15,40,40
1650074928190,COGS 172,A01,083984,Provenzano; Emily Kara,14,0,30,16
1650074934217,COGS 177,A00,083368,Staff,0,21,30,30
1650074940241,COGS 186,A01,083986,Staff,21,0,40,19
1650074946269,COGS 187A,A01,083988,Boyle; Mary E. T.,19,0,60,41
1650074952297,CSE 8A,A50,084003,Miranda; Gregory Joseph,0,18,15,15
1650074958321,CSE 11,A01,084005,Miranda; Gregory Joseph,1,24,55,54
1650074964351,CSE 20,A01,084007,Staff,0,5,20,20
1650074970376,CSE 21,A01,084009,Staff,1,33,50,49
1650074976402,CSE 30,A01,083370,Cao; Yingjun,0,63,40,40
1650074982430,CSE 100,A01,083372,Cao; Yingjun,0,47,40,40
1650074988453,CSE 101,A01,084011,Staff,0,56,40,40
1650074994478,CSE 141,A01,083374,Eldon; John,0,68,75,75
1650075000516,CSE 141L,A01,083376,Eldon; John,0,74,75,75
1650075006540,CSE 175,A01,084013,Kumar; Rakesh,22,0,25,3
1650075012568,CSE 190,A00,092508,Dubnov; Shlomo,18,0,20,2
1650075018592,ECE 5,A01,084049,Morris; Karcher William,12,0,20,8
1650075024627,ECE 100,A01,084051,Baghdadchi; Saharnaz,0,0,20,20
1650075024627,ECE 100,A02,091916,Baghdadchi; Saharnaz,12,0,20,8
1650075030657,ECE 101,A01,084053,Baghdadchi; Saharnaz,0,0,37,37
1650075030657,ECE 101,A02,084054,Baghdadchi; Saharnaz,27,0,37,10
1650075036681,ECE 107,A01,083390,Staff,26,0,40,14
1650075042705,ECE 148,A01,084056,Silberman; Jack,8,0,12,4
1650075048733,ECE 180,A00,083391,Abi Samra; Nicholas Camill,25,0,30,5
1650075048733,ECE 180,B00,083392,Abi Samra; Nicholas Camill,21,0,30,9
1650075054757,MATH 10B,A01,084110,Staff,0,0,30,30
1650075054757,MATH 10B,A02,084111,Staff,17,0,30,13
1650075054757,MATH 10B,A03,084112,Staff,23,0,30,7
1650075060784,MATH 10C,A01,083443,Staff,0,17,30,31
1650075060784,MATH 10C,A02,083444,Staff,1,18,30,29
1650075060784,MATH 10C,B01,084114,Staff,17,0,30,13
1650075060784,MATH 10C,B02,084115,Staff,24,0,30,6
1650075066809,MATH 18,A01,084117,Harel; Guershon,11,0,30,19
1650075066809,MATH 18,A02,084119,Harel; Guershon,27,0,30,3
1650075066809,MATH 18,A03,084120,Harel; Guershon,30,0,30,0
1650075066809,MATH 18,A04,084121,Harel; Guershon,29,0,30,1
1650075072834,MATH 20B,A01,084124,Um; Ko Woon,10,0,35,25
1650075072834,MATH 20B,B01,084126,Um; Ko Woon,24,0,35,11
1650075078860,MATH 20C,A01,083446,Hammock; Frances H,0,0,30,30
1650075078860,MATH 20C,A02,083447,Hammock; Frances H,13,0,30,17
1650075078860,MATH 20C,A03,083448,Hammock; Frances H,19,0,30,11
1650075078860,MATH 20C,A04,083449,Hammock; Frances H,20,0,30,10
1650075078860,MATH 20C,B01,083451,Hammock; Frances H,0,0,30,30
1650075078860,MATH 20C,B02,083452,Hammock; Frances H,15,0,30,15
1650075078860,MATH 20C,B03,083453,Hammock; Frances H,19,0,30,11
1650075078860,MATH 20C,B04,083454,Hammock; Frances H,23,0,30,7
1650075084888,MATH 20D,A01,084128,Staff,14,0,30,16
1650075084888,MATH 20D,A02,084129,Staff,29,0,30,1
1650075084888,MATH 20D,A03,084130,Staff,27,0,30,3
1650075084888,MATH 20D,B01,084133,Staff,0,0,30,30
1650075084888,MATH 20D,B02,084134,Staff,23,0,30,7
1650075084888,MATH 20D,B03,084135,Staff,28,0,30,2
1650075090912,MATH 20E,A01,084138,Staff,12,0,30,18
1650075090912,MATH 20E,A02,084139,Staff,6,0,30,24
1650075090912,MATH 20E,A03,084140,Staff,14,0,30,16
1650075090912,MATH 20E,A04,084141,Staff,19,0,30,11
1650075096936,MATH 102,A01,084143,Harel; Guershon,11,0,30,19
1650075096936,MATH 102,A02,084144,Harel; Guershon,19,0,30,11
1650075102962,MATH 103B,A01,083456,Staff,0,13,30,30
1650075102962,MATH 103B,A02,083457,Staff,0,14,30,30
1650075108988,MATH 109,A01,084146,Salehi Golsefidy; Alireza,16,0,30,14
1650075108988,MATH 109,A02,084147,Salehi Golsefidy; Alireza,15,0,30,15
1650075115012,MATH 120A,A01,085445,Eggers; John Dietrich,7,0,35,28
1650075115012,MATH 120A,A02,085446,Eggers; John Dietrich,26,0,35,9
1650075121037,MATH 142B,A01,084149,Verstraete; Jacques Allan,0,12,30,30
1650075121037,MATH 142B,A02,084150,Verstraete; Jacques Allan,0,12,30,30
1650075127062,MATH 170A,A01,083459,Nie; Jiawang,0,11,30,30
1650075127062,MATH 170A,A02,083460,Nie; Jiawang,0,10,30,30
1650075127062,MATH 170A,A03,083461,Nie; Jiawang,0,11,30,30
1650075133098,MATH 193B,A01,083463,Staff,1,0,30,29
1650075133098,MATH 193B,A02,083464,Staff,8,0,30,22
1650075133098,MATH 193B,A03,083465,Staff,16,0,30,14
1650075139148,COGS 2,A01,083966,Boyle; Mary E. T.,10,0,30,20
1650075145171,COGS 9,A01,083968,Staff,4,0,60,56
1650075151193,COGS 14B,A01,083970,Staff,8,0,50,42
1650075157216,COGS 17,A01,092679,Staff,49,0,75,26
1650075163245,COGS 100,A01,083972,Staff,1,19,60,59
1650075175309,COGS 101C,A01,083976,Staff,12,0,30,18
1650075181335,COGS 102A,A01,083978,Johnson; Christine M.,12,0,30,18
1650075187451,COGS 107B,A01,083980,Staff,0,9,50,50
1650075193477,COGS 115,A01,083982,Staff,9,0,30,21
1650075199501,COGS 118B,A01,083367,Staff,0,15,40,40
1650075205525,COGS 172,A01,083984,Provenzano; Emily Kara,13,0,30,17
1650075211553,COGS 177,A00,083368,Staff,0,22,30,30
1650075217580,COGS 186,A01,083986,Staff,21,0,40,19
1650075223608,COGS 187A,A01,083988,Boyle; Mary E. T.,19,0,60,41
1650075229646,CSE 8A,A50,084003,Miranda; Gregory Joseph,0,18,15,15
1650075235674,CSE 11,A01,084005,Miranda; Gregory Joseph,1,24,55,54
1650075241706,CSE 20,A01,084007,Staff,0,5,20,20
1650075247732,CSE 21,A01,084009,Staff,1,33,50,49
1650075253756,CSE 30,A01,083370,Cao; Yingjun,0,63,40,40
1650075259787,CSE 100,A01,083372,Cao; Yingjun,0,47,40,40
1650075265815,CSE 101,A01,084011,Staff,0,56,40,40
1650075271854,CSE 141,A01,083374,Eldon; John,0,68,75,75
1650075277878,CSE 141L,A01,083376,Eldon; John,0,74,75,75
1650075283902,CSE 175,A01,084013,Kumar; Rakesh,22,0,25,3
1650075289925,CSE 190,A00,092508,Dubnov; Shlomo,18,0,20,2
1650075295949,ECE 5,A01,084049,Morris; Karcher William,12,0,20,8
1650075301972,ECE 100,A01,084051,Baghdadchi; Saharnaz,0,0,20,20
1650075301972,ECE 100,A02,091916,Baghdadchi; Saharnaz,12,0,20,8
1650075308007,ECE 101,A01,084053,Baghdadchi; Saharnaz,0,0,37,37
1650075308007,ECE 101,A02,084054,Baghdadchi; Saharnaz,27,0,37,10
1650075314034,ECE 107,A01,083390,Staff,26,0,40,14
1650075320065,ECE 148,A01,084056,Silberman; Jack,8,0,12,4
1650075326093,ECE 180,A00,083391,Abi Samra; Nicholas Camill,25,0,30,5
1650075326093,ECE 180,B00,083392,Abi Samra; Nicholas Camill,21,0,30,9
1650075332120,MATH 10B,A01,084110,Staff,0,0,30,30
1650075332120,MATH 10B,A02,084111,Staff,17,0,30,13
1650075332120,MATH 10B,A03,084112,Staff,23,0,30,7
1650075338158,MATH 10C,A01,083443,Staff,0,17,30,31
1650075338158,MATH 10C,A02,083444,Staff,1,19,30,29
1650075338158,MATH 10C,B01,084114,Staff,17,0,30,13
1650075338158,MATH 10C,B02,084115,Staff,24,0,30,6
1650075344186,MATH 18,A01,084117,Harel; Guershon,11,0,30,19
1650075344186,MATH 18,A02,084119,Harel; Guershon,27,0,30,3
1650075344186,MATH 18,A03,084120,Harel; Guershon,30,0,30,0
1650075344186,MATH 18,A04,084121,Harel; Guershon,29,0,30,1
1650075350209,MATH 20B,A01,084124,Um; Ko Woon,10,0,35,25
1650075350209,MATH 20B,B01,084126,Um; Ko Woon,24,0,35,11
1650075356240,MATH 20C,A01,083446,Hammock; Frances H,0,0,30,30
1650075356240,MATH 20C,A02,083447,Hammock; Frances H,13,0,30,17
1650075356240,MATH 20C,A03,083448,Hammock; Frances H,19,0,30,11
1650075356240,MATH 20C,A04,083449,Hammock; Frances H,20,0,30,10
1650075356240,MATH 20C,B01,083451,Hammock; Frances H,0,0,30,30
1650075356240,MATH 20C,B02,083452,Hammock; Frances H,15,0,30,15
1650075356240,MATH 20C,B03,083453,Hammock; Frances H,19,0,30,11
1650075356240,MATH 20C,B04,083454,Hammock; Frances H,23,0,30,7
1650075362275,MATH 20D,A01,084128,Staff,14,0,30,16
1650075362275,MATH 20D,A02,084129,Staff,29,0,30,1
1650075362275,MATH 20D,A03,084130,Staff,27,0,30,3
1650075362275,MATH 20D,B01,084133,Staff,0,0,30,30
1650075362275,MATH 20D,B02,084134,Staff,23,0,30,7
1650075362275,MATH 20D,B03,084135,Staff,28,0,30,2
1650075368303,MATH 20E,A01,084138,Staff,12,0,30,18
1650075368303,MATH 20E,A02,084139,Staff,6,0,30,24
1650075368303,MATH 20E,A03,084140,Staff,14,0,30,16
1650075368303,MATH 20E,A04,084141,Staff,19,0,30,11
1650075374330,MATH 102,A01,084143,Harel; Guershon,11,0,30,19
1650075374330,MATH 102,A02,084144,Harel; Guershon,19,0,30,11
1650075380354,MATH 103B,A01,083456,Staff,0,13,30,30
1650075380354,MATH 103B,A02,083457,Staff,0,14,30,30
1650075386379,MATH 109,A01,084146,Salehi Golsefidy; Alireza,16,0,30,14
1650075386379,MATH 109,A02,084147,Salehi Golsefidy; Alireza,15,0,30,15
1650075392402,MATH 120A,A01,085445,Eggers; John Dietrich,7,0,35,28
1650075392402,MATH 120A,A02,085446,Eggers; John Dietrich,26,0,35,9
1650075398425,MATH 142B,A01,084149,Verstraete; Jacques Allan,0,12,30,30
1650075398425,MATH 142B,A02,084150,Verstraete; Jacques Allan,0,12,30,30
1650075404449,MATH 170A,A01,083459,Nie; Jiawang,0,11,30,30
1650075404449,MATH 170A,A02,083460,Nie; Jiawang,0,10,30,30
1650075404449,MATH 170A,A03,083461,Nie; Jiawang,0,11,30,30
1650075410473,MATH 193B,A01,083463,Staff,1,0,30,29
1650075410473,MATH 193B,A02,083464,Staff,8,0,30,22
1650075410473,MATH 193B,A03,083465,Staff,16,0,30,14
1650075416548,COGS 2,A01,083966,Boyle; Mary E. T.,10,0,30,20
1650075422572,COGS 9,A01,083968,Staff,4,0,60,56
1650075428600,COGS 14B,A01,083970,Staff,8,0,50,42
1650075434624,COGS 17,A01,092679,Staff,49,0,75,26
1650075440648,COGS 100,A01,083972,Staff,1,19,60,59
1650075452701,COGS 101C,A01,083976,Staff,12,0,30,18
1650075458725,COGS 102A,A01,083978,Johnson; Christine M.,12,0,30,18
1650075464752,COGS 107B,A01,083980,Staff,0,9,50,50
1650075470773,COGS 115,A01,083982,Staff,9,0,30,21
1650075476800,COGS 118B,A01,083367,Staff,0,15,40,40
1650075482825,COGS 172,A01,083984,Provenzano; Emily Kara,13,0,30,17
1650075488857,COGS 177,A00,083368,Staff,0,22,30,30
1650075494888,COGS 186,A01,083986,Staff,20,0,40,20
1650075500912,COGS 187A,A01,083988,Boyle; Mary E. T.,19,0,60,41
1650075506936,CSE 8A,A50,084003,Miranda; Gregory Joseph,0,18,15,15
1650075512964,CSE 11,A01,084005,Miranda; Gregory Joseph,1,24,55,54
1650075518995,CSE 20,A01,084007,Staff,0,5,20,20
1650075525029,CSE 21,A01,084009,Staff,1,33,50,49
1650075531057,CSE 30,A01,083370,Cao; Yingjun,0,63,40,40
1650075537085,CSE 100,A01,083372,Cao; Yingjun,0,47,40,40
1650075543112,CSE 101,A01,084011,Staff,0,56,40,40
1650075549136,CSE 141,A01,083374,Eldon; John,0,68,75,75
1650075555166,CSE 141L,A01,083376,Eldon; John,0,74,75,75
1650075561195,CSE 175,A01,084013,Kumar; Rakesh,22,0,25,3
1650075567218,CSE 190,A00,092508,Dubnov; Shlomo,18,0,20,2
1650075573240,ECE 5,A01,084049,Morris; Karcher William,12,0,20,8
1650075579262,ECE 100,A01,084051,Baghdadchi; Saharnaz,0,0,20,20
1650075579262,ECE 100,A02,091916,Baghdadchi; Saharnaz,12,0,20,8
1650075585284,ECE 101,A01,084053,Baghdadchi; Saharnaz,0,0,37,37
1650075585284,ECE 101,A02,084054,Baghdadchi; Saharnaz,27,0,37,10
1650075591308,ECE 107,A01,083390,Staff,26,0,40,14
1650075597334,ECE 148,A01,084056,Silberman; Jack,8,0,12,4
1650075603362,ECE 180,A00,083391,Abi Samra; Nicholas Camill,25,0,30,5
1650075603362,ECE 180,B00,083392,Abi Samra; Nicholas Camill,21,0,30,9
1650075609392,MATH 10B,A01,084110,Staff,0,0,30,30
1650075609392,MATH 10B,A02,084111,Staff,17,0,30,13
1650075609392,MATH 10B,A03,084112,Staff,23,0,30,7
1650075615417,MATH 10C,A01,083443,Staff,0,17,30,31
1650075615417,MATH 10C,A02,083444,Staff,1,19,30,29
1650075615417,MATH 10C,B01,084114,Staff,17,0,30,13
1650075615417,MATH 10C,B02,084115,Staff,24,0,30,6
1650075621442,MATH 18,A01,084117,Harel; Guershon,11,0,30,19
1650075621442,MATH 18,A02,084119,Harel; Guershon,27,0,30,3
1650075621442,MATH 18,A03,084120,Harel; Guershon,30,0,30,0
1650075621442,MATH 18,A04,084121,Harel; Guershon,29,0,30,1
1650075627476,MATH 20B,A01,084124,Um; Ko Woon,10,0,35,25
1650075627476,MATH 20B,B01,084126,Um; Ko Woon,24,0,35,11
1650075633500,MATH 20C,A01,083446,Hammock; Frances H,0,0,30,30
1650075633500,MATH 20C,A02,083447,Hammock; Frances H,13,0,30,17
1650075633500,MATH 20C,A03,083448,Hammock; Frances H,19,0,30,11
1650075633500,MATH 20C,A04,083449,Hammock; Frances H,20,0,30,10
1650075633500,MATH 20C,B01,083451,Hammock; Frances H,0,0,30,30
1650075633500,MATH 20C,B02,083452,Hammock; Frances H,15,0,30,15
1650075633500,MATH 20C,B03,083453,Hammock; Frances H,19,0,30,11
1650075633500,MATH 20C,B04,083454,Hammock; Frances H,23,0,30,7
1650075639527,MATH 20D,A01,084128,Staff,13,0,30,17
1650075639527,MATH 20D,A02,084129,Staff,29,0,30,1
1650075639527,MATH 20D,A03,084130,Staff,27,0,30,3
1650075639527,MATH 20D,B01,084133,Staff,0,0,30,30
1650075639527,MATH 20D,B02,084134,Staff,23,0,30,7
1650075639527,MATH 20D,B03,084135,Staff,28,0,30,2
1650075645555,MATH 20E,A01,084138,Staff,12,0,30,18
1650075645555,MATH 20E,A02,084139,Staff,6,0,30,24
1650075645555,MATH 20E,A03,084140,Staff,14,0,30,16
1650075645555,MATH 20E,A04,084141,Staff,19,0,30,11
1650075651582,MATH 102,A01,084143,Harel; Guershon,11,0,30,19
1650075651582,MATH 102,A02,084144,Harel; Guershon,19,0,30,11
1650075657609,MATH 103B,A01,083456,Staff,0,13,30,30
1650075657609,MATH 103B,A02,083457,Staff,0,14,30,30
1650075663634,MATH 109,A01,084146,Salehi Golsefidy; Alireza,16,0,30,14
1650075663634,MATH 109,A02,084147,Salehi Golsefidy; Alireza,15,0,30,15
1650075669660,MATH 120A,A01,085445,Eggers; John Dietrich,7,0,35,28
1650075669660,MATH 120A,A02,085446,Eggers; John Dietrich,26,0,35,9
1650075675684,MATH 142B,A01,084149,Verstraete; Jacques Allan,0,12,30,30
1650075675684,MATH 142B,A02,084150,Verstraete; Jacques Allan,0,12,30,30
1650075681717,MATH 170A,A01,083459,Nie; Jiawang,0,11,30,30
1650075681717,MATH 170A,A02,083460,Nie; Jiawang,0,10,30,30
1650075681717,MATH 170A,A03,083461,Nie; Jiawang,0,11,30,30
1650075687745,MATH 193B,A01,083463,Staff,1,0,30,29
1650075687745,MATH 193B,A02,083464,Staff,8,0,30,22
1650075687745,MATH 193B,A03,083465,Staff,16,0,30,14
1650075693799,COGS 2,A01,083966,Boyle; Mary E. T.,10,0,30,20
1650075699823,COGS 9,A01,083968,Staff,4,0,60,56
1650075705847,COGS 14B,A01,083970,Staff,8,0,50,42
1650075711869,COGS 17,A01,092679,Staff,49,0,75,26
1650075717904,COGS 100,A01,083972,Staff,1,19,60,59
1650075729965,COGS 101C,A01,083976,Staff,12,0,30,18
1650075735989,COGS 102A,A01,083978,Johnson; Christine M.,12,0,30,18
1650075742017,COGS 107B,A01,083980,Staff,0,9,50,50
1650075748042,COGS 115,A01,083982,Staff,9,0,30,21
1650075754068,COGS 118B,A01,083367,Staff,0,15,40,40
1650075760094,COGS 172,A01,083984,Provenzano; Emily Kara,13,0,30,17
1650075766118,COGS 177,A00,083368,Staff,0,22,30,30
1650075772144,COGS 186,A01,083986,Staff,20,0,40,20
1650075778176,COGS 187A,A01,083988,Boyle; Mary E. T.,19,0,60,41
1650075784294,CSE 8A,A50,084003,Miranda; Gregory Joseph,0,18,15,15
1650075790322,CSE 11,A01,084005,Miranda; Gregory Joseph,1,24,55,54
1650075796346,CSE 20,A01,084007,Staff,0,5,20,20
1650075802370,CSE 21,A01,084009,Staff,1,33,50,49
1650075808394,CSE 30,A01,083370,Cao; Yingjun,0,63,40,40
1650075814431,CSE 100,A01,083372,Cao; Yingjun,0,47,40,40
1650075820454,CSE 101,A01,084011,Staff,0,56,40,40
1650075826490,CSE 141,A01,083374,Eldon; John,0,68,75,75
1650075832511,CSE 141L,A01,083376,Eldon; John,0,74,75,75
1650075838537,CSE 175,A01,084013,Kumar; Rakesh,22,0,25,3
1650075844561,CSE 190,A00,092508,Dubnov; Shlomo,18,0,20,2
1650075850591,ECE 5,A01,084049,Morris; Karcher William,12,0,20,8
1650075856620,ECE 100,A01,084051,Baghdadchi; Saharnaz,0,0,20,20
1650075856620,ECE 100,A02,091916,Baghdadchi; Saharnaz,12,0,20,8
1650075862646,ECE 101,A01,084053,Baghdadchi; Saharnaz,0,0,37,37
1650075862646,ECE 101,A02,084054,Baghdadchi; Saharnaz,27,0,37,10
1650075868680,ECE 107,A01,083390,Staff,26,0,40,14
1650075874706,ECE 148,A01,084056,Silberman; Jack,8,0,12,4
1650075880731,ECE 180,A00,083391,Abi Samra; Nicholas Camill,25,0,30,5
1650075880731,ECE 180,B00,083392,Abi Samra; Nicholas Camill,21,0,30,9
1650075886757,MATH 10B,A01,084110,Staff,0,0,30,30
1650075886757,MATH 10B,A02,084111,Staff,17,0,30,13
1650075886757,MATH 10B,A03,084112,Staff,23,0,30,7
1650075892782,MATH 10C,A01,083443,Staff,0,17,30,31
1650075892782,MATH 10C,A02,083444,Staff,1,19,30,29
1650075892782,MATH 10C,B01,084114,Staff,17,0,30,13
1650075892782,MATH 10C,B02,084115,Staff,24,0,30,6
1650075898806,MATH 18,A01,084117,Harel; Guershon,11,0,30,19
1650075898806,MATH 18,A02,084119,Harel; Guershon,27,0,30,3
1650075898806,MATH 18,A03,084120,Harel; Guershon,30,0,30,0
1650075898806,MATH 18,A04,084121,Harel; Guershon,29,0,30,1
1650075904830,MATH 20B,A01,084124,Um; Ko Woon,10,0,35,25
1650075904830,MATH 20B,B01,084126,Um; Ko Woon,24,0,35,11
1650075910860,MATH 20C,A01,083446,Hammock; Frances H,0,0,30,30
1650075910860,MATH 20C,A02,083447,Hammock; Frances H,13,0,30,17
1650075910860,MATH 20C,A03,083448,Hammock; Frances H,19,0,30,11
1650075910860,MATH 20C,A04,083449,Hammock; Frances H,20,0,30,10
1650075910860,MATH 20C,B01,083451,Hammock; Frances H,0,0,30,30
1650075910860,MATH 20C,B02,083452,Hammock; Frances H,15,0,30,15
1650075910860,MATH 20C,B03,083453,Hammock; Frances H,19,0,30,11
1650075910860,MATH 20C,B04,083454,Hammock; Frances H,23,0,30,7
1650075916883,MATH 20D,A01,084128,Staff,14,0,30,16
1650075916883,MATH 20D,A02,084129,Staff,29,0,30,1
1650075916883,MATH 20D,A03,084130,Staff,27,0,30,3
1650075916883,MATH 20D,B01,084133,Staff,0,0,30,30
1650075916883,MATH 20D,B02,084134,Staff,22,0,30,8
1650075916883,MATH 20D,B03,084135,Staff,28,0,30,2
1650075922916,MATH 20E,A01,084138,Staff,12,0,30,18
1650075922916,MATH 20E,A02,084139,Staff,6,0,30,24
1650075922916,MATH 20E,A03,084140,Staff,14,0,30,16
1650075922916,MATH 20E,A04,084141,Staff,19,0,30,11
1650075928942,MATH 102,A01,084143,Harel; Guershon,11,0,30,19
1650075928942,MATH 102,A02,084144,Harel; Guershon,19,0,30,11
1650075934968,MATH 103B,A01,083456,Staff,0,13,30,30
1650075934968,MATH 103B,A02,083457,Staff,0,14,30,30
1650075940993,MATH 109,A01,084146,Salehi Golsefidy; Alireza,16,0,30,14
1650075940993,MATH 109,A02,084147,Salehi Golsefidy; Alireza,15,0,30,15
1650075947021,MATH 120A,A01,085445,Eggers; John Dietrich,7,0,35,28
1650075947021,MATH 120A,A02,085446,Eggers; John Dietrich,26,0,35,9
1650075953061,MATH 142B,A01,084149,Verstraete; Jacques Allan,0,12,30,30
1650075953061,MATH 142B,A02,084150,Verstraete; Jacques Allan,0,12,30,30
1650075959085,MATH 170A,A01,083459,Nie; Jiawang,0,11,30,30
1650075959085,MATH 170A,A02,083460,Nie; Jiawang,0,10,30,30
1650075959085,MATH 170A,A03,083461,Nie; Jiawang,0,11,30,30
1650075965109,MATH 193B,A01,083463,Staff,1,0,30,29
1650075965109,MATH 193B,A02,083464,Staff,8,0,30,22
1650075965109,MATH 193B,A03,083465,Staff,16,0,30,14
1650075971167,COGS 2,A01,083966,Boyle; Mary E. T.,10,0,30,20
1650075977191,COGS 9,A01,083968,Staff,4,0,60,56
1650075983219,COGS 14B,A01,083970,Staff,8,0,50,42
1650075989243,COGS 17,A01,092679,Staff,49,0,75,26
1650075995267,COGS 100,A01,083972,Staff,1,19,60,59
1650076007319,COGS 101C,A01,083976,Staff,12,0,30,18
1650076013353,COGS 102A,A01,083978,Johnson; Christine M.,12,0,30,18
1650076019379,COGS 107B,A01,083980,Staff,0,9,50,50
1650076025402,COGS 115,A01,083982,Staff,9,0,30,21
1650076031426,COGS 118B,A01,083367,Staff,0,16,40,40
1650076037452,COGS 172,A01,083984,Provenzano; Emily Kara,13,0,30,17
1650076043476,COGS 177,A00,083368,Staff,0,22,30,30
1650076049501,COGS 186,A01,083986,Staff,20,0,40,20
1650076055524,COGS 187A,A01,083988,Boyle; Mary E. T.,19,0,60,41
1650076061546,CSE 8A,A50,084003,Miranda; Gregory Joseph,0,18,15,15
1650076067569,CSE 11,A01,084005,Miranda; Gregory Joseph,1,24,55,54
1650076073592,CSE 20,A01,084007,Staff,0,5,20,20
1650076079619,CSE 21,A01,084009,Staff,1,33,50,49
1650076085655,CSE 30,A01,083370,Cao; Yingjun,0,63,40,40
1650076091678,CSE 100,A01,083372,Cao; Yingjun,0,47,40,40
1650076097705,CSE 101,A01,084011,Staff,0,56,40,40
1650076103732,CSE 141,A01,083374,Eldon; John,0,68,75,75
1650076109763,CSE 141L,A01,083376,Eldon; John,0,74,75,75
1650076115788,CSE 175,A01,084013,Kumar; Rakesh,22,0,25,3
1650076121813,CSE 190,A00,092508,Dubnov; Shlomo,18,0,20,2
1650076127840,ECE 5,A01,084049,Morris; Karcher William,12,0,20,8
1650076133862,ECE 100,A01,084051,Baghdadchi; Saharnaz,0,0,20,20
1650076133862,ECE 100,A02,091916,Baghdadchi; Saharnaz,12,0,20,8
1650076139892,ECE 101,A01,084053,Baghdadchi; Saharnaz,0,0,37,37
1650076139892,ECE 101,A02,084054,Baghdadchi; Saharnaz,27,0,37,10
1650076145916,ECE 107,A01,083390,Staff,26,0,40,14
1650076151941,ECE 148,A01,084056,Silberman; Jack,8,0,12,4
1650076157964,ECE 180,A00,083391,Abi Samra; Nicholas Camill,25,0,30,5
1650076157964,ECE 180,B00,083392,Abi Samra; Nicholas Camill,21,0,30,9
1650076163988,MATH 10B,A01,084110,Staff,0,0,30,30
1650076163988,MATH 10B,A02,084111,Staff,17,0,30,13
1650076163988,MATH 10B,A03,084112,Staff,23,0,30,7
1650076170016,MATH 10C,A01,083443,Staff,0,17,30,31
1650076170016,MATH 10C,A02,083444,Staff,1,19,30,29
1650076170016,MATH 10C,B01,084114,Staff,17,0,30,13
1650076170016,MATH 10C,B02,084115,Staff,24,0,30,6
1650076176039,MATH 18,A01,084117,Harel; Guershon,11,0,30,19
1650076176039,MATH 18,A02,084119,Harel; Guershon,27,0,30,3
1650076176039,MATH 18,A03,084120,Harel; Guershon,30,0,30,0
1650076176039,MATH 18,A04,084121,Harel; Guershon,29,0,30,1
1650076182066,MATH 20B,A01,084124,Um; Ko Woon,10,0,35,25
1650076182066,MATH 20B,B01,084126,Um; Ko Woon,24,0,35,11
1650076188097,MATH 20C,A01,083446,Hammock; Frances H,0,0,30,30
1650076188097,MATH 20C,A02,083447,Hammock; Frances H,13,0,30,17
1650076188097,MATH 20C,A03,083448,Hammock; Frances H,19,0,30,11
1650076188097,MATH 20C,A04,083449,Hammock; Frances H,20,0,30,10
1650076188097,MATH 20C,B01,083451,Hammock; Frances H,0,0,30,30
1650076188097,MATH 20C,B02,083452,Hammock; Frances H,15,0,30,15
1650076188097,MATH 20C,B03,083453,Hammock; Frances H,19,0,30,11
1650076188097,MATH 20C,B04,083454,Hammock; Frances H,23,0,30,7
1650076194121,MATH 20D,A01,084128,Staff,14,0,30,16
1650076194121,MATH 20D,A02,084129,Staff,29,0,30,1
1650076194121,MATH 20D,A03,084130,Staff,27,0,30,3
1650076194121,MATH 20D,B01,084133,Staff,0,0,30,30
1650076194121,MATH 20D,B02,084134,Staff,22,0,30,8
1650076194121,MATH 20D,B03,084135,Staff,28,0,30,2
1650076200144,MATH 20E,A01,084138,Staff,12,0,30,18
1650076200144,MATH 20E,A02,084139,Staff,6,0,30,24
1650076200144,MATH 20E,A03,084140,Staff,14,0,30,16
1650076200144,MATH 20E,A04,084141,Staff,19,0,30,11
1650076206166,MATH 102,A01,084143,Harel; Guershon,11,0,30,19
1650076206166,MATH 102,A02,084144,Harel; Guershon,19,0,30,11
1650076212189,MATH 103B,A01,083456,Staff,0,13,30,30
1650076212189,MATH 103B,A02,083457,Staff,0,14,30,30
1650076218211,MATH 109,A01,084146,Salehi Golsefidy; Alireza,16,0,30,14
1650076218211,MATH 109,A02,084147,Salehi Golsefidy; Alireza,15,0,30,15
1650076224237,MATH 120A,A01,085445,Eggers; John Dietrich,7,0,35,28
1650076224237,MATH 120A,A02,085446,Eggers; John Dietrich,26,0,35,9
1650076230261,MATH 142B,A01,084149,Verstraete; Jacques Allan,0,12,30,30
1650076230261,MATH 142B,A02,084150,Verstraete; Jacques Allan,0,12,30,30
1650076236285,MATH 170A,A01,083459,Nie; Jiawang,0,11,30,30
1650076236285,MATH 170A,A02,083460,Nie; Jiawang,0,10,30,30
1650076236285,MATH 170A,A03,083461,Nie; Jiawang,0,11,30,30
1650076242312,MATH 193B,A01,083463,Staff,1,0,30,29
1650076242312,MATH 193B,A02,083464,Staff,8,0,30,22
1650076242312,MATH 193B,A03,083465,Staff,16,0,30,14
1650076248374,COGS 2,A01,083966,Boyle; Mary E. T.,10,0,30,20
1650076254398,COGS 9,A01,083968,Staff,4,0,60,56
1650076260424,COGS 14B,A01,083970,Staff,8,0,50,42
1650076266448,COGS 17,A01,092679,Staff,49,0,75,26
1650076272481,COGS 100,A01,083972,Staff,1,19,60,59
1650076284530,COGS 101C,A01,083976,Staff,12,0,30,18
1650076290554,COGS 102A,A01,083978,Johnson; Christine M.,12,0,30,18
1650076296587,COGS 107B,A01,083980,Staff,0,9,50,50
1650076302613,COGS 115,A01,083982,Staff,9,0,30,21
1650076308635,COGS 118B,A01,083367,Staff,0,16,40,40
1650076314663,COGS 172,A01,083984,Provenzano; Emily Kara,13,0,30,17
1650076320687,COGS 177,A00,083368,Staff,0,22,30,30
1650076326711,COGS 186,A01,083986,Staff,20,0,40,20
1650076332738,COGS 187A,A01,083988,Boyle; Mary E. T.,19,0,60,41
1650076338762,CSE 8A,A50,084003,Miranda; Gregory Joseph,0,18,15,15
1650076344786,CSE 11,A01,084005,Miranda; Gregory Joseph,1,24,55,54
1650076350813,CSE 20,A01,084007,Staff,0,5,20,20
1650076356843,CSE 21,A01,084009,Staff,1,33,50,49
1650076362871,CSE 30,A01,083370,Cao; Yingjun,0,63,40,40
1650076368898,CSE 100,A01,083372,Cao; Yingjun,0,47,40,40
1650076374928,CSE 101,A01,084011,Staff,0,56,40,40
1650076381040,CSE 141,A01,083374,Eldon; John,0,68,75,75
1650076387069,CSE 141L,A01,083376,Eldon; John,0,74,75,75
1650076393092,CSE 175,A01,084013,Kumar; Rakesh,22,0,25,3
1650076399126,CSE 190,A00,092508,Dubnov; Shlomo,18,0,20,2
1650076405150,ECE 5,A01,084049,Morris; Karcher William,12,0,20,8
1650076411176,ECE 100,A01,084051,Baghdadchi; Saharnaz,0,0,20,20
1650076411176,ECE 100,A02,091916,Baghdadchi; Saharnaz,12,0,20,8
1650076417208,ECE 101,A01,084053,Baghdadchi; Saharnaz,0,0,37,37
1650076417208,ECE 101,A02,084054,Baghdadchi; Saharnaz,27,0,37,10
1650076423233,ECE 107,A01,083390,Staff,26,0,40,14
1650076429268,ECE 148,A01,084056,Silberman; Jack,8,0,12,4
1650076435292,ECE 180,A00,083391,Abi Samra; Nicholas Camill,25,0,30,5
1650076435292,ECE 180,B00,083392,Abi Samra; Nicholas Camill,21,0,30,9
1650076441316,MATH 10B,A01,084110,Staff,0,0,30,30
1650076441316,MATH 10B,A02,084111,Staff,17,0,30,13
1650076441316,MATH 10B,A03,084112,Staff,23,0,30,7
1650076447343,MATH 10C,A01,083443,Staff,0,17,30,31
1650076447343,MATH 10C,A02,083444,Staff,1,19,30,29
1650076447343,MATH 10C,B01,084114,Staff,17,0,30,13
1650076447343,MATH 10C,B02,084115,Staff,24,0,30,6
1650076453370,MATH 18,A01,084117,Harel; Guershon,11,0,30,19
1650076453370,MATH 18,A02,084119,Harel; Guershon,27,0,30,3
1650076453370,MATH 18,A03,084120,Harel; Guershon,30,0,30,0
1650076453370,MATH 18,A04,084121,Harel; Guershon,29,0,30,1
1650076459400,MATH 20B,A01,084124,Um; Ko Woon,10,0,35,25
1650076459400,MATH 20B,B01,084126,Um; Ko Woon,24,0,35,11
1650076465425,MATH 20C,A01,083446,Hammock; Frances H,0,0,30,30
1650076465425,MATH 20C,A02,083447,Hammock; Frances H,13,0,30,17
1650076465425,MATH 20C,A03,083448,Hammock; Frances H,19,0,30,11
1650076465425,MATH 20C,A04,083449,Hammock; Frances H,20,0,30,10
1650076465425,MATH 20C,B01,083451,Hammock; Frances H,0,0,30,30
1650076465425,MATH 20C,B02,083452,Hammock; Frances H,15,0,30,15
1650076465425,MATH 20C,B03,083453,Hammock; Frances H,19,0,30,11
1650076465425,MATH 20C,B04,083454,Hammock; Frances H,23,0,30,7
1650076471449,MATH 20D,A01,084128,Staff,13,0,30,17
1650076471449,MATH 20D,A02,084129,Staff,29,0,30,1
1650076471449,MATH 20D,A03,084130,Staff,27,0,30,3
1650076471449,MATH 20D,B01,084133,Staff,0,0,30,30
1650076471449,MATH 20D,B02,084134,Staff,23,0,30,7
1650076471449,MATH 20D,B03,084135,Staff,28,0,30,2
1650076477473,MATH 20E,A01,084138,Staff,13,0,30,17
1650076477473,MATH 20E,A02,084139,Staff,6,0,30,24
1650076477473,MATH 20E,A03,084140,Staff,14,0,30,16
1650076477473,MATH 20E,A04,084141,Staff,19,0,30,11
1650076483497,MATH 102,A01,084143,Harel; Guershon,11,0,30,19
1650076483497,MATH 102,A02,084144,Harel; Guershon,19,0,30,11
1650076489521,MATH 103B,A01,083456,Staff,0,13,30,30
1650076489521,MATH 103B,A02,083457,Staff,0,14,30,30
1650076495544,MATH 109,A01,084146,Salehi Golsefidy; Alireza,16,0,30,14
1650076495544,MATH 109,A02,084147,Salehi Golsefidy; Alireza,15,0,30,15
1650076501578,MATH 120A,A01,085445,Eggers; John Dietrich,7,0,35,28
1650076501578,MATH 120A,A02,085446,Eggers; John Dietrich,26,0,35,9
1650076507608,MATH 142B,A01,084149,Verstraete; Jacques Allan,0,12,30,30
1650076507608,MATH 142B,A02,084150,Verstraete; Jacques Allan,0,12,30,30
1650076513632,MATH 170A,A01,083459,Nie; Jiawang,0,11,30,30
1650076513632,MATH 170A,A02,083460,Nie; Jiawang,0,10,30,30
1650076513632,MATH 170A,A03,083461,Nie; Jiawang,0,11,30,30
1650076519668,MATH 193B,A01,083463,Staff,1,0,30,29
1650076519668,MATH 193B,A02,083464,Staff,8,0,30,22
1650076519668,MATH 193B,A03,083465,Staff,16,0,30,14
1650076525738,COGS 2,A01,083966,Boyle; Mary E. T.,10,0,30,20
1650076531775,COGS 9,A01,083968,Staff,3,0,60,57
1650076537801,COGS 14B,A01,083970,Staff,8,0,50,42
1650076543828,COGS 17,A01,092679,Staff,49,0,75,26
1650076549852,COGS 100,A01,083972,Staff,1,19,60,59
1650076561909,COGS 101C,A01,083976,Staff,12,0,30,18
1650076567932,COGS 102A,A01,083978,Johnson; Christine M.,12,0,30,18
1650076573963,COGS 107B,A01,083980,Staff,0,9,50,50
1650076579993,COGS 115,A01,083982,Staff,9,0,30,21
1650076586028,COGS 118B,A01,083367,Staff,0,16,40,40
1650076592052,COGS 172,A01,083984,Provenzano; Emily Kara,13,0,30,17
1650076598096,COGS 177,A00,083368,Staff,0,22,30,30
1650076604120,COGS 186,A01,083986,Staff,20,0,40,20
1650076610143,COGS 187A,A01,083988,Boyle; Mary E. T.,19,0,60,41
1650076616175,CSE 8A,A50,084003,Miranda; Gregory Joseph,0,18,15,15
1650076622198,CSE 11,A01,084005,Miranda; Gregory Joseph,1,24,55,54
1650076628222,CSE 20,A01,084007,Staff,0,5,20,20
1650076634249,CSE 21,A01,084009,Staff,1,33,50,49
1650076640272,CSE 30,A01,083370,Cao; Yingjun,0,63,40,40
1650076646295,CSE 100,A01,083372,Cao; Yingjun,0,47,40,40
1650076652318,CSE 101,A01,084011,Staff,0,56,40,40
1650076658351,CSE 141,A01,083374,Eldon; John,0,68,75,75
1650076664383,CSE 141L,A01,083376,Eldon; John,0,74,75,75
1650076670408,CSE 175,A01,084013,Kumar; Rakesh,22,0,25,3
1650076676442,CSE 190,A00,092508,Dubnov; Shlomo,18,0,20,2
1650076682466,ECE 5,A01,084049,Morris; Karcher William,12,0,20,8
1650076688492,ECE 100,A01,084051,Baghdadchi; Saharnaz,0,0,20,20
1650076688492,ECE 100,A02,091916,Baghdadchi; Saharnaz,12,0,20,8
1650076694516,ECE 101,A01,084053,Baghdadchi; Saharnaz,0,0,37,37
1650076694516,ECE 101,A02,084054,Baghdadchi; Saharnaz,27,0,37,10
1650076700543,ECE 107,A01,083390,Staff,26,0,40,14
1650076706567,ECE 148,A01,084056,Silberman; Jack,8,0,12,4
1650076712610,ECE 180,A00,083391,Abi Samra; Nicholas Camill,25,0,30,5
1650076712610,ECE 180,B00,083392,Abi Samra; Nicholas Camill,21,0,30,9
1650076718650,MATH 10B,A01,084110,Staff,0,0,30,30
1650076718650,MATH 10B,A02,084111,Staff,17,0,30,13
1650076718650,MATH 10B,A03,084112,Staff,23,0,30,7
1650076724674,MATH 10C,A01,083443,Staff,0,17,30,31
1650076724674,MATH 10C,A02,083444,Staff,1,19,30,29
1650076724674,MATH 10C,B01,084114,Staff,17,0,30,13
1650076724674,MATH 10C,B02,084115,Staff,24,0,30,6
1650076730702,MATH 18,A01,084117,Harel; Guershon,11,0,30,19
1650076730702,MATH 18,A02,084119,Harel; Guershon,27,0,30,3
1650076730702,MATH 18,A03,084120,Harel; Guershon,30,0,30,0
1650076730702,MATH 18,A04,084121,Harel; Guershon,29,0,30,1
1650076736727,MATH 20B,A01,084124,Um; Ko Woon,10,0,35,25
1650076736727,MATH 20B,B01,084126,Um; Ko Woon,24,0,35,11
1650076742768,MATH 20C,A01,083446,Hammock; Frances H,0,0,30,30
1650076742768,MATH 20C,A02,083447,Hammock; Frances H,13,0,30,17
1650076742768,MATH 20C,A03,083448,Hammock; Frances H,19,0,30,11
1650076742768,MATH 20C,A04,083449,Hammock; Frances H,20,0,30,10
1650076742768,MATH 20C,B01,083451,Hammock; Frances H,0,0,30,30
1650076742768,MATH 20C,B02,083452,Hammock; Frances H,15,0,30,15
1650076742768,MATH 20C,B03,083453,Hammock; Frances H,19,0,30,11
1650076742768,MATH 20C,B04,083454,Hammock; Frances H,23,0,30,7
1650076748793,MATH 20D,A01,084128,Staff,13,0,30,17
1650076748793,MATH 20D,A02,084129,Staff,29,0,30,1
1650076748793,MATH 20D,A03,084130,Staff,27,0,30,3
1650076748793,MATH 20D,B01,084133,Staff,0,0,30,30
1650076748793,MATH 20D,B02,084134,Staff,23,0,30,7
1650076748793,MATH 20D,B03,084135,Staff,28,0,30,2
1650076754835,MATH 20E,A01,084138,Staff,13,0,30,17
1650076754835,MATH 20E,A02,084139,Staff,6,0,30,24
1650076754835,MATH 20E,A03,084140,Staff,14,0,30,16
1650076754835,MATH 20E,A04,084141,Staff,19,0,30,11
1650076760858,MATH 102,A01,084143,Harel; Guershon,11,0,30,19
1650076760858,MATH 102,A02,084144,Harel; Guershon,19,0,30,11
1650076766882,MATH 103B,A01,083456,Staff,0,13,30,30
1650076766882,MATH 103B,A02,083457,Staff,0,14,30,30
1650076772917,MATH 109,A01,084146,Salehi Golsefidy; Alireza,16,0,30,14
1650076772917,MATH 109,A02,084147,Salehi Golsefidy; Alireza,15,0,30,15
1650076778945,MATH 120A,A01,085445,Eggers; John Dietrich,7,0,35,28
1650076778945,MATH 120A,A02,085446,Eggers; John Dietrich,26,0,35,9
1650076784978,MATH 142B,A01,084149,Verstraete; Jacques Allan,0,12,30,30
1650076784978,MATH 142B,A02,084150,Verstraete; Jacques Allan,0,12,30,30
1650076791016,MATH 170A,A01,083459,Nie; Jiawang,0,11,30,30
1650076791016,MATH 170A,A02,083460,Nie; Jiawang,0,10,30,30
1650076791016,MATH 170A,A03,083461,Nie; Jiawang,0,11,30,30
1650076797039,MATH 193B,A01,083463,Staff,1,0,30,29
1650076797039,MATH 193B,A02,083464,Staff,8,0,30,22
1650076797039,MATH 193B,A03,083465,Staff,16,0,30,14
1650076803110,COGS 2,A01,083966,Boyle; Mary E. T.,10,0,30,20
1650076809137,COGS 9,A01,083968,Staff,3,0,60,57
1650076815164,COGS 14B,A01,083970,Staff,8,0,50,42
1650076821191,COGS 17,A01,092679,Staff,49,0,75,26
1650076827213,COGS 100,A01,083972,Staff,1,19,60,59
1650076839263,COGS 101C,A01,083976,Staff,12,0,30,18
1650076845291,COGS 102A,A01,083978,Johnson; Christine M.,12,0,30,18
1650076851321,COGS 107B,A01,083980,Staff,0,9,50,50
1650076857362,COGS 115,A01,083982,Staff,9,0,30,21
1650076863387,COGS 118B,A01,083367,Staff,0,16,40,40
1650076869410,COGS 172,A01,083984,Provenzano; Emily Kara,13,0,30,17
1650076875434,COGS 177,A00,083368,Staff,0,22,30,30
1650076881458,COGS 186,A01,083986,Staff,20,0,40,20
1650076887482,COGS 187A,A01,083988,Boyle; Mary E. T.,19,0,60,41
1650076893510,CSE 8A,A50,084003,Miranda; Gregory Joseph,0,18,15,15
1650076899535,CSE 11,A01,084005,Miranda; Gregory Joseph,1,24,55,54
1650076905562,CSE 20,A01,084007,Staff,0,5,20,20
1650076911584,CSE 21,A01,084009,Staff,1,33,50,49
1650076917609,CSE 30,A01,083370,Cao; Yingjun,0,63,40,40
1650076923636,CSE 100,A01,083372,Cao; Yingjun,0,47,40,40
1650076929660,CSE 101,A01,084011,Staff,0,56,40,40
1650076935686,CSE 141,A01,083374,Eldon; John,0,68,75,75
1650076941710,CSE 141L,A01,083376,Eldon; John,0,74,75,75
1650076947733,CSE 175,A01,084013,Kumar; Rakesh,22,0,25,3
1650076953759,CSE 190,A00,092508,Dubnov; Shlomo,18,0,20,2
1650076959788,ECE 5,A01,084049,Morris; Karcher William,12,0,20,8
1650076965816,ECE 100,A01,084051,Baghdadchi; Saharnaz,0,0,20,20
1650076965816,ECE 100,A02,091916,Baghdadchi; Saharnaz,12,0,20,8
1650076971844,ECE 101,A01,084053,Baghdadchi; Saharnaz,0,0,37,37
1650076971844,ECE 101,A02,084054,Baghdadchi; Saharnaz,27,0,37,10
1650076977946,ECE 107,A01,083390,Staff,26,0,40,14
1650076983969,ECE 148,A01,084056,Silberman; Jack,8,0,12,4
1650076989993,ECE 180,A00,083391,Abi Samra; Nicholas Camill,25,0,30,5
1650076989993,ECE 180,B00,083392,Abi Samra; Nicholas Camill,21,0,30,9
1650076996015,MATH 10B,A01,084110,Staff,0,0,30,30
1650076996015,MATH 10B,A02,084111,Staff,17,0,30,13
1650076996015,MATH 10B,A03,084112,Staff,23,0,30,7
1650077002044,MATH 10C,A01,083443,Staff,0,17,30,31
1650077002044,MATH 10C,A02,083444,Staff,1,19,30,29
1650077002044,MATH 10C,B01,084114,Staff,17,0,30,13
1650077002044,MATH 10C,B02,084115,Staff,24,0,30,6
1650077008077,MATH 18,A01,084117,Harel; Guershon,11,0,30,19
1650077008077,MATH 18,A02,084119,Harel; Guershon,27,0,30,3
1650077008077,MATH 18,A03,084120,Harel; Guershon,30,0,30,0
1650077008077,MATH 18,A04,084121,Harel; Guershon,29,0,30,1
1650077014106,MATH 20B,A01,084124,Um; Ko Woon,10,0,35,25
1650077014106,MATH 20B,B01,084126,Um; Ko Woon,24,0,35,11
1650077020136,MATH 20C,A01,083446,Hammock; Frances H,0,0,30,30
1650077020136,MATH 20C,A02,083447,Hammock; Frances H,13,0,30,17
1650077020136,MATH 20C,A03,083448,Hammock; Frances H,19,0,30,11
1650077020136,MATH 20C,A04,083449,Hammock; Frances H,20,0,30,10
1650077020136,MATH 20C,B01,083451,Hammock; Frances H,0,0,30,30
1650077020136,MATH 20C,B02,083452,Hammock; Frances H,15,0,30,15
1650077020136,MATH 20C,B03,083453,Hammock; Frances H,19,0,30,11
1650077020136,MATH 20C,B04,083454,Hammock; Frances H,23,0,30,7
1650077026164,MATH 20D,A01,084128,Staff,13,0,30,17
1650077026164,MATH 20D,A02,084129,Staff,29,0,30,1
1650077026164,MATH 20D,A03,084130,Staff,27,0,30,3
1650077026164,MATH 20D,B01,084133,Staff,0,0,30,30
1650077026164,MATH 20D,B02,084134,Staff,23,0,30,7
1650077026164,MATH 20D,B03,084135,Staff,28,0,30,2
1650077032187,MATH 20E,A01,084138,Staff,13,0,30,17
1650077032187,MATH 20E,A02,084139,Staff,6,0,30,24
1650077032187,MATH 20E,A03,084140,Staff,14,0,30,16
1650077032187,MATH 20E,A04,084141,Staff,19,0,30,11
1650077038215,MATH 102,A01,084143,Harel; Guershon,11,0,30,19
1650077038215,MATH 102,A02,084144,Harel; Guershon,19,0,30,11
1650077044239,MATH 103B,A01,083456,Staff,0,13,30,30
1650077044239,MATH 103B,A02,083457,Staff,0,14,30,30
1650077050270,MATH 109,A01,084146,Salehi Golsefidy; Alireza,16,0,30,14
1650077050270,MATH 109,A02,084147,Salehi Golsefidy; Alireza,15,0,30,15
1650077056314,MATH 120A,A01,085445,Eggers; John Dietrich,7,0,35,28
1650077056314,MATH 120A,A02,085446,Eggers; John Dietrich,26,0,35,9
1650077062338,MATH 142B,A01,084149,Verstraete; Jacques Allan,0,12,30,30
1650077062338,MATH 142B,A02,084150,Verstraete; Jacques Allan,0,12,30,30
1650077068362,MATH 170A,A01,083459,Nie; Jiawang,0,11,30,30
1650077068362,MATH 170A,A02,083460,Nie; Jiawang,0,10,30,30
1650077068362,MATH 170A,A03,083461,Nie; Jiawang,0,11,30,30
1650077074385,MATH 193B,A01,083463,Staff,1,0,30,29
1650077074385,MATH 193B,A02,083464,Staff,8,0,30,22
1650077074385,MATH 193B,A03,083465,Staff,16,0,30,14
1650077080448,COGS 2,A01,083966,Boyle; Mary E. T.,10,0,30,20
1650077086473,COGS 9,A01,083968,Staff,3,0,60,57
1650077092497,COGS 14B,A01,083970,Staff,8,0,50,42
1650077098519,COGS 17,A01,092679,Staff,49,0,75,26
1650077104543,COGS 100,A01,083972,Staff,1,20,60,59
1650077116593,COGS 101C,A01,083976,Staff,12,0,30,18
1650077122620,COGS 102A,A01,083978,Johnson; Christine M.,12,0,30,18
1650077128647,COGS 107B,A01,083980,Staff,0,9,50,50
1650077134670,COGS 115,A01,083982,Staff,9,0,30,21
1650077140697,COGS 118B,A01,083367,Staff,0,16,40,40
1650077146720,COGS 172,A01,083984,Provenzano; Emily Kara,13,0,30,17
1650077152745,COGS 177,A00,083368,Staff,0,22,30,30
1650077158768,COGS 186,A01,083986,Staff,20,0,40,20
1650077164792,COGS 187A,A01,083988,Boyle; Mary E. T.,19,0,60,41
1650077170822,CSE 8A,A50,084003,Miranda; Gregory Joseph,0,18,15,15
1650077176849,CSE 11,A01,084005,Miranda; Gregory Joseph,1,24,55,54
1650077182876,CSE 20,A01,084007,Staff,0,5,20,20
1650077188899,CSE 21,A01,084009,Staff,1,33,50,49
1650077194932,CSE 30,A01,083370,Cao; Yingjun,0,63,40,40
1650077200958,CSE 100,A01,083372,Cao; Yingjun,0,47,40,40
1650077206982,CSE 101,A01,084011,Staff,0,56,40,40
1650077213005,CSE 141,A01,083374,Eldon; John,0,68,75,75
1650077219029,CSE 141L,A01,083376,Eldon; John,0,74,75,75
1650077225056,CSE 175,A01,084013,Kumar; Rakesh,22,0,25,3
1650077231079,CSE 190,A00,092508,Dubnov; Shlomo,18,0,20,2
1650077237101,ECE 5,A01,084049,Morris; Karcher William,12,0,20,8
1650077243125,ECE 100,A01,084051,Baghdadchi; Saharnaz,0,0,20,20
1650077243125,ECE 100,A02,091916,Baghdadchi; Saharnaz,12,0,20,8
1650077249152,ECE 101,A01,084053,Baghdadchi; Saharnaz,0,0,37,37
1650077249152,ECE 101,A02,084054,Baghdadchi; Saharnaz,27,0,37,10
1650077255177,ECE 107,A01,083390,Staff,26,0,40,14
1650077261201,ECE 148,A01,084056,Silberman; Jack,8,0,12,4
1650077267224,ECE 180,A00,083391,Abi Samra; Nicholas Camill,25,0,30,5
1650077267224,ECE 180,B00,083392,Abi Samra; Nicholas Camill,21,0,30,9
1650077273249,MATH 10B,A01,084110,Staff,0,0,30,30
1650077273249,MATH 10B,A02,084111,Staff,17,0,30,13
1650077273249,MATH 10B,A03,084112,Staff,23,0,30,7
1650077279277,MATH 10C,A01,083443,Staff,0,17,30,31
1650077279277,MATH 10C,A02,083444,Staff,1,19,30,29
1650077279277,MATH 10C,B01,084114,Staff,17,0,30,13
1650077279277,MATH 10C,B02,084115,Staff,24,0,30,6
1650077285300,MATH 18,A01,084117,Harel; Guershon,11,0,30,19
1650077285300,MATH 18,A02,084119,Harel; Guershon,27,0,30,3
1650077285300,MATH 18,A03,084120,Harel; Guershon,30,0,30,0
1650077285300,MATH 18,A04,084121,Harel; Guershon,29,0,30,1
1650077291325,MATH 20B,A01,084124,Um; Ko Woon,10,0,35,25
1650077291325,MATH 20B,B01,084126,Um; Ko Woon,24,0,35,11
1650077297366,MATH 20C,A01,083446,Hammock; Frances H,0,0,30,30
1650077297366,MATH 20C,A02,083447,Hammock; Frances H,13,0,30,17
1650077297366,MATH 20C,A03,083448,Hammock; Frances H,19,0,30,11
1650077297366,MATH 20C,A04,083449,Hammock; Frances H,20,0,30,10
1650077297366,MATH 20C,B01,083451,Hammock; Frances H,0,0,30,30
1650077297366,MATH 20C,B02,083452,Hammock; Frances H,15,0,30,15
1650077297366,MATH 20C,B03,083453,Hammock; Frances H,19,0,30,11
1650077297366,MATH 20C,B04,083454,Hammock; Frances H,23,0,30,7
1650077303398,MATH 20D,A01,084128,Staff,13,0,30,17
1650077303398,MATH 20D,A02,084129,Staff,29,0,30,1
1650077303398,MATH 20D,A03,084130,Staff,27,0,30,3
1650077303398,MATH 20D,B01,084133,Staff,0,0,30,30
1650077303398,MATH 20D,B02,084134,Staff,23,0,30,7
1650077303398,MATH 20D,B03,084135,Staff,28,0,30,2
1650077309426,MATH 20E,A01,084138,Staff,13,0,30,17
1650077309426,MATH 20E,A02,084139,Staff,6,0,30,24
1650077309426,MATH 20E,A03,084140,Staff,14,0,30,16
1650077309426,MATH 20E,A04,084141,Staff,19,0,30,11
1650077315454,MATH 102,A01,084143,Harel; Guershon,11,0,30,19
1650077315454,MATH 102,A02,084144,Harel; Guershon,19,0,30,11
1650077321492,MATH 103B,A01,083456,Staff,0,13,30,30
1650077321492,MATH 103B,A02,083457,Staff,0,14,30,30
1650077327515,MATH 109,A01,084146,Salehi Golsefidy; Alireza,16,0,30,14
1650077327515,MATH 109,A02,084147,Salehi Golsefidy; Alireza,15,0,30,15
1650077333542,MATH 120A,A01,085445,Eggers; John Dietrich,7,0,35,28
1650077333542,MATH 120A,A02,085446,Eggers; John Dietrich,26,0,35,9
1650077339570,MATH 142B,A01,084149,Verstraete; Jacques Allan,0,12,30,30
1650077339570,MATH 142B,A02,084150,Verstraete; Jacques Allan,0,12,30,30
1650077345598,MATH 170A,A01,083459,Nie; Jiawang,0,11,30,30
1650077345598,MATH 170A,A02,083460,Nie; Jiawang,0,10,30,30
1650077345598,MATH 170A,A03,083461,Nie; Jiawang,0,11,30,30
1650077351625,MATH 193B,A01,083463,Staff,1,0,30,29
1650077351625,MATH 193B,A02,083464,Staff,8,0,30,22
1650077351625,MATH 193B,A03,083465,Staff,16,0,30,14
1650077357675,COGS 2,A01,083966,Boyle; Mary E. T.,10,0,30,20
1650077363700,COGS 9,A01,083968,Staff,3,0,60,57
1650077369728,COGS 14B,A01,083970,Staff,8,0,50,42
1650077375755,COGS 17,A01,092679,Staff,49,0,75,26
1650077381782,COGS 100,A01,083972,Staff,1,20,60,59
1650077393828,COGS 101C,A01,083976,Staff,12,0,30,18
1650077399855,COGS 102A,A01,083978,Johnson; Christine M.,12,0,30,18
1650077405883,COGS 107B,A01,083980,Staff,0,9,50,50
1650077411910,COGS 115,A01,083982,Staff,9,0,30,21
1650077417933,COGS 118B,A01,083367,Staff,0,16,40,40
1650077423959,COGS 172,A01,083984,Provenzano; Emily Kara,13,0,30,17
1650077429993,COGS 177,A00,083368,Staff,0,22,30,30
1650077436026,COGS 186,A01,083986,Staff,21,0,40,19
1650077442049,COGS 187A,A01,083988,Boyle; Mary E. T.,18,0,60,42
1650077448076,CSE 8A,A50,084003,Miranda; Gregory Joseph,0,18,15,15
1650077454100,CSE 11,A01,084005,Miranda; Gregory Joseph,1,24,55,54
1650077460128,CSE 20,A01,084007,Staff,0,5,20,20
1650077466150,CSE 21,A01,084009,Staff,1,33,50,49
1650077472178,CSE 30,A01,083370,Cao; Yingjun,0,63,40,40
1650077478205,CSE 100,A01,083372,Cao; Yingjun,0,47,40,40
1650077484227,CSE 101,A01,084011,Staff,0,56,40,40
1650077490253,CSE 141,A01,083374,Eldon; John,0,68,75,75
1650077496285,CSE 141L,A01,083376,Eldon; John,0,74,75,75
1650077502312,CSE 175,A01,084013,Kumar; Rakesh,22,0,25,3
1650077508349,CSE 190,A00,092508,Dubnov; Shlomo,18,0,20,2
1650077514372,ECE 5,A01,084049,Morris; Karcher William,12,0,20,8
1650077520401,ECE 100,A01,084051,Baghdadchi; Saharnaz,0,0,20,20
1650077520401,ECE 100,A02,091916,Baghdadchi; Saharnaz,12,0,20,8
1650077526425,ECE 101,A01,084053,Baghdadchi; Saharnaz,0,0,37,37
1650077526425,ECE 101,A02,084054,Baghdadchi; Saharnaz,27,0,37,10
1650077532448,ECE 107,A01,083390,Staff,26,0,40,14
1650077538477,ECE 148,A01,084056,Silberman; Jack,8,0,12,4
1650077544500,ECE 180,A00,083391,Abi Samra; Nicholas Camill,25,0,30,5
1650077544500,ECE 180,B00,083392,Abi Samra; Nicholas Camill,21,0,30,9
1650077550524,MATH 10B,A01,084110,Staff,0,0,30,30
1650077550524,MATH 10B,A02,084111,Staff,17,0,30,13
1650077550524,MATH 10B,A03,084112,Staff,23,0,30,7
1650077556550,MATH 10C,A01,083443,Staff,0,17,30,31
1650077556550,MATH 10C,A02,083444,Staff,1,19,30,29
1650077556550,MATH 10C,B01,084114,Staff,17,0,30,13
1650077556550,MATH 10C,B02,084115,Staff,24,0,30,6
1650077562579,MATH 18,A01,084117,Harel; Guershon,11,0,30,19
1650077562579,MATH 18,A02,084119,Harel; Guershon,27,0,30,3
1650077562579,MATH 18,A03,084120,Harel; Guershon,30,0,30,0
1650077562579,MATH 18,A04,084121,Harel; Guershon,29,0,30,1
1650077568608,MATH 20B,A01,084124,Um; Ko Woon,10,0,35,25
1650077568608,MATH 20B,B01,084126,Um; Ko Woon,24,0,35,11
1650077574725,MATH 20C,A01,083446,Hammock; Frances H,0,0,30,30
1650077574725,MATH 20C,A02,083447,Hammock; Frances H,13,0,30,17
1650077574725,MATH 20C,A03,083448,Hammock; Frances H,18,0,30,12
1650077574725,MATH 20C,A04,083449,Hammock; Frances H,20,0,30,10
1650077574725,MATH 20C,B01,083451,Hammock; Frances H,0,0,30,30
1650077574725,MATH 20C,B02,083452,Hammock; Frances H,15,0,30,15
1650077574725,MATH 20C,B03,083453,Hammock; Frances H,19,0,30,11
1650077574725,MATH 20C,B04,083454,Hammock; Frances H,23,0,30,7
1650077580748,MATH 20D,A01,084128,Staff,13,0,30,17
1650077580748,MATH 20D,A02,084129,Staff,29,0,30,1
1650077580748,MATH 20D,A03,084130,Staff,27,0,30,3
1650077580748,MATH 20D,B01,084133,Staff,0,0,30,30
1650077580748,MATH 20D,B02,084134,Staff,23,0,30,7
1650077580748,MATH 20D,B03,084135,Staff,28,0,30,2
1650077586779,MATH 20E,A01,084138,Staff,13,0,30,17
1650077586779,MATH 20E,A02,084139,Staff,6,0,30,24
1650077586779,MATH 20E,A03,084140,Staff,14,0,30,16
1650077586779,MATH 20E,A04,084141,Staff,19,0,30,11
1650077592803,MATH 102,A01,084143,Harel; Guershon,11,0,30,19
1650077592803,MATH 102,A02,084144,Harel; Guershon,19,0,30,11
1650077598829,MATH 103B,A01,083456,Staff,0,13,30,30
1650077598829,MATH 103B,A02,083457,Staff,0,14,30,30
1650077604856,MATH 109,A01,084146,Salehi Golsefidy; Alireza,16,0,30,14
1650077604856,MATH 109,A02,084147,Salehi Golsefidy; Alireza,15,0,30,15
1650077610882,MATH 120A,A01,085445,Eggers; John Dietrich,7,0,35,28
1650077610882,MATH 120A,A02,085446,Eggers; John Dietrich,26,0,35,9
1650077616906,MATH 142B,A01,084149,Verstraete; Jacques Allan,0,12,30,30
1650077616906,MATH 142B,A02,084150,Verstraete; Jacques Allan,0,12,30,30
1650077622935,MATH 170A,A01,083459,Nie; Jiawang,0,11,30,30
1650077622935,MATH 170A,A02,083460,Nie; Jiawang,0,10,30,30
1650077622935,MATH 170A,A03,083461,Nie; Jiawang,0,11,30,30
1650077628959,MATH 193B,A01,083463,Staff,1,0,30,29
1650077628959,MATH 193B,A02,083464,Staff,8,0,30,22
1650077628959,MATH 193B,A03,083465,Staff,16,0,30,14
1650077635016,COGS 2,A01,083966,Boyle; Mary E. T.,10,0,30,20
1650077641037,COGS 9,A01,083968,Staff,3,0,60,57
1650077647061,COGS 14B,A01,083970,Staff,8,0,50,42
1650077653085,COGS 17,A01,092679,Staff,49,0,75,26
1650077659112,COGS 100,A01,083972,Staff,1,20,60,59
1650077671165,COGS 101C,A01,083976,Staff,12,0,30,18
1650077677200,COGS 102A,A01,083978,Johnson; Christine M.,12,0,30,18
1650077683227,COGS 107B,A01,083980,Staff,0,9,50,50
1650077689253,COGS 115,A01,083982,Staff,9,0,30,21
1650077695275,COGS 118B,A01,083367,Staff,0,16,40,40
1650077701302,COGS 172,A01,083984,Provenzano; Emily Kara,13,0,30,17
1650077707330,COGS 177,A00,083368,Staff,0,22,30,30
1650077713359,COGS 186,A01,083986,Staff,21,0,40,19
1650077719392,COGS 187A,A01,083988,Boyle; Mary E. T.,18,0,60,42
1650077725421,CSE 8A,A50,084003,Miranda; Gregory Joseph,0,18,15,15
1650077731452,CSE 11,A01,084005,Miranda; Gregory Joseph,1,24,55,54
1650077737476,CSE 20,A01,084007,Staff,0,5,20,20
1650077743503,CSE 21,A01,084009,Staff,1,33,50,49
1650077749527,CSE 30,A01,083370,Cao; Yingjun,0,63,40,40
1650077755550,CSE 100,A01,083372,Cao; Yingjun,0,47,40,40
1650077761577,CSE 101,A01,084011,Staff,0,56,40,40
1650077767603,CSE 141,A01,083374,Eldon; John,0,68,75,75
1650077773645,CSE 141L,A01,083376,Eldon; John,0,74,75,75
1650077779671,CSE 175,A01,084013,Kumar; Rakesh,22,0,25,3
1650077785696,CSE 190,A00,092508,Dubnov; Shlomo,18,0,20,2
1650077791720,ECE 5,A01,084049,Morris; Karcher William,12,0,20,8
1650077797743,ECE 100,A01,084051,Baghdadchi; Saharnaz,0,0,20,20
1650077797743,ECE 100,A02,091916,Baghdadchi; Saharnaz,12,0,20,8
1650077803768,ECE 101,A01,084053,Baghdadchi; Saharnaz,0,0,37,37
1650077803768,ECE 101,A02,084054,Baghdadchi; Saharnaz,27,0,37,10
1650077809796,ECE 107,A01,083390,Staff,26,0,40,14
1650077815820,ECE 148,A01,084056,Silberman; Jack,8,0,12,4
1650077821843,ECE 180,A00,083391,Abi Samra; Nicholas Camill,25,0,30,5
1650077821843,ECE 180,B00,083392,Abi Samra; Nicholas Camill,21,0,30,9
1650077827875,MATH 10B,A01,084110,Staff,0,0,30,30
1650077827875,MATH 10B,A02,084111,Staff,17,0,30,13
1650077827875,MATH 10B,A03,084112,Staff,23,0,30,7
1650077833896,MATH 10C,A01,083443,Staff,0,17,30,31
1650077833896,MATH 10C,A02,083444,Staff,1,19,30,29
1650077833896,MATH 10C,B01,084114,Staff,17,0,30,13
1650077833896,MATH 10C,B02,084115,Staff,24,0,30,6
1650077839923,MATH 18,A01,084117,Harel; Guershon,11,0,30,19
1650077839923,MATH 18,A02,084119,Harel; Guershon,27,0,30,3
1650077839923,MATH 18,A03,084120,Harel; Guershon,30,0,30,0
1650077839923,MATH 18,A04,084121,Harel; Guershon,29,0,30,1
1650077845951,MATH 20B,A01,084124,Um; Ko Woon,10,0,35,25
1650077845951,MATH 20B,B01,084126,Um; Ko Woon,24,0,35,11
1650077851983,MATH 20C,A01,083446,Hammock; Frances H,0,0,30,30
1650077851983,MATH 20C,A02,083447,Hammock; Frances H,13,0,30,17
1650077851983,MATH 20C,A03,083448,Hammock; Frances H,18,0,30,12
1650077851983,MATH 20C,A04,083449,Hammock; Frances H,20,0,30,10
1650077851983,MATH 20C,B01,083451,Hammock; Frances H,0,0,30,30
1650077851983,MATH 20C,B02,083452,Hammock; Frances H,15,0,30,15
1650077851983,MATH 20C,B03,083453,Hammock; Frances H,19,0,30,11
1650077851983,MATH 20C,B04,083454,Hammock; Frances H,23,0,30,7
1650077858009,MATH 20D,A01,084128,Staff,13,0,30,17
1650077858009,MATH 20D,A02,084129,Staff,29,0,30,1
1650077858009,MATH 20D,A03,084130,Staff,27,0,30,3
1650077858009,MATH 20D,B01,084133,Staff,0,0,30,30
1650077858009,MATH 20D,B02,084134,Staff,23,0,30,7
1650077858009,MATH 20D,B03,084135,Staff,28,0,30,2
1650077864033,MATH 20E,A01,084138,Staff,13,0,30,17
1650077864033,MATH 20E,A02,084139,Staff,6,0,30,24
1650077864033,MATH 20E,A03,084140,Staff,14,0,30,16
1650077864033,MATH 20E,A04,084141,Staff,19,0,30,11
1650077870060,MATH 102,A01,084143,Harel; Guershon,11,0,30,19
1650077870060,MATH 102,A02,084144,Harel; Guershon,19,0,30,11
1650077876088,MATH 103B,A01,083456,Staff,0,13,30,30
1650077876088,MATH 103B,A02,083457,Staff,0,14,30,30
1650077882117,MATH 109,A01,084146,Salehi Golsefidy; Alireza,16,0,30,14
1650077882117,MATH 109,A02,084147,Salehi Golsefidy; Alireza,15,0,30,15
1650077888144,MATH 120A,A01,085445,Eggers; John Dietrich,7,0,35,28
1650077888144,MATH 120A,A02,085446,Eggers; John Dietrich,26,0,35,9
1650077894167,MATH 142B,A01,084149,Verstraete; Jacques Allan,0,12,30,30
1650077894167,MATH 142B,A02,084150,Verstraete; Jacques Allan,0,12,30,30
1650077900194,MATH 170A,A01,083459,Nie; Jiawang,0,11,30,30
1650077900194,MATH 170A,A02,083460,Nie; Jiawang,0,10,30,30
1650077900194,MATH 170A,A03,083461,Nie; Jiawang,0,11,30,30
1650077906222,MATH 193B,A01,083463,Staff,1,0,30,29
1650077906222,MATH 193B,A02,083464,Staff,8,0,30,22
1650077906222,MATH 193B,A03,083465,Staff,16,0,30,14
1650077912274,COGS 2,A01,083966,Boyle; Mary E. T.,10,0,30,20
1650077918313,COGS 9,A01,083968,Staff,3,0,60,57
1650077924339,COGS 14B,A01,083970,Staff,8,0,50,42
1650077930366,COGS 17,A01,092679,Staff,49,0,75,26
1650077936390,COGS 100,A01,083972,Staff,1,20,60,59
1650077948445,COGS 101C,A01,083976,Staff,12,0,30,18
1650077954472,COGS 102A,A01,083978,Johnson; Christine M.,12,0,30,18
1650077960496,COGS 107B,A01,083980,Staff,0,9,50,50
1650077966524,COGS 115,A01,083982,Staff,9,0,30,21
1650077972547,COGS 118B,A01,083367,Staff,0,16,40,40
1650077978582,COGS 172,A01,083984,Provenzano; Emily Kara,13,0,30,17
1650077984615,COGS 177,A00,083368,Staff,0,22,30,30
1650077990641,COGS 186,A01,083986,Staff,21,0,40,19
1650077996667,COGS 187A,A01,083988,Boyle; Mary E. T.,18,0,60,42
1650078002691,CSE 8A,A50,084003,Miranda; Gregory Joseph,0,18,15,15
1650078008718,CSE 11,A01,084005,Miranda; Gregory Joseph,1,24,55,54
1650078014745,CSE 20,A01,084007,Staff,0,5,20,20
1650078020772,CSE 21,A01,084009,Staff,1,33,50,49
1650078026799,CSE 30,A01,083370,Cao; Yingjun,0,63,40,40
1650078032826,CSE 100,A01,083372,Cao; Yingjun,0,47,40,40
1650078038853,CSE 101,A01,084011,Staff,0,56,40,40
1650078044877,CSE 141,A01,083374,Eldon; John,0,68,75,75
1650078050900,CSE 141L,A01,083376,Eldon; John,0,74,75,75
1650078056927,CSE 175,A01,084013,Kumar; Rakesh,22,0,25,3
1650078062958,CSE 190,A00,092508,Dubnov; Shlomo,18,0,20,2
1650078068982,ECE 5,A01,084049,Morris; Karcher William,12,0,20,8
1650078075006,ECE 100,A01,084051,Baghdadchi; Saharnaz,0,0,20,20
1650078075006,ECE 100,A02,091916,Baghdadchi; Saharnaz,12,0,20,8
1650078081029,ECE 101,A01,084053,Baghdadchi; Saharnaz,0,0,37,37
1650078081029,ECE 101,A02,084054,Baghdadchi; Saharnaz,27,0,37,10
1650078087057,ECE 107,A01,083390,Staff,26,0,40,14
1650078093081,ECE 148,A01,084056,Silberman; Jack,8,0,12,4
1650078099107,ECE 180,A00,083391,Abi Samra; Nicholas Camill,25,0,30,5
1650078099107,ECE 180,B00,083392,Abi Samra; Nicholas Camill,21,0,30,9
1650078105132,MATH 10B,A01,084110,Staff,0,0,30,30
1650078105132,MATH 10B,A02,084111,Staff,17,0,30,13
1650078105132,MATH 10B,A03,084112,Staff,23,0,30,7
1650078111164,MATH 10C,A01,083443,Staff,0,17,30,31
1650078111164,MATH 10C,A02,083444,Staff,1,19,30,29
1650078111164,MATH 10C,B01,084114,Staff,17,0,30,13
1650078111164,MATH 10C,B02,084115,Staff,24,0,30,6
1650078117192,MATH 18,A01,084117,Harel; Guershon,11,0,30,19
1650078117192,MATH 18,A02,084119,Harel; Guershon,27,0,30,3
1650078117192,MATH 18,A03,084120,Harel; Guershon,30,0,30,0
1650078117192,MATH 18,A04,084121,Harel; Guershon,29,0,30,1
1650078123220,MATH 20B,A01,084124,Um; Ko Woon,10,0,35,25
1650078123220,MATH 20B,B01,084126,Um; Ko Woon,24,0,35,11
1650078129244,MATH 20C,A01,083446,Hammock; Frances H,0,0,30,30
1650078129244,MATH 20C,A02,083447,Hammock; Frances H,13,0,30,17
1650078129244,MATH 20C,A03,083448,Hammock; Frances H,18,0,30,12
1650078129244,MATH 20C,A04,083449,Hammock; Frances H,20,0,30,10
1650078129244,MATH 20C,B01,083451,Hammock; Frances H,0,0,30,30
1650078129244,MATH 20C,B02,083452,Hammock; Frances H,15,0,30,15
1650078129244,MATH 20C,B03,083453,Hammock; Frances H,19,0,30,11
1650078129244,MATH 20C,B04,083454,Hammock; Frances H,23,0,30,7
1650078135276,MATH 20D,A01,084128,Staff,13,0,30,17
1650078135276,MATH 20D,A02,084129,Staff,29,0,30,1
1650078135276,MATH 20D,A03,084130,Staff,27,0,30,3
1650078135276,MATH 20D,B01,084133,Staff,0,0,30,30
1650078135276,MATH 20D,B02,084134,Staff,23,0,30,7
1650078135276,MATH 20D,B03,084135,Staff,28,0,30,2
1650078141302,MATH 20E,A01,084138,Staff,13,0,30,17
1650078141302,MATH 20E,A02,084139,Staff,6,0,30,24
1650078141302,MATH 20E,A03,084140,Staff,14,0,30,16
1650078141302,MATH 20E,A04,084141,Staff,19,0,30,11
1650078147325,MATH 102,A01,084143,Harel; Guershon,11,0,30,19
1650078147325,MATH 102,A02,084144,Harel; Guershon,19,0,30,11
1650078153347,MATH 103B,A01,083456,Staff,0,13,30,30
1650078153347,MATH 103B,A02,083457,Staff,0,14,30,30
1650078159374,MATH 109,A01,084146,Salehi Golsefidy; Alireza,16,0,30,14
1650078159374,MATH 109,A02,084147,Salehi Golsefidy; Alireza,15,0,30,15
1650078165397,MATH 120A,A01,085445,Eggers; John Dietrich,7,0,35,28
1650078165397,MATH 120A,A02,085446,Eggers; John Dietrich,26,0,35,9
1650078171519,MATH 142B,A01,084149,Verstraete; Jacques Allan,0,12,30,30
1650078171519,MATH 142B,A02,084150,Verstraete; Jacques Allan,0,12,30,30
1650078177546,MATH 170A,A01,083459,Nie; Jiawang,0,11,30,30
1650078177546,MATH 170A,A02,083460,Nie; Jiawang,0,10,30,30
1650078177546,MATH 170A,A03,083461,Nie; Jiawang,0,11,30,30
1650078183583,MATH 193B,A01,083463,Staff,1,0,30,29
1650078183583,MATH 193B,A02,083464,Staff,8,0,30,22
1650078183583,MATH 193B,A03,083465,Staff,16,0,30,14
1650078189633,COGS 2,A01,083966,Boyle; Mary E. T.,10,0,30,20
1650078195661,COGS 9,A01,083968,Staff,3,0,60,57
1650078201686,COGS 14B,A01,083970,Staff,8,0,50,42
1650078207710,COGS 17,A01,092679,Staff,49,0,75,26
1650078213736,COGS 100,A01,083972,Staff,1,20,60,59
1650078225787,COGS 101C,A01,083976,Staff,12,0,30,18
1650078231819,COGS 102A,A01,083978,Johnson; Christine M.,12,0,30,18
1650078237845,COGS 107B,A01,083980,Staff,0,9,50,50
1650078243873,COGS 115,A01,083982,Staff,9,0,30,21
1650078249903,COGS 118B,A01,083367,Staff,0,16,40,40
1650078255930,COGS 172,A01,083984,Provenzano; Emily Kara,13,0,30,17
1650078261965,COGS 177,A00,083368,Staff,0,22,30,30
1650078267995,COGS 186,A01,083986,Staff,21,0,40,19
1650078274022,COGS 187A,A01,083988,Boyle; Mary E. T.,18,0,60,42
1650078280046,CSE 8A,A50,084003,Miranda; Gregory Joseph,0,18,15,15
1650078286069,CSE 11,A01,084005,Miranda; Gregory Joseph,1,24,55,54
1650078292094,CSE 20,A01,084007,Staff,0,5,20,20
1650078298116,CSE 21,A01,084009,Staff,1,33,50,49
1650078304141,CSE 30,A01,083370,Cao; Yingjun,0,63,40,40
1650078310172,CSE 100,A01,083372,Cao; Yingjun,0,47,40,40
1650078316198,CSE 101,A01,084011,Staff,0,56,40,40
1650078322223,CSE 141,A01,083374,Eldon; John,0,68,75,75
1650078328249,CSE 141L,A01,083376,Eldon; John,0,74,75,75
1650078334275,CSE 175,A01,084013,Kumar; Rakesh,22,0,25,3
1650078340306,CSE 190,A00,092508,Dubnov; Shlomo,18,0,20,2
1650078346330,ECE 5,A01,084049,Morris; Karcher William,12,0,20,8
1650078352354,ECE 100,A01,084051,Baghdadchi; Saharnaz,0,0,20,20
1650078352354,ECE 100,A02,091916,Baghdadchi; Saharnaz,12,0,20,8
1650078358378,ECE 101,A01,084053,Baghdadchi; Saharnaz,0,0,37,37
1650078358378,ECE 101,A02,084054,Baghdadchi; Saharnaz,27,0,37,10
1650078364406,ECE 107,A01,083390,Staff,26,0,40,14
1650078370432,ECE 148,A01,084056,Silberman; Jack,8,0,12,4
1650078376462,ECE 180,A00,083391,Abi Samra; Nicholas Camill,25,0,30,5
1650078376462,ECE 180,B00,083392,Abi Samra; Nicholas Camill,21,0,30,9
1650078382487,MATH 10B,A01,084110,Staff,0,0,30,30
1650078382487,MATH 10B,A02,084111,Staff,17,0,30,13
1650078382487,MATH 10B,A03,084112,Staff,23,0,30,7
1650078388514,MATH 10C,A01,083443,Staff,0,17,30,31
1650078388514,MATH 10C,A02,083444,Staff,1,19,30,29
1650078388514,MATH 10C,B01,084114,Staff,17,0,30,13
1650078388514,MATH 10C,B02,084115,Staff,24,0,30,6
1650078394543,MATH 18,A01,084117,Harel; Guershon,11,0,30,19
1650078394543,MATH 18,A02,084119,Harel; Guershon,27,0,30,3
1650078394543,MATH 18,A03,084120,Harel; Guershon,30,0,30,0
1650078394543,MATH 18,A04,084121,Harel; Guershon,29,0,30,1
1650078400567,MATH 20B,A01,084124,Um; Ko Woon,10,0,35,25
1650078400567,MATH 20B,B01,084126,Um; Ko Woon,24,0,35,11
1650078406591,MATH 20C,A01,083446,Hammock; Frances H,0,0,30,30
1650078406591,MATH 20C,A02,083447,Hammock; Frances H,13,0,30,17
1650078406591,MATH 20C,A03,083448,Hammock; Frances H,18,0,30,12
1650078406591,MATH 20C,A04,083449,Hammock; Frances H,20,0,30,10
1650078406591,MATH 20C,B01,083451,Hammock; Frances H,0,0,30,30
1650078406591,MATH 20C,B02,083452,Hammock; Frances H,15,0,30,15
1650078406591,MATH 20C,B03,083453,Hammock; Frances H,19,0,30,11
1650078406591,MATH 20C,B04,083454,Hammock; Frances H,23,0,30,7
1650078412614,MATH 20D,A01,084128,Staff,13,0,30,17
1650078412614,MATH 20D,A02,084129,Staff,29,0,30,1
1650078412614,MATH 20D,A03,084130,Staff,27,0,30,3
1650078412614,MATH 20D,B01,084133,Staff,0,0,30,30
1650078412614,MATH 20D,B02,084134,Staff,23,0,30,7
1650078412614,MATH 20D,B03,084135,Staff,28,0,30,2
1650078418639,MATH 20E,A01,084138,Staff,13,0,30,17
1650078418639,MATH 20E,A02,084139,Staff,6,0,30,24
1650078418639,MATH 20E,A03,084140,Staff,14,0,30,16
1650078418639,MATH 20E,A04,084141,Staff,19,0,30,11
1650078424666,MATH 102,A01,084143,Harel; Guershon,11,0,30,19
1650078424666,MATH 102,A02,084144,Harel; Guershon,19,0,30,11
1650078430689,MATH 103B,A01,083456,Staff,0,13,30,30
1650078430689,MATH 103B,A02,083457,Staff,0,14,30,30
1650078436711,MATH 109,A01,084146,Salehi Golsefidy; Alireza,16,0,30,14
1650078436711,MATH 109,A02,084147,Salehi Golsefidy; Alireza,15,0,30,15
1650078442735,MATH 120A,A01,085445,Eggers; John Dietrich,7,0,35,28
1650078442735,MATH 120A,A02,085446,Eggers; John Dietrich,26,0,35,9
1650078448768,MATH 142B,A01,084149,Verstraete; Jacques Allan,0,12,30,30
1650078448768,MATH 142B,A02,084150,Verstraete; Jacques Allan,0,12,30,30
1650078454796,MATH 170A,A01,083459,Nie; Jiawang,0,11,30,30
1650078454796,MATH 170A,A02,083460,Nie; Jiawang,0,10,30,30
1650078454796,MATH 170A,A03,083461,Nie; Jiawang,0,11,30,30
1650078460825,MATH 193B,A01,083463,Staff,1,0,30,29
1650078460825,MATH 193B,A02,083464,Staff,8,0,30,22
1650078460825,MATH 193B,A03,083465,Staff,16,0,30,14
1650078466898,COGS 2,A01,083966,Boyle; Mary E. T.,10,0,30,20
1650078472928,COGS 9,A01,083968,Staff,3,0,60,57
1650078478955,COGS 14B,A01,083970,Staff,8,0,50,42
1650078484981,COGS 17,A01,092679,Staff,49,0,75,26
1650078491007,COGS 100,A01,083972,Staff,1,20,60,59
1650078503058,COGS 101C,A01,083976,Staff,12,0,30,18
1650078509082,COGS 102A,A01,083978,Johnson; Christine M.,12,0,30,18
1650078515117,COGS 107B,A01,083980,Staff,0,9,50,50
1650078521140,COGS 115,A01,083982,Staff,9,0,30,21
1650078527164,COGS 118B,A01,083367,Staff,0,16,40,40
1650078533190,COGS 172,A01,083984,Provenzano; Emily Kara,13,0,30,17
1650078539222,COGS 177,A00,083368,Staff,0,22,30,30
1650078545248,COGS 186,A01,083986,Staff,21,0,40,19
1650078551272,COGS 187A,A01,083988,Boyle; Mary E. T.,18,0,60,42
1650078557296,CSE 8A,A50,084003,Miranda; Gregory Joseph,0,18,15,15
1650078563320,CSE 11,A01,084005,Miranda; Gregory Joseph,1,24,55,54
1650078569344,CSE 20,A01,084007,Staff,0,5,20,20
1650078575373,CSE 21,A01,084009,Staff,1,33,50,49
1650078581396,CSE 30,A01,083370,Cao; Yingjun,0,63,40,40
1650078587424,CSE 100,A01,083372,Cao; Yingjun,0,47,40,40
1650078593450,CSE 101,A01,084011,Staff,0,56,40,40
1650078599473,CSE 141,A01,083374,Eldon; John,0,68,75,75
1650078605505,CSE 141L,A01,083376,Eldon; John,0,74,75,75
1650078611537,CSE 175,A01,084013,Kumar; Rakesh,22,0,25,3
1650078617559,CSE 190,A00,092508,Dubnov; Shlomo,18,0,20,2
1650078623583,ECE 5,A01,084049,Morris; Karcher William,12,0,20,8
1650078629608,ECE 100,A01,084051,Baghdadchi; Saharnaz,0,0,20,20
1650078629608,ECE 100,A02,091916,Baghdadchi; Saharnaz,12,0,20,8
1650078635636,ECE 101,A01,084053,Baghdadchi; Saharnaz,0,0,37,37
1650078635636,ECE 101,A02,084054,Baghdadchi; Saharnaz,27,0,37,10
1650078641661,ECE 107,A01,083390,Staff,26,0,40,14
1650078647684,ECE 148,A01,084056,Silberman; Jack,8,0,12,4
1650078653707,ECE 180,A00,083391,Abi Samra; Nicholas Camill,25,0,30,5
1650078653707,ECE 180,B00,083392,Abi Samra; Nicholas Camill,21,0,30,9
1650078659733,MATH 10B,A01,084110,Staff,0,0,30,30
1650078659733,MATH 10B,A02,084111,Staff,17,0,30,13
1650078659733,MATH 10B,A03,084112,Staff,23,0,30,7
1650078665756,MATH 10C,A01,083443,Staff,0,17,30,31
1650078665756,MATH 10C,A02,083444,Staff,1,19,30,29
1650078665756,MATH 10C,B01,084114,Staff,17,0,30,13
1650078665756,MATH 10C,B02,084115,Staff,24,0,30,6
1650078671780,MATH 18,A01,084117,Harel; Guershon,11,0,30,19
1650078671780,MATH 18,A02,084119,Harel; Guershon,27,0,30,3
1650078671780,MATH 18,A03,084120,Harel; Guershon,30,0,30,0
1650078671780,MATH 18,A04,084121,Harel; Guershon,29,0,30,1
1650078677809,MATH 20B,A01,084124,Um; Ko Woon,10,0,35,25
1650078677809,MATH 20B,B01,084126,Um; Ko Woon,24,0,35,11
1650078683840,MATH 20C,A01,083446,Hammock; Frances H,0,0,30,30
1650078683840,MATH 20C,A02,083447,Hammock; Frances H,13,0,30,17
1650078683840,MATH 20C,A03,083448,Hammock; Frances H,18,0,30,12
1650078683840,MATH 20C,A04,083449,Hammock; Frances H,20,0,30,10
1650078683840,MATH 20C,B01,083451,Hammock; Frances H,0,0,30,30
1650078683840,MATH 20C,B02,083452,Hammock; Frances H,15,0,30,15
1650078683840,MATH 20C,B03,083453,Hammock; Frances H,19,0,30,11
1650078683840,MATH 20C,B04,083454,Hammock; Frances H,23,0,30,7
1650078689862,MATH 20D,A01,084128,Staff,13,0,30,17
1650078689862,MATH 20D,A02,084129,Staff,29,0,30,1
1650078689862,MATH 20D,A03,084130,Staff,27,0,30,3
1650078689862,MATH 20D,B01,084133,Staff,0,0,30,30
1650078689862,MATH 20D,B02,084134,Staff,23,0,30,7
1650078689862,MATH 20D,B03,084135,Staff,28,0,30,2
1650078695888,MATH 20E,A01,084138,Staff,13,0,30,17
1650078695888,MATH 20E,A02,084139,Staff,6,0,30,24
1650078695888,MATH 20E,A03,084140,Staff,14,0,30,16
1650078695888,MATH 20E,A04,084141,Staff,19,0,30,11
1650078701911,MATH 102,A01,084143,Harel; Guershon,11,0,30,19
1650078701911,MATH 102,A02,084144,Harel; Guershon,19,0,30,11
1650078707935,MATH 103B,A01,083456,Staff,0,13,30,30
1650078707935,MATH 103B,A02,083457,Staff,0,14,30,30
1650078713961,MATH 109,A01,084146,Salehi Golsefidy; Alireza,16,0,30,14
1650078713961,MATH 109,A02,084147,Salehi Golsefidy; Alireza,15,0,30,15
1650078719988,MATH 120A,A01,085445,Eggers; John Dietrich,7,0,35,28
1650078719988,MATH 120A,A02,085446,Eggers; John Dietrich,26,0,35,9
1650078726013,MATH 142B,A01,084149,Verstraete; Jacques Allan,0,12,30,30
1650078726013,MATH 142B,A02,084150,Verstraete; Jacques Allan,0,12,30,30
1650078732042,MATH 170A,A01,083459,Nie; Jiawang,0,11,30,30
1650078732042,MATH 170A,A02,083460,Nie; Jiawang,0,10,30,30
1650078732042,MATH 170A,A03,083461,Nie; Jiawang,0,11,30,30
1650078738073,MATH 193B,A01,083463,Staff,1,0,30,29
1650078738073,MATH 193B,A02,083464,Staff,8,0,30,22
1650078738073,MATH 193B,A03,083465,Staff,16,0,30,14
1650078744161,COGS 2,A01,083966,Boyle; Mary E. T.,10,0,30,20
1650078750186,COGS 9,A01,083968,Staff,3,0,60,57
1650078756211,COGS 14B,A01,083970,Staff,8,0,50,42
1650078762329,COGS 17,A01,092679,Staff,49,0,75,26
1650078768358,COGS 100,A01,083972,Staff,1,20,60,59
1650078780407,COGS 101C,A01,083976,Staff,12,0,30,18
1650078786431,COGS 102A,A01,083978,Johnson; Christine M.,12,0,30,18
1650078792466,COGS 107B,A01,083980,Staff,0,9,50,50
1650078798499,COGS 115,A01,083982,Staff,9,0,30,21
1650078804523,COGS 118B,A01,083367,Staff,0,16,40,40
1650078810547,COGS 172,A01,083984,Provenzano; Emily Kara,13,0,30,17
1650078816571,COGS 177,A00,083368,Staff,0,22,30,30
1650078822595,COGS 186,A01,083986,Staff,21,0,40,19
1650078828624,COGS 187A,A01,083988,Boyle; Mary E. T.,18,0,60,42
1650078834652,CSE 8A,A50,084003,Miranda; Gregory Joseph,0,18,15,15
1650078840676,CSE 11,A01,084005,Miranda; Gregory Joseph,1,24,55,54
1650078846705,CSE 20,A01,084007,Staff,0,5,20,20
1650078852729,CSE 21,A01,084009,Staff,1,33,50,49
1650078858753,CSE 30,A01,083370,Cao; Yingjun,0,63,40,40
1650078864776,CSE 100,A01,083372,Cao; Yingjun,0,47,40,40
1650078870803,CSE 101,A01,084011,Staff,0,56,40,40
1650078876829,CSE 141,A01,083374,Eldon; John,0,68,75,75
1650078882868,CSE 141L,A01,083376,Eldon; John,0,74,75,75
1650078888896,CSE 175,A01,084013,Kumar; Rakesh,22,0,25,3
1650078894918,CSE 190,A00,092508,Dubnov; Shlomo,18,0,20,2
1650078900946,ECE 5,A01,084049,Morris; Karcher William,12,0,20,8
1650078906968,ECE 100,A01,084051,Baghdadchi; Saharnaz,0,0,20,20
1650078906968,ECE 100,A02,091916,Baghdadchi; Saharnaz,12,0,20,8
1650078912996,ECE 101,A01,084053,Baghdadchi; Saharnaz,0,0,37,37
1650078912996,ECE 101,A02,084054,Baghdadchi; Saharnaz,27,0,37,10
1650078919020,ECE 107,A01,083390,Staff,26,0,40,14
1650078925048,ECE 148,A01,084056,Silberman; Jack,8,0,12,4
1650078931083,ECE 180,A00,083391,Abi Samra; Nicholas Camill,25,0,30,5
1650078931083,ECE 180,B00,083392,Abi Samra; Nicholas Camill,21,0,30,9
1650078937107,MATH 10B,A01,084110,Staff,0,0,30,30
1650078937107,MATH 10B,A02,084111,Staff,17,0,30,13
1650078937107,MATH 10B,A03,084112,Staff,23,0,30,7
1650078943136,MATH 10C,A01,083443,Staff,0,17,30,31
1650078943136,MATH 10C,A02,083444,Staff,1,19,30,29
1650078943136,MATH 10C,B01,084114,Staff,17,0,30,13
1650078943136,MATH 10C,B02,084115,Staff,24,0,30,6
1650078949165,MATH 18,A01,084117,Harel; Guershon,11,0,30,19
1650078949165,MATH 18,A02,084119,Harel; Guershon,27,0,30,3
1650078949165,MATH 18,A03,084120,Harel; Guershon,30,0,30,0
1650078949165,MATH 18,A04,084121,Harel; Guershon,29,0,30,1
1650078955189,MATH 20B,A01,084124,Um; Ko Woon,10,0,35,25
1650078955189,MATH 20B,B01,084126,Um; Ko Woon,24,0,35,11
1650078961221,MATH 20C,A01,083446,Hammock; Frances H,0,0,30,30
1650078961221,MATH 20C,A02,083447,Hammock; Frances H,13,0,30,17
1650078961221,MATH 20C,A03,083448,Hammock; Frances H,18,0,30,12
1650078961221,MATH 20C,A04,083449,Hammock; Frances H,20,0,30,10
1650078961221,MATH 20C,B01,083451,Hammock; Frances H,0,0,30,30
1650078961221,MATH 20C,B02,083452,Hammock; Frances H,15,0,30,15
1650078961221,MATH 20C,B03,083453,Hammock; Frances H,19,0,30,11
1650078961221,MATH 20C,B04,083454,Hammock; Frances H,23,0,30,7
1650078967246,MATH 20D,A01,084128,Staff,13,0,30,17
1650078967246,MATH 20D,A02,084129,Staff,29,0,30,1
1650078967246,MATH 20D,A03,084130,Staff,27,0,30,3
1650078967246,MATH 20D,B01,084133,Staff,0,0,30,30
1650078967246,MATH 20D,B02,084134,Staff,23,0,30,7
1650078967246,MATH 20D,B03,084135,Staff,28,0,30,2
1650078973275,MATH 20E,A01,084138,Staff,13,0,30,17
1650078973275,MATH 20E,A02,084139,Staff,6,0,30,24
1650078973275,MATH 20E,A03,084140,Staff,14,0,30,16
1650078973275,MATH 20E,A04,084141,Staff,19,0,30,11
1650078979299,MATH 102,A01,084143,Harel; Guershon,11,0,30,19
1650078979299,MATH 102,A02,084144,Harel; Guershon,19,0,30,11
1650078985323,MATH 103B,A01,083456,Staff,0,13,30,30
1650078985323,MATH 103B,A02,083457,Staff,0,14,30,30
1650078991347,MATH 109,A01,084146,Salehi Golsefidy; Alireza,16,0,30,14
1650078991347,MATH 109,A02,084147,Salehi Golsefidy; Alireza,15,0,30,15
1650078997375,MATH 120A,A01,085445,Eggers; John Dietrich,7,0,35,28
1650078997375,MATH 120A,A02,085446,Eggers; John Dietrich,26,0,35,9
1650079003403,MATH 142B,A01,084149,Verstraete; Jacques Allan,0,12,30,30
1650079003403,MATH 142B,A02,084150,Verstraete; Jacques Allan,0,12,30,30
1650079009427,MATH 170A,A01,083459,Nie; Jiawang,0,11,30,30
1650079009427,MATH 170A,A02,083460,Nie; Jiawang,0,10,30,30
1650079009427,MATH 170A,A03,083461,Nie; Jiawang,0,11,30,30
1650079015454,MATH 193B,A01,083463,Staff,1,0,30,29
1650079015454,MATH 193B,A02,083464,Staff,8,0,30,22
1650079015454,MATH 193B,A03,083465,Staff,16,0,30,14
1650079021509,COGS 2,A01,083966,Boyle; Mary E. T.,10,0,30,20
1650079027535,COGS 9,A01,083968,Staff,3,0,60,57
1650079033568,COGS 14B,A01,083970,Staff,8,0,50,42
1650079039593,COGS 17,A01,092679,Staff,49,0,75,26
1650079045620,COGS 100,A01,083972,Staff,1,20,60,59
1650079057669,COGS 101C,A01,083976,Staff,12,0,30,18
1650079063692,COGS 102A,A01,083978,Johnson; Christine M.,12,0,30,18
1650079069717,COGS 107B,A01,083980,Staff,0,9,50,50
1650079075741,COGS 115,A01,083982,Staff,9,0,30,21
1650079081768,COGS 118B,A01,083367,Staff,0,16,40,40
1650079087791,COGS 172,A01,083984,Provenzano; Emily Kara,13,0,30,17
1650079093813,COGS 177,A00,083368,Staff,0,22,30,30
1650079099836,COGS 186,A01,083986,Staff,21,0,40,19
1650079105864,COGS 187A,A01,083988,Boyle; Mary E. T.,18,0,60,42
1650079111895,CSE 8A,A50,084003,Miranda; Gregory Joseph,0,18,15,15
1650079117918,CSE 11,A01,084005,Miranda; Gregory Joseph,1,24,55,54
1650079123959,CSE 20,A01,084007,Staff,0,5,20,20
1650079129983,CSE 21,A01,084009,Staff,1,33,50,49
1650079136009,CSE 30,A01,083370,Cao; Yingjun,0,63,40,40
1650079142036,CSE 100,A01,083372,Cao; Yingjun,0,47,40,40
1650079148060,CSE 101,A01,084011,Staff,0,56,40,40
1650079154088,CSE 141,A01,083374,Eldon; John,0,68,75,75
1650079160111,CSE 141L,A01,083376,Eldon; John,0,74,75,75
1650079166135,CSE 175,A01,084013,Kumar; Rakesh,22,0,25,3
1650079172161,CSE 190,A00,092508,Dubnov; Shlomo,18,0,20,2
1650079178188,ECE 5,A01,084049,Morris; Karcher William,12,0,20,8
1650079184214,ECE 100,A01,084051,Baghdadchi; Saharnaz,0,0,20,20
1650079184214,ECE 100,A02,091916,Baghdadchi; Saharnaz,12,0,20,8
1650079190238,ECE 101,A01,084053,Baghdadchi; Saharnaz,0,0,37,37
1650079190238,ECE 101,A02,084054,Baghdadchi; Saharnaz,27,0,37,10
1650079196268,ECE 107,A01,083390,Staff,26,0,40,14
1650079202292,ECE 148,A01,084056,Silberman; Jack,8,0,12,4
1650079208317,ECE 180,A00,083391,Abi Samra; Nicholas Camill,25,0,30,5
1650079208317,ECE 180,B00,083392,Abi Samra; Nicholas Camill,21,0,30,9
1650079214341,MATH 10B,A01,084110,Staff,0,0,30,30
1650079214341,MATH 10B,A02,084111,Staff,17,0,30,13
1650079214341,MATH 10B,A03,084112,Staff,23,0,30,7
1650079220373,MATH 10C,A01,083443,Staff,0,17,30,31
1650079220373,MATH 10C,A02,083444,Staff,1,19,30,29
1650079220373,MATH 10C,B01,084114,Staff,17,0,30,13
1650079220373,MATH 10C,B02,084115,Staff,24,0,30,6
1650079226402,MATH 18,A01,084117,Harel; Guershon,11,0,30,19
1650079226402,MATH 18,A02,084119,Harel; Guershon,27,0,30,3
1650079226402,MATH 18,A03,084120,Harel; Guershon,30,0,30,0
1650079226402,MATH 18,A04,084121,Harel; Guershon,29,0,30,1
1650079232429,MATH 20B,A01,084124,Um; Ko Woon,10,0,35,25
1650079232429,MATH 20B,B01,084126,Um; Ko Woon,24,0,35,11
1650079238459,MATH 20C,A01,083446,Hammock; Frances H,0,0,30,30
1650079238459,MATH 20C,A02,083447,Hammock; Frances H,13,0,30,17
1650079238459,MATH 20C,A03,083448,Hammock; Frances H,18,0,30,12
1650079238459,MATH 20C,A04,083449,Hammock; Frances H,20,0,30,10
1650079238459,MATH 20C,B01,083451,Hammock; Frances H,0,0,30,30
1650079238459,MATH 20C,B02,083452,Hammock; Frances H,15,0,30,15
1650079238459,MATH 20C,B03,083453,Hammock; Frances H,19,0,30,11
1650079238459,MATH 20C,B04,083454,Hammock; Frances H,23,0,30,7
1650079244483,MATH 20D,A01,084128,Staff,13,0,30,17
1650079244483,MATH 20D,A02,084129,Staff,29,0,30,1
1650079244483,MATH 20D,A03,084130,Staff,27,0,30,3
1650079244483,MATH 20D,B01,084133,Staff,0,0,30,30
1650079244483,MATH 20D,B02,084134,Staff,23,0,30,7
1650079244483,MATH 20D,B03,084135,Staff,28,0,30,2
1650079250511,MATH 20E,A01,084138,Staff,13,0,30,17
1650079250511,MATH 20E,A02,084139,Staff,6,0,30,24
1650079250511,MATH 20E,A03,084140,Staff,14,0,30,16
1650079250511,MATH 20E,A04,084141,Staff,19,0,30,11
1650079256537,MATH 102,A01,084143,Harel; Guershon,11,0,30,19
1650079256537,MATH 102,A02,084144,Harel; Guershon,19,0,30,11
1650079262559,MATH 103B,A01,083456,Staff,0,13,30,30
1650079262559,MATH 103B,A02,083457,Staff,0,14,30,30
1650079268585,MATH 109,A01,084146,Salehi Golsefidy; Alireza,16,0,30,14
1650079268585,MATH 109,A02,084147,Salehi Golsefidy; Alireza,15,0,30,15
1650079274613,MATH 120A,A01,085445,Eggers; John Dietrich,7,0,35,28
1650079274613,MATH 120A,A02,085446,Eggers; John Dietrich,26,0,35,9
1650079280638,MATH 142B,A01,084149,Verstraete; Jacques Allan,0,12,30,30
1650079280638,MATH 142B,A02,084150,Verstraete; Jacques Allan,0,12,30,30
1650079286673,MATH 170A,A01,083459,Nie; Jiawang,0,11,30,30
1650079286673,MATH 170A,A02,083460,Nie; Jiawang,0,10,30,30
1650079286673,MATH 170A,A03,083461,Nie; Jiawang,0,11,30,30
1650079292705,MATH 193B,A01,083463,Staff,1,0,30,29
1650079292705,MATH 193B,A02,083464,Staff,8,0,30,22
1650079292705,MATH 193B,A03,083465,Staff,16,0,30,14
1650079298764,COGS 2,A01,083966,Boyle; Mary E. T.,10,0,30,20
1650079304800,COGS 9,A01,083968,Staff,3,0,60,57
1650079310824,COGS 14B,A01,083970,Staff,8,0,50,42
1650079316856,COGS 17,A01,092679,Staff,49,0,75,26
1650079322891,COGS 100,A01,083972,Staff,1,20,60,59
1650079334945,COGS 101C,A01,083976,Staff,12,0,30,18
1650079340972,COGS 102A,A01,083978,Johnson; Christine M.,12,0,30,18
1650079346994,COGS 107B,A01,083980,Staff,0,9,50,50
1650079353020,COGS 115,A01,083982,Staff,9,0,30,21
1650079359136,COGS 118B,A01,083367,Staff,0,16,40,40
1650079365158,COGS 172,A01,083984,Provenzano; Emily Kara,13,0,30,17
1650079371185,COGS 177,A00,083368,Staff,0,22,30,30
1650079377208,COGS 186,A01,083986,Staff,21,0,40,19
1650079383237,COGS 187A,A01,083988,Boyle; Mary E. T.,18,0,60,42
1650079389260,CSE 8A,A50,084003,Miranda; Gregory Joseph,0,18,15,15
1650079395294,CSE 11,A01,084005,Miranda; Gregory Joseph,1,24,55,54
1650079401324,CSE 20,A01,084007,Staff,0,5,20,20
1650079407350,CSE 21,A01,084009,Staff,1,33,50,49
1650079413372,CSE 30,A01,083370,Cao; Yingjun,0,63,40,40
1650079419395,CSE 100,A01,083372,Cao; Yingjun,0,47,40,40
1650079425426,CSE 101,A01,084011,Staff,0,56,40,40
1650079431463,CSE 141,A01,083374,Eldon; John,0,68,75,75
1650079437504,CSE 141L,A01,083376,Eldon; John,0,74,75,75
1650079443527,CSE 175,A01,084013,Kumar; Rakesh,22,0,25,3
1650079449559,CSE 190,A00,092508,Dubnov; Shlomo,18,0,20,2
1650079455583,ECE 5,A01,084049,Morris; Karcher William,12,0,20,8
1650079461609,ECE 100,A01,084051,Baghdadchi; Saharnaz,0,0,20,20
1650079461609,ECE 100,A02,091916,Baghdadchi; Saharnaz,12,0,20,8
1650079467632,ECE 101,A01,084053,Baghdadchi; Saharnaz,0,0,37,37
1650079467632,ECE 101,A02,084054,Baghdadchi; Saharnaz,27,0,37,10
1650079473656,ECE 107,A01,083390,Staff,26,0,40,14
1650079479689,ECE 148,A01,084056,Silberman; Jack,8,0,12,4
1650079485713,ECE 180,A00,083391,Abi Samra; Nicholas Camill,25,0,30,5
1650079485713,ECE 180,B00,083392,Abi Samra; Nicholas Camill,21,0,30,9
1650079491742,MATH 10B,A01,084110,Staff,0,0,30,30
1650079491742,MATH 10B,A02,084111,Staff,17,0,30,13
1650079491742,MATH 10B,A03,084112,Staff,23,0,30,7
1650079497769,MATH 10C,A01,083443,Staff,0,17,30,31
1650079497769,MATH 10C,A02,083444,Staff,1,19,30,29
1650079497769,MATH 10C,B01,084114,Staff,17,0,30,13
1650079497769,MATH 10C,B02,084115,Staff,24,0,30,6
1650079503798,MATH 18,A01,084117,Harel; Guershon,11,0,30,19
1650079503798,MATH 18,A02,084119,Harel; Guershon,27,0,30,3
1650079503798,MATH 18,A03,084120,Harel; Guershon,30,0,30,0
1650079503798,MATH 18,A04,084121,Harel; Guershon,29,0,30,1
1650079509827,MATH 20B,A01,084124,Um; Ko Woon,10,0,35,25
1650079509827,MATH 20B,B01,084126,Um; Ko Woon,24,0,35,11
1650079515853,MATH 20C,A01,083446,Hammock; Frances H,0,0,30,30
1650079515853,MATH 20C,A02,083447,Hammock; Frances H,13,0,30,17
1650079515853,MATH 20C,A03,083448,Hammock; Frances H,18,0,30,12
1650079515853,MATH 20C,A04,083449,Hammock; Frances H,20,0,30,10
1650079515853,MATH 20C,B01,083451,Hammock; Frances H,0,0,30,30
1650079515853,MATH 20C,B02,083452,Hammock; Frances H,15,0,30,15
1650079515853,MATH 20C,B03,083453,Hammock; Frances H,19,0,30,11
1650079515853,MATH 20C,B04,083454,Hammock; Frances H,23,0,30,7
1650079521877,MATH 20D,A01,084128,Staff,13,0,30,17
1650079521877,MATH 20D,A02,084129,Staff,29,0,30,1
1650079521877,MATH 20D,A03,084130,Staff,27,0,30,3
1650079521877,MATH 20D,B01,084133,Staff,0,0,30,30
1650079521877,MATH 20D,B02,084134,Staff,23,0,30,7
1650079521877,MATH 20D,B03,084135,Staff,28,0,30,2
1650079527905,MATH 20E,A01,084138,Staff,13,0,30,17
1650079527905,MATH 20E,A02,084139,Staff,6,0,30,24
1650079527905,MATH 20E,A03,084140,Staff,14,0,30,16
1650079527905,MATH 20E,A04,084141,Staff,19,0,30,11
1650079533933,MATH 102,A01,084143,Harel; Guershon,11,0,30,19
1650079533933,MATH 102,A02,084144,Harel; Guershon,19,0,30,11
1650079539957,MATH 103B,A01,083456,Staff,0,13,30,30
1650079539957,MATH 103B,A02,083457,Staff,0,14,30,30
1650079545997,MATH 109,A01,084146,Salehi Golsefidy; Alireza,16,0,30,14
1650079545997,MATH 109,A02,084147,Salehi Golsefidy; Alireza,15,0,30,15
1650079552021,MATH 120A,A01,085445,Eggers; John Dietrich,7,0,35,28
1650079552021,MATH 120A,A02,085446,Eggers; John Dietrich,26,0,35,9
1650079558045,MATH 142B,A01,084149,Verstraete; Jacques Allan,0,12,30,30
1650079558045,MATH 142B,A02,084150,Verstraete; Jacques Allan,0,12,30,30
1650079564068,MATH 170A,A01,083459,Nie; Jiawang,0,11,30,30
1650079564068,MATH 170A,A02,083460,Nie; Jiawang,0,10,30,30
1650079564068,MATH 170A,A03,083461,Nie; Jiawang,0,11,30,30
1650079570099,MATH 193B,A01,083463,Staff,1,0,30,29
1650079570099,MATH 193B,A02,083464,Staff,8,0,30,22
1650079570099,MATH 193B,A03,083465,Staff,16,0,30,14
1650079576160,COGS 2,A01,083966,Boyle; Mary E. T.,10,0,30,20
1650079582182,COGS 9,A01,083968,Staff,3,0,60,57
1650079588210,COGS 14B,A01,083970,Staff,8,0,50,42
1650079594237,COGS 17,A01,092679,Staff,49,0,75,26
1650079600261,COGS 100,A01,083972,Staff,1,20,60,59
1650079612308,COGS 101C,A01,083976,Staff,12,0,30,18
1650079618336,COGS 102A,A01,083978,Johnson; Christine M.,11,0,30,19
1650079624366,COGS 107B,A01,083980,Staff,0,9,50,50
1650079630396,COGS 115,A01,083982,Staff,9,0,30,21
1650079636417,COGS 118B,A01,083367,Staff,0,16,40,40
1650079642446,COGS 172,A01,083984,Provenzano; Emily Kara,13,0,30,17
1650079648469,COGS 177,A00,083368,Staff,0,22,30,30
1650079654499,COGS 186,A01,083986,Staff,21,0,40,19
1650079660525,COGS 187A,A01,083988,Boyle; Mary E. T.,18,0,60,42
1650079666549,CSE 8A,A50,084003,Miranda; Gregory Joseph,0,18,15,15
1650079672572,CSE 11,A01,084005,Miranda; Gregory Joseph,1,24,55,54
1650079678599,CSE 20,A01,084007,Staff,0,5,20,20
1650079684622,CSE 21,A01,084009,Staff,1,33,50,49
1650079690646,CSE 30,A01,083370,Cao; Yingjun,0,63,40,40
1650079696671,CSE 100,A01,083372,Cao; Yingjun,0,47,40,40
1650079702696,CSE 101,A01,084011,Staff,0,56,40,40
1650079708721,CSE 141,A01,083374,Eldon; John,0,68,75,75
1650079714759,CSE 141L,A01,083376,Eldon; John,0,74,75,75
1650079720784,CSE 175,A01,084013,Kumar; Rakesh,22,0,25,3
1650079726813,CSE 190,A00,092508,Dubnov; Shlomo,18,0,20,2
1650079732838,ECE 5,A01,084049,Morris; Karcher William,12,0,20,8
1650079738877,ECE 100,A01,084051,Baghdadchi; Saharnaz,0,0,20,20
1650079738877,ECE 100,A02,091916,Baghdadchi; Saharnaz,11,0,20,9
1650079744901,ECE 101,A01,084053,Baghdadchi; Saharnaz,0,0,37,37
1650079744901,ECE 101,A02,084054,Baghdadchi; Saharnaz,27,0,37,10
1650079750926,ECE 107,A01,083390,Staff,26,0,40,14
1650079756949,ECE 148,A01,084056,Silberman; Jack,8,0,12,4
1650079762978,ECE 180,A00,083391,Abi Samra; Nicholas Camill,25,0,30,5
1650079762978,ECE 180,B00,083392,Abi Samra; Nicholas Camill,21,0,30,9
1650079769004,MATH 10B,A01,084110,Staff,0,0,30,30
1650079769004,MATH 10B,A02,084111,Staff,17,0,30,13
1650079769004,MATH 10B,A03,084112,Staff,23,0,30,7
1650079775031,MATH 10C,A01,083443,Staff,0,17,30,31
1650079775031,MATH 10C,A02,083444,Staff,1,19,30,29
1650079775031,MATH 10C,B01,084114,Staff,17,0,30,13
1650079775031,MATH 10C,B02,084115,Staff,24,0,30,6
1650079781061,MATH 18,A01,084117,Harel; Guershon,11,0,30,19
1650079781061,MATH 18,A02,084119,Harel; Guershon,27,0,30,3
1650079781061,MATH 18,A03,084120,Harel; Guershon,30,0,30,0
1650079781061,MATH 18,A04,084121,Harel; Guershon,29,0,30,1
1650079787086,MATH 20B,A01,084124,Um; Ko Woon,10,0,35,25
1650079787086,MATH 20B,B01,084126,Um; Ko Woon,24,0,35,11
1650079793111,MATH 20C,A01,083446,Hammock; Frances H,0,0,30,30
1650079793111,MATH 20C,A02,083447,Hammock; Frances H,13,0,30,17
1650079793111,MATH 20C,A03,083448,Hammock; Frances H,18,0,30,12
1650079793111,MATH 20C,A04,083449,Hammock; Frances H,20,0,30,10
1650079793111,MATH 20C,B01,083451,Hammock; Frances H,0,0,30,30
1650079793111,MATH 20C,B02,083452,Hammock; Frances H,15,0,30,15
1650079793111,MATH 20C,B03,083453,Hammock; Frances H,19,0,30,11
1650079793111,MATH 20C,B04,083454,Hammock; Frances H,23,0,30,7
1650079799135,MATH 20D,A01,084128,Staff,13,0,30,17
1650079799135,MATH 20D,A02,084129,Staff,29,0,30,1
1650079799135,MATH 20D,A03,084130,Staff,27,0,30,3
1650079799135,MATH 20D,B01,084133,Staff,0,0,30,30
1650079799135,MATH 20D,B02,084134,Staff,23,0,30,7
1650079799135,MATH 20D,B03,084135,Staff,28,0,30,2
1650079805159,MATH 20E,A01,084138,Staff,13,0,30,17
1650079805159,MATH 20E,A02,084139,Staff,6,0,30,24
1650079805159,MATH 20E,A03,084140,Staff,14,0,30,16
1650079805159,MATH 20E,A04,084141,Staff,19,0,30,11
1650079811182,MATH 102,A01,084143,Harel; Guershon,11,0,30,19
1650079811182,MATH 102,A02,084144,Harel; Guershon,19,0,30,11
1650079817215,MATH 103B,A01,083456,Staff,0,13,30,30
1650079817215,MATH 103B,A02,083457,Staff,0,14,30,30
1650079823241,MATH 109,A01,084146,Salehi Golsefidy; Alireza,16,0,30,14
1650079823241,MATH 109,A02,084147,Salehi Golsefidy; Alireza,15,0,30,15
1650079829266,MATH 120A,A01,085445,Eggers; John Dietrich,7,0,35,28
1650079829266,MATH 120A,A02,085446,Eggers; John Dietrich,26,0,35,9
1650079835288,MATH 142B,A01,084149,Verstraete; Jacques Allan,0,12,30,30
1650079835288,MATH 142B,A02,084150,Verstraete; Jacques Allan,0,12,30,30
1650079841313,MATH 170A,A01,083459,Nie; Jiawang,0,11,30,30
1650079841313,MATH 170A,A02,083460,Nie; Jiawang,0,10,30,30
1650079841313,MATH 170A,A03,083461,Nie; Jiawang,0,11,30,30
1650079847342,MATH 193B,A01,083463,Staff,1,0,30,29
1650079847342,MATH 193B,A02,083464,Staff,8,0,30,22
1650079847342,MATH 193B,A03,083465,Staff,16,0,30,14
1650079853403,COGS 2,A01,083966,Boyle; Mary E. T.,10,0,30,20
1650079859427,COGS 9,A01,083968,Staff,3,0,60,57
1650079865451,COGS 14B,A01,083970,Staff,8,0,50,42
1650079871475,COGS 17,A01,092679,Staff,49,0,75,26
1650079877503,COGS 100,A01,083972,Staff,1,20,60,59
1650079889560,COGS 101C,A01,083976,Staff,12,0,30,18
1650079895584,COGS 102A,A01,083978,Johnson; Christine M.,11,0,30,19
1650079901631,COGS 107B,A01,083980,Staff,0,9,50,50
1650079907676,COGS 115,A01,083982,Staff,9,0,30,21
1650079913704,COGS 118B,A01,083367,Staff,0,16,40,40
1650079919732,COGS 172,A01,083984,Provenzano; Emily Kara,13,0,30,17
1650079925760,COGS 177,A00,083368,Staff,0,22,30,30
1650079931785,COGS 186,A01,083986,Staff,21,0,40,19
1650079937812,COGS 187A,A01,083988,Boyle; Mary E. T.,17,0,60,43
1650079943837,CSE 8A,A50,084003,Miranda; Gregory Joseph,0,18,15,15
1650079949862,CSE 11,A01,084005,Miranda; Gregory Joseph,1,24,55,54
1650079955974,CSE 20,A01,084007,Staff,0,5,20,20
1650079961997,CSE 21,A01,084009,Staff,1,33,50,49
1650079968032,CSE 30,A01,083370,Cao; Yingjun,0,63,40,40
1650079974059,CSE 100,A01,083372,Cao; Yingjun,0,47,40,40
1650079980085,CSE 101,A01,084011,Staff,0,56,40,40
1650079986112,CSE 141,A01,083374,Eldon; John,0,68,75,75
1650079992139,CSE 141L,A01,083376,Eldon; John,0,74,75,75
1650079998162,CSE 175,A01,084013,Kumar; Rakesh,22,0,25,3
1650080004183,CSE 190,A00,092508,Dubnov; Shlomo,18,0,20,2
1650080010212,ECE 5,A01,084049,Morris; Karcher William,12,0,20,8
1650080016235,ECE 100,A01,084051,Baghdadchi; Saharnaz,0,0,20,20
1650080016235,ECE 100,A02,091916,Baghdadchi; Saharnaz,11,0,20,9
1650080022261,ECE 101,A01,084053,Baghdadchi; Saharnaz,0,0,37,37
1650080022261,ECE 101,A02,084054,Baghdadchi; Saharnaz,27,0,37,10
1650080028287,ECE 107,A01,083390,Staff,26,0,40,14
1650080034321,ECE 148,A01,084056,Silberman; Jack,8,0,12,4
1650080040345,ECE 180,A00,083391,Abi Samra; Nicholas Camill,25,0,30,5
1650080040345,ECE 180,B00,083392,Abi Samra; Nicholas Camill,21,0,30,9
1650080046380,MATH 10B,A01,084110,Staff,0,0,30,30
1650080046380,MATH 10B,A02,084111,Staff,17,0,30,13
1650080046380,MATH 10B,A03,084112,Staff,23,0,30,7
1650080052412,MATH 10C,A01,083443,Staff,0,17,30,31
1650080052412,MATH 10C,A02,083444,Staff,1,19,30,29
1650080052412,MATH 10C,B01,084114,Staff,17,0,30,13
1650080052412,MATH 10C,B02,084115,Staff,24,0,30,6
1650080058441,MATH 18,A01,084117,Harel; Guershon,11,0,30,19
1650080058441,MATH 18,A02,084119,Harel; Guershon,27,0,30,3
1650080058441,MATH 18,A03,084120,Harel; Guershon,30,0,30,0
1650080058441,MATH 18,A04,084121,Harel; Guershon,29,0,30,1
1650080064469,MATH 20B,A01,084124,Um; Ko Woon,10,0,35,25
1650080064469,MATH 20B,B01,084126,Um; Ko Woon,24,0,35,11
1650080070493,MATH 20C,A01,083446,Hammock; Frances H,0,0,30,30
1650080070493,MATH 20C,A02,083447,Hammock; Frances H,13,0,30,17
1650080070493,MATH 20C,A03,083448,Hammock; Frances H,18,0,30,12
1650080070493,MATH 20C,A04,083449,Hammock; Frances H,20,0,30,10
1650080070493,MATH 20C,B01,083451,Hammock; Frances H,0,0,30,30
1650080070493,MATH 20C,B02,083452,Hammock; Frances H,15,0,30,15
1650080070493,MATH 20C,B03,083453,Hammock; Frances H,19,0,30,11
1650080070493,MATH 20C,B04,083454,Hammock; Frances H,23,0,30,7
1650080076518,MATH 20D,A01,084128,Staff,13,0,30,17
1650080076518,MATH 20D,A02,084129,Staff,29,0,30,1
1650080076518,MATH 20D,A03,084130,Staff,27,0,30,3
1650080076518,MATH 20D,B01,084133,Staff,0,0,30,30
1650080076518,MATH 20D,B02,084134,Staff,23,0,30,7
1650080076518,MATH 20D,B03,084135,Staff,28,0,30,2
1650080082542,MATH 20E,A01,084138,Staff,13,0,30,17
1650080082542,MATH 20E,A02,084139,Staff,6,0,30,24
1650080082542,MATH 20E,A03,084140,Staff,14,0,30,16
1650080082542,MATH 20E,A04,084141,Staff,19,0,30,11
1650080088571,MATH 102,A01,084143,Harel; Guershon,11,0,30,19
1650080088571,MATH 102,A02,084144,Harel; Guershon,19,0,30,11
1650080094595,MATH 103B,A01,083456,Staff,0,13,30,30
1650080094595,MATH 103B,A02,083457,Staff,0,14,30,30
1650080100619,MATH 109,A01,084146,Salehi Golsefidy; Alireza,16,0,30,14
1650080100619,MATH 109,A02,084147,Salehi Golsefidy; Alireza,15,0,30,15
1650080106642,MATH 120A,A01,085445,Eggers; John Dietrich,7,0,35,28
1650080106642,MATH 120A,A02,085446,Eggers; John Dietrich,26,0,35,9
1650080112668,MATH 142B,A01,084149,Verstraete; Jacques Allan,0,12,30,30
1650080112668,MATH 142B,A02,084150,Verstraete; Jacques Allan,0,12,30,30
1650080118692,MATH 170A,A01,083459,Nie; Jiawang,0,11,30,30
1650080118692,MATH 170A,A02,083460,Nie; Jiawang,0,10,30,30
1650080118692,MATH 170A,A03,083461,Nie; Jiawang,0,11,30,30
1650080124719,MATH 193B,A01,083463,Staff,1,0,30,29
1650080124719,MATH 193B,A02,083464,Staff,8,0,30,22
1650080124719,MATH 193B,A03,083465,Staff,16,0,30,14
1650080130770,COGS 2,A01,083966,Boyle; Mary E. T.,10,0,30,20
1650080136797,COGS 9,A01,083968,Staff,3,0,60,57
1650080142821,COGS 14B,A01,083970,Staff,8,0,50,42
1650080148845,COGS 17,A01,092679,Staff,49,0,75,26
1650080154873,COGS 100,A01,083972,Staff,1,20,60,59
1650080166925,COGS 101C,A01,083976,Staff,12,0,30,18
1650080172948,COGS 102A,A01,083978,Johnson; Christine M.,11,0,30,19
1650080178975,COGS 107B,A01,083980,Staff,0,9,50,50
1650080185002,COGS 115,A01,083982,Staff,9,0,30,21
1650080191025,COGS 118B,A01,083367,Staff,0,16,40,40
1650080197049,COGS 172,A01,083984,Provenzano; Emily Kara,13,0,30,17
1650080203075,COGS 177,A00,083368,Staff,0,22,30,30
1650080209104,COGS 186,A01,083986,Staff,21,0,40,19
1650080215130,COGS 187A,A01,083988,Boyle; Mary E. T.,17,0,60,43
1650080221154,CSE 8A,A50,084003,Miranda; Gregory Joseph,0,18,15,15
1650080227182,CSE 11,A01,084005,Miranda; Gregory Joseph,1,24,55,54
1650080233209,CSE 20,A01,084007,Staff,0,5,20,20
1650080239236,CSE 21,A01,084009,Staff,1,33,50,49
1650080245260,CSE 30,A01,083370,Cao; Yingjun,0,63,40,40
1650080251287,CSE 100,A01,083372,Cao; Yingjun,0,47,40,40
1650080257314,CSE 101,A01,084011,Staff,0,56,40,40
1650080263337,CSE 141,A01,083374,Eldon; John,0,68,75,75
1650080269365,CSE 141L,A01,083376,Eldon; John,0,74,75,75
1650080275389,CSE 175,A01,084013,Kumar; Rakesh,22,0,25,3
1650080281413,CSE 190,A00,092508,Dubnov; Shlomo,18,0,20,2
1650080287441,ECE 5,A01,084049,Morris; Karcher William,12,0,20,8
1650080293465,ECE 100,A01,084051,Baghdadchi; Saharnaz,0,0,20,20
1650080293465,ECE 100,A02,091916,Baghdadchi; Saharnaz,11,0,20,9
1650080299493,ECE 101,A01,084053,Baghdadchi; Saharnaz,0,0,37,37
1650080299493,ECE 101,A02,084054,Baghdadchi; Saharnaz,27,0,37,10
1650080305517,ECE 107,A01,083390,Staff,26,0,40,14
1650080311546,ECE 148,A01,084056,Silberman; Jack,8,0,12,4
1650080317569,ECE 180,A00,083391,Abi Samra; Nicholas Camill,25,0,30,5
1650080317569,ECE 180,B00,083392,Abi Samra; Nicholas Camill,21,0,30,9
1650080323597,MATH 10B,A01,084110,Staff,0,0,30,30
1650080323597,MATH 10B,A02,084111,Staff,17,0,30,13
1650080323597,MATH 10B,A03,084112,Staff,23,0,30,7
1650080329620,MATH 10C,A01,083443,Staff,0,17,30,31
1650080329620,MATH 10C,A02,083444,Staff,1,19,30,29
1650080329620,MATH 10C,B01,084114,Staff,17,0,30,13
1650080329620,MATH 10C,B02,084115,Staff,24,0,30,6
1650080335645,MATH 18,A01,084117,Harel; Guershon,11,0,30,19
1650080335645,MATH 18,A02,084119,Harel; Guershon,27,0,30,3
1650080335645,MATH 18,A03,084120,Harel; Guershon,30,0,30,0
1650080335645,MATH 18,A04,084121,Harel; Guershon,29,0,30,1
1650080341667,MATH 20B,A01,084124,Um; Ko Woon,10,0,35,25
1650080341667,MATH 20B,B01,084126,Um; Ko Woon,24,0,35,11
1650080347694,MATH 20C,A01,083446,Hammock; Frances H,0,0,30,30
1650080347694,MATH 20C,A02,083447,Hammock; Frances H,13,0,30,17
1650080347694,MATH 20C,A03,083448,Hammock; Frances H,18,0,30,12
1650080347694,MATH 20C,A04,083449,Hammock; Frances H,20,0,30,10
1650080347694,MATH 20C,B01,083451,Hammock; Frances H,0,0,30,30
1650080347694,MATH 20C,B02,083452,Hammock; Frances H,15,0,30,15
1650080347694,MATH 20C,B03,083453,Hammock; Frances H,19,0,30,11
1650080347694,MATH 20C,B04,083454,Hammock; Frances H,23,0,30,7
1650080353722,MATH 20D,A01,084128,Staff,13,0,30,17
1650080353722,MATH 20D,A02,084129,Staff,29,0,30,1
1650080353722,MATH 20D,A03,084130,Staff,27,0,30,3
1650080353722,MATH 20D,B01,084133,Staff,0,0,30,30
1650080353722,MATH 20D,B02,084134,Staff,23,0,30,7
1650080353722,MATH 20D,B03,084135,Staff,28,0,30,2
1650080359749,MATH 20E,A01,084138,Staff,13,0,30,17
1650080359749,MATH 20E,A02,084139,Staff,6,0,30,24
1650080359749,MATH 20E,A03,084140,Staff,14,0,30,16
1650080359749,MATH 20E,A04,084141,Staff,19,0,30,11
1650080365778,MATH 102,A01,084143,Harel; Guershon,11,0,30,19
1650080365778,MATH 102,A02,084144,Harel; Guershon,19,0,30,11
1650080371808,MATH 103B,A01,083456,Staff,0,13,30,30
1650080371808,MATH 103B,A02,083457,Staff,0,14,30,30
1650080377832,MATH 109,A01,084146,Salehi Golsefidy; Alireza,16,0,30,14
1650080377832,MATH 109,A02,084147,Salehi Golsefidy; Alireza,15,0,30,15
1650080383864,MATH 120A,A01,085445,Eggers; John Dietrich,7,0,35,28
1650080383864,MATH 120A,A02,085446,Eggers; John Dietrich,26,0,35,9
1650080389946,MATH 142B,A01,084149,Verstraete; Jacques Allan,0,12,30,30
1650080389946,MATH 142B,A02,084150,Verstraete; Jacques Allan,0,12,30,30
1650080395969,MATH 170A,A01,083459,Nie; Jiawang,0,11,30,30
1650080395969,MATH 170A,A02,083460,Nie; Jiawang,0,10,30,30
1650080395969,MATH 170A,A03,083461,Nie; Jiawang,0,11,30,30
1650080401994,MATH 193B,A01,083463,Staff,1,0,30,29
1650080401994,MATH 193B,A02,083464,Staff,8,0,30,22
1650080401994,MATH 193B,A03,083465,Staff,16,0,30,14
1650080408059,COGS 2,A01,083966,Boyle; Mary E. T.,10,0,30,20
1650080414085,COGS 9,A01,083968,Staff,3,0,60,57
1650080420106,COGS 14B,A01,083970,Staff,8,0,50,42
1650080426131,COGS 17,A01,092679,Staff,49,0,75,26
1650080432157,COGS 100,A01,083972,Staff,1,20,60,59
1650080444216,COGS 101C,A01,083976,Staff,12,0,30,18
1650080450253,COGS 102A,A01,083978,Johnson; Christine M.,11,0,30,19
1650080456287,COGS 107B,A01,083980,Staff,0,9,50,50
1650080462315,COGS 115,A01,083982,Staff,9,0,30,21
1650080468342,COGS 118B,A01,083367,Staff,0,16,40,40
1650080474380,COGS 172,A01,083984,Provenzano; Emily Kara,12,0,30,18
1650080480403,COGS 177,A00,083368,Staff,0,22,30,30
1650080486428,COGS 186,A01,083986,Staff,21,0,40,19
1650080492451,COGS 187A,A01,083988,Boyle; Mary E. T.,17,0,60,43
1650080498475,CSE 8A,A50,084003,Miranda; Gregory Joseph,0,18,15,15
1650080504500,CSE 11,A01,084005,Miranda; Gregory Joseph,1,24,55,54
1650080510523,CSE 20,A01,084007,Staff,0,5,20,20
1650080516549,CSE 21,A01,084009,Staff,1,33,50,49
1650080522575,CSE 30,A01,083370,Cao; Yingjun,0,63,40,40
1650080528603,CSE 100,A01,083372,Cao; Yingjun,0,47,40,40
1650080534627,CSE 101,A01,084011,Staff,0,56,40,40
1650080540651,CSE 141,A01,083374,Eldon; John,0,68,75,75
1650080546679,CSE 141L,A01,083376,Eldon; John,0,74,75,75
1650080552791,CSE 175,A01,084013,Kumar; Rakesh,22,0,25,3
1650080558831,CSE 190,A00,092508,Dubnov; Shlomo,18,0,20,2
1650080564856,ECE 5,A01,084049,Morris; Karcher William,12,0,20,8
1650080570897,ECE 100,A01,084051,Baghdadchi; Saharnaz,0,0,20,20
1650080570897,ECE 100,A02,091916,Baghdadchi; Saharnaz,11,0,20,9
1650080576921,ECE 101,A01,084053,Baghdadchi; Saharnaz,0,0,37,37
1650080576921,ECE 101,A02,084054,Baghdadchi; Saharnaz,27,0,37,10
1650080582944,ECE 107,A01,083390,Staff,26,0,40,14
1650080588967,ECE 148,A01,084056,Silberman; Jack,8,0,12,4
1650080594993,ECE 180,A00,083391,Abi Samra; Nicholas Camill,25,0,30,5
1650080594993,ECE 180,B00,083392,Abi Samra; Nicholas Camill,21,0,30,9
1650080601016,MATH 10B,A01,084110,Staff,0,0,30,30
1650080601016,MATH 10B,A02,084111,Staff,16,0,30,14
1650080601016,MATH 10B,A03,084112,Staff,23,0,30,7
1650080607039,MATH 10C,A01,083443,Staff,0,17,30,31
1650080607039,MATH 10C,A02,083444,Staff,1,19,30,29
1650080607039,MATH 10C,B01,084114,Staff,17,0,30,13
1650080607039,MATH 10C,B02,084115,Staff,24,0,30,6
1650080613061,MATH 18,A01,084117,Harel; Guershon,11,0,30,19
1650080613061,MATH 18,A02,084119,Harel; Guershon,27,0,30,3
1650080613061,MATH 18,A03,084120,Harel; Guershon,30,0,30,0
1650080613061,MATH 18,A04,084121,Harel; Guershon,29,0,30,1
1650080619095,MATH 20B,A01,084124,Um; Ko Woon,10,0,35,25
1650080619095,MATH 20B,B01,084126,Um; Ko Woon,24,0,35,11
1650080625125,MATH 20C,A01,083446,Hammock; Frances H,0,0,30,30
1650080625125,MATH 20C,A02,083447,Hammock; Frances H,13,0,30,17
1650080625125,MATH 20C,A03,083448,Hammock; Frances H,18,0,30,12
1650080625125,MATH 20C,A04,083449,Hammock; Frances H,20,0,30,10
1650080625125,MATH 20C,B01,083451,Hammock; Frances H,0,0,30,30
1650080625125,MATH 20C,B02,083452,Hammock; Frances H,15,0,30,15
1650080625125,MATH 20C,B03,083453,Hammock; Frances H,19,0,30,11
1650080625125,MATH 20C,B04,083454,Hammock; Frances H,23,0,30,7
1650080631158,MATH 20D,A01,084128,Staff,13,0,30,17
1650080631158,MATH 20D,A02,084129,Staff,29,0,30,1
1650080631158,MATH 20D,A03,084130,Staff,27,0,30,3
1650080631158,MATH 20D,B01,084133,Staff,0,0,30,30
1650080631158,MATH 20D,B02,084134,Staff,23,0,30,7
1650080631158,MATH 20D,B03,084135,Staff,28,0,30,2
1650080637182,MATH 20E,A01,084138,Staff,13,0,30,17
1650080637182,MATH 20E,A02,084139,Staff,6,0,30,24
1650080637182,MATH 20E,A03,084140,Staff,14,0,30,16
1650080637182,MATH 20E,A04,084141,Staff,19,0,30,11
1650080643203,MATH 102,A01,084143,Harel; Guershon,11,0,30,19
1650080643203,MATH 102,A02,084144,Harel; Guershon,19,0,30,11
1650080649234,MATH 103B,A01,083456,Staff,0,13,30,30
1650080649234,MATH 103B,A02,083457,Staff,0,14,30,30
1650080655258,MATH 109,A01,084146,Salehi Golsefidy; Alireza,16,0,30,14
1650080655258,MATH 109,A02,084147,Salehi Golsefidy; Alireza,15,0,30,15
1650080661281,MATH 120A,A01,085445,Eggers; John Dietrich,7,0,35,28
1650080661281,MATH 120A,A02,085446,Eggers; John Dietrich,26,0,35,9
1650080667313,MATH 142B,A01,084149,Verstraete; Jacques Allan,0,12,30,30
1650080667313,MATH 142B,A02,084150,Verstraete; Jacques Allan,0,12,30,30
1650080673339,MATH 170A,A01,083459,Nie; Jiawang,0,11,30,30
1650080673339,MATH 170A,A02,083460,Nie; Jiawang,0,10,30,30
1650080673339,MATH 170A,A03,083461,Nie; Jiawang,0,11,30,30
1650080679367,MATH 193B,A01,083463,Staff,1,0,30,29
1650080679367,MATH 193B,A02,083464,Staff,8,0,30,22
1650080679367,MATH 193B,A03,083465,Staff,16,0,30,14
1650080685417,COGS 2,A01,083966,Boyle; Mary E. T.,10,0,30,20
1650080691440,COGS 9,A01,083968,Staff,3,0,60,57
1650080697464,COGS 14B,A01,083970,Staff,8,0,50,42
1650080703488,COGS 17,A01,092679,Staff,49,0,75,26
1650080709519,COGS 100,A01,083972,Staff,1,20,60,59
1650080721568,COGS 101C,A01,083976,Staff,12,0,30,18
1650080727594,COGS 102A,A01,083978,Johnson; Christine M.,11,0,30,19
1650080733618,COGS 107B,A01,083980,Staff,0,9,50,50
1650080739643,COGS 115,A01,083982,Staff,9,0,30,21
1650080745667,COGS 118B,A01,083367,Staff,0,16,40,40
1650080751697,COGS 172,A01,083984,Provenzano; Emily Kara,12,0,30,18
1650080757725,COGS 177,A00,083368,Staff,0,22,30,30
1650080763748,COGS 186,A01,083986,Staff,21,0,40,19
1650080769772,COGS 187A,A01,083988,Boyle; Mary E. T.,17,0,60,43
1650080775796,CSE 8A,A50,084003,Miranda; Gregory Joseph,0,18,15,15
1650080781820,CSE 11,A01,084005,Miranda; Gregory Joseph,1,24,55,54
1650080787844,CSE 20,A01,084007,Staff,0,5,20,20
1650080793870,CSE 21,A01,084009,Staff,1,33,50,49
1650080799899,CSE 30,A01,083370,Cao; Yingjun,0,63,40,40
1650080805922,CSE 100,A01,083372,Cao; Yingjun,0,47,40,40
1650080811946,CSE 101,A01,084011,Staff,0,56,40,40
1650080817971,CSE 141,A01,083374,Eldon; John,0,68,75,75
1650080823995,CSE 141L,A01,083376,Eldon; John,0,74,75,75
1650080830022,CSE 175,A01,084013,Kumar; Rakesh,22,0,25,3
1650080836048,CSE 190,A00,092508,Dubnov; Shlomo,18,0,20,2
1650080842082,ECE 5,A01,084049,Morris; Karcher William,12,0,20,8
1650080848109,ECE 100,A01,084051,Baghdadchi; Saharnaz,0,0,20,20
1650080848109,ECE 100,A02,091916,Baghdadchi; Saharnaz,11,0,20,9
1650080854130,ECE 101,A01,084053,Baghdadchi; Saharnaz,0,0,37,37
1650080854130,ECE 101,A02,084054,Baghdadchi; Saharnaz,27,0,37,10
1650080860154,ECE 107,A01,083390,Staff,26,0,40,14
1650080866181,ECE 148,A01,084056,Silberman; Jack,8,0,12,4
1650080872207,ECE 180,A00,083391,Abi Samra; Nicholas Camill,25,0,30,5
1650080872207,ECE 180,B00,083392,Abi Samra; Nicholas Camill,21,0,30,9
1650080878230,MATH 10B,A01,084110,Staff,0,0,30,30
1650080878230,MATH 10B,A02,084111,Staff,16,0,30,14
1650080878230,MATH 10B,A03,084112,Staff,23,0,30,7
1650080884259,MATH 10C,A01,083443,Staff,0,17,30,31
1650080884259,MATH 10C,A02,083444,Staff,1,19,30,29
1650080884259,MATH 10C,B01,084114,Staff,17,0,30,13
1650080884259,MATH 10C,B02,084115,Staff,24,0,30,6
1650080890283,MATH 18,A01,084117,Harel; Guershon,11,0,30,19
1650080890283,MATH 18,A02,084119,Harel; Guershon,27,0,30,3
1650080890283,MATH 18,A03,084120,Harel; Guershon,30,0,30,0
1650080890283,MATH 18,A04,084121,Harel; Guershon,29,0,30,1
1650080896306,MATH 20B,A01,084124,Um; Ko Woon,10,0,35,25
1650080896306,MATH 20B,B01,084126,Um; Ko Woon,24,0,35,11
1650080902345,MATH 20C,A01,083446,Hammock; Frances H,0,0,30,30
1650080902345,MATH 20C,A02,083447,Hammock; Frances H,13,0,30,17
1650080902345,MATH 20C,A03,083448,Hammock; Frances H,18,0,30,12
1650080902345,MATH 20C,A04,083449,Hammock; Frances H,20,0,30,10
1650080902345,MATH 20C,B01,083451,Hammock; Frances H,0,0,30,30
1650080902345,MATH 20C,B02,083452,Hammock; Frances H,15,0,30,15
1650080902345,MATH 20C,B03,083453,Hammock; Frances H,19,0,30,11
1650080902345,MATH 20C,B04,083454,Hammock; Frances H,23,0,30,7
1650080908374,MATH 20D,A01,084128,Staff,13,0,30,17
1650080908374,MATH 20D,A02,084129,Staff,29,0,30,1
1650080908374,MATH 20D,A03,084130,Staff,27,0,30,3
1650080908374,MATH 20D,B01,084133,Staff,0,0,30,30
1650080908374,MATH 20D,B02,084134,Staff,23,0,30,7
1650080908374,MATH 20D,B03,084135,Staff,28,0,30,2
1650080914402,MATH 20E,A01,084138,Staff,13,0,30,17
1650080914402,MATH 20E,A02,084139,Staff,6,0,30,24
1650080914402,MATH 20E,A03,084140,Staff,14,0,30,16
1650080914402,MATH 20E,A04,084141,Staff,19,0,30,11
1650080920428,MATH 102,A01,084143,Harel; Guershon,11,0,30,19
1650080920428,MATH 102,A02,084144,Harel; Guershon,19,0,30,11
1650080926451,MATH 103B,A01,083456,Staff,0,13,30,30
1650080926451,MATH 103B,A02,083457,Staff,0,14,30,30
1650080932482,MATH 109,A01,084146,Salehi Golsefidy; Alireza,16,0,30,14
1650080932482,MATH 109,A02,084147,Salehi Golsefidy; Alireza,15,0,30,15
1650080938510,MATH 120A,A01,085445,Eggers; John Dietrich,7,0,35,28
1650080938510,MATH 120A,A02,085446,Eggers; John Dietrich,26,0,35,9
1650080944534,MATH 142B,A01,084149,Verstraete; Jacques Allan,0,12,30,30
1650080944534,MATH 142B,A02,084150,Verstraete; Jacques Allan,0,12,30,30
1650080950562,MATH 170A,A01,083459,Nie; Jiawang,0,11,30,30
1650080950562,MATH 170A,A02,083460,Nie; Jiawang,0,10,30,30
1650080950562,MATH 170A,A03,083461,Nie; Jiawang,0,11,30,30
1650080956586,MATH 193B,A01,083463,Staff,1,0,30,29
1650080956586,MATH 193B,A02,083464,Staff,8,0,30,22
1650080956586,MATH 193B,A03,083465,Staff,16,0,30,14
1650080962640,COGS 2,A01,083966,Boyle; Mary E. T.,10,0,30,20
1650080968666,COGS 9,A01,083968,Staff,3,0,60,57
1650080974690,COGS 14B,A01,083970,Staff,8,0,50,42
1650080980718,COGS 17,A01,092679,Staff,49,0,75,26
1650080986745,COGS 100,A01,083972,Staff,1,20,60,59
1650080998792,COGS 101C,A01,083976,Staff,12,0,30,18
1650081004815,COGS 102A,A01,083978,Johnson; Christine M.,11,0,30,19
1650081010843,COGS 107B,A01,083980,Staff,0,9,50,50
1650081016866,COGS 115,A01,083982,Staff,9,0,30,21
1650081022898,COGS 118B,A01,083367,Staff,0,16,40,40
1650081028924,COGS 172,A01,083984,Provenzano; Emily Kara,12,0,30,18
1650081034952,COGS 177,A00,083368,Staff,0,22,30,30
1650081040986,COGS 186,A01,083986,Staff,21,0,40,19
1650081047013,COGS 187A,A01,083988,Boyle; Mary E. T.,17,0,60,43
1650081053036,CSE 8A,A50,084003,Miranda; Gregory Joseph,0,18,15,15
1650081059063,CSE 11,A01,084005,Miranda; Gregory Joseph,1,24,55,54
1650081065088,CSE 20,A01,084007,Staff,0,5,20,20
1650081071117,CSE 21,A01,084009,Staff,1,33,50,49
1650081077140,CSE 30,A01,083370,Cao; Yingjun,0,63,40,40
1650081083164,CSE 100,A01,083372,Cao; Yingjun,0,47,40,40
1650081089197,CSE 101,A01,084011,Staff,0,56,40,40
1650081095222,CSE 141,A01,083374,Eldon; John,0,68,75,75
1650081101249,CSE 141L,A01,083376,Eldon; John,0,74,75,75
1650081107276,CSE 175,A01,084013,Kumar; Rakesh,22,0,25,3
1650081113301,CSE 190,A00,092508,Dubnov; Shlomo,18,0,20,2
1650081119325,ECE 5,A01,084049,Morris; Karcher William,12,0,20,8
1650081125350,ECE 100,A01,084051,Baghdadchi; Saharnaz,0,0,20,20
1650081125350,ECE 100,A02,091916,Baghdadchi; Saharnaz,11,0,20,9
1650081131377,ECE 101,A01,084053,Baghdadchi; Saharnaz,0,0,37,37
1650081131377,ECE 101,A02,084054,Baghdadchi; Saharnaz,27,0,37,10
1650081137405,ECE 107,A01,083390,Staff,26,0,40,14
1650081143432,ECE 148,A01,084056,Silberman; Jack,8,0,12,4
1650081149548,ECE 180,A00,083391,Abi Samra; Nicholas Camill,25,0,30,5
1650081149548,ECE 180,B00,083392,Abi Samra; Nicholas Camill,21,0,30,9
1650081155574,MATH 10B,A01,084110,Staff,0,0,30,30
1650081155574,MATH 10B,A02,084111,Staff,16,0,30,14
1650081155574,MATH 10B,A03,084112,Staff,23,0,30,7
1650081161610,MATH 10C,A01,083443,Staff,0,17,30,31
1650081161610,MATH 10C,A02,083444,Staff,1,19,30,29
1650081161610,MATH 10C,B01,084114,Staff,17,0,30,13
1650081161610,MATH 10C,B02,084115,Staff,24,0,30,6
1650081167648,MATH 18,A01,084117,Harel; Guershon,11,0,30,19
1650081167648,MATH 18,A02,084119,Harel; Guershon,27,0,30,3
1650081167648,MATH 18,A03,084120,Harel; Guershon,30,0,30,0
1650081167648,MATH 18,A04,084121,Harel; Guershon,29,0,30,1
1650081173671,MATH 20B,A01,084124,Um; Ko Woon,10,0,35,25
1650081173671,MATH 20B,B01,084126,Um; Ko Woon,24,0,35,11
1650081179697,MATH 20C,A01,083446,Hammock; Frances H,0,0,30,30
1650081179697,MATH 20C,A02,083447,Hammock; Frances H,13,0,30,17
1650081179697,MATH 20C,A03,083448,Hammock; Frances H,18,0,30,12
1650081179697,MATH 20C,A04,083449,Hammock; Frances H,20,0,30,10
1650081179697,MATH 20C,B01,083451,Hammock; Frances H,0,0,30,30
1650081179697,MATH 20C,B02,083452,Hammock; Frances H,15,0,30,15
1650081179697,MATH 20C,B03,083453,Hammock; Frances H,19,0,30,11
1650081179697,MATH 20C,B04,083454,Hammock; Frances H,23,0,30,7
1650081185722,MATH 20D,A01,084128,Staff,13,0,30,17
1650081185722,MATH 20D,A02,084129,Staff,29,0,30,1
1650081185722,MATH 20D,A03,084130,Staff,27,0,30,3
1650081185722,MATH 20D,B01,084133,Staff,0,0,30,30
1650081185722,MATH 20D,B02,084134,Staff,23,0,30,7
1650081185722,MATH 20D,B03,084135,Staff,28,0,30,2
1650081191748,MATH 20E,A01,084138,Staff,13,0,30,17
1650081191748,MATH 20E,A02,084139,Staff,6,0,30,24
1650081191748,MATH 20E,A03,084140,Staff,14,0,30,16
1650081191748,MATH 20E,A04,084141,Staff,19,0,30,11
1650081197775,MATH 102,A01,084143,Harel; Guershon,11,0,30,19
1650081197775,MATH 102,A02,084144,Harel; Guershon,19,0,30,11
1650081203803,MATH 103B,A01,083456,Staff,0,13,30,30
1650081203803,MATH 103B,A02,083457,Staff,0,14,30,30
1650081209829,MATH 109,A01,084146,Salehi Golsefidy; Alireza,16,0,30,14
1650081209829,MATH 109,A02,084147,Salehi Golsefidy; Alireza,15,0,30,15
1650081215858,MATH 120A,A01,085445,Eggers; John Dietrich,7,0,35,28
1650081215858,MATH 120A,A02,085446,Eggers; John Dietrich,26,0,35,9
1650081221885,MATH 142B,A01,084149,Verstraete; Jacques Allan,0,12,30,30
1650081221885,MATH 142B,A02,084150,Verstraete; Jacques Allan,0,12,30,30
1650081227908,MATH 170A,A01,083459,Nie; Jiawang,0,11,30,30
1650081227908,MATH 170A,A02,083460,Nie; Jiawang,0,10,30,30
1650081227908,MATH 170A,A03,083461,Nie; Jiawang,0,11,30,30
1650081233935,MATH 193B,A01,083463,Staff,1,0,30,29
1650081233935,MATH 193B,A02,083464,Staff,8,0,30,22
1650081233935,MATH 193B,A03,083465,Staff,16,0,30,14
1650081239993,COGS 2,A01,083966,Boyle; Mary E. T.,10,0,30,20
1650081246021,COGS 9,A01,083968,Staff,3,0,60,57
1650081252048,COGS 14B,A01,083970,Staff,8,0,50,42
1650081258072,COGS 17,A01,092679,Staff,49,0,75,26
1650081264095,COGS 100,A01,083972,Staff,1,20,60,59
1650081276149,COGS 101C,A01,083976,Staff,12,0,30,18
1650081282184,COGS 102A,A01,083978,Johnson; Christine M.,11,0,30,19
1650081288206,COGS 107B,A01,083980,Staff,0,9,50,50
1650081294229,COGS 115,A01,083982,Staff,9,0,30,21
1650081300252,COGS 118B,A01,083367,Staff,0,16,40,40
1650081306275,COGS 172,A01,083984,Provenzano; Emily Kara,12,0,30,18
1650081312313,COGS 177,A00,083368,Staff,0,22,30,30
1650081318339,COGS 186,A01,083986,Staff,21,0,40,19
1650081324362,COGS 187A,A01,083988,Boyle; Mary E. T.,17,0,60,43
1650081330389,CSE 8A,A50,084003,Miranda; Gregory Joseph,0,18,15,15
1650081336412,CSE 11,A01,084005,Miranda; Gregory Joseph,1,24,55,54
1650081342436,CSE 20,A01,084007,Staff,0,5,20,20
1650081348458,CSE 21,A01,084009,Staff,1,33,50,49
1650081354484,CSE 30,A01,083370,Cao; Yingjun,0,63,40,40
1650081360512,CSE 100,A01,083372,Cao; Yingjun,0,47,40,40
1650081366540,CSE 101,A01,084011,Staff,0,56,40,40
1650081372564,CSE 141,A01,083374,Eldon; John,0,68,75,75
1650081378587,CSE 141L,A01,083376,Eldon; John,0,74,75,75
1650081384622,CSE 175,A01,084013,Kumar; Rakesh,22,0,25,3
1650081390647,CSE 190,A00,092508,Dubnov; Shlomo,18,0,20,2
1650081396674,ECE 5,A01,084049,Morris; Karcher William,12,0,20,8
1650081402697,ECE 100,A01,084051,Baghdadchi; Saharnaz,0,0,20,20
1650081402697,ECE 100,A02,091916,Baghdadchi; Saharnaz,11,0,20,9
1650081408724,ECE 101,A01,084053,Baghdadchi; Saharnaz,0,0,37,37
1650081408724,ECE 101,A02,084054,Baghdadchi; Saharnaz,27,0,37,10
1650081414759,ECE 107,A01,083390,Staff,26,0,40,14
1650081420785,ECE 148,A01,084056,Silberman; Jack,8,0,12,4
1650081426817,ECE 180,A00,083391,Abi Samra; Nicholas Camill,25,0,30,5
1650081426817,ECE 180,B00,083392,Abi Samra; Nicholas Camill,21,0,30,9
1650081432846,MATH 10B,A01,084110,Staff,0,0,30,30
1650081432846,MATH 10B,A02,084111,Staff,16,0,30,14
1650081432846,MATH 10B,A03,084112,Staff,23,0,30,7
1650081438870,MATH 10C,A01,083443,Staff,0,17,30,31
1650081438870,MATH 10C,A02,083444,Staff,1,19,30,29
1650081438870,MATH 10C,B01,084114,Staff,17,0,30,13
1650081438870,MATH 10C,B02,084115,Staff,24,0,30,6
1650081444895,MATH 18,A01,084117,Harel; Guershon,11,0,30,19
1650081444895,MATH 18,A02,084119,Harel; Guershon,27,0,30,3
1650081444895,MATH 18,A03,084120,Harel; Guershon,30,0,30,0
1650081444895,MATH 18,A04,084121,Harel; Guershon,29,0,30,1
1650081450922,MATH 20B,A01,084124,Um; Ko Woon,10,0,35,25
1650081450922,MATH 20B,B01,084126,Um; Ko Woon,24,0,35,11
1650081456947,MATH 20C,A01,083446,Hammock; Frances H,0,0,30,30
1650081456947,MATH 20C,A02,083447,Hammock; Frances H,13,0,30,17
1650081456947,MATH 20C,A03,083448,Hammock; Frances H,18,0,30,12
1650081456947,MATH 20C,A04,083449,Hammock; Frances H,20,0,30,10
1650081456947,MATH 20C,B01,083451,Hammock; Frances H,0,0,30,30
1650081456947,MATH 20C,B02,083452,Hammock; Frances H,15,0,30,15
1650081456947,MATH 20C,B03,083453,Hammock; Frances H,19,0,30,11
1650081456947,MATH 20C,B04,083454,Hammock; Frances H,23,0,30,7
1650081462977,MATH 20D,A01,084128,Staff,13,0,30,17
1650081462977,MATH 20D,A02,084129,Staff,29,0,30,1
1650081462977,MATH 20D,A03,084130,Staff,27,0,30,3
1650081462977,MATH 20D,B01,084133,Staff,0,0,30,30
1650081462977,MATH 20D,B02,084134,Staff,23,0,30,7
1650081462977,MATH 20D,B03,084135,Staff,28,0,30,2
1650081469002,MATH 20E,A01,084138,Staff,13,0,30,17
1650081469002,MATH 20E,A02,084139,Staff,6,0,30,24
1650081469002,MATH 20E,A03,084140,Staff,14,0,30,16
1650081469002,MATH 20E,A04,084141,Staff,19,0,30,11
1650081475030,MATH 102,A01,084143,Harel; Guershon,11,0,30,19
1650081475030,MATH 102,A02,084144,Harel; Guershon,19,0,30,11
1650081481058,MATH 103B,A01,083456,Staff,0,13,30,30
1650081481058,MATH 103B,A02,083457,Staff,0,14,30,30
1650081487085,MATH 109,A01,084146,Salehi Golsefidy; Alireza,16,0,30,14
1650081487085,MATH 109,A02,084147,Salehi Golsefidy; Alireza,15,0,30,15
1650081493113,MATH 120A,A01,085445,Eggers; John Dietrich,7,0,35,28
1650081493113,MATH 120A,A02,085446,Eggers; John Dietrich,26,0,35,9
1650081499140,MATH 142B,A01,084149,Verstraete; Jacques Allan,0,12,30,30
1650081499140,MATH 142B,A02,084150,Verstraete; Jacques Allan,0,12,30,30
1650081505164,MATH 170A,A01,083459,Nie; Jiawang,0,11,30,30
1650081505164,MATH 170A,A02,083460,Nie; Jiawang,0,10,30,30
1650081505164,MATH 170A,A03,083461,Nie; Jiawang,0,11,30,30
1650081511193,MATH 193B,A01,083463,Staff,1,0,30,29
1650081511193,MATH 193B,A02,083464,Staff,8,0,30,22
1650081511193,MATH 193B,A03,083465,Staff,16,0,30,14
1650081517244,COGS 2,A01,083966,Boyle; Mary E. T.,10,0,30,20
1650081523268,COGS 9,A01,083968,Staff,3,0,60,57
1650081529294,COGS 14B,A01,083970,Staff,8,0,50,42
1650081535329,COGS 17,A01,092679,Staff,49,0,75,26
1650081541354,COGS 100,A01,083972,Staff,1,20,60,59
1650081553407,COGS 101C,A01,083976,Staff,12,0,30,18
1650081559432,COGS 102A,A01,083978,Johnson; Christine M.,11,0,30,19
1650081565460,COGS 107B,A01,083980,Staff,0,9,50,50
1650081571487,COGS 115,A01,083982,Staff,9,0,30,21
1650081577513,COGS 118B,A01,083367,Staff,0,16,40,40
1650081583536,COGS 172,A01,083984,Provenzano; Emily Kara,12,0,30,18
1650081589558,COGS 177,A00,083368,Staff,0,22,30,30
1650081595582,COGS 186,A01,083986,Staff,21,0,40,19
1650081601614,COGS 187A,A01,083988,Boyle; Mary E. T.,17,0,60,43
1650081607638,CSE 8A,A50,084003,Miranda; Gregory Joseph,0,18,15,15
1650081613661,CSE 11,A01,084005,Miranda; Gregory Joseph,1,24,55,54
1650081619683,CSE 20,A01,084007,Staff,0,5,20,20
1650081625707,CSE 21,A01,084009,Staff,1,33,50,49
1650081631731,CSE 30,A01,083370,Cao; Yingjun,0,63,40,40
1650081637754,CSE 100,A01,083372,Cao; Yingjun,0,47,40,40
1650081643781,CSE 101,A01,084011,Staff,0,56,40,40
1650081649817,CSE 141,A01,083374,Eldon; John,0,68,75,75
1650081655846,CSE 141L,A01,083376,Eldon; John,0,74,75,75
1650081661884,CSE 175,A01,084013,Kumar; Rakesh,22,0,25,3
1650081667912,CSE 190,A00,092508,Dubnov; Shlomo,18,0,20,2
1650081673941,ECE 5,A01,084049,Morris; Karcher William,12,0,20,8
1650081679964,ECE 100,A01,084051,Baghdadchi; Saharnaz,0,0,20,20
1650081679964,ECE 100,A02,091916,Baghdadchi; Saharnaz,11,0,20,9
1650081685988,ECE 101,A01,084053,Baghdadchi; Saharnaz,0,0,37,37
1650081685988,ECE 101,A02,084054,Baghdadchi; Saharnaz,27,0,37,10
1650081692012,ECE 107,A01,083390,Staff,26,0,40,14
1650081698047,ECE 148,A01,084056,Silberman; Jack,8,0,12,4
1650081704074,ECE 180,A00,083391,Abi Samra; Nicholas Camill,25,0,30,5
1650081704074,ECE 180,B00,083392,Abi Samra; Nicholas Camill,21,0,30,9
1650081710098,MATH 10B,A01,084110,Staff,0,0,30,30
1650081710098,MATH 10B,A02,084111,Staff,16,0,30,14
1650081710098,MATH 10B,A03,084112,Staff,23,0,30,7
1650081716121,MATH 10C,A01,083443,Staff,0,17,30,31
1650081716121,MATH 10C,A02,083444,Staff,1,19,30,29
1650081716121,MATH 10C,B01,084114,Staff,17,0,30,13
1650081716121,MATH 10C,B02,084115,Staff,24,0,30,6
1650081722148,MATH 18,A01,084117,Harel; Guershon,11,0,30,19
1650081722148,MATH 18,A02,084119,Harel; Guershon,27,0,30,3
1650081722148,MATH 18,A03,084120,Harel; Guershon,30,0,30,0
1650081722148,MATH 18,A04,084121,Harel; Guershon,29,0,30,1
1650081728174,MATH 20B,A01,084124,Um; Ko Woon,10,0,35,25
1650081728174,MATH 20B,B01,084126,Um; Ko Woon,24,0,35,11
1650081734199,MATH 20C,A01,083446,Hammock; Frances H,0,0,30,30
1650081734199,MATH 20C,A02,083447,Hammock; Frances H,13,0,30,17
1650081734199,MATH 20C,A03,083448,Hammock; Frances H,18,0,30,12
1650081734199,MATH 20C,A04,083449,Hammock; Frances H,20,0,30,10
1650081734199,MATH 20C,B01,083451,Hammock; Frances H,0,0,30,30
1650081734199,MATH 20C,B02,083452,Hammock; Frances H,15,0,30,15
1650081734199,MATH 20C,B03,083453,Hammock; Frances H,19,0,30,11
1650081734199,MATH 20C,B04,083454,Hammock; Frances H,23,0,30,7
1650081740225,MATH 20D,A01,084128,Staff,13,0,30,17
1650081740225,MATH 20D,A02,084129,Staff,29,0,30,1
1650081740225,MATH 20D,A03,084130,Staff,27,0,30,3
1650081740225,MATH 20D,B01,084133,Staff,0,0,30,30
1650081740225,MATH 20D,B02,084134,Staff,23,0,30,7
1650081740225,MATH 20D,B03,084135,Staff,28,0,30,2
1650081746347,MATH 20E,A01,084138,Staff,13,0,30,17
1650081746347,MATH 20E,A02,084139,Staff,6,0,30,24
1650081746347,MATH 20E,A03,084140,Staff,14,0,30,16
1650081746347,MATH 20E,A04,084141,Staff,19,0,30,11
1650081752369,MATH 102,A01,084143,Harel; Guershon,11,0,30,19
1650081752369,MATH 102,A02,084144,Harel; Guershon,19,0,30,11
1650081758393,MATH 103B,A01,083456,Staff,0,13,30,30
1650081758393,MATH 103B,A02,083457,Staff,0,14,30,30
1650081764420,MATH 109,A01,084146,Salehi Golsefidy; Alireza,16,0,30,14
1650081764420,MATH 109,A02,084147,Salehi Golsefidy; Alireza,15,0,30,15
1650081770444,MATH 120A,A01,085445,Eggers; John Dietrich,7,0,35,28
1650081770444,MATH 120A,A02,085446,Eggers; John Dietrich,26,0,35,9
1650081776468,MATH 142B,A01,084149,Verstraete; Jacques Allan,0,12,30,30
1650081776468,MATH 142B,A02,084150,Verstraete; Jacques Allan,0,12,30,30
1650081782495,MATH 170A,A01,083459,Nie; Jiawang,0,11,30,30
1650081782495,MATH 170A,A02,083460,Nie; Jiawang,0,10,30,30
1650081782495,MATH 170A,A03,083461,Nie; Jiawang,0,11,30,30
1650081788523,MATH 193B,A01,083463,Staff,1,0,30,29
1650081788523,MATH 193B,A02,083464,Staff,8,0,30,22
1650081788523,MATH 193B,A03,083465,Staff,16,0,30,14
1650081794572,COGS 2,A01,083966,Boyle; Mary E. T.,10,0,30,20
1650081800595,COGS 9,A01,083968,Staff,3,0,60,57
1650081806621,COGS 14B,A01,083970,Staff,8,0,50,42
1650081812648,COGS 17,A01,092679,Staff,49,0,75,26
1650081818675,COGS 100,A01,083972,Staff,1,20,60,59
1650081830728,COGS 101C,A01,083976,Staff,12,0,30,18
1650081836755,COGS 102A,A01,083978,Johnson; Christine M.,11,0,30,19
1650081842778,COGS 107B,A01,083980,Staff,0,9,50,50
1650081848818,COGS 115,A01,083982,Staff,9,0,30,21
1650081854844,COGS 118B,A01,083367,Staff,0,16,40,40
1650081860867,COGS 172,A01,083984,Provenzano; Emily Kara,12,0,30,18
1650081866891,COGS 177,A00,083368,Staff,0,22,30,30
1650081872915,COGS 186,A01,083986,Staff,21,0,40,19
1650081878942,COGS 187A,A01,083988,Boyle; Mary E. T.,17,0,60,43
1650081884970,CSE 8A,A50,084003,Miranda; Gregory Joseph,0,18,15,15
1650081890995,CSE 11,A01,084005,Miranda; Gregory Joseph,1,24,55,54
1650081897040,CSE 20,A01,084007,Staff,0,5,20,20
1650081903065,CSE 21,A01,084009,Staff,1,33,50,49
1650081909089,CSE 30,A01,083370,Cao; Yingjun,0,63,40,40
1650081915115,CSE 100,A01,083372,Cao; Yingjun,0,47,40,40
1650081921139,CSE 101,A01,084011,Staff,0,56,40,40
1650081927172,CSE 141,A01,083374,Eldon; John,0,68,75,75
1650081933200,CSE 141L,A01,083376,Eldon; John,0,74,75,75
1650081939236,CSE 175,A01,084013,Kumar; Rakesh,22,0,25,3
1650081945258,CSE 190,A00,092508,Dubnov; Shlomo,18,0,20,2
1650081951282,ECE 5,A01,084049,Morris; Karcher William,12,0,20,8
1650081957305,ECE 100,A01,084051,Baghdadchi; Saharnaz,0,0,20,20
1650081957305,ECE 100,A02,091916,Baghdadchi; Saharnaz,11,0,20,9
1650081963329,ECE 101,A01,084053,Baghdadchi; Saharnaz,0,0,37,37
1650081963329,ECE 101,A02,084054,Baghdadchi; Saharnaz,27,0,37,10
1650081969352,ECE 107,A01,083390,Staff,26,0,40,14
1650081975382,ECE 148,A01,084056,Silberman; Jack,8,0,12,4
1650081981409,ECE 180,A00,083391,Abi Samra; Nicholas Camill,25,0,30,5
1650081981409,ECE 180,B00,083392,Abi Samra; Nicholas Camill,21,0,30,9
1650081987433,MATH 10B,A01,084110,Staff,0,0,30,30
1650081987433,MATH 10B,A02,084111,Staff,16,0,30,14
1650081987433,MATH 10B,A03,084112,Staff,23,0,30,7
1650081993462,MATH 10C,A01,083443,Staff,0,17,30,31
1650081993462,MATH 10C,A02,083444,Staff,1,19,30,29
1650081993462,MATH 10C,B01,084114,Staff,17,0,30,13
1650081993462,MATH 10C,B02,084115,Staff,24,0,30,6
1650081999490,MATH 18,A01,084117,Harel; Guershon,11,0,30,19
1650081999490,MATH 18,A02,084119,Harel; Guershon,27,0,30,3
1650081999490,MATH 18,A03,084120,Harel; Guershon,30,0,30,0
1650081999490,MATH 18,A04,084121,Harel; Guershon,29,0,30,1
1650082005529,MATH 20B,A01,084124,Um; Ko Woon,10,0,35,25
1650082005529,MATH 20B,B01,084126,Um; Ko Woon,24,0,35,11
1650082011557,MATH 20C,A01,083446,Hammock; Frances H,0,0,30,30
1650082011557,MATH 20C,A02,083447,Hammock; Frances H,13,0,30,17
1650082011557,MATH 20C,A03,083448,Hammock; Frances H,18,0,30,12
1650082011557,MATH 20C,A04,083449,Hammock; Frances H,20,0,30,10
1650082011557,MATH 20C,B01,083451,Hammock; Frances H,0,0,30,30
1650082011557,MATH 20C,B02,083452,Hammock; Frances H,15,0,30,15
1650082011557,MATH 20C,B03,083453,Hammock; Frances H,19,0,30,11
1650082011557,MATH 20C,B04,083454,Hammock; Frances H,23,0,30,7
1650082017582,MATH 20D,A01,084128,Staff,13,0,30,17
1650082017582,MATH 20D,A02,084129,Staff,29,0,30,1
1650082017582,MATH 20D,A03,084130,Staff,27,0,30,3
1650082017582,MATH 20D,B01,084133,Staff,0,0,30,30
1650082017582,MATH 20D,B02,084134,Staff,23,0,30,7
1650082017582,MATH 20D,B03,084135,Staff,28,0,30,2
1650082023611,MATH 20E,A01,084138,Staff,13,0,30,17
1650082023611,MATH 20E,A02,084139,Staff,6,0,30,24
1650082023611,MATH 20E,A03,084140,Staff,14,0,30,16
1650082023611,MATH 20E,A04,084141,Staff,19,0,30,11
1650082029636,MATH 102,A01,084143,Harel; Guershon,11,0,30,19
1650082029636,MATH 102,A02,084144,Harel; Guershon,19,0,30,11
1650082035660,MATH 103B,A01,083456,Staff,0,13,30,30
1650082035660,MATH 103B,A02,083457,Staff,0,14,30,30
1650082041685,MATH 109,A01,084146,Salehi Golsefidy; Alireza,16,0,30,14
1650082041685,MATH 109,A02,084147,Salehi Golsefidy; Alireza,15,0,30,15
1650082047710,MATH 120A,A01,085445,Eggers; John Dietrich,7,0,35,28
1650082047710,MATH 120A,A02,085446,Eggers; John Dietrich,26,0,35,9
1650082053733,MATH 142B,A01,084149,Verstraete; Jacques Allan,0,12,30,30
1650082053733,MATH 142B,A02,084150,Verstraete; Jacques Allan,0,12,30,30
1650082059768,MATH 170A,A01,083459,Nie; Jiawang,0,11,30,30
1650082059768,MATH 170A,A02,083460,Nie; Jiawang,0,10,30,30
1650082059768,MATH 170A,A03,083461,Nie; Jiawang,0,11,30,30
1650082065796,MATH 193B,A01,083463,Staff,1,0,30,29
1650082065796,MATH 193B,A02,083464,Staff,8,0,30,22
1650082065796,MATH 193B,A03,083465,Staff,16,0,30,14
1650082071849,COGS 2,A01,083966,Boyle; Mary E. T.,10,0,30,20
1650082077886,COGS 9,A01,083968,Staff,3,0,60,57
1650082083918,COGS 14B,A01,083970,Staff,8,0,50,42
1650082089954,COGS 17,A01,092679,Staff,49,0,75,26
1650082095978,COGS 100,A01,083972,Staff,1,20,60,59
1650082108025,COGS 101C,A01,083976,Staff,12,0,30,18
1650082114054,COGS 102A,A01,083978,Johnson; Christine M.,11,0,30,19
1650082120083,COGS 107B,A01,083980,Staff,0,9,50,50
1650082126112,COGS 115,A01,083982,Staff,9,0,30,21
1650082132136,COGS 118B,A01,083367,Staff,0,16,40,40
1650082138162,COGS 172,A01,083984,Provenzano; Emily Kara,12,0,30,18
1650082144189,COGS 177,A00,083368,Staff,0,22,30,30
1650082150222,COGS 186,A01,083986,Staff,21,0,40,19
1650082156249,COGS 187A,A01,083988,Boyle; Mary E. T.,17,0,60,43
1650082162273,CSE 8A,A50,084003,Miranda; Gregory Joseph,0,18,15,15
1650082168297,CSE 11,A01,084005,Miranda; Gregory Joseph,1,24,55,54
1650082174322,CSE 20,A01,084007,Staff,0,5,20,20
1650082180349,CSE 21,A01,084009,Staff,1,33,50,49
1650082186379,CSE 30,A01,083370,Cao; Yingjun,0,63,40,40
1650082192407,CSE 100,A01,083372,Cao; Yingjun,0,47,40,40
1650082198430,CSE 101,A01,084011,Staff,0,56,40,40
1650082204459,CSE 141,A01,083374,Eldon; John,0,68,75,75
1650082210484,CSE 141L,A01,083376,Eldon; John,0,74,75,75
1650082216509,CSE 175,A01,084013,Kumar; Rakesh,22,0,25,3
1650082222533,CSE 190,A00,092508,Dubnov; Shlomo,18,0,20,2
1650082228567,ECE 5,A01,084049,Morris; Karcher William,12,0,20,8
1650082234591,ECE 100,A01,084051,Baghdadchi; Saharnaz,0,0,20,20
1650082234591,ECE 100,A02,091916,Baghdadchi; Saharnaz,11,0,20,9
1650082240615,ECE 101,A01,084053,Baghdadchi; Saharnaz,0,0,37,37
1650082240615,ECE 101,A02,084054,Baghdadchi; Saharnaz,27,0,37,10
1650082246642,ECE 107,A01,083390,Staff,26,0,40,14
1650082252667,ECE 148,A01,084056,Silberman; Jack,8,0,12,4
1650082258692,ECE 180,A00,083391,Abi Samra; Nicholas Camill,25,0,30,5
1650082258692,ECE 180,B00,083392,Abi Samra; Nicholas Camill,21,0,30,9
1650082264720,MATH 10B,A01,084110,Staff,0,0,30,30
1650082264720,MATH 10B,A02,084111,Staff,16,0,30,14
1650082264720,MATH 10B,A03,084112,Staff,23,0,30,7
1650082270744,MATH 10C,A01,083443,Staff,0,17,30,31
1650082270744,MATH 10C,A02,083444,Staff,1,19,30,29
1650082270744,MATH 10C,B01,084114,Staff,17,0,30,13
1650082270744,MATH 10C,B02,084115,Staff,24,0,30,6
1650082276772,MATH 18,A01,084117,Harel; Guershon,11,0,30,19
1650082276772,MATH 18,A02,084119,Harel; Guershon,27,0,30,3
1650082276772,MATH 18,A03,084120,Harel; Guershon,30,0,30,0
1650082276772,MATH 18,A04,084121,Harel; Guershon,29,0,30,1
1650082282800,MATH 20B,A01,084124,Um; Ko Woon,10,0,35,25
1650082282800,MATH 20B,B01,084126,Um; Ko Woon,24,0,35,11
1650082288830,MATH 20C,A01,083446,Hammock; Frances H,0,0,30,30
1650082288830,MATH 20C,A02,083447,Hammock; Frances H,13,0,30,17
1650082288830,MATH 20C,A03,083448,Hammock; Frances H,18,0,30,12
1650082288830,MATH 20C,A04,083449,Hammock; Frances H,20,0,30,10
1650082288830,MATH 20C,B01,083451,Hammock; Frances H,0,0,30,30
1650082288830,MATH 20C,B02,083452,Hammock; Frances H,15,0,30,15
1650082288830,MATH 20C,B03,083453,Hammock; Frances H,19,0,30,11
1650082288830,MATH 20C,B04,083454,Hammock; Frances H,23,0,30,7
1650082294855,MATH 20D,A01,084128,Staff,13,0,30,17
1650082294855,MATH 20D,A02,084129,Staff,29,0,30,1
1650082294855,MATH 20D,A03,084130,Staff,27,0,30,3
1650082294855,MATH 20D,B01,084133,Staff,0,0,30,30
1650082294855,MATH 20D,B02,084134,Staff,23,0,30,7
1650082294855,MATH 20D,B03,084135,Staff,28,0,30,2
1650082300882,MATH 20E,A01,084138,Staff,13,0,30,17
1650082300882,MATH 20E,A02,084139,Staff,6,0,30,24
1650082300882,MATH 20E,A03,084140,Staff,14,0,30,16
1650082300882,MATH 20E,A04,084141,Staff,19,0,30,11
1650082306906,MATH 102,A01,084143,Harel; Guershon,11,0,30,19
1650082306906,MATH 102,A02,084144,Harel; Guershon,19,0,30,11
1650082312933,MATH 103B,A01,083456,Staff,0,13,30,30
1650082312933,MATH 103B,A02,083457,Staff,0,14,30,30
1650082318958,MATH 109,A01,084146,Salehi Golsefidy; Alireza,16,0,30,14
1650082318958,MATH 109,A02,084147,Salehi Golsefidy; Alireza,15,0,30,15
1650082324981,MATH 120A,A01,085445,Eggers; John Dietrich,7,0,35,28
1650082324981,MATH 120A,A02,085446,Eggers; John Dietrich,26,0,35,9
1650082331016,MATH 142B,A01,084149,Verstraete; Jacques Allan,0,12,30,30
1650082331016,MATH 142B,A02,084150,Verstraete; Jacques Allan,0,12,30,30
1650082337058,MATH 170A,A01,083459,Nie; Jiawang,0,11,30,30
1650082337058,MATH 170A,A02,083460,Nie; Jiawang,0,10,30,30
1650082337058,MATH 170A,A03,083461,Nie; Jiawang,0,11,30,30
1650082343160,MATH 193B,A01,083463,Staff,1,0,30,29
1650082343160,MATH 193B,A02,083464,Staff,8,0,30,22
1650082343160,MATH 193B,A03,083465,Staff,16,0,30,14
1650082349213,COGS 2,A01,083966,Boyle; Mary E. T.,10,0,30,20
1650082355236,COGS 9,A01,083968,Staff,3,0,60,57
1650082361258,COGS 14B,A01,083970,Staff,8,0,50,42
1650082367282,COGS 17,A01,092679,Staff,49,0,75,26
1650082373304,COGS 100,A01,083972,Staff,1,20,60,59
1650082385357,COGS 101C,A01,083976,Staff,12,0,30,18
1650082391381,COGS 102A,A01,083978,Johnson; Christine M.,11,0,30,19
1650082397408,COGS 107B,A01,083980,Staff,0,9,50,50
1650082403441,COGS 115,A01,083982,Staff,9,0,30,21
1650082409466,COGS 118B,A01,083367,Staff,0,16,40,40
1650082415489,COGS 172,A01,083984,Provenzano; Emily Kara,12,0,30,18
1650082421513,COGS 177,A00,083368,Staff,0,22,30,30
1650082427536,COGS 186,A01,083986,Staff,21,0,40,19
1650082433563,COGS 187A,A01,083988,Boyle; Mary E. T.,17,0,60,43
1650082439591,CSE 8A,A50,084003,Miranda; Gregory Joseph,0,18,15,15
1650082445615,CSE 11,A01,084005,Miranda; Gregory Joseph,1,24,55,54
1650082451639,CSE 20,A01,084007,Staff,0,5,20,20
1650082457665,CSE 21,A01,084009,Staff,1,33,50,49
1650082463693,CSE 30,A01,083370,Cao; Yingjun,0,63,40,40
1650082469720,CSE 100,A01,083372,Cao; Yingjun,0,47,40,40
1650082475744,CSE 101,A01,084011,Staff,0,56,40,40
1650082481783,CSE 141,A01,083374,Eldon; John,0,68,75,75
1650082487817,CSE 141L,A01,083376,Eldon; John,0,74,75,75
1650082493847,CSE 175,A01,084013,Kumar; Rakesh,22,0,25,3
1650082499869,CSE 190,A00,092508,Dubnov; Shlomo,18,0,20,2
1650082505896,ECE 5,A01,084049,Morris; Karcher William,12,0,20,8
1650082511923,ECE 100,A01,084051,Baghdadchi; Saharnaz,0,0,20,20
1650082511923,ECE 100,A02,091916,Baghdadchi; Saharnaz,11,0,20,9
1650082517948,ECE 101,A01,084053,Baghdadchi; Saharnaz,0,0,37,37
1650082517948,ECE 101,A02,084054,Baghdadchi; Saharnaz,27,0,37,10
1650082523973,ECE 107,A01,083390,Staff,26,0,40,14
1650082529998,ECE 148,A01,084056,Silberman; Jack,8,0,12,4
1650082536022,ECE 180,A00,083391,Abi Samra; Nicholas Camill,25,0,30,5
1650082536022,ECE 180,B00,083392,Abi Samra; Nicholas Camill,21,0,30,9
1650082542048,MATH 10B,A01,084110,Staff,0,0,30,30
1650082542048,MATH 10B,A02,084111,Staff,16,0,30,14
1650082542048,MATH 10B,A03,084112,Staff,23,0,30,7
1650082548072,MATH 10C,A01,083443,Staff,0,17,30,31
1650082548072,MATH 10C,A02,083444,Staff,1,19,30,29
1650082548072,MATH 10C,B01,084114,Staff,17,0,30,13
1650082548072,MATH 10C,B02,084115,Staff,24,0,30,6
1650082554097,MATH 18,A01,084117,Harel; Guershon,11,0,30,19
1650082554097,MATH 18,A02,084119,Harel; Guershon,27,0,30,3
1650082554097,MATH 18,A03,084120,Harel; Guershon,30,0,30,0
1650082554097,MATH 18,A04,084121,Harel; Guershon,29,0,30,1
1650082560130,MATH 20B,A01,084124,Um; Ko Woon,10,0,35,25
1650082560130,MATH 20B,B01,084126,Um; Ko Woon,24,0,35,11
1650082566154,MATH 20C,A01,083446,Hammock; Frances H,0,0,30,30
1650082566154,MATH 20C,A02,083447,Hammock; Frances H,13,0,30,17
1650082566154,MATH 20C,A03,083448,Hammock; Frances H,18,0,30,12
1650082566154,MATH 20C,A04,083449,Hammock; Frances H,20,0,30,10
1650082566154,MATH 20C,B01,083451,Hammock; Frances H,0,0,30,30
1650082566154,MATH 20C,B02,083452,Hammock; Frances H,15,0,30,15
1650082566154,MATH 20C,B03,083453,Hammock; Frances H,19,0,30,11
1650082566154,MATH 20C,B04,083454,Hammock; Frances H,23,0,30,7
1650082572181,MATH 20D,A01,084128,Staff,13,0,30,17
1650082572181,MATH 20D,A02,084129,Staff,29,0,30,1
1650082572181,MATH 20D,A03,084130,Staff,27,0,30,3
1650082572181,MATH 20D,B01,084133,Staff,0,0,30,30
1650082572181,MATH 20D,B02,084134,Staff,23,0,30,7
1650082572181,MATH 20D,B03,084135,Staff,28,0,30,2
1650082578204,MATH 20E,A01,084138,Staff,13,0,30,17
1650082578204,MATH 20E,A02,084139,Staff,6,0,30,24
1650082578204,MATH 20E,A03,084140,Staff,14,0,30,16
1650082578204,MATH 20E,A04,084141,Staff,19,0,30,11
1650082584227,MATH 102,A01,084143,Harel; Guershon,11,0,30,19
1650082584227,MATH 102,A02,084144,Harel; Guershon,19,0,30,11
1650082590253,MATH 103B,A01,083456,Staff,0,13,30,30
1650082590253,MATH 103B,A02,083457,Staff,0,14,30,30
1650082596277,MATH 109,A01,084146,Salehi Golsefidy; Alireza,16,0,30,14
1650082596277,MATH 109,A02,084147,Salehi Golsefidy; Alireza,15,0,30,15
1650082602301,MATH 120A,A01,085445,Eggers; John Dietrich,7,0,35,28
1650082602301,MATH 120A,A02,085446,Eggers; John Dietrich,26,0,35,9
1650082608324,MATH 142B,A01,084149,Verstraete; Jacques Allan,0,12,30,30
1650082608324,MATH 142B,A02,084150,Verstraete; Jacques Allan,0,12,30,30
1650082614347,MATH 170A,A01,083459,Nie; Jiawang,0,11,30,30
1650082614347,MATH 170A,A02,083460,Nie; Jiawang,0,10,30,30
1650082614347,MATH 170A,A03,083461,Nie; Jiawang,0,11,30,30
1650082620370,MATH 193B,A01,083463,Staff,1,0,30,29
1650082620370,MATH 193B,A02,083464,Staff,8,0,30,22
1650082620370,MATH 193B,A03,083465,Staff,16,0,30,14
1650082626430,COGS 2,A01,083966,Boyle; Mary E. T.,10,0,30,20
1650082632453,COGS 9,A01,083968,Staff,3,0,60,57
1650082638480,COGS 14B,A01,083970,Staff,8,0,50,42
1650082644504,COGS 17,A01,092679,Staff,49,0,75,26
1650082650531,COGS 100,A01,083972,Staff,1,20,60,59
1650082662581,COGS 101C,A01,083976,Staff,12,0,30,18
1650082668615,COGS 102A,A01,083978,Johnson; Christine M.,11,0,30,19
1650082674639,COGS 107B,A01,083980,Staff,0,9,50,50
1650082680664,COGS 115,A01,083982,Staff,9,0,30,21
1650082686689,COGS 118B,A01,083367,Staff,0,16,40,40
1650082692715,COGS 172,A01,083984,Provenzano; Emily Kara,12,0,30,18
1650082698742,COGS 177,A00,083368,Staff,0,22,30,30
1650082704763,COGS 186,A01,083986,Staff,21,0,40,19
1650082710787,COGS 187A,A01,083988,Boyle; Mary E. T.,17,0,60,43
1650082716814,CSE 8A,A50,084003,Miranda; Gregory Joseph,0,18,15,15
1650082722837,CSE 11,A01,084005,Miranda; Gregory Joseph,1,24,55,54
1650082728861,CSE 20,A01,084007,Staff,0,5,20,20
1650082734888,CSE 21,A01,084009,Staff,1,33,50,49
1650082740917,CSE 30,A01,083370,Cao; Yingjun,0,63,40,40
1650082746940,CSE 100,A01,083372,Cao; Yingjun,0,47,40,40
1650082752967,CSE 101,A01,084011,Staff,0,56,40,40
1650082758990,CSE 141,A01,083374,Eldon; John,0,68,75,75
1650082765012,CSE 141L,A01,083376,Eldon; John,0,74,75,75
1650082771035,CSE 175,A01,084013,Kumar; Rakesh,22,0,25,3
1650082777064,CSE 190,A00,092508,Dubnov; Shlomo,18,0,20,2
1650082783088,ECE 5,A01,084049,Morris; Karcher William,12,0,20,8
1650082789113,ECE 100,A01,084051,Baghdadchi; Saharnaz,0,0,20,20
1650082789113,ECE 100,A02,091916,Baghdadchi; Saharnaz,11,0,20,9
1650082795140,ECE 101,A01,084053,Baghdadchi; Saharnaz,0,0,37,37
1650082795140,ECE 101,A02,084054,Baghdadchi; Saharnaz,27,0,37,10
1650082801165,ECE 107,A01,083390,Staff,26,0,40,14
1650082807189,ECE 148,A01,084056,Silberman; Jack,8,0,12,4
1650082813217,ECE 180,A00,083391,Abi Samra; Nicholas Camill,25,0,30,5
1650082813217,ECE 180,B00,083392,Abi Samra; Nicholas Camill,21,0,30,9
1650082819242,MATH 10B,A01,084110,Staff,0,0,30,30
1650082819242,MATH 10B,A02,084111,Staff,16,0,30,14
1650082819242,MATH 10B,A03,084112,Staff,23,0,30,7
1650082825265,MATH 10C,A01,083443,Staff,0,17,30,31
1650082825265,MATH 10C,A02,083444,Staff,1,19,30,29
1650082825265,MATH 10C,B01,084114,Staff,17,0,30,13
1650082825265,MATH 10C,B02,084115,Staff,24,0,30,6
1650082831288,MATH 18,A01,084117,Harel; Guershon,11,0,30,19
1650082831288,MATH 18,A02,084119,Harel; Guershon,27,0,30,3
1650082831288,MATH 18,A03,084120,Harel; Guershon,30,0,30,0
1650082831288,MATH 18,A04,084121,Harel; Guershon,29,0,30,1
1650082837321,MATH 20B,A01,084124,Um; Ko Woon,10,0,35,25
1650082837321,MATH 20B,B01,084126,Um; Ko Woon,24,0,35,11
1650082843347,MATH 20C,A01,083446,Hammock; Frances H,0,0,30,30
1650082843347,MATH 20C,A02,083447,Hammock; Frances H,13,0,30,17
1650082843347,MATH 20C,A03,083448,Hammock; Frances H,18,0,30,12
1650082843347,MATH 20C,A04,083449,Hammock; Frances H,20,0,30,10
1650082843347,MATH 20C,B01,083451,Hammock; Frances H,0,0,30,30
1650082843347,MATH 20C,B02,083452,Hammock; Frances H,15,0,30,15
1650082843347,MATH 20C,B03,083453,Hammock; Frances H,19,0,30,11
1650082843347,MATH 20C,B04,083454,Hammock; Frances H,23,0,30,7
1650082849390,MATH 20D,A01,084128,Staff,13,0,30,17
1650082849390,MATH 20D,A02,084129,Staff,29,0,30,1
1650082849390,MATH 20D,A03,084130,Staff,27,0,30,3
1650082849390,MATH 20D,B01,084133,Staff,0,0,30,30
1650082849390,MATH 20D,B02,084134,Staff,23,0,30,7
1650082849390,MATH 20D,B03,084135,Staff,28,0,30,2
1650082855416,MATH 20E,A01,084138,Staff,13,0,30,17
1650082855416,MATH 20E,A02,084139,Staff,6,0,30,24
1650082855416,MATH 20E,A03,084140,Staff,14,0,30,16
1650082855416,MATH 20E,A04,084141,Staff,19,0,30,11
1650082861445,MATH 102,A01,084143,Harel; Guershon,11,0,30,19
1650082861445,MATH 102,A02,084144,Harel; Guershon,19,0,30,11
1650082867475,MATH 103B,A01,083456,Staff,0,13,30,30
1650082867475,MATH 103B,A02,083457,Staff,0,14,30,30
1650082873499,MATH 109,A01,084146,Salehi Golsefidy; Alireza,16,0,30,14
1650082873499,MATH 109,A02,084147,Salehi Golsefidy; Alireza,15,0,30,15
1650082879523,MATH 120A,A01,085445,Eggers; John Dietrich,7,0,35,28
1650082879523,MATH 120A,A02,085446,Eggers; John Dietrich,26,0,35,9
1650082885548,MATH 142B,A01,084149,Verstraete; Jacques Allan,0,12,30,30
1650082885548,MATH 142B,A02,084150,Verstraete; Jacques Allan,0,12,30,30
1650082891570,MATH 170A,A01,083459,Nie; Jiawang,0,11,30,30
1650082891570,MATH 170A,A02,083460,Nie; Jiawang,0,10,30,30
1650082891570,MATH 170A,A03,083461,Nie; Jiawang,0,11,30,30
1650082897598,MATH 193B,A01,083463,Staff,1,0,30,29
1650082897598,MATH 193B,A02,083464,Staff,8,0,30,22
1650082897598,MATH 193B,A03,083465,Staff,16,0,30,14
1650082903650,COGS 2,A01,083966,Boyle; Mary E. T.,10,0,30,20
1650082909675,COGS 9,A01,083968,Staff,3,0,60,57
1650082915703,COGS 14B,A01,083970,Staff,8,0,50,42
1650082921740,COGS 17,A01,092679,Staff,49,0,75,26
1650082927768,COGS 100,A01,083972,Staff,1,20,60,59
1650082939942,COGS 101C,A01,083976,Staff,12,0,30,18
1650082945973,COGS 102A,A01,083978,Johnson; Christine M.,11,0,30,19
1650082951995,COGS 107B,A01,083980,Staff,0,9,50,50
1650082958018,COGS 115,A01,083982,Staff,9,0,30,21
1650082964040,COGS 118B,A01,083367,Staff,0,16,40,40
1650082970065,COGS 172,A01,083984,Provenzano; Emily Kara,12,0,30,18
1650082976104,COGS 177,A00,083368,Staff,0,22,30,30
1650082982128,COGS 186,A01,083986,Staff,21,0,40,19
1650082988156,COGS 187A,A01,083988,Boyle; Mary E. T.,17,0,60,43
1650082994184,CSE 8A,A50,084003,Miranda; Gregory Joseph,0,18,15,15
1650083000210,CSE 11,A01,084005,Miranda; Gregory Joseph,1,24,55,54
1650083006236,CSE 20,A01,084007,Staff,0,5,20,20
1650083012260,CSE 21,A01,084009,Staff,1,33,50,49
1650083018287,CSE 30,A01,083370,Cao; Yingjun,0,63,40,40
1650083024317,CSE 100,A01,083372,Cao; Yingjun,0,47,40,40
1650083030341,CSE 101,A01,084011,Staff,0,56,40,40
1650083036369,CSE 141,A01,083374,Eldon; John,0,68,75,75
1650083042393,CSE 141L,A01,083376,Eldon; John,0,74,75,75
1650083048416,CSE 175,A01,084013,Kumar; Rakesh,22,0,25,3
1650083054440,CSE 190,A00,092508,Dubnov; Shlomo,18,0,20,2
1650083060464,ECE 5,A01,084049,Morris; Karcher William,12,0,20,8
1650083066488,ECE 100,A01,084051,Baghdadchi; Saharnaz,0,0,20,20
1650083066488,ECE 100,A02,091916,Baghdadchi; Saharnaz,11,0,20,9
1650083072512,ECE 101,A01,084053,Baghdadchi; Saharnaz,0,0,37,37
1650083072512,ECE 101,A02,084054,Baghdadchi; Saharnaz,27,0,37,10
1650083078545,ECE 107,A01,083390,Staff,26,0,40,14
1650083084576,ECE 148,A01,084056,Silberman; Jack,8,0,12,4
1650083090618,ECE 180,A00,083391,Abi Samra; Nicholas Camill,25,0,30,5
1650083090618,ECE 180,B00,083392,Abi Samra; Nicholas Camill,21,0,30,9
1650083096657,MATH 10B,A01,084110,Staff,0,0,30,30
1650083096657,MATH 10B,A02,084111,Staff,16,0,30,14
1650083096657,MATH 10B,A03,084112,Staff,23,0,30,7
1650083102681,MATH 10C,A01,083443,Staff,0,17,30,31
1650083102681,MATH 10C,A02,083444,Staff,1,19,30,29
1650083102681,MATH 10C,B01,084114,Staff,17,0,30,13
1650083102681,MATH 10C,B02,084115,Staff,24,0,30,6
1650083108705,MATH 18,A01,084117,Harel; Guershon,11,0,30,19
1650083108705,MATH 18,A02,084119,Harel; Guershon,27,0,30,3
1650083108705,MATH 18,A03,084120,Harel; Guershon,30,0,30,0
1650083108705,MATH 18,A04,084121,Harel; Guershon,29,0,30,1
1650083114735,MATH 20B,A01,084124,Um; Ko Woon,10,0,35,25
1650083114735,MATH 20B,B01,084126,Um; Ko Woon,24,0,35,11
1650083120766,MATH 20C,A01,083446,Hammock; Frances H,0,0,30,30
1650083120766,MATH 20C,A02,083447,Hammock; Frances H,13,0,30,17
1650083120766,MATH 20C,A03,083448,Hammock; Frances H,18,0,30,12
1650083120766,MATH 20C,A04,083449,Hammock; Frances H,20,0,30,10
1650083120766,MATH 20C,B01,083451,Hammock; Frances H,0,0,30,30
1650083120766,MATH 20C,B02,083452,Hammock; Frances H,15,0,30,15
1650083120766,MATH 20C,B03,083453,Hammock; Frances H,19,0,30,11
1650083120766,MATH 20C,B04,083454,Hammock; Frances H,23,0,30,7
1650083126795,MATH 20D,A01,084128,Staff,13,0,30,17
1650083126795,MATH 20D,A02,084129,Staff,29,0,30,1
1650083126795,MATH 20D,A03,084130,Staff,27,0,30,3
1650083126795,MATH 20D,B01,084133,Staff,0,0,30,30
1650083126795,MATH 20D,B02,084134,Staff,23,0,30,7
1650083126795,MATH 20D,B03,084135,Staff,28,0,30,2
1650083132822,MATH 20E,A01,084138,Staff,13,0,30,17
1650083132822,MATH 20E,A02,084139,Staff,6,0,30,24
1650083132822,MATH 20E,A03,084140,Staff,14,0,30,16
1650083132822,MATH 20E,A04,084141,Staff,19,0,30,11
1650083138847,MATH 102,A01,084143,Harel; Guershon,11,0,30,19
1650083138847,MATH 102,A02,084144,Harel; Guershon,19,0,30,11
1650083144873,MATH 103B,A01,083456,Staff,0,13,30,30
1650083144873,MATH 103B,A02,083457,Staff,0,14,30,30
1650083150910,MATH 109,A01,084146,Salehi Golsefidy; Alireza,16,0,30,14
1650083150910,MATH 109,A02,084147,Salehi Golsefidy; Alireza,15,0,30,15
1650083156940,MATH 120A,A01,085445,Eggers; John Dietrich,7,0,35,28
1650083156940,MATH 120A,A02,085446,Eggers; John Dietrich,26,0,35,9
1650083162969,MATH 142B,A01,084149,Verstraete; Jacques Allan,0,12,30,30
1650083162969,MATH 142B,A02,084150,Verstraete; Jacques Allan,0,12,30,30
1650083168996,MATH 170A,A01,083459,Nie; Jiawang,0,11,30,30
1650083168996,MATH 170A,A02,083460,Nie; Jiawang,0,10,30,30
1650083168996,MATH 170A,A03,083461,Nie; Jiawang,0,11,30,30
1650083175020,MATH 193B,A01,083463,Staff,1,0,30,29
1650083175020,MATH 193B,A02,083464,Staff,8,0,30,22
1650083175020,MATH 193B,A03,083465,Staff,16,0,30,14
1650083181072,COGS 2,A01,083966,Boyle; Mary E. T.,10,0,30,20
1650083187096,COGS 9,A01,083968,Staff,3,0,60,57
1650083193119,COGS 14B,A01,083970,Staff,8,0,50,42
1650083199152,COGS 17,A01,092679,Staff,49,0,75,26
1650083205173,COGS 100,A01,083972,Staff,1,20,60,59
1650083217221,COGS 101C,A01,083976,Staff,12,0,30,18
1650083223245,COGS 102A,A01,083978,Johnson; Christine M.,11,0,30,19
1650083229283,COGS 107B,A01,083980,Staff,0,9,50,50
1650083235308,COGS 115,A01,083982,Staff,9,0,30,21
1650083241335,COGS 118B,A01,083367,Staff,0,16,40,40
1650083247357,COGS 172,A01,083984,Provenzano; Emily Kara,12,0,30,18
1650083253385,COGS 177,A00,083368,Staff,0,22,30,30
1650083259409,COGS 186,A01,083986,Staff,21,0,40,19
1650083265440,COGS 187A,A01,083988,Boyle; Mary E. T.,17,0,60,43
1650083271465,CSE 8A,A50,084003,Miranda; Gregory Joseph,0,18,15,15
1650083277491,CSE 11,A01,084005,Miranda; Gregory Joseph,1,24,55,54
1650083283515,CSE 20,A01,084007,Staff,0,5,20,20
1650083289542,CSE 21,A01,084009,Staff,1,33,50,49
1650083295566,CSE 30,A01,083370,Cao; Yingjun,0,63,40,40
1650083301590,CSE 100,A01,083372,Cao; Yingjun,0,47,40,40
1650083307618,CSE 101,A01,084011,Staff,0,56,40,40
1650083313642,CSE 141,A01,083374,Eldon; John,0,68,75,75
1650083319666,CSE 141L,A01,083376,Eldon; John,0,74,75,75
1650083325694,CSE 175,A01,084013,Kumar; Rakesh,22,0,25,3
1650083331718,CSE 190,A00,092508,Dubnov; Shlomo,18,0,20,2
1650083337745,ECE 5,A01,084049,Morris; Karcher William,12,0,20,8
1650083343778,ECE 100,A01,084051,Baghdadchi; Saharnaz,0,0,20,20
1650083343778,ECE 100,A02,091916,Baghdadchi; Saharnaz,11,0,20,9
1650083349806,ECE 101,A01,084053,Baghdadchi; Saharnaz,0,0,37,37
1650083349806,ECE 101,A02,084054,Baghdadchi; Saharnaz,27,0,37,10
1650083355830,ECE 107,A01,083390,Staff,26,0,40,14
1650083361852,ECE 148,A01,084056,Silberman; Jack,8,0,12,4
1650083367876,ECE 180,A00,083391,Abi Samra; Nicholas Camill,25,0,30,5
1650083367876,ECE 180,B00,083392,Abi Samra; Nicholas Camill,21,0,30,9
1650083373899,MATH 10B,A01,084110,Staff,0,0,30,30
1650083373899,MATH 10B,A02,084111,Staff,16,0,30,14
1650083373899,MATH 10B,A03,084112,Staff,23,0,30,7
1650083379928,MATH 10C,A01,083443,Staff,0,17,30,31
1650083379928,MATH 10C,A02,083444,Staff,1,19,30,29
1650083379928,MATH 10C,B01,084114,Staff,17,0,30,13
1650083379928,MATH 10C,B02,084115,Staff,24,0,30,6
1650083385954,MATH 18,A01,084117,Harel; Guershon,11,0,30,19
1650083385954,MATH 18,A02,084119,Harel; Guershon,27,0,30,3
1650083385954,MATH 18,A03,084120,Harel; Guershon,30,0,30,0
1650083385954,MATH 18,A04,084121,Harel; Guershon,29,0,30,1
1650083391980,MATH 20B,A01,084124,Um; Ko Woon,10,0,35,25
1650083391980,MATH 20B,B01,084126,Um; Ko Woon,24,0,35,11
1650083398005,MATH 20C,A01,083446,Hammock; Frances H,0,0,30,30
1650083398005,MATH 20C,A02,083447,Hammock; Frances H,13,0,30,17
1650083398005,MATH 20C,A03,083448,Hammock; Frances H,18,0,30,12
1650083398005,MATH 20C,A04,083449,Hammock; Frances H,20,0,30,10
1650083398005,MATH 20C,B01,083451,Hammock; Frances H,0,0,30,30
1650083398005,MATH 20C,B02,083452,Hammock; Frances H,15,0,30,15
1650083398005,MATH 20C,B03,083453,Hammock; Frances H,19,0,30,11
1650083398005,MATH 20C,B04,083454,Hammock; Frances H,23,0,30,7
1650083404033,MATH 20D,A01,084128,Staff,13,0,30,17
1650083404033,MATH 20D,A02,084129,Staff,29,0,30,1
1650083404033,MATH 20D,A03,084130,Staff,27,0,30,3
1650083404033,MATH 20D,B01,084133,Staff,0,0,30,30
1650083404033,MATH 20D,B02,084134,Staff,23,0,30,7
1650083404033,MATH 20D,B03,084135,Staff,28,0,30,2
1650083410061,MATH 20E,A01,084138,Staff,13,0,30,17
1650083410061,MATH 20E,A02,084139,Staff,6,0,30,24
1650083410061,MATH 20E,A03,084140,Staff,14,0,30,16
1650083410061,MATH 20E,A04,084141,Staff,19,0,30,11
1650083416090,MATH 102,A01,084143,Harel; Guershon,11,0,30,19
1650083416090,MATH 102,A02,084144,Harel; Guershon,19,0,30,11
1650083422117,MATH 103B,A01,083456,Staff,0,13,30,30
1650083422117,MATH 103B,A02,083457,Staff,0,14,30,30
1650083428142,MATH 109,A01,084146,Salehi Golsefidy; Alireza,16,0,30,14
1650083428142,MATH 109,A02,084147,Salehi Golsefidy; Alireza,15,0,30,15
1650083434170,MATH 120A,A01,085445,Eggers; John Dietrich,7,0,35,28
1650083434170,MATH 120A,A02,085446,Eggers; John Dietrich,26,0,35,9
1650083440195,MATH 142B,A01,084149,Verstraete; Jacques Allan,0,12,30,30
1650083440195,MATH 142B,A02,084150,Verstraete; Jacques Allan,0,12,30,30
1650083446220,MATH 170A,A01,083459,Nie; Jiawang,0,11,30,30
1650083446220,MATH 170A,A02,083460,Nie; Jiawang,0,10,30,30
1650083446220,MATH 170A,A03,083461,Nie; Jiawang,0,11,30,30
1650083452244,MATH 193B,A01,083463,Staff,1,0,30,29
1650083452244,MATH 193B,A02,083464,Staff,8,0,30,22
1650083452244,MATH 193B,A03,083465,Staff,16,0,30,14
1650083458309,COGS 2,A01,083966,Boyle; Mary E. T.,10,0,30,20
1650083464333,COGS 9,A01,083968,Staff,3,0,60,57
1650083470361,COGS 14B,A01,083970,Staff,8,0,50,42
1650083476386,COGS 17,A01,092679,Staff,49,0,75,26
1650083482412,COGS 100,A01,083972,Staff,1,20,60,59
1650083494461,COGS 101C,A01,083976,Staff,12,0,30,18
1650083500490,COGS 102A,A01,083978,Johnson; Christine M.,11,0,30,19
1650083506513,COGS 107B,A01,083980,Staff,0,9,50,50
1650083512543,COGS 115,A01,083982,Staff,9,0,30,21
1650083518568,COGS 118B,A01,083367,Staff,0,16,40,40
1650083524607,COGS 172,A01,083984,Provenzano; Emily Kara,12,0,30,18
1650083530722,COGS 177,A00,083368,Staff,0,22,30,30
1650083536744,COGS 186,A01,083986,Staff,21,0,40,19
1650083542770,COGS 187A,A01,083988,Boyle; Mary E. T.,17,0,60,43
1650083548802,CSE 8A,A50,084003,Miranda; Gregory Joseph,0,18,15,15
1650083554830,CSE 11,A01,084005,Miranda; Gregory Joseph,1,24,55,54
1650083560863,CSE 20,A01,084007,Staff,0,5,20,20
1650083566891,CSE 21,A01,084009,Staff,1,33,50,49
1650083572915,CSE 30,A01,083370,Cao; Yingjun,0,63,40,40
1650083578939,CSE 100,A01,083372,Cao; Yingjun,0,47,40,40
1650083584964,CSE 101,A01,084011,Staff,0,56,40,40
1650083590991,CSE 141,A01,083374,Eldon; John,0,68,75,75
1650083597019,CSE 141L,A01,083376,Eldon; John,0,74,75,75
1650083603046,CSE 175,A01,084013,Kumar; Rakesh,22,0,25,3
1650083609070,CSE 190,A00,092508,Dubnov; Shlomo,18,0,20,2
1650083615094,ECE 5,A01,084049,Morris; Karcher William,12,0,20,8
1650083621117,ECE 100,A01,084051,Baghdadchi; Saharnaz,0,0,20,20
1650083621117,ECE 100,A02,091916,Baghdadchi; Saharnaz,11,0,20,9
1650083627141,ECE 101,A01,084053,Baghdadchi; Saharnaz,0,0,37,37
1650083627141,ECE 101,A02,084054,Baghdadchi; Saharnaz,27,0,37,10
1650083633166,ECE 107,A01,083390,Staff,26,0,40,14
1650083639193,ECE 148,A01,084056,Silberman; Jack,8,0,12,4
1650083645222,ECE 180,A00,083391,Abi Samra; Nicholas Camill,25,0,30,5
1650083645222,ECE 180,B00,083392,Abi Samra; Nicholas Camill,21,0,30,9
1650083651244,MATH 10B,A01,084110,Staff,0,0,30,30
1650083651244,MATH 10B,A02,084111,Staff,16,0,30,14
1650083651244,MATH 10B,A03,084112,Staff,23,0,30,7
1650083657269,MATH 10C,A01,083443,Staff,0,17,30,31
1650083657269,MATH 10C,A02,083444,Staff,1,19,30,29
1650083657269,MATH 10C,B01,084114,Staff,17,0,30,13
1650083657269,MATH 10C,B02,084115,Staff,24,0,30,6
1650083663295,MATH 18,A01,084117,Harel; Guershon,11,0,30,19
1650083663295,MATH 18,A02,084119,Harel; Guershon,27,0,30,3
1650083663295,MATH 18,A03,084120,Harel; Guershon,30,0,30,0
1650083663295,MATH 18,A04,084121,Harel; Guershon,29,0,30,1
1650083669324,MATH 20B,A01,084124,Um; Ko Woon,10,0,35,25
1650083669324,MATH 20B,B01,084126,Um; Ko Woon,24,0,35,11
1650083675360,MATH 20C,A01,083446,Hammock; Frances H,0,0,30,30
1650083675360,MATH 20C,A02,083447,Hammock; Frances H,13,0,30,17
1650083675360,MATH 20C,A03,083448,Hammock; Frances H,18,0,30,12
1650083675360,MATH 20C,A04,083449,Hammock; Frances H,20,0,30,10
1650083675360,MATH 20C,B01,083451,Hammock; Frances H,0,0,30,30
1650083675360,MATH 20C,B02,083452,Hammock; Frances H,15,0,30,15
1650083675360,MATH 20C,B03,083453,Hammock; Frances H,19,0,30,11
1650083675360,MATH 20C,B04,083454,Hammock; Frances H,23,0,30,7
1650083681385,MATH 20D,A01,084128,Staff,13,0,30,17
1650083681385,MATH 20D,A02,084129,Staff,29,0,30,1
1650083681385,MATH 20D,A03,084130,Staff,27,0,30,3
1650083681385,MATH 20D,B01,084133,Staff,0,0,30,30
1650083681385,MATH 20D,B02,084134,Staff,23,0,30,7
1650083681385,MATH 20D,B03,084135,Staff,28,0,30,2
1650083687409,MATH 20E,A01,084138,Staff,13,0,30,17
1650083687409,MATH 20E,A02,084139,Staff,6,0,30,24
1650083687409,MATH 20E,A03,084140,Staff,14,0,30,16
1650083687409,MATH 20E,A04,084141,Staff,19,0,30,11
1650083693433,MATH 102,A01,084143,Harel; Guershon,11,0,30,19
1650083693433,MATH 102,A02,084144,Harel; Guershon,19,0,30,11
1650083699456,MATH 103B,A01,083456,Staff,0,13,30,30
1650083699456,MATH 103B,A02,083457,Staff,0,14,30,30
1650083705485,MATH 109,A01,084146,Salehi Golsefidy; Alireza,16,0,30,14
1650083705485,MATH 109,A02,084147,Salehi Golsefidy; Alireza,15,0,30,15
1650083711509,MATH 120A,A01,085445,Eggers; John Dietrich,7,0,35,28
1650083711509,MATH 120A,A02,085446,Eggers; John Dietrich,26,0,35,9
1650083717533,MATH 142B,A01,084149,Verstraete; Jacques Allan,0,12,30,30
1650083717533,MATH 142B,A02,084150,Verstraete; Jacques Allan,0,12,30,30
1650083723565,MATH 170A,A01,083459,Nie; Jiawang,0,11,30,30
1650083723565,MATH 170A,A02,083460,Nie; Jiawang,0,10,30,30
1650083723565,MATH 170A,A03,083461,Nie; Jiawang,0,11,30,30
1650083729588,MATH 193B,A01,083463,Staff,1,0,30,29
1650083729588,MATH 193B,A02,083464,Staff,8,0,30,22
1650083729588,MATH 193B,A03,083465,Staff,16,0,30,14
1650083735638,COGS 2,A01,083966,Boyle; Mary E. T.,10,0,30,20
1650083741662,COGS 9,A01,083968,Staff,3,0,60,57
1650083747692,COGS 14B,A01,083970,Staff,8,0,50,42
1650083753715,COGS 17,A01,092679,Staff,49,0,75,26
1650083759758,COGS 100,A01,083972,Staff,1,20,60,59
1650083771810,COGS 101C,A01,083976,Staff,12,0,30,18
1650083777838,COGS 102A,A01,083978,Johnson; Christine M.,11,0,30,19
1650083783861,COGS 107B,A01,083980,Staff,0,9,50,50
1650083789886,COGS 115,A01,083982,Staff,9,0,30,21
1650083795911,COGS 118B,A01,083367,Staff,0,16,40,40
1650083801940,COGS 172,A01,083984,Provenzano; Emily Kara,12,0,30,18
1650083807964,COGS 177,A00,083368,Staff,0,22,30,30
1650083813990,COGS 186,A01,083986,Staff,21,0,40,19
1650083820017,COGS 187A,A01,083988,Boyle; Mary E. T.,17,0,60,43
1650083826046,CSE 8A,A50,084003,Miranda; Gregory Joseph,0,18,15,15
1650083832075,CSE 11,A01,084005,Miranda; Gregory Joseph,1,24,55,54
1650083838108,CSE 20,A01,084007,Staff,0,5,20,20
1650083844130,CSE 21,A01,084009,Staff,1,33,50,49
1650083850155,CSE 30,A01,083370,Cao; Yingjun,0,63,40,40
1650083856181,CSE 100,A01,083372,Cao; Yingjun,0,47,40,40
1650083862219,CSE 101,A01,084011,Staff,0,56,40,40
1650083868245,CSE 141,A01,083374,Eldon; John,0,68,75,75
1650083874267,CSE 141L,A01,083376,Eldon; John,0,74,75,75
1650083880290,CSE 175,A01,084013,Kumar; Rakesh,22,0,25,3
1650083886318,CSE 190,A00,092508,Dubnov; Shlomo,18,0,20,2
1650083892341,ECE 5,A01,084049,Morris; Karcher William,12,0,20,8
1650083898368,ECE 100,A01,084051,Baghdadchi; Saharnaz,0,0,20,20
1650083898368,ECE 100,A02,091916,Baghdadchi; Saharnaz,11,0,20,9
1650083904391,ECE 101,A01,084053,Baghdadchi; Saharnaz,0,0,37,37
1650083904391,ECE 101,A02,084054,Baghdadchi; Saharnaz,27,0,37,10
1650083910420,ECE 107,A01,083390,Staff,26,0,40,14
1650083916454,ECE 148,A01,084056,Silberman; Jack,8,0,12,4
1650083922479,ECE 180,A00,083391,Abi Samra; Nicholas Camill,25,0,30,5
1650083922479,ECE 180,B00,083392,Abi Samra; Nicholas Camill,21,0,30,9
1650083928506,MATH 10B,A01,084110,Staff,0,0,30,30
1650083928506,MATH 10B,A02,084111,Staff,16,0,30,14
1650083928506,MATH 10B,A03,084112,Staff,23,0,30,7
1650083934533,MATH 10C,A01,083443,Staff,0,17,30,31
1650083934533,MATH 10C,A02,083444,Staff,1,19,30,29
1650083934533,MATH 10C,B01,084114,Staff,17,0,30,13
1650083934533,MATH 10C,B02,084115,Staff,24,0,30,6
1650083940561,MATH 18,A01,084117,Harel; Guershon,11,0,30,19
1650083940561,MATH 18,A02,084119,Harel; Guershon,27,0,30,3
1650083940561,MATH 18,A03,084120,Harel; Guershon,30,0,30,0
1650083940561,MATH 18,A04,084121,Harel; Guershon,29,0,30,1
1650083946586,MATH 20B,A01,084124,Um; Ko Woon,10,0,35,25
1650083946586,MATH 20B,B01,084126,Um; Ko Woon,24,0,35,11
1650083952616,MATH 20C,A01,083446,Hammock; Frances H,0,0,30,30
1650083952616,MATH 20C,A02,083447,Hammock; Frances H,13,0,30,17
1650083952616,MATH 20C,A03,083448,Hammock; Frances H,18,0,30,12
1650083952616,MATH 20C,A04,083449,Hammock; Frances H,20,0,30,10
1650083952616,MATH 20C,B01,083451,Hammock; Frances H,0,0,30,30
1650083952616,MATH 20C,B02,083452,Hammock; Frances H,15,0,30,15
1650083952616,MATH 20C,B03,083453,Hammock; Frances H,19,0,30,11
1650083952616,MATH 20C,B04,083454,Hammock; Frances H,23,0,30,7
1650083958639,MATH 20D,A01,084128,Staff,13,0,30,17
1650083958639,MATH 20D,A02,084129,Staff,29,0,30,1
1650083958639,MATH 20D,A03,084130,Staff,27,0,30,3
1650083958639,MATH 20D,B01,084133,Staff,0,0,30,30
1650083958639,MATH 20D,B02,084134,Staff,23,0,30,7
1650083958639,MATH 20D,B03,084135,Staff,28,0,30,2
1650083964670,MATH 20E,A01,084138,Staff,13,0,30,17
1650083964670,MATH 20E,A02,084139,Staff,6,0,30,24
1650083964670,MATH 20E,A03,084140,Staff,14,0,30,16
1650083964670,MATH 20E,A04,084141,Staff,19,0,30,11
1650083970695,MATH 102,A01,084143,Harel; Guershon,11,0,30,19
1650083970695,MATH 102,A02,084144,Harel; Guershon,19,0,30,11
1650083976721,MATH 103B,A01,083456,Staff,0,13,30,30
1650083976721,MATH 103B,A02,083457,Staff,0,14,30,30
1650083982745,MATH 109,A01,084146,Salehi Golsefidy; Alireza,16,0,30,14
1650083982745,MATH 109,A02,084147,Salehi Golsefidy; Alireza,15,0,30,15
1650083988773,MATH 120A,A01,085445,Eggers; John Dietrich,7,0,35,28
1650083988773,MATH 120A,A02,085446,Eggers; John Dietrich,26,0,35,9
1650083994800,MATH 142B,A01,084149,Verstraete; Jacques Allan,0,12,30,30
1650083994800,MATH 142B,A02,084150,Verstraete; Jacques Allan,0,12,30,30
1650084000824,MATH 170A,A01,083459,Nie; Jiawang,0,11,30,30
1650084000824,MATH 170A,A02,083460,Nie; Jiawang,0,10,30,30
1650084000824,MATH 170A,A03,083461,Nie; Jiawang,0,11,30,30
1650084006848,MATH 193B,A01,083463,Staff,1,0,30,29
1650084006848,MATH 193B,A02,083464,Staff,8,0,30,22
1650084006848,MATH 193B,A03,083465,Staff,16,0,30,14
1650084012901,COGS 2,A01,083966,Boyle; Mary E. T.,10,0,30,20
1650084018925,COGS 9,A01,083968,Staff,3,0,60,57
1650084024953,COGS 14B,A01,083970,Staff,8,0,50,42
1650084030979,COGS 17,A01,092679,Staff,49,0,75,26
1650084037006,COGS 100,A01,083972,Staff,1,20,60,59
1650084049057,COGS 101C,A01,083976,Staff,12,0,30,18
1650084055084,COGS 102A,A01,083978,Johnson; Christine M.,11,0,30,19
1650084061108,COGS 107B,A01,083980,Staff,0,9,50,50
1650084067132,COGS 115,A01,083982,Staff,9,0,30,21
1650084073158,COGS 118B,A01,083367,Staff,0,16,40,40
1650084079182,COGS 172,A01,083984,Provenzano; Emily Kara,12,0,30,18
1650084085206,COGS 177,A00,083368,Staff,0,22,30,30
1650084091230,COGS 186,A01,083986,Staff,21,0,40,19
1650084097258,COGS 187A,A01,083988,Boyle; Mary E. T.,16,0,60,44
1650084103283,CSE 8A,A50,084003,Miranda; Gregory Joseph,0,18,15,15
1650084109306,CSE 11,A01,084005,Miranda; Gregory Joseph,1,24,55,54
1650084115334,CSE 20,A01,084007,Staff,0,5,20,20
1650084121358,CSE 21,A01,084009,Staff,1,33,50,49
1650084127477,CSE 30,A01,083370,Cao; Yingjun,0,63,40,40
1650084133503,CSE 100,A01,083372,Cao; Yingjun,0,47,40,40
1650084139526,CSE 101,A01,084011,Staff,0,56,40,40
1650084145551,CSE 141,A01,083374,Eldon; John,0,69,75,75
1650084151582,CSE 141L,A01,083376,Eldon; John,0,75,75,75
1650084157609,CSE 175,A01,084013,Kumar; Rakesh,22,0,25,3
1650084163633,CSE 190,A00,092508,Dubnov; Shlomo,18,0,20,2
1650084169660,ECE 5,A01,084049,Morris; Karcher William,12,0,20,8
1650084175685,ECE 100,A01,084051,Baghdadchi; Saharnaz,0,0,20,20
1650084175685,ECE 100,A02,091916,Baghdadchi; Saharnaz,11,0,20,9
1650084181707,ECE 101,A01,084053,Baghdadchi; Saharnaz,0,0,37,37
1650084181707,ECE 101,A02,084054,Baghdadchi; Saharnaz,27,0,37,10
1650084187734,ECE 107,A01,083390,Staff,26,0,40,14
1650084193758,ECE 148,A01,084056,Silberman; Jack,8,0,12,4
1650084199786,ECE 180,A00,083391,Abi Samra; Nicholas Camill,25,0,30,5
1650084199786,ECE 180,B00,083392,Abi Samra; Nicholas Camill,21,0,30,9
1650084205811,MATH 10B,A01,084110,Staff,0,0,30,30
1650084205811,MATH 10B,A02,084111,Staff,16,0,30,14
1650084205811,MATH 10B,A03,084112,Staff,23,0,30,7
1650084211835,MATH 10C,A01,083443,Staff,0,17,30,31
1650084211835,MATH 10C,A02,083444,Staff,1,19,30,29
1650084211835,MATH 10C,B01,084114,Staff,17,0,30,13
1650084211835,MATH 10C,B02,084115,Staff,24,0,30,6
1650084217863,MATH 18,A01,084117,Harel; Guershon,11,0,30,19
1650084217863,MATH 18,A02,084119,Harel; Guershon,27,0,30,3
1650084217863,MATH 18,A03,084120,Harel; Guershon,30,0,30,0
1650084217863,MATH 18,A04,084121,Harel; Guershon,29,0,30,1
1650084223891,MATH 20B,A01,084124,Um; Ko Woon,10,0,35,25
1650084223891,MATH 20B,B01,084126,Um; Ko Woon,24,0,35,11
1650084229919,MATH 20C,A01,083446,Hammock; Frances H,0,0,30,30
1650084229919,MATH 20C,A02,083447,Hammock; Frances H,13,0,30,17
1650084229919,MATH 20C,A03,083448,Hammock; Frances H,18,0,30,12
1650084229919,MATH 20C,A04,083449,Hammock; Frances H,20,0,30,10
1650084229919,MATH 20C,B01,083451,Hammock; Frances H,0,0,30,30
1650084229919,MATH 20C,B02,083452,Hammock; Frances H,15,0,30,15
1650084229919,MATH 20C,B03,083453,Hammock; Frances H,19,0,30,11
1650084229919,MATH 20C,B04,083454,Hammock; Frances H,23,0,30,7
1650084235947,MATH 20D,A01,084128,Staff,13,0,30,17
1650084235947,MATH 20D,A02,084129,Staff,29,0,30,1
1650084235947,MATH 20D,A03,084130,Staff,27,0,30,3
1650084235947,MATH 20D,B01,084133,Staff,0,0,30,30
1650084235947,MATH 20D,B02,084134,Staff,23,0,30,7
1650084235947,MATH 20D,B03,084135,Staff,28,0,30,2
1650084241972,MATH 20E,A01,084138,Staff,13,0,30,17
1650084241972,MATH 20E,A02,084139,Staff,6,0,30,24
1650084241972,MATH 20E,A03,084140,Staff,14,0,30,16
1650084241972,MATH 20E,A04,084141,Staff,19,0,30,11
1650084247998,MATH 102,A01,084143,Harel; Guershon,11,0,30,19
1650084247998,MATH 102,A02,084144,Harel; Guershon,19,0,30,11
1650084254025,MATH 103B,A01,083456,Staff,0,13,30,30
1650084254025,MATH 103B,A02,083457,Staff,0,14,30,30
1650084260052,MATH 109,A01,084146,Salehi Golsefidy; Alireza,16,0,30,14
1650084260052,MATH 109,A02,084147,Salehi Golsefidy; Alireza,15,0,30,15
1650084266077,MATH 120A,A01,085445,Eggers; John Dietrich,7,0,35,28
1650084266077,MATH 120A,A02,085446,Eggers; John Dietrich,26,0,35,9
1650084272106,MATH 142B,A01,084149,Verstraete; Jacques Allan,0,12,30,30
1650084272106,MATH 142B,A02,084150,Verstraete; Jacques Allan,0,12,30,30
1650084278133,MATH 170A,A01,083459,Nie; Jiawang,0,11,30,30
1650084278133,MATH 170A,A02,083460,Nie; Jiawang,0,10,30,30
1650084278133,MATH 170A,A03,083461,Nie; Jiawang,0,11,30,30
1650084284166,MATH 193B,A01,083463,Staff,1,0,30,29
1650084284166,MATH 193B,A02,083464,Staff,8,0,30,22
1650084284166,MATH 193B,A03,083465,Staff,16,0,30,14
1650084290225,COGS 2,A01,083966,Boyle; Mary E. T.,10,0,30,20
1650084296248,COGS 9,A01,083968,Staff,3,0,60,57
1650084302274,COGS 14B,A01,083970,Staff,8,0,50,42
1650084308299,COGS 17,A01,092679,Staff,49,0,75,26
1650084314323,COGS 100,A01,083972,Staff,1,20,60,59
1650084326375,COGS 101C,A01,083976,Staff,12,0,30,18
1650084332398,COGS 102A,A01,083978,Johnson; Christine M.,11,0,30,19
1650084338424,COGS 107B,A01,083980,Staff,0,9,50,50
1650084344456,COGS 115,A01,083982,Staff,9,0,30,21
1650084350483,COGS 118B,A01,083367,Staff,0,16,40,40
1650084356506,COGS 172,A01,083984,Provenzano; Emily Kara,12,0,30,18
1650084362534,COGS 177,A00,083368,Staff,0,22,30,30
1650084368558,COGS 186,A01,083986,Staff,21,0,40,19
1650084374582,COGS 187A,A01,083988,Boyle; Mary E. T.,16,0,60,44
1650084380610,CSE 8A,A50,084003,Miranda; Gregory Joseph,0,18,15,15
1650084386635,CSE 11,A01,084005,Miranda; Gregory Joseph,1,24,55,54
1650084392663,CSE 20,A01,084007,Staff,0,5,20,20
1650084398691,CSE 21,A01,084009,Staff,1,33,50,49
1650084404715,CSE 30,A01,083370,Cao; Yingjun,0,63,40,40
1650084410746,CSE 100,A01,083372,Cao; Yingjun,0,48,40,40
1650084416772,CSE 101,A01,084011,Staff,0,56,40,40
1650084422799,CSE 141,A01,083374,Eldon; John,0,69,75,75
1650084428822,CSE 141L,A01,083376,Eldon; John,0,75,75,75
1650084434854,CSE 175,A01,084013,Kumar; Rakesh,22,0,25,3
1650084440884,CSE 190,A00,092508,Dubnov; Shlomo,18,0,20,2
1650084446908,ECE 5,A01,084049,Morris; Karcher William,12,0,20,8
1650084452937,ECE 100,A01,084051,Baghdadchi; Saharnaz,0,0,20,20
1650084452937,ECE 100,A02,091916,Baghdadchi; Saharnaz,11,0,20,9
1650084458960,ECE 101,A01,084053,Baghdadchi; Saharnaz,0,0,37,37
1650084458960,ECE 101,A02,084054,Baghdadchi; Saharnaz,27,0,37,10
1650084464984,ECE 107,A01,083390,Staff,26,0,40,14
1650084471012,ECE 148,A01,084056,Silberman; Jack,8,0,12,4
1650084477040,ECE 180,A00,083391,Abi Samra; Nicholas Camill,25,0,30,5
1650084477040,ECE 180,B00,083392,Abi Samra; Nicholas Camill,21,0,30,9
1650084483072,MATH 10B,A01,084110,Staff,0,0,30,30
1650084483072,MATH 10B,A02,084111,Staff,16,0,30,14
1650084483072,MATH 10B,A03,084112,Staff,23,0,30,7
1650084489096,MATH 10C,A01,083443,Staff,0,17,30,31
1650084489096,MATH 10C,A02,083444,Staff,1,19,30,29
1650084489096,MATH 10C,B01,084114,Staff,17,0,30,13
1650084489096,MATH 10C,B02,084115,Staff,24,0,30,6
1650084495120,MATH 18,A01,084117,Harel; Guershon,11,0,30,19
1650084495120,MATH 18,A02,084119,Harel; Guershon,27,0,30,3
1650084495120,MATH 18,A03,084120,Harel; Guershon,30,0,30,0
1650084495120,MATH 18,A04,084121,Harel; Guershon,29,0,30,1
1650084501144,MATH 20B,A01,084124,Um; Ko Woon,10,0,35,25
1650084501144,MATH 20B,B01,084126,Um; Ko Woon,24,0,35,11
1650084507170,MATH 20C,A01,083446,Hammock; Frances H,0,0,30,30
1650084507170,MATH 20C,A02,083447,Hammock; Frances H,13,0,30,17
1650084507170,MATH 20C,A03,083448,Hammock; Frances H,18,0,30,12
1650084507170,MATH 20C,A04,083449,Hammock; Frances H,20,0,30,10
1650084507170,MATH 20C,B01,083451,Hammock; Frances H,0,0,30,30
1650084507170,MATH 20C,B02,083452,Hammock; Frances H,15,0,30,15
1650084507170,MATH 20C,B03,083453,Hammock; Frances H,19,0,30,11
1650084507170,MATH 20C,B04,083454,Hammock; Frances H,23,0,30,7
1650084513197,MATH 20D,A01,084128,Staff,13,0,30,17
1650084513197,MATH 20D,A02,084129,Staff,29,0,30,1
1650084513197,MATH 20D,A03,084130,Staff,27,0,30,3
1650084513197,MATH 20D,B01,084133,Staff,0,0,30,30
1650084513197,MATH 20D,B02,084134,Staff,23,0,30,7
1650084513197,MATH 20D,B03,084135,Staff,28,0,30,2
1650084519219,MATH 20E,A01,084138,Staff,13,0,30,17
1650084519219,MATH 20E,A02,084139,Staff,6,0,30,24
1650084519219,MATH 20E,A03,084140,Staff,14,0,30,16
1650084519219,MATH 20E,A04,084141,Staff,19,0,30,11
1650084525243,MATH 102,A01,084143,Harel; Guershon,11,0,30,19
1650084525243,MATH 102,A02,084144,Harel; Guershon,19,0,30,11
1650084531265,MATH 103B,A01,083456,Staff,0,13,30,30
1650084531265,MATH 103B,A02,083457,Staff,0,14,30,30
1650084537292,MATH 109,A01,084146,Salehi Golsefidy; Alireza,16,0,30,14
1650084537292,MATH 109,A02,084147,Salehi Golsefidy; Alireza,15,0,30,15
1650084543314,MATH 120A,A01,085445,Eggers; John Dietrich,7,0,35,28
1650084543314,MATH 120A,A02,085446,Eggers; John Dietrich,26,0,35,9
1650084549337,MATH 142B,A01,084149,Verstraete; Jacques Allan,0,12,30,30
1650084549337,MATH 142B,A02,084150,Verstraete; Jacques Allan,0,12,30,30
1650084555361,MATH 170A,A01,083459,Nie; Jiawang,0,11,30,30
1650084555361,MATH 170A,A02,083460,Nie; Jiawang,0,10,30,30
1650084555361,MATH 170A,A03,083461,Nie; Jiawang,0,11,30,30
1650084561385,MATH 193B,A01,083463,Staff,1,0,30,29
1650084561385,MATH 193B,A02,083464,Staff,8,0,30,22
1650084561385,MATH 193B,A03,083465,Staff,16,0,30,14
1650084567446,COGS 2,A01,083966,Boyle; Mary E. T.,10,0,30,20
1650084573474,COGS 9,A01,083968,Staff,3,0,60,57
1650084579497,COGS 14B,A01,083970,Staff,8,0,50,42
1650084585520,COGS 17,A01,092679,Staff,49,0,75,26
1650084591544,COGS 100,A01,083972,Staff,1,20,60,59
1650084603596,COGS 101C,A01,083976,Staff,12,0,30,18
1650084609621,COGS 102A,A01,083978,Johnson; Christine M.,11,0,30,19
1650084615645,COGS 107B,A01,083980,Staff,0,9,50,50
1650084621670,COGS 115,A01,083982,Staff,9,0,30,21
1650084627693,COGS 118B,A01,083367,Staff,0,16,40,40
1650084633715,COGS 172,A01,083984,Provenzano; Emily Kara,12,0,30,18
1650084639736,COGS 177,A00,083368,Staff,0,22,30,30
1650084645761,COGS 186,A01,083986,Staff,21,0,40,19
1650084651784,COGS 187A,A01,083988,Boyle; Mary E. T.,16,0,60,44
1650084657813,CSE 8A,A50,084003,Miranda; Gregory Joseph,0,18,15,15
1650084663837,CSE 11,A01,084005,Miranda; Gregory Joseph,1,24,55,54
1650084669869,CSE 20,A01,084007,Staff,0,5,20,20
1650084675891,CSE 21,A01,084009,Staff,1,33,50,49
1650084681919,CSE 30,A01,083370,Cao; Yingjun,0,63,40,40
1650084687948,CSE 100,A01,083372,Cao; Yingjun,0,48,40,40
1650084693974,CSE 101,A01,084011,Staff,0,56,40,40
1650084699998,CSE 141,A01,083374,Eldon; John,0,69,75,75
1650084706035,CSE 141L,A01,083376,Eldon; John,0,75,75,75
1650084712058,CSE 175,A01,084013,Kumar; Rakesh,22,0,25,3
1650084718081,CSE 190,A00,092508,Dubnov; Shlomo,18,0,20,2
1650084724195,ECE 5,A01,084049,Morris; Karcher William,12,0,20,8
1650084730219,ECE 100,A01,084051,Baghdadchi; Saharnaz,0,0,20,20
1650084730219,ECE 100,A02,091916,Baghdadchi; Saharnaz,11,0,20,9
1650084736245,ECE 101,A01,084053,Baghdadchi; Saharnaz,0,0,37,37
1650084736245,ECE 101,A02,084054,Baghdadchi; Saharnaz,27,0,37,10
1650084742270,ECE 107,A01,083390,Staff,26,0,40,14
1650084748293,ECE 148,A01,084056,Silberman; Jack,8,0,12,4
1650084754317,ECE 180,A00,083391,Abi Samra; Nicholas Camill,25,0,30,5
1650084754317,ECE 180,B00,083392,Abi Samra; Nicholas Camill,21,0,30,9
1650084760340,MATH 10B,A01,084110,Staff,0,0,30,30
1650084760340,MATH 10B,A02,084111,Staff,16,0,30,14
1650084760340,MATH 10B,A03,084112,Staff,23,0,30,7
1650084766365,MATH 10C,A01,083443,Staff,0,17,30,31
1650084766365,MATH 10C,A02,083444,Staff,1,19,30,29
1650084766365,MATH 10C,B01,084114,Staff,17,0,30,13
1650084766365,MATH 10C,B02,084115,Staff,24,0,30,6
1650084772393,MATH 18,A01,084117,Harel; Guershon,11,0,30,19
1650084772393,MATH 18,A02,084119,Harel; Guershon,27,0,30,3
1650084772393,MATH 18,A03,084120,Harel; Guershon,30,0,30,0
1650084772393,MATH 18,A04,084121,Harel; Guershon,29,0,30,1
1650084778426,MATH 20B,A01,084124,Um; Ko Woon,10,0,35,25
1650084778426,MATH 20B,B01,084126,Um; Ko Woon,24,0,35,11
1650084784464,MATH 20C,A01,083446,Hammock; Frances H,0,0,30,30
1650084784464,MATH 20C,A02,083447,Hammock; Frances H,13,0,30,17
1650084784464,MATH 20C,A03,083448,Hammock; Frances H,18,0,30,12
1650084784464,MATH 20C,A04,083449,Hammock; Frances H,20,0,30,10
1650084784464,MATH 20C,B01,083451,Hammock; Frances H,0,0,30,30
1650084784464,MATH 20C,B02,083452,Hammock; Frances H,15,0,30,15
1650084784464,MATH 20C,B03,083453,Hammock; Frances H,19,0,30,11
1650084784464,MATH 20C,B04,083454,Hammock; Frances H,23,0,30,7
1650084790490,MATH 20D,A01,084128,Staff,13,0,30,17
1650084790490,MATH 20D,A02,084129,Staff,29,0,30,1
1650084790490,MATH 20D,A03,084130,Staff,27,0,30,3
1650084790490,MATH 20D,B01,084133,Staff,0,0,30,30
1650084790490,MATH 20D,B02,084134,Staff,23,0,30,7
1650084790490,MATH 20D,B03,084135,Staff,28,0,30,2
1650084796513,MATH 20E,A01,084138,Staff,13,0,30,17
1650084796513,MATH 20E,A02,084139,Staff,6,0,30,24
1650084796513,MATH 20E,A03,084140,Staff,14,0,30,16
1650084796513,MATH 20E,A04,084141,Staff,19,0,30,11
1650084802540,MATH 102,A01,084143,Harel; Guershon,11,0,30,19
1650084802540,MATH 102,A02,084144,Harel; Guershon,19,0,30,11
1650084808563,MATH 103B,A01,083456,Staff,0,13,30,30
1650084808563,MATH 103B,A02,083457,Staff,0,14,30,30
1650084814588,MATH 109,A01,084146,Salehi Golsefidy; Alireza,16,0,30,14
1650084814588,MATH 109,A02,084147,Salehi Golsefidy; Alireza,15,0,30,15
1650084820615,MATH 120A,A01,085445,Eggers; John Dietrich,7,0,35,28
1650084820615,MATH 120A,A02,085446,Eggers; John Dietrich,26,0,35,9
1650084826637,MATH 142B,A01,084149,Verstraete; Jacques Allan,0,12,30,30
1650084826637,MATH 142B,A02,084150,Verstraete; Jacques Allan,0,12,30,30
1650084832661,MATH 170A,A01,083459,Nie; Jiawang,0,11,30,30
1650084832661,MATH 170A,A02,083460,Nie; Jiawang,0,10,30,30
1650084832661,MATH 170A,A03,083461,Nie; Jiawang,0,11,30,30
1650084838684,MATH 193B,A01,083463,Staff,1,0,30,29
1650084838684,MATH 193B,A02,083464,Staff,8,0,30,22
1650084838684,MATH 193B,A03,083465,Staff,16,0,30,14
1650084844737,COGS 2,A01,083966,Boyle; Mary E. T.,10,0,30,20
1650084850759,COGS 9,A01,083968,Staff,3,0,60,57
1650084856783,COGS 14B,A01,083970,Staff,8,0,50,42
1650084862808,COGS 17,A01,092679,Staff,49,0,75,26
1650084868839,COGS 100,A01,083972,Staff,1,20,60,59
1650084880899,COGS 101C,A01,083976,Staff,12,0,30,18
1650084886924,COGS 102A,A01,083978,Johnson; Christine M.,11,0,30,19
1650084892950,COGS 107B,A01,083980,Staff,0,9,50,50
1650084898973,COGS 115,A01,083982,Staff,9,0,30,21
1650084905001,COGS 118B,A01,083367,Staff,0,16,40,40
1650084911028,COGS 172,A01,083984,Provenzano; Emily Kara,12,0,30,18
1650084917052,COGS 177,A00,083368,Staff,0,22,30,30
1650084923076,COGS 186,A01,083986,Staff,21,0,40,19
1650084929107,COGS 187A,A01,083988,Boyle; Mary E. T.,16,0,60,44
1650084935132,CSE 8A,A50,084003,Miranda; Gregory Joseph,0,18,15,15
1650084941163,CSE 11,A01,084005,Miranda; Gregory Joseph,1,24,55,54
1650084947191,CSE 20,A01,084007,Staff,0,5,20,20
1650084953226,CSE 21,A01,084009,Staff,1,33,50,49
1650084959250,CSE 30,A01,083370,Cao; Yingjun,0,63,40,40
1650084965274,CSE 100,A01,083372,Cao; Yingjun,0,48,40,40
1650084971298,CSE 101,A01,084011,Staff,0,56,40,40
1650084977326,CSE 141,A01,083374,Eldon; John,0,69,75,75
1650084983354,CSE 141L,A01,083376,Eldon; John,0,75,75,75
1650084989379,CSE 175,A01,084013,Kumar; Rakesh,22,0,25,3
1650084995406,CSE 190,A00,092508,Dubnov; Shlomo,18,0,20,2
1650085001429,ECE 5,A01,084049,Morris; Karcher William,12,0,20,8
1650085007455,ECE 100,A01,084051,Baghdadchi; Saharnaz,0,0,20,20
1650085007455,ECE 100,A02,091916,Baghdadchi; Saharnaz,11,0,20,9
1650085013480,ECE 101,A01,084053,Baghdadchi; Saharnaz,0,0,37,37
1650085013480,ECE 101,A02,084054,Baghdadchi; Saharnaz,27,0,37,10
1650085019508,ECE 107,A01,083390,Staff,26,0,40,14
1650085025537,ECE 148,A01,084056,Silberman; Jack,8,0,12,4
1650085031564,ECE 180,A00,083391,Abi Samra; Nicholas Camill,25,0,30,5
1650085031564,ECE 180,B00,083392,Abi Samra; Nicholas Camill,21,0,30,9
1650085037592,MATH 10B,A01,084110,Staff,0,0,30,30
1650085037592,MATH 10B,A02,084111,Staff,16,0,30,14
1650085037592,MATH 10B,A03,084112,Staff,23,0,30,7
1650085043616,MATH 10C,A01,083443,Staff,0,17,30,31
1650085043616,MATH 10C,A02,083444,Staff,1,19,30,29
1650085043616,MATH 10C,B01,084114,Staff,17,0,30,13
1650085043616,MATH 10C,B02,084115,Staff,24,0,30,6
1650085049639,MATH 18,A01,084117,Harel; Guershon,11,0,30,19
1650085049639,MATH 18,A02,084119,Harel; Guershon,27,0,30,3
1650085049639,MATH 18,A03,084120,Harel; Guershon,30,0,30,0
1650085049639,MATH 18,A04,084121,Harel; Guershon,29,0,30,1
1650085055663,MATH 20B,A01,084124,Um; Ko Woon,10,0,35,25
1650085055663,MATH 20B,B01,084126,Um; Ko Woon,24,0,35,11
1650085061692,MATH 20C,A01,083446,Hammock; Frances H,0,0,30,30
1650085061692,MATH 20C,A02,083447,Hammock; Frances H,13,0,30,17
1650085061692,MATH 20C,A03,083448,Hammock; Frances H,18,0,30,12
1650085061692,MATH 20C,A04,083449,Hammock; Frances H,20,0,30,10
1650085061692,MATH 20C,B01,083451,Hammock; Frances H,0,0,30,30
1650085061692,MATH 20C,B02,083452,Hammock; Frances H,15,0,30,15
1650085061692,MATH 20C,B03,083453,Hammock; Frances H,19,0,30,11
1650085061692,MATH 20C,B04,083454,Hammock; Frances H,23,0,30,7
1650085067716,MATH 20D,A01,084128,Staff,13,0,30,17
1650085067716,MATH 20D,A02,084129,Staff,29,0,30,1
1650085067716,MATH 20D,A03,084130,Staff,27,0,30,3
1650085067716,MATH 20D,B01,084133,Staff,0,0,30,30
1650085067716,MATH 20D,B02,084134,Staff,23,0,30,7
1650085067716,MATH 20D,B03,084135,Staff,28,0,30,2
1650085073744,MATH 20E,A01,084138,Staff,13,0,30,17
1650085073744,MATH 20E,A02,084139,Staff,6,0,30,24
1650085073744,MATH 20E,A03,084140,Staff,14,0,30,16
1650085073744,MATH 20E,A04,084141,Staff,19,0,30,11
1650085079781,MATH 102,A01,084143,Harel; Guershon,11,0,30,19
1650085079781,MATH 102,A02,084144,Harel; Guershon,19,0,30,11
1650085085805,MATH 103B,A01,083456,Staff,0,13,30,30
1650085085805,MATH 103B,A02,083457,Staff,0,14,30,30
1650085091832,MATH 109,A01,084146,Salehi Golsefidy; Alireza,16,0,30,14
1650085091832,MATH 109,A02,084147,Salehi Golsefidy; Alireza,15,0,30,15
1650085097859,MATH 120A,A01,085445,Eggers; John Dietrich,7,0,35,28
1650085097859,MATH 120A,A02,085446,Eggers; John Dietrich,26,0,35,9
1650085103882,MATH 142B,A01,084149,Verstraete; Jacques Allan,0,12,30,30
1650085103882,MATH 142B,A02,084150,Verstraete; Jacques Allan,0,12,30,30
1650085109905,MATH 170A,A01,083459,Nie; Jiawang,0,11,30,30
1650085109905,MATH 170A,A02,083460,Nie; Jiawang,0,10,30,30
1650085109905,MATH 170A,A03,083461,Nie; Jiawang,0,11,30,30
1650085115932,MATH 193B,A01,083463,Staff,1,0,30,29
1650085115932,MATH 193B,A02,083464,Staff,8,0,30,22
1650085115932,MATH 193B,A03,083465,Staff,16,0,30,14
1650085121992,COGS 2,A01,083966,Boyle; Mary E. T.,10,0,30,20
1650085128019,COGS 9,A01,083968,Staff,3,0,60,57
1650085134043,COGS 14B,A01,083970,Staff,8,0,50,42
1650085140067,COGS 17,A01,092679,Staff,49,0,75,26
1650085146095,COGS 100,A01,083972,Staff,1,20,60,59
1650085158144,COGS 101C,A01,083976,Staff,12,0,30,18
1650085164170,COGS 102A,A01,083978,Johnson; Christine M.,11,0,30,19
1650085170193,COGS 107B,A01,083980,Staff,0,9,50,50
1650085176222,COGS 115,A01,083982,Staff,9,0,30,21
1650085182248,COGS 118B,A01,083367,Staff,0,16,40,40
1650085188272,COGS 172,A01,083984,Provenzano; Emily Kara,12,0,30,18
1650085194295,COGS 177,A00,083368,Staff,0,22,30,30
1650085200333,COGS 186,A01,083986,Staff,21,0,40,19
1650085206365,COGS 187A,A01,083988,Boyle; Mary E. T.,16,0,60,44
1650085212403,CSE 8A,A50,084003,Miranda; Gregory Joseph,0,18,15,15
1650085218426,CSE 11,A01,084005,Miranda; Gregory Joseph,1,24,55,54
1650085224467,CSE 20,A01,084007,Staff,0,5,20,20
1650085230492,CSE 21,A01,084009,Staff,1,33,50,49
1650085236516,CSE 30,A01,083370,Cao; Yingjun,0,63,40,40
1650085242540,CSE 100,A01,083372,Cao; Yingjun,0,48,40,40
1650085248576,CSE 101,A01,084011,Staff,0,56,40,40
1650085254599,CSE 141,A01,083374,Eldon; John,0,69,75,75
1650085260634,CSE 141L,A01,083376,Eldon; John,0,75,75,75
1650085266662,CSE 175,A01,084013,Kumar; Rakesh,22,0,25,3
1650085272692,CSE 190,A00,092508,Dubnov; Shlomo,18,0,20,2
1650085278721,ECE 5,A01,084049,Morris; Karcher William,12,0,20,8
1650085284749,ECE 100,A01,084051,Baghdadchi; Saharnaz,0,0,20,20
1650085284749,ECE 100,A02,091916,Baghdadchi; Saharnaz,11,0,20,9
1650085290776,ECE 101,A01,084053,Baghdadchi; Saharnaz,0,0,37,37
1650085290776,ECE 101,A02,084054,Baghdadchi; Saharnaz,27,0,37,10
1650085296799,ECE 107,A01,083390,Staff,26,0,40,14
1650085302823,ECE 148,A01,084056,Silberman; Jack,8,0,12,4
1650085308847,ECE 180,A00,083391,Abi Samra; Nicholas Camill,25,0,30,5
1650085308847,ECE 180,B00,083392,Abi Samra; Nicholas Camill,21,0,30,9
1650085314890,MATH 10B,A01,084110,Staff,0,0,30,30
1650085314890,MATH 10B,A02,084111,Staff,16,0,30,14
1650085314890,MATH 10B,A03,084112,Staff,23,0,30,7
1650085321004,MATH 10C,A01,083443,Staff,0,17,30,31
1650085321004,MATH 10C,A02,083444,Staff,1,19,30,29
1650085321004,MATH 10C,B01,084114,Staff,17,0,30,13
1650085321004,MATH 10C,B02,084115,Staff,24,0,30,6
1650085327032,MATH 18,A01,084117,Harel; Guershon,11,0,30,19
1650085327032,MATH 18,A02,084119,Harel; Guershon,27,0,30,3
1650085327032,MATH 18,A03,084120,Harel; Guershon,30,0,30,0
1650085327032,MATH 18,A04,084121,Harel; Guershon,29,0,30,1
1650085333061,MATH 20B,A01,084124,Um; Ko Woon,10,0,35,25
1650085333061,MATH 20B,B01,084126,Um; Ko Woon,24,0,35,11
1650085339092,MATH 20C,A01,083446,Hammock; Frances H,0,0,30,30
1650085339092,MATH 20C,A02,083447,Hammock; Frances H,13,0,30,17
1650085339092,MATH 20C,A03,083448,Hammock; Frances H,18,0,30,12
1650085339092,MATH 20C,A04,083449,Hammock; Frances H,20,0,30,10
1650085339092,MATH 20C,B01,083451,Hammock; Frances H,0,0,30,30
1650085339092,MATH 20C,B02,083452,Hammock; Frances H,15,0,30,15
1650085339092,MATH 20C,B03,083453,Hammock; Frances H,19,0,30,11
1650085339092,MATH 20C,B04,083454,Hammock; Frances H,23,0,30,7
1650085345119,MATH 20D,A01,084128,Staff,13,0,30,17
1650085345119,MATH 20D,A02,084129,Staff,29,0,30,1
1650085345119,MATH 20D,A03,084130,Staff,27,0,30,3
1650085345119,MATH 20D,B01,084133,Staff,0,0,30,30
1650085345119,MATH 20D,B02,084134,Staff,23,0,30,7
1650085345119,MATH 20D,B03,084135,Staff,28,0,30,2
1650085351142,MATH 20E,A01,084138,Staff,13,0,30,17
1650085351142,MATH 20E,A02,084139,Staff,6,0,30,24
1650085351142,MATH 20E,A03,084140,Staff,14,0,30,16
1650085351142,MATH 20E,A04,084141,Staff,19,0,30,11
1650085357176,MATH 102,A01,084143,Harel; Guershon,11,0,30,19
1650085357176,MATH 102,A02,084144,Harel; Guershon,19,0,30,11
1650085363216,MATH 103B,A01,083456,Staff,0,13,30,30
1650085363216,MATH 103B,A02,083457,Staff,0,14,30,30
1650085369245,MATH 109,A01,084146,Salehi Golsefidy; Alireza,16,0,30,14
1650085369245,MATH 109,A02,084147,Salehi Golsefidy; Alireza,15,0,30,15
1650085375273,MATH 120A,A01,085445,Eggers; John Dietrich,7,0,35,28
1650085375273,MATH 120A,A02,085446,Eggers; John Dietrich,26,0,35,9
1650085381319,MATH 142B,A01,084149,Verstraete; Jacques Allan,0,12,30,30
1650085381319,MATH 142B,A02,084150,Verstraete; Jacques Allan,0,12,30,30
1650085387355,MATH 170A,A01,083459,Nie; Jiawang,0,11,30,30
1650085387355,MATH 170A,A02,083460,Nie; Jiawang,0,10,30,30
1650085387355,MATH 170A,A03,083461,Nie; Jiawang,0,11,30,30
1650085393386,MATH 193B,A01,083463,Staff,1,0,30,29
1650085393386,MATH 193B,A02,083464,Staff,8,0,30,22
1650085393386,MATH 193B,A03,083465,Staff,16,0,30,14
1650085399447,COGS 2,A01,083966,Boyle; Mary E. T.,9,0,30,21
1650085405471,COGS 9,A01,083968,Staff,3,0,60,57
1650085411496,COGS 14B,A01,083970,Staff,8,0,50,42
1650085417520,COGS 17,A01,092679,Staff,49,0,75,26
1650085423547,COGS 100,A01,083972,Staff,1,20,60,59
1650085435606,COGS 101C,A01,083976,Staff,12,0,30,18
1650085441666,COGS 102A,A01,083978,Johnson; Christine M.,11,0,30,19
1650085447690,COGS 107B,A01,083980,Staff,0,9,50,50
1650085453714,COGS 115,A01,083982,Staff,9,0,30,21
1650085459740,COGS 118B,A01,083367,Staff,0,16,40,40
1650085465779,COGS 172,A01,083984,Provenzano; Emily Kara,13,0,30,17
1650085471811,COGS 177,A00,083368,Staff,0,22,30,30
1650085477838,COGS 186,A01,083986,Staff,21,0,40,19
1650085483861,COGS 187A,A01,083988,Boyle; Mary E. T.,16,0,60,44
1650085489888,CSE 8A,A50,084003,Miranda; Gregory Joseph,0,18,15,15
1650085495912,CSE 11,A01,084005,Miranda; Gregory Joseph,1,24,55,54
1650085501946,CSE 20,A01,084007,Staff,0,5,20,20
1650085507973,CSE 21,A01,084009,Staff,1,33,50,49
1650085514000,CSE 30,A01,083370,Cao; Yingjun,0,63,40,40
1650085520037,CSE 100,A01,083372,Cao; Yingjun,0,48,40,40
1650085526061,CSE 101,A01,084011,Staff,0,56,40,40
1650085532090,CSE 141,A01,083374,Eldon; John,0,69,75,75
1650085538115,CSE 141L,A01,083376,Eldon; John,0,75,75,75
1650085544141,CSE 175,A01,084013,Kumar; Rakesh,22,0,25,3
1650085550162,CSE 190,A00,092508,Dubnov; Shlomo,18,0,20,2
1650085556186,ECE 5,A01,084049,Morris; Karcher William,12,0,20,8
1650085562216,ECE 100,A01,084051,Baghdadchi; Saharnaz,0,0,20,20
1650085562216,ECE 100,A02,091916,Baghdadchi; Saharnaz,11,0,20,9
1650085568240,ECE 101,A01,084053,Baghdadchi; Saharnaz,0,0,37,37
1650085568240,ECE 101,A02,084054,Baghdadchi; Saharnaz,27,0,37,10
1650085574265,ECE 107,A01,083390,Staff,26,0,40,14
1650085580291,ECE 148,A01,084056,Silberman; Jack,8,0,12,4
1650085586315,ECE 180,A00,083391,Abi Samra; Nicholas Camill,25,0,30,5
1650085586315,ECE 180,B00,083392,Abi Samra; Nicholas Camill,21,0,30,9
1650085592342,MATH 10B,A01,084110,Staff,0,0,30,30
1650085592342,MATH 10B,A02,084111,Staff,16,0,30,14
1650085592342,MATH 10B,A03,084112,Staff,23,0,30,7
1650085598372,MATH 10C,A01,083443,Staff,0,17,30,31
1650085598372,MATH 10C,A02,083444,Staff,1,19,30,29
1650085598372,MATH 10C,B01,084114,Staff,17,0,30,13
1650085598372,MATH 10C,B02,084115,Staff,24,0,30,6
1650085604396,MATH 18,A01,084117,Harel; Guershon,11,0,30,19
1650085604396,MATH 18,A02,084119,Harel; Guershon,27,0,30,3
1650085604396,MATH 18,A03,084120,Harel; Guershon,30,0,30,0
1650085604396,MATH 18,A04,084121,Harel; Guershon,29,0,30,1
1650085610430,MATH 20B,A01,084124,Um; Ko Woon,10,0,35,25
1650085610430,MATH 20B,B01,084126,Um; Ko Woon,24,0,35,11
1650085616460,MATH 20C,A01,083446,Hammock; Frances H,0,0,30,30
1650085616460,MATH 20C,A02,083447,Hammock; Frances H,13,0,30,17
1650085616460,MATH 20C,A03,083448,Hammock; Frances H,18,0,30,12
1650085616460,MATH 20C,A04,083449,Hammock; Frances H,20,0,30,10
1650085616460,MATH 20C,B01,083451,Hammock; Frances H,0,0,30,30
1650085616460,MATH 20C,B02,083452,Hammock; Frances H,15,0,30,15
1650085616460,MATH 20C,B03,083453,Hammock; Frances H,19,0,30,11
1650085616460,MATH 20C,B04,083454,Hammock; Frances H,23,0,30,7
1650085622483,MATH 20D,A01,084128,Staff,13,0,30,17
1650085622483,MATH 20D,A02,084129,Staff,29,0,30,1
1650085622483,MATH 20D,A03,084130,Staff,27,0,30,3
1650085622483,MATH 20D,B01,084133,Staff,0,0,30,30
1650085622483,MATH 20D,B02,084134,Staff,23,0,30,7
1650085622483,MATH 20D,B03,084135,Staff,28,0,30,2
1650085628506,MATH 20E,A01,084138,Staff,13,0,30,17
1650085628506,MATH 20E,A02,084139,Staff,6,0,30,24
1650085628506,MATH 20E,A03,084140,Staff,14,0,30,16
1650085628506,MATH 20E,A04,084141,Staff,19,0,30,11
1650085634541,MATH 102,A01,084143,Harel; Guershon,11,0,30,19
1650085634541,MATH 102,A02,084144,Harel; Guershon,19,0,30,11
1650085640567,MATH 103B,A01,083456,Staff,0,13,30,30
1650085640567,MATH 103B,A02,083457,Staff,0,14,30,30
1650085646589,MATH 109,A01,084146,Salehi Golsefidy; Alireza,16,0,30,14
1650085646589,MATH 109,A02,084147,Salehi Golsefidy; Alireza,15,0,30,15
1650085652617,MATH 120A,A01,085445,Eggers; John Dietrich,7,0,35,28
1650085652617,MATH 120A,A02,085446,Eggers; John Dietrich,26,0,35,9
1650085658641,MATH 142B,A01,084149,Verstraete; Jacques Allan,0,12,30,30
1650085658641,MATH 142B,A02,084150,Verstraete; Jacques Allan,0,12,30,30
1650085664669,MATH 170A,A01,083459,Nie; Jiawang,0,11,30,30
1650085664669,MATH 170A,A02,083460,Nie; Jiawang,0,10,30,30
1650085664669,MATH 170A,A03,083461,Nie; Jiawang,0,11,30,30
1650085670696,MATH 193B,A01,083463,Staff,1,0,30,29
1650085670696,MATH 193B,A02,083464,Staff,8,0,30,22
1650085670696,MATH 193B,A03,083465,Staff,16,0,30,14
1650085676748,COGS 2,A01,083966,Boyle; Mary E. T.,9,0,30,21
1650085682775,COGS 9,A01,083968,Staff,3,0,60,57
1650085688810,COGS 14B,A01,083970,Staff,8,0,50,42
1650085694833,COGS 17,A01,092679,Staff,49,0,75,26
1650085700857,COGS 100,A01,083972,Staff,1,20,60,59
1650085712905,COGS 101C,A01,083976,Staff,12,0,30,18
1650085718929,COGS 102A,A01,083978,Johnson; Christine M.,11,0,30,19
1650085724952,COGS 107B,A01,083980,Staff,0,9,50,50
1650085730976,COGS 115,A01,083982,Staff,9,0,30,21
1650085737002,COGS 118B,A01,083367,Staff,0,16,40,40
1650085743029,COGS 172,A01,083984,Provenzano; Emily Kara,13,0,30,17
1650085749063,COGS 177,A00,083368,Staff,0,22,30,30
1650085755096,COGS 186,A01,083986,Staff,21,0,40,19
1650085761119,COGS 187A,A01,083988,Boyle; Mary E. T.,16,0,60,44
1650085767143,CSE 8A,A50,084003,Miranda; Gregory Joseph,0,18,15,15
1650085773168,CSE 11,A01,084005,Miranda; Gregory Joseph,1,24,55,54
1650085779190,CSE 20,A01,084007,Staff,0,5,20,20
1650085785211,CSE 21,A01,084009,Staff,1,33,50,49
1650085791238,CSE 30,A01,083370,Cao; Yingjun,0,63,40,40
1650085797262,CSE 100,A01,083372,Cao; Yingjun,0,48,40,40
1650085803297,CSE 101,A01,084011,Staff,0,56,40,40
1650085809319,CSE 141,A01,083374,Eldon; John,0,69,75,75
1650085815351,CSE 141L,A01,083376,Eldon; John,0,75,75,75
1650085821374,CSE 175,A01,084013,Kumar; Rakesh,22,0,25,3
1650085827401,CSE 190,A00,092508,Dubnov; Shlomo,18,0,20,2
1650085833426,ECE 5,A01,084049,Morris; Karcher William,12,0,20,8
1650085839454,ECE 100,A01,084051,Baghdadchi; Saharnaz,0,0,20,20
1650085839454,ECE 100,A02,091916,Baghdadchi; Saharnaz,11,0,20,9
1650085845482,ECE 101,A01,084053,Baghdadchi; Saharnaz,0,0,37,37
1650085845482,ECE 101,A02,084054,Baghdadchi; Saharnaz,27,0,37,10
1650085851504,ECE 107,A01,083390,Staff,26,0,40,14
1650085857549,ECE 148,A01,084056,Silberman; Jack,8,0,12,4
1650085863572,ECE 180,A00,083391,Abi Samra; Nicholas Camill,25,0,30,5
1650085863572,ECE 180,B00,083392,Abi Samra; Nicholas Camill,21,0,30,9
1650085869600,MATH 10B,A01,084110,Staff,0,0,30,30
1650085869600,MATH 10B,A02,084111,Staff,16,0,30,14
1650085869600,MATH 10B,A03,084112,Staff,23,0,30,7
1650085875624,MATH 10C,A01,083443,Staff,0,17,30,31
1650085875624,MATH 10C,A02,083444,Staff,1,19,30,29
1650085875624,MATH 10C,B01,084114,Staff,17,0,30,13
1650085875624,MATH 10C,B02,084115,Staff,24,0,30,6
1650085881648,MATH 18,A01,084117,Harel; Guershon,11,0,30,19
1650085881648,MATH 18,A02,084119,Harel; Guershon,27,0,30,3
1650085881648,MATH 18,A03,084120,Harel; Guershon,30,0,30,0
1650085881648,MATH 18,A04,084121,Harel; Guershon,29,0,30,1
1650085887693,MATH 20B,A01,084124,Um; Ko Woon,10,0,35,25
1650085887693,MATH 20B,B01,084126,Um; Ko Woon,24,0,35,11
1650085893718,MATH 20C,A01,083446,Hammock; Frances H,0,0,30,30
1650085893718,MATH 20C,A02,083447,Hammock; Frances H,13,0,30,17
1650085893718,MATH 20C,A03,083448,Hammock; Frances H,18,0,30,12
1650085893718,MATH 20C,A04,083449,Hammock; Frances H,20,0,30,10
1650085893718,MATH 20C,B01,083451,Hammock; Frances H,0,0,30,30
1650085893718,MATH 20C,B02,083452,Hammock; Frances H,15,0,30,15
1650085893718,MATH 20C,B03,083453,Hammock; Frances H,19,0,30,11
1650085893718,MATH 20C,B04,083454,Hammock; Frances H,23,0,30,7
1650085899743,MATH 20D,A01,084128,Staff,13,0,30,17
1650085899743,MATH 20D,A02,084129,Staff,29,0,30,1
1650085899743,MATH 20D,A03,084130,Staff,27,0,30,3
1650085899743,MATH 20D,B01,084133,Staff,0,0,30,30
1650085899743,MATH 20D,B02,084134,Staff,23,0,30,7
1650085899743,MATH 20D,B03,084135,Staff,28,0,30,2
1650085905771,MATH 20E,A01,084138,Staff,13,0,30,17
1650085905771,MATH 20E,A02,084139,Staff,6,0,30,24
1650085905771,MATH 20E,A03,084140,Staff,14,0,30,16
1650085905771,MATH 20E,A04,084141,Staff,19,0,30,11
1650085911795,MATH 102,A01,084143,Harel; Guershon,11,0,30,19
1650085911795,MATH 102,A02,084144,Harel; Guershon,19,0,30,11
1650085917919,MATH 103B,A01,083456,Staff,0,13,30,30
1650085917919,MATH 103B,A02,083457,Staff,0,14,30,30
1650085923959,MATH 109,A01,084146,Salehi Golsefidy; Alireza,16,0,30,14
1650085923959,MATH 109,A02,084147,Salehi Golsefidy; Alireza,15,0,30,15
1650085929988,MATH 120A,A01,085445,Eggers; John Dietrich,7,0,35,28
1650085929988,MATH 120A,A02,085446,Eggers; John Dietrich,26,0,35,9
1650085936010,MATH 142B,A01,084149,Verstraete; Jacques Allan,0,12,30,30
1650085936010,MATH 142B,A02,084150,Verstraete; Jacques Allan,0,12,30,30
1650085942032,MATH 170A,A01,083459,Nie; Jiawang,0,11,30,30
1650085942032,MATH 170A,A02,083460,Nie; Jiawang,0,10,30,30
1650085942032,MATH 170A,A03,083461,Nie; Jiawang,0,11,30,30
1650085948055,MATH 193B,A01,083463,Staff,1,0,30,29
1650085948055,MATH 193B,A02,083464,Staff,8,0,30,22
1650085948055,MATH 193B,A03,083465,Staff,16,0,30,14
1650085954108,COGS 2,A01,083966,Boyle; Mary E. T.,9,0,30,21
1650085960134,COGS 9,A01,083968,Staff,3,0,60,57
1650085966157,COGS 14B,A01,083970,Staff,8,0,50,42
1650085972179,COGS 17,A01,092679,Staff,49,0,75,26
1650085978203,COGS 100,A01,083972,Staff,1,20,60,59
1650085990253,COGS 101C,A01,083976,Staff,12,0,30,18
1650085996277,COGS 102A,A01,083978,Johnson; Christine M.,11,0,30,19
1650086002300,COGS 107B,A01,083980,Staff,0,9,50,50
1650086008328,COGS 115,A01,083982,Staff,9,0,30,21
1650086014359,COGS 118B,A01,083367,Staff,0,16,40,40
1650086020387,COGS 172,A01,083984,Provenzano; Emily Kara,13,0,30,17
1650086026416,COGS 177,A00,083368,Staff,0,22,30,30
1650086032443,COGS 186,A01,083986,Staff,21,0,40,19
1650086038467,COGS 187A,A01,083988,Boyle; Mary E. T.,16,0,60,44
1650086044492,CSE 8A,A50,084003,Miranda; Gregory Joseph,0,18,15,15
1650086050519,CSE 11,A01,084005,Miranda; Gregory Joseph,1,25,55,54
1650086056545,CSE 20,A01,084007,Staff,0,5,20,20
1650086062570,CSE 21,A01,084009,Staff,1,33,50,49
1650086068598,CSE 30,A01,083370,Cao; Yingjun,0,63,40,40
1650086074621,CSE 100,A01,083372,Cao; Yingjun,0,48,40,40
1650086080648,CSE 101,A01,084011,Staff,0,56,40,40
1650086086674,CSE 141,A01,083374,Eldon; John,0,69,75,75
1650086092701,CSE 141L,A01,083376,Eldon; John,0,75,75,75
1650086098737,CSE 175,A01,084013,Kumar; Rakesh,22,0,25,3
1650086104760,CSE 190,A00,092508,Dubnov; Shlomo,18,0,20,2
1650086110795,ECE 5,A01,084049,Morris; Karcher William,12,0,20,8
1650086116819,ECE 100,A01,084051,Baghdadchi; Saharnaz,0,0,20,20
1650086116819,ECE 100,A02,091916,Baghdadchi; Saharnaz,11,0,20,9
1650086122842,ECE 101,A01,084053,Baghdadchi; Saharnaz,0,0,37,37
1650086122842,ECE 101,A02,084054,Baghdadchi; Saharnaz,27,0,37,10
1650086128872,ECE 107,A01,083390,Staff,26,0,40,14
1650086134898,ECE 148,A01,084056,Silberman; Jack,8,0,12,4
1650086140925,ECE 180,A00,083391,Abi Samra; Nicholas Camill,25,0,30,5
1650086140925,ECE 180,B00,083392,Abi Samra; Nicholas Camill,21,0,30,9
1650086146949,MATH 10B,A01,084110,Staff,0,0,30,30
1650086146949,MATH 10B,A02,084111,Staff,16,0,30,14
1650086146949,MATH 10B,A03,084112,Staff,23,0,30,7
1650086152974,MATH 10C,A01,083443,Staff,0,17,30,31
1650086152974,MATH 10C,A02,083444,Staff,1,19,30,29
1650086152974,MATH 10C,B01,084114,Staff,17,0,30,13
1650086152974,MATH 10C,B02,084115,Staff,24,0,30,6
1650086159006,MATH 18,A01,084117,Harel; Guershon,11,0,30,19
1650086159006,MATH 18,A02,084119,Harel; Guershon,27,0,30,3
1650086159006,MATH 18,A03,084120,Harel; Guershon,30,0,30,0
1650086159006,MATH 18,A04,084121,Harel; Guershon,29,0,30,1
1650086165031,MATH 20B,A01,084124,Um; Ko Woon,10,0,35,25
1650086165031,MATH 20B,B01,084126,Um; Ko Woon,24,0,35,11
1650086171057,MATH 20C,A01,083446,Hammock; Frances H,0,0,30,30
1650086171057,MATH 20C,A02,083447,Hammock; Frances H,13,0,30,17
1650086171057,MATH 20C,A03,083448,Hammock; Frances H,18,0,30,12
1650086171057,MATH 20C,A04,083449,Hammock; Frances H,20,0,30,10
1650086171057,MATH 20C,B01,083451,Hammock; Frances H,0,0,30,30
1650086171057,MATH 20C,B02,083452,Hammock; Frances H,15,0,30,15
1650086171057,MATH 20C,B03,083453,Hammock; Frances H,19,0,30,11
1650086171057,MATH 20C,B04,083454,Hammock; Frances H,23,0,30,7
1650086177081,MATH 20D,A01,084128,Staff,13,0,30,17
1650086177081,MATH 20D,A02,084129,Staff,29,0,30,1
1650086177081,MATH 20D,A03,084130,Staff,27,0,30,3
1650086177081,MATH 20D,B01,084133,Staff,0,0,30,30
1650086177081,MATH 20D,B02,084134,Staff,23,0,30,7
1650086177081,MATH 20D,B03,084135,Staff,28,0,30,2
1650086183106,MATH 20E,A01,084138,Staff,13,0,30,17
1650086183106,MATH 20E,A02,084139,Staff,6,0,30,24
1650086183106,MATH 20E,A03,084140,Staff,14,0,30,16
1650086183106,MATH 20E,A04,084141,Staff,19,0,30,11
1650086189129,MATH 102,A01,084143,Harel; Guershon,11,0,30,19
1650086189129,MATH 102,A02,084144,Harel; Guershon,19,0,30,11
1650086195165,MATH 103B,A01,083456,Staff,0,13,30,30
1650086195165,MATH 103B,A02,083457,Staff,0,14,30,30
1650086201190,MATH 109,A01,084146,Salehi Golsefidy; Alireza,16,0,30,14
1650086201190,MATH 109,A02,084147,Salehi Golsefidy; Alireza,15,0,30,15
1650086207218,MATH 120A,A01,085445,Eggers; John Dietrich,7,0,35,28
1650086207218,MATH 120A,A02,085446,Eggers; John Dietrich,26,0,35,9
1650086213245,MATH 142B,A01,084149,Verstraete; Jacques Allan,0,12,30,30
1650086213245,MATH 142B,A02,084150,Verstraete; Jacques Allan,0,12,30,30
1650086219269,MATH 170A,A01,083459,Nie; Jiawang,0,11,30,30
1650086219269,MATH 170A,A02,083460,Nie; Jiawang,0,10,30,30
1650086219269,MATH 170A,A03,083461,Nie; Jiawang,0,11,30,30
1650086225294,MATH 193B,A01,083463,Staff,1,0,30,29
1650086225294,MATH 193B,A02,083464,Staff,8,0,30,22
1650086225294,MATH 193B,A03,083465,Staff,16,0,30,14
1650086231346,COGS 2,A01,083966,Boyle; Mary E. T.,9,0,30,21
1650086237373,COGS 9,A01,083968,Staff,3,0,60,57
1650086243396,COGS 14B,A01,083970,Staff,8,0,50,42
1650086249420,COGS 17,A01,092679,Staff,49,0,75,26
1650086255443,COGS 100,A01,083972,Staff,1,20,60,59
1650086267495,COGS 101C,A01,083976,Staff,12,0,30,18
1650086273519,COGS 102A,A01,083978,Johnson; Christine M.,11,0,30,19
1650086279555,COGS 107B,A01,083980,Staff,0,9,50,50
1650086285591,COGS 115,A01,083982,Staff,9,0,30,21
1650086291615,COGS 118B,A01,083367,Staff,0,16,40,40
1650086297643,COGS 172,A01,083984,Provenzano; Emily Kara,13,0,30,17
1650086303670,COGS 177,A00,083368,Staff,0,22,30,30
1650086309693,COGS 186,A01,083986,Staff,21,0,40,19
1650086315719,COGS 187A,A01,083988,Boyle; Mary E. T.,16,0,60,44
1650086321746,CSE 8A,A50,084003,Miranda; Gregory Joseph,0,18,15,15
1650086327771,CSE 11,A01,084005,Miranda; Gregory Joseph,1,25,55,54
1650086333798,CSE 20,A01,084007,Staff,0,5,20,20
1650086339824,CSE 21,A01,084009,Staff,1,33,50,49
1650086345848,CSE 30,A01,083370,Cao; Yingjun,0,63,40,40
1650086351871,CSE 100,A01,083372,Cao; Yingjun,0,48,40,40
1650086357899,CSE 101,A01,084011,Staff,0,56,40,40
1650086363927,CSE 141,A01,083374,Eldon; John,0,69,75,75
1650086369951,CSE 141L,A01,083376,Eldon; John,0,75,75,75
1650086375987,CSE 175,A01,084013,Kumar; Rakesh,22,0,25,3
1650086382026,CSE 190,A00,092508,Dubnov; Shlomo,18,0,20,2
1650086388051,ECE 5,A01,084049,Morris; Karcher William,12,0,20,8
1650086394072,ECE 100,A01,084051,Baghdadchi; Saharnaz,0,0,20,20
1650086394072,ECE 100,A02,091916,Baghdadchi; Saharnaz,11,0,20,9
1650086400096,ECE 101,A01,084053,Baghdadchi; Saharnaz,0,0,37,37
1650086400096,ECE 101,A02,084054,Baghdadchi; Saharnaz,27,0,37,10
1650086406119,ECE 107,A01,083390,Staff,26,0,40,14
1650086412147,ECE 148,A01,084056,Silberman; Jack,8,0,12,4
1650086418172,ECE 180,A00,083391,Abi Samra; Nicholas Camill,25,0,30,5
1650086418172,ECE 180,B00,083392,Abi Samra; Nicholas Camill,21,0,30,9
1650086424195,MATH 10B,A01,084110,Staff,0,0,30,30
1650086424195,MATH 10B,A02,084111,Staff,16,0,30,14
1650086424195,MATH 10B,A03,084112,Staff,23,0,30,7
1650086430219,MATH 10C,A01,083443,Staff,0,17,30,31
1650086430219,MATH 10C,A02,083444,Staff,1,19,30,29
1650086430219,MATH 10C,B01,084114,Staff,17,0,30,13
1650086430219,MATH 10C,B02,084115,Staff,24,0,30,6
1650086436242,MATH 18,A01,084117,Harel; Guershon,11,0,30,19
1650086436242,MATH 18,A02,084119,Harel; Guershon,27,0,30,3
1650086436242,MATH 18,A03,084120,Harel; Guershon,30,0,30,0
1650086436242,MATH 18,A04,084121,Harel; Guershon,29,0,30,1
1650086442264,MATH 20B,A01,084124,Um; Ko Woon,10,0,35,25
1650086442264,MATH 20B,B01,084126,Um; Ko Woon,24,0,35,11
1650086448290,MATH 20C,A01,083446,Hammock; Frances H,0,0,30,30
1650086448290,MATH 20C,A02,083447,Hammock; Frances H,13,0,30,17
1650086448290,MATH 20C,A03,083448,Hammock; Frances H,18,0,30,12
1650086448290,MATH 20C,A04,083449,Hammock; Frances H,20,0,30,10
1650086448290,MATH 20C,B01,083451,Hammock; Frances H,0,0,30,30
1650086448290,MATH 20C,B02,083452,Hammock; Frances H,15,0,30,15
1650086448290,MATH 20C,B03,083453,Hammock; Frances H,19,0,30,11
1650086448290,MATH 20C,B04,083454,Hammock; Frances H,23,0,30,7
1650086454314,MATH 20D,A01,084128,Staff,13,0,30,17
1650086454314,MATH 20D,A02,084129,Staff,29,0,30,1
1650086454314,MATH 20D,A03,084130,Staff,28,0,30,2
1650086454314,MATH 20D,B01,084133,Staff,0,0,30,30
1650086454314,MATH 20D,B02,084134,Staff,23,0,30,7
1650086454314,MATH 20D,B03,084135,Staff,28,0,30,2
1650086460339,MATH 20E,A01,084138,Staff,13,0,30,17
1650086460339,MATH 20E,A02,084139,Staff,6,0,30,24
1650086460339,MATH 20E,A03,084140,Staff,14,0,30,16
1650086460339,MATH 20E,A04,084141,Staff,19,0,30,11
1650086466363,MATH 102,A01,084143,Harel; Guershon,11,0,30,19
1650086466363,MATH 102,A02,084144,Harel; Guershon,19,0,30,11
1650086472396,MATH 103B,A01,083456,Staff,0,13,30,30
1650086472396,MATH 103B,A02,083457,Staff,0,14,30,30
1650086478421,MATH 109,A01,084146,Salehi Golsefidy; Alireza,16,0,30,14
1650086478421,MATH 109,A02,084147,Salehi Golsefidy; Alireza,15,0,30,15
1650086484449,MATH 120A,A01,085445,Eggers; John Dietrich,6,0,35,29
1650086484449,MATH 120A,A02,085446,Eggers; John Dietrich,26,0,35,9
1650086490472,MATH 142B,A01,084149,Verstraete; Jacques Allan,0,12,30,30
1650086490472,MATH 142B,A02,084150,Verstraete; Jacques Allan,0,12,30,30
1650086496497,MATH 170A,A01,083459,Nie; Jiawang,0,11,30,30
1650086496497,MATH 170A,A02,083460,Nie; Jiawang,0,10,30,30
1650086496497,MATH 170A,A03,083461,Nie; Jiawang,0,11,30,30
1650086502521,MATH 193B,A01,083463,Staff,1,0,30,29
1650086502521,MATH 193B,A02,083464,Staff,8,0,30,22
1650086502521,MATH 193B,A03,083465,Staff,16,0,30,14
1650086508667,COGS 2,A01,083966,Boyle; Mary E. T.,9,0,30,21
1650086514696,COGS 9,A01,083968,Staff,3,0,60,57
1650086520722,COGS 14B,A01,083970,Staff,8,0,50,42
1650086526780,COGS 17,A01,092679,Staff,48,0,75,27
1650086532807,COGS 100,A01,083972,Staff,1,20,60,59
1650086544857,COGS 101C,A01,083976,Staff,12,0,30,18
1650086550884,COGS 102A,A01,083978,Johnson; Christine M.,11,0,30,19
1650086556908,COGS 107B,A01,083980,Staff,0,9,50,50
1650086562933,COGS 115,A01,083982,Staff,9,0,30,21
1650086568956,COGS 118B,A01,083367,Staff,0,16,40,40
1650086574986,COGS 172,A01,083984,Provenzano; Emily Kara,13,0,30,17
1650086581010,COGS 177,A00,083368,Staff,0,22,30,30
1650086587033,COGS 186,A01,083986,Staff,21,0,40,19
1650086593061,COGS 187A,A01,083988,Boyle; Mary E. T.,16,0,60,44
1650086599086,CSE 8A,A50,084003,Miranda; Gregory Joseph,0,18,15,15
1650086605114,CSE 11,A01,084005,Miranda; Gregory Joseph,1,25,55,54
1650086611138,CSE 20,A01,084007,Staff,0,5,20,20
1650086617162,CSE 21,A01,084009,Staff,1,33,50,49
1650086623185,CSE 30,A01,083370,Cao; Yingjun,0,63,40,40
1650086629209,CSE 100,A01,083372,Cao; Yingjun,0,48,40,40
1650086635232,CSE 101,A01,084011,Staff,0,56,40,40
1650086641254,CSE 141,A01,083374,Eldon; John,0,69,75,75
1650086647285,CSE 141L,A01,083376,Eldon; John,0,75,75,75
1650086653309,CSE 175,A01,084013,Kumar; Rakesh,22,0,25,3
1650086659333,CSE 190,A00,092508,Dubnov; Shlomo,18,0,20,2
1650086665357,ECE 5,A01,084049,Morris; Karcher William,12,0,20,8
1650086671380,ECE 100,A01,084051,Baghdadchi; Saharnaz,0,0,20,20
1650086671380,ECE 100,A02,091916,Baghdadchi; Saharnaz,11,0,20,9
1650086677407,ECE 101,A01,084053,Baghdadchi; Saharnaz,0,0,37,37
1650086677407,ECE 101,A02,084054,Baghdadchi; Saharnaz,27,0,37,10
1650086683437,ECE 107,A01,083390,Staff,26,0,40,14
1650086689459,ECE 148,A01,084056,Silberman; Jack,8,0,12,4
1650086695483,ECE 180,A00,083391,Abi Samra; Nicholas Camill,25,0,30,5
1650086695483,ECE 180,B00,083392,Abi Samra; Nicholas Camill,21,0,30,9
1650086701507,MATH 10B,A01,084110,Staff,0,0,30,30
1650086701507,MATH 10B,A02,084111,Staff,16,0,30,14
1650086701507,MATH 10B,A03,084112,Staff,23,0,30,7
1650086707534,MATH 10C,A01,083443,Staff,0,17,30,31
1650086707534,MATH 10C,A02,083444,Staff,1,19,30,29
1650086707534,MATH 10C,B01,084114,Staff,17,0,30,13
1650086707534,MATH 10C,B02,084115,Staff,24,0,30,6
1650086713563,MATH 18,A01,084117,Harel; Guershon,11,0,30,19
1650086713563,MATH 18,A02,084119,Harel; Guershon,27,0,30,3
1650086713563,MATH 18,A03,084120,Harel; Guershon,30,0,30,0
1650086713563,MATH 18,A04,084121,Harel; Guershon,29,0,30,1
1650086719587,MATH 20B,A01,084124,Um; Ko Woon,10,0,35,25
1650086719587,MATH 20B,B01,084126,Um; Ko Woon,24,0,35,11
1650086725617,MATH 20C,A01,083446,Hammock; Frances H,0,0,30,30
1650086725617,MATH 20C,A02,083447,Hammock; Frances H,13,0,30,17
1650086725617,MATH 20C,A03,083448,Hammock; Frances H,18,0,30,12
1650086725617,MATH 20C,A04,083449,Hammock; Frances H,20,0,30,10
1650086725617,MATH 20C,B01,083451,Hammock; Frances H,0,0,30,30
1650086725617,MATH 20C,B02,083452,Hammock; Frances H,15,0,30,15
1650086725617,MATH 20C,B03,083453,Hammock; Frances H,19,0,30,11
1650086725617,MATH 20C,B04,083454,Hammock; Frances H,23,0,30,7
1650086731648,MATH 20D,A01,084128,Staff,13,0,30,17
1650086731648,MATH 20D,A02,084129,Staff,29,0,30,1
1650086731648,MATH 20D,A03,084130,Staff,28,0,30,2
1650086731648,MATH 20D,B01,084133,Staff,0,0,30,30
1650086731648,MATH 20D,B02,084134,Staff,23,0,30,7
1650086731648,MATH 20D,B03,084135,Staff,28,0,30,2
1650086737675,MATH 20E,A01,084138,Staff,13,0,30,17
1650086737675,MATH 20E,A02,084139,Staff,6,0,30,24
1650086737675,MATH 20E,A03,084140,Staff,14,0,30,16
1650086737675,MATH 20E,A04,084141,Staff,19,0,30,11
1650086743700,MATH 102,A01,084143,Harel; Guershon,11,0,30,19
1650086743700,MATH 102,A02,084144,Harel; Guershon,19,0,30,11
1650086749723,MATH 103B,A01,083456,Staff,0,13,30,30
1650086749723,MATH 103B,A02,083457,Staff,0,14,30,30
1650086755747,MATH 109,A01,084146,Salehi Golsefidy; Alireza,16,0,30,14
1650086755747,MATH 109,A02,084147,Salehi Golsefidy; Alireza,15,0,30,15
1650086761771,MATH 120A,A01,085445,Eggers; John Dietrich,6,0,35,29
1650086761771,MATH 120A,A02,085446,Eggers; John Dietrich,26,0,35,9
1650086767796,MATH 142B,A01,084149,Verstraete; Jacques Allan,0,12,30,30
1650086767796,MATH 142B,A02,084150,Verstraete; Jacques Allan,0,12,30,30
1650086773826,MATH 170A,A01,083459,Nie; Jiawang,0,11,30,30
1650086773826,MATH 170A,A02,083460,Nie; Jiawang,0,10,30,30
1650086773826,MATH 170A,A03,083461,Nie; Jiawang,0,11,30,30
1650086779851,MATH 193B,A01,083463,Staff,1,0,30,29
1650086779851,MATH 193B,A02,083464,Staff,8,0,30,22
1650086779851,MATH 193B,A03,083465,Staff,16,0,30,14
1650086785902,COGS 2,A01,083966,Boyle; Mary E. T.,9,0,30,21
1650086791937,COGS 9,A01,083968,Staff,3,0,60,57
1650086797964,COGS 14B,A01,083970,Staff,8,0,50,42
1650086803991,COGS 17,A01,092679,Staff,49,0,75,26
1650086810018,COGS 100,A01,083972,Staff,0,19,60,60
1650086822070,COGS 101C,A01,083976,Staff,12,0,30,18
1650086828093,COGS 102A,A01,083978,Johnson; Christine M.,10,0,30,20
1650086834115,COGS 107B,A01,083980,Staff,0,9,50,50
1650086840140,COGS 115,A01,083982,Staff,9,0,30,21
1650086846164,COGS 118B,A01,083367,Staff,0,16,40,40
1650086852196,COGS 172,A01,083984,Provenzano; Emily Kara,13,0,30,17
1650086858223,COGS 177,A00,083368,Staff,0,22,30,30
1650086864252,COGS 186,A01,083986,Staff,21,0,40,19
1650086870275,COGS 187A,A01,083988,Boyle; Mary E. T.,16,0,60,44
1650086876302,CSE 8A,A50,084003,Miranda; Gregory Joseph,0,18,15,15
1650086882330,CSE 11,A01,084005,Miranda; Gregory Joseph,0,24,55,55
1650086888353,CSE 20,A01,084007,Staff,0,5,20,20
1650086894384,CSE 21,A01,084009,Staff,0,32,50,50
1650086900414,CSE 30,A01,083370,Cao; Yingjun,0,63,40,40
1650086906442,CSE 100,A01,083372,Cao; Yingjun,0,48,40,40
1650086912474,CSE 101,A01,084011,Staff,0,56,40,40
1650086918501,CSE 141,A01,083374,Eldon; John,0,69,75,75
1650086924524,CSE 141L,A01,083376,Eldon; John,0,75,75,75
1650086930548,CSE 175,A01,084013,Kumar; Rakesh,22,0,25,3
1650086936571,CSE 190,A00,092508,Dubnov; Shlomo,18,0,20,2
1650086942594,ECE 5,A01,084049,Morris; Karcher William,12,0,20,8
1650086948619,ECE 100,A01,084051,Baghdadchi; Saharnaz,0,0,20,20
1650086948619,ECE 100,A02,091916,Baghdadchi; Saharnaz,11,0,20,9
1650086954644,ECE 101,A01,084053,Baghdadchi; Saharnaz,0,0,37,37
1650086954644,ECE 101,A02,084054,Baghdadchi; Saharnaz,27,0,37,10
1650086960671,ECE 107,A01,083390,Staff,26,0,40,14
1650086966695,ECE 148,A01,084056,Silberman; Jack,8,0,12,4
1650086972722,ECE 180,A00,083391,Abi Samra; Nicholas Camill,25,0,30,5
1650086972722,ECE 180,B00,083392,Abi Samra; Nicholas Camill,21,0,30,9
1650086978749,MATH 10B,A01,084110,Staff,0,0,30,30
1650086978749,MATH 10B,A02,084111,Staff,16,0,30,14
1650086978749,MATH 10B,A03,084112,Staff,23,0,30,7
1650086984774,MATH 10C,A01,083443,Staff,0,17,30,31
1650086984774,MATH 10C,A02,083444,Staff,0,18,30,30
1650086984774,MATH 10C,B01,084114,Staff,17,0,30,13
1650086984774,MATH 10C,B02,084115,Staff,24,0,30,6
1650086990801,MATH 18,A01,084117,Harel; Guershon,11,0,30,19
1650086990801,MATH 18,A02,084119,Harel; Guershon,27,0,30,3
1650086990801,MATH 18,A03,084120,Harel; Guershon,30,0,30,0
1650086990801,MATH 18,A04,084121,Harel; Guershon,29,0,30,1
1650086996829,MATH 20B,A01,084124,Um; Ko Woon,10,0,35,25
1650086996829,MATH 20B,B01,084126,Um; Ko Woon,24,0,35,11
1650087002853,MATH 20C,A01,083446,Hammock; Frances H,0,0,30,30
1650087002853,MATH 20C,A02,083447,Hammock; Frances H,13,0,30,17
1650087002853,MATH 20C,A03,083448,Hammock; Frances H,18,0,30,12
1650087002853,MATH 20C,A04,083449,Hammock; Frances H,20,0,30,10
1650087002853,MATH 20C,B01,083451,Hammock; Frances H,0,0,30,30
1650087002853,MATH 20C,B02,083452,Hammock; Frances H,15,0,30,15
1650087002853,MATH 20C,B03,083453,Hammock; Frances H,19,0,30,11
1650087002853,MATH 20C,B04,083454,Hammock; Frances H,23,0,30,7
1650087008876,MATH 20D,A01,084128,Staff,13,0,30,17
1650087008876,MATH 20D,A02,084129,Staff,29,0,30,1
1650087008876,MATH 20D,A03,084130,Staff,28,0,30,2
1650087008876,MATH 20D,B01,084133,Staff,0,0,30,30
1650087008876,MATH 20D,B02,084134,Staff,23,0,30,7
1650087008876,MATH 20D,B03,084135,Staff,28,0,30,2
1650087014900,MATH 20E,A01,084138,Staff,13,0,30,17
1650087014900,MATH 20E,A02,084139,Staff,6,0,30,24
1650087014900,MATH 20E,A03,084140,Staff,14,0,30,16
1650087014900,MATH 20E,A04,084141,Staff,19,0,30,11
1650087020926,MATH 102,A01,084143,Harel; Guershon,11,0,30,19
1650087020926,MATH 102,A02,084144,Harel; Guershon,19,0,30,11
1650087026950,MATH 103B,A01,083456,Staff,0,13,30,30
1650087026950,MATH 103B,A02,083457,Staff,0,14,30,30
1650087032974,MATH 109,A01,084146,Salehi Golsefidy; Alireza,16,0,30,14
1650087032974,MATH 109,A02,084147,Salehi Golsefidy; Alireza,15,0,30,15
1650087038997,MATH 120A,A01,085445,Eggers; John Dietrich,6,0,35,29
1650087038997,MATH 120A,A02,085446,Eggers; John Dietrich,26,0,35,9
1650087045021,MATH 142B,A01,084149,Verstraete; Jacques Allan,0,12,30,30
1650087045021,MATH 142B,A02,084150,Verstraete; Jacques Allan,0,12,30,30
1650087051044,MATH 170A,A01,083459,Nie; Jiawang,0,11,30,30
1650087051044,MATH 170A,A02,083460,Nie; Jiawang,0,10,30,30
1650087051044,MATH 170A,A03,083461,Nie; Jiawang,0,11,30,30
1650087057071,MATH 193B,A01,083463,Staff,1,0,30,29
1650087057071,MATH 193B,A02,083464,Staff,8,0,30,22
1650087057071,MATH 193B,A03,083465,Staff,16,0,30,14
1650087063125,COGS 2,A01,083966,Boyle; Mary E. T.,9,0,30,21
1650087069150,COGS 9,A01,083968,Staff,2,0,60,58
1650087075173,COGS 14B,A01,083970,Staff,8,0,50,42
1650087081196,COGS 17,A01,092679,Staff,49,0,75,26
1650087087219,COGS 100,A01,083972,Staff,0,19,60,60
1650087099270,COGS 101C,A01,083976,Staff,12,0,30,18
1650087105380,COGS 102A,A01,083978,Johnson; Christine M.,10,0,30,20
1650087111407,COGS 107B,A01,083980,Staff,0,9,50,50
1650087117444,COGS 115,A01,083982,Staff,9,0,30,21
1650087123468,COGS 118B,A01,083367,Staff,0,16,40,40
1650087129492,COGS 172,A01,083984,Provenzano; Emily Kara,13,0,30,17
1650087135518,COGS 177,A00,083368,Staff,0,22,30,30
1650087141544,COGS 186,A01,083986,Staff,21,0,40,19
1650087147569,COGS 187A,A01,083988,Boyle; Mary E. T.,16,0,60,44
1650087153594,CSE 8A,A50,084003,Miranda; Gregory Joseph,0,18,15,15
1650087159622,CSE 11,A01,084005,Miranda; Gregory Joseph,0,24,55,55
1650087165671,CSE 20,A01,084007,Staff,0,5,20,20
1650087171695,CSE 21,A01,084009,Staff,0,32,50,50
1650087177731,CSE 30,A01,083370,Cao; Yingjun,0,63,40,40
1650087183758,CSE 100,A01,083372,Cao; Yingjun,0,48,40,40
1650087189781,CSE 101,A01,084011,Staff,0,56,40,40
1650087195805,CSE 141,A01,083374,Eldon; John,0,69,75,75
1650087201835,CSE 141L,A01,083376,Eldon; John,0,75,75,75
1650087207858,CSE 175,A01,084013,Kumar; Rakesh,22,0,25,3
1650087213885,CSE 190,A00,092508,Dubnov; Shlomo,18,0,20,2
1650087219909,ECE 5,A01,084049,Morris; Karcher William,12,0,20,8
1650087225932,ECE 100,A01,084051,Baghdadchi; Saharnaz,0,0,20,20
1650087225932,ECE 100,A02,091916,Baghdadchi; Saharnaz,11,0,20,9
1650087231956,ECE 101,A01,084053,Baghdadchi; Saharnaz,0,0,37,37
1650087231956,ECE 101,A02,084054,Baghdadchi; Saharnaz,27,0,37,10
1650087237985,ECE 107,A01,083390,Staff,26,0,40,14
1650087244022,ECE 148,A01,084056,Silberman; Jack,8,0,12,4
1650087250046,ECE 180,A00,083391,Abi Samra; Nicholas Camill,25,0,30,5
1650087250046,ECE 180,B00,083392,Abi Samra; Nicholas Camill,21,0,30,9
1650087256069,MATH 10B,A01,084110,Staff,0,0,30,30
1650087256069,MATH 10B,A02,084111,Staff,16,0,30,14
1650087256069,MATH 10B,A03,084112,Staff,23,0,30,7
1650087262094,MATH 10C,A01,083443,Staff,0,17,30,31
1650087262094,MATH 10C,A02,083444,Staff,0,18,30,30
1650087262094,MATH 10C,B01,084114,Staff,17,0,30,13
1650087262094,MATH 10C,B02,084115,Staff,24,0,30,6
1650087268119,MATH 18,A01,084117,Harel; Guershon,11,0,30,19
1650087268119,MATH 18,A02,084119,Harel; Guershon,27,0,30,3
1650087268119,MATH 18,A03,084120,Harel; Guershon,30,0,30,0
1650087268119,MATH 18,A04,084121,Harel; Guershon,29,0,30,1
1650087274147,MATH 20B,A01,084124,Um; Ko Woon,10,0,35,25
1650087274147,MATH 20B,B01,084126,Um; Ko Woon,24,0,35,11
1650087280175,MATH 20C,A01,083446,Hammock; Frances H,0,0,30,30
1650087280175,MATH 20C,A02,083447,Hammock; Frances H,13,0,30,17
1650087280175,MATH 20C,A03,083448,Hammock; Frances H,18,0,30,12
1650087280175,MATH 20C,A04,083449,Hammock; Frances H,20,0,30,10
1650087280175,MATH 20C,B01,083451,Hammock; Frances H,0,0,30,30
1650087280175,MATH 20C,B02,083452,Hammock; Frances H,15,0,30,15
1650087280175,MATH 20C,B03,083453,Hammock; Frances H,19,0,30,11
1650087280175,MATH 20C,B04,083454,Hammock; Frances H,23,0,30,7
1650087286201,MATH 20D,A01,084128,Staff,13,0,30,17
1650087286201,MATH 20D,A02,084129,Staff,29,0,30,1
1650087286201,MATH 20D,A03,084130,Staff,28,0,30,2
1650087286201,MATH 20D,B01,084133,Staff,0,0,30,30
1650087286201,MATH 20D,B02,084134,Staff,23,0,30,7
1650087286201,MATH 20D,B03,084135,Staff,28,0,30,2
1650087292226,MATH 20E,A01,084138,Staff,13,0,30,17
1650087292226,MATH 20E,A02,084139,Staff,6,0,30,24
1650087292226,MATH 20E,A03,084140,Staff,14,0,30,16
1650087292226,MATH 20E,A04,084141,Staff,19,0,30,11
1650087298253,MATH 102,A01,084143,Harel; Guershon,11,0,30,19
1650087298253,MATH 102,A02,084144,Harel; Guershon,19,0,30,11
1650087304335,MATH 103B,A01,083456,Staff,0,13,30,30
1650087304335,MATH 103B,A02,083457,Staff,0,14,30,30
1650087310358,MATH 109,A01,084146,Salehi Golsefidy; Alireza,16,0,30,14
1650087310358,MATH 109,A02,084147,Salehi Golsefidy; Alireza,15,0,30,15
1650087316386,MATH 120A,A01,085445,Eggers; John Dietrich,6,0,35,29
1650087316386,MATH 120A,A02,085446,Eggers; John Dietrich,26,0,35,9
1650087322411,MATH 142B,A01,084149,Verstraete; Jacques Allan,0,12,30,30
1650087322411,MATH 142B,A02,084150,Verstraete; Jacques Allan,0,12,30,30
1650087328435,MATH 170A,A01,083459,Nie; Jiawang,0,11,30,30
1650087328435,MATH 170A,A02,083460,Nie; Jiawang,0,10,30,30
1650087328435,MATH 170A,A03,083461,Nie; Jiawang,0,11,30,30
1650087334463,MATH 193B,A01,083463,Staff,1,0,30,29
1650087334463,MATH 193B,A02,083464,Staff,8,0,30,22
1650087334463,MATH 193B,A03,083465,Staff,16,0,30,14
1650087340527,COGS 2,A01,083966,Boyle; Mary E. T.,9,0,30,21
1650087346553,COGS 9,A01,083968,Staff,2,0,60,58
1650087352580,COGS 14B,A01,083970,Staff,7,0,50,43
1650087358606,COGS 17,A01,092679,Staff,49,0,75,26
1650087364634,COGS 100,A01,083972,Staff,0,19,60,60
1650087376682,COGS 101C,A01,083976,Staff,12,0,30,18
1650087382706,COGS 102A,A01,083978,Johnson; Christine M.,10,0,30,20
1650087388732,COGS 107B,A01,083980,Staff,0,9,50,50
1650087394755,COGS 115,A01,083982,Staff,9,0,30,21
1650087400779,COGS 118B,A01,083367,Staff,0,16,40,40
1650087406803,COGS 172,A01,083984,Provenzano; Emily Kara,13,0,30,17
1650087412827,COGS 177,A00,083368,Staff,0,22,30,30
1650087418854,COGS 186,A01,083986,Staff,21,0,40,19
1650087424880,COGS 187A,A01,083988,Boyle; Mary E. T.,16,0,60,44
1650087430908,CSE 8A,A50,084003,Miranda; Gregory Joseph,0,18,15,15
1650087436932,CSE 11,A01,084005,Miranda; Gregory Joseph,0,24,55,55
1650087442955,CSE 20,A01,084007,Staff,0,5,20,20
1650087448978,CSE 21,A01,084009,Staff,0,32,50,50
1650087455005,CSE 30,A01,083370,Cao; Yingjun,0,63,40,40
1650087461029,CSE 100,A01,083372,Cao; Yingjun,0,48,40,40
1650087467050,CSE 101,A01,084011,Staff,0,56,40,40
1650087473079,CSE 141,A01,083374,Eldon; John,0,69,75,75
1650087479103,CSE 141L,A01,083376,Eldon; John,0,75,75,75
1650087485125,CSE 175,A01,084013,Kumar; Rakesh,22,0,25,3
1650087491152,CSE 190,A00,092508,Dubnov; Shlomo,18,0,20,2
1650087497176,ECE 5,A01,084049,Morris; Karcher William,12,0,20,8
1650087503201,ECE 100,A01,084051,Baghdadchi; Saharnaz,0,0,20,20
1650087503201,ECE 100,A02,091916,Baghdadchi; Saharnaz,11,0,20,9
1650087509228,ECE 101,A01,084053,Baghdadchi; Saharnaz,0,0,37,37
1650087509228,ECE 101,A02,084054,Baghdadchi; Saharnaz,27,0,37,10
1650087515252,ECE 107,A01,083390,Staff,26,0,40,14
1650087521276,ECE 148,A01,084056,Silberman; Jack,8,0,12,4
1650087527299,ECE 180,A00,083391,Abi Samra; Nicholas Camill,25,0,30,5
1650087527299,ECE 180,B00,083392,Abi Samra; Nicholas Camill,21,0,30,9
1650087533323,MATH 10B,A01,084110,Staff,0,0,30,30
1650087533323,MATH 10B,A02,084111,Staff,16,0,30,14
1650087533323,MATH 10B,A03,084112,Staff,23,0,30,7
1650087539348,MATH 10C,A01,083443,Staff,0,17,30,31
1650087539348,MATH 10C,A02,083444,Staff,0,18,30,30
1650087539348,MATH 10C,B01,084114,Staff,17,0,30,13
1650087539348,MATH 10C,B02,084115,Staff,24,0,30,6
1650087545378,MATH 18,A01,084117,Harel; Guershon,11,0,30,19
1650087545378,MATH 18,A02,084119,Harel; Guershon,27,0,30,3
1650087545378,MATH 18,A03,084120,Harel; Guershon,30,0,30,0
1650087545378,MATH 18,A04,084121,Harel; Guershon,29,0,30,1
1650087551402,MATH 20B,A01,084124,Um; Ko Woon,10,0,35,25
1650087551402,MATH 20B,B01,084126,Um; Ko Woon,24,0,35,11
1650087557428,MATH 20C,A01,083446,Hammock; Frances H,0,0,30,30
1650087557428,MATH 20C,A02,083447,Hammock; Frances H,13,0,30,17
1650087557428,MATH 20C,A03,083448,Hammock; Frances H,18,0,30,12
1650087557428,MATH 20C,A04,083449,Hammock; Frances H,20,0,30,10
1650087557428,MATH 20C,B01,083451,Hammock; Frances H,0,0,30,30
1650087557428,MATH 20C,B02,083452,Hammock; Frances H,15,0,30,15
1650087557428,MATH 20C,B03,083453,Hammock; Frances H,19,0,30,11
1650087557428,MATH 20C,B04,083454,Hammock; Frances H,23,0,30,7
1650087563452,MATH 20D,A01,084128,Staff,13,0,30,17
1650087563452,MATH 20D,A02,084129,Staff,29,0,30,1
1650087563452,MATH 20D,A03,084130,Staff,28,0,30,2
1650087563452,MATH 20D,B01,084133,Staff,0,0,30,30
1650087563452,MATH 20D,B02,084134,Staff,23,0,30,7
1650087563452,MATH 20D,B03,084135,Staff,28,0,30,2
1650087569479,MATH 20E,A01,084138,Staff,13,0,30,17
1650087569479,MATH 20E,A02,084139,Staff,6,0,30,24
1650087569479,MATH 20E,A03,084140,Staff,14,0,30,16
1650087569479,MATH 20E,A04,084141,Staff,19,0,30,11
1650087575508,MATH 102,A01,084143,Harel; Guershon,11,0,30,19
1650087575508,MATH 102,A02,084144,Harel; Guershon,19,0,30,11
1650087581532,MATH 103B,A01,083456,Staff,0,13,30,30
1650087581532,MATH 103B,A02,083457,Staff,0,14,30,30
1650087587559,MATH 109,A01,084146,Salehi Golsefidy; Alireza,16,0,30,14
1650087587559,MATH 109,A02,084147,Salehi Golsefidy; Alireza,15,0,30,15
1650087593583,MATH 120A,A01,085445,Eggers; John Dietrich,6,0,35,29
1650087593583,MATH 120A,A02,085446,Eggers; John Dietrich,26,0,35,9
1650087599611,MATH 142B,A01,084149,Verstraete; Jacques Allan,0,12,30,30
1650087599611,MATH 142B,A02,084150,Verstraete; Jacques Allan,0,12,30,30
1650087605635,MATH 170A,A01,083459,Nie; Jiawang,0,11,30,30
1650087605635,MATH 170A,A02,083460,Nie; Jiawang,0,10,30,30
1650087605635,MATH 170A,A03,083461,Nie; Jiawang,0,11,30,30
1650087611659,MATH 193B,A01,083463,Staff,1,0,30,29
1650087611659,MATH 193B,A02,083464,Staff,8,0,30,22
1650087611659,MATH 193B,A03,083465,Staff,16,0,30,14
1650087617710,COGS 2,A01,083966,Boyle; Mary E. T.,9,0,30,21
1650087623738,COGS 9,A01,083968,Staff,2,0,60,58
1650087629767,COGS 14B,A01,083970,Staff,7,0,50,43
1650087635791,COGS 17,A01,092679,Staff,49,0,75,26
1650087641815,COGS 100,A01,083972,Staff,0,19,60,60
1650087653864,COGS 101C,A01,083976,Staff,12,0,30,18
1650087659889,COGS 102A,A01,083978,Johnson; Christine M.,10,0,30,20
1650087665914,COGS 107B,A01,083980,Staff,0,9,50,50
1650087671946,COGS 115,A01,083982,Staff,9,0,30,21
1650087677979,COGS 118B,A01,083367,Staff,0,16,40,40
1650087684002,COGS 172,A01,083984,Provenzano; Emily Kara,13,0,30,17
1650087690030,COGS 177,A00,083368,Staff,0,22,30,30
1650087696054,COGS 186,A01,083986,Staff,21,0,40,19
1650087702159,COGS 187A,A01,083988,Boyle; Mary E. T.,16,0,60,44
1650087708183,CSE 8A,A50,084003,Miranda; Gregory Joseph,0,18,15,15
1650087714210,CSE 11,A01,084005,Miranda; Gregory Joseph,0,24,55,55
1650087720233,CSE 20,A01,084007,Staff,0,5,20,20
1650087726263,CSE 21,A01,084009,Staff,0,32,50,50
1650087732289,CSE 30,A01,083370,Cao; Yingjun,0,63,40,40
1650087738332,CSE 100,A01,083372,Cao; Yingjun,0,48,40,40
1650087744354,CSE 101,A01,084011,Staff,0,56,40,40
1650087750380,CSE 141,A01,083374,Eldon; John,0,69,75,75
1650087756404,CSE 141L,A01,083376,Eldon; John,0,75,75,75
1650087762430,CSE 175,A01,084013,Kumar; Rakesh,22,0,25,3
1650087768454,CSE 190,A00,092508,Dubnov; Shlomo,18,0,20,2
1650087774481,ECE 5,A01,084049,Morris; Karcher William,12,0,20,8
1650087780507,ECE 100,A01,084051,Baghdadchi; Saharnaz,0,0,20,20
1650087780507,ECE 100,A02,091916,Baghdadchi; Saharnaz,11,0,20,9
1650087786531,ECE 101,A01,084053,Baghdadchi; Saharnaz,0,0,37,37
1650087786531,ECE 101,A02,084054,Baghdadchi; Saharnaz,27,0,37,10
1650087792558,ECE 107,A01,083390,Staff,26,0,40,14
1650087798582,ECE 148,A01,084056,Silberman; Jack,8,0,12,4
1650087804606,ECE 180,A00,083391,Abi Samra; Nicholas Camill,25,0,30,5
1650087804606,ECE 180,B00,083392,Abi Samra; Nicholas Camill,21,0,30,9
1650087810630,MATH 10B,A01,084110,Staff,0,0,30,30
1650087810630,MATH 10B,A02,084111,Staff,16,0,30,14
1650087810630,MATH 10B,A03,084112,Staff,23,0,30,7
1650087816657,MATH 10C,A01,083443,Staff,0,17,30,31
1650087816657,MATH 10C,A02,083444,Staff,0,18,30,30
1650087816657,MATH 10C,B01,084114,Staff,17,0,30,13
1650087816657,MATH 10C,B02,084115,Staff,24,0,30,6
1650087822682,MATH 18,A01,084117,Harel; Guershon,11,0,30,19
1650087822682,MATH 18,A02,084119,Harel; Guershon,27,0,30,3
1650087822682,MATH 18,A03,084120,Harel; Guershon,30,0,30,0
1650087822682,MATH 18,A04,084121,Harel; Guershon,29,0,30,1
1650087828709,MATH 20B,A01,084124,Um; Ko Woon,10,0,35,25
1650087828709,MATH 20B,B01,084126,Um; Ko Woon,24,0,35,11
1650087834739,MATH 20C,A01,083446,Hammock; Frances H,0,0,30,30
1650087834739,MATH 20C,A02,083447,Hammock; Frances H,13,0,30,17
1650087834739,MATH 20C,A03,083448,Hammock; Frances H,18,0,30,12
1650087834739,MATH 20C,A04,083449,Hammock; Frances H,20,0,30,10
1650087834739,MATH 20C,B01,083451,Hammock; Frances H,0,0,30,30
1650087834739,MATH 20C,B02,083452,Hammock; Frances H,15,0,30,15
1650087834739,MATH 20C,B03,083453,Hammock; Frances H,19,0,30,11
1650087834739,MATH 20C,B04,083454,Hammock; Frances H,23,0,30,7
1650087840766,MATH 20D,A01,084128,Staff,13,0,30,17
1650087840766,MATH 20D,A02,084129,Staff,29,0,30,1
1650087840766,MATH 20D,A03,084130,Staff,28,0,30,2
1650087840766,MATH 20D,B01,084133,Staff,0,0,30,30
1650087840766,MATH 20D,B02,084134,Staff,23,0,30,7
1650087840766,MATH 20D,B03,084135,Staff,28,0,30,2
1650087846791,MATH 20E,A01,084138,Staff,13,0,30,17
1650087846791,MATH 20E,A02,084139,Staff,6,0,30,24
1650087846791,MATH 20E,A03,084140,Staff,14,0,30,16
1650087846791,MATH 20E,A04,084141,Staff,19,0,30,11
1650087852819,MATH 102,A01,084143,Harel; Guershon,11,0,30,19
1650087852819,MATH 102,A02,084144,Harel; Guershon,19,0,30,11
1650087858846,MATH 103B,A01,083456,Staff,0,13,30,30
1650087858846,MATH 103B,A02,083457,Staff,0,14,30,30
1650087864877,MATH 109,A01,084146,Salehi Golsefidy; Alireza,16,0,30,14
1650087864877,MATH 109,A02,084147,Salehi Golsefidy; Alireza,15,0,30,15
1650087870904,MATH 120A,A01,085445,Eggers; John Dietrich,6,0,35,29
1650087870904,MATH 120A,A02,085446,Eggers; John Dietrich,26,0,35,9
1650087876932,MATH 142B,A01,084149,Verstraete; Jacques Allan,0,12,30,30
1650087876932,MATH 142B,A02,084150,Verstraete; Jacques Allan,0,12,30,30
1650087882958,MATH 170A,A01,083459,Nie; Jiawang,0,11,30,30
1650087882958,MATH 170A,A02,083460,Nie; Jiawang,0,10,30,30
1650087882958,MATH 170A,A03,083461,Nie; Jiawang,0,11,30,30
1650087888984,MATH 193B,A01,083463,Staff,1,0,30,29
1650087888984,MATH 193B,A02,083464,Staff,8,0,30,22
1650087888984,MATH 193B,A03,083465,Staff,16,0,30,14
1650087895043,COGS 2,A01,083966,Boyle; Mary E. T.,9,0,30,21
1650087901067,COGS 9,A01,083968,Staff,2,0,60,58
1650087907089,COGS 14B,A01,083970,Staff,7,0,50,43
1650087913114,COGS 17,A01,092679,Staff,49,0,75,26
1650087919140,COGS 100,A01,083972,Staff,0,19,60,60
1650087931195,COGS 101C,A01,083976,Staff,12,0,30,18
1650087937222,COGS 102A,A01,083978,Johnson; Christine M.,10,0,30,20
1650087943249,COGS 107B,A01,083980,Staff,0,9,50,50
1650087949271,COGS 115,A01,083982,Staff,9,0,30,21
1650087955295,COGS 118B,A01,083367,Staff,0,16,40,40
1650087961320,COGS 172,A01,083984,Provenzano; Emily Kara,13,0,30,17
1650087967342,COGS 177,A00,083368,Staff,0,22,30,30
1650087973363,COGS 186,A01,083986,Staff,21,0,40,19
1650087979387,COGS 187A,A01,083988,Boyle; Mary E. T.,16,0,60,44
1650087985411,CSE 8A,A50,084003,Miranda; Gregory Joseph,0,19,15,15
1650087991440,CSE 11,A01,084005,Miranda; Gregory Joseph,0,24,55,55
1650087997467,CSE 20,A01,084007,Staff,0,5,20,20
1650088003491,CSE 21,A01,084009,Staff,0,32,50,50
1650088009522,CSE 30,A01,083370,Cao; Yingjun,0,63,40,40
1650088015548,CSE 100,A01,083372,Cao; Yingjun,0,48,40,40
1650088021575,CSE 101,A01,084011,Staff,0,56,40,40
1650088027602,CSE 141,A01,083374,Eldon; John,0,69,75,75
1650088033630,CSE 141L,A01,083376,Eldon; John,0,75,75,75
1650088039653,CSE 175,A01,084013,Kumar; Rakesh,22,0,25,3
1650088045677,CSE 190,A00,092508,Dubnov; Shlomo,18,0,20,2
1650088051713,ECE 5,A01,084049,Morris; Karcher William,12,0,20,8
1650088057741,ECE 100,A01,084051,Baghdadchi; Saharnaz,0,0,20,20
1650088057741,ECE 100,A02,091916,Baghdadchi; Saharnaz,11,0,20,9
1650088063773,ECE 101,A01,084053,Baghdadchi; Saharnaz,0,0,37,37
1650088063773,ECE 101,A02,084054,Baghdadchi; Saharnaz,27,0,37,10
1650088069794,ECE 107,A01,083390,Staff,26,0,40,14
1650088075834,ECE 148,A01,084056,Silberman; Jack,8,0,12,4
1650088081862,ECE 180,A00,083391,Abi Samra; Nicholas Camill,25,0,30,5
1650088081862,ECE 180,B00,083392,Abi Samra; Nicholas Camill,21,0,30,9
1650088087887,MATH 10B,A01,084110,Staff,0,0,30,30
1650088087887,MATH 10B,A02,084111,Staff,16,0,30,14
1650088087887,MATH 10B,A03,084112,Staff,23,0,30,7
1650088093915,MATH 10C,A01,083443,Staff,0,17,30,31
1650088093915,MATH 10C,A02,083444,Staff,0,18,30,30
1650088093915,MATH 10C,B01,084114,Staff,17,0,30,13
1650088093915,MATH 10C,B02,084115,Staff,24,0,30,6
1650088099944,MATH 18,A01,084117,Harel; Guershon,11,0,30,19
1650088099944,MATH 18,A02,084119,Harel; Guershon,27,0,30,3
1650088099944,MATH 18,A03,084120,Harel; Guershon,30,0,30,0
1650088099944,MATH 18,A04,084121,Harel; Guershon,29,0,30,1
1650088105972,MATH 20B,A01,084124,Um; Ko Woon,10,0,35,25
1650088105972,MATH 20B,B01,084126,Um; Ko Woon,24,0,35,11
1650088111997,MATH 20C,A01,083446,Hammock; Frances H,0,0,30,30
1650088111997,MATH 20C,A02,083447,Hammock; Frances H,13,0,30,17
1650088111997,MATH 20C,A03,083448,Hammock; Frances H,18,0,30,12
1650088111997,MATH 20C,A04,083449,Hammock; Frances H,20,0,30,10
1650088111997,MATH 20C,B01,083451,Hammock; Frances H,0,0,30,30
1650088111997,MATH 20C,B02,083452,Hammock; Frances H,15,0,30,15
1650088111997,MATH 20C,B03,083453,Hammock; Frances H,19,0,30,11
1650088111997,MATH 20C,B04,083454,Hammock; Frances H,23,0,30,7
1650088118020,MATH 20D,A01,084128,Staff,13,0,30,17
1650088118020,MATH 20D,A02,084129,Staff,29,0,30,1
1650088118020,MATH 20D,A03,084130,Staff,28,0,30,2
1650088118020,MATH 20D,B01,084133,Staff,0,0,30,30
1650088118020,MATH 20D,B02,084134,Staff,23,0,30,7
1650088118020,MATH 20D,B03,084135,Staff,28,0,30,2
1650088124047,MATH 20E,A01,084138,Staff,13,0,30,17
1650088124047,MATH 20E,A02,084139,Staff,6,0,30,24
1650088124047,MATH 20E,A03,084140,Staff,14,0,30,16
1650088124047,MATH 20E,A04,084141,Staff,19,0,30,11
1650088130072,MATH 102,A01,084143,Harel; Guershon,11,0,30,19
1650088130072,MATH 102,A02,084144,Harel; Guershon,19,0,30,11
1650088136101,MATH 103B,A01,083456,Staff,0,13,30,30
1650088136101,MATH 103B,A02,083457,Staff,0,14,30,30
1650088142126,MATH 109,A01,084146,Salehi Golsefidy; Alireza,16,0,30,14
1650088142126,MATH 109,A02,084147,Salehi Golsefidy; Alireza,15,0,30,15
1650088148149,MATH 120A,A01,085445,Eggers; John Dietrich,6,0,35,29
1650088148149,MATH 120A,A02,085446,Eggers; John Dietrich,26,0,35,9
1650088154178,MATH 142B,A01,084149,Verstraete; Jacques Allan,0,12,30,30
1650088154178,MATH 142B,A02,084150,Verstraete; Jacques Allan,0,12,30,30
1650088160201,MATH 170A,A01,083459,Nie; Jiawang,0,11,30,30
1650088160201,MATH 170A,A02,083460,Nie; Jiawang,0,10,30,30
1650088160201,MATH 170A,A03,083461,Nie; Jiawang,0,11,30,30
1650088166230,MATH 193B,A01,083463,Staff,1,0,30,29
1650088166230,MATH 193B,A02,083464,Staff,8,0,30,22
1650088166230,MATH 193B,A03,083465,Staff,16,0,30,14
1650088172283,COGS 2,A01,083966,Boyle; Mary E. T.,9,0,30,21
1650088178311,COGS 9,A01,083968,Staff,2,0,60,58
1650088184337,COGS 14B,A01,083970,Staff,7,0,50,43
1650088190360,COGS 17,A01,092679,Staff,49,0,75,26
1650088196383,COGS 100,A01,083972,Staff,0,19,60,60
1650088208435,COGS 101C,A01,083976,Staff,12,0,30,18
1650088214463,COGS 102A,A01,083978,Johnson; Christine M.,10,0,30,20
1650088220485,COGS 107B,A01,083980,Staff,0,9,50,50
1650088226507,COGS 115,A01,083982,Staff,9,0,30,21
1650088232532,COGS 118B,A01,083367,Staff,0,16,40,40
1650088238560,COGS 172,A01,083984,Provenzano; Emily Kara,13,0,30,17
1650088244584,COGS 177,A00,083368,Staff,0,22,30,30
1650088250611,COGS 186,A01,083986,Staff,21,0,40,19
1650088256635,COGS 187A,A01,083988,Boyle; Mary E. T.,16,0,60,44
1650088262658,CSE 8A,A50,084003,Miranda; Gregory Joseph,0,19,15,15
1650088268680,CSE 11,A01,084005,Miranda; Gregory Joseph,0,24,55,55
1650088274708,CSE 20,A01,084007,Staff,0,5,20,20
1650088280732,CSE 21,A01,084009,Staff,0,32,50,50
1650088286756,CSE 30,A01,083370,Cao; Yingjun,0,63,40,40
1650088292780,CSE 100,A01,083372,Cao; Yingjun,0,48,40,40
1650088298892,CSE 101,A01,084011,Staff,0,56,40,40
1650088304916,CSE 141,A01,083374,Eldon; John,0,69,75,75
1650088310940,CSE 141L,A01,083376,Eldon; John,0,75,75,75
1650088316968,CSE 175,A01,084013,Kumar; Rakesh,22,0,25,3
1650088322995,CSE 190,A00,092508,Dubnov; Shlomo,18,0,20,2
1650088329019,ECE 5,A01,084049,Morris; Karcher William,12,0,20,8
1650088335050,ECE 100,A01,084051,Baghdadchi; Saharnaz,0,0,20,20
1650088335050,ECE 100,A02,091916,Baghdadchi; Saharnaz,11,0,20,9
1650088341086,ECE 101,A01,084053,Baghdadchi; Saharnaz,0,0,37,37
1650088341086,ECE 101,A02,084054,Baghdadchi; Saharnaz,27,0,37,10
1650088347122,ECE 107,A01,083390,Staff,26,0,40,14
1650088353148,ECE 148,A01,084056,Silberman; Jack,8,0,12,4
1650088359171,ECE 180,A00,083391,Abi Samra; Nicholas Camill,25,0,30,5
1650088359171,ECE 180,B00,083392,Abi Samra; Nicholas Camill,21,0,30,9
1650088365193,MATH 10B,A01,084110,Staff,0,0,30,30
1650088365193,MATH 10B,A02,084111,Staff,16,0,30,14
1650088365193,MATH 10B,A03,084112,Staff,23,0,30,7
1650088371216,MATH 10C,A01,083443,Staff,0,17,30,31
1650088371216,MATH 10C,A02,083444,Staff,0,18,30,30
1650088371216,MATH 10C,B01,084114,Staff,17,0,30,13
1650088371216,MATH 10C,B02,084115,Staff,24,0,30,6
1650088377239,MATH 18,A01,084117,Harel; Guershon,11,0,30,19
1650088377239,MATH 18,A02,084119,Harel; Guershon,27,0,30,3
1650088377239,MATH 18,A03,084120,Harel; Guershon,30,0,30,0
1650088377239,MATH 18,A04,084121,Harel; Guershon,29,0,30,1
1650088383268,MATH 20B,A01,084124,Um; Ko Woon,10,0,35,25
1650088383268,MATH 20B,B01,084126,Um; Ko Woon,24,0,35,11
1650088389290,MATH 20C,A01,083446,Hammock; Frances H,0,0,30,30
1650088389290,MATH 20C,A02,083447,Hammock; Frances H,13,0,30,17
1650088389290,MATH 20C,A03,083448,Hammock; Frances H,18,0,30,12
1650088389290,MATH 20C,A04,083449,Hammock; Frances H,20,0,30,10
1650088389290,MATH 20C,B01,083451,Hammock; Frances H,0,0,30,30
1650088389290,MATH 20C,B02,083452,Hammock; Frances H,15,0,30,15
1650088389290,MATH 20C,B03,083453,Hammock; Frances H,19,0,30,11
1650088389290,MATH 20C,B04,083454,Hammock; Frances H,23,0,30,7
1650088395313,MATH 20D,A01,084128,Staff,13,0,30,17
1650088395313,MATH 20D,A02,084129,Staff,29,0,30,1
1650088395313,MATH 20D,A03,084130,Staff,28,0,30,2
1650088395313,MATH 20D,B01,084133,Staff,0,0,30,30
1650088395313,MATH 20D,B02,084134,Staff,23,0,30,7
1650088395313,MATH 20D,B03,084135,Staff,28,0,30,2
1650088401336,MATH 20E,A01,084138,Staff,13,0,30,17
1650088401336,MATH 20E,A02,084139,Staff,6,0,30,24
1650088401336,MATH 20E,A03,084140,Staff,14,0,30,16
1650088401336,MATH 20E,A04,084141,Staff,19,0,30,11
1650088407362,MATH 102,A01,084143,Harel; Guershon,11,0,30,19
1650088407362,MATH 102,A02,084144,Harel; Guershon,19,0,30,11
1650088413391,MATH 103B,A01,083456,Staff,0,13,30,30
1650088413391,MATH 103B,A02,083457,Staff,0,14,30,30
1650088419417,MATH 109,A01,084146,Salehi Golsefidy; Alireza,16,0,30,14
1650088419417,MATH 109,A02,084147,Salehi Golsefidy; Alireza,15,0,30,15
1650088425445,MATH 120A,A01,085445,Eggers; John Dietrich,6,0,35,29
1650088425445,MATH 120A,A02,085446,Eggers; John Dietrich,26,0,35,9
1650088431472,MATH 142B,A01,084149,Verstraete; Jacques Allan,0,12,30,30
1650088431472,MATH 142B,A02,084150,Verstraete; Jacques Allan,0,12,30,30
1650088437494,MATH 170A,A01,083459,Nie; Jiawang,0,11,30,30
1650088437494,MATH 170A,A02,083460,Nie; Jiawang,0,10,30,30
1650088437494,MATH 170A,A03,083461,Nie; Jiawang,0,11,30,30
1650088443541,MATH 193B,A01,083463,Staff,1,0,30,29
1650088443541,MATH 193B,A02,083464,Staff,8,0,30,22
1650088443541,MATH 193B,A03,083465,Staff,16,0,30,14
1650088449590,COGS 2,A01,083966,Boyle; Mary E. T.,9,0,30,21
1650088455613,COGS 9,A01,083968,Staff,2,0,60,58
1650088461640,COGS 14B,A01,083970,Staff,7,0,50,43
1650088467663,COGS 17,A01,092679,Staff,49,0,75,26
1650088473690,COGS 100,A01,083972,Staff,0,19,60,60
1650088485753,COGS 101C,A01,083976,Staff,12,0,30,18
1650088491781,COGS 102A,A01,083978,Johnson; Christine M.,10,0,30,20
1650088497807,COGS 107B,A01,083980,Staff,0,9,50,50
1650088503831,COGS 115,A01,083982,Staff,9,0,30,21
1650088509858,COGS 118B,A01,083367,Staff,0,16,40,40
1650088515882,COGS 172,A01,083984,Provenzano; Emily Kara,13,0,30,17
1650088521906,COGS 177,A00,083368,Staff,0,22,30,30
1650088527938,COGS 186,A01,083986,Staff,21,0,40,19
1650088533962,COGS 187A,A01,083988,Boyle; Mary E. T.,16,0,60,44
1650088539987,CSE 8A,A50,084003,Miranda; Gregory Joseph,0,19,15,15
1650088546010,CSE 11,A01,084005,Miranda; Gregory Joseph,0,24,55,55
1650088552042,CSE 20,A01,084007,Staff,0,5,20,20
1650088558069,CSE 21,A01,084009,Staff,0,32,50,50
1650088564096,CSE 30,A01,083370,Cao; Yingjun,0,63,40,40
1650088570120,CSE 100,A01,083372,Cao; Yingjun,0,48,40,40
1650088576146,CSE 101,A01,084011,Staff,0,56,40,40
1650088582173,CSE 141,A01,083374,Eldon; John,0,69,75,75
1650088588200,CSE 141L,A01,083376,Eldon; John,0,75,75,75
1650088594228,CSE 175,A01,084013,Kumar; Rakesh,22,0,25,3
1650088600254,CSE 190,A00,092508,Dubnov; Shlomo,18,0,20,2
1650088606278,ECE 5,A01,084049,Morris; Karcher William,12,0,20,8
1650088612307,ECE 100,A01,084051,Baghdadchi; Saharnaz,0,0,20,20
1650088612307,ECE 100,A02,091916,Baghdadchi; Saharnaz,11,0,20,9
1650088618332,ECE 101,A01,084053,Baghdadchi; Saharnaz,0,0,37,37
1650088618332,ECE 101,A02,084054,Baghdadchi; Saharnaz,27,0,37,10
1650088624360,ECE 107,A01,083390,Staff,26,0,40,14
1650088630388,ECE 148,A01,084056,Silberman; Jack,8,0,12,4
1650088636415,ECE 180,A00,083391,Abi Samra; Nicholas Camill,25,0,30,5
1650088636415,ECE 180,B00,083392,Abi Samra; Nicholas Camill,21,0,30,9
1650088642442,MATH 10B,A01,084110,Staff,0,0,30,30
1650088642442,MATH 10B,A02,084111,Staff,16,0,30,14
1650088642442,MATH 10B,A03,084112,Staff,23,0,30,7
1650088648469,MATH 10C,A01,083443,Staff,0,17,30,31
1650088648469,MATH 10C,A02,083444,Staff,0,18,30,30
1650088648469,MATH 10C,B01,084114,Staff,17,0,30,13
1650088648469,MATH 10C,B02,084115,Staff,24,0,30,6
1650088654493,MATH 18,A01,084117,Harel; Guershon,11,0,30,19
1650088654493,MATH 18,A02,084119,Harel; Guershon,27,0,30,3
1650088654493,MATH 18,A03,084120,Harel; Guershon,30,0,30,0
1650088654493,MATH 18,A04,084121,Harel; Guershon,29,0,30,1
1650088660545,MATH 20B,A01,084124,Um; Ko Woon,10,0,35,25
1650088660545,MATH 20B,B01,084126,Um; Ko Woon,24,0,35,11
1650088666574,MATH 20C,A01,083446,Hammock; Frances H,0,0,30,30
1650088666574,MATH 20C,A02,083447,Hammock; Frances H,13,0,30,17
1650088666574,MATH 20C,A03,083448,Hammock; Frances H,18,0,30,12
1650088666574,MATH 20C,A04,083449,Hammock; Frances H,20,0,30,10
1650088666574,MATH 20C,B01,083451,Hammock; Frances H,0,0,30,30
1650088666574,MATH 20C,B02,083452,Hammock; Frances H,15,0,30,15
1650088666574,MATH 20C,B03,083453,Hammock; Frances H,19,0,30,11
1650088666574,MATH 20C,B04,083454,Hammock; Frances H,23,0,30,7
1650088672599,MATH 20D,A01,084128,Staff,13,0,30,17
1650088672599,MATH 20D,A02,084129,Staff,29,0,30,1
1650088672599,MATH 20D,A03,084130,Staff,28,0,30,2
1650088672599,MATH 20D,B01,084133,Staff,0,0,30,30
1650088672599,MATH 20D,B02,084134,Staff,23,0,30,7
1650088672599,MATH 20D,B03,084135,Staff,28,0,30,2
1650088678626,MATH 20E,A01,084138,Staff,13,0,30,17
1650088678626,MATH 20E,A02,084139,Staff,6,0,30,24
1650088678626,MATH 20E,A03,084140,Staff,14,0,30,16
1650088678626,MATH 20E,A04,084141,Staff,19,0,30,11
1650088684651,MATH 102,A01,084143,Harel; Guershon,11,0,30,19
1650088684651,MATH 102,A02,084144,Harel; Guershon,19,0,30,11
1650088690678,MATH 103B,A01,083456,Staff,0,13,30,30
1650088690678,MATH 103B,A02,083457,Staff,0,14,30,30
1650088696712,MATH 109,A01,084146,Salehi Golsefidy; Alireza,16,0,30,14
1650088696712,MATH 109,A02,084147,Salehi Golsefidy; Alireza,15,0,30,15
1650088702737,MATH 120A,A01,085445,Eggers; John Dietrich,6,0,35,29
1650088702737,MATH 120A,A02,085446,Eggers; John Dietrich,26,0,35,9
1650088708764,MATH 142B,A01,084149,Verstraete; Jacques Allan,0,12,30,30
1650088708764,MATH 142B,A02,084150,Verstraete; Jacques Allan,0,12,30,30
1650088714787,MATH 170A,A01,083459,Nie; Jiawang,0,11,30,30
1650088714787,MATH 170A,A02,083460,Nie; Jiawang,0,10,30,30
1650088714787,MATH 170A,A03,083461,Nie; Jiawang,0,11,30,30
1650088720811,MATH 193B,A01,083463,Staff,1,0,30,29
1650088720811,MATH 193B,A02,083464,Staff,8,0,30,22
1650088720811,MATH 193B,A03,083465,Staff,16,0,30,14
1650088726861,COGS 2,A01,083966,Boyle; Mary E. T.,9,0,30,21
1650088732889,COGS 9,A01,083968,Staff,2,0,60,58
1650088738916,COGS 14B,A01,083970,Staff,7,0,50,43
1650088744942,COGS 17,A01,092679,Staff,49,0,75,26
1650088750970,COGS 100,A01,083972,Staff,0,19,60,60
1650088763024,COGS 101C,A01,083976,Staff,12,0,30,18
1650088769051,COGS 102A,A01,083978,Johnson; Christine M.,10,0,30,20
1650088775076,COGS 107B,A01,083980,Staff,0,9,50,50
1650088781103,COGS 115,A01,083982,Staff,9,0,30,21
1650088787130,COGS 118B,A01,083367,Staff,0,16,40,40
1650088793154,COGS 172,A01,083984,Provenzano; Emily Kara,13,0,30,17
1650088799180,COGS 177,A00,083368,Staff,0,22,30,30
1650088805210,COGS 186,A01,083986,Staff,21,0,40,19
1650088811233,COGS 187A,A01,083988,Boyle; Mary E. T.,16,0,60,44
1650088817258,CSE 8A,A50,084003,Miranda; Gregory Joseph,0,19,15,15
1650088823286,CSE 11,A01,084005,Miranda; Gregory Joseph,0,24,55,55
1650088829312,CSE 20,A01,084007,Staff,0,5,20,20
1650088835346,CSE 21,A01,084009,Staff,0,32,50,50
1650088841378,CSE 30,A01,083370,Cao; Yingjun,0,63,40,40
1650088847407,CSE 100,A01,083372,Cao; Yingjun,0,48,40,40
1650088853448,CSE 101,A01,084011,Staff,0,56,40,40
1650088859476,CSE 141,A01,083374,Eldon; John,0,69,75,75
1650088865504,CSE 141L,A01,083376,Eldon; John,0,75,75,75
1650088871530,CSE 175,A01,084013,Kumar; Rakesh,22,0,25,3
1650088877559,CSE 190,A00,092508,Dubnov; Shlomo,18,0,20,2
1650088883598,ECE 5,A01,084049,Morris; Karcher William,12,0,20,8
1650088889636,ECE 100,A01,084051,Baghdadchi; Saharnaz,0,0,20,20
1650088889636,ECE 100,A02,091916,Baghdadchi; Saharnaz,11,0,20,9
1650088895753,ECE 101,A01,084053,Baghdadchi; Saharnaz,0,0,37,37
1650088895753,ECE 101,A02,084054,Baghdadchi; Saharnaz,27,0,37,10
1650088901783,ECE 107,A01,083390,Staff,26,0,40,14
1650088907815,ECE 148,A01,084056,Silberman; Jack,8,0,12,4
1650088913842,ECE 180,A00,083391,Abi Samra; Nicholas Camill,25,0,30,5
1650088913842,ECE 180,B00,083392,Abi Samra; Nicholas Camill,21,0,30,9
1650088919865,MATH 10B,A01,084110,Staff,0,0,30,30
1650088919865,MATH 10B,A02,084111,Staff,16,0,30,14
1650088919865,MATH 10B,A03,084112,Staff,23,0,30,7
1650088925892,MATH 10C,A01,083443,Staff,0,17,30,31
1650088925892,MATH 10C,A02,083444,Staff,0,18,30,30
1650088925892,MATH 10C,B01,084114,Staff,17,0,30,13
1650088925892,MATH 10C,B02,084115,Staff,24,0,30,6
1650088931916,MATH 18,A01,084117,Harel; Guershon,11,0,30,19
1650088931916,MATH 18,A02,084119,Harel; Guershon,27,0,30,3
1650088931916,MATH 18,A03,084120,Harel; Guershon,30,0,30,0
1650088931916,MATH 18,A04,084121,Harel; Guershon,29,0,30,1
1650088937939,MATH 20B,A01,084124,Um; Ko Woon,10,0,35,25
1650088937939,MATH 20B,B01,084126,Um; Ko Woon,24,0,35,11
1650088943970,MATH 20C,A01,083446,Hammock; Frances H,0,0,30,30
1650088943970,MATH 20C,A02,083447,Hammock; Frances H,13,0,30,17
1650088943970,MATH 20C,A03,083448,Hammock; Frances H,18,0,30,12
1650088943970,MATH 20C,A04,083449,Hammock; Frances H,20,0,30,10
1650088943970,MATH 20C,B01,083451,Hammock; Frances H,0,0,30,30
1650088943970,MATH 20C,B02,083452,Hammock; Frances H,15,0,30,15
1650088943970,MATH 20C,B03,083453,Hammock; Frances H,19,0,30,11
1650088943970,MATH 20C,B04,083454,Hammock; Frances H,23,0,30,7
1650088949995,MATH 20D,A01,084128,Staff,13,0,30,17
1650088949995,MATH 20D,A02,084129,Staff,29,0,30,1
1650088949995,MATH 20D,A03,084130,Staff,28,0,30,2
1650088949995,MATH 20D,B01,084133,Staff,0,0,30,30
1650088949995,MATH 20D,B02,084134,Staff,23,0,30,7
1650088949995,MATH 20D,B03,084135,Staff,28,0,30,2
1650088956019,MATH 20E,A01,084138,Staff,13,0,30,17
1650088956019,MATH 20E,A02,084139,Staff,6,0,30,24
1650088956019,MATH 20E,A03,084140,Staff,14,0,30,16
1650088956019,MATH 20E,A04,084141,Staff,19,0,30,11
1650088962049,MATH 102,A01,084143,Harel; Guershon,11,0,30,19
1650088962049,MATH 102,A02,084144,Harel; Guershon,18,0,30,12
1650088968073,MATH 103B,A01,083456,Staff,0,13,30,30
1650088968073,MATH 103B,A02,083457,Staff,0,14,30,30
1650088974114,MATH 109,A01,084146,Salehi Golsefidy; Alireza,16,0,30,14
1650088974114,MATH 109,A02,084147,Salehi Golsefidy; Alireza,15,0,30,15
1650088980136,MATH 120A,A01,085445,Eggers; John Dietrich,6,0,35,29
1650088980136,MATH 120A,A02,085446,Eggers; John Dietrich,26,0,35,9
1650088986159,MATH 142B,A01,084149,Verstraete; Jacques Allan,0,12,30,30
1650088986159,MATH 142B,A02,084150,Verstraete; Jacques Allan,0,12,30,30
1650088992182,MATH 170A,A01,083459,Nie; Jiawang,0,11,30,30
1650088992182,MATH 170A,A02,083460,Nie; Jiawang,0,10,30,30
1650088992182,MATH 170A,A03,083461,Nie; Jiawang,0,11,30,30
1650088998205,MATH 193B,A01,083463,Staff,1,0,30,29
1650088998205,MATH 193B,A02,083464,Staff,8,0,30,22
1650088998205,MATH 193B,A03,083465,Staff,16,0,30,14
1650089004261,COGS 2,A01,083966,Boyle; Mary E. T.,9,0,30,21
1650089010285,COGS 9,A01,083968,Staff,2,0,60,58
1650089016314,COGS 14B,A01,083970,Staff,7,0,50,43
1650089022337,COGS 17,A01,092679,Staff,49,0,75,26
1650089028359,COGS 100,A01,083972,Staff,0,19,60,60
1650089040410,COGS 101C,A01,083976,Staff,12,0,30,18
1650089046435,COGS 102A,A01,083978,Johnson; Christine M.,10,0,30,20
1650089052462,COGS 107B,A01,083980,Staff,0,9,50,50
1650089058487,COGS 115,A01,083982,Staff,9,0,30,21
1650089064514,COGS 118B,A01,083367,Staff,0,16,40,40
1650089070537,COGS 172,A01,083984,Provenzano; Emily Kara,13,0,30,17
1650089076564,COGS 177,A00,083368,Staff,0,22,30,30
1650089082595,COGS 186,A01,083986,Staff,21,0,40,19
1650089088624,COGS 187A,A01,083988,Boyle; Mary E. T.,16,0,60,44
1650089094648,CSE 8A,A50,084003,Miranda; Gregory Joseph,0,19,15,15
1650089100684,CSE 11,A01,084005,Miranda; Gregory Joseph,0,24,55,55
1650089106707,CSE 20,A01,084007,Staff,0,5,20,20
1650089112735,CSE 21,A01,084009,Staff,0,32,50,50
1650089118776,CSE 30,A01,083370,Cao; Yingjun,0,63,40,40
1650089124821,CSE 100,A01,083372,Cao; Yingjun,0,48,40,40
1650089130844,CSE 101,A01,084011,Staff,0,56,40,40
1650089136868,CSE 141,A01,083374,Eldon; John,0,69,75,75
1650089142892,CSE 141L,A01,083376,Eldon; John,0,75,75,75
1650089148923,CSE 175,A01,084013,Kumar; Rakesh,22,0,25,3
1650089154945,CSE 190,A00,092508,Dubnov; Shlomo,18,0,20,2
1650089160976,ECE 5,A01,084049,Morris; Karcher William,12,0,20,8
1650089167004,ECE 100,A01,084051,Baghdadchi; Saharnaz,0,0,20,20
1650089167004,ECE 100,A02,091916,Baghdadchi; Saharnaz,11,0,20,9
1650089173028,ECE 101,A01,084053,Baghdadchi; Saharnaz,0,0,37,37
1650089173028,ECE 101,A02,084054,Baghdadchi; Saharnaz,27,0,37,10
1650089179056,ECE 107,A01,083390,Staff,26,0,40,14
1650089185083,ECE 148,A01,084056,Silberman; Jack,8,0,12,4
1650089191108,ECE 180,A00,083391,Abi Samra; Nicholas Camill,25,0,30,5
1650089191108,ECE 180,B00,083392,Abi Samra; Nicholas Camill,21,0,30,9
1650089197132,MATH 10B,A01,084110,Staff,0,0,30,30
1650089197132,MATH 10B,A02,084111,Staff,16,0,30,14
1650089197132,MATH 10B,A03,084112,Staff,23,0,30,7
1650089203157,MATH 10C,A01,083443,Staff,0,17,30,31
1650089203157,MATH 10C,A02,083444,Staff,0,18,30,30
1650089203157,MATH 10C,B01,084114,Staff,17,0,30,13
1650089203157,MATH 10C,B02,084115,Staff,24,0,30,6
1650089209182,MATH 18,A01,084117,Harel; Guershon,11,0,30,19
1650089209182,MATH 18,A02,084119,Harel; Guershon,27,0,30,3
1650089209182,MATH 18,A03,084120,Harel; Guershon,30,0,30,0
1650089209182,MATH 18,A04,084121,Harel; Guershon,29,0,30,1
1650089215209,MATH 20B,A01,084124,Um; Ko Woon,10,0,35,25
1650089215209,MATH 20B,B01,084126,Um; Ko Woon,24,0,35,11
1650089221234,MATH 20C,A01,083446,Hammock; Frances H,0,0,30,30
1650089221234,MATH 20C,A02,083447,Hammock; Frances H,13,0,30,17
1650089221234,MATH 20C,A03,083448,Hammock; Frances H,18,0,30,12
1650089221234,MATH 20C,A04,083449,Hammock; Frances H,20,0,30,10
1650089221234,MATH 20C,B01,083451,Hammock; Frances H,0,0,30,30
1650089221234,MATH 20C,B02,083452,Hammock; Frances H,15,0,30,15
1650089221234,MATH 20C,B03,083453,Hammock; Frances H,19,0,30,11
1650089221234,MATH 20C,B04,083454,Hammock; Frances H,23,0,30,7
1650089227260,MATH 20D,A01,084128,Staff,13,0,30,17
1650089227260,MATH 20D,A02,084129,Staff,29,0,30,1
1650089227260,MATH 20D,A03,084130,Staff,28,0,30,2
1650089227260,MATH 20D,B01,084133,Staff,0,0,30,30
1650089227260,MATH 20D,B02,084134,Staff,23,0,30,7
1650089227260,MATH 20D,B03,084135,Staff,28,0,30,2
1650089233287,MATH 20E,A01,084138,Staff,13,0,30,17
1650089233287,MATH 20E,A02,084139,Staff,6,0,30,24
1650089233287,MATH 20E,A03,084140,Staff,14,0,30,16
1650089233287,MATH 20E,A04,084141,Staff,19,0,30,11
1650089239314,MATH 102,A01,084143,Harel; Guershon,11,0,30,19
1650089239314,MATH 102,A02,084144,Harel; Guershon,18,0,30,12
1650089245339,MATH 103B,A01,083456,Staff,0,13,30,30
1650089245339,MATH 103B,A02,083457,Staff,0,14,30,30
1650089251367,MATH 109,A01,084146,Salehi Golsefidy; Alireza,16,0,30,14
1650089251367,MATH 109,A02,084147,Salehi Golsefidy; Alireza,15,0,30,15
1650089257392,MATH 120A,A01,085445,Eggers; John Dietrich,6,0,35,29
1650089257392,MATH 120A,A02,085446,Eggers; John Dietrich,26,0,35,9
1650089263416,MATH 142B,A01,084149,Verstraete; Jacques Allan,0,12,30,30
1650089263416,MATH 142B,A02,084150,Verstraete; Jacques Allan,0,12,30,30
1650089269444,MATH 170A,A01,083459,Nie; Jiawang,0,11,30,30
1650089269444,MATH 170A,A02,083460,Nie; Jiawang,0,10,30,30
1650089269444,MATH 170A,A03,083461,Nie; Jiawang,0,11,30,30
1650089275472,MATH 193B,A01,083463,Staff,1,0,30,29
1650089275472,MATH 193B,A02,083464,Staff,8,0,30,22
1650089275472,MATH 193B,A03,083465,Staff,16,0,30,14
1650089281540,COGS 2,A01,083966,Boyle; Mary E. T.,9,0,30,21
1650089287567,COGS 9,A01,083968,Staff,2,0,60,58
1650089293595,COGS 14B,A01,083970,Staff,7,0,50,43
1650089299620,COGS 17,A01,092679,Staff,49,0,75,26
1650089305644,COGS 100,A01,083972,Staff,0,19,60,60
1650089317693,COGS 101C,A01,083976,Staff,12,0,30,18
1650089323722,COGS 102A,A01,083978,Johnson; Christine M.,10,0,30,20
1650089329746,COGS 107B,A01,083980,Staff,0,9,50,50
1650089335768,COGS 115,A01,083982,Staff,9,0,30,21
1650089341791,COGS 118B,A01,083367,Staff,0,16,40,40
1650089347821,COGS 172,A01,083984,Provenzano; Emily Kara,13,0,30,17
1650089353849,COGS 177,A00,083368,Staff,0,22,30,30
1650089359871,COGS 186,A01,083986,Staff,21,0,40,19
1650089365897,COGS 187A,A01,083988,Boyle; Mary E. T.,16,0,60,44
1650089371922,CSE 8A,A50,084003,Miranda; Gregory Joseph,0,19,15,15
1650089377952,CSE 11,A01,084005,Miranda; Gregory Joseph,0,24,55,55
1650089383980,CSE 20,A01,084007,Staff,0,5,20,20
1650089390023,CSE 21,A01,084009,Staff,0,32,50,50
1650089396046,CSE 30,A01,083370,Cao; Yingjun,0,63,40,40
1650089402080,CSE 100,A01,083372,Cao; Yingjun,0,48,40,40
1650089408107,CSE 101,A01,084011,Staff,0,56,40,40
1650089414135,CSE 141,A01,083374,Eldon; John,0,69,75,75
1650089420167,CSE 141L,A01,083376,Eldon; John,0,75,75,75
1650089426190,CSE 175,A01,084013,Kumar; Rakesh,22,0,25,3
1650089432214,CSE 190,A00,092508,Dubnov; Shlomo,18,0,20,2
1650089438239,ECE 5,A01,084049,Morris; Karcher William,12,0,20,8
1650089444264,ECE 100,A01,084051,Baghdadchi; Saharnaz,0,0,20,20
1650089444264,ECE 100,A02,091916,Baghdadchi; Saharnaz,11,0,20,9
1650089450289,ECE 101,A01,084053,Baghdadchi; Saharnaz,0,0,37,37
1650089450289,ECE 101,A02,084054,Baghdadchi; Saharnaz,27,0,37,10
1650089456313,ECE 107,A01,083390,Staff,26,0,40,14
1650089462346,ECE 148,A01,084056,Silberman; Jack,8,0,12,4
1650089468372,ECE 180,A00,083391,Abi Samra; Nicholas Camill,25,0,30,5
1650089468372,ECE 180,B00,083392,Abi Samra; Nicholas Camill,21,0,30,9
1650089474400,MATH 10B,A01,084110,Staff,0,0,30,30
1650089474400,MATH 10B,A02,084111,Staff,16,0,30,14
1650089474400,MATH 10B,A03,084112,Staff,23,0,30,7
1650089480429,MATH 10C,A01,083443,Staff,0,17,30,31
1650089480429,MATH 10C,A02,083444,Staff,0,18,30,30
1650089480429,MATH 10C,B01,084114,Staff,17,0,30,13
1650089480429,MATH 10C,B02,084115,Staff,24,0,30,6
1650089486454,MATH 18,A01,084117,Harel; Guershon,11,0,30,19
1650089486454,MATH 18,A02,084119,Harel; Guershon,27,0,30,3
1650089486454,MATH 18,A03,084120,Harel; Guershon,30,0,30,0
1650089486454,MATH 18,A04,084121,Harel; Guershon,29,0,30,1
1650089492569,MATH 20B,A01,084124,Um; Ko Woon,10,0,35,25
1650089492569,MATH 20B,B01,084126,Um; Ko Woon,24,0,35,11
1650089498595,MATH 20C,A01,083446,Hammock; Frances H,0,0,30,30
1650089498595,MATH 20C,A02,083447,Hammock; Frances H,13,0,30,17
1650089498595,MATH 20C,A03,083448,Hammock; Frances H,18,0,30,12
1650089498595,MATH 20C,A04,083449,Hammock; Frances H,20,0,30,10
1650089498595,MATH 20C,B01,083451,Hammock; Frances H,0,0,30,30
1650089498595,MATH 20C,B02,083452,Hammock; Frances H,15,0,30,15
1650089498595,MATH 20C,B03,083453,Hammock; Frances H,19,0,30,11
1650089498595,MATH 20C,B04,083454,Hammock; Frances H,23,0,30,7
1650089504620,MATH 20D,A01,084128,Staff,13,0,30,17
1650089504620,MATH 20D,A02,084129,Staff,29,0,30,1
1650089504620,MATH 20D,A03,084130,Staff,28,0,30,2
1650089504620,MATH 20D,B01,084133,Staff,0,0,30,30
1650089504620,MATH 20D,B02,084134,Staff,23,0,30,7
1650089504620,MATH 20D,B03,084135,Staff,28,0,30,2
1650089510645,MATH 20E,A01,084138,Staff,13,0,30,17
1650089510645,MATH 20E,A02,084139,Staff,6,0,30,24
1650089510645,MATH 20E,A03,084140,Staff,14,0,30,16
1650089510645,MATH 20E,A04,084141,Staff,19,0,30,11
1650089516676,MATH 102,A01,084143,Harel; Guershon,11,0,30,19
1650089516676,MATH 102,A02,084144,Harel; Guershon,18,0,30,12
1650089522699,MATH 103B,A01,083456,Staff,0,13,30,30
1650089522699,MATH 103B,A02,083457,Staff,0,14,30,30
1650089528723,MATH 109,A01,084146,Salehi Golsefidy; Alireza,16,0,30,14
1650089528723,MATH 109,A02,084147,Salehi Golsefidy; Alireza,15,0,30,15
1650089534746,MATH 120A,A01,085445,Eggers; John Dietrich,6,0,35,29
1650089534746,MATH 120A,A02,085446,Eggers; John Dietrich,26,0,35,9
1650089540770,MATH 142B,A01,084149,Verstraete; Jacques Allan,0,12,30,30
1650089540770,MATH 142B,A02,084150,Verstraete; Jacques Allan,0,12,30,30
1650089546793,MATH 170A,A01,083459,Nie; Jiawang,0,11,30,30
1650089546793,MATH 170A,A02,083460,Nie; Jiawang,0,10,30,30
1650089546793,MATH 170A,A03,083461,Nie; Jiawang,0,11,30,30
1650089552820,MATH 193B,A01,083463,Staff,1,0,30,29
1650089552820,MATH 193B,A02,083464,Staff,8,0,30,22
1650089552820,MATH 193B,A03,083465,Staff,16,0,30,14
1650089558868,COGS 2,A01,083966,Boyle; Mary E. T.,9,0,30,21
1650089564891,COGS 9,A01,083968,Staff,2,0,60,58
1650089570914,COGS 14B,A01,083970,Staff,7,0,50,43
1650089576960,COGS 17,A01,092679,Staff,49,0,75,26
1650089582982,COGS 100,A01,083972,Staff,0,19,60,60
1650089595030,COGS 101C,A01,083976,Staff,12,0,30,18
1650089601052,COGS 102A,A01,083978,Johnson; Christine M.,10,0,30,20
1650089607075,COGS 107B,A01,083980,Staff,0,9,50,50
1650089613097,COGS 115,A01,083982,Staff,9,0,30,21
1650089619127,COGS 118B,A01,083367,Staff,0,16,40,40
1650089625155,COGS 172,A01,083984,Provenzano; Emily Kara,13,0,30,17
1650089631178,COGS 177,A00,083368,Staff,0,22,30,30
1650089637200,COGS 186,A01,083986,Staff,21,0,40,19
1650089643225,COGS 187A,A01,083988,Boyle; Mary E. T.,16,0,60,44
1650089649248,CSE 8A,A50,084003,Miranda; Gregory Joseph,0,19,15,15
1650089655273,CSE 11,A01,084005,Miranda; Gregory Joseph,0,24,55,55
1650089661300,CSE 20,A01,084007,Staff,0,5,20,20
1650089667324,CSE 21,A01,084009,Staff,0,32,50,50
1650089673355,CSE 30,A01,083370,Cao; Yingjun,0,63,40,40
1650089679380,CSE 100,A01,083372,Cao; Yingjun,0,48,40,40
1650089685406,CSE 101,A01,084011,Staff,0,56,40,40
1650089691439,CSE 141,A01,083374,Eldon; John,0,69,75,75
1650089697476,CSE 141L,A01,083376,Eldon; John,0,75,75,75
1650089703512,CSE 175,A01,084013,Kumar; Rakesh,22,0,25,3
1650089709535,CSE 190,A00,092508,Dubnov; Shlomo,18,0,20,2
1650089715558,ECE 5,A01,084049,Morris; Karcher William,12,0,20,8
1650089721586,ECE 100,A01,084051,Baghdadchi; Saharnaz,0,0,20,20
1650089721586,ECE 100,A02,091916,Baghdadchi; Saharnaz,11,0,20,9
1650089727614,ECE 101,A01,084053,Baghdadchi; Saharnaz,0,0,37,37
1650089727614,ECE 101,A02,084054,Baghdadchi; Saharnaz,27,0,37,10
1650089733639,ECE 107,A01,083390,Staff,26,0,40,14
1650089739663,ECE 148,A01,084056,Silberman; Jack,8,0,12,4
1650089745691,ECE 180,A00,083391,Abi Samra; Nicholas Camill,25,0,30,5
1650089745691,ECE 180,B00,083392,Abi Samra; Nicholas Camill,21,0,30,9
1650089751716,MATH 10B,A01,084110,Staff,0,0,30,30
1650089751716,MATH 10B,A02,084111,Staff,16,0,30,14
1650089751716,MATH 10B,A03,084112,Staff,23,0,30,7
1650089757743,MATH 10C,A01,083443,Staff,0,17,30,31
1650089757743,MATH 10C,A02,083444,Staff,0,18,30,30
1650089757743,MATH 10C,B01,084114,Staff,17,0,30,13
1650089757743,MATH 10C,B02,084115,Staff,24,0,30,6
1650089763769,MATH 18,A01,084117,Harel; Guershon,11,0,30,19
1650089763769,MATH 18,A02,084119,Harel; Guershon,27,0,30,3
1650089763769,MATH 18,A03,084120,Harel; Guershon,30,0,30,0
1650089763769,MATH 18,A04,084121,Harel; Guershon,29,0,30,1
1650089769798,MATH 20B,A01,084124,Um; Ko Woon,10,0,35,25
1650089769798,MATH 20B,B01,084126,Um; Ko Woon,24,0,35,11
1650089775824,MATH 20C,A01,083446,Hammock; Frances H,0,0,30,30
1650089775824,MATH 20C,A02,083447,Hammock; Frances H,13,0,30,17
1650089775824,MATH 20C,A03,083448,Hammock; Frances H,18,0,30,12
1650089775824,MATH 20C,A04,083449,Hammock; Frances H,20,0,30,10
1650089775824,MATH 20C,B01,083451,Hammock; Frances H,0,0,30,30
1650089775824,MATH 20C,B02,083452,Hammock; Frances H,15,0,30,15
1650089775824,MATH 20C,B03,083453,Hammock; Frances H,19,0,30,11
1650089775824,MATH 20C,B04,083454,Hammock; Frances H,23,0,30,7
1650089781852,MATH 20D,A01,084128,Staff,13,0,30,17
1650089781852,MATH 20D,A02,084129,Staff,29,0,30,1
1650089781852,MATH 20D,A03,084130,Staff,28,0,30,2
1650089781852,MATH 20D,B01,084133,Staff,0,0,30,30
1650089781852,MATH 20D,B02,084134,Staff,23,0,30,7
1650089781852,MATH 20D,B03,084135,Staff,28,0,30,2
1650089787880,MATH 20E,A01,084138,Staff,13,0,30,17
1650089787880,MATH 20E,A02,084139,Staff,6,0,30,24
1650089787880,MATH 20E,A03,084140,Staff,14,0,30,16
1650089787880,MATH 20E,A04,084141,Staff,19,0,30,11
1650089793904,MATH 102,A01,084143,Harel; Guershon,11,0,30,19
1650089793904,MATH 102,A02,084144,Harel; Guershon,18,0,30,12
1650089799936,MATH 103B,A01,083456,Staff,0,13,30,30
1650089799936,MATH 103B,A02,083457,Staff,0,14,30,30
1650089805961,MATH 109,A01,084146,Salehi Golsefidy; Alireza,16,0,30,14
1650089805961,MATH 109,A02,084147,Salehi Golsefidy; Alireza,15,0,30,15
1650089811984,MATH 120A,A01,085445,Eggers; John Dietrich,6,0,35,29
1650089811984,MATH 120A,A02,085446,Eggers; John Dietrich,26,0,35,9
1650089818013,MATH 142B,A01,084149,Verstraete; Jacques Allan,0,12,30,30
1650089818013,MATH 142B,A02,084150,Verstraete; Jacques Allan,0,12,30,30
1650089824036,MATH 170A,A01,083459,Nie; Jiawang,0,11,30,30
1650089824036,MATH 170A,A02,083460,Nie; Jiawang,0,10,30,30
1650089824036,MATH 170A,A03,083461,Nie; Jiawang,0,11,30,30
1650089830061,MATH 193B,A01,083463,Staff,1,0,30,29
1650089830061,MATH 193B,A02,083464,Staff,8,0,30,22
1650089830061,MATH 193B,A03,083465,Staff,16,0,30,14
1650089836131,COGS 2,A01,083966,Boyle; Mary E. T.,9,0,30,21
1650089842154,COGS 9,A01,083968,Staff,2,0,60,58
1650089848187,COGS 14B,A01,083970,Staff,7,0,50,43
1650089854214,COGS 17,A01,092679,Staff,49,0,75,26
1650089860238,COGS 100,A01,083972,Staff,0,19,60,60
1650089872295,COGS 101C,A01,083976,Staff,12,0,30,18
1650089878332,COGS 102A,A01,083978,Johnson; Christine M.,10,0,30,20
1650089884360,COGS 107B,A01,083980,Staff,0,9,50,50
1650089890384,COGS 115,A01,083982,Staff,9,0,30,21
1650089896412,COGS 118B,A01,083367,Staff,0,16,40,40
1650089902435,COGS 172,A01,083984,Provenzano; Emily Kara,13,0,30,17
1650089908458,COGS 177,A00,083368,Staff,0,22,30,30
1650089914483,COGS 186,A01,083986,Staff,21,0,40,19
1650089920508,COGS 187A,A01,083988,Boyle; Mary E. T.,16,0,60,44
1650089926535,CSE 8A,A50,084003,Miranda; Gregory Joseph,0,19,15,15
1650089932562,CSE 11,A01,084005,Miranda; Gregory Joseph,0,24,55,55
1650089938587,CSE 20,A01,084007,Staff,0,5,20,20
1650089944613,CSE 21,A01,084009,Staff,0,32,50,50
1650089950648,CSE 30,A01,083370,Cao; Yingjun,0,63,40,40
1650089956671,CSE 100,A01,083372,Cao; Yingjun,0,48,40,40
1650089962699,CSE 101,A01,084011,Staff,0,56,40,40
1650089968722,CSE 141,A01,083374,Eldon; John,0,69,75,75
1650089974746,CSE 141L,A01,083376,Eldon; John,0,75,75,75
1650089980770,CSE 175,A01,084013,Kumar; Rakesh,22,0,25,3
1650089986793,CSE 190,A00,092508,Dubnov; Shlomo,18,0,20,2
1650089992817,ECE 5,A01,084049,Morris; Karcher William,12,0,20,8
1650089998846,ECE 100,A01,084051,Baghdadchi; Saharnaz,0,0,20,20
1650089998846,ECE 100,A02,091916,Baghdadchi; Saharnaz,11,0,20,9
1650090004871,ECE 101,A01,084053,Baghdadchi; Saharnaz,0,0,37,37
1650090004871,ECE 101,A02,084054,Baghdadchi; Saharnaz,27,0,37,10
1650090010901,ECE 107,A01,083390,Staff,26,0,40,14
1650090016924,ECE 148,A01,084056,Silberman; Jack,8,0,12,4
1650090022956,ECE 180,A00,083391,Abi Samra; Nicholas Camill,25,0,30,5
1650090022956,ECE 180,B00,083392,Abi Samra; Nicholas Camill,21,0,30,9
1650090028982,MATH 10B,A01,084110,Staff,0,0,30,30
1650090028982,MATH 10B,A02,084111,Staff,16,0,30,14
1650090028982,MATH 10B,A03,084112,Staff,23,0,30,7
1650090035007,MATH 10C,A01,083443,Staff,0,17,30,31
1650090035007,MATH 10C,A02,083444,Staff,0,18,30,30
1650090035007,MATH 10C,B01,084114,Staff,17,0,30,13
1650090035007,MATH 10C,B02,084115,Staff,24,0,30,6
1650090041030,MATH 18,A01,084117,Harel; Guershon,11,0,30,19
1650090041030,MATH 18,A02,084119,Harel; Guershon,27,0,30,3
1650090041030,MATH 18,A03,084120,Harel; Guershon,30,0,30,0
1650090041030,MATH 18,A04,084121,Harel; Guershon,29,0,30,1
1650090047053,MATH 20B,A01,084124,Um; Ko Woon,10,0,35,25
1650090047053,MATH 20B,B01,084126,Um; Ko Woon,24,0,35,11
1650090053086,MATH 20C,A01,083446,Hammock; Frances H,0,0,30,30
1650090053086,MATH 20C,A02,083447,Hammock; Frances H,13,0,30,17
1650090053086,MATH 20C,A03,083448,Hammock; Frances H,18,0,30,12
1650090053086,MATH 20C,A04,083449,Hammock; Frances H,20,0,30,10
1650090053086,MATH 20C,B01,083451,Hammock; Frances H,0,0,30,30
1650090053086,MATH 20C,B02,083452,Hammock; Frances H,15,0,30,15
1650090053086,MATH 20C,B03,083453,Hammock; Frances H,19,0,30,11
1650090053086,MATH 20C,B04,083454,Hammock; Frances H,23,0,30,7
1650090059116,MATH 20D,A01,084128,Staff,13,0,30,17
1650090059116,MATH 20D,A02,084129,Staff,29,0,30,1
1650090059116,MATH 20D,A03,084130,Staff,28,0,30,2
1650090059116,MATH 20D,B01,084133,Staff,0,0,30,30
1650090059116,MATH 20D,B02,084134,Staff,23,0,30,7
1650090059116,MATH 20D,B03,084135,Staff,28,0,30,2
1650090065148,MATH 20E,A01,084138,Staff,13,0,30,17
1650090065148,MATH 20E,A02,084139,Staff,6,0,30,24
1650090065148,MATH 20E,A03,084140,Staff,14,0,30,16
1650090065148,MATH 20E,A04,084141,Staff,19,0,30,11
1650090071181,MATH 102,A01,084143,Harel; Guershon,11,0,30,19
1650090071181,MATH 102,A02,084144,Harel; Guershon,18,0,30,12
1650090077208,MATH 103B,A01,083456,Staff,0,13,30,30
1650090077208,MATH 103B,A02,083457,Staff,0,14,30,30
1650090083231,MATH 109,A01,084146,Salehi Golsefidy; Alireza,16,0,30,14
1650090083231,MATH 109,A02,084147,Salehi Golsefidy; Alireza,15,0,30,15
1650090089375,MATH 120A,A01,085445,Eggers; John Dietrich,6,0,35,29
1650090089375,MATH 120A,A02,085446,Eggers; John Dietrich,26,0,35,9
1650090095400,MATH 142B,A01,084149,Verstraete; Jacques Allan,0,12,30,30
1650090095400,MATH 142B,A02,084150,Verstraete; Jacques Allan,0,12,30,30
1650090101434,MATH 170A,A01,083459,Nie; Jiawang,0,11,30,30
1650090101434,MATH 170A,A02,083460,Nie; Jiawang,0,10,30,30
1650090101434,MATH 170A,A03,083461,Nie; Jiawang,0,11,30,30
1650090107458,MATH 193B,A01,083463,Staff,1,0,30,29
1650090107458,MATH 193B,A02,083464,Staff,8,0,30,22
1650090107458,MATH 193B,A03,083465,Staff,16,0,30,14
1650090113516,COGS 2,A01,083966,Boyle; Mary E. T.,9,0,30,21
1650090119540,COGS 9,A01,083968,Staff,2,0,60,58
1650090125571,COGS 14B,A01,083970,Staff,7,0,50,43
1650090131596,COGS 17,A01,092679,Staff,49,0,75,26
1650090137620,COGS 100,A01,083972,Staff,0,19,60,60
1650090149680,COGS 101C,A01,083976,Staff,12,0,30,18
1650090155708,COGS 102A,A01,083978,Johnson; Christine M.,10,0,30,20
1650090161732,COGS 107B,A01,083980,Staff,0,9,50,50
1650090167760,COGS 115,A01,083982,Staff,9,0,30,21
1650090173784,COGS 118B,A01,083367,Staff,0,16,40,40
1650090179813,COGS 172,A01,083984,Provenzano; Emily Kara,13,0,30,17
1650090185839,COGS 177,A00,083368,Staff,0,22,30,30
1650090191863,COGS 186,A01,083986,Staff,21,0,40,19
1650090197889,COGS 187A,A01,083988,Boyle; Mary E. T.,16,0,60,44
1650090203916,CSE 8A,A50,084003,Miranda; Gregory Joseph,0,19,15,15
1650090209944,CSE 11,A01,084005,Miranda; Gregory Joseph,0,24,55,55
1650090215972,CSE 20,A01,084007,Staff,0,5,20,20
1650090221999,CSE 21,A01,084009,Staff,0,32,50,50
1650090228027,CSE 30,A01,083370,Cao; Yingjun,0,63,40,40
1650090234051,CSE 100,A01,083372,Cao; Yingjun,0,48,40,40
1650090240075,CSE 101,A01,084011,Staff,0,56,40,40
1650090246098,CSE 141,A01,083374,Eldon; John,0,69,75,75
1650090252124,CSE 141L,A01,083376,Eldon; John,0,75,75,75
1650090258151,CSE 175,A01,084013,Kumar; Rakesh,22,0,25,3
1650090264172,CSE 190,A00,092508,Dubnov; Shlomo,18,0,20,2
1650090270201,ECE 5,A01,084049,Morris; Karcher William,12,0,20,8
1650090276226,ECE 100,A01,084051,Baghdadchi; Saharnaz,0,0,20,20
1650090276226,ECE 100,A02,091916,Baghdadchi; Saharnaz,11,0,20,9
1650090282249,ECE 101,A01,084053,Baghdadchi; Saharnaz,0,0,37,37
1650090282249,ECE 101,A02,084054,Baghdadchi; Saharnaz,27,0,37,10
1650090288272,ECE 107,A01,083390,Staff,26,0,40,14
1650090294295,ECE 148,A01,084056,Silberman; Jack,8,0,12,4
1650090300327,ECE 180,A00,083391,Abi Samra; Nicholas Camill,25,0,30,5
1650090300327,ECE 180,B00,083392,Abi Samra; Nicholas Camill,21,0,30,9
1650090306351,MATH 10B,A01,084110,Staff,0,0,30,30
1650090306351,MATH 10B,A02,084111,Staff,16,0,30,14
1650090306351,MATH 10B,A03,084112,Staff,23,0,30,7
1650090312373,MATH 10C,A01,083443,Staff,0,17,30,31
1650090312373,MATH 10C,A02,083444,Staff,0,18,30,30
1650090312373,MATH 10C,B01,084114,Staff,17,0,30,13
1650090312373,MATH 10C,B02,084115,Staff,24,0,30,6
1650090318402,MATH 18,A01,084117,Harel; Guershon,11,0,30,19
1650090318402,MATH 18,A02,084119,Harel; Guershon,27,0,30,3
1650090318402,MATH 18,A03,084120,Harel; Guershon,30,0,30,0
1650090318402,MATH 18,A04,084121,Harel; Guershon,29,0,30,1
1650090324438,MATH 20B,A01,084124,Um; Ko Woon,10,0,35,25
1650090324438,MATH 20B,B01,084126,Um; Ko Woon,24,0,35,11
1650090330464,MATH 20C,A01,083446,Hammock; Frances H,0,0,30,30
1650090330464,MATH 20C,A02,083447,Hammock; Frances H,13,0,30,17
1650090330464,MATH 20C,A03,083448,Hammock; Frances H,18,0,30,12
1650090330464,MATH 20C,A04,083449,Hammock; Frances H,20,0,30,10
1650090330464,MATH 20C,B01,083451,Hammock; Frances H,0,0,30,30
1650090330464,MATH 20C,B02,083452,Hammock; Frances H,15,0,30,15
1650090330464,MATH 20C,B03,083453,Hammock; Frances H,19,0,30,11
1650090330464,MATH 20C,B04,083454,Hammock; Frances H,23,0,30,7
1650090336487,MATH 20D,A01,084128,Staff,13,0,30,17
1650090336487,MATH 20D,A02,084129,Staff,29,0,30,1
1650090336487,MATH 20D,A03,084130,Staff,28,0,30,2
1650090336487,MATH 20D,B01,084133,Staff,0,0,30,30
1650090336487,MATH 20D,B02,084134,Staff,23,0,30,7
1650090336487,MATH 20D,B03,084135,Staff,28,0,30,2
1650090342513,MATH 20E,A01,084138,Staff,13,0,30,17
1650090342513,MATH 20E,A02,084139,Staff,6,0,30,24
1650090342513,MATH 20E,A03,084140,Staff,14,0,30,16
1650090342513,MATH 20E,A04,084141,Staff,19,0,30,11
1650090348539,MATH 102,A01,084143,Harel; Guershon,11,0,30,19
1650090348539,MATH 102,A02,084144,Harel; Guershon,18,0,30,12
1650090354564,MATH 103B,A01,083456,Staff,0,13,30,30
1650090354564,MATH 103B,A02,083457,Staff,0,14,30,30
1650090360596,MATH 109,A01,084146,Salehi Golsefidy; Alireza,16,0,30,14
1650090360596,MATH 109,A02,084147,Salehi Golsefidy; Alireza,15,0,30,15
1650090366619,MATH 120A,A01,085445,Eggers; John Dietrich,6,0,35,29
1650090366619,MATH 120A,A02,085446,Eggers; John Dietrich,26,0,35,9
1650090372646,MATH 142B,A01,084149,Verstraete; Jacques Allan,0,12,30,30
1650090372646,MATH 142B,A02,084150,Verstraete; Jacques Allan,0,12,30,30
1650090378668,MATH 170A,A01,083459,Nie; Jiawang,0,11,30,30
1650090378668,MATH 170A,A02,083460,Nie; Jiawang,0,10,30,30
1650090378668,MATH 170A,A03,083461,Nie; Jiawang,0,11,30,30
1650090384695,MATH 193B,A01,083463,Staff,1,0,30,29
1650090384695,MATH 193B,A02,083464,Staff,8,0,30,22
1650090384695,MATH 193B,A03,083465,Staff,16,0,30,14
1650090390755,COGS 2,A01,083966,Boyle; Mary E. T.,9,0,30,21
1650090396782,COGS 9,A01,083968,Staff,2,0,60,58
1650090402806,COGS 14B,A01,083970,Staff,7,0,50,43
1650090408832,COGS 17,A01,092679,Staff,49,0,75,26
1650090414857,COGS 100,A01,083972,Staff,0,19,60,60
1650090426908,COGS 101C,A01,083976,Staff,12,0,30,18
1650090432935,COGS 102A,A01,083978,Johnson; Christine M.,10,0,30,20
1650090438959,COGS 107B,A01,083980,Staff,0,9,50,50
1650090444982,COGS 115,A01,083982,Staff,9,0,30,21
1650090451005,COGS 118B,A01,083367,Staff,0,16,40,40
1650090457029,COGS 172,A01,083984,Provenzano; Emily Kara,13,0,30,17
1650090463054,COGS 177,A00,083368,Staff,0,22,30,30
1650090469079,COGS 186,A01,083986,Staff,21,0,40,19
1650090475102,COGS 187A,A01,083988,Boyle; Mary E. T.,16,0,60,44
1650090481127,CSE 8A,A50,084003,Miranda; Gregory Joseph,0,19,15,15
1650090487153,CSE 11,A01,084005,Miranda; Gregory Joseph,0,24,55,55
1650090493181,CSE 20,A01,084007,Staff,0,5,20,20
1650090499208,CSE 21,A01,084009,Staff,0,32,50,50
1650090505230,CSE 30,A01,083370,Cao; Yingjun,0,63,40,40
1650090511263,CSE 100,A01,083372,Cao; Yingjun,0,48,40,40
1650090517290,CSE 101,A01,084011,Staff,0,56,40,40
1650090523312,CSE 141,A01,083374,Eldon; John,0,69,75,75
1650090529339,CSE 141L,A01,083376,Eldon; John,0,75,75,75
1650090535363,CSE 175,A01,084013,Kumar; Rakesh,22,0,25,3
1650090541398,CSE 190,A00,092508,Dubnov; Shlomo,18,0,20,2
1650090547421,ECE 5,A01,084049,Morris; Karcher William,12,0,20,8
1650090553451,ECE 100,A01,084051,Baghdadchi; Saharnaz,0,0,20,20
1650090553451,ECE 100,A02,091916,Baghdadchi; Saharnaz,11,0,20,9
1650090559478,ECE 101,A01,084053,Baghdadchi; Saharnaz,0,0,37,37
1650090559478,ECE 101,A02,084054,Baghdadchi; Saharnaz,27,0,37,10
1650090565502,ECE 107,A01,083390,Staff,26,0,40,14
1650090571530,ECE 148,A01,084056,Silberman; Jack,8,0,12,4
1650090577553,ECE 180,A00,083391,Abi Samra; Nicholas Camill,25,0,30,5
1650090577553,ECE 180,B00,083392,Abi Samra; Nicholas Camill,21,0,30,9
1650090583591,MATH 10B,A01,084110,Staff,0,0,30,30
1650090583591,MATH 10B,A02,084111,Staff,16,0,30,14
1650090583591,MATH 10B,A03,084112,Staff,23,0,30,7
1650090589616,MATH 10C,A01,083443,Staff,0,17,30,31
1650090589616,MATH 10C,A02,083444,Staff,0,18,30,30
1650090589616,MATH 10C,B01,084114,Staff,17,0,30,13
1650090589616,MATH 10C,B02,084115,Staff,24,0,30,6
1650090595644,MATH 18,A01,084117,Harel; Guershon,11,0,30,19
1650090595644,MATH 18,A02,084119,Harel; Guershon,27,0,30,3
1650090595644,MATH 18,A03,084120,Harel; Guershon,30,0,30,0
1650090595644,MATH 18,A04,084121,Harel; Guershon,29,0,30,1
1650090601671,MATH 20B,A01,084124,Um; Ko Woon,10,0,35,25
1650090601671,MATH 20B,B01,084126,Um; Ko Woon,24,0,35,11
1650090607694,MATH 20C,A01,083446,Hammock; Frances H,0,0,30,30
1650090607694,MATH 20C,A02,083447,Hammock; Frances H,13,0,30,17
1650090607694,MATH 20C,A03,083448,Hammock; Frances H,18,0,30,12
1650090607694,MATH 20C,A04,083449,Hammock; Frances H,20,0,30,10
1650090607694,MATH 20C,B01,083451,Hammock; Frances H,0,0,30,30
1650090607694,MATH 20C,B02,083452,Hammock; Frances H,15,0,30,15
1650090607694,MATH 20C,B03,083453,Hammock; Frances H,19,0,30,11
1650090607694,MATH 20C,B04,083454,Hammock; Frances H,23,0,30,7
1650090613723,MATH 20D,A01,084128,Staff,13,0,30,17
1650090613723,MATH 20D,A02,084129,Staff,29,0,30,1
1650090613723,MATH 20D,A03,084130,Staff,28,0,30,2
1650090613723,MATH 20D,B01,084133,Staff,0,0,30,30
1650090613723,MATH 20D,B02,084134,Staff,23,0,30,7
1650090613723,MATH 20D,B03,084135,Staff,28,0,30,2
1650090619748,MATH 20E,A01,084138,Staff,13,0,30,17
1650090619748,MATH 20E,A02,084139,Staff,6,0,30,24
1650090619748,MATH 20E,A03,084140,Staff,14,0,30,16
1650090619748,MATH 20E,A04,084141,Staff,19,0,30,11
1650090625774,MATH 102,A01,084143,Harel; Guershon,11,0,30,19
1650090625774,MATH 102,A02,084144,Harel; Guershon,18,0,30,12
1650090631798,MATH 103B,A01,083456,Staff,0,13,30,30
1650090631798,MATH 103B,A02,083457,Staff,0,14,30,30
1650090637825,MATH 109,A01,084146,Salehi Golsefidy; Alireza,16,0,30,14
1650090637825,MATH 109,A02,084147,Salehi Golsefidy; Alireza,15,0,30,15
1650090643849,MATH 120A,A01,085445,Eggers; John Dietrich,6,0,35,29
1650090643849,MATH 120A,A02,085446,Eggers; John Dietrich,26,0,35,9
1650090649878,MATH 142B,A01,084149,Verstraete; Jacques Allan,0,12,30,30
1650090649878,MATH 142B,A02,084150,Verstraete; Jacques Allan,0,12,30,30
1650090655902,MATH 170A,A01,083459,Nie; Jiawang,0,11,30,30
1650090655902,MATH 170A,A02,083460,Nie; Jiawang,0,10,30,30
1650090655902,MATH 170A,A03,083461,Nie; Jiawang,0,11,30,30
1650090661929,MATH 193B,A01,083463,Staff,1,0,30,29
1650090661929,MATH 193B,A02,083464,Staff,8,0,30,22
1650090661929,MATH 193B,A03,083465,Staff,16,0,30,14
1650090667977,COGS 2,A01,083966,Boyle; Mary E. T.,9,0,30,21
1650090674004,COGS 9,A01,083968,Staff,2,0,60,58
1650090680118,COGS 14B,A01,083970,Staff,7,0,50,43
1650090686141,COGS 17,A01,092679,Staff,49,0,75,26
1650090692175,COGS 100,A01,083972,Staff,0,19,60,60
1650090704228,COGS 101C,A01,083976,Staff,12,0,30,18
1650090710254,COGS 102A,A01,083978,Johnson; Christine M.,10,0,30,20
1650090716292,COGS 107B,A01,083980,Staff,0,9,50,50
1650090722318,COGS 115,A01,083982,Staff,9,0,30,21
1650090728346,COGS 118B,A01,083367,Staff,0,16,40,40
1650090734373,COGS 172,A01,083984,Provenzano; Emily Kara,13,0,30,17
1650090740401,COGS 177,A00,083368,Staff,0,22,30,30
1650090746426,COGS 186,A01,083986,Staff,21,0,40,19
1650090752452,COGS 187A,A01,083988,Boyle; Mary E. T.,16,0,60,44
1650090758480,CSE 8A,A50,084003,Miranda; Gregory Joseph,0,19,15,15
1650090764503,CSE 11,A01,084005,Miranda; Gregory Joseph,0,24,55,55
1650090770526,CSE 20,A01,084007,Staff,0,5,20,20
1650090776549,CSE 21,A01,084009,Staff,0,32,50,50
1650090782574,CSE 30,A01,083370,Cao; Yingjun,0,63,40,40
1650090788597,CSE 100,A01,083372,Cao; Yingjun,0,48,40,40
1650090794619,CSE 101,A01,084011,Staff,0,56,40,40
1650090800643,CSE 141,A01,083374,Eldon; John,0,69,75,75
1650090806679,CSE 141L,A01,083376,Eldon; John,0,75,75,75
1650090812702,CSE 175,A01,084013,Kumar; Rakesh,22,0,25,3
1650090818729,CSE 190,A00,092508,Dubnov; Shlomo,18,0,20,2
1650090824759,ECE 5,A01,084049,Morris; Karcher William,12,0,20,8
1650090830783,ECE 100,A01,084051,Baghdadchi; Saharnaz,0,0,20,20
1650090830783,ECE 100,A02,091916,Baghdadchi; Saharnaz,11,0,20,9
1650090836806,ECE 101,A01,084053,Baghdadchi; Saharnaz,0,0,37,37
1650090836806,ECE 101,A02,084054,Baghdadchi; Saharnaz,27,0,37,10
1650090842839,ECE 107,A01,083390,Staff,26,0,40,14
1650090848864,ECE 148,A01,084056,Silberman; Jack,8,0,12,4
1650090854894,ECE 180,A00,083391,Abi Samra; Nicholas Camill,25,0,30,5
1650090854894,ECE 180,B00,083392,Abi Samra; Nicholas Camill,21,0,30,9
1650090860918,MATH 10B,A01,084110,Staff,0,0,30,30
1650090860918,MATH 10B,A02,084111,Staff,16,0,30,14
1650090860918,MATH 10B,A03,084112,Staff,23,0,30,7
1650090866952,MATH 10C,A01,083443,Staff,0,17,30,31
1650090866952,MATH 10C,A02,083444,Staff,0,18,30,30
1650090866952,MATH 10C,B01,084114,Staff,17,0,30,13
1650090866952,MATH 10C,B02,084115,Staff,24,0,30,6
1650090872974,MATH 18,A01,084117,Harel; Guershon,11,0,30,19
1650090872974,MATH 18,A02,084119,Harel; Guershon,27,0,30,3
1650090872974,MATH 18,A03,084120,Harel; Guershon,30,0,30,0
1650090872974,MATH 18,A04,084121,Harel; Guershon,29,0,30,1
1650090879014,MATH 20B,A01,084124,Um; Ko Woon,10,0,35,25
1650090879014,MATH 20B,B01,084126,Um; Ko Woon,24,0,35,11
1650090885043,MATH 20C,A01,083446,Hammock; Frances H,0,0,30,30
1650090885043,MATH 20C,A02,083447,Hammock; Frances H,13,0,30,17
1650090885043,MATH 20C,A03,083448,Hammock; Frances H,18,0,30,12
1650090885043,MATH 20C,A04,083449,Hammock; Frances H,20,0,30,10
1650090885043,MATH 20C,B01,083451,Hammock; Frances H,0,0,30,30
1650090885043,MATH 20C,B02,083452,Hammock; Frances H,15,0,30,15
1650090885043,MATH 20C,B03,083453,Hammock; Frances H,19,0,30,11
1650090885043,MATH 20C,B04,083454,Hammock; Frances H,23,0,30,7
1650090891069,MATH 20D,A01,084128,Staff,13,0,30,17
1650090891069,MATH 20D,A02,084129,Staff,29,0,30,1
1650090891069,MATH 20D,A03,084130,Staff,28,0,30,2
1650090891069,MATH 20D,B01,084133,Staff,0,0,30,30
1650090891069,MATH 20D,B02,084134,Staff,23,0,30,7
1650090891069,MATH 20D,B03,084135,Staff,28,0,30,2
1650090897099,MATH 20E,A01,084138,Staff,13,0,30,17
1650090897099,MATH 20E,A02,084139,Staff,6,0,30,24
1650090897099,MATH 20E,A03,084140,Staff,14,0,30,16
1650090897099,MATH 20E,A04,084141,Staff,19,0,30,11
1650090903128,MATH 102,A01,084143,Harel; Guershon,11,0,30,19
1650090903128,MATH 102,A02,084144,Harel; Guershon,18,0,30,12
1650090909154,MATH 103B,A01,083456,Staff,0,13,30,30
1650090909154,MATH 103B,A02,083457,Staff,0,14,30,30
1650090915179,MATH 109,A01,084146,Salehi Golsefidy; Alireza,16,0,30,14
1650090915179,MATH 109,A02,084147,Salehi Golsefidy; Alireza,15,0,30,15
1650090921203,MATH 120A,A01,085445,Eggers; John Dietrich,6,0,35,29
1650090921203,MATH 120A,A02,085446,Eggers; John Dietrich,26,0,35,9
1650090927227,MATH 142B,A01,084149,Verstraete; Jacques Allan,0,12,30,30
1650090927227,MATH 142B,A02,084150,Verstraete; Jacques Allan,0,12,30,30
1650090933251,MATH 170A,A01,083459,Nie; Jiawang,0,11,30,30
1650090933251,MATH 170A,A02,083460,Nie; Jiawang,0,10,30,30
1650090933251,MATH 170A,A03,083461,Nie; Jiawang,0,11,30,30
1650090939275,MATH 193B,A01,083463,Staff,1,0,30,29
1650090939275,MATH 193B,A02,083464,Staff,8,0,30,22
1650090939275,MATH 193B,A03,083465,Staff,16,0,30,14
1650090945341,COGS 2,A01,083966,Boyle; Mary E. T.,9,0,30,21
1650090951364,COGS 9,A01,083968,Staff,2,0,60,58
1650090957399,COGS 14B,A01,083970,Staff,7,0,50,43
1650090963423,COGS 17,A01,092679,Staff,49,0,75,26
1650090969445,COGS 100,A01,083972,Staff,0,19,60,60
1650090981496,COGS 101C,A01,083976,Staff,12,0,30,18
1650090987520,COGS 102A,A01,083978,Johnson; Christine M.,10,0,30,20
1650090993548,COGS 107B,A01,083980,Staff,0,9,50,50
1650090999570,COGS 115,A01,083982,Staff,9,0,30,21
1650091005595,COGS 118B,A01,083367,Staff,0,16,40,40
1650091011620,COGS 172,A01,083984,Provenzano; Emily Kara,13,0,30,17
1650091017647,COGS 177,A00,083368,Staff,0,22,30,30
1650091023676,COGS 186,A01,083986,Staff,21,0,40,19
1650091029703,COGS 187A,A01,083988,Boyle; Mary E. T.,16,0,60,44
1650091035730,CSE 8A,A50,084003,Miranda; Gregory Joseph,0,19,15,15
1650091041764,CSE 11,A01,084005,Miranda; Gregory Joseph,0,24,55,55
1650091047787,CSE 20,A01,084007,Staff,0,5,20,20
1650091053814,CSE 21,A01,084009,Staff,0,32,50,50
1650091059843,CSE 30,A01,083370,Cao; Yingjun,0,63,40,40
1650091065866,CSE 100,A01,083372,Cao; Yingjun,0,48,40,40
1650091071890,CSE 101,A01,084011,Staff,0,56,40,40
1650091077914,CSE 141,A01,083374,Eldon; John,0,69,75,75
1650091083939,CSE 141L,A01,083376,Eldon; John,0,75,75,75
1650091089965,CSE 175,A01,084013,Kumar; Rakesh,22,0,25,3
1650091095989,CSE 190,A00,092508,Dubnov; Shlomo,18,0,20,2
1650091102013,ECE 5,A01,084049,Morris; Karcher William,12,0,20,8
1650091108042,ECE 100,A01,084051,Baghdadchi; Saharnaz,0,0,20,20
1650091108042,ECE 100,A02,091916,Baghdadchi; Saharnaz,11,0,20,9
1650091114066,ECE 101,A01,084053,Baghdadchi; Saharnaz,0,0,37,37
1650091114066,ECE 101,A02,084054,Baghdadchi; Saharnaz,27,0,37,10
1650091120090,ECE 107,A01,083390,Staff,26,0,40,14
1650091126121,ECE 148,A01,084056,Silberman; Jack,8,0,12,4
1650091132158,ECE 180,A00,083391,Abi Samra; Nicholas Camill,25,0,30,5
1650091132158,ECE 180,B00,083392,Abi Samra; Nicholas Camill,21,0,30,9
1650091138190,MATH 10B,A01,084110,Staff,0,0,30,30
1650091138190,MATH 10B,A02,084111,Staff,16,0,30,14
1650091138190,MATH 10B,A03,084112,Staff,23,0,30,7
1650091144221,MATH 10C,A01,083443,Staff,0,17,30,31
1650091144221,MATH 10C,A02,083444,Staff,0,18,30,30
1650091144221,MATH 10C,B01,084114,Staff,17,0,30,13
1650091144221,MATH 10C,B02,084115,Staff,24,0,30,6
1650091150251,MATH 18,A01,084117,Harel; Guershon,11,0,30,19
1650091150251,MATH 18,A02,084119,Harel; Guershon,27,0,30,3
1650091150251,MATH 18,A03,084120,Harel; Guershon,30,0,30,0
1650091150251,MATH 18,A04,084121,Harel; Guershon,29,0,30,1
1650091156280,MATH 20B,A01,084124,Um; Ko Woon,10,0,35,25
1650091156280,MATH 20B,B01,084126,Um; Ko Woon,24,0,35,11
1650091162305,MATH 20C,A01,083446,Hammock; Frances H,0,0,30,30
1650091162305,MATH 20C,A02,083447,Hammock; Frances H,13,0,30,17
1650091162305,MATH 20C,A03,083448,Hammock; Frances H,18,0,30,12
1650091162305,MATH 20C,A04,083449,Hammock; Frances H,20,0,30,10
1650091162305,MATH 20C,B01,083451,Hammock; Frances H,0,0,30,30
1650091162305,MATH 20C,B02,083452,Hammock; Frances H,15,0,30,15
1650091162305,MATH 20C,B03,083453,Hammock; Frances H,19,0,30,11
1650091162305,MATH 20C,B04,083454,Hammock; Frances H,23,0,30,7
1650091168358,MATH 20D,A01,084128,Staff,13,0,30,17
1650091168358,MATH 20D,A02,084129,Staff,29,0,30,1
1650091168358,MATH 20D,A03,084130,Staff,28,0,30,2
1650091168358,MATH 20D,B01,084133,Staff,0,0,30,30
1650091168358,MATH 20D,B02,084134,Staff,23,0,30,7
1650091168358,MATH 20D,B03,084135,Staff,28,0,30,2
1650091174384,MATH 20E,A01,084138,Staff,13,0,30,17
1650091174384,MATH 20E,A02,084139,Staff,6,0,30,24
1650091174384,MATH 20E,A03,084140,Staff,14,0,30,16
1650091174384,MATH 20E,A04,084141,Staff,19,0,30,11
1650091180418,MATH 102,A01,084143,Harel; Guershon,11,0,30,19
1650091180418,MATH 102,A02,084144,Harel; Guershon,18,0,30,12
1650091186444,MATH 103B,A01,083456,Staff,0,13,30,30
1650091186444,MATH 103B,A02,083457,Staff,0,14,30,30
1650091192475,MATH 109,A01,084146,Salehi Golsefidy; Alireza,16,0,30,14
1650091192475,MATH 109,A02,084147,Salehi Golsefidy; Alireza,15,0,30,15
1650091198499,MATH 120A,A01,085445,Eggers; John Dietrich,6,0,35,29
1650091198499,MATH 120A,A02,085446,Eggers; John Dietrich,26,0,35,9
1650091204533,MATH 142B,A01,084149,Verstraete; Jacques Allan,0,12,30,30
1650091204533,MATH 142B,A02,084150,Verstraete; Jacques Allan,0,12,30,30
1650091210568,MATH 170A,A01,083459,Nie; Jiawang,0,11,30,30
1650091210568,MATH 170A,A02,083460,Nie; Jiawang,0,10,30,30
1650091210568,MATH 170A,A03,083461,Nie; Jiawang,0,11,30,30
1650091216595,MATH 193B,A01,083463,Staff,1,0,30,29
1650091216595,MATH 193B,A02,083464,Staff,8,0,30,22
1650091216595,MATH 193B,A03,083465,Staff,16,0,30,14
1650091222655,COGS 2,A01,083966,Boyle; Mary E. T.,9,0,30,21
1650091228682,COGS 9,A01,083968,Staff,2,0,60,58
1650091234708,COGS 14B,A01,083970,Staff,7,0,50,43
1650091240732,COGS 17,A01,092679,Staff,49,0,75,26
1650091246756,COGS 100,A01,083972,Staff,0,19,60,60
1650091258804,COGS 101C,A01,083976,Staff,12,0,30,18
1650091264828,COGS 102A,A01,083978,Johnson; Christine M.,10,0,30,20
1650091270855,COGS 107B,A01,083980,Staff,0,9,50,50
1650091276970,COGS 115,A01,083982,Staff,9,0,30,21
1650091282997,COGS 118B,A01,083367,Staff,0,16,40,40
1650091289021,COGS 172,A01,083984,Provenzano; Emily Kara,13,0,30,17
1650091295045,COGS 177,A00,083368,Staff,0,22,30,30
1650091301082,COGS 186,A01,083986,Staff,21,0,40,19
1650091307106,COGS 187A,A01,083988,Boyle; Mary E. T.,16,0,60,44
1650091313132,CSE 8A,A50,084003,Miranda; Gregory Joseph,0,19,15,15
1650091319156,CSE 11,A01,084005,Miranda; Gregory Joseph,0,24,55,55
1650091325180,CSE 20,A01,084007,Staff,0,5,20,20
1650091331202,CSE 21,A01,084009,Staff,0,32,50,50
1650091337226,CSE 30,A01,083370,Cao; Yingjun,0,63,40,40
1650091343259,CSE 100,A01,083372,Cao; Yingjun,0,48,40,40
1650091349285,CSE 101,A01,084011,Staff,0,56,40,40
1650091355312,CSE 141,A01,083374,Eldon; John,0,69,75,75
1650091361345,CSE 141L,A01,083376,Eldon; John,0,75,75,75
1650091367369,CSE 175,A01,084013,Kumar; Rakesh,22,0,25,3
1650091373391,CSE 190,A00,092508,Dubnov; Shlomo,18,0,20,2
1650091379415,ECE 5,A01,084049,Morris; Karcher William,12,0,20,8
1650091385437,ECE 100,A01,084051,Baghdadchi; Saharnaz,0,0,20,20
1650091385437,ECE 100,A02,091916,Baghdadchi; Saharnaz,11,0,20,9
1650091391465,ECE 101,A01,084053,Baghdadchi; Saharnaz,0,0,37,37
1650091391465,ECE 101,A02,084054,Baghdadchi; Saharnaz,27,0,37,10
1650091397489,ECE 107,A01,083390,Staff,26,0,40,14
1650091403522,ECE 148,A01,084056,Silberman; Jack,8,0,12,4
1650091409545,ECE 180,A00,083391,Abi Samra; Nicholas Camill,25,0,30,5
1650091409545,ECE 180,B00,083392,Abi Samra; Nicholas Camill,21,0,30,9
1650091415569,MATH 10B,A01,084110,Staff,0,0,30,30
1650091415569,MATH 10B,A02,084111,Staff,16,0,30,14
1650091415569,MATH 10B,A03,084112,Staff,23,0,30,7
1650091421595,MATH 10C,A01,083443,Staff,0,17,30,31
1650091421595,MATH 10C,A02,083444,Staff,0,18,30,30
1650091421595,MATH 10C,B01,084114,Staff,17,0,30,13
1650091421595,MATH 10C,B02,084115,Staff,24,0,30,6
1650091427619,MATH 18,A01,084117,Harel; Guershon,11,0,30,19
1650091427619,MATH 18,A02,084119,Harel; Guershon,27,0,30,3
1650091427619,MATH 18,A03,084120,Harel; Guershon,30,0,30,0
1650091427619,MATH 18,A04,084121,Harel; Guershon,29,0,30,1
1650091433648,MATH 20B,A01,084124,Um; Ko Woon,10,0,35,25
1650091433648,MATH 20B,B01,084126,Um; Ko Woon,24,0,35,11
1650091439675,MATH 20C,A01,083446,Hammock; Frances H,0,0,30,30
1650091439675,MATH 20C,A02,083447,Hammock; Frances H,13,0,30,17
1650091439675,MATH 20C,A03,083448,Hammock; Frances H,18,0,30,12
1650091439675,MATH 20C,A04,083449,Hammock; Frances H,20,0,30,10
1650091439675,MATH 20C,B01,083451,Hammock; Frances H,0,0,30,30
1650091439675,MATH 20C,B02,083452,Hammock; Frances H,15,0,30,15
1650091439675,MATH 20C,B03,083453,Hammock; Frances H,19,0,30,11
1650091439675,MATH 20C,B04,083454,Hammock; Frances H,23,0,30,7
1650091445716,MATH 20D,A01,084128,Staff,13,0,30,17
1650091445716,MATH 20D,A02,084129,Staff,29,0,30,1
1650091445716,MATH 20D,A03,084130,Staff,28,0,30,2
1650091445716,MATH 20D,B01,084133,Staff,0,0,30,30
1650091445716,MATH 20D,B02,084134,Staff,23,0,30,7
1650091445716,MATH 20D,B03,084135,Staff,28,0,30,2
1650091451745,MATH 20E,A01,084138,Staff,13,0,30,17
1650091451745,MATH 20E,A02,084139,Staff,6,0,30,24
1650091451745,MATH 20E,A03,084140,Staff,14,0,30,16
1650091451745,MATH 20E,A04,084141,Staff,19,0,30,11
1650091457771,MATH 102,A01,084143,Harel; Guershon,11,0,30,19
1650091457771,MATH 102,A02,084144,Harel; Guershon,18,0,30,12
1650091463802,MATH 103B,A01,083456,Staff,0,13,30,30
1650091463802,MATH 103B,A02,083457,Staff,0,14,30,30
1650091469824,MATH 109,A01,084146,Salehi Golsefidy; Alireza,16,0,30,14
1650091469824,MATH 109,A02,084147,Salehi Golsefidy; Alireza,15,0,30,15
1650091475857,MATH 120A,A01,085445,Eggers; John Dietrich,6,0,35,29
1650091475857,MATH 120A,A02,085446,Eggers; John Dietrich,26,0,35,9
1650091481881,MATH 142B,A01,084149,Verstraete; Jacques Allan,0,12,30,30
1650091481881,MATH 142B,A02,084150,Verstraete; Jacques Allan,0,12,30,30
1650091487905,MATH 170A,A01,083459,Nie; Jiawang,0,11,30,30
1650091487905,MATH 170A,A02,083460,Nie; Jiawang,0,10,30,30
1650091487905,MATH 170A,A03,083461,Nie; Jiawang,0,11,30,30
1650091493931,MATH 193B,A01,083463,Staff,1,0,30,29
1650091493931,MATH 193B,A02,083464,Staff,8,0,30,22
1650091493931,MATH 193B,A03,083465,Staff,16,0,30,14
1650091499988,COGS 2,A01,083966,Boyle; Mary E. T.,9,0,30,21
1650091506010,COGS 9,A01,083968,Staff,2,0,60,58
1650091512033,COGS 14B,A01,083970,Staff,7,0,50,43
1650091518060,COGS 17,A01,092679,Staff,49,0,75,26
1650091524082,COGS 100,A01,083972,Staff,0,19,60,60
1650091536135,COGS 101C,A01,083976,Staff,12,0,30,18
1650091542163,COGS 102A,A01,083978,Johnson; Christine M.,10,0,30,20
1650091548186,COGS 107B,A01,083980,Staff,0,9,50,50
1650091554209,COGS 115,A01,083982,Staff,9,0,30,21
1650091560231,COGS 118B,A01,083367,Staff,0,16,40,40
1650091566255,COGS 172,A01,083984,Provenzano; Emily Kara,13,0,30,17
1650091572286,COGS 177,A00,083368,Staff,0,22,30,30
1650091578310,COGS 186,A01,083986,Staff,21,0,40,19
1650091584339,COGS 187A,A01,083988,Boyle; Mary E. T.,16,0,60,44
1650091590364,CSE 8A,A50,084003,Miranda; Gregory Joseph,0,19,15,15
1650091596388,CSE 11,A01,084005,Miranda; Gregory Joseph,0,24,55,55
1650091602412,CSE 20,A01,084007,Staff,0,5,20,20
1650091608437,CSE 21,A01,084009,Staff,0,32,50,50
1650091614465,CSE 30,A01,083370,Cao; Yingjun,0,63,40,40
1650091620497,CSE 100,A01,083372,Cao; Yingjun,0,48,40,40
1650091626520,CSE 101,A01,084011,Staff,0,56,40,40
1650091632544,CSE 141,A01,083374,Eldon; John,0,69,75,75
1650091638567,CSE 141L,A01,083376,Eldon; John,0,75,75,75
1650091644591,CSE 175,A01,084013,Kumar; Rakesh,22,0,25,3
1650091650615,CSE 190,A00,092508,Dubnov; Shlomo,18,0,20,2
1650091656641,ECE 5,A01,084049,Morris; Karcher William,12,0,20,8
1650091662668,ECE 100,A01,084051,Baghdadchi; Saharnaz,0,0,20,20
1650091662668,ECE 100,A02,091916,Baghdadchi; Saharnaz,11,0,20,9
1650091668691,ECE 101,A01,084053,Baghdadchi; Saharnaz,0,0,37,37
1650091668691,ECE 101,A02,084054,Baghdadchi; Saharnaz,27,0,37,10
1650091674720,ECE 107,A01,083390,Staff,26,0,40,14
1650091680748,ECE 148,A01,084056,Silberman; Jack,8,0,12,4
1650091686771,ECE 180,A00,083391,Abi Samra; Nicholas Camill,25,0,30,5
1650091686771,ECE 180,B00,083392,Abi Samra; Nicholas Camill,21,0,30,9
1650091692795,MATH 10B,A01,084110,Staff,0,0,30,30
1650091692795,MATH 10B,A02,084111,Staff,16,0,30,14
1650091692795,MATH 10B,A03,084112,Staff,23,0,30,7
1650091698819,MATH 10C,A01,083443,Staff,0,17,30,31
1650091698819,MATH 10C,A02,083444,Staff,0,18,30,30
1650091698819,MATH 10C,B01,084114,Staff,17,0,30,13
1650091698819,MATH 10C,B02,084115,Staff,24,0,30,6
1650091704843,MATH 18,A01,084117,Harel; Guershon,11,0,30,19
1650091704843,MATH 18,A02,084119,Harel; Guershon,27,0,30,3
1650091704843,MATH 18,A03,084120,Harel; Guershon,30,0,30,0
1650091704843,MATH 18,A04,084121,Harel; Guershon,29,0,30,1
1650091710867,MATH 20B,A01,084124,Um; Ko Woon,10,0,35,25
1650091710867,MATH 20B,B01,084126,Um; Ko Woon,24,0,35,11
1650091716892,MATH 20C,A01,083446,Hammock; Frances H,0,0,30,30
1650091716892,MATH 20C,A02,083447,Hammock; Frances H,13,0,30,17
1650091716892,MATH 20C,A03,083448,Hammock; Frances H,18,0,30,12
1650091716892,MATH 20C,A04,083449,Hammock; Frances H,20,0,30,10
1650091716892,MATH 20C,B01,083451,Hammock; Frances H,0,0,30,30
1650091716892,MATH 20C,B02,083452,Hammock; Frances H,15,0,30,15
1650091716892,MATH 20C,B03,083453,Hammock; Frances H,19,0,30,11
1650091716892,MATH 20C,B04,083454,Hammock; Frances H,23,0,30,7
1650091722919,MATH 20D,A01,084128,Staff,13,0,30,17
1650091722919,MATH 20D,A02,084129,Staff,29,0,30,1
1650091722919,MATH 20D,A03,084130,Staff,28,0,30,2
1650091722919,MATH 20D,B01,084133,Staff,0,0,30,30
1650091722919,MATH 20D,B02,084134,Staff,23,0,30,7
1650091722919,MATH 20D,B03,084135,Staff,28,0,30,2
1650091728946,MATH 20E,A01,084138,Staff,13,0,30,17
1650091728946,MATH 20E,A02,084139,Staff,6,0,30,24
1650091728946,MATH 20E,A03,084140,Staff,14,0,30,16
1650091728946,MATH 20E,A04,084141,Staff,19,0,30,11
1650091734970,MATH 102,A01,084143,Harel; Guershon,11,0,30,19
1650091734970,MATH 102,A02,084144,Harel; Guershon,18,0,30,12
1650091740995,MATH 103B,A01,083456,Staff,0,13,30,30
1650091740995,MATH 103B,A02,083457,Staff,0,14,30,30
1650091747019,MATH 109,A01,084146,Salehi Golsefidy; Alireza,16,0,30,14
1650091747019,MATH 109,A02,084147,Salehi Golsefidy; Alireza,15,0,30,15
1650091753044,MATH 120A,A01,085445,Eggers; John Dietrich,6,0,35,29
1650091753044,MATH 120A,A02,085446,Eggers; John Dietrich,26,0,35,9
1650091759069,MATH 142B,A01,084149,Verstraete; Jacques Allan,0,12,30,30
1650091759069,MATH 142B,A02,084150,Verstraete; Jacques Allan,0,12,30,30
1650091765105,MATH 170A,A01,083459,Nie; Jiawang,0,11,30,30
1650091765105,MATH 170A,A02,083460,Nie; Jiawang,0,10,30,30
1650091765105,MATH 170A,A03,083461,Nie; Jiawang,0,11,30,30
1650091771128,MATH 193B,A01,083463,Staff,1,0,30,29
1650091771128,MATH 193B,A02,083464,Staff,8,0,30,22
1650091771128,MATH 193B,A03,083465,Staff,16,0,30,14
1650091777210,COGS 2,A01,083966,Boyle; Mary E. T.,9,0,30,21
1650091783233,COGS 9,A01,083968,Staff,2,0,60,58
1650091789272,COGS 14B,A01,083970,Staff,7,0,50,43
1650091795296,COGS 17,A01,092679,Staff,49,0,75,26
1650091801322,COGS 100,A01,083972,Staff,0,19,60,60
1650091813369,COGS 101C,A01,083976,Staff,12,0,30,18
1650091819392,COGS 102A,A01,083978,Johnson; Christine M.,10,0,30,20
1650091825424,COGS 107B,A01,083980,Staff,0,10,50,50
1650091831446,COGS 115,A01,083982,Staff,9,0,30,21
1650091837470,COGS 118B,A01,083367,Staff,0,16,40,40
1650091843497,COGS 172,A01,083984,Provenzano; Emily Kara,13,0,30,17
1650091849528,COGS 177,A00,083368,Staff,0,22,30,30
1650091855549,COGS 186,A01,083986,Staff,21,0,40,19
1650091861573,COGS 187A,A01,083988,Boyle; Mary E. T.,16,0,60,44
1650091867597,CSE 8A,A50,084003,Miranda; Gregory Joseph,0,19,15,15
1650091873711,CSE 11,A01,084005,Miranda; Gregory Joseph,0,24,55,55
1650091879738,CSE 20,A01,084007,Staff,0,5,20,20
1650091885765,CSE 21,A01,084009,Staff,0,32,50,50
1650091891791,CSE 30,A01,083370,Cao; Yingjun,0,63,40,40
1650091897813,CSE 100,A01,083372,Cao; Yingjun,0,48,40,40
1650091903837,CSE 101,A01,084011,Staff,0,56,40,40
1650091909863,CSE 141,A01,083374,Eldon; John,0,69,75,75
1650091915885,CSE 141L,A01,083376,Eldon; John,0,75,75,75
1650091921909,CSE 175,A01,084013,Kumar; Rakesh,22,0,25,3
1650091927933,CSE 190,A00,092508,Dubnov; Shlomo,18,0,20,2
1650091933960,ECE 5,A01,084049,Morris; Karcher William,12,0,20,8
1650091939992,ECE 100,A01,084051,Baghdadchi; Saharnaz,0,0,20,20
1650091939992,ECE 100,A02,091916,Baghdadchi; Saharnaz,11,0,20,9
1650091946015,ECE 101,A01,084053,Baghdadchi; Saharnaz,0,0,37,37
1650091946015,ECE 101,A02,084054,Baghdadchi; Saharnaz,27,0,37,10
1650091952039,ECE 107,A01,083390,Staff,26,0,40,14
1650091958064,ECE 148,A01,084056,Silberman; Jack,8,0,12,4
1650091964089,ECE 180,A00,083391,Abi Samra; Nicholas Camill,25,0,30,5
1650091964089,ECE 180,B00,083392,Abi Samra; Nicholas Camill,21,0,30,9
1650091970114,MATH 10B,A01,084110,Staff,0,0,30,30
1650091970114,MATH 10B,A02,084111,Staff,16,0,30,14
1650091970114,MATH 10B,A03,084112,Staff,23,0,30,7
1650091976140,MATH 10C,A01,083443,Staff,0,17,30,31
1650091976140,MATH 10C,A02,083444,Staff,0,18,30,30
1650091976140,MATH 10C,B01,084114,Staff,17,0,30,13
1650091976140,MATH 10C,B02,084115,Staff,24,0,30,6
1650091982166,MATH 18,A01,084117,Harel; Guershon,11,0,30,19
1650091982166,MATH 18,A02,084119,Harel; Guershon,27,0,30,3
1650091982166,MATH 18,A03,084120,Harel; Guershon,30,0,30,0
1650091982166,MATH 18,A04,084121,Harel; Guershon,29,0,30,1
1650091988194,MATH 20B,A01,084124,Um; Ko Woon,10,0,35,25
1650091988194,MATH 20B,B01,084126,Um; Ko Woon,24,0,35,11
1650091994219,MATH 20C,A01,083446,Hammock; Frances H,0,0,30,30
1650091994219,MATH 20C,A02,083447,Hammock; Frances H,13,0,30,17
1650091994219,MATH 20C,A03,083448,Hammock; Frances H,18,0,30,12
1650091994219,MATH 20C,A04,083449,Hammock; Frances H,20,0,30,10
1650091994219,MATH 20C,B01,083451,Hammock; Frances H,0,0,30,30
1650091994219,MATH 20C,B02,083452,Hammock; Frances H,15,0,30,15
1650091994219,MATH 20C,B03,083453,Hammock; Frances H,19,0,30,11
1650091994219,MATH 20C,B04,083454,Hammock; Frances H,23,0,30,7
1650092000247,MATH 20D,A01,084128,Staff,13,0,30,17
1650092000247,MATH 20D,A02,084129,Staff,29,0,30,1
1650092000247,MATH 20D,A03,084130,Staff,28,0,30,2
1650092000247,MATH 20D,B01,084133,Staff,0,0,30,30
1650092000247,MATH 20D,B02,084134,Staff,23,0,30,7
1650092000247,MATH 20D,B03,084135,Staff,28,0,30,2
1650092006270,MATH 20E,A01,084138,Staff,13,0,30,17
1650092006270,MATH 20E,A02,084139,Staff,6,0,30,24
1650092006270,MATH 20E,A03,084140,Staff,14,0,30,16
1650092006270,MATH 20E,A04,084141,Staff,19,0,30,11
1650092012293,MATH 102,A01,084143,Harel; Guershon,11,0,30,19
1650092012293,MATH 102,A02,084144,Harel; Guershon,18,0,30,12
1650092018319,MATH 103B,A01,083456,Staff,0,13,30,30
1650092018319,MATH 103B,A02,083457,Staff,0,14,30,30
1650092024363,MATH 109,A01,084146,Salehi Golsefidy; Alireza,16,0,30,14
1650092024363,MATH 109,A02,084147,Salehi Golsefidy; Alireza,15,0,30,15
1650092030400,MATH 120A,A01,085445,Eggers; John Dietrich,6,0,35,29
1650092030400,MATH 120A,A02,085446,Eggers; John Dietrich,26,0,35,9
1650092036427,MATH 142B,A01,084149,Verstraete; Jacques Allan,0,12,30,30
1650092036427,MATH 142B,A02,084150,Verstraete; Jacques Allan,0,12,30,30
1650092042451,MATH 170A,A01,083459,Nie; Jiawang,0,11,30,30
1650092042451,MATH 170A,A02,083460,Nie; Jiawang,0,10,30,30
1650092042451,MATH 170A,A03,083461,Nie; Jiawang,0,11,30,30
1650092048475,MATH 193B,A01,083463,Staff,1,0,30,29
1650092048475,MATH 193B,A02,083464,Staff,8,0,30,22
1650092048475,MATH 193B,A03,083465,Staff,16,0,30,14
1650092054561,COGS 2,A01,083966,Boyle; Mary E. T.,9,0,30,21
1650092060587,COGS 9,A01,083968,Staff,2,0,60,58
1650092066610,COGS 14B,A01,083970,Staff,7,0,50,43
1650092072640,COGS 17,A01,092679,Staff,49,0,75,26
1650092078668,COGS 100,A01,083972,Staff,0,19,60,60
1650092090725,COGS 101C,A01,083976,Staff,12,0,30,18
1650092096752,COGS 102A,A01,083978,Johnson; Christine M.,9,0,30,21
1650092102780,COGS 107B,A01,083980,Staff,0,9,50,50
1650092108804,COGS 115,A01,083982,Staff,9,0,30,21
1650092114831,COGS 118B,A01,083367,Staff,0,16,40,40
1650092120855,COGS 172,A01,083984,Provenzano; Emily Kara,13,0,30,17
1650092126881,COGS 177,A00,083368,Staff,0,22,30,30
1650092132909,COGS 186,A01,083986,Staff,21,0,40,19
1650092138936,COGS 187A,A01,083988,Boyle; Mary E. T.,15,0,60,45
1650092144962,CSE 8A,A50,084003,Miranda; Gregory Joseph,0,19,15,15
1650092150986,CSE 11,A01,084005,Miranda; Gregory Joseph,0,24,55,55
1650092157012,CSE 20,A01,084007,Staff,0,5,20,20
1650092163040,CSE 21,A01,084009,Staff,0,32,50,50
1650092169067,CSE 30,A01,083370,Cao; Yingjun,0,63,40,40
1650092175092,CSE 100,A01,083372,Cao; Yingjun,0,48,40,40
1650092181120,CSE 101,A01,084011,Staff,0,56,40,40
1650092187146,CSE 141,A01,083374,Eldon; John,0,69,75,75
1650092193172,CSE 141L,A01,083376,Eldon; John,0,75,75,75
1650092199197,CSE 175,A01,084013,Kumar; Rakesh,22,0,25,3
1650092205229,CSE 190,A00,092508,Dubnov; Shlomo,18,0,20,2
1650092211254,ECE 5,A01,084049,Morris; Karcher William,12,0,20,8
1650092217281,ECE 100,A01,084051,Baghdadchi; Saharnaz,0,0,20,20
1650092217281,ECE 100,A02,091916,Baghdadchi; Saharnaz,11,0,20,9
1650092223306,ECE 101,A01,084053,Baghdadchi; Saharnaz,0,0,37,37
1650092223306,ECE 101,A02,084054,Baghdadchi; Saharnaz,27,0,37,10
1650092229334,ECE 107,A01,083390,Staff,26,0,40,14
1650092235357,ECE 148,A01,084056,Silberman; Jack,8,0,12,4
1650092241380,ECE 180,A00,083391,Abi Samra; Nicholas Camill,25,0,30,5
1650092241380,ECE 180,B00,083392,Abi Samra; Nicholas Camill,21,0,30,9
1650092247402,MATH 10B,A01,084110,Staff,0,0,30,30
1650092247402,MATH 10B,A02,084111,Staff,16,0,30,14
1650092247402,MATH 10B,A03,084112,Staff,23,0,30,7
1650092253426,MATH 10C,A01,083443,Staff,0,17,30,31
1650092253426,MATH 10C,A02,083444,Staff,0,18,30,30
1650092253426,MATH 10C,B01,084114,Staff,17,0,30,13
1650092253426,MATH 10C,B02,084115,Staff,24,0,30,6
1650092259451,MATH 18,A01,084117,Harel; Guershon,11,0,30,19
1650092259451,MATH 18,A02,084119,Harel; Guershon,27,0,30,3
1650092259451,MATH 18,A03,084120,Harel; Guershon,30,0,30,0
1650092259451,MATH 18,A04,084121,Harel; Guershon,29,0,30,1
1650092265484,MATH 20B,A01,084124,Um; Ko Woon,10,0,35,25
1650092265484,MATH 20B,B01,084126,Um; Ko Woon,24,0,35,11
1650092271510,MATH 20C,A01,083446,Hammock; Frances H,0,0,30,30
1650092271510,MATH 20C,A02,083447,Hammock; Frances H,13,0,30,17
1650092271510,MATH 20C,A03,083448,Hammock; Frances H,18,0,30,12
1650092271510,MATH 20C,A04,083449,Hammock; Frances H,20,0,30,10
1650092271510,MATH 20C,B01,083451,Hammock; Frances H,0,0,30,30
1650092271510,MATH 20C,B02,083452,Hammock; Frances H,15,0,30,15
1650092271510,MATH 20C,B03,083453,Hammock; Frances H,19,0,30,11
1650092271510,MATH 20C,B04,083454,Hammock; Frances H,23,0,30,7
1650092277543,MATH 20D,A01,084128,Staff,13,0,30,17
1650092277543,MATH 20D,A02,084129,Staff,29,0,30,1
1650092277543,MATH 20D,A03,084130,Staff,28,0,30,2
1650092277543,MATH 20D,B01,084133,Staff,0,0,30,30
1650092277543,MATH 20D,B02,084134,Staff,23,0,30,7
1650092277543,MATH 20D,B03,084135,Staff,28,0,30,2
1650092283567,MATH 20E,A01,084138,Staff,13,0,30,17
1650092283567,MATH 20E,A02,084139,Staff,6,0,30,24
1650092283567,MATH 20E,A03,084140,Staff,14,0,30,16
1650092283567,MATH 20E,A04,084141,Staff,19,0,30,11
1650092289595,MATH 102,A01,084143,Harel; Guershon,11,0,30,19
1650092289595,MATH 102,A02,084144,Harel; Guershon,18,0,30,12
1650092295621,MATH 103B,A01,083456,Staff,0,13,30,30
1650092295621,MATH 103B,A02,083457,Staff,0,14,30,30
1650092301646,MATH 109,A01,084146,Salehi Golsefidy; Alireza,16,0,30,14
1650092301646,MATH 109,A02,084147,Salehi Golsefidy; Alireza,15,0,30,15
1650092307670,MATH 120A,A01,085445,Eggers; John Dietrich,6,0,35,29
1650092307670,MATH 120A,A02,085446,Eggers; John Dietrich,26,0,35,9
1650092313698,MATH 142B,A01,084149,Verstraete; Jacques Allan,0,12,30,30
1650092313698,MATH 142B,A02,084150,Verstraete; Jacques Allan,0,12,30,30
1650092319721,MATH 170A,A01,083459,Nie; Jiawang,0,11,30,30
1650092319721,MATH 170A,A02,083460,Nie; Jiawang,0,10,30,30
1650092319721,MATH 170A,A03,083461,Nie; Jiawang,0,11,30,30
1650092325745,MATH 193B,A01,083463,Staff,1,0,30,29
1650092325745,MATH 193B,A02,083464,Staff,8,0,30,22
1650092325745,MATH 193B,A03,083465,Staff,16,0,30,14
1650092331809,COGS 2,A01,083966,Boyle; Mary E. T.,9,0,30,21
1650092337837,COGS 9,A01,083968,Staff,2,0,60,58
1650092343862,COGS 14B,A01,083970,Staff,7,0,50,43
1650092349894,COGS 17,A01,092679,Staff,49,0,75,26
1650092355922,COGS 100,A01,083972,Staff,0,19,60,60
1650092367971,COGS 101C,A01,083976,Staff,12,0,30,18
1650092373999,COGS 102A,A01,083978,Johnson; Christine M.,9,0,30,21
1650092380025,COGS 107B,A01,083980,Staff,0,9,50,50
1650092386051,COGS 115,A01,083982,Staff,9,0,30,21
1650092392073,COGS 118B,A01,083367,Staff,0,16,40,40
1650092398097,COGS 172,A01,083984,Provenzano; Emily Kara,13,0,30,17
1650092404125,COGS 177,A00,083368,Staff,0,22,30,30
1650092410150,COGS 186,A01,083986,Staff,21,0,40,19
1650092416173,COGS 187A,A01,083988,Boyle; Mary E. T.,15,0,60,45
1650092422203,CSE 8A,A50,084003,Miranda; Gregory Joseph,0,19,15,15
1650092428233,CSE 11,A01,084005,Miranda; Gregory Joseph,0,24,55,55
1650092434257,CSE 20,A01,084007,Staff,0,5,20,20
1650092440282,CSE 21,A01,084009,Staff,0,32,50,50
1650092446313,CSE 30,A01,083370,Cao; Yingjun,0,63,40,40
1650092452339,CSE 100,A01,083372,Cao; Yingjun,0,48,40,40
1650092458363,CSE 101,A01,084011,Staff,0,56,40,40
1650092464402,CSE 141,A01,083374,Eldon; John,0,69,75,75
1650092470551,CSE 141L,A01,083376,Eldon; John,0,75,75,75
1650092476575,CSE 175,A01,084013,Kumar; Rakesh,22,0,25,3
1650092482610,CSE 190,A00,092508,Dubnov; Shlomo,18,0,20,2
1650092488639,ECE 5,A01,084049,Morris; Karcher William,12,0,20,8
1650092494669,ECE 100,A01,084051,Baghdadchi; Saharnaz,0,0,20,20
1650092494669,ECE 100,A02,091916,Baghdadchi; Saharnaz,11,0,20,9
1650092500705,ECE 101,A01,084053,Baghdadchi; Saharnaz,0,0,37,37
1650092500705,ECE 101,A02,084054,Baghdadchi; Saharnaz,27,0,37,10
1650092506735,ECE 107,A01,083390,Staff,26,0,40,14
1650092512759,ECE 148,A01,084056,Silberman; Jack,8,0,12,4
1650092518784,ECE 180,A00,083391,Abi Samra; Nicholas Camill,25,0,30,5
1650092518784,ECE 180,B00,083392,Abi Samra; Nicholas Camill,21,0,30,9
1650092524811,MATH 10B,A01,084110,Staff,0,0,30,30
1650092524811,MATH 10B,A02,084111,Staff,16,0,30,14
1650092524811,MATH 10B,A03,084112,Staff,23,0,30,7
1650092530840,MATH 10C,A01,083443,Staff,0,17,30,31
1650092530840,MATH 10C,A02,083444,Staff,0,18,30,30
1650092530840,MATH 10C,B01,084114,Staff,17,0,30,13
1650092530840,MATH 10C,B02,084115,Staff,24,0,30,6
1650092536867,MATH 18,A01,084117,Harel; Guershon,11,0,30,19
1650092536867,MATH 18,A02,084119,Harel; Guershon,27,0,30,3
1650092536867,MATH 18,A03,084120,Harel; Guershon,30,0,30,0
1650092536867,MATH 18,A04,084121,Harel; Guershon,29,0,30,1
1650092542896,MATH 20B,A01,084124,Um; Ko Woon,10,0,35,25
1650092542896,MATH 20B,B01,084126,Um; Ko Woon,24,0,35,11
1650092548921,MATH 20C,A01,083446,Hammock; Frances H,0,0,30,30
1650092548921,MATH 20C,A02,083447,Hammock; Frances H,13,0,30,17
1650092548921,MATH 20C,A03,083448,Hammock; Frances H,18,0,30,12
1650092548921,MATH 20C,A04,083449,Hammock; Frances H,20,0,30,10
1650092548921,MATH 20C,B01,083451,Hammock; Frances H,0,0,30,30
1650092548921,MATH 20C,B02,083452,Hammock; Frances H,15,0,30,15
1650092548921,MATH 20C,B03,083453,Hammock; Frances H,19,0,30,11
1650092548921,MATH 20C,B04,083454,Hammock; Frances H,23,0,30,7
1650092554952,MATH 20D,A01,084128,Staff,13,0,30,17
1650092554952,MATH 20D,A02,084129,Staff,29,0,30,1
1650092554952,MATH 20D,A03,084130,Staff,28,0,30,2
1650092554952,MATH 20D,B01,084133,Staff,0,0,30,30
1650092554952,MATH 20D,B02,084134,Staff,23,0,30,7
1650092554952,MATH 20D,B03,084135,Staff,28,0,30,2
1650092560976,MATH 20E,A01,084138,Staff,13,0,30,17
1650092560976,MATH 20E,A02,084139,Staff,6,0,30,24
1650092560976,MATH 20E,A03,084140,Staff,14,0,30,16
1650092560976,MATH 20E,A04,084141,Staff,19,0,30,11
1650092567001,MATH 102,A01,084143,Harel; Guershon,11,0,30,19
1650092567001,MATH 102,A02,084144,Harel; Guershon,18,0,30,12
1650092573026,MATH 103B,A01,083456,Staff,0,13,30,30
1650092573026,MATH 103B,A02,083457,Staff,0,14,30,30
1650092579059,MATH 109,A01,084146,Salehi Golsefidy; Alireza,16,0,30,14
1650092579059,MATH 109,A02,084147,Salehi Golsefidy; Alireza,15,0,30,15
1650092585083,MATH 120A,A01,085445,Eggers; John Dietrich,6,0,35,29
1650092585083,MATH 120A,A02,085446,Eggers; John Dietrich,26,0,35,9
1650092591109,MATH 142B,A01,084149,Verstraete; Jacques Allan,0,12,30,30
1650092591109,MATH 142B,A02,084150,Verstraete; Jacques Allan,0,12,30,30
1650092597140,MATH 170A,A01,083459,Nie; Jiawang,0,11,30,30
1650092597140,MATH 170A,A02,083460,Nie; Jiawang,0,10,30,30
1650092597140,MATH 170A,A03,083461,Nie; Jiawang,0,11,30,30
1650092603169,MATH 193B,A01,083463,Staff,1,0,30,29
1650092603169,MATH 193B,A02,083464,Staff,8,0,30,22
1650092603169,MATH 193B,A03,083465,Staff,16,0,30,14
1650092609230,COGS 2,A01,083966,Boyle; Mary E. T.,9,0,30,21
1650092615253,COGS 9,A01,083968,Staff,2,0,60,58
1650092621279,COGS 14B,A01,083970,Staff,7,0,50,43
1650092627309,COGS 17,A01,092679,Staff,49,0,75,26
1650092633340,COGS 100,A01,083972,Staff,0,19,60,60
1650092645393,COGS 101C,A01,083976,Staff,12,0,30,18
1650092651416,COGS 102A,A01,083978,Johnson; Christine M.,9,0,30,21
1650092657447,COGS 107B,A01,083980,Staff,0,9,50,50
1650092663472,COGS 115,A01,083982,Staff,9,0,30,21
1650092669499,COGS 118B,A01,083367,Staff,0,16,40,40
1650092675524,COGS 172,A01,083984,Provenzano; Emily Kara,13,0,30,17
1650092681549,COGS 177,A00,083368,Staff,0,22,30,30
1650092687578,COGS 186,A01,083986,Staff,21,0,40,19
1650092693601,COGS 187A,A01,083988,Boyle; Mary E. T.,15,0,60,45
1650092699625,CSE 8A,A50,084003,Miranda; Gregory Joseph,0,19,15,15
1650092705652,CSE 11,A01,084005,Miranda; Gregory Joseph,0,24,55,55
1650092711678,CSE 20,A01,084007,Staff,0,5,20,20
1650092717706,CSE 21,A01,084009,Staff,0,32,50,50
1650092723731,CSE 30,A01,083370,Cao; Yingjun,0,63,40,40
1650092729760,CSE 100,A01,083372,Cao; Yingjun,0,48,40,40
1650092735784,CSE 101,A01,084011,Staff,0,56,40,40
1650092741809,CSE 141,A01,083374,Eldon; John,0,69,75,75
1650092747832,CSE 141L,A01,083376,Eldon; John,0,75,75,75
1650092753860,CSE 175,A01,084013,Kumar; Rakesh,22,0,25,3
1650092759890,CSE 190,A00,092508,Dubnov; Shlomo,18,0,20,2
1650092765916,ECE 5,A01,084049,Morris; Karcher William,12,0,20,8
1650092771941,ECE 100,A01,084051,Baghdadchi; Saharnaz,0,0,20,20
1650092771941,ECE 100,A02,091916,Baghdadchi; Saharnaz,11,0,20,9
1650092777975,ECE 101,A01,084053,Baghdadchi; Saharnaz,0,0,37,37
1650092777975,ECE 101,A02,084054,Baghdadchi; Saharnaz,27,0,37,10
1650092783998,ECE 107,A01,083390,Staff,26,0,40,14
1650092790028,ECE 148,A01,084056,Silberman; Jack,8,0,12,4
1650092796052,ECE 180,A00,083391,Abi Samra; Nicholas Camill,25,0,30,5
1650092796052,ECE 180,B00,083392,Abi Samra; Nicholas Camill,21,0,30,9
1650092802092,MATH 10B,A01,084110,Staff,0,0,30,30
1650092802092,MATH 10B,A02,084111,Staff,16,0,30,14
1650092802092,MATH 10B,A03,084112,Staff,23,0,30,7
1650092808123,MATH 10C,A01,083443,Staff,0,17,30,31
1650092808123,MATH 10C,A02,083444,Staff,0,18,30,30
1650092808123,MATH 10C,B01,084114,Staff,17,0,30,13
1650092808123,MATH 10C,B02,084115,Staff,24,0,30,6
1650092814154,MATH 18,A01,084117,Harel; Guershon,11,0,30,19
1650092814154,MATH 18,A02,084119,Harel; Guershon,27,0,30,3
1650092814154,MATH 18,A03,084120,Harel; Guershon,30,0,30,0
1650092814154,MATH 18,A04,084121,Harel; Guershon,29,0,30,1
1650092820193,MATH 20B,A01,084124,Um; Ko Woon,10,0,35,25
1650092820193,MATH 20B,B01,084126,Um; Ko Woon,24,0,35,11
1650092826217,MATH 20C,A01,083446,Hammock; Frances H,0,0,30,30
1650092826217,MATH 20C,A02,083447,Hammock; Frances H,13,0,30,17
1650092826217,MATH 20C,A03,083448,Hammock; Frances H,18,0,30,12
1650092826217,MATH 20C,A04,083449,Hammock; Frances H,20,0,30,10
1650092826217,MATH 20C,B01,083451,Hammock; Frances H,0,0,30,30
1650092826217,MATH 20C,B02,083452,Hammock; Frances H,15,0,30,15
1650092826217,MATH 20C,B03,083453,Hammock; Frances H,19,0,30,11
1650092826217,MATH 20C,B04,083454,Hammock; Frances H,23,0,30,7
1650092832246,MATH 20D,A01,084128,Staff,13,0,30,17
1650092832246,MATH 20D,A02,084129,Staff,29,0,30,1
1650092832246,MATH 20D,A03,084130,Staff,28,0,30,2
1650092832246,MATH 20D,B01,084133,Staff,0,0,30,30
1650092832246,MATH 20D,B02,084134,Staff,23,0,30,7
1650092832246,MATH 20D,B03,084135,Staff,28,0,30,2
1650092838274,MATH 20E,A01,084138,Staff,13,0,30,17
1650092838274,MATH 20E,A02,084139,Staff,6,0,30,24
1650092838274,MATH 20E,A03,084140,Staff,14,0,30,16
1650092838274,MATH 20E,A04,084141,Staff,19,0,30,11
1650092844302,MATH 102,A01,084143,Harel; Guershon,11,0,30,19
1650092844302,MATH 102,A02,084144,Harel; Guershon,18,0,30,12
1650092850331,MATH 103B,A01,083456,Staff,0,13,30,30
1650092850331,MATH 103B,A02,083457,Staff,0,14,30,30
1650092856361,MATH 109,A01,084146,Salehi Golsefidy; Alireza,16,0,30,14
1650092856361,MATH 109,A02,084147,Salehi Golsefidy; Alireza,15,0,30,15
1650092862392,MATH 120A,A01,085445,Eggers; John Dietrich,6,0,35,29
1650092862392,MATH 120A,A02,085446,Eggers; John Dietrich,26,0,35,9
1650092868415,MATH 142B,A01,084149,Verstraete; Jacques Allan,0,12,30,30
1650092868415,MATH 142B,A02,084150,Verstraete; Jacques Allan,0,12,30,30
1650092874445,MATH 170A,A01,083459,Nie; Jiawang,0,11,30,30
1650092874445,MATH 170A,A02,083460,Nie; Jiawang,0,10,30,30
1650092874445,MATH 170A,A03,083461,Nie; Jiawang,0,11,30,30
1650092880470,MATH 193B,A01,083463,Staff,1,0,30,29
1650092880470,MATH 193B,A02,083464,Staff,8,0,30,22
1650092880470,MATH 193B,A03,083465,Staff,16,0,30,14
1650092886527,COGS 2,A01,083966,Boyle; Mary E. T.,9,0,30,21
1650092892556,COGS 9,A01,083968,Staff,2,0,60,58
1650092898585,COGS 14B,A01,083970,Staff,7,0,50,43
1650092904609,COGS 17,A01,092679,Staff,49,0,75,26
1650092910635,COGS 100,A01,083972,Staff,0,19,60,60
1650092922688,COGS 101C,A01,083976,Staff,12,0,30,18
1650092928725,COGS 102A,A01,083978,Johnson; Christine M.,9,0,30,21
1650092934755,COGS 107B,A01,083980,Staff,0,9,50,50
1650092940785,COGS 115,A01,083982,Staff,9,0,30,21
1650092946810,COGS 118B,A01,083367,Staff,0,16,40,40
1650092952838,COGS 172,A01,083984,Provenzano; Emily Kara,13,0,30,17
1650092958865,COGS 177,A00,083368,Staff,0,22,30,30
1650092964889,COGS 186,A01,083986,Staff,21,0,40,19
1650092970919,COGS 187A,A01,083988,Boyle; Mary E. T.,15,0,60,45
1650092976947,CSE 8A,A50,084003,Miranda; Gregory Joseph,0,19,15,15
1650092982971,CSE 11,A01,084005,Miranda; Gregory Joseph,0,24,55,55
1650092988996,CSE 20,A01,084007,Staff,0,5,20,20
1650092995019,CSE 21,A01,084009,Staff,0,32,50,50
1650093001044,CSE 30,A01,083370,Cao; Yingjun,0,63,40,40
1650093007070,CSE 100,A01,083372,Cao; Yingjun,0,48,40,40
1650093013097,CSE 101,A01,084011,Staff,0,56,40,40
1650093019122,CSE 141,A01,083374,Eldon; John,0,69,75,75
1650093025160,CSE 141L,A01,083376,Eldon; John,0,75,75,75
1650093031188,CSE 175,A01,084013,Kumar; Rakesh,22,0,25,3
1650093037214,CSE 190,A00,092508,Dubnov; Shlomo,18,0,20,2
1650093043238,ECE 5,A01,084049,Morris; Karcher William,12,0,20,8
1650093049261,ECE 100,A01,084051,Baghdadchi; Saharnaz,0,0,20,20
1650093049261,ECE 100,A02,091916,Baghdadchi; Saharnaz,11,0,20,9
1650093055285,ECE 101,A01,084053,Baghdadchi; Saharnaz,0,0,37,37
1650093055285,ECE 101,A02,084054,Baghdadchi; Saharnaz,27,0,37,10
1650093061313,ECE 107,A01,083390,Staff,26,0,40,14
1650093067415,ECE 148,A01,084056,Silberman; Jack,8,0,12,4
1650093073439,ECE 180,A00,083391,Abi Samra; Nicholas Camill,25,0,30,5
1650093073439,ECE 180,B00,083392,Abi Samra; Nicholas Camill,21,0,30,9
1650093079464,MATH 10B,A01,084110,Staff,0,0,30,30
1650093079464,MATH 10B,A02,084111,Staff,16,0,30,14
1650093079464,MATH 10B,A03,084112,Staff,23,0,30,7
1650093085488,MATH 10C,A01,083443,Staff,0,17,30,31
1650093085488,MATH 10C,A02,083444,Staff,0,18,30,30
1650093085488,MATH 10C,B01,084114,Staff,17,0,30,13
1650093085488,MATH 10C,B02,084115,Staff,24,0,30,6
1650093091516,MATH 18,A01,084117,Harel; Guershon,11,0,30,19
1650093091516,MATH 18,A02,084119,Harel; Guershon,27,0,30,3
1650093091516,MATH 18,A03,084120,Harel; Guershon,30,0,30,0
1650093091516,MATH 18,A04,084121,Harel; Guershon,29,0,30,1
1650093097547,MATH 20B,A01,084124,Um; Ko Woon,10,0,35,25
1650093097547,MATH 20B,B01,084126,Um; Ko Woon,24,0,35,11
1650093103579,MATH 20C,A01,083446,Hammock; Frances H,0,0,30,30
1650093103579,MATH 20C,A02,083447,Hammock; Frances H,13,0,30,17
1650093103579,MATH 20C,A03,083448,Hammock; Frances H,18,0,30,12
1650093103579,MATH 20C,A04,083449,Hammock; Frances H,20,0,30,10
1650093103579,MATH 20C,B01,083451,Hammock; Frances H,0,0,30,30
1650093103579,MATH 20C,B02,083452,Hammock; Frances H,15,0,30,15
1650093103579,MATH 20C,B03,083453,Hammock; Frances H,19,0,30,11
1650093103579,MATH 20C,B04,083454,Hammock; Frances H,23,0,30,7
1650093109611,MATH 20D,A01,084128,Staff,13,0,30,17
1650093109611,MATH 20D,A02,084129,Staff,29,0,30,1
1650093109611,MATH 20D,A03,084130,Staff,28,0,30,2
1650093109611,MATH 20D,B01,084133,Staff,0,0,30,30
1650093109611,MATH 20D,B02,084134,Staff,23,0,30,7
1650093109611,MATH 20D,B03,084135,Staff,28,0,30,2
1650093115641,MATH 20E,A01,084138,Staff,13,0,30,17
1650093115641,MATH 20E,A02,084139,Staff,6,0,30,24
1650093115641,MATH 20E,A03,084140,Staff,14,0,30,16
1650093115641,MATH 20E,A04,084141,Staff,19,0,30,11
1650093121667,MATH 102,A01,084143,Harel; Guershon,11,0,30,19
1650093121667,MATH 102,A02,084144,Harel; Guershon,18,0,30,12
1650093127693,MATH 103B,A01,083456,Staff,0,13,30,30
1650093127693,MATH 103B,A02,083457,Staff,0,14,30,30
1650093133721,MATH 109,A01,084146,Salehi Golsefidy; Alireza,16,0,30,14
1650093133721,MATH 109,A02,084147,Salehi Golsefidy; Alireza,15,0,30,15
1650093139746,MATH 120A,A01,085445,Eggers; John Dietrich,6,0,35,29
1650093139746,MATH 120A,A02,085446,Eggers; John Dietrich,26,0,35,9
1650093145797,MATH 142B,A01,084149,Verstraete; Jacques Allan,0,12,30,30
1650093145797,MATH 142B,A02,084150,Verstraete; Jacques Allan,0,12,30,30
1650093151831,MATH 170A,A01,083459,Nie; Jiawang,0,11,30,30
1650093151831,MATH 170A,A02,083460,Nie; Jiawang,0,10,30,30
1650093151831,MATH 170A,A03,083461,Nie; Jiawang,0,11,30,30
1650093157863,MATH 193B,A01,083463,Staff,1,0,30,29
1650093157863,MATH 193B,A02,083464,Staff,8,0,30,22
1650093157863,MATH 193B,A03,083465,Staff,16,0,30,14
1650093163922,COGS 2,A01,083966,Boyle; Mary E. T.,9,0,30,21
1650093169952,COGS 9,A01,083968,Staff,2,0,60,58
1650093175976,COGS 14B,A01,083970,Staff,7,0,50,43
1650093182004,COGS 17,A01,092679,Staff,49,0,75,26
1650093188027,COGS 100,A01,083972,Staff,0,19,60,60
1650093200092,COGS 101C,A01,083976,Staff,12,0,30,18
1650093206123,COGS 102A,A01,083978,Johnson; Christine M.,9,0,30,21
1650093212146,COGS 107B,A01,083980,Staff,0,9,50,50
1650093218175,COGS 115,A01,083982,Staff,9,0,30,21
1650093224199,COGS 118B,A01,083367,Staff,0,16,40,40
1650093230232,COGS 172,A01,083984,Provenzano; Emily Kara,13,0,30,17
1650093236257,COGS 177,A00,083368,Staff,0,22,30,30
1650093242281,COGS 186,A01,083986,Staff,21,0,40,19
1650093248311,COGS 187A,A01,083988,Boyle; Mary E. T.,15,0,60,45
1650093254336,CSE 8A,A50,084003,Miranda; Gregory Joseph,0,19,15,15
1650093260364,CSE 11,A01,084005,Miranda; Gregory Joseph,0,24,55,55
1650093266395,CSE 20,A01,084007,Staff,0,5,20,20
1650093272432,CSE 21,A01,084009,Staff,0,32,50,50
1650093278462,CSE 30,A01,083370,Cao; Yingjun,0,64,40,40
1650093284486,CSE 100,A01,083372,Cao; Yingjun,0,48,40,40
1650093290511,CSE 101,A01,084011,Staff,0,56,40,40
1650093296536,CSE 141,A01,083374,Eldon; John,0,69,75,75
1650093302577,CSE 141L,A01,083376,Eldon; John,0,75,75,75
1650093308604,CSE 175,A01,084013,Kumar; Rakesh,22,0,25,3
1650093314630,CSE 190,A00,092508,Dubnov; Shlomo,18,0,20,2
1650093320662,ECE 5,A01,084049,Morris; Karcher William,12,0,20,8
1650093326687,ECE 100,A01,084051,Baghdadchi; Saharnaz,0,0,20,20
1650093326687,ECE 100,A02,091916,Baghdadchi; Saharnaz,11,0,20,9
1650093332710,ECE 101,A01,084053,Baghdadchi; Saharnaz,0,0,37,37
1650093332710,ECE 101,A02,084054,Baghdadchi; Saharnaz,27,0,37,10
1650093338734,ECE 107,A01,083390,Staff,26,0,40,14
1650093344758,ECE 148,A01,084056,Silberman; Jack,8,0,12,4
1650093350790,ECE 180,A00,083391,Abi Samra; Nicholas Camill,25,0,30,5
1650093350790,ECE 180,B00,083392,Abi Samra; Nicholas Camill,21,0,30,9
1650093356815,MATH 10B,A01,084110,Staff,0,0,30,30
1650093356815,MATH 10B,A02,084111,Staff,16,0,30,14
1650093356815,MATH 10B,A03,084112,Staff,23,0,30,7
1650093362888,MATH 10C,A01,083443,Staff,0,17,30,31
1650093362888,MATH 10C,A02,083444,Staff,0,18,30,30
1650093362888,MATH 10C,B01,084114,Staff,17,0,30,13
1650093362888,MATH 10C,B02,084115,Staff,24,0,30,6
1650093368913,MATH 18,A01,084117,Harel; Guershon,11,0,30,19
1650093368913,MATH 18,A02,084119,Harel; Guershon,27,0,30,3
1650093368913,MATH 18,A03,084120,Harel; Guershon,30,0,30,0
1650093368913,MATH 18,A04,084121,Harel; Guershon,29,0,30,1
1650093374937,MATH 20B,A01,084124,Um; Ko Woon,10,0,35,25
1650093374937,MATH 20B,B01,084126,Um; Ko Woon,24,0,35,11
1650093380964,MATH 20C,A01,083446,Hammock; Frances H,0,0,30,30
1650093380964,MATH 20C,A02,083447,Hammock; Frances H,13,0,30,17
1650093380964,MATH 20C,A03,083448,Hammock; Frances H,18,0,30,12
1650093380964,MATH 20C,A04,083449,Hammock; Frances H,20,0,30,10
1650093380964,MATH 20C,B01,083451,Hammock; Frances H,0,0,30,30
1650093380964,MATH 20C,B02,083452,Hammock; Frances H,15,0,30,15
1650093380964,MATH 20C,B03,083453,Hammock; Frances H,19,0,30,11
1650093380964,MATH 20C,B04,083454,Hammock; Frances H,23,0,30,7
1650093386993,MATH 20D,A01,084128,Staff,13,0,30,17
1650093386993,MATH 20D,A02,084129,Staff,29,0,30,1
1650093386993,MATH 20D,A03,084130,Staff,28,0,30,2
1650093386993,MATH 20D,B01,084133,Staff,0,0,30,30
1650093386993,MATH 20D,B02,084134,Staff,23,0,30,7
1650093386993,MATH 20D,B03,084135,Staff,28,0,30,2
1650093393031,MATH 20E,A01,084138,Staff,13,0,30,17
1650093393031,MATH 20E,A02,084139,Staff,6,0,30,24
1650093393031,MATH 20E,A03,084140,Staff,14,0,30,16
1650093393031,MATH 20E,A04,084141,Staff,19,0,30,11
1650093399055,MATH 102,A01,084143,Harel; Guershon,11,0,30,19
1650093399055,MATH 102,A02,084144,Harel; Guershon,18,0,30,12
1650093405083,MATH 103B,A01,083456,Staff,0,13,30,30
1650093405083,MATH 103B,A02,083457,Staff,0,14,30,30
1650093411108,MATH 109,A01,084146,Salehi Golsefidy; Alireza,16,0,30,14
1650093411108,MATH 109,A02,084147,Salehi Golsefidy; Alireza,15,0,30,15
1650093417132,MATH 120A,A01,085445,Eggers; John Dietrich,6,0,35,29
1650093417132,MATH 120A,A02,085446,Eggers; John Dietrich,26,0,35,9
1650093423161,MATH 142B,A01,084149,Verstraete; Jacques Allan,0,12,30,30
1650093423161,MATH 142B,A02,084150,Verstraete; Jacques Allan,0,12,30,30
1650093429189,MATH 170A,A01,083459,Nie; Jiawang,0,11,30,30
1650093429189,MATH 170A,A02,083460,Nie; Jiawang,0,10,30,30
1650093429189,MATH 170A,A03,083461,Nie; Jiawang,0,11,30,30
1650093435214,MATH 193B,A01,083463,Staff,1,0,30,29
1650093435214,MATH 193B,A02,083464,Staff,8,0,30,22
1650093435214,MATH 193B,A03,083465,Staff,16,0,30,14
1650093441272,COGS 2,A01,083966,Boyle; Mary E. T.,9,0,30,21
1650093447303,COGS 9,A01,083968,Staff,2,0,60,58
1650093453328,COGS 14B,A01,083970,Staff,7,0,50,43
1650093459352,COGS 17,A01,092679,Staff,49,0,75,26
1650093465377,COGS 100,A01,083972,Staff,0,19,60,60
1650093477426,COGS 101C,A01,083976,Staff,12,0,30,18
1650093483456,COGS 102A,A01,083978,Johnson; Christine M.,9,0,30,21
1650093489484,COGS 107B,A01,083980,Staff,0,9,50,50
1650093495508,COGS 115,A01,083982,Staff,9,0,30,21
1650093501533,COGS 118B,A01,083367,Staff,0,16,40,40
1650093507559,COGS 172,A01,083984,Provenzano; Emily Kara,13,0,30,17
1650093513592,COGS 177,A00,083368,Staff,0,22,30,30
1650093519619,COGS 186,A01,083986,Staff,21,0,40,19
1650093525644,COGS 187A,A01,083988,Boyle; Mary E. T.,15,0,60,45
1650093531683,CSE 8A,A50,084003,Miranda; Gregory Joseph,0,19,15,15
1650093537707,CSE 11,A01,084005,Miranda; Gregory Joseph,0,24,55,55
1650093543731,CSE 20,A01,084007,Staff,0,5,20,20
1650093549757,CSE 21,A01,084009,Staff,0,32,50,50
1650093555781,CSE 30,A01,083370,Cao; Yingjun,0,64,40,40
1650093561809,CSE 100,A01,083372,Cao; Yingjun,0,48,40,40
1650093567838,CSE 101,A01,084011,Staff,0,56,40,40
1650093573863,CSE 141,A01,083374,Eldon; John,0,69,75,75
1650093579887,CSE 141L,A01,083376,Eldon; John,0,75,75,75
1650093585911,CSE 175,A01,084013,Kumar; Rakesh,22,0,25,3
1650093591937,CSE 190,A00,092508,Dubnov; Shlomo,18,0,20,2
1650093597961,ECE 5,A01,084049,Morris; Karcher William,12,0,20,8
1650093603985,ECE 100,A01,084051,Baghdadchi; Saharnaz,0,0,20,20
1650093603985,ECE 100,A02,091916,Baghdadchi; Saharnaz,11,0,20,9
1650093610008,ECE 101,A01,084053,Baghdadchi; Saharnaz,0,0,37,37
1650093610008,ECE 101,A02,084054,Baghdadchi; Saharnaz,27,0,37,10
1650093616035,ECE 107,A01,083390,Staff,26,0,40,14
1650093622061,ECE 148,A01,084056,Silberman; Jack,8,0,12,4
1650093628084,ECE 180,A00,083391,Abi Samra; Nicholas Camill,25,0,30,5
1650093628084,ECE 180,B00,083392,Abi Samra; Nicholas Camill,21,0,30,9
1650093634113,MATH 10B,A01,084110,Staff,0,0,30,30
1650093634113,MATH 10B,A02,084111,Staff,16,0,30,14
1650093634113,MATH 10B,A03,084112,Staff,23,0,30,7
1650093640142,MATH 10C,A01,083443,Staff,0,17,30,31
1650093640142,MATH 10C,A02,083444,Staff,0,18,30,30
1650093640142,MATH 10C,B01,084114,Staff,17,0,30,13
1650093640142,MATH 10C,B02,084115,Staff,24,0,30,6
1650093646166,MATH 18,A01,084117,Harel; Guershon,11,0,30,19
1650093646166,MATH 18,A02,084119,Harel; Guershon,27,0,30,3
1650093646166,MATH 18,A03,084120,Harel; Guershon,30,0,30,0
1650093646166,MATH 18,A04,084121,Harel; Guershon,29,0,30,1
1650093652196,MATH 20B,A01,084124,Um; Ko Woon,10,0,35,25
1650093652196,MATH 20B,B01,084126,Um; Ko Woon,24,0,35,11
1650093658221,MATH 20C,A01,083446,Hammock; Frances H,0,0,30,30
1650093658221,MATH 20C,A02,083447,Hammock; Frances H,13,0,30,17
1650093658221,MATH 20C,A03,083448,Hammock; Frances H,18,0,30,12
1650093658221,MATH 20C,A04,083449,Hammock; Frances H,20,0,30,10
1650093658221,MATH 20C,B01,083451,Hammock; Frances H,0,0,30,30
1650093658221,MATH 20C,B02,083452,Hammock; Frances H,15,0,30,15
1650093658221,MATH 20C,B03,083453,Hammock; Frances H,19,0,30,11
1650093658221,MATH 20C,B04,083454,Hammock; Frances H,23,0,30,7
1650093664338,MATH 20D,A01,084128,Staff,13,0,30,17
1650093664338,MATH 20D,A02,084129,Staff,29,0,30,1
1650093664338,MATH 20D,A03,084130,Staff,28,0,30,2
1650093664338,MATH 20D,B01,084133,Staff,0,0,30,30
1650093664338,MATH 20D,B02,084134,Staff,23,0,30,7
1650093664338,MATH 20D,B03,084135,Staff,28,0,30,2
1650093670362,MATH 20E,A01,084138,Staff,13,0,30,17
1650093670362,MATH 20E,A02,084139,Staff,6,0,30,24
1650093670362,MATH 20E,A03,084140,Staff,14,0,30,16
1650093670362,MATH 20E,A04,084141,Staff,19,0,30,11
1650093676386,MATH 102,A01,084143,Harel; Guershon,11,0,30,19
1650093676386,MATH 102,A02,084144,Harel; Guershon,18,0,30,12
1650093682418,MATH 103B,A01,083456,Staff,0,13,30,30
1650093682418,MATH 103B,A02,083457,Staff,0,14,30,30
1650093688443,MATH 109,A01,084146,Salehi Golsefidy; Alireza,16,0,30,14
1650093688443,MATH 109,A02,084147,Salehi Golsefidy; Alireza,15,0,30,15
1650093694472,MATH 120A,A01,085445,Eggers; John Dietrich,6,0,35,29
1650093694472,MATH 120A,A02,085446,Eggers; John Dietrich,26,0,35,9
1650093700504,MATH 142B,A01,084149,Verstraete; Jacques Allan,0,12,30,30
1650093700504,MATH 142B,A02,084150,Verstraete; Jacques Allan,0,12,30,30
1650093706530,MATH 170A,A01,083459,Nie; Jiawang,0,11,30,30
1650093706530,MATH 170A,A02,083460,Nie; Jiawang,0,10,30,30
1650093706530,MATH 170A,A03,083461,Nie; Jiawang,0,11,30,30
1650093712554,MATH 193B,A01,083463,Staff,1,0,30,29
1650093712554,MATH 193B,A02,083464,Staff,8,0,30,22
1650093712554,MATH 193B,A03,083465,Staff,16,0,30,14
1650093718614,COGS 2,A01,083966,Boyle; Mary E. T.,9,0,30,21
1650093724638,COGS 9,A01,083968,Staff,2,0,60,58
1650093730664,COGS 14B,A01,083970,Staff,7,0,50,43
1650093736688,COGS 17,A01,092679,Staff,49,0,75,26
1650093742724,COGS 100,A01,083972,Staff,0,19,60,60
1650093754776,COGS 101C,A01,083976,Staff,12,0,30,18
1650093760802,COGS 102A,A01,083978,Johnson; Christine M.,9,0,30,21
1650093766826,COGS 107B,A01,083980,Staff,0,9,50,50
1650093772853,COGS 115,A01,083982,Staff,9,0,30,21
1650093778877,COGS 118B,A01,083367,Staff,0,16,40,40
1650093784902,COGS 172,A01,083984,Provenzano; Emily Kara,13,0,30,17
1650093790929,COGS 177,A00,083368,Staff,0,22,30,30
1650093796956,COGS 186,A01,083986,Staff,21,0,40,19
1650093802981,COGS 187A,A01,083988,Boyle; Mary E. T.,15,0,60,45
1650093809011,CSE 8A,A50,084003,Miranda; Gregory Joseph,0,19,15,15
1650093815036,CSE 11,A01,084005,Miranda; Gregory Joseph,0,24,55,55
1650093821062,CSE 20,A01,084007,Staff,0,5,20,20
1650093827086,CSE 21,A01,084009,Staff,0,32,50,50
1650093833111,CSE 30,A01,083370,Cao; Yingjun,0,64,40,40
1650093839134,CSE 100,A01,083372,Cao; Yingjun,0,48,40,40
1650093845164,CSE 101,A01,084011,Staff,0,56,40,40
1650093851189,CSE 141,A01,083374,Eldon; John,0,69,75,75
1650093857213,CSE 141L,A01,083376,Eldon; John,0,75,75,75
1650093863240,CSE 175,A01,084013,Kumar; Rakesh,22,0,25,3
1650093869265,CSE 190,A00,092508,Dubnov; Shlomo,18,0,20,2
1650093875299,ECE 5,A01,084049,Morris; Karcher William,12,0,20,8
1650093881328,ECE 100,A01,084051,Baghdadchi; Saharnaz,0,0,20,20
1650093881328,ECE 100,A02,091916,Baghdadchi; Saharnaz,11,0,20,9
1650093887356,ECE 101,A01,084053,Baghdadchi; Saharnaz,0,0,37,37
1650093887356,ECE 101,A02,084054,Baghdadchi; Saharnaz,27,0,37,10
1650093893385,ECE 107,A01,083390,Staff,26,0,40,14
1650093899409,ECE 148,A01,084056,Silberman; Jack,8,0,12,4
1650093905433,ECE 180,A00,083391,Abi Samra; Nicholas Camill,25,0,30,5
1650093905433,ECE 180,B00,083392,Abi Samra; Nicholas Camill,21,0,30,9
1650093911457,MATH 10B,A01,084110,Staff,0,0,30,30
1650093911457,MATH 10B,A02,084111,Staff,16,0,30,14
1650093911457,MATH 10B,A03,084112,Staff,23,0,30,7
1650093917487,MATH 10C,A01,083443,Staff,0,17,30,31
1650093917487,MATH 10C,A02,083444,Staff,0,18,30,30
1650093917487,MATH 10C,B01,084114,Staff,17,0,30,13
1650093917487,MATH 10C,B02,084115,Staff,24,0,30,6
1650093923513,MATH 18,A01,084117,Harel; Guershon,11,0,30,19
1650093923513,MATH 18,A02,084119,Harel; Guershon,27,0,30,3
1650093923513,MATH 18,A03,084120,Harel; Guershon,30,0,30,0
1650093923513,MATH 18,A04,084121,Harel; Guershon,29,0,30,1
1650093929537,MATH 20B,A01,084124,Um; Ko Woon,10,0,35,25
1650093929537,MATH 20B,B01,084126,Um; Ko Woon,24,0,35,11
1650093935562,MATH 20C,A01,083446,Hammock; Frances H,0,0,30,30
1650093935562,MATH 20C,A02,083447,Hammock; Frances H,13,0,30,17
1650093935562,MATH 20C,A03,083448,Hammock; Frances H,18,0,30,12
1650093935562,MATH 20C,A04,083449,Hammock; Frances H,20,0,30,10
1650093935562,MATH 20C,B01,083451,Hammock; Frances H,0,0,30,30
1650093935562,MATH 20C,B02,083452,Hammock; Frances H,15,0,30,15
1650093935562,MATH 20C,B03,083453,Hammock; Frances H,19,0,30,11
1650093935562,MATH 20C,B04,083454,Hammock; Frances H,23,0,30,7
1650093941586,MATH 20D,A01,084128,Staff,13,0,30,17
1650093941586,MATH 20D,A02,084129,Staff,29,0,30,1
1650093941586,MATH 20D,A03,084130,Staff,28,0,30,2
1650093941586,MATH 20D,B01,084133,Staff,0,0,30,30
1650093941586,MATH 20D,B02,084134,Staff,23,0,30,7
1650093941586,MATH 20D,B03,084135,Staff,28,0,30,2
1650093947610,MATH 20E,A01,084138,Staff,13,0,30,17
1650093947610,MATH 20E,A02,084139,Staff,6,0,30,24
1650093947610,MATH 20E,A03,084140,Staff,14,0,30,16
1650093947610,MATH 20E,A04,084141,Staff,19,0,30,11
1650093953639,MATH 102,A01,084143,Harel; Guershon,11,0,30,19
1650093953639,MATH 102,A02,084144,Harel; Guershon,18,0,30,12
1650093959662,MATH 103B,A01,083456,Staff,0,13,30,30
1650093959662,MATH 103B,A02,083457,Staff,0,14,30,30
1650093965686,MATH 109,A01,084146,Salehi Golsefidy; Alireza,16,0,30,14
1650093965686,MATH 109,A02,084147,Salehi Golsefidy; Alireza,15,0,30,15
1650093971710,MATH 120A,A01,085445,Eggers; John Dietrich,6,0,35,29
1650093971710,MATH 120A,A02,085446,Eggers; John Dietrich,26,0,35,9
1650093977737,MATH 142B,A01,084149,Verstraete; Jacques Allan,0,12,30,30
1650093977737,MATH 142B,A02,084150,Verstraete; Jacques Allan,0,12,30,30
1650093983765,MATH 170A,A01,083459,Nie; Jiawang,0,11,30,30
1650093983765,MATH 170A,A02,083460,Nie; Jiawang,0,10,30,30
1650093983765,MATH 170A,A03,083461,Nie; Jiawang,0,11,30,30
1650093989789,MATH 193B,A01,083463,Staff,1,0,30,29
1650093989789,MATH 193B,A02,083464,Staff,8,0,30,22
1650093989789,MATH 193B,A03,083465,Staff,16,0,30,14
1650093995858,COGS 2,A01,083966,Boyle; Mary E. T.,9,0,30,21
1650094001881,COGS 9,A01,083968,Staff,2,0,60,58
1650094007907,COGS 14B,A01,083970,Staff,7,0,50,43
1650094013931,COGS 17,A01,092679,Staff,49,0,75,26
1650094019956,COGS 100,A01,083972,Staff,0,19,60,60
1650094032007,COGS 101C,A01,083976,Staff,12,0,30,18
1650094038029,COGS 102A,A01,083978,Johnson; Christine M.,9,0,30,21
1650094044065,COGS 107B,A01,083980,Staff,0,9,50,50
1650094050088,COGS 115,A01,083982,Staff,9,0,30,21
1650094056114,COGS 118B,A01,083367,Staff,0,16,40,40
1650094062163,COGS 172,A01,083984,Provenzano; Emily Kara,13,0,30,17
1650094068187,COGS 177,A00,083368,Staff,0,22,30,30
1650094074212,COGS 186,A01,083986,Staff,21,0,40,19
1650094080235,COGS 187A,A01,083988,Boyle; Mary E. T.,15,0,60,45
1650094086260,CSE 8A,A50,084003,Miranda; Gregory Joseph,0,19,15,15
1650094092283,CSE 11,A01,084005,Miranda; Gregory Joseph,0,24,55,55
1650094098310,CSE 20,A01,084007,Staff,0,5,20,20
1650094104337,CSE 21,A01,084009,Staff,0,32,50,50
1650094110364,CSE 30,A01,083370,Cao; Yingjun,0,64,40,40
1650094116404,CSE 100,A01,083372,Cao; Yingjun,0,48,40,40
1650094122435,CSE 101,A01,084011,Staff,0,56,40,40
1650094128465,CSE 141,A01,083374,Eldon; John,0,69,75,75
1650094134492,CSE 141L,A01,083376,Eldon; John,0,75,75,75
1650094140520,CSE 175,A01,084013,Kumar; Rakesh,22,0,25,3
1650094146549,CSE 190,A00,092508,Dubnov; Shlomo,18,0,20,2
1650094152577,ECE 5,A01,084049,Morris; Karcher William,12,0,20,8
1650094158605,ECE 100,A01,084051,Baghdadchi; Saharnaz,0,0,20,20
1650094158605,ECE 100,A02,091916,Baghdadchi; Saharnaz,11,0,20,9
1650094164632,ECE 101,A01,084053,Baghdadchi; Saharnaz,0,0,37,37
1650094164632,ECE 101,A02,084054,Baghdadchi; Saharnaz,27,0,37,10
1650094170656,ECE 107,A01,083390,Staff,26,0,40,14
1650094176683,ECE 148,A01,084056,Silberman; Jack,8,0,12,4
1650094182711,ECE 180,A00,083391,Abi Samra; Nicholas Camill,25,0,30,5
1650094182711,ECE 180,B00,083392,Abi Samra; Nicholas Camill,21,0,30,9
1650094188734,MATH 10B,A01,084110,Staff,0,0,30,30
1650094188734,MATH 10B,A02,084111,Staff,16,0,30,14
1650094188734,MATH 10B,A03,084112,Staff,23,0,30,7
1650094194762,MATH 10C,A01,083443,Staff,0,17,30,31
1650094194762,MATH 10C,A02,083444,Staff,0,18,30,30
1650094194762,MATH 10C,B01,084114,Staff,17,0,30,13
1650094194762,MATH 10C,B02,084115,Staff,24,0,30,6
1650094200786,MATH 18,A01,084117,Harel; Guershon,11,0,30,19
1650094200786,MATH 18,A02,084119,Harel; Guershon,27,0,30,3
1650094200786,MATH 18,A03,084120,Harel; Guershon,30,0,30,0
1650094200786,MATH 18,A04,084121,Harel; Guershon,29,0,30,1
1650094206810,MATH 20B,A01,084124,Um; Ko Woon,10,0,35,25
1650094206810,MATH 20B,B01,084126,Um; Ko Woon,24,0,35,11
1650094212835,MATH 20C,A01,083446,Hammock; Frances H,0,0,30,30
1650094212835,MATH 20C,A02,083447,Hammock; Frances H,13,0,30,17
1650094212835,MATH 20C,A03,083448,Hammock; Frances H,18,0,30,12
1650094212835,MATH 20C,A04,083449,Hammock; Frances H,20,0,30,10
1650094212835,MATH 20C,B01,083451,Hammock; Frances H,0,0,30,30
1650094212835,MATH 20C,B02,083452,Hammock; Frances H,15,0,30,15
1650094212835,MATH 20C,B03,083453,Hammock; Frances H,19,0,30,11
1650094212835,MATH 20C,B04,083454,Hammock; Frances H,23,0,30,7
1650094218860,MATH 20D,A01,084128,Staff,13,0,30,17
1650094218860,MATH 20D,A02,084129,Staff,29,0,30,1
1650094218860,MATH 20D,A03,084130,Staff,28,0,30,2
1650094218860,MATH 20D,B01,084133,Staff,0,0,30,30
1650094218860,MATH 20D,B02,084134,Staff,23,0,30,7
1650094218860,MATH 20D,B03,084135,Staff,28,0,30,2
1650094224884,MATH 20E,A01,084138,Staff,13,0,30,17
1650094224884,MATH 20E,A02,084139,Staff,6,0,30,24
1650094224884,MATH 20E,A03,084140,Staff,14,0,30,16
1650094224884,MATH 20E,A04,084141,Staff,19,0,30,11
1650094230922,MATH 102,A01,084143,Harel; Guershon,11,0,30,19
1650094230922,MATH 102,A02,084144,Harel; Guershon,18,0,30,12
1650094236946,MATH 103B,A01,083456,Staff,0,13,30,30
1650094236946,MATH 103B,A02,083457,Staff,0,14,30,30
1650094242978,MATH 109,A01,084146,Salehi Golsefidy; Alireza,16,0,30,14
1650094242978,MATH 109,A02,084147,Salehi Golsefidy; Alireza,15,0,30,15
1650094249003,MATH 120A,A01,085445,Eggers; John Dietrich,6,0,35,29
1650094249003,MATH 120A,A02,085446,Eggers; John Dietrich,26,0,35,9
1650094255041,MATH 142B,A01,084149,Verstraete; Jacques Allan,0,12,30,30
1650094255041,MATH 142B,A02,084150,Verstraete; Jacques Allan,0,12,30,30
1650094261158,MATH 170A,A01,083459,Nie; Jiawang,0,11,30,30
1650094261158,MATH 170A,A02,083460,Nie; Jiawang,0,10,30,30
1650094261158,MATH 170A,A03,083461,Nie; Jiawang,0,11,30,30
1650094267186,MATH 193B,A01,083463,Staff,1,0,30,29
1650094267186,MATH 193B,A02,083464,Staff,8,0,30,22
1650094267186,MATH 193B,A03,083465,Staff,16,0,30,14
1650094273282,COGS 2,A01,083966,Boyle; Mary E. T.,9,0,30,21
1650094279307,COGS 9,A01,083968,Staff,2,0,60,58
1650094285333,COGS 14B,A01,083970,Staff,7,0,50,43
1650094291355,COGS 17,A01,092679,Staff,49,0,75,26
1650094297379,COGS 100,A01,083972,Staff,0,19,60,60
1650094309428,COGS 101C,A01,083976,Staff,12,0,30,18
1650094315461,COGS 102A,A01,083978,Johnson; Christine M.,9,0,30,21
1650094321487,COGS 107B,A01,083980,Staff,0,9,50,50
1650094327515,COGS 115,A01,083982,Staff,9,0,30,21
1650094333542,COGS 118B,A01,083367,Staff,0,16,40,40
1650094339567,COGS 172,A01,083984,Provenzano; Emily Kara,13,0,30,17
1650094345594,COGS 177,A00,083368,Staff,0,22,30,30
1650094351617,COGS 186,A01,083986,Staff,21,0,40,19
1650094357642,COGS 187A,A01,083988,Boyle; Mary E. T.,15,0,60,45
1650094363668,CSE 8A,A50,084003,Miranda; Gregory Joseph,0,19,15,15
1650094369692,CSE 11,A01,084005,Miranda; Gregory Joseph,0,24,55,55
1650094375717,CSE 20,A01,084007,Staff,0,5,20,20
1650094381742,CSE 21,A01,084009,Staff,0,32,50,50
1650094387766,CSE 30,A01,083370,Cao; Yingjun,0,64,40,40
1650094393791,CSE 100,A01,083372,Cao; Yingjun,0,48,40,40
1650094399821,CSE 101,A01,084011,Staff,0,56,40,40
1650094405860,CSE 141,A01,083374,Eldon; John,0,69,75,75
1650094411891,CSE 141L,A01,083376,Eldon; John,0,75,75,75
1650094417924,CSE 175,A01,084013,Kumar; Rakesh,22,0,25,3
1650094423952,CSE 190,A00,092508,Dubnov; Shlomo,18,0,20,2
1650094429994,ECE 5,A01,084049,Morris; Karcher William,12,0,20,8
1650094436021,ECE 100,A01,084051,Baghdadchi; Saharnaz,0,0,20,20
1650094436021,ECE 100,A02,091916,Baghdadchi; Saharnaz,11,0,20,9
1650094442048,ECE 101,A01,084053,Baghdadchi; Saharnaz,0,0,37,37
1650094442048,ECE 101,A02,084054,Baghdadchi; Saharnaz,27,0,37,10
1650094448075,ECE 107,A01,083390,Staff,26,0,40,14
1650094454104,ECE 148,A01,084056,Silberman; Jack,8,0,12,4
1650094460132,ECE 180,A00,083391,Abi Samra; Nicholas Camill,25,0,30,5
1650094460132,ECE 180,B00,083392,Abi Samra; Nicholas Camill,21,0,30,9
1650094466158,MATH 10B,A01,084110,Staff,0,0,30,30
1650094466158,MATH 10B,A02,084111,Staff,16,0,30,14
1650094466158,MATH 10B,A03,084112,Staff,23,0,30,7
1650094472184,MATH 10C,A01,083443,Staff,0,17,30,31
1650094472184,MATH 10C,A02,083444,Staff,0,18,30,30
1650094472184,MATH 10C,B01,084114,Staff,17,0,30,13
1650094472184,MATH 10C,B02,084115,Staff,24,0,30,6
1650094478213,MATH 18,A01,084117,Harel; Guershon,11,0,30,19
1650094478213,MATH 18,A02,084119,Harel; Guershon,27,0,30,3
1650094478213,MATH 18,A03,084120,Harel; Guershon,30,0,30,0
1650094478213,MATH 18,A04,084121,Harel; Guershon,29,0,30,1
1650094484238,MATH 20B,A01,084124,Um; Ko Woon,10,0,35,25
1650094484238,MATH 20B,B01,084126,Um; Ko Woon,24,0,35,11
1650094490267,MATH 20C,A01,083446,Hammock; Frances H,0,0,30,30
1650094490267,MATH 20C,A02,083447,Hammock; Frances H,13,0,30,17
1650094490267,MATH 20C,A03,083448,Hammock; Frances H,18,0,30,12
1650094490267,MATH 20C,A04,083449,Hammock; Frances H,20,0,30,10
1650094490267,MATH 20C,B01,083451,Hammock; Frances H,0,0,30,30
1650094490267,MATH 20C,B02,083452,Hammock; Frances H,15,0,30,15
1650094490267,MATH 20C,B03,083453,Hammock; Frances H,19,0,30,11
1650094490267,MATH 20C,B04,083454,Hammock; Frances H,23,0,30,7
1650094496293,MATH 20D,A01,084128,Staff,13,0,30,17
1650094496293,MATH 20D,A02,084129,Staff,29,0,30,1
1650094496293,MATH 20D,A03,084130,Staff,28,0,30,2
1650094496293,MATH 20D,B01,084133,Staff,0,0,30,30
1650094496293,MATH 20D,B02,084134,Staff,23,0,30,7
1650094496293,MATH 20D,B03,084135,Staff,28,0,30,2
1650094502317,MATH 20E,A01,084138,Staff,13,0,30,17
1650094502317,MATH 20E,A02,084139,Staff,6,0,30,24
1650094502317,MATH 20E,A03,084140,Staff,14,0,30,16
1650094502317,MATH 20E,A04,084141,Staff,19,0,30,11
1650094508342,MATH 102,A01,084143,Harel; Guershon,11,0,30,19
1650094508342,MATH 102,A02,084144,Harel; Guershon,18,0,30,12
1650094514366,MATH 103B,A01,083456,Staff,0,13,30,30
1650094514366,MATH 103B,A02,083457,Staff,0,14,30,30
1650094520396,MATH 109,A01,084146,Salehi Golsefidy; Alireza,16,0,30,14
1650094520396,MATH 109,A02,084147,Salehi Golsefidy; Alireza,15,0,30,15
1650094526423,MATH 120A,A01,085445,Eggers; John Dietrich,6,0,35,29
1650094526423,MATH 120A,A02,085446,Eggers; John Dietrich,26,0,35,9
1650094532450,MATH 142B,A01,084149,Verstraete; Jacques Allan,0,12,30,30
1650094532450,MATH 142B,A02,084150,Verstraete; Jacques Allan,0,12,30,30
1650094538487,MATH 170A,A01,083459,Nie; Jiawang,0,11,30,30
1650094538487,MATH 170A,A02,083460,Nie; Jiawang,0,10,30,30
1650094538487,MATH 170A,A03,083461,Nie; Jiawang,0,11,30,30
1650094544516,MATH 193B,A01,083463,Staff,1,0,30,29
1650094544516,MATH 193B,A02,083464,Staff,8,0,30,22
1650094544516,MATH 193B,A03,083465,Staff,16,0,30,14
1650094550608,COGS 2,A01,083966,Boyle; Mary E. T.,9,0,30,21
1650094556634,COGS 9,A01,083968,Staff,2,0,60,58
1650094562664,COGS 14B,A01,083970,Staff,7,0,50,43
1650094568689,COGS 17,A01,092679,Staff,49,0,75,26
1650094574713,COGS 100,A01,083972,Staff,0,19,60,60
1650094586760,COGS 101C,A01,083976,Staff,12,0,30,18
1650094592785,COGS 102A,A01,083978,Johnson; Christine M.,9,0,30,21
1650094598814,COGS 107B,A01,083980,Staff,0,9,50,50
1650094604838,COGS 115,A01,083982,Staff,9,0,30,21
1650094610862,COGS 118B,A01,083367,Staff,0,16,40,40
1650094616887,COGS 172,A01,083984,Provenzano; Emily Kara,13,0,30,17
1650094622917,COGS 177,A00,083368,Staff,0,22,30,30
1650094628942,COGS 186,A01,083986,Staff,21,0,40,19
1650094634970,COGS 187A,A01,083988,Boyle; Mary E. T.,15,0,60,45
1650094640995,CSE 8A,A50,084003,Miranda; Gregory Joseph,0,19,15,15
1650094647020,CSE 11,A01,084005,Miranda; Gregory Joseph,0,24,55,55
1650094653047,CSE 20,A01,084007,Staff,0,5,20,20
1650094659070,CSE 21,A01,084009,Staff,0,32,50,50
1650094665099,CSE 30,A01,083370,Cao; Yingjun,0,64,40,40
1650094671124,CSE 100,A01,083372,Cao; Yingjun,0,48,40,40
1650094677148,CSE 101,A01,084011,Staff,0,56,40,40
1650094683171,CSE 141,A01,083374,Eldon; John,0,69,75,75
1650094689198,CSE 141L,A01,083376,Eldon; John,0,75,75,75
1650094695223,CSE 175,A01,084013,Kumar; Rakesh,22,0,25,3
1650094701247,CSE 190,A00,092508,Dubnov; Shlomo,18,0,20,2
1650094707272,ECE 5,A01,084049,Morris; Karcher William,12,0,20,8
1650094713299,ECE 100,A01,084051,Baghdadchi; Saharnaz,0,0,20,20
1650094713299,ECE 100,A02,091916,Baghdadchi; Saharnaz,11,0,20,9
1650094719324,ECE 101,A01,084053,Baghdadchi; Saharnaz,0,0,37,37
1650094719324,ECE 101,A02,084054,Baghdadchi; Saharnaz,27,0,37,10
1650094725353,ECE 107,A01,083390,Staff,26,0,40,14
1650094731391,ECE 148,A01,084056,Silberman; Jack,8,0,12,4
1650094737420,ECE 180,A00,083391,Abi Samra; Nicholas Camill,25,0,30,5
1650094737420,ECE 180,B00,083392,Abi Samra; Nicholas Camill,21,0,30,9
1650094743457,MATH 10B,A01,084110,Staff,0,0,30,30
1650094743457,MATH 10B,A02,084111,Staff,16,0,30,14
1650094743457,MATH 10B,A03,084112,Staff,23,0,30,7
1650094749488,MATH 10C,A01,083443,Staff,0,17,30,31
1650094749488,MATH 10C,A02,083444,Staff,0,18,30,30
1650094749488,MATH 10C,B01,084114,Staff,17,0,30,13
1650094749488,MATH 10C,B02,084115,Staff,24,0,30,6
1650094755520,MATH 18,A01,084117,Harel; Guershon,11,0,30,19
1650094755520,MATH 18,A02,084119,Harel; Guershon,27,0,30,3
1650094755520,MATH 18,A03,084120,Harel; Guershon,30,0,30,0
1650094755520,MATH 18,A04,084121,Harel; Guershon,29,0,30,1
1650094761553,MATH 20B,A01,084124,Um; Ko Woon,10,0,35,25
1650094761553,MATH 20B,B01,084126,Um; Ko Woon,24,0,35,11
1650094767580,MATH 20C,A01,083446,Hammock; Frances H,0,0,30,30
1650094767580,MATH 20C,A02,083447,Hammock; Frances H,13,0,30,17
1650094767580,MATH 20C,A03,083448,Hammock; Frances H,18,0,30,12
1650094767580,MATH 20C,A04,083449,Hammock; Frances H,20,0,30,10
1650094767580,MATH 20C,B01,083451,Hammock; Frances H,0,0,30,30
1650094767580,MATH 20C,B02,083452,Hammock; Frances H,15,0,30,15
1650094767580,MATH 20C,B03,083453,Hammock; Frances H,19,0,30,11
1650094767580,MATH 20C,B04,083454,Hammock; Frances H,23,0,30,7
1650094773613,MATH 20D,A01,084128,Staff,13,0,30,17
1650094773613,MATH 20D,A02,084129,Staff,29,0,30,1
1650094773613,MATH 20D,A03,084130,Staff,28,0,30,2
1650094773613,MATH 20D,B01,084133,Staff,0,0,30,30
1650094773613,MATH 20D,B02,084134,Staff,23,0,30,7
1650094773613,MATH 20D,B03,084135,Staff,28,0,30,2
1650094779643,MATH 20E,A01,084138,Staff,13,0,30,17
1650094779643,MATH 20E,A02,084139,Staff,6,0,30,24
1650094779643,MATH 20E,A03,084140,Staff,14,0,30,16
1650094779643,MATH 20E,A04,084141,Staff,19,0,30,11
1650094785667,MATH 102,A01,084143,Harel; Guershon,11,0,30,19
1650094785667,MATH 102,A02,084144,Harel; Guershon,18,0,30,12
1650094791692,MATH 103B,A01,083456,Staff,0,13,30,30
1650094791692,MATH 103B,A02,083457,Staff,0,14,30,30
1650094797718,MATH 109,A01,084146,Salehi Golsefidy; Alireza,16,0,30,14
1650094797718,MATH 109,A02,084147,Salehi Golsefidy; Alireza,15,0,30,15
1650094803744,MATH 120A,A01,085445,Eggers; John Dietrich,6,0,35,29
1650094803744,MATH 120A,A02,085446,Eggers; John Dietrich,26,0,35,9
1650094809777,MATH 142B,A01,084149,Verstraete; Jacques Allan,0,12,30,30
1650094809777,MATH 142B,A02,084150,Verstraete; Jacques Allan,0,12,30,30
1650094815804,MATH 170A,A01,083459,Nie; Jiawang,0,11,30,30
1650094815804,MATH 170A,A02,083460,Nie; Jiawang,0,10,30,30
1650094815804,MATH 170A,A03,083461,Nie; Jiawang,0,11,30,30
1650094821834,MATH 193B,A01,083463,Staff,1,0,30,29
1650094821834,MATH 193B,A02,083464,Staff,8,0,30,22
1650094821834,MATH 193B,A03,083465,Staff,16,0,30,14
1650094827945,COGS 2,A01,083966,Boyle; Mary E. T.,9,0,30,21
1650094833971,COGS 9,A01,083968,Staff,2,0,60,58
1650094840030,COGS 14B,A01,083970,Staff,7,0,50,43
1650094846071,COGS 17,A01,092679,Staff,49,0,75,26
1650094852197,COGS 100,A01,083972,Staff,0,19,60,60
1650094864253,COGS 101C,A01,083976,Staff,12,0,30,18
1650094870282,COGS 102A,A01,083978,Johnson; Christine M.,9,0,30,21
1650094876309,COGS 107B,A01,083980,Staff,0,9,50,50
1650094882338,COGS 115,A01,083982,Staff,9,0,30,21
1650094888364,COGS 118B,A01,083367,Staff,0,16,40,40
1650094894388,COGS 172,A01,083984,Provenzano; Emily Kara,13,0,30,17
1650094900416,COGS 177,A00,083368,Staff,0,22,30,30
1650094906448,COGS 186,A01,083986,Staff,21,0,40,19
1650094912473,COGS 187A,A01,083988,Boyle; Mary E. T.,15,0,60,45
1650094918499,CSE 8A,A50,084003,Miranda; Gregory Joseph,0,19,15,15
1650094924528,CSE 11,A01,084005,Miranda; Gregory Joseph,0,24,55,55
1650094930552,CSE 20,A01,084007,Staff,0,5,20,20
1650094936578,CSE 21,A01,084009,Staff,0,32,50,50
1650094942602,CSE 30,A01,083370,Cao; Yingjun,0,64,40,40
1650094948629,CSE 100,A01,083372,Cao; Yingjun,0,48,40,40
1650094954652,CSE 101,A01,084011,Staff,0,56,40,40
1650094960689,CSE 141,A01,083374,Eldon; John,0,69,75,75
1650094966717,CSE 141L,A01,083376,Eldon; John,0,75,75,75
1650094972750,CSE 175,A01,084013,Kumar; Rakesh,22,0,25,3
1650094978777,CSE 190,A00,092508,Dubnov; Shlomo,18,0,20,2
1650094984809,ECE 5,A01,084049,Morris; Karcher William,12,0,20,8
1650094990841,ECE 100,A01,084051,Baghdadchi; Saharnaz,0,0,20,20
1650094990841,ECE 100,A02,091916,Baghdadchi; Saharnaz,11,0,20,9
1650094996872,ECE 101,A01,084053,Baghdadchi; Saharnaz,0,0,37,37
1650094996872,ECE 101,A02,084054,Baghdadchi; Saharnaz,27,0,37,10
1650095002898,ECE 107,A01,083390,Staff,26,0,40,14
1650095008929,ECE 148,A01,084056,Silberman; Jack,8,0,12,4
1650095014954,ECE 180,A00,083391,Abi Samra; Nicholas Camill,25,0,30,5
1650095014954,ECE 180,B00,083392,Abi Samra; Nicholas Camill,21,0,30,9
1650095020981,MATH 10B,A01,084110,Staff,0,0,30,30
1650095020981,MATH 10B,A02,084111,Staff,16,0,30,14
1650095020981,MATH 10B,A03,084112,Staff,23,0,30,7
1650095027006,MATH 10C,A01,083443,Staff,0,17,30,31
1650095027006,MATH 10C,A02,083444,Staff,0,18,30,30
1650095027006,MATH 10C,B01,084114,Staff,17,0,30,13
1650095027006,MATH 10C,B02,084115,Staff,24,0,30,6
1650095033037,MATH 18,A01,084117,Harel; Guershon,11,0,30,19
1650095033037,MATH 18,A02,084119,Harel; Guershon,27,0,30,3
1650095033037,MATH 18,A03,084120,Harel; Guershon,30,0,30,0
1650095033037,MATH 18,A04,084121,Harel; Guershon,29,0,30,1
1650095039068,MATH 20B,A01,084124,Um; Ko Woon,10,0,35,25
1650095039068,MATH 20B,B01,084126,Um; Ko Woon,24,0,35,11
1650095045096,MATH 20C,A01,083446,Hammock; Frances H,0,0,30,30
1650095045096,MATH 20C,A02,083447,Hammock; Frances H,13,0,30,17
1650095045096,MATH 20C,A03,083448,Hammock; Frances H,18,0,30,12
1650095045096,MATH 20C,A04,083449,Hammock; Frances H,20,0,30,10
1650095045096,MATH 20C,B01,083451,Hammock; Frances H,0,0,30,30
1650095045096,MATH 20C,B02,083452,Hammock; Frances H,15,0,30,15
1650095045096,MATH 20C,B03,083453,Hammock; Frances H,19,0,30,11
1650095045096,MATH 20C,B04,083454,Hammock; Frances H,23,0,30,7
1650095051122,MATH 20D,A01,084128,Staff,13,0,30,17
1650095051122,MATH 20D,A02,084129,Staff,29,0,30,1
1650095051122,MATH 20D,A03,084130,Staff,28,0,30,2
1650095051122,MATH 20D,B01,084133,Staff,0,0,30,30
1650095051122,MATH 20D,B02,084134,Staff,23,0,30,7
1650095051122,MATH 20D,B03,084135,Staff,28,0,30,2
1650095057152,MATH 20E,A01,084138,Staff,13,0,30,17
1650095057152,MATH 20E,A02,084139,Staff,6,0,30,24
1650095057152,MATH 20E,A03,084140,Staff,14,0,30,16
1650095057152,MATH 20E,A04,084141,Staff,19,0,30,11
1650095063178,MATH 102,A01,084143,Harel; Guershon,11,0,30,19
1650095063178,MATH 102,A02,084144,Harel; Guershon,18,0,30,12
1650095069201,MATH 103B,A01,083456,Staff,0,13,30,30
1650095069201,MATH 103B,A02,083457,Staff,0,14,30,30
1650095075232,MATH 109,A01,084146,Salehi Golsefidy; Alireza,16,0,30,14
1650095075232,MATH 109,A02,084147,Salehi Golsefidy; Alireza,15,0,30,15
1650095081264,MATH 120A,A01,085445,Eggers; John Dietrich,6,0,35,29
1650095081264,MATH 120A,A02,085446,Eggers; John Dietrich,26,0,35,9
1650095087293,MATH 142B,A01,084149,Verstraete; Jacques Allan,0,12,30,30
1650095087293,MATH 142B,A02,084150,Verstraete; Jacques Allan,0,12,30,30
1650095093321,MATH 170A,A01,083459,Nie; Jiawang,0,11,30,30
1650095093321,MATH 170A,A02,083460,Nie; Jiawang,0,10,30,30
1650095093321,MATH 170A,A03,083461,Nie; Jiawang,0,11,30,30
1650095099346,MATH 193B,A01,083463,Staff,1,0,30,29
1650095099346,MATH 193B,A02,083464,Staff,8,0,30,22
1650095099346,MATH 193B,A03,083465,Staff,16,0,30,14
1650095105417,COGS 2,A01,083966,Boyle; Mary E. T.,9,0,30,21
1650095111446,COGS 9,A01,083968,Staff,2,0,60,58
1650095117471,COGS 14B,A01,083970,Staff,7,0,50,43
1650095123496,COGS 17,A01,092679,Staff,49,0,75,26
1650095129524,COGS 100,A01,083972,Staff,0,19,60,60
1650095141581,COGS 101C,A01,083976,Staff,12,0,30,18
1650095147607,COGS 102A,A01,083978,Johnson; Christine M.,9,0,30,21
1650095153635,COGS 107B,A01,083980,Staff,0,9,50,50
1650095159660,COGS 115,A01,083982,Staff,9,0,30,21
1650095165688,COGS 118B,A01,083367,Staff,0,16,40,40
1650095171718,COGS 172,A01,083984,Provenzano; Emily Kara,13,0,30,17
1650095177742,COGS 177,A00,083368,Staff,0,22,30,30
1650095183771,COGS 186,A01,083986,Staff,21,0,40,19
1650095189795,COGS 187A,A01,083988,Boyle; Mary E. T.,15,0,60,45
1650095195838,CSE 8A,A50,084003,Miranda; Gregory Joseph,0,19,15,15
1650095201864,CSE 11,A01,084005,Miranda; Gregory Joseph,0,24,55,55
1650095207900,CSE 20,A01,084007,Staff,0,5,20,20
1650095213932,CSE 21,A01,084009,Staff,0,32,50,50
1650095219963,CSE 30,A01,083370,Cao; Yingjun,0,64,40,40
1650095225993,CSE 100,A01,083372,Cao; Yingjun,0,48,40,40
1650095232019,CSE 101,A01,084011,Staff,0,56,40,40
1650095238046,CSE 141,A01,083374,Eldon; John,0,69,75,75
1650095244072,CSE 141L,A01,083376,Eldon; John,0,75,75,75
1650095250102,CSE 175,A01,084013,Kumar; Rakesh,22,0,25,3
1650095256133,CSE 190,A00,092508,Dubnov; Shlomo,18,0,20,2
1650095262171,ECE 5,A01,084049,Morris; Karcher William,12,0,20,8
1650095268197,ECE 100,A01,084051,Baghdadchi; Saharnaz,0,0,20,20
1650095268197,ECE 100,A02,091916,Baghdadchi; Saharnaz,11,0,20,9
1650095274228,ECE 101,A01,084053,Baghdadchi; Saharnaz,0,0,37,37
1650095274228,ECE 101,A02,084054,Baghdadchi; Saharnaz,27,0,37,10
1650095280257,ECE 107,A01,083390,Staff,26,0,40,14
1650095286282,ECE 148,A01,084056,Silberman; Jack,8,0,12,4
1650095292306,ECE 180,A00,083391,Abi Samra; Nicholas Camill,25,0,30,5
1650095292306,ECE 180,B00,083392,Abi Samra; Nicholas Camill,21,0,30,9
1650095298337,MATH 10B,A01,084110,Staff,0,0,30,30
1650095298337,MATH 10B,A02,084111,Staff,16,0,30,14
1650095298337,MATH 10B,A03,084112,Staff,23,0,30,7
1650095304370,MATH 10C,A01,083443,Staff,0,17,30,31
1650095304370,MATH 10C,A02,083444,Staff,0,18,30,30
1650095304370,MATH 10C,B01,084114,Staff,17,0,30,13
1650095304370,MATH 10C,B02,084115,Staff,24,0,30,6
1650095310401,MATH 18,A01,084117,Harel; Guershon,11,0,30,19
1650095310401,MATH 18,A02,084119,Harel; Guershon,27,0,30,3
1650095310401,MATH 18,A03,084120,Harel; Guershon,30,0,30,0
1650095310401,MATH 18,A04,084121,Harel; Guershon,29,0,30,1
1650095316427,MATH 20B,A01,084124,Um; Ko Woon,10,0,35,25
1650095316427,MATH 20B,B01,084126,Um; Ko Woon,24,0,35,11
1650095322458,MATH 20C,A01,083446,Hammock; Frances H,0,0,30,30
1650095322458,MATH 20C,A02,083447,Hammock; Frances H,13,0,30,17
1650095322458,MATH 20C,A03,083448,Hammock; Frances H,18,0,30,12
1650095322458,MATH 20C,A04,083449,Hammock; Frances H,20,0,30,10
1650095322458,MATH 20C,B01,083451,Hammock; Frances H,0,0,30,30
1650095322458,MATH 20C,B02,083452,Hammock; Frances H,15,0,30,15
1650095322458,MATH 20C,B03,083453,Hammock; Frances H,19,0,30,11
1650095322458,MATH 20C,B04,083454,Hammock; Frances H,23,0,30,7
1650095328489,MATH 20D,A01,084128,Staff,13,0,30,17
1650095328489,MATH 20D,A02,084129,Staff,29,0,30,1
1650095328489,MATH 20D,A03,084130,Staff,28,0,30,2
1650095328489,MATH 20D,B01,084133,Staff,0,0,30,30
1650095328489,MATH 20D,B02,084134,Staff,23,0,30,7
1650095328489,MATH 20D,B03,084135,Staff,28,0,30,2
1650095334520,MATH 20E,A01,084138,Staff,13,0,30,17
1650095334520,MATH 20E,A02,084139,Staff,6,0,30,24
1650095334520,MATH 20E,A03,084140,Staff,14,0,30,16
1650095334520,MATH 20E,A04,084141,Staff,19,0,30,11
1650095340549,MATH 102,A01,084143,Harel; Guershon,11,0,30,19
1650095340549,MATH 102,A02,084144,Harel; Guershon,18,0,30,12
1650095346573,MATH 103B,A01,083456,Staff,0,13,30,30
1650095346573,MATH 103B,A02,083457,Staff,0,14,30,30
1650095352600,MATH 109,A01,084146,Salehi Golsefidy; Alireza,16,0,30,14
1650095352600,MATH 109,A02,084147,Salehi Golsefidy; Alireza,15,0,30,15
1650095358630,MATH 120A,A01,085445,Eggers; John Dietrich,6,0,35,29
1650095358630,MATH 120A,A02,085446,Eggers; John Dietrich,26,0,35,9
1650095364659,MATH 142B,A01,084149,Verstraete; Jacques Allan,0,12,30,30
1650095364659,MATH 142B,A02,084150,Verstraete; Jacques Allan,0,12,30,30
1650095370690,MATH 170A,A01,083459,Nie; Jiawang,0,11,30,30
1650095370690,MATH 170A,A02,083460,Nie; Jiawang,0,10,30,30
1650095370690,MATH 170A,A03,083461,Nie; Jiawang,0,11,30,30
1650095376719,MATH 193B,A01,083463,Staff,1,0,30,29
1650095376719,MATH 193B,A02,083464,Staff,8,0,30,22
1650095376719,MATH 193B,A03,083465,Staff,16,0,30,14
1650095382809,COGS 2,A01,083966,Boyle; Mary E. T.,9,0,30,21
1650095388832,COGS 9,A01,083968,Staff,2,0,60,58
1650095394859,COGS 14B,A01,083970,Staff,7,0,50,43
1650095400884,COGS 17,A01,092679,Staff,49,0,75,26
1650095406908,COGS 100,A01,083972,Staff,0,19,60,60
1650095418962,COGS 101C,A01,083976,Staff,12,0,30,18
1650095424986,COGS 102A,A01,083978,Johnson; Christine M.,9,0,30,21
1650095431010,COGS 107B,A01,083980,Staff,0,9,50,50
1650095437040,COGS 115,A01,083982,Staff,9,0,30,21
1650095443065,COGS 118B,A01,083367,Staff,0,16,40,40
1650095449180,COGS 172,A01,083984,Provenzano; Emily Kara,13,0,30,17
1650095455205,COGS 177,A00,083368,Staff,0,22,30,30
1650095461234,COGS 186,A01,083986,Staff,21,0,40,19
1650095467262,COGS 187A,A01,083988,Boyle; Mary E. T.,15,0,60,45
1650095473289,CSE 8A,A50,084003,Miranda; Gregory Joseph,0,19,15,15
1650095479320,CSE 11,A01,084005,Miranda; Gregory Joseph,0,24,55,55
1650095485352,CSE 20,A01,084007,Staff,0,5,20,20
1650095491377,CSE 21,A01,084009,Staff,0,32,50,50
1650095497408,CSE 30,A01,083370,Cao; Yingjun,0,64,40,40
1650095503437,CSE 100,A01,083372,Cao; Yingjun,0,48,40,40
1650095509468,CSE 101,A01,084011,Staff,0,56,40,40
1650095515493,CSE 141,A01,083374,Eldon; John,0,69,75,75
1650095521525,CSE 141L,A01,083376,Eldon; John,0,75,75,75
1650095527554,CSE 175,A01,084013,Kumar; Rakesh,22,0,25,3
1650095533585,CSE 190,A00,092508,Dubnov; Shlomo,18,0,20,2
1650095539611,ECE 5,A01,084049,Morris; Karcher William,12,0,20,8
1650095545663,ECE 100,A01,084051,Baghdadchi; Saharnaz,0,0,20,20
1650095545663,ECE 100,A02,091916,Baghdadchi; Saharnaz,11,0,20,9
1650095551689,ECE 101,A01,084053,Baghdadchi; Saharnaz,0,0,37,37
1650095551689,ECE 101,A02,084054,Baghdadchi; Saharnaz,27,0,37,10
1650095557721,ECE 107,A01,083390,Staff,26,0,40,14
1650095563746,ECE 148,A01,084056,Silberman; Jack,8,0,12,4
1650095569779,ECE 180,A00,083391,Abi Samra; Nicholas Camill,25,0,30,5
1650095569779,ECE 180,B00,083392,Abi Samra; Nicholas Camill,21,0,30,9
1650095575815,MATH 10B,A01,084110,Staff,0,0,30,30
1650095575815,MATH 10B,A02,084111,Staff,16,0,30,14
1650095575815,MATH 10B,A03,084112,Staff,23,0,30,7
1650095581844,MATH 10C,A01,083443,Staff,0,17,30,31
1650095581844,MATH 10C,A02,083444,Staff,0,18,30,30
1650095581844,MATH 10C,B01,084114,Staff,17,0,30,13
1650095581844,MATH 10C,B02,084115,Staff,24,0,30,6
1650095587870,MATH 18,A01,084117,Harel; Guershon,11,0,30,19
1650095587870,MATH 18,A02,084119,Harel; Guershon,27,0,30,3
1650095587870,MATH 18,A03,084120,Harel; Guershon,30,0,30,0
1650095587870,MATH 18,A04,084121,Harel; Guershon,29,0,30,1
1650095593902,MATH 20B,A01,084124,Um; Ko Woon,10,0,35,25
1650095593902,MATH 20B,B01,084126,Um; Ko Woon,24,0,35,11
1650095599935,MATH 20C,A01,083446,Hammock; Frances H,0,0,30,30
1650095599935,MATH 20C,A02,083447,Hammock; Frances H,13,0,30,17
1650095599935,MATH 20C,A03,083448,Hammock; Frances H,18,0,30,12
1650095599935,MATH 20C,A04,083449,Hammock; Frances H,20,0,30,10
1650095599935,MATH 20C,B01,083451,Hammock; Frances H,0,0,30,30
1650095599935,MATH 20C,B02,083452,Hammock; Frances H,15,0,30,15
1650095599935,MATH 20C,B03,083453,Hammock; Frances H,19,0,30,11
1650095599935,MATH 20C,B04,083454,Hammock; Frances H,23,0,30,7
1650095605960,MATH 20D,A01,084128,Staff,13,0,30,17
1650095605960,MATH 20D,A02,084129,Staff,29,0,30,1
1650095605960,MATH 20D,A03,084130,Staff,28,0,30,2
1650095605960,MATH 20D,B01,084133,Staff,0,0,30,30
1650095605960,MATH 20D,B02,084134,Staff,23,0,30,7
1650095605960,MATH 20D,B03,084135,Staff,28,0,30,2
1650095611991,MATH 20E,A01,084138,Staff,13,0,30,17
1650095611991,MATH 20E,A02,084139,Staff,6,0,30,24
1650095611991,MATH 20E,A03,084140,Staff,14,0,30,16
1650095611991,MATH 20E,A04,084141,Staff,19,0,30,11
1650095618014,MATH 102,A01,084143,Harel; Guershon,11,0,30,19
1650095618014,MATH 102,A02,084144,Harel; Guershon,18,0,30,12
1650095624053,MATH 103B,A01,083456,Staff,0,13,30,30
1650095624053,MATH 103B,A02,083457,Staff,0,14,30,30
1650095630078,MATH 109,A01,084146,Salehi Golsefidy; Alireza,16,0,30,14
1650095630078,MATH 109,A02,084147,Salehi Golsefidy; Alireza,15,0,30,15
1650095636119,MATH 120A,A01,085445,Eggers; John Dietrich,6,0,35,29
1650095636119,MATH 120A,A02,085446,Eggers; John Dietrich,26,0,35,9
1650095642144,MATH 142B,A01,084149,Verstraete; Jacques Allan,0,12,30,30
1650095642144,MATH 142B,A02,084150,Verstraete; Jacques Allan,0,12,30,30
1650095648170,MATH 170A,A01,083459,Nie; Jiawang,0,11,30,30
1650095648170,MATH 170A,A02,083460,Nie; Jiawang,0,10,30,30
1650095648170,MATH 170A,A03,083461,Nie; Jiawang,0,11,30,30
1650095654195,MATH 193B,A01,083463,Staff,1,0,30,29
1650095654195,MATH 193B,A02,083464,Staff,8,0,30,22
1650095654195,MATH 193B,A03,083465,Staff,16,0,30,14
1650095660274,COGS 2,A01,083966,Boyle; Mary E. T.,9,0,30,21
1650095666299,COGS 9,A01,083968,Staff,2,0,60,58
1650095672330,COGS 14B,A01,083970,Staff,7,0,50,43
1650095678358,COGS 17,A01,092679,Staff,49,0,75,26
1650095684382,COGS 100,A01,083972,Staff,0,19,60,60
1650095696434,COGS 101C,A01,083976,Staff,12,0,30,18
1650095702460,COGS 102A,A01,083978,Johnson; Christine M.,9,0,30,21
1650095708484,COGS 107B,A01,083980,Staff,0,9,50,50
1650095714512,COGS 115,A01,083982,Staff,9,0,30,21
1650095720537,COGS 118B,A01,083367,Staff,0,16,40,40
1650095726567,COGS 172,A01,083984,Provenzano; Emily Kara,13,0,30,17
1650095732591,COGS 177,A00,083368,Staff,0,22,30,30
1650095738619,COGS 186,A01,083986,Staff,21,0,40,19
1650095744645,COGS 187A,A01,083988,Boyle; Mary E. T.,15,0,60,45
1650095750677,CSE 8A,A50,084003,Miranda; Gregory Joseph,0,19,15,15
1650095756703,CSE 11,A01,084005,Miranda; Gregory Joseph,0,24,55,55
1650095762733,CSE 20,A01,084007,Staff,0,5,20,20
1650095768758,CSE 21,A01,084009,Staff,0,32,50,50
1650095774797,CSE 30,A01,083370,Cao; Yingjun,0,64,40,40
1650095780825,CSE 100,A01,083372,Cao; Yingjun,0,48,40,40
1650095786857,CSE 101,A01,084011,Staff,0,56,40,40
1650095792889,CSE 141,A01,083374,Eldon; John,0,69,75,75
1650095798918,CSE 141L,A01,083376,Eldon; John,0,75,75,75
1650095804946,CSE 175,A01,084013,Kumar; Rakesh,22,0,25,3
1650095810977,CSE 190,A00,092508,Dubnov; Shlomo,18,0,20,2
1650095817002,ECE 5,A01,084049,Morris; Karcher William,12,0,20,8
1650095823027,ECE 100,A01,084051,Baghdadchi; Saharnaz,0,0,20,20
1650095823027,ECE 100,A02,091916,Baghdadchi; Saharnaz,11,0,20,9
1650095829056,ECE 101,A01,084053,Baghdadchi; Saharnaz,0,0,37,37
1650095829056,ECE 101,A02,084054,Baghdadchi; Saharnaz,27,0,37,10
1650095835082,ECE 107,A01,083390,Staff,26,0,40,14
1650095841109,ECE 148,A01,084056,Silberman; Jack,8,0,12,4
1650095847135,ECE 180,A00,083391,Abi Samra; Nicholas Camill,25,0,30,5
1650095847135,ECE 180,B00,083392,Abi Samra; Nicholas Camill,21,0,30,9
1650095853172,MATH 10B,A01,084110,Staff,0,0,30,30
1650095853172,MATH 10B,A02,084111,Staff,16,0,30,14
1650095853172,MATH 10B,A03,084112,Staff,23,0,30,7
1650095859200,MATH 10C,A01,083443,Staff,0,17,30,31
1650095859200,MATH 10C,A02,083444,Staff,0,18,30,30
1650095859200,MATH 10C,B01,084114,Staff,17,0,30,13
1650095859200,MATH 10C,B02,084115,Staff,24,0,30,6
1650095865229,MATH 18,A01,084117,Harel; Guershon,11,0,30,19
1650095865229,MATH 18,A02,084119,Harel; Guershon,27,0,30,3
1650095865229,MATH 18,A03,084120,Harel; Guershon,30,0,30,0
1650095865229,MATH 18,A04,084121,Harel; Guershon,29,0,30,1
1650095871254,MATH 20B,A01,084124,Um; Ko Woon,10,0,35,25
1650095871254,MATH 20B,B01,084126,Um; Ko Woon,24,0,35,11
1650095877284,MATH 20C,A01,083446,Hammock; Frances H,0,0,30,30
1650095877284,MATH 20C,A02,083447,Hammock; Frances H,13,0,30,17
1650095877284,MATH 20C,A03,083448,Hammock; Frances H,18,0,30,12
1650095877284,MATH 20C,A04,083449,Hammock; Frances H,20,0,30,10
1650095877284,MATH 20C,B01,083451,Hammock; Frances H,0,0,30,30
1650095877284,MATH 20C,B02,083452,Hammock; Frances H,15,0,30,15
1650095877284,MATH 20C,B03,083453,Hammock; Frances H,19,0,30,11
1650095877284,MATH 20C,B04,083454,Hammock; Frances H,23,0,30,7
1650095883309,MATH 20D,A01,084128,Staff,13,0,30,17
1650095883309,MATH 20D,A02,084129,Staff,29,0,30,1
1650095883309,MATH 20D,A03,084130,Staff,28,0,30,2
1650095883309,MATH 20D,B01,084133,Staff,0,0,30,30
1650095883309,MATH 20D,B02,084134,Staff,23,0,30,7
1650095883309,MATH 20D,B03,084135,Staff,28,0,30,2
1650095889339,MATH 20E,A01,084138,Staff,13,0,30,17
1650095889339,MATH 20E,A02,084139,Staff,6,0,30,24
1650095889339,MATH 20E,A03,084140,Staff,14,0,30,16
1650095889339,MATH 20E,A04,084141,Staff,19,0,30,11
1650095895369,MATH 102,A01,084143,Harel; Guershon,11,0,30,19
1650095895369,MATH 102,A02,084144,Harel; Guershon,18,0,30,12
1650095901393,MATH 103B,A01,083456,Staff,0,13,30,30
1650095901393,MATH 103B,A02,083457,Staff,0,14,30,30
1650095907424,MATH 109,A01,084146,Salehi Golsefidy; Alireza,16,0,30,14
1650095907424,MATH 109,A02,084147,Salehi Golsefidy; Alireza,15,0,30,15
1650095913450,MATH 120A,A01,085445,Eggers; John Dietrich,6,0,35,29
1650095913450,MATH 120A,A02,085446,Eggers; John Dietrich,26,0,35,9
1650095919476,MATH 142B,A01,084149,Verstraete; Jacques Allan,0,12,30,30
1650095919476,MATH 142B,A02,084150,Verstraete; Jacques Allan,0,12,30,30
1650095925509,MATH 170A,A01,083459,Nie; Jiawang,0,11,30,30
1650095925509,MATH 170A,A02,083460,Nie; Jiawang,0,10,30,30
1650095925509,MATH 170A,A03,083461,Nie; Jiawang,0,11,30,30
1650095931534,MATH 193B,A01,083463,Staff,1,0,30,29
1650095931534,MATH 193B,A02,083464,Staff,8,0,30,22
1650095931534,MATH 193B,A03,083465,Staff,16,0,30,14
1650095937614,COGS 2,A01,083966,Boyle; Mary E. T.,9,0,30,21
1650095943639,COGS 9,A01,083968,Staff,2,0,60,58
1650095949663,COGS 14B,A01,083970,Staff,7,0,50,43
1650095955689,COGS 17,A01,092679,Staff,49,0,75,26
1650095961712,COGS 100,A01,083972,Staff,0,19,60,60
1650095973767,COGS 101C,A01,083976,Staff,12,0,30,18
1650095979792,COGS 102A,A01,083978,Johnson; Christine M.,9,0,30,21
1650095985835,COGS 107B,A01,083980,Staff,0,9,50,50
1650095991858,COGS 115,A01,083982,Staff,9,0,30,21
1650095997882,COGS 118B,A01,083367,Staff,0,16,40,40
1650096003916,COGS 172,A01,083984,Provenzano; Emily Kara,13,0,30,17
1650096009946,COGS 177,A00,083368,Staff,0,22,30,30
1650096015980,COGS 186,A01,083986,Staff,21,0,40,19
1650096022010,COGS 187A,A01,083988,Boyle; Mary E. T.,15,0,60,45
1650096028036,CSE 8A,A50,084003,Miranda; Gregory Joseph,0,19,15,15
1650096034063,CSE 11,A01,084005,Miranda; Gregory Joseph,0,24,55,55
1650096040088,CSE 20,A01,084007,Staff,0,5,20,20
1650096046204,CSE 21,A01,084009,Staff,0,32,50,50
1650096052229,CSE 30,A01,083370,Cao; Yingjun,0,64,40,40
1650096058256,CSE 100,A01,083372,Cao; Yingjun,0,48,40,40
1650096064286,CSE 101,A01,084011,Staff,0,56,40,40
1650096070311,CSE 141,A01,083374,Eldon; John,0,69,75,75
1650096076336,CSE 141L,A01,083376,Eldon; John,0,75,75,75
1650096082361,CSE 175,A01,084013,Kumar; Rakesh,22,0,25,3
1650096088386,CSE 190,A00,092508,Dubnov; Shlomo,18,0,20,2
1650096094413,ECE 5,A01,084049,Morris; Karcher William,12,0,20,8
1650096100450,ECE 100,A01,084051,Baghdadchi; Saharnaz,0,0,20,20
1650096100450,ECE 100,A02,091916,Baghdadchi; Saharnaz,11,0,20,9
1650096106475,ECE 101,A01,084053,Baghdadchi; Saharnaz,0,0,37,37
1650096106475,ECE 101,A02,084054,Baghdadchi; Saharnaz,27,0,37,10
1650096112504,ECE 107,A01,083390,Staff,26,0,40,14
1650096118530,ECE 148,A01,084056,Silberman; Jack,8,0,12,4
1650096124555,ECE 180,A00,083391,Abi Samra; Nicholas Camill,25,0,30,5
1650096124555,ECE 180,B00,083392,Abi Samra; Nicholas Camill,21,0,30,9
1650096130580,MATH 10B,A01,084110,Staff,0,0,30,30
1650096130580,MATH 10B,A02,084111,Staff,16,0,30,14
1650096130580,MATH 10B,A03,084112,Staff,23,0,30,7
1650096136605,MATH 10C,A01,083443,Staff,0,17,30,31
1650096136605,MATH 10C,A02,083444,Staff,0,18,30,30
1650096136605,MATH 10C,B01,084114,Staff,17,0,30,13
1650096136605,MATH 10C,B02,084115,Staff,24,0,30,6
1650096142640,MATH 18,A01,084117,Harel; Guershon,11,0,30,19
1650096142640,MATH 18,A02,084119,Harel; Guershon,27,0,30,3
1650096142640,MATH 18,A03,084120,Harel; Guershon,30,0,30,0
1650096142640,MATH 18,A04,084121,Harel; Guershon,29,0,30,1
1650096148671,MATH 20B,A01,084124,Um; Ko Woon,10,0,35,25
1650096148671,MATH 20B,B01,084126,Um; Ko Woon,24,0,35,11
1650096154700,MATH 20C,A01,083446,Hammock; Frances H,0,0,30,30
1650096154700,MATH 20C,A02,083447,Hammock; Frances H,13,0,30,17
1650096154700,MATH 20C,A03,083448,Hammock; Frances H,18,0,30,12
1650096154700,MATH 20C,A04,083449,Hammock; Frances H,20,0,30,10
1650096154700,MATH 20C,B01,083451,Hammock; Frances H,0,0,30,30
1650096154700,MATH 20C,B02,083452,Hammock; Frances H,15,0,30,15
1650096154700,MATH 20C,B03,083453,Hammock; Frances H,19,0,30,11
1650096154700,MATH 20C,B04,083454,Hammock; Frances H,23,0,30,7
1650096160727,MATH 20D,A01,084128,Staff,13,0,30,17
1650096160727,MATH 20D,A02,084129,Staff,29,0,30,1
1650096160727,MATH 20D,A03,084130,Staff,28,0,30,2
1650096160727,MATH 20D,B01,084133,Staff,0,0,30,30
1650096160727,MATH 20D,B02,084134,Staff,23,0,30,7
1650096160727,MATH 20D,B03,084135,Staff,28,0,30,2
1650096166755,MATH 20E,A01,084138,Staff,13,0,30,17
1650096166755,MATH 20E,A02,084139,Staff,6,0,30,24
1650096166755,MATH 20E,A03,084140,Staff,14,0,30,16
1650096166755,MATH 20E,A04,084141,Staff,19,0,30,11
1650096172783,MATH 102,A01,084143,Harel; Guershon,11,0,30,19
1650096172783,MATH 102,A02,084144,Harel; Guershon,18,0,30,12
1650096178808,MATH 103B,A01,083456,Staff,0,13,30,30
1650096178808,MATH 103B,A02,083457,Staff,0,14,30,30
1650096184834,MATH 109,A01,084146,Salehi Golsefidy; Alireza,16,0,30,14
1650096184834,MATH 109,A02,084147,Salehi Golsefidy; Alireza,15,0,30,15
1650096190863,MATH 120A,A01,085445,Eggers; John Dietrich,6,0,35,29
1650096190863,MATH 120A,A02,085446,Eggers; John Dietrich,26,0,35,9
1650096196887,MATH 142B,A01,084149,Verstraete; Jacques Allan,0,12,30,30
1650096196887,MATH 142B,A02,084150,Verstraete; Jacques Allan,0,12,30,30
1650096202911,MATH 170A,A01,083459,Nie; Jiawang,0,11,30,30
1650096202911,MATH 170A,A02,083460,Nie; Jiawang,0,10,30,30
1650096202911,MATH 170A,A03,083461,Nie; Jiawang,0,11,30,30
1650096208938,MATH 193B,A01,083463,Staff,1,0,30,29
1650096208938,MATH 193B,A02,083464,Staff,8,0,30,22
1650096208938,MATH 193B,A03,083465,Staff,16,0,30,14
1650096214994,COGS 2,A01,083966,Boyle; Mary E. T.,9,0,30,21
1650096221025,COGS 9,A01,083968,Staff,2,0,60,58
1650096227055,COGS 14B,A01,083970,Staff,7,0,50,43
1650096233082,COGS 17,A01,092679,Staff,49,0,75,26
1650096239106,COGS 100,A01,083972,Staff,0,19,60,60
1650096251156,COGS 101C,A01,083976,Staff,12,0,30,18
1650096257183,COGS 102A,A01,083978,Johnson; Christine M.,9,0,30,21
1650096263213,COGS 107B,A01,083980,Staff,0,9,50,50
1650096269241,COGS 115,A01,083982,Staff,9,0,30,21
1650096275265,COGS 118B,A01,083367,Staff,0,16,40,40
1650096281289,COGS 172,A01,083984,Provenzano; Emily Kara,13,0,30,17
1650096287317,COGS 177,A00,083368,Staff,0,22,30,30
1650096293352,COGS 186,A01,083986,Staff,21,0,40,19
1650096299377,COGS 187A,A01,083988,Boyle; Mary E. T.,15,0,60,45
1650096305408,CSE 8A,A50,084003,Miranda; Gregory Joseph,0,19,15,15
1650096311434,CSE 11,A01,084005,Miranda; Gregory Joseph,0,24,55,55
1650096317464,CSE 20,A01,084007,Staff,0,5,20,20
1650096323490,CSE 21,A01,084009,Staff,0,32,50,50
1650096329518,CSE 30,A01,083370,Cao; Yingjun,0,64,40,40
1650096335541,CSE 100,A01,083372,Cao; Yingjun,0,48,40,40
1650096341566,CSE 101,A01,084011,Staff,0,56,40,40
1650096347596,CSE 141,A01,083374,Eldon; John,0,69,75,75
1650096353621,CSE 141L,A01,083376,Eldon; John,0,75,75,75
1650096359650,CSE 175,A01,084013,Kumar; Rakesh,22,0,25,3
1650096365673,CSE 190,A00,092508,Dubnov; Shlomo,18,0,20,2
1650096371697,ECE 5,A01,084049,Morris; Karcher William,12,0,20,8
1650096377723,ECE 100,A01,084051,Baghdadchi; Saharnaz,0,0,20,20
1650096377723,ECE 100,A02,091916,Baghdadchi; Saharnaz,11,0,20,9
1650096383750,ECE 101,A01,084053,Baghdadchi; Saharnaz,0,0,37,37
1650096383750,ECE 101,A02,084054,Baghdadchi; Saharnaz,27,0,37,10
1650096389781,ECE 107,A01,083390,Staff,26,0,40,14
1650096395817,ECE 148,A01,084056,Silberman; Jack,8,0,12,4
1650096401844,ECE 180,A00,083391,Abi Samra; Nicholas Camill,25,0,30,5
1650096401844,ECE 180,B00,083392,Abi Samra; Nicholas Camill,21,0,30,9
1650096407874,MATH 10B,A01,084110,Staff,0,0,30,30
1650096407874,MATH 10B,A02,084111,Staff,16,0,30,14
1650096407874,MATH 10B,A03,084112,Staff,23,0,30,7
1650096413900,MATH 10C,A01,083443,Staff,0,17,30,31
1650096413900,MATH 10C,A02,083444,Staff,0,18,30,30
1650096413900,MATH 10C,B01,084114,Staff,17,0,30,13
1650096413900,MATH 10C,B02,084115,Staff,24,0,30,6
1650096419935,MATH 18,A01,084117,Harel; Guershon,11,0,30,19
1650096419935,MATH 18,A02,084119,Harel; Guershon,27,0,30,3
1650096419935,MATH 18,A03,084120,Harel; Guershon,30,0,30,0
1650096419935,MATH 18,A04,084121,Harel; Guershon,29,0,30,1
1650096425981,MATH 20B,A01,084124,Um; Ko Woon,10,0,35,25
1650096425981,MATH 20B,B01,084126,Um; Ko Woon,24,0,35,11
1650096432014,MATH 20C,A01,083446,Hammock; Frances H,0,0,30,30
1650096432014,MATH 20C,A02,083447,Hammock; Frances H,13,0,30,17
1650096432014,MATH 20C,A03,083448,Hammock; Frances H,18,0,30,12
1650096432014,MATH 20C,A04,083449,Hammock; Frances H,20,0,30,10
1650096432014,MATH 20C,B01,083451,Hammock; Frances H,0,0,30,30
1650096432014,MATH 20C,B02,083452,Hammock; Frances H,15,0,30,15
1650096432014,MATH 20C,B03,083453,Hammock; Frances H,19,0,30,11
1650096432014,MATH 20C,B04,083454,Hammock; Frances H,23,0,30,7
1650096438039,MATH 20D,A01,084128,Staff,13,0,30,17
1650096438039,MATH 20D,A02,084129,Staff,29,0,30,1
1650096438039,MATH 20D,A03,084130,Staff,28,0,30,2
1650096438039,MATH 20D,B01,084133,Staff,0,0,30,30
1650096438039,MATH 20D,B02,084134,Staff,23,0,30,7
1650096438039,MATH 20D,B03,084135,Staff,28,0,30,2
1650096444061,MATH 20E,A01,084138,Staff,13,0,30,17
1650096444061,MATH 20E,A02,084139,Staff,6,0,30,24
1650096444061,MATH 20E,A03,084140,Staff,14,0,30,16
1650096444061,MATH 20E,A04,084141,Staff,19,0,30,11
1650096450087,MATH 102,A01,084143,Harel; Guershon,11,0,30,19
1650096450087,MATH 102,A02,084144,Harel; Guershon,18,0,30,12
1650096456115,MATH 103B,A01,083456,Staff,0,13,30,30
1650096456115,MATH 103B,A02,083457,Staff,0,14,30,30
1650096462139,MATH 109,A01,084146,Salehi Golsefidy; Alireza,16,0,30,14
1650096462139,MATH 109,A02,084147,Salehi Golsefidy; Alireza,15,0,30,15
1650096468166,MATH 120A,A01,085445,Eggers; John Dietrich,6,0,35,29
1650096468166,MATH 120A,A02,085446,Eggers; John Dietrich,26,0,35,9
1650096474195,MATH 142B,A01,084149,Verstraete; Jacques Allan,0,12,30,30
1650096474195,MATH 142B,A02,084150,Verstraete; Jacques Allan,0,12,30,30
1650096480232,MATH 170A,A01,083459,Nie; Jiawang,0,11,30,30
1650096480232,MATH 170A,A02,083460,Nie; Jiawang,0,10,30,30
1650096480232,MATH 170A,A03,083461,Nie; Jiawang,0,11,30,30
1650096486261,MATH 193B,A01,083463,Staff,1,0,30,29
1650096486261,MATH 193B,A02,083464,Staff,8,0,30,22
1650096486261,MATH 193B,A03,083465,Staff,16,0,30,14
1650096492325,COGS 2,A01,083966,Boyle; Mary E. T.,9,0,30,21
1650096498349,COGS 9,A01,083968,Staff,2,0,60,58
1650096504379,COGS 14B,A01,083970,Staff,7,0,50,43
1650096510408,COGS 17,A01,092679,Staff,49,0,75,26
1650096516432,COGS 100,A01,083972,Staff,0,19,60,60
1650096528485,COGS 101C,A01,083976,Staff,12,0,30,18
1650096534510,COGS 102A,A01,083978,Johnson; Christine M.,9,0,30,21
1650096540534,COGS 107B,A01,083980,Staff,0,9,50,50
1650096546564,COGS 115,A01,083982,Staff,9,0,30,21
1650096552594,COGS 118B,A01,083367,Staff,0,16,40,40
1650096558625,COGS 172,A01,083984,Provenzano; Emily Kara,13,0,30,17
1650096564649,COGS 177,A00,083368,Staff,0,22,30,30
1650096570672,COGS 186,A01,083986,Staff,21,0,40,19
1650096576700,COGS 187A,A01,083988,Boyle; Mary E. T.,15,0,60,45
1650096582728,CSE 8A,A50,084003,Miranda; Gregory Joseph,0,19,15,15
1650096588758,CSE 11,A01,084005,Miranda; Gregory Joseph,0,24,55,55
1650096594785,CSE 20,A01,084007,Staff,0,5,20,20
1650096600810,CSE 21,A01,084009,Staff,0,32,50,50
1650096606835,CSE 30,A01,083370,Cao; Yingjun,0,64,40,40
1650096612860,CSE 100,A01,083372,Cao; Yingjun,0,48,40,40
1650096618885,CSE 101,A01,084011,Staff,0,56,40,40
1650096624915,CSE 141,A01,083374,Eldon; John,0,69,75,75
1650096630940,CSE 141L,A01,083376,Eldon; John,0,75,75,75
1650096636972,CSE 175,A01,084013,Kumar; Rakesh,22,0,25,3
1650096643101,CSE 190,A00,092508,Dubnov; Shlomo,18,0,20,2
1650096649132,ECE 5,A01,084049,Morris; Karcher William,12,0,20,8
1650096655159,ECE 100,A01,084051,Baghdadchi; Saharnaz,0,0,20,20
1650096655159,ECE 100,A02,091916,Baghdadchi; Saharnaz,11,0,20,9
1650096661187,ECE 101,A01,084053,Baghdadchi; Saharnaz,0,0,37,37
1650096661187,ECE 101,A02,084054,Baghdadchi; Saharnaz,27,0,37,10
1650096667214,ECE 107,A01,083390,Staff,26,0,40,14
1650096673246,ECE 148,A01,084056,Silberman; Jack,8,0,12,4
1650096679270,ECE 180,A00,083391,Abi Samra; Nicholas Camill,25,0,30,5
1650096679270,ECE 180,B00,083392,Abi Samra; Nicholas Camill,21,0,30,9
1650096685301,MATH 10B,A01,084110,Staff,0,0,30,30
1650096685301,MATH 10B,A02,084111,Staff,16,0,30,14
1650096685301,MATH 10B,A03,084112,Staff,23,0,30,7
1650096691331,MATH 10C,A01,083443,Staff,0,17,30,31
1650096691331,MATH 10C,A02,083444,Staff,0,18,30,30
1650096691331,MATH 10C,B01,084114,Staff,17,0,30,13
1650096691331,MATH 10C,B02,084115,Staff,24,0,30,6
1650096697359,MATH 18,A01,084117,Harel; Guershon,11,0,30,19
1650096697359,MATH 18,A02,084119,Harel; Guershon,27,0,30,3
1650096697359,MATH 18,A03,084120,Harel; Guershon,30,0,30,0
1650096697359,MATH 18,A04,084121,Harel; Guershon,29,0,30,1
1650096703383,MATH 20B,A01,084124,Um; Ko Woon,10,0,35,25
1650096703383,MATH 20B,B01,084126,Um; Ko Woon,24,0,35,11
1650096709412,MATH 20C,A01,083446,Hammock; Frances H,0,0,30,30
1650096709412,MATH 20C,A02,083447,Hammock; Frances H,13,0,30,17
1650096709412,MATH 20C,A03,083448,Hammock; Frances H,18,0,30,12
1650096709412,MATH 20C,A04,083449,Hammock; Frances H,20,0,30,10
1650096709412,MATH 20C,B01,083451,Hammock; Frances H,0,0,30,30
1650096709412,MATH 20C,B02,083452,Hammock; Frances H,15,0,30,15
1650096709412,MATH 20C,B03,083453,Hammock; Frances H,19,0,30,11
1650096709412,MATH 20C,B04,083454,Hammock; Frances H,23,0,30,7
1650096715437,MATH 20D,A01,084128,Staff,13,0,30,17
1650096715437,MATH 20D,A02,084129,Staff,29,0,30,1
1650096715437,MATH 20D,A03,084130,Staff,28,0,30,2
1650096715437,MATH 20D,B01,084133,Staff,0,0,30,30
1650096715437,MATH 20D,B02,084134,Staff,23,0,30,7
1650096715437,MATH 20D,B03,084135,Staff,28,0,30,2
1650096721462,MATH 20E,A01,084138,Staff,13,0,30,17
1650096721462,MATH 20E,A02,084139,Staff,6,0,30,24
1650096721462,MATH 20E,A03,084140,Staff,14,0,30,16
1650096721462,MATH 20E,A04,084141,Staff,19,0,30,11
1650096727492,MATH 102,A01,084143,Harel; Guershon,11,0,30,19
1650096727492,MATH 102,A02,084144,Harel; Guershon,18,0,30,12
1650096733517,MATH 103B,A01,083456,Staff,0,13,30,30
1650096733517,MATH 103B,A02,083457,Staff,0,14,30,30
1650096739548,MATH 109,A01,084146,Salehi Golsefidy; Alireza,16,0,30,14
1650096739548,MATH 109,A02,084147,Salehi Golsefidy; Alireza,15,0,30,15
1650096745577,MATH 120A,A01,085445,Eggers; John Dietrich,6,0,35,29
1650096745577,MATH 120A,A02,085446,Eggers; John Dietrich,26,0,35,9
1650096751606,MATH 142B,A01,084149,Verstraete; Jacques Allan,0,12,30,30
1650096751606,MATH 142B,A02,084150,Verstraete; Jacques Allan,0,12,30,30
1650096757645,MATH 170A,A01,083459,Nie; Jiawang,0,11,30,30
1650096757645,MATH 170A,A02,083460,Nie; Jiawang,0,10,30,30
1650096757645,MATH 170A,A03,083461,Nie; Jiawang,0,11,30,30
1650096763674,MATH 193B,A01,083463,Staff,1,0,30,29
1650096763674,MATH 193B,A02,083464,Staff,8,0,30,22
1650096763674,MATH 193B,A03,083465,Staff,16,0,30,14
1650096769741,COGS 2,A01,083966,Boyle; Mary E. T.,9,0,30,21
1650096775773,COGS 9,A01,083968,Staff,2,0,60,58
1650096781798,COGS 14B,A01,083970,Staff,7,0,50,43
1650096787823,COGS 17,A01,092679,Staff,49,0,75,26
1650096793851,COGS 100,A01,083972,Staff,0,20,60,60
1650096805904,COGS 101C,A01,083976,Staff,12,0,30,18
1650096811935,COGS 102A,A01,083978,Johnson; Christine M.,8,0,30,22
1650096817962,COGS 107B,A01,083980,Staff,0,9,50,50
1650096823989,COGS 115,A01,083982,Staff,9,0,30,21
1650096830014,COGS 118B,A01,083367,Staff,0,16,40,40
1650096836045,COGS 172,A01,083984,Provenzano; Emily Kara,13,0,30,17
1650096842074,COGS 177,A00,083368,Staff,0,22,30,30
1650096848101,COGS 186,A01,083986,Staff,22,0,40,18
1650096854131,COGS 187A,A01,083988,Boyle; Mary E. T.,15,0,60,45
1650096860163,CSE 8A,A50,084003,Miranda; Gregory Joseph,0,19,15,15
1650096866192,CSE 11,A01,084005,Miranda; Gregory Joseph,0,24,55,55
1650096872217,CSE 20,A01,084007,Staff,0,5,20,20
1650096878241,CSE 21,A01,084009,Staff,0,32,50,50
1650096884266,CSE 30,A01,083370,Cao; Yingjun,0,64,40,40
1650096890291,CSE 100,A01,083372,Cao; Yingjun,0,48,40,40
1650096896323,CSE 101,A01,084011,Staff,0,56,40,40
1650096902349,CSE 141,A01,083374,Eldon; John,0,69,75,75
1650096908376,CSE 141L,A01,083376,Eldon; John,0,75,75,75
1650096914407,CSE 175,A01,084013,Kumar; Rakesh,22,0,25,3
1650096920465,CSE 190,A00,092508,Dubnov; Shlomo,18,0,20,2
1650096926489,ECE 5,A01,084049,Morris; Karcher William,12,0,20,8
1650096932521,ECE 100,A01,084051,Baghdadchi; Saharnaz,0,0,20,20
1650096932521,ECE 100,A02,091916,Baghdadchi; Saharnaz,11,0,20,9
1650096938548,ECE 101,A01,084053,Baghdadchi; Saharnaz,0,0,37,37
1650096938548,ECE 101,A02,084054,Baghdadchi; Saharnaz,27,0,37,10
1650096944574,ECE 107,A01,083390,Staff,26,0,40,14
1650096950610,ECE 148,A01,084056,Silberman; Jack,8,0,12,4
1650096956641,ECE 180,A00,083391,Abi Samra; Nicholas Camill,25,0,30,5
1650096956641,ECE 180,B00,083392,Abi Samra; Nicholas Camill,21,0,30,9
1650096962666,MATH 10B,A01,084110,Staff,0,0,30,30
1650096962666,MATH 10B,A02,084111,Staff,16,0,30,14
1650096962666,MATH 10B,A03,084112,Staff,23,0,30,7
1650096968701,MATH 10C,A01,083443,Staff,0,17,30,31
1650096968701,MATH 10C,A02,083444,Staff,0,18,30,30
1650096968701,MATH 10C,B01,084114,Staff,17,0,30,13
1650096968701,MATH 10C,B02,084115,Staff,24,0,30,6
1650096974726,MATH 18,A01,084117,Harel; Guershon,11,0,30,19
1650096974726,MATH 18,A02,084119,Harel; Guershon,27,0,30,3
1650096974726,MATH 18,A03,084120,Harel; Guershon,30,0,30,0
1650096974726,MATH 18,A04,084121,Harel; Guershon,29,0,30,1
1650096980755,MATH 20B,A01,084124,Um; Ko Woon,10,0,35,25
1650096980755,MATH 20B,B01,084126,Um; Ko Woon,24,0,35,11
1650096986786,MATH 20C,A01,083446,Hammock; Frances H,0,0,30,30
1650096986786,MATH 20C,A02,083447,Hammock; Frances H,13,0,30,17
1650096986786,MATH 20C,A03,083448,Hammock; Frances H,18,0,30,12
1650096986786,MATH 20C,A04,083449,Hammock; Frances H,20,0,30,10
1650096986786,MATH 20C,B01,083451,Hammock; Frances H,0,0,30,30
1650096986786,MATH 20C,B02,083452,Hammock; Frances H,15,0,30,15
1650096986786,MATH 20C,B03,083453,Hammock; Frances H,19,0,30,11
1650096986786,MATH 20C,B04,083454,Hammock; Frances H,23,0,30,7
1650096992816,MATH 20D,A01,084128,Staff,13,0,30,17
1650096992816,MATH 20D,A02,084129,Staff,29,0,30,1
1650096992816,MATH 20D,A03,084130,Staff,28,0,30,2
1650096992816,MATH 20D,B01,084133,Staff,0,0,30,30
1650096992816,MATH 20D,B02,084134,Staff,23,0,30,7
1650096992816,MATH 20D,B03,084135,Staff,28,0,30,2
1650096998848,MATH 20E,A01,084138,Staff,13,0,30,17
1650096998848,MATH 20E,A02,084139,Staff,6,0,30,24
1650096998848,MATH 20E,A03,084140,Staff,14,0,30,16
1650096998848,MATH 20E,A04,084141,Staff,19,0,30,11
1650097004872,MATH 102,A01,084143,Harel; Guershon,11,0,30,19
1650097004872,MATH 102,A02,084144,Harel; Guershon,18,0,30,12
1650097010897,MATH 103B,A01,083456,Staff,0,13,30,30
1650097010897,MATH 103B,A02,083457,Staff,0,14,30,30
1650097016920,MATH 109,A01,084146,Salehi Golsefidy; Alireza,16,0,30,14
1650097016920,MATH 109,A02,084147,Salehi Golsefidy; Alireza,15,0,30,15
1650097022955,MATH 120A,A01,085445,Eggers; John Dietrich,6,0,35,29
1650097022955,MATH 120A,A02,085446,Eggers; John Dietrich,26,0,35,9
1650097028981,MATH 142B,A01,084149,Verstraete; Jacques Allan,0,12,30,30
1650097028981,MATH 142B,A02,084150,Verstraete; Jacques Allan,0,12,30,30
1650097035005,MATH 170A,A01,083459,Nie; Jiawang,0,11,30,30
1650097035005,MATH 170A,A02,083460,Nie; Jiawang,0,10,30,30
1650097035005,MATH 170A,A03,083461,Nie; Jiawang,0,11,30,30
1650097041037,MATH 193B,A01,083463,Staff,1,0,30,29
1650097041037,MATH 193B,A02,083464,Staff,8,0,30,22
1650097041037,MATH 193B,A03,083465,Staff,16,0,30,14
1650097047093,COGS 2,A01,083966,Boyle; Mary E. T.,9,0,30,21
1650097053114,COGS 9,A01,083968,Staff,2,0,60,58
1650097059140,COGS 14B,A01,083970,Staff,7,0,50,43
1650097065168,COGS 17,A01,092679,Staff,49,0,75,26
1650097071191,COGS 100,A01,083972,Staff,0,20,60,60
1650097083242,COGS 101C,A01,083976,Staff,12,0,30,18
1650097089265,COGS 102A,A01,083978,Johnson; Christine M.,8,0,30,22
1650097095292,COGS 107B,A01,083980,Staff,0,9,50,50
1650097101319,COGS 115,A01,083982,Staff,9,0,30,21
1650097107346,COGS 118B,A01,083367,Staff,0,16,40,40
1650097113378,COGS 172,A01,083984,Provenzano; Emily Kara,13,0,30,17
1650097119405,COGS 177,A00,083368,Staff,0,22,30,30
1650097125433,COGS 186,A01,083986,Staff,22,0,40,18
1650097131454,COGS 187A,A01,083988,Boyle; Mary E. T.,15,0,60,45
1650097137479,CSE 8A,A50,084003,Miranda; Gregory Joseph,0,19,15,15
1650097143503,CSE 11,A01,084005,Miranda; Gregory Joseph,0,24,55,55
1650097149528,CSE 20,A01,084007,Staff,0,5,20,20
1650097155552,CSE 21,A01,084009,Staff,0,32,50,50
1650097161578,CSE 30,A01,083370,Cao; Yingjun,0,64,40,40
1650097167606,CSE 100,A01,083372,Cao; Yingjun,0,48,40,40
1650097173634,CSE 101,A01,084011,Staff,0,56,40,40
1650097179664,CSE 141,A01,083374,Eldon; John,0,69,75,75
1650097185691,CSE 141L,A01,083376,Eldon; John,0,75,75,75
1650097191718,CSE 175,A01,084013,Kumar; Rakesh,22,0,25,3
1650097197743,CSE 190,A00,092508,Dubnov; Shlomo,18,0,20,2
1650097203768,ECE 5,A01,084049,Morris; Karcher William,12,0,20,8
1650097209794,ECE 100,A01,084051,Baghdadchi; Saharnaz,0,0,20,20
1650097209794,ECE 100,A02,091916,Baghdadchi; Saharnaz,11,0,20,9
1650097215822,ECE 101,A01,084053,Baghdadchi; Saharnaz,0,0,37,37
1650097215822,ECE 101,A02,084054,Baghdadchi; Saharnaz,27,0,37,10
1650097221852,ECE 107,A01,083390,Staff,26,0,40,14
1650097227876,ECE 148,A01,084056,Silberman; Jack,8,0,12,4
1650097233904,ECE 180,A00,083391,Abi Samra; Nicholas Camill,25,0,30,5
1650097233904,ECE 180,B00,083392,Abi Samra; Nicholas Camill,21,0,30,9
1650097240016,MATH 10B,A01,084110,Staff,0,0,30,30
1650097240016,MATH 10B,A02,084111,Staff,16,0,30,14
1650097240016,MATH 10B,A03,084112,Staff,23,0,30,7
1650097246044,MATH 10C,A01,083443,Staff,0,17,30,31
1650097246044,MATH 10C,A02,083444,Staff,0,18,30,30
1650097246044,MATH 10C,B01,084114,Staff,17,0,30,13
1650097246044,MATH 10C,B02,084115,Staff,24,0,30,6
1650097252069,MATH 18,A01,084117,Harel; Guershon,11,0,30,19
1650097252069,MATH 18,A02,084119,Harel; Guershon,27,0,30,3
1650097252069,MATH 18,A03,084120,Harel; Guershon,30,0,30,0
1650097252069,MATH 18,A04,084121,Harel; Guershon,29,0,30,1
1650097258094,MATH 20B,A01,084124,Um; Ko Woon,10,0,35,25
1650097258094,MATH 20B,B01,084126,Um; Ko Woon,24,0,35,11
1650097264120,MATH 20C,A01,083446,Hammock; Frances H,0,0,30,30
1650097264120,MATH 20C,A02,083447,Hammock; Frances H,13,0,30,17
1650097264120,MATH 20C,A03,083448,Hammock; Frances H,18,0,30,12
1650097264120,MATH 20C,A04,083449,Hammock; Frances H,20,0,30,10
1650097264120,MATH 20C,B01,083451,Hammock; Frances H,0,0,30,30
1650097264120,MATH 20C,B02,083452,Hammock; Frances H,15,0,30,15
1650097264120,MATH 20C,B03,083453,Hammock; Frances H,19,0,30,11
1650097264120,MATH 20C,B04,083454,Hammock; Frances H,23,0,30,7
1650097270150,MATH 20D,A01,084128,Staff,13,0,30,17
1650097270150,MATH 20D,A02,084129,Staff,29,0,30,1
1650097270150,MATH 20D,A03,084130,Staff,28,0,30,2
1650097270150,MATH 20D,B01,084133,Staff,0,0,30,30
1650097270150,MATH 20D,B02,084134,Staff,23,0,30,7
1650097270150,MATH 20D,B03,084135,Staff,28,0,30,2
1650097276179,MATH 20E,A01,084138,Staff,13,0,30,17
1650097276179,MATH 20E,A02,084139,Staff,6,0,30,24
1650097276179,MATH 20E,A03,084140,Staff,14,0,30,16
1650097276179,MATH 20E,A04,084141,Staff,19,0,30,11
1650097282206,MATH 102,A01,084143,Harel; Guershon,11,0,30,19
1650097282206,MATH 102,A02,084144,Harel; Guershon,18,0,30,12
1650097288243,MATH 103B,A01,083456,Staff,0,13,30,30
1650097288243,MATH 103B,A02,083457,Staff,0,14,30,30
1650097294270,MATH 109,A01,084146,Salehi Golsefidy; Alireza,16,0,30,14
1650097294270,MATH 109,A02,084147,Salehi Golsefidy; Alireza,15,0,30,15
1650097300294,MATH 120A,A01,085445,Eggers; John Dietrich,6,0,35,29
1650097300294,MATH 120A,A02,085446,Eggers; John Dietrich,26,0,35,9
1650097306319,MATH 142B,A01,084149,Verstraete; Jacques Allan,0,12,30,30
1650097306319,MATH 142B,A02,084150,Verstraete; Jacques Allan,0,12,30,30
1650097312348,MATH 170A,A01,083459,Nie; Jiawang,0,11,30,30
1650097312348,MATH 170A,A02,083460,Nie; Jiawang,0,10,30,30
1650097312348,MATH 170A,A03,083461,Nie; Jiawang,0,11,30,30
1650097318376,MATH 193B,A01,083463,Staff,1,0,30,29
1650097318376,MATH 193B,A02,083464,Staff,8,0,30,22
1650097318376,MATH 193B,A03,083465,Staff,16,0,30,14
1650097324431,COGS 2,A01,083966,Boyle; Mary E. T.,9,0,30,21
1650097330458,COGS 9,A01,083968,Staff,2,0,60,58
1650097336487,COGS 14B,A01,083970,Staff,7,0,50,43
1650097342510,COGS 17,A01,092679,Staff,49,0,75,26
1650097348540,COGS 100,A01,083972,Staff,0,20,60,60
1650097360593,COGS 101C,A01,083976,Staff,12,0,30,18
1650097366620,COGS 102A,A01,083978,Johnson; Christine M.,8,0,30,22
1650097372645,COGS 107B,A01,083980,Staff,0,9,50,50
1650097378673,COGS 115,A01,083982,Staff,9,0,30,21
1650097384701,COGS 118B,A01,083367,Staff,0,16,40,40
1650097390726,COGS 172,A01,083984,Provenzano; Emily Kara,13,0,30,17
1650097396750,COGS 177,A00,083368,Staff,0,22,30,30
1650097402774,COGS 186,A01,083986,Staff,22,0,40,18
1650097408802,COGS 187A,A01,083988,Boyle; Mary E. T.,15,0,60,45
1650097414826,CSE 8A,A50,084003,Miranda; Gregory Joseph,0,19,15,15
1650097420852,CSE 11,A01,084005,Miranda; Gregory Joseph,0,24,55,55
1650097426880,CSE 20,A01,084007,Staff,0,5,20,20
1650097432903,CSE 21,A01,084009,Staff,0,32,50,50
1650097438931,CSE 30,A01,083370,Cao; Yingjun,0,64,40,40
1650097444954,CSE 100,A01,083372,Cao; Yingjun,0,48,40,40
1650097450978,CSE 101,A01,084011,Staff,0,56,40,40
1650097457003,CSE 141,A01,083374,Eldon; John,0,69,75,75
1650097463027,CSE 141L,A01,083376,Eldon; John,0,75,75,75
1650097469053,CSE 175,A01,084013,Kumar; Rakesh,22,0,25,3
1650097475077,CSE 190,A00,092508,Dubnov; Shlomo,18,0,20,2
1650097481100,ECE 5,A01,084049,Morris; Karcher William,12,0,20,8
1650097487129,ECE 100,A01,084051,Baghdadchi; Saharnaz,0,0,20,20
1650097487129,ECE 100,A02,091916,Baghdadchi; Saharnaz,11,0,20,9
1650097493156,ECE 101,A01,084053,Baghdadchi; Saharnaz,0,0,37,37
1650097493156,ECE 101,A02,084054,Baghdadchi; Saharnaz,27,0,37,10
1650097499183,ECE 107,A01,083390,Staff,26,0,40,14
1650097505228,ECE 148,A01,084056,Silberman; Jack,8,0,12,4
1650097511250,ECE 180,A00,083391,Abi Samra; Nicholas Camill,25,0,30,5
1650097511250,ECE 180,B00,083392,Abi Samra; Nicholas Camill,21,0,30,9
1650097517287,MATH 10B,A01,084110,Staff,0,0,30,30
1650097517287,MATH 10B,A02,084111,Staff,16,0,30,14
1650097517287,MATH 10B,A03,084112,Staff,23,0,30,7
1650097523314,MATH 10C,A01,083443,Staff,0,17,30,31
1650097523314,MATH 10C,A02,083444,Staff,0,18,30,30
1650097523314,MATH 10C,B01,084114,Staff,17,0,30,13
1650097523314,MATH 10C,B02,084115,Staff,24,0,30,6
1650097529342,MATH 18,A01,084117,Harel; Guershon,11,0,30,19
1650097529342,MATH 18,A02,084119,Harel; Guershon,27,0,30,3
1650097529342,MATH 18,A03,084120,Harel; Guershon,30,0,30,0
1650097529342,MATH 18,A04,084121,Harel; Guershon,29,0,30,1
1650097535372,MATH 20B,A01,084124,Um; Ko Woon,10,0,35,25
1650097535372,MATH 20B,B01,084126,Um; Ko Woon,24,0,35,11
1650097541398,MATH 20C,A01,083446,Hammock; Frances H,0,0,30,30
1650097541398,MATH 20C,A02,083447,Hammock; Frances H,13,0,30,17
1650097541398,MATH 20C,A03,083448,Hammock; Frances H,18,0,30,12
1650097541398,MATH 20C,A04,083449,Hammock; Frances H,20,0,30,10
1650097541398,MATH 20C,B01,083451,Hammock; Frances H,0,0,30,30
1650097541398,MATH 20C,B02,083452,Hammock; Frances H,15,0,30,15
1650097541398,MATH 20C,B03,083453,Hammock; Frances H,19,0,30,11
1650097541398,MATH 20C,B04,083454,Hammock; Frances H,23,0,30,7
1650097547423,MATH 20D,A01,084128,Staff,13,0,30,17
1650097547423,MATH 20D,A02,084129,Staff,29,0,30,1
1650097547423,MATH 20D,A03,084130,Staff,28,0,30,2
1650097547423,MATH 20D,B01,084133,Staff,0,0,30,30
1650097547423,MATH 20D,B02,084134,Staff,23,0,30,7
1650097547423,MATH 20D,B03,084135,Staff,28,0,30,2
1650097553450,MATH 20E,A01,084138,Staff,13,0,30,17
1650097553450,MATH 20E,A02,084139,Staff,6,0,30,24
1650097553450,MATH 20E,A03,084140,Staff,14,0,30,16
1650097553450,MATH 20E,A04,084141,Staff,19,0,30,11
1650097559473,MATH 102,A01,084143,Harel; Guershon,11,0,30,19
1650097559473,MATH 102,A02,084144,Harel; Guershon,18,0,30,12
1650097565497,MATH 103B,A01,083456,Staff,0,13,30,30
1650097565497,MATH 103B,A02,083457,Staff,0,14,30,30
1650097571521,MATH 109,A01,084146,Salehi Golsefidy; Alireza,16,0,30,14
1650097571521,MATH 109,A02,084147,Salehi Golsefidy; Alireza,15,0,30,15
1650097577546,MATH 120A,A01,085445,Eggers; John Dietrich,6,0,35,29
1650097577546,MATH 120A,A02,085446,Eggers; John Dietrich,26,0,35,9
1650097583570,MATH 142B,A01,084149,Verstraete; Jacques Allan,0,12,30,30
1650097583570,MATH 142B,A02,084150,Verstraete; Jacques Allan,0,12,30,30
1650097589601,MATH 170A,A01,083459,Nie; Jiawang,0,11,30,30
1650097589601,MATH 170A,A02,083460,Nie; Jiawang,0,10,30,30
1650097589601,MATH 170A,A03,083461,Nie; Jiawang,0,11,30,30
1650097595624,MATH 193B,A01,083463,Staff,1,0,30,29
1650097595624,MATH 193B,A02,083464,Staff,8,0,30,22
1650097595624,MATH 193B,A03,083465,Staff,16,0,30,14
1650097601685,COGS 2,A01,083966,Boyle; Mary E. T.,9,0,30,21
1650097607710,COGS 9,A01,083968,Staff,2,0,60,58
1650097613739,COGS 14B,A01,083970,Staff,7,0,50,43
1650097619764,COGS 17,A01,092679,Staff,49,0,75,26
1650097625789,COGS 100,A01,083972,Staff,0,20,60,60
1650097637849,COGS 101C,A01,083976,Staff,12,0,30,18
1650097643880,COGS 102A,A01,083978,Johnson; Christine M.,8,0,30,22
1650097649908,COGS 107B,A01,083980,Staff,0,9,50,50
1650097655930,COGS 115,A01,083982,Staff,9,0,30,21
1650097661955,COGS 118B,A01,083367,Staff,0,16,40,40
1650097667980,COGS 172,A01,083984,Provenzano; Emily Kara,13,0,30,17
1650097674005,COGS 177,A00,083368,Staff,0,22,30,30
1650097680033,COGS 186,A01,083986,Staff,22,0,40,18
1650097686059,COGS 187A,A01,083988,Boyle; Mary E. T.,15,0,60,45
1650097692098,CSE 8A,A50,084003,Miranda; Gregory Joseph,0,19,15,15
1650097698124,CSE 11,A01,084005,Miranda; Gregory Joseph,0,24,55,55
1650097704150,CSE 20,A01,084007,Staff,0,5,20,20
1650097710179,CSE 21,A01,084009,Staff,0,32,50,50
1650097716208,CSE 30,A01,083370,Cao; Yingjun,0,64,40,40
1650097722238,CSE 100,A01,083372,Cao; Yingjun,0,48,40,40
1650097728262,CSE 101,A01,084011,Staff,0,56,40,40
1650097734297,CSE 141,A01,083374,Eldon; John,0,69,75,75
1650097740325,CSE 141L,A01,083376,Eldon; John,0,75,75,75
1650097746357,CSE 175,A01,084013,Kumar; Rakesh,22,0,25,3
1650097752389,CSE 190,A00,092508,Dubnov; Shlomo,18,0,20,2
1650097758421,ECE 5,A01,084049,Morris; Karcher William,12,0,20,8
1650097764456,ECE 100,A01,084051,Baghdadchi; Saharnaz,0,0,20,20
1650097764456,ECE 100,A02,091916,Baghdadchi; Saharnaz,11,0,20,9
1650097770483,ECE 101,A01,084053,Baghdadchi; Saharnaz,0,0,37,37
1650097770483,ECE 101,A02,084054,Baghdadchi; Saharnaz,27,0,37,10
1650097776510,ECE 107,A01,083390,Staff,26,0,40,14
1650097782547,ECE 148,A01,084056,Silberman; Jack,8,0,12,4
1650097788581,ECE 180,A00,083391,Abi Samra; Nicholas Camill,25,0,30,5
1650097788581,ECE 180,B00,083392,Abi Samra; Nicholas Camill,21,0,30,9
1650097794608,MATH 10B,A01,084110,Staff,0,0,30,30
1650097794608,MATH 10B,A02,084111,Staff,16,0,30,14
1650097794608,MATH 10B,A03,084112,Staff,23,0,30,7
1650097800634,MATH 10C,A01,083443,Staff,0,17,30,31
1650097800634,MATH 10C,A02,083444,Staff,0,18,30,30
1650097800634,MATH 10C,B01,084114,Staff,17,0,30,13
1650097800634,MATH 10C,B02,084115,Staff,24,0,30,6
1650097806688,MATH 18,A01,084117,Harel; Guershon,11,0,30,19
1650097806688,MATH 18,A02,084119,Harel; Guershon,27,0,30,3
1650097806688,MATH 18,A03,084120,Harel; Guershon,30,0,30,0
1650097806688,MATH 18,A04,084121,Harel; Guershon,29,0,30,1
1650097812716,MATH 20B,A01,084124,Um; Ko Woon,10,0,35,25
1650097812716,MATH 20B,B01,084126,Um; Ko Woon,24,0,35,11
1650097818744,MATH 20C,A01,083446,Hammock; Frances H,0,0,30,30
1650097818744,MATH 20C,A02,083447,Hammock; Frances H,13,0,30,17
1650097818744,MATH 20C,A03,083448,Hammock; Frances H,18,0,30,12
1650097818744,MATH 20C,A04,083449,Hammock; Frances H,20,0,30,10
1650097818744,MATH 20C,B01,083451,Hammock; Frances H,0,0,30,30
1650097818744,MATH 20C,B02,083452,Hammock; Frances H,15,0,30,15
1650097818744,MATH 20C,B03,083453,Hammock; Frances H,19,0,30,11
1650097818744,MATH 20C,B04,083454,Hammock; Frances H,23,0,30,7
1650097824772,MATH 20D,A01,084128,Staff,13,0,30,17
1650097824772,MATH 20D,A02,084129,Staff,29,0,30,1
1650097824772,MATH 20D,A03,084130,Staff,28,0,30,2
1650097824772,MATH 20D,B01,084133,Staff,0,0,30,30
1650097824772,MATH 20D,B02,084134,Staff,23,0,30,7
1650097824772,MATH 20D,B03,084135,Staff,28,0,30,2
1650097830796,MATH 20E,A01,084138,Staff,13,0,30,17
1650097830796,MATH 20E,A02,084139,Staff,6,0,30,24
1650097830796,MATH 20E,A03,084140,Staff,14,0,30,16
1650097830796,MATH 20E,A04,084141,Staff,19,0,30,11
1650097836916,MATH 102,A01,084143,Harel; Guershon,11,0,30,19
1650097836916,MATH 102,A02,084144,Harel; Guershon,18,0,30,12
1650097842945,MATH 103B,A01,083456,Staff,0,13,30,30
1650097842945,MATH 103B,A02,083457,Staff,0,14,30,30
1650097848974,MATH 109,A01,084146,Salehi Golsefidy; Alireza,16,0,30,14
1650097848974,MATH 109,A02,084147,Salehi Golsefidy; Alireza,15,0,30,15
1650097855002,MATH 120A,A01,085445,Eggers; John Dietrich,6,0,35,29
1650097855002,MATH 120A,A02,085446,Eggers; John Dietrich,26,0,35,9
1650097861035,MATH 142B,A01,084149,Verstraete; Jacques Allan,0,12,30,30
1650097861035,MATH 142B,A02,084150,Verstraete; Jacques Allan,0,12,30,30
1650097867065,MATH 170A,A01,083459,Nie; Jiawang,0,11,30,30
1650097867065,MATH 170A,A02,083460,Nie; Jiawang,0,10,30,30
1650097867065,MATH 170A,A03,083461,Nie; Jiawang,0,11,30,30
1650097873091,MATH 193B,A01,083463,Staff,1,0,30,29
1650097873091,MATH 193B,A02,083464,Staff,8,0,30,22
1650097873091,MATH 193B,A03,083465,Staff,16,0,30,14
1650097879166,COGS 2,A01,083966,Boyle; Mary E. T.,9,0,30,21
1650097885191,COGS 9,A01,083968,Staff,2,0,60,58
1650097891218,COGS 14B,A01,083970,Staff,7,0,50,43
1650097897242,COGS 17,A01,092679,Staff,49,0,75,26
1650097903271,COGS 100,A01,083972,Staff,0,20,60,60
1650097915340,COGS 101C,A01,083976,Staff,12,0,30,18
1650097921379,COGS 102A,A01,083978,Johnson; Christine M.,8,0,30,22
1650097927408,COGS 107B,A01,083980,Staff,0,9,50,50
1650097933433,COGS 115,A01,083982,Staff,9,0,30,21
1650097939469,COGS 118B,A01,083367,Staff,0,16,40,40
1650097945503,COGS 172,A01,083984,Provenzano; Emily Kara,13,0,30,17
1650097951528,COGS 177,A00,083368,Staff,0,22,30,30
1650097957554,COGS 186,A01,083986,Staff,22,0,40,18
1650097963579,COGS 187A,A01,083988,Boyle; Mary E. T.,15,0,60,45
1650097969606,CSE 8A,A50,084003,Miranda; Gregory Joseph,0,19,15,15
1650097975636,CSE 11,A01,084005,Miranda; Gregory Joseph,0,24,55,55
1650097981662,CSE 20,A01,084007,Staff,0,5,20,20
1650097987690,CSE 21,A01,084009,Staff,0,32,50,50
1650097993721,CSE 30,A01,083370,Cao; Yingjun,0,64,40,40
1650097999747,CSE 100,A01,083372,Cao; Yingjun,0,48,40,40
1650098005778,CSE 101,A01,084011,Staff,0,56,40,40
1650098011804,CSE 141,A01,083374,Eldon; John,0,69,75,75
1650098017835,CSE 141L,A01,083376,Eldon; John,0,75,75,75
1650098023868,CSE 175,A01,084013,Kumar; Rakesh,22,0,25,3
1650098029899,CSE 190,A00,092508,Dubnov; Shlomo,18,0,20,2
1650098035938,ECE 5,A01,084049,Morris; Karcher William,12,0,20,8
1650098041971,ECE 100,A01,084051,Baghdadchi; Saharnaz,0,0,20,20
1650098041971,ECE 100,A02,091916,Baghdadchi; Saharnaz,11,0,20,9
1650098048002,ECE 101,A01,084053,Baghdadchi; Saharnaz,0,0,37,37
1650098048002,ECE 101,A02,084054,Baghdadchi; Saharnaz,27,0,37,10
1650098054028,ECE 107,A01,083390,Staff,26,0,40,14
1650098060053,ECE 148,A01,084056,Silberman; Jack,8,0,12,4
1650098066079,ECE 180,A00,083391,Abi Samra; Nicholas Camill,25,0,30,5
1650098066079,ECE 180,B00,083392,Abi Samra; Nicholas Camill,21,0,30,9
1650098072106,MATH 10B,A01,084110,Staff,0,0,30,30
1650098072106,MATH 10B,A02,084111,Staff,16,0,30,14
1650098072106,MATH 10B,A03,084112,Staff,23,0,30,7
1650098078130,MATH 10C,A01,083443,Staff,0,17,30,31
1650098078130,MATH 10C,A02,083444,Staff,0,18,30,30
1650098078130,MATH 10C,B01,084114,Staff,17,0,30,13
1650098078130,MATH 10C,B02,084115,Staff,24,0,30,6
1650098084161,MATH 18,A01,084117,Harel; Guershon,11,0,30,19
1650098084161,MATH 18,A02,084119,Harel; Guershon,27,0,30,3
1650098084161,MATH 18,A03,084120,Harel; Guershon,30,0,30,0
1650098084161,MATH 18,A04,084121,Harel; Guershon,29,0,30,1
1650098090192,MATH 20B,A01,084124,Um; Ko Woon,10,0,35,25
1650098090192,MATH 20B,B01,084126,Um; Ko Woon,24,0,35,11
1650098096220,MATH 20C,A01,083446,Hammock; Frances H,0,0,30,30
1650098096220,MATH 20C,A02,083447,Hammock; Frances H,13,0,30,17
1650098096220,MATH 20C,A03,083448,Hammock; Frances H,18,0,30,12
1650098096220,MATH 20C,A04,083449,Hammock; Frances H,20,0,30,10
1650098096220,MATH 20C,B01,083451,Hammock; Frances H,0,0,30,30
1650098096220,MATH 20C,B02,083452,Hammock; Frances H,15,0,30,15
1650098096220,MATH 20C,B03,083453,Hammock; Frances H,19,0,30,11
1650098096220,MATH 20C,B04,083454,Hammock; Frances H,23,0,30,7
1650098102247,MATH 20D,A01,084128,Staff,13,0,30,17
1650098102247,MATH 20D,A02,084129,Staff,29,0,30,1
1650098102247,MATH 20D,A03,084130,Staff,28,0,30,2
1650098102247,MATH 20D,B01,084133,Staff,0,0,30,30
1650098102247,MATH 20D,B02,084134,Staff,23,0,30,7
1650098102247,MATH 20D,B03,084135,Staff,28,0,30,2
1650098108272,MATH 20E,A01,084138,Staff,13,0,30,17
1650098108272,MATH 20E,A02,084139,Staff,6,0,30,24
1650098108272,MATH 20E,A03,084140,Staff,14,0,30,16
1650098108272,MATH 20E,A04,084141,Staff,19,0,30,11
1650098114303,MATH 102,A01,084143,Harel; Guershon,11,0,30,19
1650098114303,MATH 102,A02,084144,Harel; Guershon,18,0,30,12
1650098120326,MATH 103B,A01,083456,Staff,0,13,30,30
1650098120326,MATH 103B,A02,083457,Staff,0,14,30,30
1650098126358,MATH 109,A01,084146,Salehi Golsefidy; Alireza,16,0,30,14
1650098126358,MATH 109,A02,084147,Salehi Golsefidy; Alireza,15,0,30,15
1650098132389,MATH 120A,A01,085445,Eggers; John Dietrich,6,0,35,29
1650098132389,MATH 120A,A02,085446,Eggers; John Dietrich,26,0,35,9
1650098138414,MATH 142B,A01,084149,Verstraete; Jacques Allan,0,12,30,30
1650098138414,MATH 142B,A02,084150,Verstraete; Jacques Allan,0,12,30,30
1650098144438,MATH 170A,A01,083459,Nie; Jiawang,0,11,30,30
1650098144438,MATH 170A,A02,083460,Nie; Jiawang,0,10,30,30
1650098144438,MATH 170A,A03,083461,Nie; Jiawang,0,11,30,30
1650098150463,MATH 193B,A01,083463,Staff,1,0,30,29
1650098150463,MATH 193B,A02,083464,Staff,8,0,30,22
1650098150463,MATH 193B,A03,083465,Staff,16,0,30,14
1650098156534,COGS 2,A01,083966,Boyle; Mary E. T.,9,0,30,21
1650098162558,COGS 9,A01,083968,Staff,2,0,60,58
1650098168584,COGS 14B,A01,083970,Staff,7,0,50,43
1650098174607,COGS 17,A01,092679,Staff,49,0,75,26
1650098180632,COGS 100,A01,083972,Staff,0,20,60,60
1650098192682,COGS 101C,A01,083976,Staff,12,0,30,18
1650098198707,COGS 102A,A01,083978,Johnson; Christine M.,8,0,30,22
1650098204732,COGS 107B,A01,083980,Staff,0,9,50,50
1650098210759,COGS 115,A01,083982,Staff,9,0,30,21
1650098216788,COGS 118B,A01,083367,Staff,0,16,40,40
1650098222826,COGS 172,A01,083984,Provenzano; Emily Kara,13,0,30,17
1650098228854,COGS 177,A00,083368,Staff,0,22,30,30
1650098234883,COGS 186,A01,083986,Staff,22,0,40,18
1650098240907,COGS 187A,A01,083988,Boyle; Mary E. T.,15,0,60,45
1650098246939,CSE 8A,A50,084003,Miranda; Gregory Joseph,0,19,15,15
1650098252964,CSE 11,A01,084005,Miranda; Gregory Joseph,0,24,55,55
1650098258989,CSE 20,A01,084007,Staff,0,5,20,20
1650098265015,CSE 21,A01,084009,Staff,0,32,50,50
1650098271040,CSE 30,A01,083370,Cao; Yingjun,0,64,40,40
1650098277069,CSE 100,A01,083372,Cao; Yingjun,0,48,40,40
1650098283093,CSE 101,A01,084011,Staff,0,56,40,40
1650098289122,CSE 141,A01,083374,Eldon; John,0,69,75,75
1650098295146,CSE 141L,A01,083376,Eldon; John,0,75,75,75
1650098301172,CSE 175,A01,084013,Kumar; Rakesh,22,0,25,3
1650098307196,CSE 190,A00,092508,Dubnov; Shlomo,18,0,20,2
1650098313223,ECE 5,A01,084049,Morris; Karcher William,12,0,20,8
1650098319248,ECE 100,A01,084051,Baghdadchi; Saharnaz,0,0,20,20
1650098319248,ECE 100,A02,091916,Baghdadchi; Saharnaz,11,0,20,9
1650098325273,ECE 101,A01,084053,Baghdadchi; Saharnaz,0,0,37,37
1650098325273,ECE 101,A02,084054,Baghdadchi; Saharnaz,27,0,37,10
1650098331299,ECE 107,A01,083390,Staff,26,0,40,14
1650098337326,ECE 148,A01,084056,Silberman; Jack,8,0,12,4
1650098343354,ECE 180,A00,083391,Abi Samra; Nicholas Camill,25,0,30,5
1650098343354,ECE 180,B00,083392,Abi Samra; Nicholas Camill,21,0,30,9
1650098349380,MATH 10B,A01,084110,Staff,0,0,30,30
1650098349380,MATH 10B,A02,084111,Staff,16,0,30,14
1650098349380,MATH 10B,A03,084112,Staff,23,0,30,7
1650098355411,MATH 10C,A01,083443,Staff,0,17,30,31
1650098355411,MATH 10C,A02,083444,Staff,0,18,30,30
1650098355411,MATH 10C,B01,084114,Staff,17,0,30,13
1650098355411,MATH 10C,B02,084115,Staff,24,0,30,6
1650098361443,MATH 18,A01,084117,Harel; Guershon,11,0,30,19
1650098361443,MATH 18,A02,084119,Harel; Guershon,27,0,30,3
1650098361443,MATH 18,A03,084120,Harel; Guershon,30,0,30,0
1650098361443,MATH 18,A04,084121,Harel; Guershon,29,0,30,1
1650098367469,MATH 20B,A01,084124,Um; Ko Woon,10,0,35,25
1650098367469,MATH 20B,B01,084126,Um; Ko Woon,24,0,35,11
1650098373495,MATH 20C,A01,083446,Hammock; Frances H,0,0,30,30
1650098373495,MATH 20C,A02,083447,Hammock; Frances H,13,0,30,17
1650098373495,MATH 20C,A03,083448,Hammock; Frances H,18,0,30,12
1650098373495,MATH 20C,A04,083449,Hammock; Frances H,20,0,30,10
1650098373495,MATH 20C,B01,083451,Hammock; Frances H,0,0,30,30
1650098373495,MATH 20C,B02,083452,Hammock; Frances H,15,0,30,15
1650098373495,MATH 20C,B03,083453,Hammock; Frances H,19,0,30,11
1650098373495,MATH 20C,B04,083454,Hammock; Frances H,23,0,30,7
1650098379521,MATH 20D,A01,084128,Staff,13,0,30,17
1650098379521,MATH 20D,A02,084129,Staff,29,0,30,1
1650098379521,MATH 20D,A03,084130,Staff,28,0,30,2
1650098379521,MATH 20D,B01,084133,Staff,0,0,30,30
1650098379521,MATH 20D,B02,084134,Staff,23,0,30,7
1650098379521,MATH 20D,B03,084135,Staff,28,0,30,2
1650098385547,MATH 20E,A01,084138,Staff,13,0,30,17
1650098385547,MATH 20E,A02,084139,Staff,6,0,30,24
1650098385547,MATH 20E,A03,084140,Staff,14,0,30,16
1650098385547,MATH 20E,A04,084141,Staff,19,0,30,11
1650098391573,MATH 102,A01,084143,Harel; Guershon,11,0,30,19
1650098391573,MATH 102,A02,084144,Harel; Guershon,18,0,30,12
1650098397598,MATH 103B,A01,083456,Staff,0,13,30,30
1650098397598,MATH 103B,A02,083457,Staff,0,14,30,30
1650098403625,MATH 109,A01,084146,Salehi Golsefidy; Alireza,16,0,30,14
1650098403625,MATH 109,A02,084147,Salehi Golsefidy; Alireza,15,0,30,15
1650098409650,MATH 120A,A01,085445,Eggers; John Dietrich,6,0,35,29
1650098409650,MATH 120A,A02,085446,Eggers; John Dietrich,26,0,35,9
1650098415677,MATH 142B,A01,084149,Verstraete; Jacques Allan,0,12,30,30
1650098415677,MATH 142B,A02,084150,Verstraete; Jacques Allan,0,12,30,30
1650098421703,MATH 170A,A01,083459,Nie; Jiawang,0,11,30,30
1650098421703,MATH 170A,A02,083460,Nie; Jiawang,0,10,30,30
1650098421703,MATH 170A,A03,083461,Nie; Jiawang,0,11,30,30
1650098427733,MATH 193B,A01,083463,Staff,1,0,30,29
1650098427733,MATH 193B,A02,083464,Staff,8,0,30,22
1650098427733,MATH 193B,A03,083465,Staff,16,0,30,14
1650098433875,COGS 2,A01,083966,Boyle; Mary E. T.,9,0,30,21
1650098439900,COGS 9,A01,083968,Staff,2,0,60,58
1650098445924,COGS 14B,A01,083970,Staff,7,0,50,43
1650098451949,COGS 17,A01,092679,Staff,49,0,75,26
1650098457972,COGS 100,A01,083972,Staff,0,20,60,60
1650098470034,COGS 101C,A01,083976,Staff,12,0,30,18
1650098476069,COGS 102A,A01,083978,Johnson; Christine M.,8,0,30,22
1650098482094,COGS 107B,A01,083980,Staff,0,9,50,50
1650098488128,COGS 115,A01,083982,Staff,9,0,30,21
1650098494153,COGS 118B,A01,083367,Staff,0,16,40,40
1650098500179,COGS 172,A01,083984,Provenzano; Emily Kara,13,0,30,17
1650098506207,COGS 177,A00,083368,Staff,0,22,30,30
1650098512238,COGS 186,A01,083986,Staff,22,0,40,18
1650098518267,COGS 187A,A01,083988,Boyle; Mary E. T.,15,0,60,45
1650098524297,CSE 8A,A50,084003,Miranda; Gregory Joseph,0,19,15,15
1650098530329,CSE 11,A01,084005,Miranda; Gregory Joseph,0,24,55,55
1650098536355,CSE 20,A01,084007,Staff,0,5,20,20
1650098542380,CSE 21,A01,084009,Staff,0,32,50,50
1650098548410,CSE 30,A01,083370,Cao; Yingjun,0,64,40,40
1650098554435,CSE 100,A01,083372,Cao; Yingjun,0,48,40,40
1650098560459,CSE 101,A01,084011,Staff,0,56,40,40
1650098566489,CSE 141,A01,083374,Eldon; John,0,69,75,75
1650098572520,CSE 141L,A01,083376,Eldon; John,0,75,75,75
1650098578548,CSE 175,A01,084013,Kumar; Rakesh,22,0,25,3
1650098584580,CSE 190,A00,092508,Dubnov; Shlomo,18,0,20,2
1650098590623,ECE 5,A01,084049,Morris; Karcher William,12,0,20,8
1650098596651,ECE 100,A01,084051,Baghdadchi; Saharnaz,0,0,20,20
1650098596651,ECE 100,A02,091916,Baghdadchi; Saharnaz,11,0,20,9
1650098602682,ECE 101,A01,084053,Baghdadchi; Saharnaz,0,0,37,37
1650098602682,ECE 101,A02,084054,Baghdadchi; Saharnaz,27,0,37,10
1650099578304,ECE 148,A01,084056,Silberman; Jack,8,0,12,4
1650099584334,ECE 180,A00,083391,Abi Samra; Nicholas Camill,25,0,30,5
1650099584334,ECE 180,B00,083392,Abi Samra; Nicholas Camill,21,0,30,9
1650099590364,MATH 10B,A01,084110,Staff,0,0,30,30
1650099590364,MATH 10B,A02,084111,Staff,16,0,30,14
1650099590364,MATH 10B,A03,084112,Staff,23,0,30,7
1650099596392,MATH 10C,A01,083443,Staff,0,17,30,31
1650099596392,MATH 10C,A02,083444,Staff,0,18,30,30
1650099596392,MATH 10C,B01,084114,Staff,17,0,30,13
1650099596392,MATH 10C,B02,084115,Staff,24,0,30,6
1650099602420,MATH 18,A01,084117,Harel; Guershon,11,0,30,19
1650099602420,MATH 18,A02,084119,Harel; Guershon,27,0,30,3
1650099602420,MATH 18,A03,084120,Harel; Guershon,30,0,30,0
1650099602420,MATH 18,A04,084121,Harel; Guershon,28,0,30,2
1650099608449,MATH 20B,A01,084124,Um; Ko Woon,10,0,35,25
1650099608449,MATH 20B,B01,084126,Um; Ko Woon,24,0,35,11
1650099614475,MATH 20C,A01,083446,Hammock; Frances H,0,0,30,30
1650099614475,MATH 20C,A02,083447,Hammock; Frances H,12,0,30,18
1650099614475,MATH 20C,A03,083448,Hammock; Frances H,18,0,30,12
1650099614475,MATH 20C,A04,083449,Hammock; Frances H,20,0,30,10
1650099614475,MATH 20C,B01,083451,Hammock; Frances H,0,0,30,30
1650099614475,MATH 20C,B02,083452,Hammock; Frances H,15,0,30,15
1650099614475,MATH 20C,B03,083453,Hammock; Frances H,19,0,30,11
1650099614475,MATH 20C,B04,083454,Hammock; Frances H,23,0,30,7
1650099620504,MATH 20D,A01,084128,Staff,13,0,30,17
1650099620504,MATH 20D,A02,084129,Staff,29,0,30,1
1650099620504,MATH 20D,A03,084130,Staff,28,0,30,2
1650099620504,MATH 20D,B01,084133,Staff,0,0,30,30
1650099620504,MATH 20D,B02,084134,Staff,23,0,30,7
1650099620504,MATH 20D,B03,084135,Staff,28,0,30,2
1650099626527,MATH 20E,A01,084138,Staff,13,0,30,17
1650099626527,MATH 20E,A02,084139,Staff,6,0,30,24
1650099626527,MATH 20E,A03,084140,Staff,14,0,30,16
1650099626527,MATH 20E,A04,084141,Staff,19,0,30,11
1650099632552,MATH 102,A01,084143,Harel; Guershon,11,0,30,19
1650099632552,MATH 102,A02,084144,Harel; Guershon,18,0,30,12
1650099638575,MATH 103B,A01,083456,Staff,0,13,30,30
1650099638575,MATH 103B,A02,083457,Staff,0,14,30,30
1650099644598,MATH 109,A01,084146,Salehi Golsefidy; Alireza,16,0,30,14
1650099644598,MATH 109,A02,084147,Salehi Golsefidy; Alireza,15,0,30,15
1650099650626,MATH 120A,A01,085445,Eggers; John Dietrich,6,0,35,29
1650099650626,MATH 120A,A02,085446,Eggers; John Dietrich,26,0,35,9
1650099656651,MATH 142B,A01,084149,Verstraete; Jacques Allan,0,12,30,30
1650099656651,MATH 142B,A02,084150,Verstraete; Jacques Allan,0,12,30,30
1650099662674,MATH 170A,A01,083459,Nie; Jiawang,0,11,30,30
1650099662674,MATH 170A,A02,083460,Nie; Jiawang,0,10,30,30
1650099662674,MATH 170A,A03,083461,Nie; Jiawang,0,11,30,30
1650099668699,MATH 193B,A01,083463,Staff,1,0,30,29
1650099668699,MATH 193B,A02,083464,Staff,8,0,30,22
1650099668699,MATH 193B,A03,083465,Staff,16,0,30,14
1650099674756,COGS 2,A01,083966,Boyle; Mary E. T.,9,0,30,21
1650099680787,COGS 9,A01,083968,Staff,2,0,60,58
1650099686817,COGS 14B,A01,083970,Staff,7,0,50,43
1650099692841,COGS 17,A01,092679,Staff,49,0,75,26
1650099698868,COGS 100,A01,083972,Staff,0,20,60,60
1650099710927,COGS 101C,A01,083976,Staff,12,0,30,18
1650099716959,COGS 102A,A01,083978,Johnson; Christine M.,8,0,30,22
1650099722985,COGS 107B,A01,083980,Staff,0,9,50,50
1650099729010,COGS 115,A01,083982,Staff,9,0,30,21
1650099735037,COGS 118B,A01,083367,Staff,0,16,40,40
1650099741064,COGS 172,A01,083984,Provenzano; Emily Kara,13,0,30,17
1650099747090,COGS 177,A00,083368,Staff,0,22,30,30
1650099753128,COGS 186,A01,083986,Staff,22,0,40,18
1650099759152,COGS 187A,A01,083988,Boyle; Mary E. T.,15,0,60,45
1650099765184,CSE 8A,A50,084003,Miranda; Gregory Joseph,0,19,15,15
1650099771208,CSE 11,A01,084005,Miranda; Gregory Joseph,0,25,55,55
1650099777233,CSE 20,A01,084007,Staff,0,5,20,20
1650099783274,CSE 21,A01,084009,Staff,0,32,50,50
1650099789303,CSE 30,A01,083370,Cao; Yingjun,0,64,40,40
1650099795328,CSE 100,A01,083372,Cao; Yingjun,0,48,40,40
1650099801356,CSE 101,A01,084011,Staff,0,56,40,40
1650099807381,CSE 141,A01,083374,Eldon; John,0,69,75,75
1650099813406,CSE 141L,A01,083376,Eldon; John,0,75,75,75
1650099819434,CSE 175,A01,084013,Kumar; Rakesh,22,0,25,3
1650099825464,CSE 190,A00,092508,Dubnov; Shlomo,18,0,20,2
1650099831489,ECE 5,A01,084049,Morris; Karcher William,12,0,20,8
1650099837514,ECE 100,A01,084051,Baghdadchi; Saharnaz,0,0,20,20
1650099837514,ECE 100,A02,091916,Baghdadchi; Saharnaz,11,0,20,9
1650099843563,ECE 101,A01,084053,Baghdadchi; Saharnaz,0,0,37,37
1650099843563,ECE 101,A02,084054,Baghdadchi; Saharnaz,27,0,37,10
1650099849592,ECE 107,A01,083390,Staff,26,0,40,14
1650099855621,ECE 148,A01,084056,Silberman; Jack,8,0,12,4
1650099861652,ECE 180,A00,083391,Abi Samra; Nicholas Camill,25,0,30,5
1650099861652,ECE 180,B00,083392,Abi Samra; Nicholas Camill,21,0,30,9
1650099867681,MATH 10B,A01,084110,Staff,0,0,30,30
1650099867681,MATH 10B,A02,084111,Staff,16,0,30,14
1650099867681,MATH 10B,A03,084112,Staff,23,0,30,7
1650099873712,MATH 10C,A01,083443,Staff,0,17,30,31
1650099873712,MATH 10C,A02,083444,Staff,0,18,30,30
1650099873712,MATH 10C,B01,084114,Staff,17,0,30,13
1650099873712,MATH 10C,B02,084115,Staff,24,0,30,6
1650099879742,MATH 18,A01,084117,Harel; Guershon,11,0,30,19
1650099879742,MATH 18,A02,084119,Harel; Guershon,27,0,30,3
1650099879742,MATH 18,A03,084120,Harel; Guershon,30,0,30,0
1650099879742,MATH 18,A04,084121,Harel; Guershon,29,0,30,1
1650099885772,MATH 20B,A01,084124,Um; Ko Woon,10,0,35,25
1650099885772,MATH 20B,B01,084126,Um; Ko Woon,24,0,35,11
1650099891807,MATH 20C,A01,083446,Hammock; Frances H,0,0,30,30
1650099891807,MATH 20C,A02,083447,Hammock; Frances H,12,0,30,18
1650099891807,MATH 20C,A03,083448,Hammock; Frances H,18,0,30,12
1650099891807,MATH 20C,A04,083449,Hammock; Frances H,20,0,30,10
1650099891807,MATH 20C,B01,083451,Hammock; Frances H,0,0,30,30
1650099891807,MATH 20C,B02,083452,Hammock; Frances H,15,0,30,15
1650099891807,MATH 20C,B03,083453,Hammock; Frances H,19,0,30,11
1650099891807,MATH 20C,B04,083454,Hammock; Frances H,23,0,30,7
1650099897837,MATH 20D,A01,084128,Staff,13,0,30,17
1650099897837,MATH 20D,A02,084129,Staff,29,0,30,1
1650099897837,MATH 20D,A03,084130,Staff,28,0,30,2
1650099897837,MATH 20D,B01,084133,Staff,0,0,30,30
1650099897837,MATH 20D,B02,084134,Staff,23,0,30,7
1650099897837,MATH 20D,B03,084135,Staff,28,0,30,2
1650099903864,MATH 20E,A01,084138,Staff,13,0,30,17
1650099903864,MATH 20E,A02,084139,Staff,6,0,30,24
1650099903864,MATH 20E,A03,084140,Staff,14,0,30,16
1650099903864,MATH 20E,A04,084141,Staff,19,0,30,11
1650099909890,MATH 102,A01,084143,Harel; Guershon,11,0,30,19
1650099909890,MATH 102,A02,084144,Harel; Guershon,18,0,30,12
1650099915916,MATH 103B,A01,083456,Staff,0,13,30,30
1650099915916,MATH 103B,A02,083457,Staff,0,14,30,30
1650099921946,MATH 109,A01,084146,Salehi Golsefidy; Alireza,16,0,30,14
1650099921946,MATH 109,A02,084147,Salehi Golsefidy; Alireza,15,0,30,15
1650099927971,MATH 120A,A01,085445,Eggers; John Dietrich,6,0,35,29
1650099927971,MATH 120A,A02,085446,Eggers; John Dietrich,26,0,35,9
1650099933999,MATH 142B,A01,084149,Verstraete; Jacques Allan,0,12,30,30
1650099933999,MATH 142B,A02,084150,Verstraete; Jacques Allan,0,12,30,30
1650099940027,MATH 170A,A01,083459,Nie; Jiawang,0,11,30,30
1650099940027,MATH 170A,A02,083460,Nie; Jiawang,0,10,30,30
1650099940027,MATH 170A,A03,083461,Nie; Jiawang,0,11,30,30
1650099946052,MATH 193B,A01,083463,Staff,1,0,30,29
1650099946052,MATH 193B,A02,083464,Staff,8,0,30,22
1650099946052,MATH 193B,A03,083465,Staff,16,0,30,14
1650099952118,COGS 2,A01,083966,Boyle; Mary E. T.,9,0,30,21
1650099958143,COGS 9,A01,083968,Staff,2,0,60,58
1650099964173,COGS 14B,A01,083970,Staff,7,0,50,43
1650099970197,COGS 17,A01,092679,Staff,49,0,75,26
1650099976224,COGS 100,A01,083972,Staff,0,20,60,60
1650099988274,COGS 101C,A01,083976,Staff,12,0,30,18
1650099994297,COGS 102A,A01,083978,Johnson; Christine M.,8,0,30,22
1650100000325,COGS 107B,A01,083980,Staff,0,9,50,50
1650100006349,COGS 115,A01,083982,Staff,9,0,30,21
1650100012377,COGS 118B,A01,083367,Staff,0,16,40,40
1650100018405,COGS 172,A01,083984,Provenzano; Emily Kara,13,0,30,17
1650100024428,COGS 177,A00,083368,Staff,0,22,30,30
1650100030453,COGS 186,A01,083986,Staff,22,0,40,18
1650100036477,COGS 187A,A01,083988,Boyle; Mary E. T.,15,0,60,45
1650100042507,CSE 8A,A50,084003,Miranda; Gregory Joseph,0,19,15,15
1650100048535,CSE 11,A01,084005,Miranda; Gregory Joseph,0,25,55,55
1650100054560,CSE 20,A01,084007,Staff,0,5,20,20
1650100060588,CSE 21,A01,084009,Staff,0,32,50,50
1650100066617,CSE 30,A01,083370,Cao; Yingjun,0,64,40,40
1650100072641,CSE 100,A01,083372,Cao; Yingjun,0,48,40,40
1650100078670,CSE 101,A01,084011,Staff,0,56,40,40
1650100084698,CSE 141,A01,083374,Eldon; John,0,69,75,75
1650100090722,CSE 141L,A01,083376,Eldon; John,0,75,75,75
1650100096747,CSE 175,A01,084013,Kumar; Rakesh,22,0,25,3
1650100102774,CSE 190,A00,092508,Dubnov; Shlomo,18,0,20,2
1650100108802,ECE 5,A01,084049,Morris; Karcher William,12,0,20,8
1650100114833,ECE 100,A01,084051,Baghdadchi; Saharnaz,0,0,20,20
1650100114833,ECE 100,A02,091916,Baghdadchi; Saharnaz,11,0,20,9
1650100120857,ECE 101,A01,084053,Baghdadchi; Saharnaz,0,0,37,37
1650100120857,ECE 101,A02,084054,Baghdadchi; Saharnaz,27,0,37,10
1650100126881,ECE 107,A01,083390,Staff,26,0,40,14
1650100132907,ECE 148,A01,084056,Silberman; Jack,8,0,12,4
1650100138935,ECE 180,A00,083391,Abi Samra; Nicholas Camill,25,0,30,5
1650100138935,ECE 180,B00,083392,Abi Samra; Nicholas Camill,21,0,30,9
1650100144972,MATH 10B,A01,084110,Staff,0,0,30,30
1650100144972,MATH 10B,A02,084111,Staff,16,0,30,14
1650100144972,MATH 10B,A03,084112,Staff,23,0,30,7
1650100151000,MATH 10C,A01,083443,Staff,0,17,30,31
1650100151000,MATH 10C,A02,083444,Staff,0,18,30,30
1650100151000,MATH 10C,B01,084114,Staff,17,0,30,13
1650100151000,MATH 10C,B02,084115,Staff,24,0,30,6
1650100157025,MATH 18,A01,084117,Harel; Guershon,11,0,30,19
1650100157025,MATH 18,A02,084119,Harel; Guershon,27,0,30,3
1650100157025,MATH 18,A03,084120,Harel; Guershon,30,0,30,0
1650100157025,MATH 18,A04,084121,Harel; Guershon,29,0,30,1
1650100163055,MATH 20B,A01,084124,Um; Ko Woon,10,0,35,25
1650100163055,MATH 20B,B01,084126,Um; Ko Woon,24,0,35,11
1650100169081,MATH 20C,A01,083446,Hammock; Frances H,0,0,30,30
1650100169081,MATH 20C,A02,083447,Hammock; Frances H,12,0,30,18
1650100169081,MATH 20C,A03,083448,Hammock; Frances H,18,0,30,12
1650100169081,MATH 20C,A04,083449,Hammock; Frances H,20,0,30,10
1650100169081,MATH 20C,B01,083451,Hammock; Frances H,0,0,30,30
1650100169081,MATH 20C,B02,083452,Hammock; Frances H,14,0,30,16
1650100169081,MATH 20C,B03,083453,Hammock; Frances H,19,0,30,11
1650100169081,MATH 20C,B04,083454,Hammock; Frances H,23,0,30,7
1650100175203,MATH 20D,A01,084128,Staff,13,0,30,17
1650100175203,MATH 20D,A02,084129,Staff,29,0,30,1
1650100175203,MATH 20D,A03,084130,Staff,28,0,30,2
1650100175203,MATH 20D,B01,084133,Staff,0,0,30,30
1650100175203,MATH 20D,B02,084134,Staff,23,0,30,7
1650100175203,MATH 20D,B03,084135,Staff,28,0,30,2
1650100181241,MATH 20E,A01,084138,Staff,13,0,30,17
1650100181241,MATH 20E,A02,084139,Staff,6,0,30,24
1650100181241,MATH 20E,A03,084140,Staff,14,0,30,16
1650100181241,MATH 20E,A04,084141,Staff,19,0,30,11
1650100187264,MATH 102,A01,084143,Harel; Guershon,11,0,30,19
1650100187264,MATH 102,A02,084144,Harel; Guershon,18,0,30,12
1650100193289,MATH 103B,A01,083456,Staff,0,13,30,30
1650100193289,MATH 103B,A02,083457,Staff,0,14,30,30
1650100199315,MATH 109,A01,084146,Salehi Golsefidy; Alireza,16,0,30,14
1650100199315,MATH 109,A02,084147,Salehi Golsefidy; Alireza,15,0,30,15
1650100205352,MATH 120A,A01,085445,Eggers; John Dietrich,6,0,35,29
1650100205352,MATH 120A,A02,085446,Eggers; John Dietrich,26,0,35,9
1650100211376,MATH 142B,A01,084149,Verstraete; Jacques Allan,0,12,30,30
1650100211376,MATH 142B,A02,084150,Verstraete; Jacques Allan,0,12,30,30
1650100217406,MATH 170A,A01,083459,Nie; Jiawang,0,11,30,30
1650100217406,MATH 170A,A02,083460,Nie; Jiawang,0,10,30,30
1650100217406,MATH 170A,A03,083461,Nie; Jiawang,0,11,30,30
1650100223431,MATH 193B,A01,083463,Staff,1,0,30,29
1650100223431,MATH 193B,A02,083464,Staff,8,0,30,22
1650100223431,MATH 193B,A03,083465,Staff,16,0,30,14
1650100229501,COGS 2,A01,083966,Boyle; Mary E. T.,9,0,30,21
1650100235525,COGS 9,A01,083968,Staff,2,0,60,58
1650100241553,COGS 14B,A01,083970,Staff,7,0,50,43
1650100247577,COGS 17,A01,092679,Staff,49,0,75,26
1650100253600,COGS 100,A01,083972,Staff,0,20,60,60
1650100265653,COGS 101C,A01,083976,Staff,12,0,30,18
1650100271677,COGS 102A,A01,083978,Johnson; Christine M.,8,0,30,22
1650100277699,COGS 107B,A01,083980,Staff,0,9,50,50
1650100283729,COGS 115,A01,083982,Staff,9,0,30,21
1650100289753,COGS 118B,A01,083367,Staff,0,16,40,40
1650100295782,COGS 172,A01,083984,Provenzano; Emily Kara,13,0,30,17
1650100301812,COGS 177,A00,083368,Staff,0,22,30,30
1650100307841,COGS 186,A01,083986,Staff,22,0,40,18
1650100313868,COGS 187A,A01,083988,Boyle; Mary E. T.,15,0,60,45
1650100319892,CSE 8A,A50,084003,Miranda; Gregory Joseph,0,19,15,15
1650100325916,CSE 11,A01,084005,Miranda; Gregory Joseph,0,25,55,55
1650100331941,CSE 20,A01,084007,Staff,0,5,20,20
1650100337965,CSE 21,A01,084009,Staff,0,32,50,50
1650100343993,CSE 30,A01,083370,Cao; Yingjun,0,64,40,40
1650100350016,CSE 100,A01,083372,Cao; Yingjun,0,48,40,40
1650100356040,CSE 101,A01,084011,Staff,0,56,40,40
1650100362064,CSE 141,A01,083374,Eldon; John,0,69,75,75
1650100368087,CSE 141L,A01,083376,Eldon; John,0,75,75,75
1650100374110,CSE 175,A01,084013,Kumar; Rakesh,22,0,25,3
1650100380135,CSE 190,A00,092508,Dubnov; Shlomo,18,0,20,2
1650100386158,ECE 5,A01,084049,Morris; Karcher William,12,0,20,8
1650100392181,ECE 100,A01,084051,Baghdadchi; Saharnaz,0,0,20,20
1650100392181,ECE 100,A02,091916,Baghdadchi; Saharnaz,11,0,20,9
1650100398213,ECE 101,A01,084053,Baghdadchi; Saharnaz,0,0,37,37
1650100398213,ECE 101,A02,084054,Baghdadchi; Saharnaz,27,0,37,10
1650100404237,ECE 107,A01,083390,Staff,26,0,40,14
1650100410267,ECE 148,A01,084056,Silberman; Jack,8,0,12,4
1650100416295,ECE 180,A00,083391,Abi Samra; Nicholas Camill,25,0,30,5
1650100416295,ECE 180,B00,083392,Abi Samra; Nicholas Camill,21,0,30,9
1650100422321,MATH 10B,A01,084110,Staff,0,0,30,30
1650100422321,MATH 10B,A02,084111,Staff,16,0,30,14
1650100422321,MATH 10B,A03,084112,Staff,23,0,30,7
1650100428346,MATH 10C,A01,083443,Staff,0,17,30,31
1650100428346,MATH 10C,A02,083444,Staff,0,18,30,30
1650100428346,MATH 10C,B01,084114,Staff,17,0,30,13
1650100428346,MATH 10C,B02,084115,Staff,24,0,30,6
1650100434377,MATH 18,A01,084117,Harel; Guershon,11,0,30,19
1650100434377,MATH 18,A02,084119,Harel; Guershon,27,0,30,3
1650100434377,MATH 18,A03,084120,Harel; Guershon,30,0,30,0
1650100434377,MATH 18,A04,084121,Harel; Guershon,29,0,30,1
1650100440412,MATH 20B,A01,084124,Um; Ko Woon,10,0,35,25
1650100440412,MATH 20B,B01,084126,Um; Ko Woon,24,0,35,11
1650100446438,MATH 20C,A01,083446,Hammock; Frances H,0,0,30,30
1650100446438,MATH 20C,A02,083447,Hammock; Frances H,12,0,30,18
1650100446438,MATH 20C,A03,083448,Hammock; Frances H,18,0,30,12
1650100446438,MATH 20C,A04,083449,Hammock; Frances H,20,0,30,10
1650100446438,MATH 20C,B01,083451,Hammock; Frances H,0,0,30,30
1650100446438,MATH 20C,B02,083452,Hammock; Frances H,14,0,30,16
1650100446438,MATH 20C,B03,083453,Hammock; Frances H,19,0,30,11
1650100446438,MATH 20C,B04,083454,Hammock; Frances H,23,0,30,7
1650100452463,MATH 20D,A01,084128,Staff,13,0,30,17
1650100452463,MATH 20D,A02,084129,Staff,29,0,30,1
1650100452463,MATH 20D,A03,084130,Staff,28,0,30,2
1650100452463,MATH 20D,B01,084133,Staff,0,0,30,30
1650100452463,MATH 20D,B02,084134,Staff,23,0,30,7
1650100452463,MATH 20D,B03,084135,Staff,28,0,30,2
1650100458488,MATH 20E,A01,084138,Staff,13,0,30,17
1650100458488,MATH 20E,A02,084139,Staff,6,0,30,24
1650100458488,MATH 20E,A03,084140,Staff,14,0,30,16
1650100458488,MATH 20E,A04,084141,Staff,19,0,30,11
1650100464511,MATH 102,A01,084143,Harel; Guershon,11,0,30,19
1650100464511,MATH 102,A02,084144,Harel; Guershon,18,0,30,12
1650100470533,MATH 103B,A01,083456,Staff,0,13,30,30
1650100470533,MATH 103B,A02,083457,Staff,0,14,30,30
1650100476559,MATH 109,A01,084146,Salehi Golsefidy; Alireza,16,0,30,14
1650100476559,MATH 109,A02,084147,Salehi Golsefidy; Alireza,15,0,30,15
1650100482586,MATH 120A,A01,085445,Eggers; John Dietrich,6,0,35,29
1650100482586,MATH 120A,A02,085446,Eggers; John Dietrich,26,0,35,9
1650100488612,MATH 142B,A01,084149,Verstraete; Jacques Allan,0,12,30,30
1650100488612,MATH 142B,A02,084150,Verstraete; Jacques Allan,0,12,30,30
1650100494637,MATH 170A,A01,083459,Nie; Jiawang,0,11,30,30
1650100494637,MATH 170A,A02,083460,Nie; Jiawang,0,10,30,30
1650100494637,MATH 170A,A03,083461,Nie; Jiawang,0,11,30,30
1650100500665,MATH 193B,A01,083463,Staff,1,0,30,29
1650100500665,MATH 193B,A02,083464,Staff,8,0,30,22
1650100500665,MATH 193B,A03,083465,Staff,16,0,30,14
1650100506722,COGS 2,A01,083966,Boyle; Mary E. T.,9,0,30,21
1650100512746,COGS 9,A01,083968,Staff,2,0,60,58
1650100518774,COGS 14B,A01,083970,Staff,7,0,50,43
1650100524801,COGS 17,A01,092679,Staff,49,0,75,26
1650100530830,COGS 100,A01,083972,Staff,0,20,60,60
1650100542876,COGS 101C,A01,083976,Staff,12,0,30,18
1650100548903,COGS 102A,A01,083978,Johnson; Christine M.,8,0,30,22
1650100554925,COGS 107B,A01,083980,Staff,0,9,50,50
1650100560949,COGS 115,A01,083982,Staff,9,0,30,21
1650100566972,COGS 118B,A01,083367,Staff,0,16,40,40
1650100573000,COGS 172,A01,083984,Provenzano; Emily Kara,13,0,30,17
1650100579027,COGS 177,A00,083368,Staff,0,22,30,30
1650100585050,COGS 186,A01,083986,Staff,22,0,40,18
1650100591075,COGS 187A,A01,083988,Boyle; Mary E. T.,15,0,60,45
1650100597099,CSE 8A,A50,084003,Miranda; Gregory Joseph,0,19,15,15
1650100603122,CSE 11,A01,084005,Miranda; Gregory Joseph,0,25,55,55
1650100609162,CSE 20,A01,084007,Staff,0,5,20,20
1650100615187,CSE 21,A01,084009,Staff,0,32,50,50
1650100621210,CSE 30,A01,083370,Cao; Yingjun,0,64,40,40
1650100627238,CSE 100,A01,083372,Cao; Yingjun,0,48,40,40
1650100633260,CSE 101,A01,084011,Staff,0,56,40,40
1650100639284,CSE 141,A01,083374,Eldon; John,0,69,75,75
1650100645306,CSE 141L,A01,083376,Eldon; John,0,75,75,75
1650100651331,CSE 175,A01,084013,Kumar; Rakesh,22,0,25,3
1650100657356,CSE 190,A00,092508,Dubnov; Shlomo,18,0,20,2
1650100663386,ECE 5,A01,084049,Morris; Karcher William,12,0,20,8
1650100669409,ECE 100,A01,084051,Baghdadchi; Saharnaz,0,0,20,20
1650100669409,ECE 100,A02,091916,Baghdadchi; Saharnaz,11,0,20,9
1650100675432,ECE 101,A01,084053,Baghdadchi; Saharnaz,0,0,37,37
1650100675432,ECE 101,A02,084054,Baghdadchi; Saharnaz,27,0,37,10
1650100681455,ECE 107,A01,083390,Staff,26,0,40,14
1650100687478,ECE 148,A01,084056,Silberman; Jack,8,0,12,4
1650100693503,ECE 180,A00,083391,Abi Samra; Nicholas Camill,25,0,30,5
1650100693503,ECE 180,B00,083392,Abi Samra; Nicholas Camill,21,0,30,9
1650100699528,MATH 10B,A01,084110,Staff,0,0,30,30
1650100699528,MATH 10B,A02,084111,Staff,16,0,30,14
1650100699528,MATH 10B,A03,084112,Staff,23,0,30,7
1650100705551,MATH 10C,A01,083443,Staff,0,17,30,31
1650100705551,MATH 10C,A02,083444,Staff,0,18,30,30
1650100705551,MATH 10C,B01,084114,Staff,17,0,30,13
1650100705551,MATH 10C,B02,084115,Staff,24,0,30,6
1650100711575,MATH 18,A01,084117,Harel; Guershon,11,0,30,19
1650100711575,MATH 18,A02,084119,Harel; Guershon,27,0,30,3
1650100711575,MATH 18,A03,084120,Harel; Guershon,30,0,30,0
1650100711575,MATH 18,A04,084121,Harel; Guershon,29,0,30,1
1650100717603,MATH 20B,A01,084124,Um; Ko Woon,10,0,35,25
1650100717603,MATH 20B,B01,084126,Um; Ko Woon,24,0,35,11
1650100723628,MATH 20C,A01,083446,Hammock; Frances H,0,0,30,30
1650100723628,MATH 20C,A02,083447,Hammock; Frances H,12,0,30,18
1650100723628,MATH 20C,A03,083448,Hammock; Frances H,18,0,30,12
1650100723628,MATH 20C,A04,083449,Hammock; Frances H,20,0,30,10
1650100723628,MATH 20C,B01,083451,Hammock; Frances H,0,0,30,30
1650100723628,MATH 20C,B02,083452,Hammock; Frances H,14,0,30,16
1650100723628,MATH 20C,B03,083453,Hammock; Frances H,19,0,30,11
1650100723628,MATH 20C,B04,083454,Hammock; Frances H,23,0,30,7
1650100729662,MATH 20D,A01,084128,Staff,13,0,30,17
1650100729662,MATH 20D,A02,084129,Staff,29,0,30,1
1650100729662,MATH 20D,A03,084130,Staff,28,0,30,2
1650100729662,MATH 20D,B01,084133,Staff,0,0,30,30
1650100729662,MATH 20D,B02,084134,Staff,23,0,30,7
1650100729662,MATH 20D,B03,084135,Staff,28,0,30,2
1650100735686,MATH 20E,A01,084138,Staff,13,0,30,17
1650100735686,MATH 20E,A02,084139,Staff,6,0,30,24
1650100735686,MATH 20E,A03,084140,Staff,14,0,30,16
1650100735686,MATH 20E,A04,084141,Staff,19,0,30,11
1650100741710,MATH 102,A01,084143,Harel; Guershon,11,0,30,19
1650100741710,MATH 102,A02,084144,Harel; Guershon,18,0,30,12
1650100747737,MATH 103B,A01,083456,Staff,0,13,30,30
1650100747737,MATH 103B,A02,083457,Staff,0,14,30,30
1650100753764,MATH 109,A01,084146,Salehi Golsefidy; Alireza,16,0,30,14
1650100753764,MATH 109,A02,084147,Salehi Golsefidy; Alireza,15,0,30,15
1650100759788,MATH 120A,A01,085445,Eggers; John Dietrich,6,0,35,29
1650100759788,MATH 120A,A02,085446,Eggers; John Dietrich,26,0,35,9
1650100765812,MATH 142B,A01,084149,Verstraete; Jacques Allan,0,12,30,30
1650100765812,MATH 142B,A02,084150,Verstraete; Jacques Allan,0,12,30,30
1650100771930,MATH 170A,A01,083459,Nie; Jiawang,0,11,30,30
1650100771930,MATH 170A,A02,083460,Nie; Jiawang,0,10,30,30
1650100771930,MATH 170A,A03,083461,Nie; Jiawang,0,11,30,30
1650100777958,MATH 193B,A01,083463,Staff,1,0,30,29
1650100777958,MATH 193B,A02,083464,Staff,8,0,30,22
1650100777958,MATH 193B,A03,083465,Staff,16,0,30,14
1650100784010,COGS 2,A01,083966,Boyle; Mary E. T.,9,0,30,21
1650100790035,COGS 9,A01,083968,Staff,2,0,60,58
1650100796058,COGS 14B,A01,083970,Staff,7,0,50,43
1650100802081,COGS 17,A01,092679,Staff,49,0,75,26
1650100808104,COGS 100,A01,083972,Staff,0,20,60,60
1650100820157,COGS 101C,A01,083976,Staff,12,0,30,18
1650100826183,COGS 102A,A01,083978,Johnson; Christine M.,8,0,30,22
1650100832209,COGS 107B,A01,083980,Staff,0,9,50,50
1650100838231,COGS 115,A01,083982,Staff,9,0,30,21
1650100844254,COGS 118B,A01,083367,Staff,0,16,40,40
1650100850278,COGS 172,A01,083984,Provenzano; Emily Kara,13,0,30,17
1650100856301,COGS 177,A00,083368,Staff,0,22,30,30
1650100862328,COGS 186,A01,083986,Staff,22,0,40,18
1650100868352,COGS 187A,A01,083988,Boyle; Mary E. T.,15,0,60,45
1650100874383,CSE 8A,A50,084003,Miranda; Gregory Joseph,0,19,15,15
1650100880411,CSE 11,A01,084005,Miranda; Gregory Joseph,0,25,55,55
1650100886437,CSE 20,A01,084007,Staff,0,5,20,20
1650100892462,CSE 21,A01,084009,Staff,0,32,50,50
1650100898486,CSE 30,A01,083370,Cao; Yingjun,0,64,40,40
1650100904512,CSE 100,A01,083372,Cao; Yingjun,0,48,40,40
1650100910537,CSE 101,A01,084011,Staff,0,56,40,40
1650100916561,CSE 141,A01,083374,Eldon; John,0,69,75,75
1650100922585,CSE 141L,A01,083376,Eldon; John,0,75,75,75
1650100928611,CSE 175,A01,084013,Kumar; Rakesh,22,0,25,3
1650100934642,CSE 190,A00,092508,Dubnov; Shlomo,18,0,20,2
1650100940668,ECE 5,A01,084049,Morris; Karcher William,12,0,20,8
1650100946695,ECE 100,A01,084051,Baghdadchi; Saharnaz,0,0,20,20
1650100946695,ECE 100,A02,091916,Baghdadchi; Saharnaz,11,0,20,9
1650100952722,ECE 101,A01,084053,Baghdadchi; Saharnaz,0,0,37,37
1650100952722,ECE 101,A02,084054,Baghdadchi; Saharnaz,27,0,37,10
1650100958746,ECE 107,A01,083390,Staff,26,0,40,14
1650100964769,ECE 148,A01,084056,Silberman; Jack,8,0,12,4
1650100970796,ECE 180,A00,083391,Abi Samra; Nicholas Camill,25,0,30,5
1650100970796,ECE 180,B00,083392,Abi Samra; Nicholas Camill,21,0,30,9
1650100976818,MATH 10B,A01,084110,Staff,0,0,30,30
1650100976818,MATH 10B,A02,084111,Staff,16,0,30,14
1650100976818,MATH 10B,A03,084112,Staff,23,0,30,7
1650100982846,MATH 10C,A01,083443,Staff,0,17,30,31
1650100982846,MATH 10C,A02,083444,Staff,0,18,30,30
1650100982846,MATH 10C,B01,084114,Staff,17,0,30,13
1650100982846,MATH 10C,B02,084115,Staff,24,0,30,6
1650100988869,MATH 18,A01,084117,Harel; Guershon,11,0,30,19
1650100988869,MATH 18,A02,084119,Harel; Guershon,27,0,30,3
1650100988869,MATH 18,A03,084120,Harel; Guershon,30,0,30,0
1650100988869,MATH 18,A04,084121,Harel; Guershon,29,0,30,1
1650100994893,MATH 20B,A01,084124,Um; Ko Woon,10,0,35,25
1650100994893,MATH 20B,B01,084126,Um; Ko Woon,24,0,35,11
1650101000925,MATH 20C,A01,083446,Hammock; Frances H,0,0,30,30
1650101000925,MATH 20C,A02,083447,Hammock; Frances H,12,0,30,18
1650101000925,MATH 20C,A03,083448,Hammock; Frances H,18,0,30,12
1650101000925,MATH 20C,A04,083449,Hammock; Frances H,20,0,30,10
1650101000925,MATH 20C,B01,083451,Hammock; Frances H,0,0,30,30
1650101000925,MATH 20C,B02,083452,Hammock; Frances H,14,0,30,16
1650101000925,MATH 20C,B03,083453,Hammock; Frances H,19,0,30,11
1650101000925,MATH 20C,B04,083454,Hammock; Frances H,23,0,30,7
1650101006947,MATH 20D,A01,084128,Staff,13,0,30,17
1650101006947,MATH 20D,A02,084129,Staff,29,0,30,1
1650101006947,MATH 20D,A03,084130,Staff,28,0,30,2
1650101006947,MATH 20D,B01,084133,Staff,0,0,30,30
1650101006947,MATH 20D,B02,084134,Staff,23,0,30,7
1650101006947,MATH 20D,B03,084135,Staff,28,0,30,2
1650101012974,MATH 20E,A01,084138,Staff,13,0,30,17
1650101012974,MATH 20E,A02,084139,Staff,6,0,30,24
1650101012974,MATH 20E,A03,084140,Staff,14,0,30,16
1650101012974,MATH 20E,A04,084141,Staff,19,0,30,11
1650101018998,MATH 102,A01,084143,Harel; Guershon,11,0,30,19
1650101018998,MATH 102,A02,084144,Harel; Guershon,18,0,30,12
1650101025025,MATH 103B,A01,083456,Staff,0,13,30,30
1650101025025,MATH 103B,A02,083457,Staff,0,14,30,30
1650101031051,MATH 109,A01,084146,Salehi Golsefidy; Alireza,16,0,30,14
1650101031051,MATH 109,A02,084147,Salehi Golsefidy; Alireza,15,0,30,15
1650101037089,MATH 120A,A01,085445,Eggers; John Dietrich,6,0,35,29
1650101037089,MATH 120A,A02,085446,Eggers; John Dietrich,26,0,35,9
1650101043113,MATH 142B,A01,084149,Verstraete; Jacques Allan,0,12,30,30
1650101043113,MATH 142B,A02,084150,Verstraete; Jacques Allan,0,12,30,30
1650101049136,MATH 170A,A01,083459,Nie; Jiawang,0,11,30,30
1650101049136,MATH 170A,A02,083460,Nie; Jiawang,0,10,30,30
1650101049136,MATH 170A,A03,083461,Nie; Jiawang,0,11,30,30
1650101055157,MATH 193B,A01,083463,Staff,1,0,30,29
1650101055157,MATH 193B,A02,083464,Staff,8,0,30,22
1650101055157,MATH 193B,A03,083465,Staff,16,0,30,14
1650101061218,COGS 2,A01,083966,Boyle; Mary E. T.,9,0,30,21
1650101067240,COGS 9,A01,083968,Staff,2,0,60,58
1650101073265,COGS 14B,A01,083970,Staff,7,0,50,43
1650101079289,COGS 17,A01,092679,Staff,49,0,75,26
1650101085312,COGS 100,A01,083972,Staff,0,20,60,60
1650101097360,COGS 101C,A01,083976,Staff,12,0,30,18
1650101103388,COGS 102A,A01,083978,Johnson; Christine M.,8,0,30,22
1650101109412,COGS 107B,A01,083980,Staff,0,9,50,50
1650101115447,COGS 115,A01,083982,Staff,9,0,30,21
1650101121470,COGS 118B,A01,083367,Staff,0,16,40,40
1650101127497,COGS 172,A01,083984,Provenzano; Emily Kara,13,0,30,17
1650101133521,COGS 177,A00,083368,Staff,0,22,30,30
1650101139548,COGS 186,A01,083986,Staff,22,0,40,18
1650101145573,COGS 187A,A01,083988,Boyle; Mary E. T.,15,0,60,45
1650101151597,CSE 8A,A50,084003,Miranda; Gregory Joseph,0,19,15,15
1650101157625,CSE 11,A01,084005,Miranda; Gregory Joseph,0,25,55,55
1650101163648,CSE 20,A01,084007,Staff,0,5,20,20
1650101169671,CSE 21,A01,084009,Staff,0,32,50,50
1650101175698,CSE 30,A01,083370,Cao; Yingjun,0,64,40,40
1650101181722,CSE 100,A01,083372,Cao; Yingjun,0,48,40,40
1650101187745,CSE 101,A01,084011,Staff,0,56,40,40
1650101193773,CSE 141,A01,083374,Eldon; John,0,69,75,75
1650101199797,CSE 141L,A01,083376,Eldon; John,0,75,75,75
1650101205834,CSE 175,A01,084013,Kumar; Rakesh,22,0,25,3
1650101211859,CSE 190,A00,092508,Dubnov; Shlomo,18,0,20,2
1650101217885,ECE 5,A01,084049,Morris; Karcher William,12,0,20,8
1650101223907,ECE 100,A01,084051,Baghdadchi; Saharnaz,0,0,20,20
1650101223907,ECE 100,A02,091916,Baghdadchi; Saharnaz,11,0,20,9
1650101229931,ECE 101,A01,084053,Baghdadchi; Saharnaz,0,0,37,37
1650101229931,ECE 101,A02,084054,Baghdadchi; Saharnaz,27,0,37,10
1650101235958,ECE 107,A01,083390,Staff,26,0,40,14
1650101241981,ECE 148,A01,084056,Silberman; Jack,8,0,12,4
1650101248005,ECE 180,A00,083391,Abi Samra; Nicholas Camill,25,0,30,5
1650101248005,ECE 180,B00,083392,Abi Samra; Nicholas Camill,21,0,30,9
1650101254032,MATH 10B,A01,084110,Staff,0,0,30,30
1650101254032,MATH 10B,A02,084111,Staff,16,0,30,14
1650101254032,MATH 10B,A03,084112,Staff,23,0,30,7
1650101260056,MATH 10C,A01,083443,Staff,0,17,30,31
1650101260056,MATH 10C,A02,083444,Staff,0,18,30,30
1650101260056,MATH 10C,B01,084114,Staff,17,0,30,13
1650101260056,MATH 10C,B02,084115,Staff,24,0,30,6
1650101266078,MATH 18,A01,084117,Harel; Guershon,11,0,30,19
1650101266078,MATH 18,A02,084119,Harel; Guershon,27,0,30,3
1650101266078,MATH 18,A03,084120,Harel; Guershon,30,0,30,0
1650101266078,MATH 18,A04,084121,Harel; Guershon,29,0,30,1
1650101272101,MATH 20B,A01,084124,Um; Ko Woon,10,0,35,25
1650101272101,MATH 20B,B01,084126,Um; Ko Woon,24,0,35,11
1650101278125,MATH 20C,A01,083446,Hammock; Frances H,0,0,30,30
1650101278125,MATH 20C,A02,083447,Hammock; Frances H,12,0,30,18
1650101278125,MATH 20C,A03,083448,Hammock; Frances H,18,0,30,12
1650101278125,MATH 20C,A04,083449,Hammock; Frances H,20,0,30,10
1650101278125,MATH 20C,B01,083451,Hammock; Frances H,0,0,30,30
1650101278125,MATH 20C,B02,083452,Hammock; Frances H,14,0,30,16
1650101278125,MATH 20C,B03,083453,Hammock; Frances H,19,0,30,11
1650101278125,MATH 20C,B04,083454,Hammock; Frances H,23,0,30,7
1650101284148,MATH 20D,A01,084128,Staff,13,0,30,17
1650101284148,MATH 20D,A02,084129,Staff,29,0,30,1
1650101284148,MATH 20D,A03,084130,Staff,28,0,30,2
1650101284148,MATH 20D,B01,084133,Staff,0,0,30,30
1650101284148,MATH 20D,B02,084134,Staff,23,0,30,7
1650101284148,MATH 20D,B03,084135,Staff,28,0,30,2
1650101290174,MATH 20E,A01,084138,Staff,13,0,30,17
1650101290174,MATH 20E,A02,084139,Staff,6,0,30,24
1650101290174,MATH 20E,A03,084140,Staff,14,0,30,16
1650101290174,MATH 20E,A04,084141,Staff,19,0,30,11
1650101296201,MATH 102,A01,084143,Harel; Guershon,11,0,30,19
1650101296201,MATH 102,A02,084144,Harel; Guershon,18,0,30,12
1650101302229,MATH 103B,A01,083456,Staff,0,13,30,30
1650101302229,MATH 103B,A02,083457,Staff,0,14,30,30
1650101308251,MATH 109,A01,084146,Salehi Golsefidy; Alireza,16,0,30,14
1650101308251,MATH 109,A02,084147,Salehi Golsefidy; Alireza,15,0,30,15
1650101314274,MATH 120A,A01,085445,Eggers; John Dietrich,6,0,35,29
1650101314274,MATH 120A,A02,085446,Eggers; John Dietrich,26,0,35,9
1650101320304,MATH 142B,A01,084149,Verstraete; Jacques Allan,0,12,30,30
1650101320304,MATH 142B,A02,084150,Verstraete; Jacques Allan,0,12,30,30
1650101326326,MATH 170A,A01,083459,Nie; Jiawang,0,11,30,30
1650101326326,MATH 170A,A02,083460,Nie; Jiawang,0,10,30,30
1650101326326,MATH 170A,A03,083461,Nie; Jiawang,0,11,30,30
1650101332349,MATH 193B,A01,083463,Staff,1,0,30,29
1650101332349,MATH 193B,A02,083464,Staff,8,0,30,22
1650101332349,MATH 193B,A03,083465,Staff,16,0,30,14
1650101338410,COGS 2,A01,083966,Boyle; Mary E. T.,9,0,30,21
1650101344434,COGS 9,A01,083968,Staff,2,0,60,58
1650101350457,COGS 14B,A01,083970,Staff,7,0,50,43
1650101356481,COGS 17,A01,092679,Staff,49,0,75,26
1650101362594,COGS 100,A01,083972,Staff,0,20,60,60
1650101374641,COGS 101C,A01,083976,Staff,12,0,30,18
1650101380663,COGS 102A,A01,083978,Johnson; Christine M.,8,0,30,22
1650101386692,COGS 107B,A01,083980,Staff,0,9,50,50
1650101392717,COGS 115,A01,083982,Staff,9,0,30,21
1650101398739,COGS 118B,A01,083367,Staff,0,16,40,40
1650101404763,COGS 172,A01,083984,Provenzano; Emily Kara,13,0,30,17
1650101410786,COGS 177,A00,083368,Staff,0,22,30,30
1650101416809,COGS 186,A01,083986,Staff,22,0,40,18
1650101422832,COGS 187A,A01,083988,Boyle; Mary E. T.,15,0,60,45
1650101428861,CSE 8A,A50,084003,Miranda; Gregory Joseph,0,19,15,15
1650101434886,CSE 11,A01,084005,Miranda; Gregory Joseph,0,25,55,55
1650101440912,CSE 20,A01,084007,Staff,0,5,20,20
1650101446939,CSE 21,A01,084009,Staff,0,32,50,50
1650101452964,CSE 30,A01,083370,Cao; Yingjun,0,64,40,40
1650101458990,CSE 100,A01,083372,Cao; Yingjun,0,48,40,40
1650101465017,CSE 101,A01,084011,Staff,0,56,40,40
1650101471045,CSE 141,A01,083374,Eldon; John,0,69,75,75
1650101477072,CSE 141L,A01,083376,Eldon; John,0,75,75,75
1650101483099,CSE 175,A01,084013,Kumar; Rakesh,22,0,25,3
1650101489132,CSE 190,A00,092508,Dubnov; Shlomo,18,0,20,2
1650101495154,ECE 5,A01,084049,Morris; Karcher William,12,0,20,8
1650101501181,ECE 100,A01,084051,Baghdadchi; Saharnaz,0,0,20,20
1650101501181,ECE 100,A02,091916,Baghdadchi; Saharnaz,11,0,20,9
1650101507205,ECE 101,A01,084053,Baghdadchi; Saharnaz,0,0,37,37
1650101507205,ECE 101,A02,084054,Baghdadchi; Saharnaz,27,0,37,10
1650101513230,ECE 107,A01,083390,Staff,26,0,40,14
1650101519253,ECE 148,A01,084056,Silberman; Jack,8,0,12,4
1650101525280,ECE 180,A00,083391,Abi Samra; Nicholas Camill,25,0,30,5
1650101525280,ECE 180,B00,083392,Abi Samra; Nicholas Camill,21,0,30,9
1650101531307,MATH 10B,A01,084110,Staff,0,0,30,30
1650101531307,MATH 10B,A02,084111,Staff,16,0,30,14
1650101531307,MATH 10B,A03,084112,Staff,23,0,30,7
1650101537329,MATH 10C,A01,083443,Staff,0,17,30,31
1650101537329,MATH 10C,A02,083444,Staff,0,18,30,30
1650101537329,MATH 10C,B01,084114,Staff,17,0,30,13
1650101537329,MATH 10C,B02,084115,Staff,24,0,30,6
1650101543354,MATH 18,A01,084117,Harel; Guershon,11,0,30,19
1650101543354,MATH 18,A02,084119,Harel; Guershon,27,0,30,3
1650101543354,MATH 18,A03,084120,Harel; Guershon,30,0,30,0
1650101543354,MATH 18,A04,084121,Harel; Guershon,29,0,30,1
1650101549381,MATH 20B,A01,084124,Um; Ko Woon,10,0,35,25
1650101549381,MATH 20B,B01,084126,Um; Ko Woon,24,0,35,11
1650101555414,MATH 20C,A01,083446,Hammock; Frances H,0,0,30,30
1650101555414,MATH 20C,A02,083447,Hammock; Frances H,12,0,30,18
1650101555414,MATH 20C,A03,083448,Hammock; Frances H,18,0,30,12
1650101555414,MATH 20C,A04,083449,Hammock; Frances H,20,0,30,10
1650101555414,MATH 20C,B01,083451,Hammock; Frances H,0,0,30,30
1650101555414,MATH 20C,B02,083452,Hammock; Frances H,14,0,30,16
1650101555414,MATH 20C,B03,083453,Hammock; Frances H,19,0,30,11
1650101555414,MATH 20C,B04,083454,Hammock; Frances H,23,0,30,7
1650101561442,MATH 20D,A01,084128,Staff,13,0,30,17
1650101561442,MATH 20D,A02,084129,Staff,29,0,30,1
1650101561442,MATH 20D,A03,084130,Staff,28,0,30,2
1650101561442,MATH 20D,B01,084133,Staff,0,0,30,30
1650101561442,MATH 20D,B02,084134,Staff,23,0,30,7
1650101561442,MATH 20D,B03,084135,Staff,28,0,30,2
1650101567470,MATH 20E,A01,084138,Staff,13,0,30,17
1650101567470,MATH 20E,A02,084139,Staff,6,0,30,24
1650101567470,MATH 20E,A03,084140,Staff,14,0,30,16
1650101567470,MATH 20E,A04,084141,Staff,19,0,30,11
1650101573494,MATH 102,A01,084143,Harel; Guershon,11,0,30,19
1650101573494,MATH 102,A02,084144,Harel; Guershon,18,0,30,12
1650101579521,MATH 103B,A01,083456,Staff,0,13,30,30
1650101579521,MATH 103B,A02,083457,Staff,0,14,30,30
1650101585546,MATH 109,A01,084146,Salehi Golsefidy; Alireza,16,0,30,14
1650101585546,MATH 109,A02,084147,Salehi Golsefidy; Alireza,15,0,30,15
1650101591574,MATH 120A,A01,085445,Eggers; John Dietrich,6,0,35,29
1650101591574,MATH 120A,A02,085446,Eggers; John Dietrich,26,0,35,9
1650101597599,MATH 142B,A01,084149,Verstraete; Jacques Allan,0,12,30,30
1650101597599,MATH 142B,A02,084150,Verstraete; Jacques Allan,0,12,30,30
1650101603628,MATH 170A,A01,083459,Nie; Jiawang,0,11,30,30
1650101603628,MATH 170A,A02,083460,Nie; Jiawang,0,10,30,30
1650101603628,MATH 170A,A03,083461,Nie; Jiawang,0,11,30,30
1650101609652,MATH 193B,A01,083463,Staff,1,0,30,29
1650101609652,MATH 193B,A02,083464,Staff,8,0,30,22
1650101609652,MATH 193B,A03,083465,Staff,16,0,30,14
1650101615713,COGS 2,A01,083966,Boyle; Mary E. T.,9,0,30,21
1650101621737,COGS 9,A01,083968,Staff,2,0,60,58
1650101627759,COGS 14B,A01,083970,Staff,7,0,50,43
1650101633785,COGS 17,A01,092679,Staff,49,0,75,26
1650101639812,COGS 100,A01,083972,Staff,0,20,60,60
1650101651864,COGS 101C,A01,083976,Staff,12,0,30,18
1650101657887,COGS 102A,A01,083978,Johnson; Christine M.,8,0,30,22
1650101663910,COGS 107B,A01,083980,Staff,0,9,50,50
1650101669934,COGS 115,A01,083982,Staff,9,0,30,21
1650101675957,COGS 118B,A01,083367,Staff,0,16,40,40
1650101681981,COGS 172,A01,083984,Provenzano; Emily Kara,13,0,30,17
1650101688004,COGS 177,A00,083368,Staff,0,22,30,30
1650101694031,COGS 186,A01,083986,Staff,22,0,40,18
1650101700053,COGS 187A,A01,083988,Boyle; Mary E. T.,15,0,60,45
1650101706083,CSE 8A,A50,084003,Miranda; Gregory Joseph,0,19,15,15
1650101712108,CSE 11,A01,084005,Miranda; Gregory Joseph,0,25,55,55
1650101718129,CSE 20,A01,084007,Staff,0,5,20,20
1650101724155,CSE 21,A01,084009,Staff,0,32,50,50
1650101730185,CSE 30,A01,083370,Cao; Yingjun,0,64,40,40
1650101736208,CSE 100,A01,083372,Cao; Yingjun,0,48,40,40
1650101742234,CSE 101,A01,084011,Staff,0,56,40,40
1650101748260,CSE 141,A01,083374,Eldon; John,0,69,75,75
1650101754284,CSE 141L,A01,083376,Eldon; John,0,75,75,75
1650101760308,CSE 175,A01,084013,Kumar; Rakesh,22,0,25,3
1650101766334,CSE 190,A00,092508,Dubnov; Shlomo,18,0,20,2
1650101772361,ECE 5,A01,084049,Morris; Karcher William,12,0,20,8
1650101778383,ECE 100,A01,084051,Baghdadchi; Saharnaz,0,0,20,20
1650101778383,ECE 100,A02,091916,Baghdadchi; Saharnaz,11,0,20,9
1650101784407,ECE 101,A01,084053,Baghdadchi; Saharnaz,0,0,37,37
1650101784407,ECE 101,A02,084054,Baghdadchi; Saharnaz,27,0,37,10
1650101790431,ECE 107,A01,083390,Staff,26,0,40,14
1650101796455,ECE 148,A01,084056,Silberman; Jack,8,0,12,4
1650101802482,ECE 180,A00,083391,Abi Samra; Nicholas Camill,25,0,30,5
1650101802482,ECE 180,B00,083392,Abi Samra; Nicholas Camill,21,0,30,9
1650101808506,MATH 10B,A01,084110,Staff,0,0,30,30
1650101808506,MATH 10B,A02,084111,Staff,16,0,30,14
1650101808506,MATH 10B,A03,084112,Staff,23,0,30,7
1650101814531,MATH 10C,A01,083443,Staff,0,17,30,31
1650101814531,MATH 10C,A02,083444,Staff,0,18,30,30
1650101814531,MATH 10C,B01,084114,Staff,17,0,30,13
1650101814531,MATH 10C,B02,084115,Staff,24,0,30,6
1650101820564,MATH 18,A01,084117,Harel; Guershon,11,0,30,19
1650101820564,MATH 18,A02,084119,Harel; Guershon,27,0,30,3
1650101820564,MATH 18,A03,084120,Harel; Guershon,30,0,30,0
1650101820564,MATH 18,A04,084121,Harel; Guershon,29,0,30,1
1650101826596,MATH 20B,A01,084124,Um; Ko Woon,10,0,35,25
1650101826596,MATH 20B,B01,084126,Um; Ko Woon,24,0,35,11
1650101832635,MATH 20C,A01,083446,Hammock; Frances H,0,0,30,30
1650101832635,MATH 20C,A02,083447,Hammock; Frances H,12,0,30,18
1650101832635,MATH 20C,A03,083448,Hammock; Frances H,18,0,30,12
1650101832635,MATH 20C,A04,083449,Hammock; Frances H,20,0,30,10
1650101832635,MATH 20C,B01,083451,Hammock; Frances H,0,0,30,30
1650101832635,MATH 20C,B02,083452,Hammock; Frances H,14,0,30,16
1650101832635,MATH 20C,B03,083453,Hammock; Frances H,19,0,30,11
1650101832635,MATH 20C,B04,083454,Hammock; Frances H,23,0,30,7
1650101838659,MATH 20D,A01,084128,Staff,13,0,30,17
1650101838659,MATH 20D,A02,084129,Staff,29,0,30,1
1650101838659,MATH 20D,A03,084130,Staff,28,0,30,2
1650101838659,MATH 20D,B01,084133,Staff,0,0,30,30
1650101838659,MATH 20D,B02,084134,Staff,23,0,30,7
1650101838659,MATH 20D,B03,084135,Staff,28,0,30,2
1650101844685,MATH 20E,A01,084138,Staff,13,0,30,17
1650101844685,MATH 20E,A02,084139,Staff,6,0,30,24
1650101844685,MATH 20E,A03,084140,Staff,14,0,30,16
1650101844685,MATH 20E,A04,084141,Staff,19,0,30,11
1650101850710,MATH 102,A01,084143,Harel; Guershon,11,0,30,19
1650101850710,MATH 102,A02,084144,Harel; Guershon,18,0,30,12
1650101856738,MATH 103B,A01,083456,Staff,0,13,30,30
1650101856738,MATH 103B,A02,083457,Staff,0,14,30,30
1650101862762,MATH 109,A01,084146,Salehi Golsefidy; Alireza,16,0,30,14
1650101862762,MATH 109,A02,084147,Salehi Golsefidy; Alireza,15,0,30,15
1650101868789,MATH 120A,A01,085445,Eggers; John Dietrich,6,0,35,29
1650101868789,MATH 120A,A02,085446,Eggers; John Dietrich,26,0,35,9
1650101874813,MATH 142B,A01,084149,Verstraete; Jacques Allan,0,12,30,30
1650101874813,MATH 142B,A02,084150,Verstraete; Jacques Allan,0,12,30,30
1650101880837,MATH 170A,A01,083459,Nie; Jiawang,0,11,30,30
1650101880837,MATH 170A,A02,083460,Nie; Jiawang,0,10,30,30
1650101880837,MATH 170A,A03,083461,Nie; Jiawang,0,11,30,30
1650101886863,MATH 193B,A01,083463,Staff,1,0,30,29
1650101886863,MATH 193B,A02,083464,Staff,8,0,30,22
1650101886863,MATH 193B,A03,083465,Staff,16,0,30,14
1650101892915,COGS 2,A01,083966,Boyle; Mary E. T.,9,0,30,21
1650101898939,COGS 9,A01,083968,Staff,2,0,60,58
1650101904966,COGS 14B,A01,083970,Staff,7,0,50,43
1650101910989,COGS 17,A01,092679,Staff,49,0,75,26
1650101917023,COGS 100,A01,083972,Staff,0,20,60,60
1650101929072,COGS 101C,A01,083976,Staff,12,0,30,18
1650101935096,COGS 102A,A01,083978,Johnson; Christine M.,8,0,30,22
1650101941119,COGS 107B,A01,083980,Staff,0,9,50,50
1650101947144,COGS 115,A01,083982,Staff,9,0,30,21
1650101953268,COGS 118B,A01,083367,Staff,0,16,40,40
1650101959304,COGS 172,A01,083984,Provenzano; Emily Kara,13,0,30,17
1650101965327,COGS 177,A00,083368,Staff,0,22,30,30
1650101971350,COGS 186,A01,083986,Staff,22,0,40,18
1650101977374,COGS 187A,A01,083988,Boyle; Mary E. T.,15,0,60,45
1650101983402,CSE 8A,A50,084003,Miranda; Gregory Joseph,0,19,15,15
1650101989430,CSE 11,A01,084005,Miranda; Gregory Joseph,0,25,55,55
1650101995454,CSE 20,A01,084007,Staff,0,5,20,20
1650102001476,CSE 21,A01,084009,Staff,0,32,50,50
1650102007512,CSE 30,A01,083370,Cao; Yingjun,0,64,40,40
1650102013536,CSE 100,A01,083372,Cao; Yingjun,0,48,40,40
1650102019563,CSE 101,A01,084011,Staff,0,56,40,40
1650102025587,CSE 141,A01,083374,Eldon; John,0,69,75,75
1650102031613,CSE 141L,A01,083376,Eldon; John,0,75,75,75
1650102037636,CSE 175,A01,084013,Kumar; Rakesh,22,0,25,3
1650102043663,CSE 190,A00,092508,Dubnov; Shlomo,18,0,20,2
1650102049687,ECE 5,A01,084049,Morris; Karcher William,12,0,20,8
1650102055710,ECE 100,A01,084051,Baghdadchi; Saharnaz,0,0,20,20
1650102055710,ECE 100,A02,091916,Baghdadchi; Saharnaz,11,0,20,9
1650102061737,ECE 101,A01,084053,Baghdadchi; Saharnaz,0,0,37,37
1650102061737,ECE 101,A02,084054,Baghdadchi; Saharnaz,27,0,37,10
1650102067760,ECE 107,A01,083390,Staff,26,0,40,14
1650102073786,ECE 148,A01,084056,Silberman; Jack,8,0,12,4
1650102079810,ECE 180,A00,083391,Abi Samra; Nicholas Camill,25,0,30,5
1650102079810,ECE 180,B00,083392,Abi Samra; Nicholas Camill,21,0,30,9
1650102085834,MATH 10B,A01,084110,Staff,0,0,30,30
1650102085834,MATH 10B,A02,084111,Staff,16,0,30,14
1650102085834,MATH 10B,A03,084112,Staff,23,0,30,7
1650102091861,MATH 10C,A01,083443,Staff,0,17,30,31
1650102091861,MATH 10C,A02,083444,Staff,0,18,30,30
1650102091861,MATH 10C,B01,084114,Staff,17,0,30,13
1650102091861,MATH 10C,B02,084115,Staff,24,0,30,6
1650102097887,MATH 18,A01,084117,Harel; Guershon,11,0,30,19
1650102097887,MATH 18,A02,084119,Harel; Guershon,27,0,30,3
1650102097887,MATH 18,A03,084120,Harel; Guershon,30,0,30,0
1650102097887,MATH 18,A04,084121,Harel; Guershon,29,0,30,1
1650102103911,MATH 20B,A01,084124,Um; Ko Woon,10,0,35,25
1650102103911,MATH 20B,B01,084126,Um; Ko Woon,24,0,35,11
1650102109939,MATH 20C,A01,083446,Hammock; Frances H,0,0,30,30
1650102109939,MATH 20C,A02,083447,Hammock; Frances H,12,0,30,18
1650102109939,MATH 20C,A03,083448,Hammock; Frances H,18,0,30,12
1650102109939,MATH 20C,A04,083449,Hammock; Frances H,20,0,30,10
1650102109939,MATH 20C,B01,083451,Hammock; Frances H,0,0,30,30
1650102109939,MATH 20C,B02,083452,Hammock; Frances H,14,0,30,16
1650102109939,MATH 20C,B03,083453,Hammock; Frances H,19,0,30,11
1650102109939,MATH 20C,B04,083454,Hammock; Frances H,23,0,30,7
1650102115963,MATH 20D,A01,084128,Staff,13,0,30,17
1650102115963,MATH 20D,A02,084129,Staff,29,0,30,1
1650102115963,MATH 20D,A03,084130,Staff,28,0,30,2
1650102115963,MATH 20D,B01,084133,Staff,0,0,30,30
1650102115963,MATH 20D,B02,084134,Staff,23,0,30,7
1650102115963,MATH 20D,B03,084135,Staff,28,0,30,2
1650102121986,MATH 20E,A01,084138,Staff,13,0,30,17
1650102121986,MATH 20E,A02,084139,Staff,6,0,30,24
1650102121986,MATH 20E,A03,084140,Staff,14,0,30,16
1650102121986,MATH 20E,A04,084141,Staff,19,0,30,11
1650102128012,MATH 102,A01,084143,Harel; Guershon,11,0,30,19
1650102128012,MATH 102,A02,084144,Harel; Guershon,18,0,30,12
1650102134035,MATH 103B,A01,083456,Staff,0,13,30,30
1650102134035,MATH 103B,A02,083457,Staff,0,14,30,30
1650102140059,MATH 109,A01,084146,Salehi Golsefidy; Alireza,16,0,30,14
1650102140059,MATH 109,A02,084147,Salehi Golsefidy; Alireza,15,0,30,15
1650102146083,MATH 120A,A01,085445,Eggers; John Dietrich,6,0,35,29
1650102146083,MATH 120A,A02,085446,Eggers; John Dietrich,26,0,35,9
1650102152107,MATH 142B,A01,084149,Verstraete; Jacques Allan,0,12,30,30
1650102152107,MATH 142B,A02,084150,Verstraete; Jacques Allan,0,12,30,30
1650102158131,MATH 170A,A01,083459,Nie; Jiawang,0,11,30,30
1650102158131,MATH 170A,A02,083460,Nie; Jiawang,0,10,30,30
1650102158131,MATH 170A,A03,083461,Nie; Jiawang,0,11,30,30
1650102164155,MATH 193B,A01,083463,Staff,1,0,30,29
1650102164155,MATH 193B,A02,083464,Staff,8,0,30,22
1650102164155,MATH 193B,A03,083465,Staff,16,0,30,14
1650102170204,COGS 2,A01,083966,Boyle; Mary E. T.,9,0,30,21
1650102176228,COGS 9,A01,083968,Staff,2,0,60,58
1650102182255,COGS 14B,A01,083970,Staff,7,0,50,43
1650102188277,COGS 17,A01,092679,Staff,49,0,75,26
1650102194301,COGS 100,A01,083972,Staff,0,20,60,60
1650102206348,COGS 101C,A01,083976,Staff,12,0,30,18
1650102212377,COGS 102A,A01,083978,Johnson; Christine M.,8,0,30,22
1650102218401,COGS 107B,A01,083980,Staff,0,9,50,50
1650102224425,COGS 115,A01,083982,Staff,9,0,30,21
1650102230449,COGS 118B,A01,083367,Staff,0,16,40,40
1650102236473,COGS 172,A01,083984,Provenzano; Emily Kara,13,0,30,17
1650102242499,COGS 177,A00,083368,Staff,0,22,30,30
1650102248528,COGS 186,A01,083986,Staff,22,0,40,18
1650102254552,COGS 187A,A01,083988,Boyle; Mary E. T.,15,0,60,45
1650102260576,CSE 8A,A50,084003,Miranda; Gregory Joseph,0,19,15,15
1650102266599,CSE 11,A01,084005,Miranda; Gregory Joseph,0,25,55,55
1650102272621,CSE 20,A01,084007,Staff,0,5,20,20
1650102278645,CSE 21,A01,084009,Staff,0,32,50,50
1650102284672,CSE 30,A01,083370,Cao; Yingjun,0,64,40,40
1650102290694,CSE 100,A01,083372,Cao; Yingjun,0,48,40,40
1650102296717,CSE 101,A01,084011,Staff,0,56,40,40
1650102302741,CSE 141,A01,083374,Eldon; John,0,70,75,75
1650102308769,CSE 141L,A01,083376,Eldon; John,0,76,75,75
1650102314792,CSE 175,A01,084013,Kumar; Rakesh,22,0,25,3
1650102320819,CSE 190,A00,092508,Dubnov; Shlomo,18,0,20,2
1650102326843,ECE 5,A01,084049,Morris; Karcher William,12,0,20,8
1650102332870,ECE 100,A01,084051,Baghdadchi; Saharnaz,0,0,20,20
1650102332870,ECE 100,A02,091916,Baghdadchi; Saharnaz,11,0,20,9
1650102338897,ECE 101,A01,084053,Baghdadchi; Saharnaz,0,0,37,37
1650102338897,ECE 101,A02,084054,Baghdadchi; Saharnaz,27,0,37,10
1650102344923,ECE 107,A01,083390,Staff,26,0,40,14
1650102350946,ECE 148,A01,084056,Silberman; Jack,8,0,12,4
1650102356972,ECE 180,A00,083391,Abi Samra; Nicholas Camill,25,0,30,5
1650102356972,ECE 180,B00,083392,Abi Samra; Nicholas Camill,21,0,30,9
1650102363006,MATH 10B,A01,084110,Staff,0,0,30,30
1650102363006,MATH 10B,A02,084111,Staff,16,0,30,14
1650102363006,MATH 10B,A03,084112,Staff,23,0,30,7
1650102369030,MATH 10C,A01,083443,Staff,0,17,30,31
1650102369030,MATH 10C,A02,083444,Staff,0,18,30,30
1650102369030,MATH 10C,B01,084114,Staff,17,0,30,13
1650102369030,MATH 10C,B02,084115,Staff,24,0,30,6
1650102375058,MATH 18,A01,084117,Harel; Guershon,11,0,30,19
1650102375058,MATH 18,A02,084119,Harel; Guershon,27,0,30,3
1650102375058,MATH 18,A03,084120,Harel; Guershon,30,0,30,0
1650102375058,MATH 18,A04,084121,Harel; Guershon,29,0,30,1
1650102381082,MATH 20B,A01,084124,Um; Ko Woon,10,0,35,25
1650102381082,MATH 20B,B01,084126,Um; Ko Woon,24,0,35,11
1650102387106,MATH 20C,A01,083446,Hammock; Frances H,0,0,30,30
1650102387106,MATH 20C,A02,083447,Hammock; Frances H,12,0,30,18
1650102387106,MATH 20C,A03,083448,Hammock; Frances H,18,0,30,12
1650102387106,MATH 20C,A04,083449,Hammock; Frances H,20,0,30,10
1650102387106,MATH 20C,B01,083451,Hammock; Frances H,0,0,30,30
1650102387106,MATH 20C,B02,083452,Hammock; Frances H,14,0,30,16
1650102387106,MATH 20C,B03,083453,Hammock; Frances H,19,0,30,11
1650102387106,MATH 20C,B04,083454,Hammock; Frances H,23,0,30,7
1650102393130,MATH 20D,A01,084128,Staff,13,0,30,17
1650102393130,MATH 20D,A02,084129,Staff,29,0,30,1
1650102393130,MATH 20D,A03,084130,Staff,28,0,30,2
1650102393130,MATH 20D,B01,084133,Staff,0,0,30,30
1650102393130,MATH 20D,B02,084134,Staff,23,0,30,7
1650102393130,MATH 20D,B03,084135,Staff,28,0,30,2
1650102399157,MATH 20E,A01,084138,Staff,13,0,30,17
1650102399157,MATH 20E,A02,084139,Staff,6,0,30,24
1650102399157,MATH 20E,A03,084140,Staff,14,0,30,16
1650102399157,MATH 20E,A04,084141,Staff,19,0,30,11
1650102405184,MATH 102,A01,084143,Harel; Guershon,11,0,30,19
1650102405184,MATH 102,A02,084144,Harel; Guershon,18,0,30,12
1650102411205,MATH 103B,A01,083456,Staff,0,13,30,30
1650102411205,MATH 103B,A02,083457,Staff,0,14,30,30
1650102417228,MATH 109,A01,084146,Salehi Golsefidy; Alireza,16,0,30,14
1650102417228,MATH 109,A02,084147,Salehi Golsefidy; Alireza,15,0,30,15
1650102423252,MATH 120A,A01,085445,Eggers; John Dietrich,6,0,35,29
1650102423252,MATH 120A,A02,085446,Eggers; John Dietrich,26,0,35,9
1650102429284,MATH 142B,A01,084149,Verstraete; Jacques Allan,0,12,30,30
1650102429284,MATH 142B,A02,084150,Verstraete; Jacques Allan,0,12,30,30
1650102435311,MATH 170A,A01,083459,Nie; Jiawang,0,11,30,30
1650102435311,MATH 170A,A02,083460,Nie; Jiawang,0,10,30,30
1650102435311,MATH 170A,A03,083461,Nie; Jiawang,0,11,30,30
1650102441337,MATH 193B,A01,083463,Staff,1,0,30,29
1650102441337,MATH 193B,A02,083464,Staff,8,0,30,22
1650102441337,MATH 193B,A03,083465,Staff,16,0,30,14
1650102447393,COGS 2,A01,083966,Boyle; Mary E. T.,9,0,30,21
1650102453417,COGS 9,A01,083968,Staff,2,0,60,58
1650102459441,COGS 14B,A01,083970,Staff,7,0,50,43
1650102465465,COGS 17,A01,092679,Staff,49,0,75,26
1650102471492,COGS 100,A01,083972,Staff,0,20,60,60
1650102483539,COGS 101C,A01,083976,Staff,12,0,30,18
1650102489565,COGS 102A,A01,083978,Johnson; Christine M.,8,0,30,22
1650102495589,COGS 107B,A01,083980,Staff,0,9,50,50
1650102501612,COGS 115,A01,083982,Staff,9,0,30,21
1650102507639,COGS 118B,A01,083367,Staff,0,16,40,40
1650102513667,COGS 172,A01,083984,Provenzano; Emily Kara,13,0,30,17
1650102519689,COGS 177,A00,083368,Staff,0,22,30,30
1650102525713,COGS 186,A01,083986,Staff,22,0,40,18
1650102531737,COGS 187A,A01,083988,Boyle; Mary E. T.,15,0,60,45
1650102537760,CSE 8A,A50,084003,Miranda; Gregory Joseph,0,19,15,15
1650102543788,CSE 11,A01,084005,Miranda; Gregory Joseph,0,25,55,55
1650102549908,CSE 20,A01,084007,Staff,0,5,20,20
1650102555930,CSE 21,A01,084009,Staff,0,32,50,50
1650102561956,CSE 30,A01,083370,Cao; Yingjun,0,64,40,40
1650102567979,CSE 100,A01,083372,Cao; Yingjun,0,48,40,40
1650102574008,CSE 101,A01,084011,Staff,0,56,40,40
1650102580031,CSE 141,A01,083374,Eldon; John,0,70,75,75
1650102586057,CSE 141L,A01,083376,Eldon; John,0,76,75,75
1650102592083,CSE 175,A01,084013,Kumar; Rakesh,22,0,25,3
1650102598111,CSE 190,A00,092508,Dubnov; Shlomo,18,0,20,2
1650102604139,ECE 5,A01,084049,Morris; Karcher William,12,0,20,8
1650102610167,ECE 100,A01,084051,Baghdadchi; Saharnaz,0,0,20,20
1650102610167,ECE 100,A02,091916,Baghdadchi; Saharnaz,11,0,20,9
1650102616193,ECE 101,A01,084053,Baghdadchi; Saharnaz,0,0,37,37
1650102616193,ECE 101,A02,084054,Baghdadchi; Saharnaz,27,0,37,10
1650102622216,ECE 107,A01,083390,Staff,26,0,40,14
1650102628243,ECE 148,A01,084056,Silberman; Jack,8,0,12,4
1650102634268,ECE 180,A00,083391,Abi Samra; Nicholas Camill,25,0,30,5
1650102634268,ECE 180,B00,083392,Abi Samra; Nicholas Camill,21,0,30,9
1650102640295,MATH 10B,A01,084110,Staff,0,0,30,30
1650102640295,MATH 10B,A02,084111,Staff,16,0,30,14
1650102640295,MATH 10B,A03,084112,Staff,23,0,30,7
1650102646323,MATH 10C,A01,083443,Staff,0,17,30,31
1650102646323,MATH 10C,A02,083444,Staff,0,18,30,30
1650102646323,MATH 10C,B01,084114,Staff,17,0,30,13
1650102646323,MATH 10C,B02,084115,Staff,24,0,30,6
1650102652347,MATH 18,A01,084117,Harel; Guershon,11,0,30,19
1650102652347,MATH 18,A02,084119,Harel; Guershon,27,0,30,3
1650102652347,MATH 18,A03,084120,Harel; Guershon,30,0,30,0
1650102652347,MATH 18,A04,084121,Harel; Guershon,29,0,30,1
1650102658371,MATH 20B,A01,084124,Um; Ko Woon,10,0,35,25
1650102658371,MATH 20B,B01,084126,Um; Ko Woon,24,0,35,11
1650102664415,MATH 20C,A01,083446,Hammock; Frances H,0,0,30,30
1650102664415,MATH 20C,A02,083447,Hammock; Frances H,12,0,30,18
1650102664415,MATH 20C,A03,083448,Hammock; Frances H,18,0,30,12
1650102664415,MATH 20C,A04,083449,Hammock; Frances H,20,0,30,10
1650102664415,MATH 20C,B01,083451,Hammock; Frances H,0,0,30,30
1650102664415,MATH 20C,B02,083452,Hammock; Frances H,14,0,30,16
1650102664415,MATH 20C,B03,083453,Hammock; Frances H,19,0,30,11
1650102664415,MATH 20C,B04,083454,Hammock; Frances H,23,0,30,7
1650102670445,MATH 20D,A01,084128,Staff,13,0,30,17
1650102670445,MATH 20D,A02,084129,Staff,29,0,30,1
1650102670445,MATH 20D,A03,084130,Staff,28,0,30,2
1650102670445,MATH 20D,B01,084133,Staff,0,0,30,30
1650102670445,MATH 20D,B02,084134,Staff,23,0,30,7
1650102670445,MATH 20D,B03,084135,Staff,28,0,30,2
1650102676468,MATH 20E,A01,084138,Staff,13,0,30,17
1650102676468,MATH 20E,A02,084139,Staff,6,0,30,24
1650102676468,MATH 20E,A03,084140,Staff,14,0,30,16
1650102676468,MATH 20E,A04,084141,Staff,19,0,30,11
1650102682498,MATH 102,A01,084143,Harel; Guershon,11,0,30,19
1650102682498,MATH 102,A02,084144,Harel; Guershon,18,0,30,12
1650102688520,MATH 103B,A01,083456,Staff,0,13,30,30
1650102688520,MATH 103B,A02,083457,Staff,0,14,30,30
1650102694548,MATH 109,A01,084146,Salehi Golsefidy; Alireza,16,0,30,14
1650102694548,MATH 109,A02,084147,Salehi Golsefidy; Alireza,15,0,30,15
1650102700572,MATH 120A,A01,085445,Eggers; John Dietrich,6,0,35,29
1650102700572,MATH 120A,A02,085446,Eggers; John Dietrich,26,0,35,9
1650102706603,MATH 142B,A01,084149,Verstraete; Jacques Allan,0,12,30,30
1650102706603,MATH 142B,A02,084150,Verstraete; Jacques Allan,0,12,30,30
1650102712631,MATH 170A,A01,083459,Nie; Jiawang,0,11,30,30
1650102712631,MATH 170A,A02,083460,Nie; Jiawang,0,10,30,30
1650102712631,MATH 170A,A03,083461,Nie; Jiawang,0,11,30,30
1650102718661,MATH 193B,A01,083463,Staff,1,0,30,29
1650102718661,MATH 193B,A02,083464,Staff,8,0,30,22
1650102718661,MATH 193B,A03,083465,Staff,16,0,30,14
1650102724737,COGS 2,A01,083966,Boyle; Mary E. T.,9,0,30,21
1650102730759,COGS 9,A01,083968,Staff,2,0,60,58
1650102736784,COGS 14B,A01,083970,Staff,7,0,50,43
1650102742808,COGS 17,A01,092679,Staff,49,0,75,26
1650102748834,COGS 100,A01,083972,Staff,0,20,60,60
1650102760882,COGS 101C,A01,083976,Staff,12,0,30,18
1650102766905,COGS 102A,A01,083978,Johnson; Christine M.,8,0,30,22
1650102772932,COGS 107B,A01,083980,Staff,0,9,50,50
1650102778960,COGS 115,A01,083982,Staff,9,0,30,21
1650102784984,COGS 118B,A01,083367,Staff,0,16,40,40
1650102791012,COGS 172,A01,083984,Provenzano; Emily Kara,13,0,30,17
1650102797035,COGS 177,A00,083368,Staff,0,22,30,30
1650102803063,COGS 186,A01,083986,Staff,22,0,40,18
1650102809088,COGS 187A,A01,083988,Boyle; Mary E. T.,15,0,60,45
1650102815112,CSE 8A,A50,084003,Miranda; Gregory Joseph,0,19,15,15
1650102821135,CSE 11,A01,084005,Miranda; Gregory Joseph,0,25,55,55
1650102827159,CSE 20,A01,084007,Staff,0,5,20,20
1650102833184,CSE 21,A01,084009,Staff,0,32,50,50
1650102839210,CSE 30,A01,083370,Cao; Yingjun,0,64,40,40
1650102845244,CSE 100,A01,083372,Cao; Yingjun,0,48,40,40
1650102851271,CSE 101,A01,084011,Staff,0,56,40,40
1650102857294,CSE 141,A01,083374,Eldon; John,0,70,75,75
1650102863317,CSE 141L,A01,083376,Eldon; John,0,76,75,75
1650102869341,CSE 175,A01,084013,Kumar; Rakesh,22,0,25,3
1650102875370,CSE 190,A00,092508,Dubnov; Shlomo,18,0,20,2
1650102881391,ECE 5,A01,084049,Morris; Karcher William,12,0,20,8
1650102887418,ECE 100,A01,084051,Baghdadchi; Saharnaz,0,0,20,20
1650102887418,ECE 100,A02,091916,Baghdadchi; Saharnaz,11,0,20,9
1650102893443,ECE 101,A01,084053,Baghdadchi; Saharnaz,0,0,37,37
1650102893443,ECE 101,A02,084054,Baghdadchi; Saharnaz,27,0,37,10
1650102899466,ECE 107,A01,083390,Staff,26,0,40,14
1650102905494,ECE 148,A01,084056,Silberman; Jack,8,0,12,4
1650102911516,ECE 180,A00,083391,Abi Samra; Nicholas Camill,25,0,30,5
1650102911516,ECE 180,B00,083392,Abi Samra; Nicholas Camill,21,0,30,9
1650102917540,MATH 10B,A01,084110,Staff,0,0,30,30
1650102917540,MATH 10B,A02,084111,Staff,16,0,30,14
1650102917540,MATH 10B,A03,084112,Staff,23,0,30,7
1650102923564,MATH 10C,A01,083443,Staff,0,17,30,31
1650102923564,MATH 10C,A02,083444,Staff,0,18,30,30
1650102923564,MATH 10C,B01,084114,Staff,17,0,30,13
1650102923564,MATH 10C,B02,084115,Staff,24,0,30,6
1650102929588,MATH 18,A01,084117,Harel; Guershon,11,0,30,19
1650102929588,MATH 18,A02,084119,Harel; Guershon,27,0,30,3
1650102929588,MATH 18,A03,084120,Harel; Guershon,30,0,30,0
1650102929588,MATH 18,A04,084121,Harel; Guershon,29,0,30,1
1650102935617,MATH 20B,A01,084124,Um; Ko Woon,10,0,35,25
1650102935617,MATH 20B,B01,084126,Um; Ko Woon,24,0,35,11
1650102941644,MATH 20C,A01,083446,Hammock; Frances H,0,0,30,30
1650102941644,MATH 20C,A02,083447,Hammock; Frances H,12,0,30,18
1650102941644,MATH 20C,A03,083448,Hammock; Frances H,18,0,30,12
1650102941644,MATH 20C,A04,083449,Hammock; Frances H,20,0,30,10
1650102941644,MATH 20C,B01,083451,Hammock; Frances H,0,0,30,30
1650102941644,MATH 20C,B02,083452,Hammock; Frances H,14,0,30,16
1650102941644,MATH 20C,B03,083453,Hammock; Frances H,19,0,30,11
1650102941644,MATH 20C,B04,083454,Hammock; Frances H,23,0,30,7
1650102947671,MATH 20D,A01,084128,Staff,13,0,30,17
1650102947671,MATH 20D,A02,084129,Staff,29,0,30,1
1650102947671,MATH 20D,A03,084130,Staff,28,0,30,2
1650102947671,MATH 20D,B01,084133,Staff,0,0,30,30
1650102947671,MATH 20D,B02,084134,Staff,23,0,30,7
1650102947671,MATH 20D,B03,084135,Staff,28,0,30,2
1650102953698,MATH 20E,A01,084138,Staff,13,0,30,17
1650102953698,MATH 20E,A02,084139,Staff,6,0,30,24
1650102953698,MATH 20E,A03,084140,Staff,14,0,30,16
1650102953698,MATH 20E,A04,084141,Staff,19,0,30,11
1650102959732,MATH 102,A01,084143,Harel; Guershon,11,0,30,19
1650102959732,MATH 102,A02,084144,Harel; Guershon,18,0,30,12
1650102965756,MATH 103B,A01,083456,Staff,0,13,30,30
1650102965756,MATH 103B,A02,083457,Staff,0,14,30,30
1650102971783,MATH 109,A01,084146,Salehi Golsefidy; Alireza,16,0,30,14
1650102971783,MATH 109,A02,084147,Salehi Golsefidy; Alireza,15,0,30,15
1650102977815,MATH 120A,A01,085445,Eggers; John Dietrich,6,0,35,29
1650102977815,MATH 120A,A02,085446,Eggers; John Dietrich,26,0,35,9
1650102983844,MATH 142B,A01,084149,Verstraete; Jacques Allan,0,12,30,30
1650102983844,MATH 142B,A02,084150,Verstraete; Jacques Allan,0,12,30,30
1650102989871,MATH 170A,A01,083459,Nie; Jiawang,0,11,30,30
1650102989871,MATH 170A,A02,083460,Nie; Jiawang,0,10,30,30
1650102989871,MATH 170A,A03,083461,Nie; Jiawang,0,11,30,30
1650102995895,MATH 193B,A01,083463,Staff,1,0,30,29
1650102995895,MATH 193B,A02,083464,Staff,8,0,30,22
1650102995895,MATH 193B,A03,083465,Staff,16,0,30,14
1650103001948,COGS 2,A01,083966,Boyle; Mary E. T.,9,0,30,21
1650103007976,COGS 9,A01,083968,Staff,2,0,60,58
1650103013999,COGS 14B,A01,083970,Staff,7,0,50,43
1650103020025,COGS 17,A01,092679,Staff,49,0,75,26
1650103026049,COGS 100,A01,083972,Staff,0,20,60,60
1650103038098,COGS 101C,A01,083976,Staff,12,0,30,18
1650103044122,COGS 102A,A01,083978,Johnson; Christine M.,8,0,30,22
1650103050145,COGS 107B,A01,083980,Staff,0,9,50,50
1650103056168,COGS 115,A01,083982,Staff,9,0,30,21
1650103062192,COGS 118B,A01,083367,Staff,0,16,40,40
1650103068213,COGS 172,A01,083984,Provenzano; Emily Kara,13,0,30,17
1650103074241,COGS 177,A00,083368,Staff,0,22,30,30
1650103080265,COGS 186,A01,083986,Staff,22,0,40,18
1650103086289,COGS 187A,A01,083988,Boyle; Mary E. T.,15,0,60,45
1650103092312,CSE 8A,A50,084003,Miranda; Gregory Joseph,0,19,15,15
1650103098334,CSE 11,A01,084005,Miranda; Gregory Joseph,0,25,55,55
1650103104363,CSE 20,A01,084007,Staff,0,5,20,20
1650103110389,CSE 21,A01,084009,Staff,0,32,50,50
1650103116412,CSE 30,A01,083370,Cao; Yingjun,0,64,40,40
1650103122436,CSE 100,A01,083372,Cao; Yingjun,0,48,40,40
1650103128469,CSE 101,A01,084011,Staff,0,56,40,40
1650103134496,CSE 141,A01,083374,Eldon; John,0,70,75,75
1650103140519,CSE 141L,A01,083376,Eldon; John,0,76,75,75
1650103146641,CSE 175,A01,084013,Kumar; Rakesh,22,0,25,3
1650103152665,CSE 190,A00,092508,Dubnov; Shlomo,18,0,20,2
1650103158688,ECE 5,A01,084049,Morris; Karcher William,12,0,20,8
1650103164712,ECE 100,A01,084051,Baghdadchi; Saharnaz,0,0,20,20
1650103164712,ECE 100,A02,091916,Baghdadchi; Saharnaz,11,0,20,9
1650103170740,ECE 101,A01,084053,Baghdadchi; Saharnaz,0,0,37,37
1650103170740,ECE 101,A02,084054,Baghdadchi; Saharnaz,27,0,37,10
1650103176766,ECE 107,A01,083390,Staff,26,0,40,14
1650103182789,ECE 148,A01,084056,Silberman; Jack,8,0,12,4
1650103188816,ECE 180,A00,083391,Abi Samra; Nicholas Camill,25,0,30,5
1650103188816,ECE 180,B00,083392,Abi Samra; Nicholas Camill,21,0,30,9
1650103194840,MATH 10B,A01,084110,Staff,0,0,30,30
1650103194840,MATH 10B,A02,084111,Staff,16,0,30,14
1650103194840,MATH 10B,A03,084112,Staff,23,0,30,7
1650103200869,MATH 10C,A01,083443,Staff,0,17,30,31
1650103200869,MATH 10C,A02,083444,Staff,0,18,30,30
1650103200869,MATH 10C,B01,084114,Staff,17,0,30,13
1650103200869,MATH 10C,B02,084115,Staff,24,0,30,6
1650103206898,MATH 18,A01,084117,Harel; Guershon,11,0,30,19
1650103206898,MATH 18,A02,084119,Harel; Guershon,27,0,30,3
1650103206898,MATH 18,A03,084120,Harel; Guershon,30,0,30,0
1650103206898,MATH 18,A04,084121,Harel; Guershon,29,0,30,1
1650103212931,MATH 20B,A01,084124,Um; Ko Woon,10,0,35,25
1650103212931,MATH 20B,B01,084126,Um; Ko Woon,24,0,35,11
1650103218959,MATH 20C,A01,083446,Hammock; Frances H,0,0,30,30
1650103218959,MATH 20C,A02,083447,Hammock; Frances H,12,0,30,18
1650103218959,MATH 20C,A03,083448,Hammock; Frances H,18,0,30,12
1650103218959,MATH 20C,A04,083449,Hammock; Frances H,20,0,30,10
1650103218959,MATH 20C,B01,083451,Hammock; Frances H,0,0,30,30
1650103218959,MATH 20C,B02,083452,Hammock; Frances H,14,0,30,16
1650103218959,MATH 20C,B03,083453,Hammock; Frances H,19,0,30,11
1650103218959,MATH 20C,B04,083454,Hammock; Frances H,23,0,30,7
1650103224989,MATH 20D,A01,084128,Staff,13,0,30,17
1650103224989,MATH 20D,A02,084129,Staff,29,0,30,1
1650103224989,MATH 20D,A03,084130,Staff,28,0,30,2
1650103224989,MATH 20D,B01,084133,Staff,0,0,30,30
1650103224989,MATH 20D,B02,084134,Staff,23,0,30,7
1650103224989,MATH 20D,B03,084135,Staff,28,0,30,2
1650103231018,MATH 20E,A01,084138,Staff,13,0,30,17
1650103231018,MATH 20E,A02,084139,Staff,6,0,30,24
1650103231018,MATH 20E,A03,084140,Staff,14,0,30,16
1650103231018,MATH 20E,A04,084141,Staff,19,0,30,11
1650103237043,MATH 102,A01,084143,Harel; Guershon,11,0,30,19
1650103237043,MATH 102,A02,084144,Harel; Guershon,18,0,30,12
1650103243066,MATH 103B,A01,083456,Staff,0,13,30,30
1650103243066,MATH 103B,A02,083457,Staff,0,14,30,30
1650103249091,MATH 109,A01,084146,Salehi Golsefidy; Alireza,16,0,30,14
1650103249091,MATH 109,A02,084147,Salehi Golsefidy; Alireza,15,0,30,15
1650103255124,MATH 120A,A01,085445,Eggers; John Dietrich,6,0,35,29
1650103255124,MATH 120A,A02,085446,Eggers; John Dietrich,26,0,35,9
1650103261148,MATH 142B,A01,084149,Verstraete; Jacques Allan,0,12,30,30
1650103261148,MATH 142B,A02,084150,Verstraete; Jacques Allan,0,12,30,30
1650103267185,MATH 170A,A01,083459,Nie; Jiawang,0,11,30,30
1650103267185,MATH 170A,A02,083460,Nie; Jiawang,0,10,30,30
1650103267185,MATH 170A,A03,083461,Nie; Jiawang,0,11,30,30
1650103273217,MATH 193B,A01,083463,Staff,1,0,30,29
1650103273217,MATH 193B,A02,083464,Staff,8,0,30,22
1650103273217,MATH 193B,A03,083465,Staff,16,0,30,14
1650103279287,COGS 2,A01,083966,Boyle; Mary E. T.,9,0,30,21
1650103285315,COGS 9,A01,083968,Staff,2,0,60,58
1650103291339,COGS 14B,A01,083970,Staff,7,0,50,43
1650103297365,COGS 17,A01,092679,Staff,49,0,75,26
1650103303396,COGS 100,A01,083972,Staff,0,20,60,60
1650103315448,COGS 101C,A01,083976,Staff,12,0,30,18
1650103321472,COGS 102A,A01,083978,Johnson; Christine M.,8,0,30,22
1650103327496,COGS 107B,A01,083980,Staff,0,9,50,50
1650103333524,COGS 115,A01,083982,Staff,9,0,30,21
1650103339552,COGS 118B,A01,083367,Staff,0,16,40,40
1650103345576,COGS 172,A01,083984,Provenzano; Emily Kara,13,0,30,17
1650103351603,COGS 177,A00,083368,Staff,0,22,30,30
1650103357650,COGS 186,A01,083986,Staff,22,0,40,18
1650103363672,COGS 187A,A01,083988,Boyle; Mary E. T.,15,0,60,45
1650103369700,CSE 8A,A50,084003,Miranda; Gregory Joseph,0,19,15,15
1650103375728,CSE 11,A01,084005,Miranda; Gregory Joseph,0,25,55,55
1650103381752,CSE 20,A01,084007,Staff,0,5,20,20
1650103387782,CSE 21,A01,084009,Staff,0,32,50,50
1650103393811,CSE 30,A01,083370,Cao; Yingjun,0,64,40,40
1650103399845,CSE 100,A01,083372,Cao; Yingjun,0,48,40,40
1650103405871,CSE 101,A01,084011,Staff,0,56,40,40
1650103411899,CSE 141,A01,083374,Eldon; John,0,70,75,75
1650103417924,CSE 141L,A01,083376,Eldon; John,0,76,75,75
1650103423960,CSE 175,A01,084013,Kumar; Rakesh,22,0,25,3
1650103429986,CSE 190,A00,092508,Dubnov; Shlomo,18,0,20,2
1650103436009,ECE 5,A01,084049,Morris; Karcher William,12,0,20,8
1650103442033,ECE 100,A01,084051,Baghdadchi; Saharnaz,0,0,20,20
1650103442033,ECE 100,A02,091916,Baghdadchi; Saharnaz,11,0,20,9
1650103448057,ECE 101,A01,084053,Baghdadchi; Saharnaz,0,0,37,37
1650103448057,ECE 101,A02,084054,Baghdadchi; Saharnaz,27,0,37,10
1650103454081,ECE 107,A01,083390,Staff,26,0,40,14
1650103460108,ECE 148,A01,084056,Silberman; Jack,8,0,12,4
1650103466135,ECE 180,A00,083391,Abi Samra; Nicholas Camill,25,0,30,5
1650103466135,ECE 180,B00,083392,Abi Samra; Nicholas Camill,21,0,30,9
1650103472163,MATH 10B,A01,084110,Staff,0,0,30,30
1650103472163,MATH 10B,A02,084111,Staff,16,0,30,14
1650103472163,MATH 10B,A03,084112,Staff,23,0,30,7
1650103478187,MATH 10C,A01,083443,Staff,0,17,30,31
1650103478187,MATH 10C,A02,083444,Staff,0,18,30,30
1650103478187,MATH 10C,B01,084114,Staff,17,0,30,13
1650103478187,MATH 10C,B02,084115,Staff,24,0,30,6
1650103484215,MATH 18,A01,084117,Harel; Guershon,11,0,30,19
1650103484215,MATH 18,A02,084119,Harel; Guershon,27,0,30,3
1650103484215,MATH 18,A03,084120,Harel; Guershon,30,0,30,0
1650103484215,MATH 18,A04,084121,Harel; Guershon,29,0,30,1
1650103490238,MATH 20B,A01,084124,Um; Ko Woon,10,0,35,25
1650103490238,MATH 20B,B01,084126,Um; Ko Woon,24,0,35,11
1650103496263,MATH 20C,A01,083446,Hammock; Frances H,0,0,30,30
1650103496263,MATH 20C,A02,083447,Hammock; Frances H,12,0,30,18
1650103496263,MATH 20C,A03,083448,Hammock; Frances H,18,0,30,12
1650103496263,MATH 20C,A04,083449,Hammock; Frances H,20,0,30,10
1650103496263,MATH 20C,B01,083451,Hammock; Frances H,0,0,30,30
1650103496263,MATH 20C,B02,083452,Hammock; Frances H,14,0,30,16
1650103496263,MATH 20C,B03,083453,Hammock; Frances H,19,0,30,11
1650103496263,MATH 20C,B04,083454,Hammock; Frances H,23,0,30,7
1650103502290,MATH 20D,A01,084128,Staff,13,0,30,17
1650103502290,MATH 20D,A02,084129,Staff,29,0,30,1
1650103502290,MATH 20D,A03,084130,Staff,28,0,30,2
1650103502290,MATH 20D,B01,084133,Staff,0,0,30,30
1650103502290,MATH 20D,B02,084134,Staff,23,0,30,7
1650103502290,MATH 20D,B03,084135,Staff,28,0,30,2
1650103508317,MATH 20E,A01,084138,Staff,13,0,30,17
1650103508317,MATH 20E,A02,084139,Staff,6,0,30,24
1650103508317,MATH 20E,A03,084140,Staff,14,0,30,16
1650103508317,MATH 20E,A04,084141,Staff,19,0,30,11
1650103514341,MATH 102,A01,084143,Harel; Guershon,11,0,30,19
1650103514341,MATH 102,A02,084144,Harel; Guershon,18,0,30,12
1650103520368,MATH 103B,A01,083456,Staff,0,13,30,30
1650103520368,MATH 103B,A02,083457,Staff,0,14,30,30
1650103526392,MATH 109,A01,084146,Salehi Golsefidy; Alireza,16,0,30,14
1650103526392,MATH 109,A02,084147,Salehi Golsefidy; Alireza,15,0,30,15
1650103532417,MATH 120A,A01,085445,Eggers; John Dietrich,6,0,35,29
1650103532417,MATH 120A,A02,085446,Eggers; John Dietrich,26,0,35,9
1650103538448,MATH 142B,A01,084149,Verstraete; Jacques Allan,0,12,30,30
1650103538448,MATH 142B,A02,084150,Verstraete; Jacques Allan,0,12,30,30
1650103544476,MATH 170A,A01,083459,Nie; Jiawang,0,11,30,30
1650103544476,MATH 170A,A02,083460,Nie; Jiawang,0,10,30,30
1650103544476,MATH 170A,A03,083461,Nie; Jiawang,0,11,30,30
1650103550503,MATH 193B,A01,083463,Staff,1,0,30,29
1650103550503,MATH 193B,A02,083464,Staff,8,0,30,22
1650103550503,MATH 193B,A03,083465,Staff,16,0,30,14
1650103556557,COGS 2,A01,083966,Boyle; Mary E. T.,9,0,30,21
1650103562585,COGS 9,A01,083968,Staff,2,0,60,58
1650103568611,COGS 14B,A01,083970,Staff,7,0,50,43
1650103574636,COGS 17,A01,092679,Staff,48,0,75,27
1650103580660,COGS 100,A01,083972,Staff,0,20,60,60
1650103592711,COGS 101C,A01,083976,Staff,12,0,30,18
1650103598739,COGS 102A,A01,083978,Johnson; Christine M.,8,0,30,22
1650103604763,COGS 107B,A01,083980,Staff,0,9,50,50
1650103610790,COGS 115,A01,083982,Staff,9,0,30,21
1650103616814,COGS 118B,A01,083367,Staff,0,16,40,40
1650103622846,COGS 172,A01,083984,Provenzano; Emily Kara,13,0,30,17
1650103628877,COGS 177,A00,083368,Staff,0,22,30,30
1650103634901,COGS 186,A01,083986,Staff,22,0,40,18
1650103640926,COGS 187A,A01,083988,Boyle; Mary E. T.,15,0,60,45
1650103646948,CSE 8A,A50,084003,Miranda; Gregory Joseph,0,19,15,15
1650103652972,CSE 11,A01,084005,Miranda; Gregory Joseph,0,25,55,55
1650103658999,CSE 20,A01,084007,Staff,0,5,20,20
1650103665028,CSE 21,A01,084009,Staff,0,32,50,50
1650103671052,CSE 30,A01,083370,Cao; Yingjun,0,64,40,40
1650103677077,CSE 100,A01,083372,Cao; Yingjun,0,48,40,40
1650103683101,CSE 101,A01,084011,Staff,0,56,40,40
1650103689128,CSE 141,A01,083374,Eldon; John,0,70,75,75
1650103695152,CSE 141L,A01,083376,Eldon; John,0,76,75,75
1650103701178,CSE 175,A01,084013,Kumar; Rakesh,22,0,25,3
1650103707201,CSE 190,A00,092508,Dubnov; Shlomo,18,0,20,2
1650103713224,ECE 5,A01,084049,Morris; Karcher William,12,0,20,8
1650103719246,ECE 100,A01,084051,Baghdadchi; Saharnaz,0,0,20,20
1650103719246,ECE 100,A02,091916,Baghdadchi; Saharnaz,11,0,20,9
1650103725274,ECE 101,A01,084053,Baghdadchi; Saharnaz,0,0,37,37
1650103725274,ECE 101,A02,084054,Baghdadchi; Saharnaz,27,0,37,10
1650103731304,ECE 107,A01,083390,Staff,26,0,40,14
1650103737327,ECE 148,A01,084056,Silberman; Jack,8,0,12,4
1650103743444,ECE 180,A00,083391,Abi Samra; Nicholas Camill,25,0,30,5
1650103743444,ECE 180,B00,083392,Abi Samra; Nicholas Camill,21,0,30,9
1650103749469,MATH 10B,A01,084110,Staff,0,0,30,30
1650103749469,MATH 10B,A02,084111,Staff,16,0,30,14
1650103749469,MATH 10B,A03,084112,Staff,23,0,30,7
1650103755497,MATH 10C,A01,083443,Staff,0,17,30,31
1650103755497,MATH 10C,A02,083444,Staff,0,18,30,30
1650103755497,MATH 10C,B01,084114,Staff,17,0,30,13
1650103755497,MATH 10C,B02,084115,Staff,24,0,30,6
1650103761529,MATH 18,A01,084117,Harel; Guershon,11,0,30,19
1650103761529,MATH 18,A02,084119,Harel; Guershon,27,0,30,3
1650103761529,MATH 18,A03,084120,Harel; Guershon,30,0,30,0
1650103761529,MATH 18,A04,084121,Harel; Guershon,29,0,30,1
1650103767554,MATH 20B,A01,084124,Um; Ko Woon,10,0,35,25
1650103767554,MATH 20B,B01,084126,Um; Ko Woon,24,0,35,11
1650103773583,MATH 20C,A01,083446,Hammock; Frances H,0,0,30,30
1650103773583,MATH 20C,A02,083447,Hammock; Frances H,12,0,30,18
1650103773583,MATH 20C,A03,083448,Hammock; Frances H,18,0,30,12
1650103773583,MATH 20C,A04,083449,Hammock; Frances H,20,0,30,10
1650103773583,MATH 20C,B01,083451,Hammock; Frances H,0,0,30,30
1650103773583,MATH 20C,B02,083452,Hammock; Frances H,14,0,30,16
1650103773583,MATH 20C,B03,083453,Hammock; Frances H,18,0,30,12
1650103773583,MATH 20C,B04,083454,Hammock; Frances H,23,0,30,7
1650103779615,MATH 20D,A01,084128,Staff,13,0,30,17
1650103779615,MATH 20D,A02,084129,Staff,29,0,30,1
1650103779615,MATH 20D,A03,084130,Staff,28,0,30,2
1650103779615,MATH 20D,B01,084133,Staff,0,0,30,30
1650103779615,MATH 20D,B02,084134,Staff,23,0,30,7
1650103779615,MATH 20D,B03,084135,Staff,28,0,30,2
1650103785639,MATH 20E,A01,084138,Staff,13,0,30,17
1650103785639,MATH 20E,A02,084139,Staff,6,0,30,24
1650103785639,MATH 20E,A03,084140,Staff,14,0,30,16
1650103785639,MATH 20E,A04,084141,Staff,19,0,30,11
1650103791663,MATH 102,A01,084143,Harel; Guershon,11,0,30,19
1650103791663,MATH 102,A02,084144,Harel; Guershon,18,0,30,12
1650103797688,MATH 103B,A01,083456,Staff,0,13,30,30
1650103797688,MATH 103B,A02,083457,Staff,0,14,30,30
1650103803715,MATH 109,A01,084146,Salehi Golsefidy; Alireza,16,0,30,14
1650103803715,MATH 109,A02,084147,Salehi Golsefidy; Alireza,15,0,30,15
1650103809743,MATH 120A,A01,085445,Eggers; John Dietrich,6,0,35,29
1650103809743,MATH 120A,A02,085446,Eggers; John Dietrich,26,0,35,9
1650103815767,MATH 142B,A01,084149,Verstraete; Jacques Allan,0,12,30,30
1650103815767,MATH 142B,A02,084150,Verstraete; Jacques Allan,0,12,30,30
1650103821794,MATH 170A,A01,083459,Nie; Jiawang,0,11,30,30
1650103821794,MATH 170A,A02,083460,Nie; Jiawang,0,10,30,30
1650103821794,MATH 170A,A03,083461,Nie; Jiawang,0,11,30,30
1650103827820,MATH 193B,A01,083463,Staff,1,0,30,29
1650103827820,MATH 193B,A02,083464,Staff,8,0,30,22
1650103827820,MATH 193B,A03,083465,Staff,16,0,30,14
1650103833872,COGS 2,A01,083966,Boyle; Mary E. T.,9,0,30,21
1650103839898,COGS 9,A01,083968,Staff,2,0,60,58
1650103845921,COGS 14B,A01,083970,Staff,7,0,50,43
1650103851954,COGS 17,A01,092679,Staff,48,0,75,27
1650103857981,COGS 100,A01,083972,Staff,0,20,60,60
1650103870034,COGS 101C,A01,083976,Staff,12,0,30,18
1650103876059,COGS 102A,A01,083978,Johnson; Christine M.,8,0,30,22
1650103882082,COGS 107B,A01,083980,Staff,0,9,50,50
1650103888104,COGS 115,A01,083982,Staff,9,0,30,21
1650103894128,COGS 118B,A01,083367,Staff,0,16,40,40
1650103900152,COGS 172,A01,083984,Provenzano; Emily Kara,13,0,30,17
1650103906179,COGS 177,A00,083368,Staff,0,22,30,30
1650103912206,COGS 186,A01,083986,Staff,22,0,40,18
1650103918234,COGS 187A,A01,083988,Boyle; Mary E. T.,15,0,60,45
1650103924258,CSE 8A,A50,084003,Miranda; Gregory Joseph,0,19,15,15
1650103930288,CSE 11,A01,084005,Miranda; Gregory Joseph,0,25,55,55
1650103936312,CSE 20,A01,084007,Staff,0,5,20,20
1650103942339,CSE 21,A01,084009,Staff,0,32,50,50
1650103948363,CSE 30,A01,083370,Cao; Yingjun,0,64,40,40
1650103954385,CSE 100,A01,083372,Cao; Yingjun,0,48,40,40
1650103960409,CSE 101,A01,084011,Staff,0,56,40,40
1650103966437,CSE 141,A01,083374,Eldon; John,0,70,75,75
1650103972459,CSE 141L,A01,083376,Eldon; John,0,76,75,75
1650103978486,CSE 175,A01,084013,Kumar; Rakesh,22,0,25,3
1650103984509,CSE 190,A00,092508,Dubnov; Shlomo,18,0,20,2
1650103990532,ECE 5,A01,084049,Morris; Karcher William,12,0,20,8
1650103996557,ECE 100,A01,084051,Baghdadchi; Saharnaz,0,0,20,20
1650103996557,ECE 100,A02,091916,Baghdadchi; Saharnaz,11,0,20,9
1650104002582,ECE 101,A01,084053,Baghdadchi; Saharnaz,0,0,37,37
1650104002582,ECE 101,A02,084054,Baghdadchi; Saharnaz,27,0,37,10
1650104008606,ECE 107,A01,083390,Staff,26,0,40,14
1650104014630,ECE 148,A01,084056,Silberman; Jack,8,0,12,4
1650104020655,ECE 180,A00,083391,Abi Samra; Nicholas Camill,25,0,30,5
1650104020655,ECE 180,B00,083392,Abi Samra; Nicholas Camill,21,0,30,9
1650104026680,MATH 10B,A01,084110,Staff,0,0,30,30
1650104026680,MATH 10B,A02,084111,Staff,16,0,30,14
1650104026680,MATH 10B,A03,084112,Staff,23,0,30,7
1650104032718,MATH 10C,A01,083443,Staff,0,17,30,31
1650104032718,MATH 10C,A02,083444,Staff,0,18,30,30
1650104032718,MATH 10C,B01,084114,Staff,17,0,30,13
1650104032718,MATH 10C,B02,084115,Staff,24,0,30,6
1650104038744,MATH 18,A01,084117,Harel; Guershon,11,0,30,19
1650104038744,MATH 18,A02,084119,Harel; Guershon,27,0,30,3
1650104038744,MATH 18,A03,084120,Harel; Guershon,30,0,30,0
1650104038744,MATH 18,A04,084121,Harel; Guershon,29,0,30,1
1650104044778,MATH 20B,A01,084124,Um; Ko Woon,10,0,35,25
1650104044778,MATH 20B,B01,084126,Um; Ko Woon,24,0,35,11
1650104050807,MATH 20C,A01,083446,Hammock; Frances H,0,0,30,30
1650104050807,MATH 20C,A02,083447,Hammock; Frances H,12,0,30,18
1650104050807,MATH 20C,A03,083448,Hammock; Frances H,18,0,30,12
1650104050807,MATH 20C,A04,083449,Hammock; Frances H,20,0,30,10
1650104050807,MATH 20C,B01,083451,Hammock; Frances H,0,0,30,30
1650104050807,MATH 20C,B02,083452,Hammock; Frances H,14,0,30,16
1650104050807,MATH 20C,B03,083453,Hammock; Frances H,18,0,30,12
1650104050807,MATH 20C,B04,083454,Hammock; Frances H,23,0,30,7
1650104056839,MATH 20D,A01,084128,Staff,13,0,30,17
1650104056839,MATH 20D,A02,084129,Staff,29,0,30,1
1650104056839,MATH 20D,A03,084130,Staff,28,0,30,2
1650104056839,MATH 20D,B01,084133,Staff,0,0,30,30
1650104056839,MATH 20D,B02,084134,Staff,23,0,30,7
1650104056839,MATH 20D,B03,084135,Staff,28,0,30,2
1650104062866,MATH 20E,A01,084138,Staff,13,0,30,17
1650104062866,MATH 20E,A02,084139,Staff,6,0,30,24
1650104062866,MATH 20E,A03,084140,Staff,14,0,30,16
1650104062866,MATH 20E,A04,084141,Staff,19,0,30,11
1650104068891,MATH 102,A01,084143,Harel; Guershon,11,0,30,19
1650104068891,MATH 102,A02,084144,Harel; Guershon,18,0,30,12
1650104074915,MATH 103B,A01,083456,Staff,0,13,30,30
1650104074915,MATH 103B,A02,083457,Staff,0,14,30,30
1650104080949,MATH 109,A01,084146,Salehi Golsefidy; Alireza,16,0,30,14
1650104080949,MATH 109,A02,084147,Salehi Golsefidy; Alireza,15,0,30,15
1650104086981,MATH 120A,A01,085445,Eggers; John Dietrich,6,0,35,29
1650104086981,MATH 120A,A02,085446,Eggers; John Dietrich,26,0,35,9
1650104093008,MATH 142B,A01,084149,Verstraete; Jacques Allan,0,12,30,30
1650104093008,MATH 142B,A02,084150,Verstraete; Jacques Allan,0,12,30,30
1650104099033,MATH 170A,A01,083459,Nie; Jiawang,0,11,30,30
1650104099033,MATH 170A,A02,083460,Nie; Jiawang,0,10,30,30
1650104099033,MATH 170A,A03,083461,Nie; Jiawang,0,11,30,30
1650104105064,MATH 193B,A01,083463,Staff,1,0,30,29
1650104105064,MATH 193B,A02,083464,Staff,8,0,30,22
1650104105064,MATH 193B,A03,083465,Staff,16,0,30,14
1650104111212,COGS 2,A01,083966,Boyle; Mary E. T.,9,0,30,21
1650104117241,COGS 9,A01,083968,Staff,2,0,60,58
1650104123267,COGS 14B,A01,083970,Staff,7,0,50,43
1650104129293,COGS 17,A01,092679,Staff,48,0,75,27
1650104135317,COGS 100,A01,083972,Staff,0,20,60,60
1650104147376,COGS 101C,A01,083976,Staff,12,0,30,18
1650104153403,COGS 102A,A01,083978,Johnson; Christine M.,8,0,30,22
1650104159432,COGS 107B,A01,083980,Staff,0,9,50,50
1650104165462,COGS 115,A01,083982,Staff,9,0,30,21
1650104171487,COGS 118B,A01,083367,Staff,0,16,40,40
1650104177513,COGS 172,A01,083984,Provenzano; Emily Kara,13,0,30,17
1650104183544,COGS 177,A00,083368,Staff,0,22,30,30
1650104189569,COGS 186,A01,083986,Staff,22,0,40,18
1650104195601,COGS 187A,A01,083988,Boyle; Mary E. T.,15,0,60,45
1650104201634,CSE 8A,A50,084003,Miranda; Gregory Joseph,0,19,15,15
1650104207659,CSE 11,A01,084005,Miranda; Gregory Joseph,0,25,55,55
1650104213694,CSE 20,A01,084007,Staff,0,5,20,20
1650104219721,CSE 21,A01,084009,Staff,0,32,50,50
1650104225757,CSE 30,A01,083370,Cao; Yingjun,0,64,40,40
1650104231782,CSE 100,A01,083372,Cao; Yingjun,0,48,40,40
1650104237817,CSE 101,A01,084011,Staff,0,56,40,40
1650104243844,CSE 141,A01,083374,Eldon; John,0,70,75,75
1650104249879,CSE 141L,A01,083376,Eldon; John,0,76,75,75
1650104255904,CSE 175,A01,084013,Kumar; Rakesh,22,0,25,3
1650104261937,CSE 190,A00,092508,Dubnov; Shlomo,18,0,20,2
1650104267974,ECE 5,A01,084049,Morris; Karcher William,12,0,20,8
1650104274013,ECE 100,A01,084051,Baghdadchi; Saharnaz,0,0,20,20
1650104274013,ECE 100,A02,091916,Baghdadchi; Saharnaz,11,0,20,9
1650104280042,ECE 101,A01,084053,Baghdadchi; Saharnaz,0,0,37,37
1650104280042,ECE 101,A02,084054,Baghdadchi; Saharnaz,27,0,37,10
1650104286072,ECE 107,A01,083390,Staff,26,0,40,14
1650104292104,ECE 148,A01,084056,Silberman; Jack,8,0,12,4
1650104298127,ECE 180,A00,083391,Abi Samra; Nicholas Camill,25,0,30,5
1650104298127,ECE 180,B00,083392,Abi Samra; Nicholas Camill,21,0,30,9
1650104304154,MATH 10B,A01,084110,Staff,0,0,30,30
1650104304154,MATH 10B,A02,084111,Staff,16,0,30,14
1650104304154,MATH 10B,A03,084112,Staff,23,0,30,7
1650104310182,MATH 10C,A01,083443,Staff,0,17,30,31
1650104310182,MATH 10C,A02,083444,Staff,0,18,30,30
1650104310182,MATH 10C,B01,084114,Staff,17,0,30,13
1650104310182,MATH 10C,B02,084115,Staff,24,0,30,6
1650104316212,MATH 18,A01,084117,Harel; Guershon,11,0,30,19
1650104316212,MATH 18,A02,084119,Harel; Guershon,27,0,30,3
1650104316212,MATH 18,A03,084120,Harel; Guershon,30,0,30,0
1650104316212,MATH 18,A04,084121,Harel; Guershon,29,0,30,1
1650104322238,MATH 20B,A01,084124,Um; Ko Woon,10,0,35,25
1650104322238,MATH 20B,B01,084126,Um; Ko Woon,24,0,35,11
1650104328269,MATH 20C,A01,083446,Hammock; Frances H,0,0,30,30
1650104328269,MATH 20C,A02,083447,Hammock; Frances H,12,0,30,18
1650104328269,MATH 20C,A03,083448,Hammock; Frances H,18,0,30,12
1650104328269,MATH 20C,A04,083449,Hammock; Frances H,20,0,30,10
1650104328269,MATH 20C,B01,083451,Hammock; Frances H,0,0,30,30
1650104328269,MATH 20C,B02,083452,Hammock; Frances H,14,0,30,16
1650104328269,MATH 20C,B03,083453,Hammock; Frances H,18,0,30,12
1650104328269,MATH 20C,B04,083454,Hammock; Frances H,23,0,30,7
1650104334298,MATH 20D,A01,084128,Staff,13,0,30,17
1650104334298,MATH 20D,A02,084129,Staff,29,0,30,1
1650104334298,MATH 20D,A03,084130,Staff,28,0,30,2
1650104334298,MATH 20D,B01,084133,Staff,0,0,30,30
1650104334298,MATH 20D,B02,084134,Staff,23,0,30,7
1650104334298,MATH 20D,B03,084135,Staff,28,0,30,2
1650104340400,MATH 20E,A01,084138,Staff,13,0,30,17
1650104340400,MATH 20E,A02,084139,Staff,6,0,30,24
1650104340400,MATH 20E,A03,084140,Staff,14,0,30,16
1650104340400,MATH 20E,A04,084141,Staff,19,0,30,11
1650104346430,MATH 102,A01,084143,Harel; Guershon,11,0,30,19
1650104346430,MATH 102,A02,084144,Harel; Guershon,18,0,30,12
1650104352458,MATH 103B,A01,083456,Staff,0,13,30,30
1650104352458,MATH 103B,A02,083457,Staff,0,14,30,30
1650104358484,MATH 109,A01,084146,Salehi Golsefidy; Alireza,16,0,30,14
1650104358484,MATH 109,A02,084147,Salehi Golsefidy; Alireza,15,0,30,15
1650104364516,MATH 120A,A01,085445,Eggers; John Dietrich,6,0,35,29
1650104364516,MATH 120A,A02,085446,Eggers; John Dietrich,26,0,35,9
1650104370541,MATH 142B,A01,084149,Verstraete; Jacques Allan,0,12,30,30
1650104370541,MATH 142B,A02,084150,Verstraete; Jacques Allan,0,12,30,30
1650104376566,MATH 170A,A01,083459,Nie; Jiawang,0,11,30,30
1650104376566,MATH 170A,A02,083460,Nie; Jiawang,0,10,30,30
1650104376566,MATH 170A,A03,083461,Nie; Jiawang,0,11,30,30
1650104382599,MATH 193B,A01,083463,Staff,1,0,30,29
1650104382599,MATH 193B,A02,083464,Staff,8,0,30,22
1650104382599,MATH 193B,A03,083465,Staff,16,0,30,14
1650104388665,COGS 2,A01,083966,Boyle; Mary E. T.,9,0,30,21
1650104394690,COGS 9,A01,083968,Staff,2,0,60,58
1650104400723,COGS 14B,A01,083970,Staff,7,0,50,43
1650104406753,COGS 17,A01,092679,Staff,48,0,75,27
1650104412780,COGS 100,A01,083972,Staff,0,20,60,60
1650104424828,COGS 101C,A01,083976,Staff,12,0,30,18
1650104430858,COGS 102A,A01,083978,Johnson; Christine M.,8,0,30,22
1650104436884,COGS 107B,A01,083980,Staff,0,9,50,50
1650104442909,COGS 115,A01,083982,Staff,9,0,30,21
1650104448938,COGS 118B,A01,083367,Staff,0,16,40,40
1650104454972,COGS 172,A01,083984,Provenzano; Emily Kara,13,0,30,17
1650104461000,COGS 177,A00,083368,Staff,0,22,30,30
1650104467026,COGS 186,A01,083986,Staff,22,0,40,18
1650104473057,COGS 187A,A01,083988,Boyle; Mary E. T.,15,0,60,45
1650104479096,CSE 8A,A50,084003,Miranda; Gregory Joseph,0,19,15,15
1650104485138,CSE 11,A01,084005,Miranda; Gregory Joseph,0,25,55,55
1650104491164,CSE 20,A01,084007,Staff,0,5,20,20
1650104497195,CSE 21,A01,084009,Staff,0,32,50,50
1650104503222,CSE 30,A01,083370,Cao; Yingjun,0,64,40,40
1650104509251,CSE 100,A01,083372,Cao; Yingjun,0,48,40,40
1650104515279,CSE 101,A01,084011,Staff,0,56,40,40
1650104521304,CSE 141,A01,083374,Eldon; John,0,70,75,75
1650104527328,CSE 141L,A01,083376,Eldon; John,0,76,75,75
1650104533358,CSE 175,A01,084013,Kumar; Rakesh,22,0,25,3
1650104539382,CSE 190,A00,092508,Dubnov; Shlomo,18,0,20,2
1650104545409,ECE 5,A01,084049,Morris; Karcher William,12,0,20,8
1650104551436,ECE 100,A01,084051,Baghdadchi; Saharnaz,0,0,20,20
1650104551436,ECE 100,A02,091916,Baghdadchi; Saharnaz,11,0,20,9
1650104557462,ECE 101,A01,084053,Baghdadchi; Saharnaz,0,0,37,37
1650104557462,ECE 101,A02,084054,Baghdadchi; Saharnaz,27,0,37,10
1650104563490,ECE 107,A01,083390,Staff,26,0,40,14
1650104569517,ECE 148,A01,084056,Silberman; Jack,8,0,12,4
1650104575554,ECE 180,A00,083391,Abi Samra; Nicholas Camill,25,0,30,5
1650104575554,ECE 180,B00,083392,Abi Samra; Nicholas Camill,21,0,30,9
1650104581579,MATH 10B,A01,084110,Staff,0,0,30,30
1650104581579,MATH 10B,A02,084111,Staff,16,0,30,14
1650104581579,MATH 10B,A03,084112,Staff,23,0,30,7
1650104587605,MATH 10C,A01,083443,Staff,0,17,30,31
1650104587605,MATH 10C,A02,083444,Staff,0,18,30,30
1650104587605,MATH 10C,B01,084114,Staff,17,0,30,13
1650104587605,MATH 10C,B02,084115,Staff,24,0,30,6
1650104593641,MATH 18,A01,084117,Harel; Guershon,11,0,30,19
1650104593641,MATH 18,A02,084119,Harel; Guershon,27,0,30,3
1650104593641,MATH 18,A03,084120,Harel; Guershon,30,0,30,0
1650104593641,MATH 18,A04,084121,Harel; Guershon,29,0,30,1
1650104599677,MATH 20B,A01,084124,Um; Ko Woon,10,0,35,25
1650104599677,MATH 20B,B01,084126,Um; Ko Woon,24,0,35,11
1650104605707,MATH 20C,A01,083446,Hammock; Frances H,0,0,30,30
1650104605707,MATH 20C,A02,083447,Hammock; Frances H,12,0,30,18
1650104605707,MATH 20C,A03,083448,Hammock; Frances H,18,0,30,12
1650104605707,MATH 20C,A04,083449,Hammock; Frances H,20,0,30,10
1650104605707,MATH 20C,B01,083451,Hammock; Frances H,0,0,30,30
1650104605707,MATH 20C,B02,083452,Hammock; Frances H,14,0,30,16
1650104605707,MATH 20C,B03,083453,Hammock; Frances H,18,0,30,12
1650104605707,MATH 20C,B04,083454,Hammock; Frances H,23,0,30,7
1650104611733,MATH 20D,A01,084128,Staff,13,0,30,17
1650104611733,MATH 20D,A02,084129,Staff,29,0,30,1
1650104611733,MATH 20D,A03,084130,Staff,28,0,30,2
1650104611733,MATH 20D,B01,084133,Staff,0,0,30,30
1650104611733,MATH 20D,B02,084134,Staff,23,0,30,7
1650104611733,MATH 20D,B03,084135,Staff,28,0,30,2
1650104617759,MATH 20E,A01,084138,Staff,13,0,30,17
1650104617759,MATH 20E,A02,084139,Staff,6,0,30,24
1650104617759,MATH 20E,A03,084140,Staff,14,0,30,16
1650104617759,MATH 20E,A04,084141,Staff,19,0,30,11
1650104623785,MATH 102,A01,084143,Harel; Guershon,11,0,30,19
1650104623785,MATH 102,A02,084144,Harel; Guershon,18,0,30,12
1650104629823,MATH 103B,A01,083456,Staff,0,13,30,30
1650104629823,MATH 103B,A02,083457,Staff,0,14,30,30
1650104635848,MATH 109,A01,084146,Salehi Golsefidy; Alireza,16,0,30,14
1650104635848,MATH 109,A02,084147,Salehi Golsefidy; Alireza,15,0,30,15
1650104641879,MATH 120A,A01,085445,Eggers; John Dietrich,6,0,35,29
1650104641879,MATH 120A,A02,085446,Eggers; John Dietrich,26,0,35,9
1650104647902,MATH 142B,A01,084149,Verstraete; Jacques Allan,0,12,30,30
1650104647902,MATH 142B,A02,084150,Verstraete; Jacques Allan,0,12,30,30
1650104653930,MATH 170A,A01,083459,Nie; Jiawang,0,11,30,30
1650104653930,MATH 170A,A02,083460,Nie; Jiawang,0,10,30,30
1650104653930,MATH 170A,A03,083461,Nie; Jiawang,0,11,30,30
1650104659954,MATH 193B,A01,083463,Staff,1,0,30,29
1650104659954,MATH 193B,A02,083464,Staff,8,0,30,22
1650104659954,MATH 193B,A03,083465,Staff,16,0,30,14
1650104666018,COGS 2,A01,083966,Boyle; Mary E. T.,9,0,30,21
1650104672042,COGS 9,A01,083968,Staff,2,0,60,58
1650104678068,COGS 14B,A01,083970,Staff,7,0,50,43
1650104684092,COGS 17,A01,092679,Staff,48,0,75,27
1650104690117,COGS 100,A01,083972,Staff,0,20,60,60
1650104702175,COGS 101C,A01,083976,Staff,12,0,30,18
1650104708211,COGS 102A,A01,083978,Johnson; Christine M.,8,0,30,22
1650104714238,COGS 107B,A01,083980,Staff,0,9,50,50
1650104720267,COGS 115,A01,083982,Staff,9,0,30,21
1650104726296,COGS 118B,A01,083367,Staff,0,16,40,40
1650104732326,COGS 172,A01,083984,Provenzano; Emily Kara,13,0,30,17
1650104738351,COGS 177,A00,083368,Staff,0,22,30,30
1650104744379,COGS 186,A01,083986,Staff,22,0,40,18
1650104750408,COGS 187A,A01,083988,Boyle; Mary E. T.,15,0,60,45
1650104756433,CSE 8A,A50,084003,Miranda; Gregory Joseph,0,19,15,15
1650104762471,CSE 11,A01,084005,Miranda; Gregory Joseph,0,25,55,55
1650104768501,CSE 20,A01,084007,Staff,0,5,20,20
1650104774530,CSE 21,A01,084009,Staff,0,32,50,50
1650104780560,CSE 30,A01,083370,Cao; Yingjun,0,64,40,40
1650104786585,CSE 100,A01,083372,Cao; Yingjun,0,48,40,40
1650104792609,CSE 101,A01,084011,Staff,0,56,40,40
1650104798637,CSE 141,A01,083374,Eldon; John,0,70,75,75
1650104804677,CSE 141L,A01,083376,Eldon; John,0,76,75,75
1650104810703,CSE 175,A01,084013,Kumar; Rakesh,22,0,25,3
1650104816729,CSE 190,A00,092508,Dubnov; Shlomo,18,0,20,2
1650104822752,ECE 5,A01,084049,Morris; Karcher William,12,0,20,8
1650104828778,ECE 100,A01,084051,Baghdadchi; Saharnaz,0,0,20,20
1650104828778,ECE 100,A02,091916,Baghdadchi; Saharnaz,11,0,20,9
1650104834810,ECE 101,A01,084053,Baghdadchi; Saharnaz,0,0,37,37
1650104834810,ECE 101,A02,084054,Baghdadchi; Saharnaz,27,0,37,10
1650104840840,ECE 107,A01,083390,Staff,26,0,40,14
1650104846875,ECE 148,A01,084056,Silberman; Jack,8,0,12,4
1650104852907,ECE 180,A00,083391,Abi Samra; Nicholas Camill,25,0,30,5
1650104852907,ECE 180,B00,083392,Abi Samra; Nicholas Camill,21,0,30,9
1650104858933,MATH 10B,A01,084110,Staff,0,0,30,30
1650104858933,MATH 10B,A02,084111,Staff,16,0,30,14
1650104858933,MATH 10B,A03,084112,Staff,23,0,30,7
1650104864959,MATH 10C,A01,083443,Staff,0,17,30,31
1650104864959,MATH 10C,A02,083444,Staff,0,18,30,30
1650104864959,MATH 10C,B01,084114,Staff,17,0,30,13
1650104864959,MATH 10C,B02,084115,Staff,24,0,30,6
1650104870983,MATH 18,A01,084117,Harel; Guershon,11,0,30,19
1650104870983,MATH 18,A02,084119,Harel; Guershon,27,0,30,3
1650104870983,MATH 18,A03,084120,Harel; Guershon,30,0,30,0
1650104870983,MATH 18,A04,084121,Harel; Guershon,29,0,30,1
1650104877009,MATH 20B,A01,084124,Um; Ko Woon,10,0,35,25
1650104877009,MATH 20B,B01,084126,Um; Ko Woon,24,0,35,11
1650104883034,MATH 20C,A01,083446,Hammock; Frances H,0,0,30,30
1650104883034,MATH 20C,A02,083447,Hammock; Frances H,12,0,30,18
1650104883034,MATH 20C,A03,083448,Hammock; Frances H,18,0,30,12
1650104883034,MATH 20C,A04,083449,Hammock; Frances H,20,0,30,10
1650104883034,MATH 20C,B01,083451,Hammock; Frances H,0,0,30,30
1650104883034,MATH 20C,B02,083452,Hammock; Frances H,14,0,30,16
1650104883034,MATH 20C,B03,083453,Hammock; Frances H,18,0,30,12
1650104883034,MATH 20C,B04,083454,Hammock; Frances H,23,0,30,7
1650104889066,MATH 20D,A01,084128,Staff,13,0,30,17
1650104889066,MATH 20D,A02,084129,Staff,29,0,30,1
1650104889066,MATH 20D,A03,084130,Staff,28,0,30,2
1650104889066,MATH 20D,B01,084133,Staff,0,0,30,30
1650104889066,MATH 20D,B02,084134,Staff,23,0,30,7
1650104889066,MATH 20D,B03,084135,Staff,28,0,30,2
1650104895091,MATH 20E,A01,084138,Staff,13,0,30,17
1650104895091,MATH 20E,A02,084139,Staff,6,0,30,24
1650104895091,MATH 20E,A03,084140,Staff,14,0,30,16
1650104895091,MATH 20E,A04,084141,Staff,19,0,30,11
1650104901117,MATH 102,A01,084143,Harel; Guershon,11,0,30,19
1650104901117,MATH 102,A02,084144,Harel; Guershon,18,0,30,12
1650104907140,MATH 103B,A01,083456,Staff,0,13,30,30
1650104907140,MATH 103B,A02,083457,Staff,0,14,30,30
1650104913168,MATH 109,A01,084146,Salehi Golsefidy; Alireza,16,0,30,14
1650104913168,MATH 109,A02,084147,Salehi Golsefidy; Alireza,15,0,30,15
1650104919192,MATH 120A,A01,085445,Eggers; John Dietrich,6,0,35,29
1650104919192,MATH 120A,A02,085446,Eggers; John Dietrich,26,0,35,9
1650104925217,MATH 142B,A01,084149,Verstraete; Jacques Allan,0,12,30,30
1650104925217,MATH 142B,A02,084150,Verstraete; Jacques Allan,0,12,30,30
1650104931340,MATH 170A,A01,083459,Nie; Jiawang,0,11,30,30
1650104931340,MATH 170A,A02,083460,Nie; Jiawang,0,10,30,30
1650104931340,MATH 170A,A03,083461,Nie; Jiawang,0,11,30,30
1650104937369,MATH 193B,A01,083463,Staff,1,0,30,29
1650104937369,MATH 193B,A02,083464,Staff,8,0,30,22
1650104937369,MATH 193B,A03,083465,Staff,16,0,30,14
1650104943459,COGS 2,A01,083966,Boyle; Mary E. T.,9,0,30,21
1650104949487,COGS 9,A01,083968,Staff,2,0,60,58
1650104955518,COGS 14B,A01,083970,Staff,7,0,50,43
1650104961594,COGS 17,A01,092679,Staff,48,0,75,27
1650104967623,COGS 100,A01,083972,Staff,0,20,60,60
1650104979678,COGS 101C,A01,083976,Staff,12,0,30,18
1650104985702,COGS 102A,A01,083978,Johnson; Christine M.,8,0,30,22
1650104991730,COGS 107B,A01,083980,Staff,0,9,50,50
1650104997759,COGS 115,A01,083982,Staff,9,0,30,21
1650105003786,COGS 118B,A01,083367,Staff,0,16,40,40
1650105009822,COGS 172,A01,083984,Provenzano; Emily Kara,13,0,30,17
1650105015875,COGS 177,A00,083368,Staff,0,22,30,30
1650105021913,COGS 186,A01,083986,Staff,22,0,40,18
1650105027942,COGS 187A,A01,083988,Boyle; Mary E. T.,15,0,60,45
1650105033975,CSE 8A,A50,084003,Miranda; Gregory Joseph,0,19,15,15
1650105040007,CSE 11,A01,084005,Miranda; Gregory Joseph,0,25,55,55
1650105046036,CSE 20,A01,084007,Staff,0,5,20,20
1650105052062,CSE 21,A01,084009,Staff,0,32,50,50
1650105058097,CSE 30,A01,083370,Cao; Yingjun,0,64,40,40
1650105064124,CSE 100,A01,083372,Cao; Yingjun,0,48,40,40
1650105070155,CSE 101,A01,084011,Staff,0,56,40,40
1650105076186,CSE 141,A01,083374,Eldon; John,0,70,75,75
1650105082218,CSE 141L,A01,083376,Eldon; John,0,76,75,75
1650105088249,CSE 175,A01,084013,Kumar; Rakesh,22,0,25,3
1650105094276,CSE 190,A00,092508,Dubnov; Shlomo,18,0,20,2
1650105100307,ECE 5,A01,084049,Morris; Karcher William,12,0,20,8
1650105106335,ECE 100,A01,084051,Baghdadchi; Saharnaz,0,0,20,20
1650105106335,ECE 100,A02,091916,Baghdadchi; Saharnaz,11,0,20,9
1650105112361,ECE 101,A01,084053,Baghdadchi; Saharnaz,0,0,37,37
1650105112361,ECE 101,A02,084054,Baghdadchi; Saharnaz,27,0,37,10
1650105118387,ECE 107,A01,083390,Staff,26,0,40,14
1650105124420,ECE 148,A01,084056,Silberman; Jack,8,0,12,4
1650105130448,ECE 180,A00,083391,Abi Samra; Nicholas Camill,25,0,30,5
1650105130448,ECE 180,B00,083392,Abi Samra; Nicholas Camill,21,0,30,9
1650105136483,MATH 10B,A01,084110,Staff,0,0,30,30
1650105136483,MATH 10B,A02,084111,Staff,16,0,30,14
1650105136483,MATH 10B,A03,084112,Staff,23,0,30,7
1650105142519,MATH 10C,A01,083443,Staff,0,17,30,31
1650105142519,MATH 10C,A02,083444,Staff,0,18,30,30
1650105142519,MATH 10C,B01,084114,Staff,17,0,30,13
1650105142519,MATH 10C,B02,084115,Staff,24,0,30,6
1650105148554,MATH 18,A01,084117,Harel; Guershon,11,0,30,19
1650105148554,MATH 18,A02,084119,Harel; Guershon,27,0,30,3
1650105148554,MATH 18,A03,084120,Harel; Guershon,30,0,30,0
1650105148554,MATH 18,A04,084121,Harel; Guershon,29,0,30,1
1650105154593,MATH 20B,A01,084124,Um; Ko Woon,10,0,35,25
1650105154593,MATH 20B,B01,084126,Um; Ko Woon,24,0,35,11
1650105160620,MATH 20C,A01,083446,Hammock; Frances H,0,0,30,30
1650105160620,MATH 20C,A02,083447,Hammock; Frances H,12,0,30,18
1650105160620,MATH 20C,A03,083448,Hammock; Frances H,18,0,30,12
1650105160620,MATH 20C,A04,083449,Hammock; Frances H,20,0,30,10
1650105160620,MATH 20C,B01,083451,Hammock; Frances H,0,0,30,30
1650105160620,MATH 20C,B02,083452,Hammock; Frances H,14,0,30,16
1650105160620,MATH 20C,B03,083453,Hammock; Frances H,18,0,30,12
1650105160620,MATH 20C,B04,083454,Hammock; Frances H,23,0,30,7
1650105166646,MATH 20D,A01,084128,Staff,13,0,30,17
1650105166646,MATH 20D,A02,084129,Staff,29,0,30,1
1650105166646,MATH 20D,A03,084130,Staff,28,0,30,2
1650105166646,MATH 20D,B01,084133,Staff,0,0,30,30
1650105166646,MATH 20D,B02,084134,Staff,23,0,30,7
1650105166646,MATH 20D,B03,084135,Staff,28,0,30,2
1650105172675,MATH 20E,A01,084138,Staff,13,0,30,17
1650105172675,MATH 20E,A02,084139,Staff,6,0,30,24
1650105172675,MATH 20E,A03,084140,Staff,14,0,30,16
1650105172675,MATH 20E,A04,084141,Staff,19,0,30,11
1650105178709,MATH 102,A01,084143,Harel; Guershon,11,0,30,19
1650105178709,MATH 102,A02,084144,Harel; Guershon,18,0,30,12
1650105184735,MATH 103B,A01,083456,Staff,0,13,30,30
1650105184735,MATH 103B,A02,083457,Staff,0,14,30,30
1650105190771,MATH 109,A01,084146,Salehi Golsefidy; Alireza,16,0,30,14
1650105190771,MATH 109,A02,084147,Salehi Golsefidy; Alireza,15,0,30,15
1650105196816,MATH 120A,A01,085445,Eggers; John Dietrich,6,0,35,29
1650105196816,MATH 120A,A02,085446,Eggers; John Dietrich,26,0,35,9
1650105202850,MATH 142B,A01,084149,Verstraete; Jacques Allan,0,12,30,30
1650105202850,MATH 142B,A02,084150,Verstraete; Jacques Allan,0,12,30,30
1650105208881,MATH 170A,A01,083459,Nie; Jiawang,0,11,30,30
1650105208881,MATH 170A,A02,083460,Nie; Jiawang,0,10,30,30
1650105208881,MATH 170A,A03,083461,Nie; Jiawang,0,11,30,30
1650105214913,MATH 193B,A01,083463,Staff,1,0,30,29
1650105214913,MATH 193B,A02,083464,Staff,8,0,30,22
1650105214913,MATH 193B,A03,083465,Staff,16,0,30,14
1650105220994,COGS 2,A01,083966,Boyle; Mary E. T.,9,0,30,21
1650105227019,COGS 9,A01,083968,Staff,2,0,60,58
1650105233050,COGS 14B,A01,083970,Staff,7,0,50,43
1650105239079,COGS 17,A01,092679,Staff,48,0,75,27
1650105245105,COGS 100,A01,083972,Staff,0,20,60,60
1650105257168,COGS 101C,A01,083976,Staff,12,0,30,18
1650105263192,COGS 102A,A01,083978,Johnson; Christine M.,8,0,30,22
1650105269216,COGS 107B,A01,083980,Staff,0,9,50,50
1650105275240,COGS 115,A01,083982,Staff,9,0,30,21
1650105281264,COGS 118B,A01,083367,Staff,0,16,40,40
1650105287291,COGS 172,A01,083984,Provenzano; Emily Kara,13,0,30,17
1650105293321,COGS 177,A00,083368,Staff,0,22,30,30
1650105299347,COGS 186,A01,083986,Staff,22,0,40,18
1650105305372,COGS 187A,A01,083988,Boyle; Mary E. T.,15,0,60,45
1650105311406,CSE 8A,A50,084003,Miranda; Gregory Joseph,0,19,15,15
1650105317431,CSE 11,A01,084005,Miranda; Gregory Joseph,0,25,55,55
1650105323461,CSE 20,A01,084007,Staff,0,5,20,20
1650105329486,CSE 21,A01,084009,Staff,0,32,50,50
1650105335517,CSE 30,A01,083370,Cao; Yingjun,0,64,40,40
1650105341541,CSE 100,A01,083372,Cao; Yingjun,0,48,40,40
1650105347568,CSE 101,A01,084011,Staff,0,56,40,40
1650105353599,CSE 141,A01,083374,Eldon; John,0,70,75,75
1650105359623,CSE 141L,A01,083376,Eldon; John,0,76,75,75
1650105365664,CSE 175,A01,084013,Kumar; Rakesh,22,0,25,3
1650105371696,CSE 190,A00,092508,Dubnov; Shlomo,18,0,20,2
1650105377736,ECE 5,A01,084049,Morris; Karcher William,12,0,20,8
1650105383770,ECE 100,A01,084051,Baghdadchi; Saharnaz,0,0,20,20
1650105383770,ECE 100,A02,091916,Baghdadchi; Saharnaz,11,0,20,9
1650105389803,ECE 101,A01,084053,Baghdadchi; Saharnaz,0,0,37,37
1650105389803,ECE 101,A02,084054,Baghdadchi; Saharnaz,27,0,37,10
1650105395830,ECE 107,A01,083390,Staff,26,0,40,14
1650105401859,ECE 148,A01,084056,Silberman; Jack,8,0,12,4
1650105407885,ECE 180,A00,083391,Abi Samra; Nicholas Camill,25,0,30,5
1650105407885,ECE 180,B00,083392,Abi Samra; Nicholas Camill,21,0,30,9
1650105413911,MATH 10B,A01,084110,Staff,0,0,30,30
1650105413911,MATH 10B,A02,084111,Staff,16,0,30,14
1650105413911,MATH 10B,A03,084112,Staff,23,0,30,7
1650105419936,MATH 10C,A01,083443,Staff,0,17,30,31
1650105419936,MATH 10C,A02,083444,Staff,0,18,30,30
1650105419936,MATH 10C,B01,084114,Staff,17,0,30,13
1650105419936,MATH 10C,B02,084115,Staff,24,0,30,6
1650105425979,MATH 18,A01,084117,Harel; Guershon,11,0,30,19
1650105425979,MATH 18,A02,084119,Harel; Guershon,27,0,30,3
1650105425979,MATH 18,A03,084120,Harel; Guershon,30,0,30,0
1650105425979,MATH 18,A04,084121,Harel; Guershon,29,0,30,1
1650105432006,MATH 20B,A01,084124,Um; Ko Woon,10,0,35,25
1650105432006,MATH 20B,B01,084126,Um; Ko Woon,24,0,35,11
1650105438034,MATH 20C,A01,083446,Hammock; Frances H,0,0,30,30
1650105438034,MATH 20C,A02,083447,Hammock; Frances H,12,0,30,18
1650105438034,MATH 20C,A03,083448,Hammock; Frances H,18,0,30,12
1650105438034,MATH 20C,A04,083449,Hammock; Frances H,20,0,30,10
1650105438034,MATH 20C,B01,083451,Hammock; Frances H,0,0,30,30
1650105438034,MATH 20C,B02,083452,Hammock; Frances H,14,0,30,16
1650105438034,MATH 20C,B03,083453,Hammock; Frances H,18,0,30,12
1650105438034,MATH 20C,B04,083454,Hammock; Frances H,23,0,30,7
1650105444064,MATH 20D,A01,084128,Staff,13,0,30,17
1650105444064,MATH 20D,A02,084129,Staff,29,0,30,1
1650105444064,MATH 20D,A03,084130,Staff,28,0,30,2
1650105444064,MATH 20D,B01,084133,Staff,0,0,30,30
1650105444064,MATH 20D,B02,084134,Staff,23,0,30,7
1650105444064,MATH 20D,B03,084135,Staff,28,0,30,2
1650105450095,MATH 20E,A01,084138,Staff,13,0,30,17
1650105450095,MATH 20E,A02,084139,Staff,6,0,30,24
1650105450095,MATH 20E,A03,084140,Staff,14,0,30,16
1650105450095,MATH 20E,A04,084141,Staff,19,0,30,11
1650105456128,MATH 102,A01,084143,Harel; Guershon,11,0,30,19
1650105456128,MATH 102,A02,084144,Harel; Guershon,18,0,30,12
1650105462152,MATH 103B,A01,083456,Staff,0,13,30,30
1650105462152,MATH 103B,A02,083457,Staff,0,14,30,30
1650105468177,MATH 109,A01,084146,Salehi Golsefidy; Alireza,16,0,30,14
1650105468177,MATH 109,A02,084147,Salehi Golsefidy; Alireza,15,0,30,15
1650105474206,MATH 120A,A01,085445,Eggers; John Dietrich,6,0,35,29
1650105474206,MATH 120A,A02,085446,Eggers; John Dietrich,26,0,35,9
1650105480229,MATH 142B,A01,084149,Verstraete; Jacques Allan,0,12,30,30
1650105480229,MATH 142B,A02,084150,Verstraete; Jacques Allan,0,12,30,30
1650105486255,MATH 170A,A01,083459,Nie; Jiawang,0,11,30,30
1650105486255,MATH 170A,A02,083460,Nie; Jiawang,0,10,30,30
1650105486255,MATH 170A,A03,083461,Nie; Jiawang,0,11,30,30
1650105492286,MATH 193B,A01,083463,Staff,1,0,30,29
1650105492286,MATH 193B,A02,083464,Staff,8,0,30,22
1650105492286,MATH 193B,A03,083465,Staff,16,0,30,14
1650105498353,COGS 2,A01,083966,Boyle; Mary E. T.,9,0,30,21
1650105504377,COGS 9,A01,083968,Staff,2,0,60,58
1650105510405,COGS 14B,A01,083970,Staff,7,0,50,43
1650105516432,COGS 17,A01,092679,Staff,48,0,75,27
1650105522527,COGS 100,A01,083972,Staff,0,20,60,60
1650105534578,COGS 101C,A01,083976,Staff,12,0,30,18
1650105540603,COGS 102A,A01,083978,Johnson; Christine M.,8,0,30,22
1650105546631,COGS 107B,A01,083980,Staff,0,9,50,50
1650105552659,COGS 115,A01,083982,Staff,9,0,30,21
1650105558684,COGS 118B,A01,083367,Staff,0,16,40,40
1650105564713,COGS 172,A01,083984,Provenzano; Emily Kara,13,0,30,17
1650105570736,COGS 177,A00,083368,Staff,0,22,30,30
1650105576763,COGS 186,A01,083986,Staff,22,0,40,18
1650105582792,COGS 187A,A01,083988,Boyle; Mary E. T.,15,0,60,45
1650105588826,CSE 8A,A50,084003,Miranda; Gregory Joseph,0,19,15,15
1650105594852,CSE 11,A01,084005,Miranda; Gregory Joseph,0,25,55,55
1650105600876,CSE 20,A01,084007,Staff,0,5,20,20
1650105606908,CSE 21,A01,084009,Staff,0,32,50,50
1650105612935,CSE 30,A01,083370,Cao; Yingjun,0,64,40,40
1650105618969,CSE 100,A01,083372,Cao; Yingjun,0,48,40,40
1650105624994,CSE 101,A01,084011,Staff,0,56,40,40
1650105631020,CSE 141,A01,083374,Eldon; John,0,70,75,75
1650105637045,CSE 141L,A01,083376,Eldon; John,0,76,75,75
1650105643072,CSE 175,A01,084013,Kumar; Rakesh,22,0,25,3
1650105649105,CSE 190,A00,092508,Dubnov; Shlomo,18,0,20,2
1650105655139,ECE 5,A01,084049,Morris; Karcher William,12,0,20,8
1650105661177,ECE 100,A01,084051,Baghdadchi; Saharnaz,0,0,20,20
1650105661177,ECE 100,A02,091916,Baghdadchi; Saharnaz,11,0,20,9
1650105667204,ECE 101,A01,084053,Baghdadchi; Saharnaz,0,0,37,37
1650105667204,ECE 101,A02,084054,Baghdadchi; Saharnaz,27,0,37,10
1650105673230,ECE 107,A01,083390,Staff,26,0,40,14
1650105679261,ECE 148,A01,084056,Silberman; Jack,8,0,12,4
1650105685287,ECE 180,A00,083391,Abi Samra; Nicholas Camill,25,0,30,5
1650105685287,ECE 180,B00,083392,Abi Samra; Nicholas Camill,21,0,30,9
1650105691318,MATH 10B,A01,084110,Staff,0,0,30,30
1650105691318,MATH 10B,A02,084111,Staff,16,0,30,14
1650105691318,MATH 10B,A03,084112,Staff,23,0,30,7
1650105697351,MATH 10C,A01,083443,Staff,0,17,30,31
1650105697351,MATH 10C,A02,083444,Staff,0,18,30,30
1650105697351,MATH 10C,B01,084114,Staff,17,0,30,13
1650105697351,MATH 10C,B02,084115,Staff,24,0,30,6
1650105703376,MATH 18,A01,084117,Harel; Guershon,11,0,30,19
1650105703376,MATH 18,A02,084119,Harel; Guershon,27,0,30,3
1650105703376,MATH 18,A03,084120,Harel; Guershon,30,0,30,0
1650105703376,MATH 18,A04,084121,Harel; Guershon,29,0,30,1
1650105709401,MATH 20B,A01,084124,Um; Ko Woon,10,0,35,25
1650105709401,MATH 20B,B01,084126,Um; Ko Woon,24,0,35,11
1650105715435,MATH 20C,A01,083446,Hammock; Frances H,0,0,30,30
1650105715435,MATH 20C,A02,083447,Hammock; Frances H,12,0,30,18
1650105715435,MATH 20C,A03,083448,Hammock; Frances H,18,0,30,12
1650105715435,MATH 20C,A04,083449,Hammock; Frances H,20,0,30,10
1650105715435,MATH 20C,B01,083451,Hammock; Frances H,0,0,30,30
1650105715435,MATH 20C,B02,083452,Hammock; Frances H,14,0,30,16
1650105715435,MATH 20C,B03,083453,Hammock; Frances H,18,0,30,12
1650105715435,MATH 20C,B04,083454,Hammock; Frances H,23,0,30,7
1650105721461,MATH 20D,A01,084128,Staff,13,0,30,17
1650105721461,MATH 20D,A02,084129,Staff,29,0,30,1
1650105721461,MATH 20D,A03,084130,Staff,28,0,30,2
1650105721461,MATH 20D,B01,084133,Staff,0,0,30,30
1650105721461,MATH 20D,B02,084134,Staff,23,0,30,7
1650105721461,MATH 20D,B03,084135,Staff,28,0,30,2
1650105727495,MATH 20E,A01,084138,Staff,13,0,30,17
1650105727495,MATH 20E,A02,084139,Staff,6,0,30,24
1650105727495,MATH 20E,A03,084140,Staff,14,0,30,16
1650105727495,MATH 20E,A04,084141,Staff,19,0,30,11
1650105733526,MATH 102,A01,084143,Harel; Guershon,11,0,30,19
1650105733526,MATH 102,A02,084144,Harel; Guershon,18,0,30,12
1650105739551,MATH 103B,A01,083456,Staff,0,13,30,30
1650105739551,MATH 103B,A02,083457,Staff,0,14,30,30
1650105745577,MATH 109,A01,084146,Salehi Golsefidy; Alireza,16,0,30,14
1650105745577,MATH 109,A02,084147,Salehi Golsefidy; Alireza,15,0,30,15
1650105751605,MATH 120A,A01,085445,Eggers; John Dietrich,6,0,35,29
1650105751605,MATH 120A,A02,085446,Eggers; John Dietrich,26,0,35,9
1650105757629,MATH 142B,A01,084149,Verstraete; Jacques Allan,0,12,30,30
1650105757629,MATH 142B,A02,084150,Verstraete; Jacques Allan,0,12,30,30
1650105763655,MATH 170A,A01,083459,Nie; Jiawang,0,11,30,30
1650105763655,MATH 170A,A02,083460,Nie; Jiawang,0,10,30,30
1650105763655,MATH 170A,A03,083461,Nie; Jiawang,0,11,30,30
1650105769685,MATH 193B,A01,083463,Staff,1,0,30,29
1650105769685,MATH 193B,A02,083464,Staff,8,0,30,22
1650105769685,MATH 193B,A03,083465,Staff,16,0,30,14
1650105775756,COGS 2,A01,083966,Boyle; Mary E. T.,9,0,30,21
1650105781785,COGS 9,A01,083968,Staff,2,0,60,58
1650105787817,COGS 14B,A01,083970,Staff,7,0,50,43
1650105793841,COGS 17,A01,092679,Staff,48,0,75,27
1650105799866,COGS 100,A01,083972,Staff,0,20,60,60
1650105811915,COGS 101C,A01,083976,Staff,12,0,30,18
1650105817944,COGS 102A,A01,083978,Johnson; Christine M.,8,0,30,22
1650105823967,COGS 107B,A01,083980,Staff,0,9,50,50
1650105829992,COGS 115,A01,083982,Staff,9,0,30,21
1650105836019,COGS 118B,A01,083367,Staff,0,16,40,40
1650105842046,COGS 172,A01,083984,Provenzano; Emily Kara,13,0,30,17
1650105848070,COGS 177,A00,083368,Staff,0,22,30,30
1650105854097,COGS 186,A01,083986,Staff,22,0,40,18
1650105860120,COGS 187A,A01,083988,Boyle; Mary E. T.,15,0,60,45
1650105866156,CSE 8A,A50,084003,Miranda; Gregory Joseph,0,19,15,15
1650105872194,CSE 11,A01,084005,Miranda; Gregory Joseph,0,25,55,55
1650105878222,CSE 20,A01,084007,Staff,0,5,20,20
1650105884247,CSE 21,A01,084009,Staff,0,32,50,50
1650105890273,CSE 30,A01,083370,Cao; Yingjun,0,64,40,40
1650105896301,CSE 100,A01,083372,Cao; Yingjun,0,48,40,40
1650105902325,CSE 101,A01,084011,Staff,0,56,40,40
1650105908350,CSE 141,A01,083374,Eldon; John,0,70,75,75
1650105914375,CSE 141L,A01,083376,Eldon; John,0,76,75,75
1650105920400,CSE 175,A01,084013,Kumar; Rakesh,22,0,25,3
1650105926427,CSE 190,A00,092508,Dubnov; Shlomo,18,0,20,2
1650105932472,ECE 5,A01,084049,Morris; Karcher William,12,0,20,8
1650105938507,ECE 100,A01,084051,Baghdadchi; Saharnaz,0,0,20,20
1650105938507,ECE 100,A02,091916,Baghdadchi; Saharnaz,11,0,20,9
1650105944538,ECE 101,A01,084053,Baghdadchi; Saharnaz,0,0,37,37
1650105944538,ECE 101,A02,084054,Baghdadchi; Saharnaz,27,0,37,10
1650105950567,ECE 107,A01,083390,Staff,26,0,40,14
1650105956599,ECE 148,A01,084056,Silberman; Jack,8,0,12,4
1650105962624,ECE 180,A00,083391,Abi Samra; Nicholas Camill,25,0,30,5
1650105962624,ECE 180,B00,083392,Abi Samra; Nicholas Camill,21,0,30,9
1650105968651,MATH 10B,A01,084110,Staff,0,0,30,30
1650105968651,MATH 10B,A02,084111,Staff,16,0,30,14
1650105968651,MATH 10B,A03,084112,Staff,23,0,30,7
1650105974682,MATH 10C,A01,083443,Staff,0,17,30,31
1650105974682,MATH 10C,A02,083444,Staff,0,18,30,30
1650105974682,MATH 10C,B01,084114,Staff,17,0,30,13
1650105974682,MATH 10C,B02,084115,Staff,24,0,30,6
1650105980713,MATH 18,A01,084117,Harel; Guershon,11,0,30,19
1650105980713,MATH 18,A02,084119,Harel; Guershon,27,0,30,3
1650105980713,MATH 18,A03,084120,Harel; Guershon,30,0,30,0
1650105980713,MATH 18,A04,084121,Harel; Guershon,29,0,30,1
1650105986739,MATH 20B,A01,084124,Um; Ko Woon,10,0,35,25
1650105986739,MATH 20B,B01,084126,Um; Ko Woon,24,0,35,11
1650105992767,MATH 20C,A01,083446,Hammock; Frances H,0,0,30,30
1650105992767,MATH 20C,A02,083447,Hammock; Frances H,12,0,30,18
1650105992767,MATH 20C,A03,083448,Hammock; Frances H,18,0,30,12
1650105992767,MATH 20C,A04,083449,Hammock; Frances H,20,0,30,10
1650105992767,MATH 20C,B01,083451,Hammock; Frances H,0,0,30,30
1650105992767,MATH 20C,B02,083452,Hammock; Frances H,14,0,30,16
1650105992767,MATH 20C,B03,083453,Hammock; Frances H,18,0,30,12
1650105992767,MATH 20C,B04,083454,Hammock; Frances H,23,0,30,7
1650105998806,MATH 20D,A01,084128,Staff,13,0,30,17
1650105998806,MATH 20D,A02,084129,Staff,29,0,30,1
1650105998806,MATH 20D,A03,084130,Staff,28,0,30,2
1650105998806,MATH 20D,B01,084133,Staff,0,0,30,30
1650105998806,MATH 20D,B02,084134,Staff,23,0,30,7
1650105998806,MATH 20D,B03,084135,Staff,28,0,30,2
1650106004831,MATH 20E,A01,084138,Staff,13,0,30,17
1650106004831,MATH 20E,A02,084139,Staff,6,0,30,24
1650106004831,MATH 20E,A03,084140,Staff,14,0,30,16
1650106004831,MATH 20E,A04,084141,Staff,19,0,30,11
1650106010863,MATH 102,A01,084143,Harel; Guershon,11,0,30,19
1650106010863,MATH 102,A02,084144,Harel; Guershon,18,0,30,12
1650106016888,MATH 103B,A01,083456,Staff,0,13,30,30
1650106016888,MATH 103B,A02,083457,Staff,0,14,30,30
1650106022915,MATH 109,A01,084146,Salehi Golsefidy; Alireza,16,0,30,14
1650106022915,MATH 109,A02,084147,Salehi Golsefidy; Alireza,15,0,30,15
1650106028940,MATH 120A,A01,085445,Eggers; John Dietrich,6,0,35,29
1650106028940,MATH 120A,A02,085446,Eggers; John Dietrich,26,0,35,9
1650106034966,MATH 142B,A01,084149,Verstraete; Jacques Allan,0,12,30,30
1650106034966,MATH 142B,A02,084150,Verstraete; Jacques Allan,0,12,30,30
1650106040992,MATH 170A,A01,083459,Nie; Jiawang,0,11,30,30
1650106040992,MATH 170A,A02,083460,Nie; Jiawang,0,10,30,30
1650106040992,MATH 170A,A03,083461,Nie; Jiawang,0,11,30,30
1650106047016,MATH 193B,A01,083463,Staff,1,0,30,29
1650106047016,MATH 193B,A02,083464,Staff,8,0,30,22
1650106047016,MATH 193B,A03,083465,Staff,16,0,30,14
1650106053092,COGS 2,A01,083966,Boyle; Mary E. T.,9,0,30,21
1650106059123,COGS 9,A01,083968,Staff,2,0,60,58
1650106065155,COGS 14B,A01,083970,Staff,7,0,50,43
1650106071184,COGS 17,A01,092679,Staff,48,0,75,27
1650106077208,COGS 100,A01,083972,Staff,0,20,60,60
1650106089262,COGS 101C,A01,083976,Staff,12,0,30,18
1650106095287,COGS 102A,A01,083978,Johnson; Christine M.,8,0,30,22
1650106101311,COGS 107B,A01,083980,Staff,0,9,50,50
1650106107335,COGS 115,A01,083982,Staff,9,0,30,21
1650106113363,COGS 118B,A01,083367,Staff,0,16,40,40
1650106119491,COGS 172,A01,083984,Provenzano; Emily Kara,13,0,30,17
1650106125515,COGS 177,A00,083368,Staff,0,22,30,30
1650106131545,COGS 186,A01,083986,Staff,22,0,40,18
1650106137570,COGS 187A,A01,083988,Boyle; Mary E. T.,15,0,60,45
1650106143596,CSE 8A,A50,084003,Miranda; Gregory Joseph,0,19,15,15
1650106149621,CSE 11,A01,084005,Miranda; Gregory Joseph,0,25,55,55
1650106155651,CSE 20,A01,084007,Staff,0,5,20,20
1650106161681,CSE 21,A01,084009,Staff,0,32,50,50
1650106167708,CSE 30,A01,083370,Cao; Yingjun,0,64,40,40
1650106173737,CSE 100,A01,083372,Cao; Yingjun,0,48,40,40
1650106179766,CSE 101,A01,084011,Staff,0,56,40,40
1650106185789,CSE 141,A01,083374,Eldon; John,0,70,75,75
1650106191817,CSE 141L,A01,083376,Eldon; John,0,76,75,75
1650106197841,CSE 175,A01,084013,Kumar; Rakesh,22,0,25,3
1650106203863,CSE 190,A00,092508,Dubnov; Shlomo,18,0,20,2
1650106209891,ECE 5,A01,084049,Morris; Karcher William,12,0,20,8
1650106215925,ECE 100,A01,084051,Baghdadchi; Saharnaz,0,0,20,20
1650106215925,ECE 100,A02,091916,Baghdadchi; Saharnaz,11,0,20,9
1650106221958,ECE 101,A01,084053,Baghdadchi; Saharnaz,0,0,37,37
1650106221958,ECE 101,A02,084054,Baghdadchi; Saharnaz,27,0,37,10
1650106227983,ECE 107,A01,083390,Staff,26,0,40,14
1650106234009,ECE 148,A01,084056,Silberman; Jack,8,0,12,4
1650106240035,ECE 180,A00,083391,Abi Samra; Nicholas Camill,25,0,30,5
1650106240035,ECE 180,B00,083392,Abi Samra; Nicholas Camill,21,0,30,9
1650106246072,MATH 10B,A01,084110,Staff,0,0,30,30
1650106246072,MATH 10B,A02,084111,Staff,16,0,30,14
1650106246072,MATH 10B,A03,084112,Staff,23,0,30,7
1650106252097,MATH 10C,A01,083443,Staff,0,17,30,31
1650106252097,MATH 10C,A02,083444,Staff,0,18,30,30
1650106252097,MATH 10C,B01,084114,Staff,17,0,30,13
1650106252097,MATH 10C,B02,084115,Staff,24,0,30,6
1650106258121,MATH 18,A01,084117,Harel; Guershon,11,0,30,19
1650106258121,MATH 18,A02,084119,Harel; Guershon,27,0,30,3
1650106258121,MATH 18,A03,084120,Harel; Guershon,30,0,30,0
1650106258121,MATH 18,A04,084121,Harel; Guershon,29,0,30,1
1650106264147,MATH 20B,A01,084124,Um; Ko Woon,10,0,35,25
1650106264147,MATH 20B,B01,084126,Um; Ko Woon,24,0,35,11
1650106270182,MATH 20C,A01,083446,Hammock; Frances H,0,0,30,30
1650106270182,MATH 20C,A02,083447,Hammock; Frances H,12,0,30,18
1650106270182,MATH 20C,A03,083448,Hammock; Frances H,18,0,30,12
1650106270182,MATH 20C,A04,083449,Hammock; Frances H,20,0,30,10
1650106270182,MATH 20C,B01,083451,Hammock; Frances H,0,0,30,30
1650106270182,MATH 20C,B02,083452,Hammock; Frances H,14,0,30,16
1650106270182,MATH 20C,B03,083453,Hammock; Frances H,18,0,30,12
1650106270182,MATH 20C,B04,083454,Hammock; Frances H,23,0,30,7
1650106276208,MATH 20D,A01,084128,Staff,13,0,30,17
1650106276208,MATH 20D,A02,084129,Staff,29,0,30,1
1650106276208,MATH 20D,A03,084130,Staff,28,0,30,2
1650106276208,MATH 20D,B01,084133,Staff,0,0,30,30
1650106276208,MATH 20D,B02,084134,Staff,23,0,30,7
1650106276208,MATH 20D,B03,084135,Staff,28,0,30,2
1650106282233,MATH 20E,A01,084138,Staff,13,0,30,17
1650106282233,MATH 20E,A02,084139,Staff,6,0,30,24
1650106282233,MATH 20E,A03,084140,Staff,14,0,30,16
1650106282233,MATH 20E,A04,084141,Staff,19,0,30,11
1650106288263,MATH 102,A01,084143,Harel; Guershon,11,0,30,19
1650106288263,MATH 102,A02,084144,Harel; Guershon,18,0,30,12
1650106294287,MATH 103B,A01,083456,Staff,0,13,30,30
1650106294287,MATH 103B,A02,083457,Staff,0,14,30,30
1650106300314,MATH 109,A01,084146,Salehi Golsefidy; Alireza,16,0,30,14
1650106300314,MATH 109,A02,084147,Salehi Golsefidy; Alireza,15,0,30,15
1650106306342,MATH 120A,A01,085445,Eggers; John Dietrich,6,0,35,29
1650106306342,MATH 120A,A02,085446,Eggers; John Dietrich,26,0,35,9
1650106312365,MATH 142B,A01,084149,Verstraete; Jacques Allan,0,12,30,30
1650106312365,MATH 142B,A02,084150,Verstraete; Jacques Allan,0,12,30,30
1650106318392,MATH 170A,A01,083459,Nie; Jiawang,0,11,30,30
1650106318392,MATH 170A,A02,083460,Nie; Jiawang,0,10,30,30
1650106318392,MATH 170A,A03,083461,Nie; Jiawang,0,11,30,30
1650106324417,MATH 193B,A01,083463,Staff,1,0,30,29
1650106324417,MATH 193B,A02,083464,Staff,8,0,30,22
1650106324417,MATH 193B,A03,083465,Staff,16,0,30,14
1650106330498,COGS 2,A01,083966,Boyle; Mary E. T.,9,0,30,21
1650106336522,COGS 9,A01,083968,Staff,2,0,60,58
1650106342560,COGS 14B,A01,083970,Staff,7,0,50,43
1650106348584,COGS 17,A01,092679,Staff,48,0,75,27
1650106354611,COGS 100,A01,083972,Staff,0,20,60,60
1650106366668,COGS 101C,A01,083976,Staff,12,0,30,18
1650106372694,COGS 102A,A01,083978,Johnson; Christine M.,8,0,30,22
1650106378721,COGS 107B,A01,083980,Staff,0,9,50,50
1650106384750,COGS 115,A01,083982,Staff,9,0,30,21
1650106390775,COGS 118B,A01,083367,Staff,0,16,40,40
1650106396800,COGS 172,A01,083984,Provenzano; Emily Kara,13,0,30,17
1650106402823,COGS 177,A00,083368,Staff,0,22,30,30
1650106408846,COGS 186,A01,083986,Staff,22,0,40,18
1650106414870,COGS 187A,A01,083988,Boyle; Mary E. T.,15,0,60,45
1650106420903,CSE 8A,A50,084003,Miranda; Gregory Joseph,0,19,15,15
1650106426932,CSE 11,A01,084005,Miranda; Gregory Joseph,0,25,55,55
1650106432962,CSE 20,A01,084007,Staff,0,5,20,20
1650106438988,CSE 21,A01,084009,Staff,0,32,50,50
1650106445018,CSE 30,A01,083370,Cao; Yingjun,0,64,40,40
1650106451043,CSE 100,A01,083372,Cao; Yingjun,0,48,40,40
1650106457068,CSE 101,A01,084011,Staff,0,56,40,40
1650106463097,CSE 141,A01,083374,Eldon; John,0,70,75,75
1650106469127,CSE 141L,A01,083376,Eldon; John,0,76,75,75
1650106475150,CSE 175,A01,084013,Kumar; Rakesh,22,0,25,3
1650106481176,CSE 190,A00,092508,Dubnov; Shlomo,18,0,20,2
1650106487211,ECE 5,A01,084049,Morris; Karcher William,12,0,20,8
1650106493237,ECE 100,A01,084051,Baghdadchi; Saharnaz,0,0,20,20
1650106493237,ECE 100,A02,091916,Baghdadchi; Saharnaz,11,0,20,9
1650106499269,ECE 101,A01,084053,Baghdadchi; Saharnaz,0,0,37,37
1650106499269,ECE 101,A02,084054,Baghdadchi; Saharnaz,27,0,37,10
1650106505303,ECE 107,A01,083390,Staff,26,0,40,14
1650106511328,ECE 148,A01,084056,Silberman; Jack,8,0,12,4
1650106517358,ECE 180,A00,083391,Abi Samra; Nicholas Camill,25,0,30,5
1650106517358,ECE 180,B00,083392,Abi Samra; Nicholas Camill,21,0,30,9
1650106523384,MATH 10B,A01,084110,Staff,0,0,30,30
1650106523384,MATH 10B,A02,084111,Staff,16,0,30,14
1650106523384,MATH 10B,A03,084112,Staff,23,0,30,7
1650106529410,MATH 10C,A01,083443,Staff,0,17,30,31
1650106529410,MATH 10C,A02,083444,Staff,0,18,30,30
1650106529410,MATH 10C,B01,084114,Staff,17,0,30,13
1650106529410,MATH 10C,B02,084115,Staff,24,0,30,6
1650106535435,MATH 18,A01,084117,Harel; Guershon,11,0,30,19
1650106535435,MATH 18,A02,084119,Harel; Guershon,27,0,30,3
1650106535435,MATH 18,A03,084120,Harel; Guershon,30,0,30,0
1650106535435,MATH 18,A04,084121,Harel; Guershon,29,0,30,1
1650106541461,MATH 20B,A01,084124,Um; Ko Woon,10,0,35,25
1650106541461,MATH 20B,B01,084126,Um; Ko Woon,24,0,35,11
1650106547494,MATH 20C,A01,083446,Hammock; Frances H,0,0,30,30
1650106547494,MATH 20C,A02,083447,Hammock; Frances H,12,0,30,18
1650106547494,MATH 20C,A03,083448,Hammock; Frances H,18,0,30,12
1650106547494,MATH 20C,A04,083449,Hammock; Frances H,20,0,30,10
1650106547494,MATH 20C,B01,083451,Hammock; Frances H,0,0,30,30
1650106547494,MATH 20C,B02,083452,Hammock; Frances H,14,0,30,16
1650106547494,MATH 20C,B03,083453,Hammock; Frances H,18,0,30,12
1650106547494,MATH 20C,B04,083454,Hammock; Frances H,23,0,30,7
1650106553521,MATH 20D,A01,084128,Staff,13,0,30,17
1650106553521,MATH 20D,A02,084129,Staff,29,0,30,1
1650106553521,MATH 20D,A03,084130,Staff,28,0,30,2
1650106553521,MATH 20D,B01,084133,Staff,0,0,30,30
1650106553521,MATH 20D,B02,084134,Staff,23,0,30,7
1650106553521,MATH 20D,B03,084135,Staff,28,0,30,2
1650106559548,MATH 20E,A01,084138,Staff,13,0,30,17
1650106559548,MATH 20E,A02,084139,Staff,6,0,30,24
1650106559548,MATH 20E,A03,084140,Staff,14,0,30,16
1650106559548,MATH 20E,A04,084141,Staff,19,0,30,11
1650106565572,MATH 102,A01,084143,Harel; Guershon,11,0,30,19
1650106565572,MATH 102,A02,084144,Harel; Guershon,18,0,30,12
1650106571600,MATH 103B,A01,083456,Staff,0,13,30,30
1650106571600,MATH 103B,A02,083457,Staff,0,14,30,30
1650106577626,MATH 109,A01,084146,Salehi Golsefidy; Alireza,16,0,30,14
1650106577626,MATH 109,A02,084147,Salehi Golsefidy; Alireza,15,0,30,15
1650106583649,MATH 120A,A01,085445,Eggers; John Dietrich,6,0,35,29
1650106583649,MATH 120A,A02,085446,Eggers; John Dietrich,26,0,35,9
1650106589674,MATH 142B,A01,084149,Verstraete; Jacques Allan,0,12,30,30
1650106589674,MATH 142B,A02,084150,Verstraete; Jacques Allan,0,12,30,30
1650106595704,MATH 170A,A01,083459,Nie; Jiawang,0,11,30,30
1650106595704,MATH 170A,A02,083460,Nie; Jiawang,0,10,30,30
1650106595704,MATH 170A,A03,083461,Nie; Jiawang,0,11,30,30
1650106601730,MATH 193B,A01,083463,Staff,1,0,30,29
1650106601730,MATH 193B,A02,083464,Staff,8,0,30,22
1650106601730,MATH 193B,A03,083465,Staff,16,0,30,14
1650106607798,COGS 2,A01,083966,Boyle; Mary E. T.,9,0,30,21
1650106613829,COGS 9,A01,083968,Staff,2,0,60,58
1650106619861,COGS 14B,A01,083970,Staff,7,0,50,43
1650106625885,COGS 17,A01,092679,Staff,48,0,75,27
1650106631910,COGS 100,A01,083972,Staff,0,20,60,60
1650106643984,COGS 101C,A01,083976,Staff,12,0,30,18
1650106650025,COGS 102A,A01,083978,Johnson; Christine M.,8,0,30,22
1650106656050,COGS 107B,A01,083980,Staff,0,9,50,50
1650106662075,COGS 115,A01,083982,Staff,9,0,30,21
1650106668106,COGS 118B,A01,083367,Staff,0,16,40,40
1650106674133,COGS 172,A01,083984,Provenzano; Emily Kara,13,0,30,17
1650106680158,COGS 177,A00,083368,Staff,0,22,30,30
1650106686183,COGS 186,A01,083986,Staff,22,0,40,18
1650106692211,COGS 187A,A01,083988,Boyle; Mary E. T.,15,0,60,45
1650106698237,CSE 8A,A50,084003,Miranda; Gregory Joseph,0,19,15,15
1650106704266,CSE 11,A01,084005,Miranda; Gregory Joseph,0,25,55,55
1650106710296,CSE 20,A01,084007,Staff,0,5,20,20
1650106716419,CSE 21,A01,084009,Staff,0,32,50,50
1650106722443,CSE 30,A01,083370,Cao; Yingjun,0,64,40,40
1650106728467,CSE 100,A01,083372,Cao; Yingjun,0,48,40,40
1650106734493,CSE 101,A01,084011,Staff,0,56,40,40
1650106740525,CSE 141,A01,083374,Eldon; John,0,70,75,75
1650106746550,CSE 141L,A01,083376,Eldon; John,0,76,75,75
1650106752574,CSE 175,A01,084013,Kumar; Rakesh,22,0,25,3
1650106758607,CSE 190,A00,092508,Dubnov; Shlomo,18,0,20,2
1650106764664,ECE 5,A01,084049,Morris; Karcher William,12,0,20,8
1650106770691,ECE 100,A01,084051,Baghdadchi; Saharnaz,0,0,20,20
1650106770691,ECE 100,A02,091916,Baghdadchi; Saharnaz,11,0,20,9
1650106776724,ECE 101,A01,084053,Baghdadchi; Saharnaz,0,0,37,37
1650106776724,ECE 101,A02,084054,Baghdadchi; Saharnaz,27,0,37,10
1650106782755,ECE 107,A01,083390,Staff,26,0,40,14
1650106788781,ECE 148,A01,084056,Silberman; Jack,8,0,12,4
1650106794812,ECE 180,A00,083391,Abi Samra; Nicholas Camill,25,0,30,5
1650106794812,ECE 180,B00,083392,Abi Samra; Nicholas Camill,21,0,30,9
1650106800848,MATH 10B,A01,084110,Staff,0,0,30,30
1650106800848,MATH 10B,A02,084111,Staff,16,0,30,14
1650106800848,MATH 10B,A03,084112,Staff,23,0,30,7
1650106806875,MATH 10C,A01,083443,Staff,0,17,30,31
1650106806875,MATH 10C,A02,083444,Staff,0,18,30,30
1650106806875,MATH 10C,B01,084114,Staff,17,0,30,13
1650106806875,MATH 10C,B02,084115,Staff,24,0,30,6
1650106812902,MATH 18,A01,084117,Harel; Guershon,11,0,30,19
1650106812902,MATH 18,A02,084119,Harel; Guershon,27,0,30,3
1650106812902,MATH 18,A03,084120,Harel; Guershon,30,0,30,0
1650106812902,MATH 18,A04,084121,Harel; Guershon,29,0,30,1
1650106818934,MATH 20B,A01,084124,Um; Ko Woon,10,0,35,25
1650106818934,MATH 20B,B01,084126,Um; Ko Woon,24,0,35,11
1650106824970,MATH 20C,A01,083446,Hammock; Frances H,0,0,30,30
1650106824970,MATH 20C,A02,083447,Hammock; Frances H,12,0,30,18
1650106824970,MATH 20C,A03,083448,Hammock; Frances H,18,0,30,12
1650106824970,MATH 20C,A04,083449,Hammock; Frances H,20,0,30,10
1650106824970,MATH 20C,B01,083451,Hammock; Frances H,0,0,30,30
1650106824970,MATH 20C,B02,083452,Hammock; Frances H,14,0,30,16
1650106824970,MATH 20C,B03,083453,Hammock; Frances H,18,0,30,12
1650106824970,MATH 20C,B04,083454,Hammock; Frances H,23,0,30,7
1650106831007,MATH 20D,A01,084128,Staff,13,0,30,17
1650106831007,MATH 20D,A02,084129,Staff,29,0,30,1
1650106831007,MATH 20D,A03,084130,Staff,28,0,30,2
1650106831007,MATH 20D,B01,084133,Staff,0,0,30,30
1650106831007,MATH 20D,B02,084134,Staff,23,0,30,7
1650106831007,MATH 20D,B03,084135,Staff,28,0,30,2
1650106837032,MATH 20E,A01,084138,Staff,13,0,30,17
1650106837032,MATH 20E,A02,084139,Staff,6,0,30,24
1650106837032,MATH 20E,A03,084140,Staff,14,0,30,16
1650106837032,MATH 20E,A04,084141,Staff,19,0,30,11
1650106843057,MATH 102,A01,084143,Harel; Guershon,11,0,30,19
1650106843057,MATH 102,A02,084144,Harel; Guershon,18,0,30,12
1650106849081,MATH 103B,A01,083456,Staff,0,13,30,30
1650106849081,MATH 103B,A02,083457,Staff,0,14,30,30
1650106855107,MATH 109,A01,084146,Salehi Golsefidy; Alireza,16,0,30,14
1650106855107,MATH 109,A02,084147,Salehi Golsefidy; Alireza,15,0,30,15
1650106861139,MATH 120A,A01,085445,Eggers; John Dietrich,6,0,35,29
1650106861139,MATH 120A,A02,085446,Eggers; John Dietrich,26,0,35,9
1650106867170,MATH 142B,A01,084149,Verstraete; Jacques Allan,0,12,30,30
1650106867170,MATH 142B,A02,084150,Verstraete; Jacques Allan,0,12,30,30
1650106873203,MATH 170A,A01,083459,Nie; Jiawang,0,11,30,30
1650106873203,MATH 170A,A02,083460,Nie; Jiawang,0,10,30,30
1650106873203,MATH 170A,A03,083461,Nie; Jiawang,0,11,30,30
1650106879228,MATH 193B,A01,083463,Staff,1,0,30,29
1650106879228,MATH 193B,A02,083464,Staff,8,0,30,22
1650106879228,MATH 193B,A03,083465,Staff,16,0,30,14
1650106885294,COGS 2,A01,083966,Boyle; Mary E. T.,9,0,30,21
1650106891329,COGS 9,A01,083968,Staff,2,0,60,58
1650106897359,COGS 14B,A01,083970,Staff,7,0,50,43
1650106903389,COGS 17,A01,092679,Staff,48,0,75,27
1650106909414,COGS 100,A01,083972,Staff,0,20,60,60
1650106921462,COGS 101C,A01,083976,Staff,12,0,30,18
1650106927494,COGS 102A,A01,083978,Johnson; Christine M.,8,0,30,22
1650106933521,COGS 107B,A01,083980,Staff,0,9,50,50
1650106939544,COGS 115,A01,083982,Staff,9,0,30,21
1650106945581,COGS 118B,A01,083367,Staff,0,16,40,40
1650106951606,COGS 172,A01,083984,Provenzano; Emily Kara,13,0,30,17
1650106957631,COGS 177,A00,083368,Staff,0,22,30,30
1650106963663,COGS 186,A01,083986,Staff,22,0,40,18
1650106969703,COGS 187A,A01,083988,Boyle; Mary E. T.,15,0,60,45
1650106975731,CSE 8A,A50,084003,Miranda; Gregory Joseph,0,19,15,15
1650106981848,CSE 11,A01,084005,Miranda; Gregory Joseph,0,25,55,55
1650106987878,CSE 20,A01,084007,Staff,0,5,20,20
1650106993907,CSE 21,A01,084009,Staff,0,32,50,50
1650106999934,CSE 30,A01,083370,Cao; Yingjun,0,64,40,40
1650107005962,CSE 100,A01,083372,Cao; Yingjun,0,48,40,40
1650107011995,CSE 101,A01,084011,Staff,0,56,40,40
1650107018022,CSE 141,A01,083374,Eldon; John,0,70,75,75
1650107024047,CSE 141L,A01,083376,Eldon; John,0,76,75,75
1650107030071,CSE 175,A01,084013,Kumar; Rakesh,22,0,25,3
