time,subj_course_id,sec_code,sec_id,prof,available,waitlist,total,enrolled_ct
1649935490665,COGS 2,A01,083966,Boyle; Mary E. T.,18,0,30,12
1649935496706,COGS 9,A01,083968,Staff,41,0,60,19
1649935508820,COGS 14B,A01,083970,Staff,28,0,50,22
1649935514862,COGS 17,A01,092679,Staff,67,0,75,8
1649935529035,COGS 100,A01,083972,Staff,9,0,60,51
1649935541121,COGS 101C,A01,083976,Staff,19,0,30,11
1649935547156,COGS 102A,A01,083978,Johnson; Christine M.,17,0,30,13
1649935553188,COGS 107B,A01,083980,Staff,3,0,50,47
1649935559220,COGS 115,A01,083982,Staff,14,0,30,16
1649935565249,COGS 118B,A01,083367,Staff,0,11,40,40
1649935571282,COGS 172,A01,083984,Provenzano; Emily Kara,16,0,30,14
1649935577317,COGS 177,A00,083368,Staff,0,17,30,30
1649935583348,COGS 186,A01,083986,Staff,21,0,40,19
1649935589380,COGS 187A,A01,083988,Boyle; Mary E. T.,24,0,60,36
1649935595417,CSE 8A,A50,084003,Miranda; Gregory Joseph,0,0,15,15
1649935601451,CSE 11,A01,084005,Miranda; Gregory Joseph,22,0,55,33
1649935607488,CSE 20,A01,084007,Staff,9,0,20,11
1649935613521,CSE 21,A01,084009,Staff,10,0,50,40
1649935619555,CSE 30,A01,083370,Cao; Yingjun,0,20,40,40
1649935625590,CSE 100,A01,083372,Cao; Yingjun,0,23,40,40
1649935631622,CSE 101,A01,084011,Staff,0,49,40,40
1649935637652,CSE 141,A01,083374,Eldon; John,0,51,75,75
1649935643689,CSE 141L,A01,083376,Eldon; John,0,56,75,75
1649935649726,CSE 175,A01,084013,Kumar; Rakesh,22,0,25,3
1649935655765,CSE 190,A00,092508,Dubnov; Shlomo,15,0,15,0
1649935661811,ECE 5,A01,084049,Morris; Karcher William,15,0,20,5
1649935667851,ECE 100,A01,084051,Baghdadchi; Saharnaz,1,0,20,19
1649935667851,ECE 100,A02,091916,Baghdadchi; Saharnaz,16,0,20,4
1649935673889,ECE 101,A01,084053,Baghdadchi; Saharnaz,5,0,37,32
1649935673889,ECE 101,A02,084054,Baghdadchi; Saharnaz,33,0,37,4
1649935679937,ECE 107,A01,083390,Staff,28,0,40,12
1649935685980,ECE 148,A01,084056,Silberman; Jack,7,0,12,5
1649935692012,ECE 180,A00,083391,Abi Samra; Nicholas Camill,25,0,30,5
1649935692012,ECE 180,B00,083392,Abi Samra; Nicholas Camill,22,0,30,8
1649935698052,MATH 10B,A01,084110,Staff,8,0,30,22
1649935698052,MATH 10B,A02,084111,Staff,29,0,30,1
1649935698052,MATH 10B,A03,084112,Staff,28,0,30,2
1649935704089,MATH 10C,A01,083443,Staff,9,0,30,21
1649935704089,MATH 10C,A02,083444,Staff,16,0,30,14
1649935704089,MATH 10C,B01,084114,Staff,25,0,30,5
1649935704089,MATH 10C,B02,084115,Staff,29,0,30,1
1649935710131,MATH 18,A01,084117,Harel; Guershon,27,0,30,3
1649935710131,MATH 18,A02,084119,Harel; Guershon,29,0,30,1
1649935710131,MATH 18,A03,084120,Harel; Guershon,30,0,30,0
1649935710131,MATH 18,A04,084121,Harel; Guershon,29,0,30,1
1649935716159,MATH 20B,A01,084124,Um; Ko Woon,31,0,35,4
1649935716159,MATH 20B,B01,084126,Um; Ko Woon,32,0,35,3
1649935722193,MATH 20C,A01,083446,Hammock; Frances H,17,0,30,13
1649935722193,MATH 20C,A02,083447,Hammock; Frances H,28,0,30,2
1649935722193,MATH 20C,A03,083448,Hammock; Frances H,30,0,30,0
1649935722193,MATH 20C,A04,083449,Hammock; Frances H,30,0,30,0
1649935722193,MATH 20C,B01,083451,Hammock; Frances H,25,0,30,5
1649935722193,MATH 20C,B02,083452,Hammock; Frances H,27,0,30,3
1649935722193,MATH 20C,B03,083453,Hammock; Frances H,26,0,30,4
1649935722193,MATH 20C,B04,083454,Hammock; Frances H,30,0,30,0
1649935728228,MATH 20D,A01,084128,Staff,26,0,30,4
1649935728228,MATH 20D,A02,084129,Staff,30,0,30,0
1649935728228,MATH 20D,A03,084130,Staff,29,0,30,1
1649935728228,MATH 20D,B01,084133,Staff,21,0,30,9
1649935728228,MATH 20D,B02,084134,Staff,27,0,30,3
1649935728228,MATH 20D,B03,084135,Staff,30,0,30,0
1649935734263,MATH 20E,A01,084138,Staff,22,0,30,8
1649935734263,MATH 20E,A02,084139,Staff,22,0,30,8
1649935734263,MATH 20E,A03,084140,Staff,23,0,30,7
1649935734263,MATH 20E,A04,084141,Staff,25,0,30,5
1649935740305,MATH 102,A01,084143,Harel; Guershon,16,0,30,14
1649935740305,MATH 102,A02,084144,Harel; Guershon,22,0,30,8
1649935746351,MATH 103B,A01,083456,Staff,0,8,30,30
1649935746351,MATH 103B,A02,083457,Staff,0,9,30,30
1649935752382,MATH 109,A01,084146,Salehi Golsefidy; Alireza,28,0,30,2
1649935752382,MATH 109,A02,084147,Salehi Golsefidy; Alireza,22,0,30,8
1649935758414,MATH 120A,A01,085445,Eggers; John Dietrich,20,0,35,15
1649935758414,MATH 120A,A02,085446,Eggers; John Dietrich,28,0,35,7
1649935764446,MATH 142B,A01,084149,Verstraete; Jacques Allan,0,10,30,30
1649935764446,MATH 142B,A02,084150,Verstraete; Jacques Allan,0,9,30,30
1649935770482,MATH 170A,A01,083459,Nie; Jiawang,0,2,30,30
1649935770482,MATH 170A,A02,083460,Nie; Jiawang,0,0,30,30
1649935770482,MATH 170A,A03,083461,Nie; Jiawang,7,0,30,23
1649935776521,MATH 193B,A01,083463,Staff,3,0,30,27
1649935776521,MATH 193B,A02,083464,Staff,10,0,30,20
1649935776521,MATH 193B,A03,083465,Staff,19,0,30,11
1649935787285,COGS 2,A01,083966,Boyle; Mary E. T.,18,0,30,12
1649935793315,COGS 9,A01,083968,Staff,41,0,60,19
1649935802295,COGS 14B,A01,083970,Staff,28,0,50,22
1649935808348,COGS 17,A01,092679,Staff,67,0,75,8
1649935814378,COGS 100,A01,083972,Staff,9,0,60,51
1649935826441,COGS 101C,A01,083976,Staff,19,0,30,11
1649935832473,COGS 102A,A01,083978,Johnson; Christine M.,17,0,30,13
1649935838503,COGS 107B,A01,083980,Staff,3,0,50,47
1649935844532,COGS 115,A01,083982,Staff,14,0,30,16
1649935850562,COGS 118B,A01,083367,Staff,0,11,40,40
1649935856600,COGS 172,A01,083984,Provenzano; Emily Kara,16,0,30,14
1649935862630,COGS 177,A00,083368,Staff,0,17,30,30
1649935868660,COGS 186,A01,083986,Staff,21,0,40,19
1649935874696,COGS 187A,A01,083988,Boyle; Mary E. T.,24,0,60,36
1649935880727,CSE 8A,A50,084003,Miranda; Gregory Joseph,0,0,15,15
1649935886756,CSE 11,A01,084005,Miranda; Gregory Joseph,22,0,55,33
1649935892795,CSE 20,A01,084007,Staff,9,0,20,11
1649935898826,CSE 21,A01,084009,Staff,10,0,50,40
1649935904855,CSE 30,A01,083370,Cao; Yingjun,0,20,40,40
1649935910890,CSE 100,A01,083372,Cao; Yingjun,0,23,40,40
1649935916920,CSE 101,A01,084011,Staff,0,49,40,40
1649935922950,CSE 141,A01,083374,Eldon; John,0,51,75,75
1649935928984,CSE 141L,A01,083376,Eldon; John,0,56,75,75
1649935935017,CSE 175,A01,084013,Kumar; Rakesh,22,0,25,3
1649935941047,CSE 190,A00,092508,Dubnov; Shlomo,15,0,15,0
1649935947080,ECE 5,A01,084049,Morris; Karcher William,15,0,20,5
1649935953115,ECE 100,A01,084051,Baghdadchi; Saharnaz,1,0,20,19
1649935953115,ECE 100,A02,091916,Baghdadchi; Saharnaz,16,0,20,4
1649935959146,ECE 101,A01,084053,Baghdadchi; Saharnaz,5,0,37,32
1649935959146,ECE 101,A02,084054,Baghdadchi; Saharnaz,33,0,37,4
1649935965180,ECE 107,A01,083390,Staff,28,0,40,12
1649935971215,ECE 148,A01,084056,Silberman; Jack,7,0,12,5
1649935977243,ECE 180,A00,083391,Abi Samra; Nicholas Camill,25,0,30,5
1649935977243,ECE 180,B00,083392,Abi Samra; Nicholas Camill,22,0,30,8
1649935983293,MATH 10B,A01,084110,Staff,8,0,30,22
1649935983293,MATH 10B,A02,084111,Staff,29,0,30,1
1649935983293,MATH 10B,A03,084112,Staff,28,0,30,2
1649935989322,MATH 10C,A01,083443,Staff,9,0,30,21
1649935989322,MATH 10C,A02,083444,Staff,16,0,30,14
1649935989322,MATH 10C,B01,084114,Staff,25,0,30,5
1649935989322,MATH 10C,B02,084115,Staff,29,0,30,1
1649935995352,MATH 18,A01,084117,Harel; Guershon,27,0,30,3
1649935995352,MATH 18,A02,084119,Harel; Guershon,29,0,30,1
1649935995352,MATH 18,A03,084120,Harel; Guershon,30,0,30,0
1649935995352,MATH 18,A04,084121,Harel; Guershon,29,0,30,1
1649936001390,MATH 20B,A01,084124,Um; Ko Woon,31,0,35,4
1649936001390,MATH 20B,B01,084126,Um; Ko Woon,32,0,35,3
1649936007430,MATH 20C,A01,083446,Hammock; Frances H,17,0,30,13
1649936007430,MATH 20C,A02,083447,Hammock; Frances H,28,0,30,2
1649936007430,MATH 20C,A03,083448,Hammock; Frances H,30,0,30,0
1649936007430,MATH 20C,A04,083449,Hammock; Frances H,30,0,30,0
1649936007430,MATH 20C,B01,083451,Hammock; Frances H,25,0,30,5
1649936007430,MATH 20C,B02,083452,Hammock; Frances H,27,0,30,3
1649936007430,MATH 20C,B03,083453,Hammock; Frances H,26,0,30,4
1649936007430,MATH 20C,B04,083454,Hammock; Frances H,30,0,30,0
1649936013461,MATH 20D,A01,084128,Staff,26,0,30,4
1649936013461,MATH 20D,A02,084129,Staff,30,0,30,0
1649936013461,MATH 20D,A03,084130,Staff,29,0,30,1
1649936013461,MATH 20D,B01,084133,Staff,21,0,30,9
1649936013461,MATH 20D,B02,084134,Staff,27,0,30,3
1649936013461,MATH 20D,B03,084135,Staff,30,0,30,0
1649936019494,MATH 20E,A01,084138,Staff,22,0,30,8
1649936019494,MATH 20E,A02,084139,Staff,22,0,30,8
1649936019494,MATH 20E,A03,084140,Staff,23,0,30,7
1649936019494,MATH 20E,A04,084141,Staff,25,0,30,5
1649936025525,MATH 102,A01,084143,Harel; Guershon,16,0,30,14
1649936025525,MATH 102,A02,084144,Harel; Guershon,22,0,30,8
1649936031559,MATH 103B,A01,083456,Staff,0,8,30,30
1649936031559,MATH 103B,A02,083457,Staff,0,9,30,30
1649936037594,MATH 109,A01,084146,Salehi Golsefidy; Alireza,28,0,30,2
1649936037594,MATH 109,A02,084147,Salehi Golsefidy; Alireza,22,0,30,8
1649936043631,MATH 120A,A01,085445,Eggers; John Dietrich,20,0,35,15
1649936043631,MATH 120A,A02,085446,Eggers; John Dietrich,28,0,35,7
1649936049661,MATH 142B,A01,084149,Verstraete; Jacques Allan,0,10,30,30
1649936049661,MATH 142B,A02,084150,Verstraete; Jacques Allan,0,9,30,30
1649936055691,MATH 170A,A01,083459,Nie; Jiawang,0,2,30,30
1649936055691,MATH 170A,A02,083460,Nie; Jiawang,0,0,30,30
1649936055691,MATH 170A,A03,083461,Nie; Jiawang,7,0,30,23
1649936061728,MATH 193B,A01,083463,Staff,3,0,30,27
1649936061728,MATH 193B,A02,083464,Staff,10,0,30,20
1649936061728,MATH 193B,A03,083465,Staff,19,0,30,11
1649936067814,COGS 2,A01,083966,Boyle; Mary E. T.,18,0,30,12
1649936073845,COGS 9,A01,083968,Staff,41,0,60,19
1649936079883,COGS 14B,A01,083970,Staff,28,0,50,22
1649936086000,COGS 17,A01,092679,Staff,67,0,75,8
1649936092030,COGS 100,A01,083972,Staff,9,0,60,51
1649936104089,COGS 101C,A01,083976,Staff,19,0,30,11
1649936110119,COGS 102A,A01,083978,Johnson; Christine M.,17,0,30,13
1649936116148,COGS 107B,A01,083980,Staff,3,0,50,47
1649936122181,COGS 115,A01,083982,Staff,14,0,30,16
1649936128213,COGS 118B,A01,083367,Staff,0,11,40,40
1649936134245,COGS 172,A01,083984,Provenzano; Emily Kara,16,0,30,14
1649936140277,COGS 177,A00,083368,Staff,0,17,30,30
1649936146308,COGS 186,A01,083986,Staff,21,0,40,19
1649936152337,COGS 187A,A01,083988,Boyle; Mary E. T.,24,0,60,36
1649936158369,CSE 8A,A50,084003,Miranda; Gregory Joseph,0,0,15,15
1649936164399,CSE 11,A01,084005,Miranda; Gregory Joseph,22,0,55,33
1649936170430,CSE 20,A01,084007,Staff,9,0,20,11
1649936176467,CSE 21,A01,084009,Staff,10,0,50,40
1649936182500,CSE 30,A01,083370,Cao; Yingjun,0,20,40,40
1649936188529,CSE 100,A01,083372,Cao; Yingjun,0,23,40,40
1649936194564,CSE 101,A01,084011,Staff,0,49,40,40
1649936200595,CSE 141,A01,083374,Eldon; John,0,51,75,75
1649936206628,CSE 141L,A01,083376,Eldon; John,0,56,75,75
1649936212662,CSE 175,A01,084013,Kumar; Rakesh,22,0,25,3
1649936218691,CSE 190,A00,092508,Dubnov; Shlomo,15,0,15,0
1649936224729,ECE 5,A01,084049,Morris; Karcher William,15,0,20,5
1649936230760,ECE 100,A01,084051,Baghdadchi; Saharnaz,1,0,20,19
1649936230760,ECE 100,A02,091916,Baghdadchi; Saharnaz,16,0,20,4
1649936236790,ECE 101,A01,084053,Baghdadchi; Saharnaz,5,0,37,32
1649936236790,ECE 101,A02,084054,Baghdadchi; Saharnaz,33,0,37,4
1649936242824,ECE 107,A01,083390,Staff,28,0,40,12
1649936248860,ECE 148,A01,084056,Silberman; Jack,7,0,12,5
1649936254898,ECE 180,A00,083391,Abi Samra; Nicholas Camill,25,0,30,5
1649936254898,ECE 180,B00,083392,Abi Samra; Nicholas Camill,22,0,30,8
1649936260929,MATH 10B,A01,084110,Staff,8,0,30,22
1649936260929,MATH 10B,A02,084111,Staff,29,0,30,1
1649936260929,MATH 10B,A03,084112,Staff,28,0,30,2
1649936266964,MATH 10C,A01,083443,Staff,9,0,30,21
1649936266964,MATH 10C,A02,083444,Staff,16,0,30,14
1649936266964,MATH 10C,B01,084114,Staff,25,0,30,5
1649936266964,MATH 10C,B02,084115,Staff,29,0,30,1
1649936273000,MATH 18,A01,084117,Harel; Guershon,27,0,30,3
1649936273000,MATH 18,A02,084119,Harel; Guershon,29,0,30,1
1649936273000,MATH 18,A03,084120,Harel; Guershon,30,0,30,0
1649936273000,MATH 18,A04,084121,Harel; Guershon,29,0,30,1
1649936279032,MATH 20B,A01,084124,Um; Ko Woon,31,0,35,4
1649936279032,MATH 20B,B01,084126,Um; Ko Woon,32,0,35,3
1649936285064,MATH 20C,A01,083446,Hammock; Frances H,17,0,30,13
1649936285064,MATH 20C,A02,083447,Hammock; Frances H,28,0,30,2
1649936285064,MATH 20C,A03,083448,Hammock; Frances H,30,0,30,0
1649936285064,MATH 20C,A04,083449,Hammock; Frances H,30,0,30,0
1649936285064,MATH 20C,B01,083451,Hammock; Frances H,25,0,30,5
1649936285064,MATH 20C,B02,083452,Hammock; Frances H,27,0,30,3
1649936285064,MATH 20C,B03,083453,Hammock; Frances H,26,0,30,4
1649936285064,MATH 20C,B04,083454,Hammock; Frances H,30,0,30,0
1649936291103,MATH 20D,A01,084128,Staff,26,0,30,4
1649936291103,MATH 20D,A02,084129,Staff,30,0,30,0
1649936291103,MATH 20D,A03,084130,Staff,29,0,30,1
1649936291103,MATH 20D,B01,084133,Staff,21,0,30,9
1649936291103,MATH 20D,B02,084134,Staff,27,0,30,3
1649936291103,MATH 20D,B03,084135,Staff,30,0,30,0
1649936297137,MATH 20E,A01,084138,Staff,22,0,30,8
1649936297137,MATH 20E,A02,084139,Staff,22,0,30,8
1649936297137,MATH 20E,A03,084140,Staff,23,0,30,7
1649936297137,MATH 20E,A04,084141,Staff,25,0,30,5
1649936303167,MATH 102,A01,084143,Harel; Guershon,16,0,30,14
1649936303167,MATH 102,A02,084144,Harel; Guershon,22,0,30,8
1649936309197,MATH 103B,A01,083456,Staff,0,8,30,30
1649936309197,MATH 103B,A02,083457,Staff,0,9,30,30
1649936315226,MATH 109,A01,084146,Salehi Golsefidy; Alireza,28,0,30,2
1649936315226,MATH 109,A02,084147,Salehi Golsefidy; Alireza,22,0,30,8
1649936321257,MATH 120A,A01,085445,Eggers; John Dietrich,20,0,35,15
1649936321257,MATH 120A,A02,085446,Eggers; John Dietrich,28,0,35,7
1649936327289,MATH 142B,A01,084149,Verstraete; Jacques Allan,0,10,30,30
1649936327289,MATH 142B,A02,084150,Verstraete; Jacques Allan,0,9,30,30
1649936333319,MATH 170A,A01,083459,Nie; Jiawang,0,2,30,30
1649936333319,MATH 170A,A02,083460,Nie; Jiawang,0,0,30,30
1649936333319,MATH 170A,A03,083461,Nie; Jiawang,7,0,30,23
1649936339351,MATH 193B,A01,083463,Staff,3,0,30,27
1649936339351,MATH 193B,A02,083464,Staff,10,0,30,20
1649936339351,MATH 193B,A03,083465,Staff,19,0,30,11
1649936345425,COGS 2,A01,083966,Boyle; Mary E. T.,18,0,30,12
1649936351454,COGS 9,A01,083968,Staff,41,0,60,19
1649936357485,COGS 14B,A01,083970,Staff,28,0,50,22
1649936363515,COGS 17,A01,092679,Staff,67,0,75,8
1649936369547,COGS 100,A01,083972,Staff,9,0,60,51
1649936381604,COGS 101C,A01,083976,Staff,19,0,30,11
1649936387645,COGS 102A,A01,083978,Johnson; Christine M.,17,0,30,13
1649936393670,COGS 107B,A01,083980,Staff,3,0,50,47
1649936399704,COGS 115,A01,083982,Staff,14,0,30,16
1649936405732,COGS 118B,A01,083367,Staff,0,11,40,40
1649936411769,COGS 172,A01,083984,Provenzano; Emily Kara,16,0,30,14
1649936417802,COGS 177,A00,083368,Staff,0,17,30,30
1649936423834,COGS 186,A01,083986,Staff,21,0,40,19
1649936429869,COGS 187A,A01,083988,Boyle; Mary E. T.,24,0,60,36
1649936435901,CSE 8A,A50,084003,Miranda; Gregory Joseph,0,0,15,15
1649936441930,CSE 11,A01,084005,Miranda; Gregory Joseph,22,0,55,33
1649936447973,CSE 20,A01,084007,Staff,9,0,20,11
1649936454008,CSE 21,A01,084009,Staff,10,0,50,40
1649936460039,CSE 30,A01,083370,Cao; Yingjun,0,20,40,40
1649936466072,CSE 100,A01,083372,Cao; Yingjun,0,23,40,40
1649936472108,CSE 101,A01,084011,Staff,0,49,40,40
1649936478138,CSE 141,A01,083374,Eldon; John,0,51,75,75
1649936484172,CSE 141L,A01,083376,Eldon; John,0,56,75,75
1649936490200,CSE 175,A01,084013,Kumar; Rakesh,22,0,25,3
1649936496227,CSE 190,A00,092508,Dubnov; Shlomo,15,0,15,0
1649936502255,ECE 5,A01,084049,Morris; Karcher William,15,0,20,5
1649936508285,ECE 100,A01,084051,Baghdadchi; Saharnaz,1,0,20,19
1649936508285,ECE 100,A02,091916,Baghdadchi; Saharnaz,16,0,20,4
1649936514318,ECE 101,A01,084053,Baghdadchi; Saharnaz,5,0,37,32
1649936514318,ECE 101,A02,084054,Baghdadchi; Saharnaz,33,0,37,4
1649936520353,ECE 107,A01,083390,Staff,28,0,40,12
1649936526386,ECE 148,A01,084056,Silberman; Jack,7,0,12,5
1649936532416,ECE 180,A00,083391,Abi Samra; Nicholas Camill,25,0,30,5
1649936532416,ECE 180,B00,083392,Abi Samra; Nicholas Camill,22,0,30,8
1649936538446,MATH 10B,A01,084110,Staff,8,0,30,22
1649936538446,MATH 10B,A02,084111,Staff,29,0,30,1
1649936538446,MATH 10B,A03,084112,Staff,28,0,30,2
1649936544482,MATH 10C,A01,083443,Staff,9,0,30,21
1649936544482,MATH 10C,A02,083444,Staff,16,0,30,14
1649936544482,MATH 10C,B01,084114,Staff,25,0,30,5
1649936544482,MATH 10C,B02,084115,Staff,29,0,30,1
1649936550510,MATH 18,A01,084117,Harel; Guershon,27,0,30,3
1649936550510,MATH 18,A02,084119,Harel; Guershon,29,0,30,1
1649936550510,MATH 18,A03,084120,Harel; Guershon,30,0,30,0
1649936550510,MATH 18,A04,084121,Harel; Guershon,29,0,30,1
1649936556546,MATH 20B,A01,084124,Um; Ko Woon,31,0,35,4
1649936556546,MATH 20B,B01,084126,Um; Ko Woon,32,0,35,3
1649936562585,MATH 20C,A01,083446,Hammock; Frances H,17,0,30,13
1649936562585,MATH 20C,A02,083447,Hammock; Frances H,28,0,30,2
1649936562585,MATH 20C,A03,083448,Hammock; Frances H,30,0,30,0
1649936562585,MATH 20C,A04,083449,Hammock; Frances H,30,0,30,0
1649936562585,MATH 20C,B01,083451,Hammock; Frances H,25,0,30,5
1649936562585,MATH 20C,B02,083452,Hammock; Frances H,27,0,30,3
1649936562585,MATH 20C,B03,083453,Hammock; Frances H,26,0,30,4
1649936562585,MATH 20C,B04,083454,Hammock; Frances H,30,0,30,0
1649936568618,MATH 20D,A01,084128,Staff,26,0,30,4
1649936568618,MATH 20D,A02,084129,Staff,30,0,30,0
1649936568618,MATH 20D,A03,084130,Staff,29,0,30,1
1649936568618,MATH 20D,B01,084133,Staff,21,0,30,9
1649936568618,MATH 20D,B02,084134,Staff,27,0,30,3
1649936568618,MATH 20D,B03,084135,Staff,30,0,30,0
1649936574647,MATH 20E,A01,084138,Staff,22,0,30,8
1649936574647,MATH 20E,A02,084139,Staff,22,0,30,8
1649936574647,MATH 20E,A03,084140,Staff,23,0,30,7
1649936574647,MATH 20E,A04,084141,Staff,25,0,30,5
1649936580677,MATH 102,A01,084143,Harel; Guershon,16,0,30,14
1649936580677,MATH 102,A02,084144,Harel; Guershon,22,0,30,8
1649936586705,MATH 103B,A01,083456,Staff,0,8,30,30
1649936586705,MATH 103B,A02,083457,Staff,0,9,30,30
1649936592749,MATH 109,A01,084146,Salehi Golsefidy; Alireza,28,0,30,2
1649936592749,MATH 109,A02,084147,Salehi Golsefidy; Alireza,22,0,30,8
1649936598789,MATH 120A,A01,085445,Eggers; John Dietrich,20,0,35,15
1649936598789,MATH 120A,A02,085446,Eggers; John Dietrich,28,0,35,7
1649936604820,MATH 142B,A01,084149,Verstraete; Jacques Allan,0,10,30,30
1649936604820,MATH 142B,A02,084150,Verstraete; Jacques Allan,0,9,30,30
1649936610848,MATH 170A,A01,083459,Nie; Jiawang,0,2,30,30
1649936610848,MATH 170A,A02,083460,Nie; Jiawang,0,0,30,30
1649936610848,MATH 170A,A03,083461,Nie; Jiawang,7,0,30,23
1649936616878,MATH 193B,A01,083463,Staff,3,0,30,27
1649936616878,MATH 193B,A02,083464,Staff,10,0,30,20
1649936616878,MATH 193B,A03,083465,Staff,19,0,30,11
1649936622968,COGS 2,A01,083966,Boyle; Mary E. T.,18,0,30,12
1649936629010,COGS 9,A01,083968,Staff,41,0,60,19
1649936635042,COGS 14B,A01,083970,Staff,28,0,50,22
1649936641072,COGS 17,A01,092679,Staff,67,0,75,8
1649936647104,COGS 100,A01,083972,Staff,9,0,60,51
1649936659166,COGS 101C,A01,083976,Staff,19,0,30,11
1649936665196,COGS 102A,A01,083978,Johnson; Christine M.,17,0,30,13
1649936671229,COGS 107B,A01,083980,Staff,3,0,50,47
1649936677259,COGS 115,A01,083982,Staff,14,0,30,16
1649936683389,COGS 118B,A01,083367,Staff,0,11,40,40
1649936689424,COGS 172,A01,083984,Provenzano; Emily Kara,16,0,30,14
1649936695452,COGS 177,A00,083368,Staff,0,17,30,30
1649936701484,COGS 186,A01,083986,Staff,21,0,40,19
1649936707544,COGS 187A,A01,083988,Boyle; Mary E. T.,24,0,60,36
1649936713580,CSE 8A,A50,084003,Miranda; Gregory Joseph,0,0,15,15
1649936719609,CSE 11,A01,084005,Miranda; Gregory Joseph,22,0,55,33
1649936725641,CSE 20,A01,084007,Staff,9,0,20,11
1649936731681,CSE 21,A01,084009,Staff,10,0,50,40
1649936737718,CSE 30,A01,083370,Cao; Yingjun,0,20,40,40
1649936743747,CSE 100,A01,083372,Cao; Yingjun,0,23,40,40
1649936749779,CSE 101,A01,084011,Staff,0,49,40,40
1649936755809,CSE 141,A01,083374,Eldon; John,0,51,75,75
1649936761836,CSE 141L,A01,083376,Eldon; John,0,56,75,75
1649936767870,CSE 175,A01,084013,Kumar; Rakesh,22,0,25,3
1649936773898,CSE 190,A00,092508,Dubnov; Shlomo,15,0,15,0
1649936779928,ECE 5,A01,084049,Morris; Karcher William,15,0,20,5
1649936785958,ECE 100,A01,084051,Baghdadchi; Saharnaz,1,0,20,19
1649936785958,ECE 100,A02,091916,Baghdadchi; Saharnaz,16,0,20,4
1649936791989,ECE 101,A01,084053,Baghdadchi; Saharnaz,5,0,37,32
1649936791989,ECE 101,A02,084054,Baghdadchi; Saharnaz,33,0,37,4
1649936798019,ECE 107,A01,083390,Staff,28,0,40,12
1649936804055,ECE 148,A01,084056,Silberman; Jack,7,0,12,5
1649936810085,ECE 180,A00,083391,Abi Samra; Nicholas Camill,25,0,30,5
1649936810085,ECE 180,B00,083392,Abi Samra; Nicholas Camill,22,0,30,8
1649936816121,MATH 10B,A01,084110,Staff,8,0,30,22
1649936816121,MATH 10B,A02,084111,Staff,29,0,30,1
1649936816121,MATH 10B,A03,084112,Staff,28,0,30,2
1649936822152,MATH 10C,A01,083443,Staff,9,0,30,21
1649936822152,MATH 10C,A02,083444,Staff,16,0,30,14
1649936822152,MATH 10C,B01,084114,Staff,25,0,30,5
1649936822152,MATH 10C,B02,084115,Staff,29,0,30,1
1649936828182,MATH 18,A01,084117,Harel; Guershon,27,0,30,3
1649936828182,MATH 18,A02,084119,Harel; Guershon,29,0,30,1
1649936828182,MATH 18,A03,084120,Harel; Guershon,30,0,30,0
1649936828182,MATH 18,A04,084121,Harel; Guershon,29,0,30,1
1649936834211,MATH 20B,A01,084124,Um; Ko Woon,31,0,35,4
1649936834211,MATH 20B,B01,084126,Um; Ko Woon,32,0,35,3
1649936840246,MATH 20C,A01,083446,Hammock; Frances H,17,0,30,13
1649936840246,MATH 20C,A02,083447,Hammock; Frances H,28,0,30,2
1649936840246,MATH 20C,A03,083448,Hammock; Frances H,30,0,30,0
1649936840246,MATH 20C,A04,083449,Hammock; Frances H,30,0,30,0
1649936840246,MATH 20C,B01,083451,Hammock; Frances H,25,0,30,5
1649936840246,MATH 20C,B02,083452,Hammock; Frances H,27,0,30,3
1649936840246,MATH 20C,B03,083453,Hammock; Frances H,26,0,30,4
1649936840246,MATH 20C,B04,083454,Hammock; Frances H,30,0,30,0
1649936846276,MATH 20D,A01,084128,Staff,26,0,30,4
1649936846276,MATH 20D,A02,084129,Staff,30,0,30,0
1649936846276,MATH 20D,A03,084130,Staff,29,0,30,1
1649936846276,MATH 20D,B01,084133,Staff,21,0,30,9
1649936846276,MATH 20D,B02,084134,Staff,27,0,30,3
1649936846276,MATH 20D,B03,084135,Staff,30,0,30,0
1649936852306,MATH 20E,A01,084138,Staff,22,0,30,8
1649936852306,MATH 20E,A02,084139,Staff,22,0,30,8
1649936852306,MATH 20E,A03,084140,Staff,23,0,30,7
1649936852306,MATH 20E,A04,084141,Staff,25,0,30,5
1649936858334,MATH 102,A01,084143,Harel; Guershon,16,0,30,14
1649936858334,MATH 102,A02,084144,Harel; Guershon,22,0,30,8
1649936864373,MATH 103B,A01,083456,Staff,0,8,30,30
1649936864373,MATH 103B,A02,083457,Staff,0,9,30,30
1649936870406,MATH 109,A01,084146,Salehi Golsefidy; Alireza,28,0,30,2
1649936870406,MATH 109,A02,084147,Salehi Golsefidy; Alireza,22,0,30,8
1649936876438,MATH 120A,A01,085445,Eggers; John Dietrich,20,0,35,15
1649936876438,MATH 120A,A02,085446,Eggers; John Dietrich,28,0,35,7
1649936882466,MATH 142B,A01,084149,Verstraete; Jacques Allan,0,10,30,30
1649936882466,MATH 142B,A02,084150,Verstraete; Jacques Allan,0,9,30,30
1649936888499,MATH 170A,A01,083459,Nie; Jiawang,0,2,30,30
1649936888499,MATH 170A,A02,083460,Nie; Jiawang,0,0,30,30
1649936888499,MATH 170A,A03,083461,Nie; Jiawang,7,0,30,23
1649936894542,MATH 193B,A01,083463,Staff,3,0,30,27
1649936894542,MATH 193B,A02,083464,Staff,10,0,30,20
1649936894542,MATH 193B,A03,083465,Staff,19,0,30,11
1649936900634,COGS 2,A01,083966,Boyle; Mary E. T.,18,0,30,12
1649936906662,COGS 9,A01,083968,Staff,41,0,60,19
1649936912696,COGS 14B,A01,083970,Staff,28,0,50,22
1649936918727,COGS 17,A01,092679,Staff,67,0,75,8
1649936924758,COGS 100,A01,083972,Staff,9,0,60,51
1649936936819,COGS 101C,A01,083976,Staff,19,0,30,11
1649936942848,COGS 102A,A01,083978,Johnson; Christine M.,17,0,30,13
1649936948881,COGS 107B,A01,083980,Staff,3,0,50,47
1649936954909,COGS 115,A01,083982,Staff,14,0,30,16
1649936960939,COGS 118B,A01,083367,Staff,0,11,40,40
1649936966968,COGS 172,A01,083984,Provenzano; Emily Kara,16,0,30,14
1649936972999,COGS 177,A00,083368,Staff,0,17,30,30
1649936979027,COGS 186,A01,083986,Staff,21,0,40,19
1649936985058,COGS 187A,A01,083988,Boyle; Mary E. T.,24,0,60,36
1649936991094,CSE 8A,A50,084003,Miranda; Gregory Joseph,0,0,15,15
1649936997122,CSE 11,A01,084005,Miranda; Gregory Joseph,22,0,55,33
1649937003152,CSE 20,A01,084007,Staff,9,0,20,11
1649937009177,CSE 21,A01,084009,Staff,10,0,50,40
1649937015206,CSE 30,A01,083370,Cao; Yingjun,0,20,40,40
1649937021234,CSE 100,A01,083372,Cao; Yingjun,0,23,40,40
1649937027261,CSE 101,A01,084011,Staff,0,49,40,40
1649937033288,CSE 141,A01,083374,Eldon; John,0,51,75,75
1649937039313,CSE 141L,A01,083376,Eldon; John,0,56,75,75
1649937045344,CSE 175,A01,084013,Kumar; Rakesh,22,0,25,3
1649937051377,CSE 190,A00,092508,Dubnov; Shlomo,15,0,15,0
1649937057406,ECE 5,A01,084049,Morris; Karcher William,15,0,20,5
1649937063438,ECE 100,A01,084051,Baghdadchi; Saharnaz,1,0,20,19
1649937063438,ECE 100,A02,091916,Baghdadchi; Saharnaz,16,0,20,4
1649937069468,ECE 101,A01,084053,Baghdadchi; Saharnaz,5,0,37,32
1649937069468,ECE 101,A02,084054,Baghdadchi; Saharnaz,33,0,37,4
1649937075502,ECE 107,A01,083390,Staff,28,0,40,12
1649937081534,ECE 148,A01,084056,Silberman; Jack,7,0,12,5
1649937087562,ECE 180,A00,083391,Abi Samra; Nicholas Camill,25,0,30,5
1649937087562,ECE 180,B00,083392,Abi Samra; Nicholas Camill,22,0,30,8
1649937093596,MATH 10B,A01,084110,Staff,8,0,30,22
1649937093596,MATH 10B,A02,084111,Staff,29,0,30,1
1649937093596,MATH 10B,A03,084112,Staff,28,0,30,2
1649937099625,MATH 10C,A01,083443,Staff,9,0,30,21
1649937099625,MATH 10C,A02,083444,Staff,16,0,30,14
1649937099625,MATH 10C,B01,084114,Staff,25,0,30,5
1649937099625,MATH 10C,B02,084115,Staff,29,0,30,1
1649937105661,MATH 18,A01,084117,Harel; Guershon,27,0,30,3
1649937105661,MATH 18,A02,084119,Harel; Guershon,29,0,30,1
1649937105661,MATH 18,A03,084120,Harel; Guershon,30,0,30,0
1649937105661,MATH 18,A04,084121,Harel; Guershon,29,0,30,1
1649937111693,MATH 20B,A01,084124,Um; Ko Woon,31,0,35,4
1649937111693,MATH 20B,B01,084126,Um; Ko Woon,32,0,35,3
1649937117729,MATH 20C,A01,083446,Hammock; Frances H,17,0,30,13
1649937117729,MATH 20C,A02,083447,Hammock; Frances H,28,0,30,2
1649937117729,MATH 20C,A03,083448,Hammock; Frances H,30,0,30,0
1649937117729,MATH 20C,A04,083449,Hammock; Frances H,30,0,30,0
1649937117729,MATH 20C,B01,083451,Hammock; Frances H,25,0,30,5
1649937117729,MATH 20C,B02,083452,Hammock; Frances H,27,0,30,3
1649937117729,MATH 20C,B03,083453,Hammock; Frances H,26,0,30,4
1649937117729,MATH 20C,B04,083454,Hammock; Frances H,30,0,30,0
1649937123768,MATH 20D,A01,084128,Staff,26,0,30,4
1649937123768,MATH 20D,A02,084129,Staff,30,0,30,0
1649937123768,MATH 20D,A03,084130,Staff,29,0,30,1
1649937123768,MATH 20D,B01,084133,Staff,21,0,30,9
1649937123768,MATH 20D,B02,084134,Staff,27,0,30,3
1649937123768,MATH 20D,B03,084135,Staff,30,0,30,0
1649937129795,MATH 20E,A01,084138,Staff,22,0,30,8
1649937129795,MATH 20E,A02,084139,Staff,22,0,30,8
1649937129795,MATH 20E,A03,084140,Staff,23,0,30,7
1649937129795,MATH 20E,A04,084141,Staff,25,0,30,5
1649937135823,MATH 102,A01,084143,Harel; Guershon,16,0,30,14
1649937135823,MATH 102,A02,084144,Harel; Guershon,22,0,30,8
1649937141856,MATH 103B,A01,083456,Staff,0,8,30,30
1649937141856,MATH 103B,A02,083457,Staff,0,9,30,30
1649937147888,MATH 109,A01,084146,Salehi Golsefidy; Alireza,28,0,30,2
1649937147888,MATH 109,A02,084147,Salehi Golsefidy; Alireza,22,0,30,8
1649937153917,MATH 120A,A01,085445,Eggers; John Dietrich,20,0,35,15
1649937153917,MATH 120A,A02,085446,Eggers; John Dietrich,28,0,35,7
1649937159946,MATH 142B,A01,084149,Verstraete; Jacques Allan,0,10,30,30
1649937159946,MATH 142B,A02,084150,Verstraete; Jacques Allan,0,9,30,30
1649937165975,MATH 170A,A01,083459,Nie; Jiawang,0,2,30,30
1649937165975,MATH 170A,A02,083460,Nie; Jiawang,0,0,30,30
1649937165975,MATH 170A,A03,083461,Nie; Jiawang,7,0,30,23
1649937172001,MATH 193B,A01,083463,Staff,3,0,30,27
1649937172001,MATH 193B,A02,083464,Staff,10,0,30,20
1649937172001,MATH 193B,A03,083465,Staff,19,0,30,11
1649937178074,COGS 2,A01,083966,Boyle; Mary E. T.,18,0,30,12
1649937184106,COGS 9,A01,083968,Staff,41,0,60,19
1649937190135,COGS 14B,A01,083970,Staff,28,0,50,22
1649937196167,COGS 17,A01,092679,Staff,67,0,75,8
1649937202194,COGS 100,A01,083972,Staff,9,0,60,51
1649937214254,COGS 101C,A01,083976,Staff,19,0,30,11
1649937220284,COGS 102A,A01,083978,Johnson; Christine M.,17,0,30,13
1649937226316,COGS 107B,A01,083980,Staff,3,0,50,47
1649937232345,COGS 115,A01,083982,Staff,14,0,30,16
1649937238377,COGS 118B,A01,083367,Staff,0,11,40,40
1649937244411,COGS 172,A01,083984,Provenzano; Emily Kara,16,0,30,14
1649937250442,COGS 177,A00,083368,Staff,0,17,30,30
1649937256469,COGS 186,A01,083986,Staff,21,0,40,19
1649937262501,COGS 187A,A01,083988,Boyle; Mary E. T.,24,0,60,36
1649937268535,CSE 8A,A50,084003,Miranda; Gregory Joseph,0,0,15,15
1649937274566,CSE 11,A01,084005,Miranda; Gregory Joseph,22,0,55,33
1649937280688,CSE 20,A01,084007,Staff,9,0,20,11
1649937286724,CSE 21,A01,084009,Staff,10,0,50,40
1649937292756,CSE 30,A01,083370,Cao; Yingjun,0,20,40,40
1649937298789,CSE 100,A01,083372,Cao; Yingjun,0,23,40,40
1649937304818,CSE 101,A01,084011,Staff,0,49,40,40
1649937310846,CSE 141,A01,083374,Eldon; John,0,51,75,75
1649937316889,CSE 141L,A01,083376,Eldon; John,0,56,75,75
1649937322920,CSE 175,A01,084013,Kumar; Rakesh,22,0,25,3
1649937328955,CSE 190,A00,092508,Dubnov; Shlomo,15,0,15,0
1649937334982,ECE 5,A01,084049,Morris; Karcher William,15,0,20,5
1649937341014,ECE 100,A01,084051,Baghdadchi; Saharnaz,1,0,20,19
1649937341014,ECE 100,A02,091916,Baghdadchi; Saharnaz,16,0,20,4
1649937347048,ECE 101,A01,084053,Baghdadchi; Saharnaz,5,0,37,32
1649937347048,ECE 101,A02,084054,Baghdadchi; Saharnaz,33,0,37,4
1649937353083,ECE 107,A01,083390,Staff,28,0,40,12
1649937359113,ECE 148,A01,084056,Silberman; Jack,7,0,12,5
1649937365140,ECE 180,A00,083391,Abi Samra; Nicholas Camill,25,0,30,5
1649937365140,ECE 180,B00,083392,Abi Samra; Nicholas Camill,22,0,30,8
1649937371177,MATH 10B,A01,084110,Staff,8,0,30,22
1649937371177,MATH 10B,A02,084111,Staff,29,0,30,1
1649937371177,MATH 10B,A03,084112,Staff,28,0,30,2
1649937377205,MATH 10C,A01,083443,Staff,9,0,30,21
1649937377205,MATH 10C,A02,083444,Staff,16,0,30,14
1649937377205,MATH 10C,B01,084114,Staff,25,0,30,5
1649937377205,MATH 10C,B02,084115,Staff,29,0,30,1
1649937383234,MATH 18,A01,084117,Harel; Guershon,27,0,30,3
1649937383234,MATH 18,A02,084119,Harel; Guershon,29,0,30,1
1649937383234,MATH 18,A03,084120,Harel; Guershon,30,0,30,0
1649937383234,MATH 18,A04,084121,Harel; Guershon,29,0,30,1
1649937389269,MATH 20B,A01,084124,Um; Ko Woon,31,0,35,4
1649937389269,MATH 20B,B01,084126,Um; Ko Woon,32,0,35,3
1649937395306,MATH 20C,A01,083446,Hammock; Frances H,17,0,30,13
1649937395306,MATH 20C,A02,083447,Hammock; Frances H,28,0,30,2
1649937395306,MATH 20C,A03,083448,Hammock; Frances H,30,0,30,0
1649937395306,MATH 20C,A04,083449,Hammock; Frances H,30,0,30,0
1649937395306,MATH 20C,B01,083451,Hammock; Frances H,25,0,30,5
1649937395306,MATH 20C,B02,083452,Hammock; Frances H,27,0,30,3
1649937395306,MATH 20C,B03,083453,Hammock; Frances H,26,0,30,4
1649937395306,MATH 20C,B04,083454,Hammock; Frances H,30,0,30,0
1649937401337,MATH 20D,A01,084128,Staff,26,0,30,4
1649937401337,MATH 20D,A02,084129,Staff,30,0,30,0
1649937401337,MATH 20D,A03,084130,Staff,29,0,30,1
1649937401337,MATH 20D,B01,084133,Staff,21,0,30,9
1649937401337,MATH 20D,B02,084134,Staff,27,0,30,3
1649937401337,MATH 20D,B03,084135,Staff,30,0,30,0
1649937407364,MATH 20E,A01,084138,Staff,22,0,30,8
1649937407364,MATH 20E,A02,084139,Staff,22,0,30,8
1649937407364,MATH 20E,A03,084140,Staff,23,0,30,7
1649937407364,MATH 20E,A04,084141,Staff,25,0,30,5
1649937413393,MATH 102,A01,084143,Harel; Guershon,16,0,30,14
1649937413393,MATH 102,A02,084144,Harel; Guershon,22,0,30,8
1649937419421,MATH 103B,A01,083456,Staff,0,8,30,30
1649937419421,MATH 103B,A02,083457,Staff,0,9,30,30
1649937425453,MATH 109,A01,084146,Salehi Golsefidy; Alireza,28,0,30,2
1649937425453,MATH 109,A02,084147,Salehi Golsefidy; Alireza,22,0,30,8
1649937431482,MATH 120A,A01,085445,Eggers; John Dietrich,20,0,35,15
1649937431482,MATH 120A,A02,085446,Eggers; John Dietrich,28,0,35,7
1649937437510,MATH 142B,A01,084149,Verstraete; Jacques Allan,0,10,30,30
1649937437510,MATH 142B,A02,084150,Verstraete; Jacques Allan,0,9,30,30
1649937443540,MATH 170A,A01,083459,Nie; Jiawang,0,2,30,30
1649937443540,MATH 170A,A02,083460,Nie; Jiawang,0,0,30,30
1649937443540,MATH 170A,A03,083461,Nie; Jiawang,7,0,30,23
1649937449572,MATH 193B,A01,083463,Staff,3,0,30,27
1649937449572,MATH 193B,A02,083464,Staff,10,0,30,20
1649937449572,MATH 193B,A03,083465,Staff,19,0,30,11
1649937455668,COGS 2,A01,083966,Boyle; Mary E. T.,18,0,30,12
1649937461697,COGS 9,A01,083968,Staff,41,0,60,19
1649937467728,COGS 14B,A01,083970,Staff,28,0,50,22
1649937473758,COGS 17,A01,092679,Staff,67,0,75,8
1649937479787,COGS 100,A01,083972,Staff,9,0,60,51
1649937491851,COGS 101C,A01,083976,Staff,19,0,30,11
1649937497882,COGS 102A,A01,083978,Johnson; Christine M.,17,0,30,13
1649937503910,COGS 107B,A01,083980,Staff,3,0,50,47
1649937509937,COGS 115,A01,083982,Staff,14,0,30,16
1649937515968,COGS 118B,A01,083367,Staff,0,11,40,40
1649937522002,COGS 172,A01,083984,Provenzano; Emily Kara,16,0,30,14
1649937528032,COGS 177,A00,083368,Staff,0,17,30,30
1649937534061,COGS 186,A01,083986,Staff,21,0,40,19
1649937540090,COGS 187A,A01,083988,Boyle; Mary E. T.,24,0,60,36
1649937546122,CSE 8A,A50,084003,Miranda; Gregory Joseph,0,0,15,15
1649937552149,CSE 11,A01,084005,Miranda; Gregory Joseph,22,0,55,33
1649937558182,CSE 20,A01,084007,Staff,9,0,20,11
1649937564212,CSE 21,A01,084009,Staff,10,0,50,40
1649937570243,CSE 30,A01,083370,Cao; Yingjun,0,20,40,40
1649937576268,CSE 100,A01,083372,Cao; Yingjun,0,23,40,40
1649937582302,CSE 101,A01,084011,Staff,0,49,40,40
1649937588329,CSE 141,A01,083374,Eldon; John,0,51,75,75
1649937594361,CSE 141L,A01,083376,Eldon; John,0,56,75,75
1649937600393,CSE 175,A01,084013,Kumar; Rakesh,22,0,25,3
1649937606430,CSE 190,A00,092508,Dubnov; Shlomo,15,0,15,0
1649937612457,ECE 5,A01,084049,Morris; Karcher William,15,0,20,5
1649937618486,ECE 100,A01,084051,Baghdadchi; Saharnaz,1,0,20,19
1649937618486,ECE 100,A02,091916,Baghdadchi; Saharnaz,16,0,20,4
1649937624515,ECE 101,A01,084053,Baghdadchi; Saharnaz,5,0,37,32
1649937624515,ECE 101,A02,084054,Baghdadchi; Saharnaz,33,0,37,4
1649937630552,ECE 107,A01,083390,Staff,28,0,40,12
1649937636583,ECE 148,A01,084056,Silberman; Jack,7,0,12,5
1649937642610,ECE 180,A00,083391,Abi Samra; Nicholas Camill,25,0,30,5
1649937642610,ECE 180,B00,083392,Abi Samra; Nicholas Camill,22,0,30,8
1649937648640,MATH 10B,A01,084110,Staff,8,0,30,22
1649937648640,MATH 10B,A02,084111,Staff,29,0,30,1
1649937648640,MATH 10B,A03,084112,Staff,28,0,30,2
1649937654668,MATH 10C,A01,083443,Staff,9,0,30,21
1649937654668,MATH 10C,A02,083444,Staff,16,0,30,14
1649937654668,MATH 10C,B01,084114,Staff,25,0,30,5
1649937654668,MATH 10C,B02,084115,Staff,29,0,30,1
1649937660697,MATH 18,A01,084117,Harel; Guershon,27,0,30,3
1649937660697,MATH 18,A02,084119,Harel; Guershon,29,0,30,1
1649937660697,MATH 18,A03,084120,Harel; Guershon,30,0,30,0
1649937660697,MATH 18,A04,084121,Harel; Guershon,29,0,30,1
1649937666726,MATH 20B,A01,084124,Um; Ko Woon,31,0,35,4
1649937666726,MATH 20B,B01,084126,Um; Ko Woon,32,0,35,3
1649937672760,MATH 20C,A01,083446,Hammock; Frances H,17,0,30,13
1649937672760,MATH 20C,A02,083447,Hammock; Frances H,28,0,30,2
1649937672760,MATH 20C,A03,083448,Hammock; Frances H,30,0,30,0
1649937672760,MATH 20C,A04,083449,Hammock; Frances H,30,0,30,0
1649937672760,MATH 20C,B01,083451,Hammock; Frances H,25,0,30,5
1649937672760,MATH 20C,B02,083452,Hammock; Frances H,27,0,30,3
1649937672760,MATH 20C,B03,083453,Hammock; Frances H,26,0,30,4
1649937672760,MATH 20C,B04,083454,Hammock; Frances H,30,0,30,0
1649937678788,MATH 20D,A01,084128,Staff,26,0,30,4
1649937678788,MATH 20D,A02,084129,Staff,30,0,30,0
1649937678788,MATH 20D,A03,084130,Staff,29,0,30,1
1649937678788,MATH 20D,B01,084133,Staff,21,0,30,9
1649937678788,MATH 20D,B02,084134,Staff,27,0,30,3
1649937678788,MATH 20D,B03,084135,Staff,30,0,30,0
1649937684816,MATH 20E,A01,084138,Staff,22,0,30,8
1649937684816,MATH 20E,A02,084139,Staff,22,0,30,8
1649937684816,MATH 20E,A03,084140,Staff,23,0,30,7
1649937684816,MATH 20E,A04,084141,Staff,25,0,30,5
1649937690843,MATH 102,A01,084143,Harel; Guershon,16,0,30,14
1649937690843,MATH 102,A02,084144,Harel; Guershon,22,0,30,8
1649937696869,MATH 103B,A01,083456,Staff,0,8,30,30
1649937696869,MATH 103B,A02,083457,Staff,0,9,30,30
1649937702897,MATH 109,A01,084146,Salehi Golsefidy; Alireza,28,0,30,2
1649937702897,MATH 109,A02,084147,Salehi Golsefidy; Alireza,22,0,30,8
1649937708926,MATH 120A,A01,085445,Eggers; John Dietrich,20,0,35,15
1649937708926,MATH 120A,A02,085446,Eggers; John Dietrich,28,0,35,7
1649937714953,MATH 142B,A01,084149,Verstraete; Jacques Allan,0,10,30,30
1649937714953,MATH 142B,A02,084150,Verstraete; Jacques Allan,0,9,30,30
1649937720981,MATH 170A,A01,083459,Nie; Jiawang,0,2,30,30
1649937720981,MATH 170A,A02,083460,Nie; Jiawang,0,0,30,30
1649937720981,MATH 170A,A03,083461,Nie; Jiawang,7,0,30,23
1649937727011,MATH 193B,A01,083463,Staff,3,0,30,27
1649937727011,MATH 193B,A02,083464,Staff,10,0,30,20
1649937727011,MATH 193B,A03,083465,Staff,19,0,30,11
1649937733081,COGS 2,A01,083966,Boyle; Mary E. T.,18,0,30,12
1649937739114,COGS 9,A01,083968,Staff,41,0,60,19
1649937745145,COGS 14B,A01,083970,Staff,28,0,50,22
1649937751171,COGS 17,A01,092679,Staff,67,0,75,8
1649937757198,COGS 100,A01,083972,Staff,9,0,60,51
1649937769257,COGS 101C,A01,083976,Staff,19,0,30,11
1649937775290,COGS 102A,A01,083978,Johnson; Christine M.,17,0,30,13
1649937781324,COGS 107B,A01,083980,Staff,3,0,50,47
1649937787351,COGS 115,A01,083982,Staff,14,0,30,16
1649937793385,COGS 118B,A01,083367,Staff,0,11,40,40
1649937799424,COGS 172,A01,083984,Provenzano; Emily Kara,16,0,30,14
1649937805466,COGS 177,A00,083368,Staff,0,17,30,30
1649937811492,COGS 186,A01,083986,Staff,21,0,40,19
1649937817524,COGS 187A,A01,083988,Boyle; Mary E. T.,24,0,60,36
1649937823552,CSE 8A,A50,084003,Miranda; Gregory Joseph,0,0,15,15
1649937829575,CSE 11,A01,084005,Miranda; Gregory Joseph,22,0,55,33
1649937835609,CSE 20,A01,084007,Staff,9,0,20,11
1649937841642,CSE 21,A01,084009,Staff,10,0,50,40
1649937847695,CSE 30,A01,083370,Cao; Yingjun,0,20,40,40
1649937853728,CSE 100,A01,083372,Cao; Yingjun,0,23,40,40
1649937859755,CSE 101,A01,084011,Staff,0,49,40,40
1649937865783,CSE 141,A01,083374,Eldon; John,0,51,75,75
1649937871812,CSE 141L,A01,083376,Eldon; John,0,56,75,75
1649937877941,CSE 175,A01,084013,Kumar; Rakesh,22,0,25,3
1649937883971,CSE 190,A00,092508,Dubnov; Shlomo,15,0,15,0
1649937890003,ECE 5,A01,084049,Morris; Karcher William,15,0,20,5
1649937896039,ECE 100,A01,084051,Baghdadchi; Saharnaz,1,0,20,19
1649937896039,ECE 100,A02,091916,Baghdadchi; Saharnaz,16,0,20,4
1649937902074,ECE 101,A01,084053,Baghdadchi; Saharnaz,5,0,37,32
1649937902074,ECE 101,A02,084054,Baghdadchi; Saharnaz,33,0,37,4
1649937908107,ECE 107,A01,083390,Staff,28,0,40,12
1649937914136,ECE 148,A01,084056,Silberman; Jack,7,0,12,5
1649937920167,ECE 180,A00,083391,Abi Samra; Nicholas Camill,25,0,30,5
1649937920167,ECE 180,B00,083392,Abi Samra; Nicholas Camill,22,0,30,8
1649937926198,MATH 10B,A01,084110,Staff,8,0,30,22
1649937926198,MATH 10B,A02,084111,Staff,29,0,30,1
1649937926198,MATH 10B,A03,084112,Staff,28,0,30,2
1649937932227,MATH 10C,A01,083443,Staff,9,0,30,21
1649937932227,MATH 10C,A02,083444,Staff,16,0,30,14
1649937932227,MATH 10C,B01,084114,Staff,25,0,30,5
1649937932227,MATH 10C,B02,084115,Staff,29,0,30,1
1649937938261,MATH 18,A01,084117,Harel; Guershon,27,0,30,3
1649937938261,MATH 18,A02,084119,Harel; Guershon,29,0,30,1
1649937938261,MATH 18,A03,084120,Harel; Guershon,30,0,30,0
1649937938261,MATH 18,A04,084121,Harel; Guershon,29,0,30,1
1649937944293,MATH 20B,A01,084124,Um; Ko Woon,31,0,35,4
1649937944293,MATH 20B,B01,084126,Um; Ko Woon,32,0,35,3
1649937950337,MATH 20C,A01,083446,Hammock; Frances H,17,0,30,13
1649937950337,MATH 20C,A02,083447,Hammock; Frances H,28,0,30,2
1649937950337,MATH 20C,A03,083448,Hammock; Frances H,30,0,30,0
1649937950337,MATH 20C,A04,083449,Hammock; Frances H,30,0,30,0
1649937950337,MATH 20C,B01,083451,Hammock; Frances H,25,0,30,5
1649937950337,MATH 20C,B02,083452,Hammock; Frances H,27,0,30,3
1649937950337,MATH 20C,B03,083453,Hammock; Frances H,26,0,30,4
1649937950337,MATH 20C,B04,083454,Hammock; Frances H,30,0,30,0
1649937956369,MATH 20D,A01,084128,Staff,26,0,30,4
1649937956369,MATH 20D,A02,084129,Staff,30,0,30,0
1649937956369,MATH 20D,A03,084130,Staff,29,0,30,1
1649937956369,MATH 20D,B01,084133,Staff,21,0,30,9
1649937956369,MATH 20D,B02,084134,Staff,27,0,30,3
1649937956369,MATH 20D,B03,084135,Staff,30,0,30,0
1649937962396,MATH 20E,A01,084138,Staff,22,0,30,8
1649937962396,MATH 20E,A02,084139,Staff,22,0,30,8
1649937962396,MATH 20E,A03,084140,Staff,23,0,30,7
1649937962396,MATH 20E,A04,084141,Staff,25,0,30,5
1649937968433,MATH 102,A01,084143,Harel; Guershon,16,0,30,14
1649937968433,MATH 102,A02,084144,Harel; Guershon,22,0,30,8
1649937974467,MATH 103B,A01,083456,Staff,0,8,30,30
1649937974467,MATH 103B,A02,083457,Staff,0,9,30,30
1649937980502,MATH 109,A01,084146,Salehi Golsefidy; Alireza,28,0,30,2
1649937980502,MATH 109,A02,084147,Salehi Golsefidy; Alireza,22,0,30,8
1649937986531,MATH 120A,A01,085445,Eggers; John Dietrich,20,0,35,15
1649937986531,MATH 120A,A02,085446,Eggers; John Dietrich,28,0,35,7
1649937992564,MATH 142B,A01,084149,Verstraete; Jacques Allan,0,10,30,30
1649937992564,MATH 142B,A02,084150,Verstraete; Jacques Allan,0,9,30,30
1649937998592,MATH 170A,A01,083459,Nie; Jiawang,0,2,30,30
1649937998592,MATH 170A,A02,083460,Nie; Jiawang,0,0,30,30
1649937998592,MATH 170A,A03,083461,Nie; Jiawang,7,0,30,23
1649938004624,MATH 193B,A01,083463,Staff,3,0,30,27
1649938004624,MATH 193B,A02,083464,Staff,10,0,30,20
1649938004624,MATH 193B,A03,083465,Staff,19,0,30,11
1649938010693,COGS 2,A01,083966,Boyle; Mary E. T.,18,0,30,12
1649938016724,COGS 9,A01,083968,Staff,41,0,60,19
1649938022755,COGS 14B,A01,083970,Staff,28,0,50,22
1649938028780,COGS 17,A01,092679,Staff,67,0,75,8
1649938034810,COGS 100,A01,083972,Staff,9,0,60,51
1649938046863,COGS 101C,A01,083976,Staff,19,0,30,11
1649938052891,COGS 102A,A01,083978,Johnson; Christine M.,17,0,30,13
1649938058919,COGS 107B,A01,083980,Staff,3,0,50,47
1649938064947,COGS 115,A01,083982,Staff,14,0,30,16
1649938070973,COGS 118B,A01,083367,Staff,0,11,40,40
1649938077003,COGS 172,A01,083984,Provenzano; Emily Kara,16,0,30,14
1649938083029,COGS 177,A00,083368,Staff,0,17,30,30
1649938089060,COGS 186,A01,083986,Staff,21,0,40,19
1649938095088,COGS 187A,A01,083988,Boyle; Mary E. T.,24,0,60,36
1649938101123,CSE 8A,A50,084003,Miranda; Gregory Joseph,0,0,15,15
1649938107154,CSE 11,A01,084005,Miranda; Gregory Joseph,22,0,55,33
1649938113181,CSE 20,A01,084007,Staff,9,0,20,11
1649938119209,CSE 21,A01,084009,Staff,10,0,50,40
1649938125237,CSE 30,A01,083370,Cao; Yingjun,0,20,40,40
1649938131271,CSE 100,A01,083372,Cao; Yingjun,0,23,40,40
1649938137302,CSE 101,A01,084011,Staff,0,49,40,40
1649938143328,CSE 141,A01,083374,Eldon; John,0,51,75,75
1649938149362,CSE 141L,A01,083376,Eldon; John,0,56,75,75
1649938155391,CSE 175,A01,084013,Kumar; Rakesh,22,0,25,3
1649938161418,CSE 190,A00,092508,Dubnov; Shlomo,15,0,15,0
1649938167447,ECE 5,A01,084049,Morris; Karcher William,15,0,20,5
1649938173482,ECE 100,A01,084051,Baghdadchi; Saharnaz,1,0,20,19
1649938173482,ECE 100,A02,091916,Baghdadchi; Saharnaz,16,0,20,4
1649938179510,ECE 101,A01,084053,Baghdadchi; Saharnaz,5,0,37,32
1649938179510,ECE 101,A02,084054,Baghdadchi; Saharnaz,33,0,37,4
1649938185540,ECE 107,A01,083390,Staff,28,0,40,12
1649938191567,ECE 148,A01,084056,Silberman; Jack,7,0,12,5
1649938197600,ECE 180,A00,083391,Abi Samra; Nicholas Camill,25,0,30,5
1649938197600,ECE 180,B00,083392,Abi Samra; Nicholas Camill,22,0,30,8
1649938203634,MATH 10B,A01,084110,Staff,8,0,30,22
1649938203634,MATH 10B,A02,084111,Staff,29,0,30,1
1649938203634,MATH 10B,A03,084112,Staff,28,0,30,2
1649938209667,MATH 10C,A01,083443,Staff,9,0,30,21
1649938209667,MATH 10C,A02,083444,Staff,16,0,30,14
1649938209667,MATH 10C,B01,084114,Staff,25,0,30,5
1649938209667,MATH 10C,B02,084115,Staff,29,0,30,1
1649938215695,MATH 18,A01,084117,Harel; Guershon,27,0,30,3
1649938215695,MATH 18,A02,084119,Harel; Guershon,29,0,30,1
1649938215695,MATH 18,A03,084120,Harel; Guershon,30,0,30,0
1649938215695,MATH 18,A04,084121,Harel; Guershon,29,0,30,1
1649938221723,MATH 20B,A01,084124,Um; Ko Woon,31,0,35,4
1649938221723,MATH 20B,B01,084126,Um; Ko Woon,32,0,35,3
1649938227758,MATH 20C,A01,083446,Hammock; Frances H,17,0,30,13
1649938227758,MATH 20C,A02,083447,Hammock; Frances H,28,0,30,2
1649938227758,MATH 20C,A03,083448,Hammock; Frances H,30,0,30,0
1649938227758,MATH 20C,A04,083449,Hammock; Frances H,30,0,30,0
1649938227758,MATH 20C,B01,083451,Hammock; Frances H,25,0,30,5
1649938227758,MATH 20C,B02,083452,Hammock; Frances H,27,0,30,3
1649938227758,MATH 20C,B03,083453,Hammock; Frances H,26,0,30,4
1649938227758,MATH 20C,B04,083454,Hammock; Frances H,30,0,30,0
1649938233794,MATH 20D,A01,084128,Staff,26,0,30,4
1649938233794,MATH 20D,A02,084129,Staff,30,0,30,0
1649938233794,MATH 20D,A03,084130,Staff,29,0,30,1
1649938233794,MATH 20D,B01,084133,Staff,21,0,30,9
1649938233794,MATH 20D,B02,084134,Staff,27,0,30,3
1649938233794,MATH 20D,B03,084135,Staff,30,0,30,0
1649938239822,MATH 20E,A01,084138,Staff,22,0,30,8
1649938239822,MATH 20E,A02,084139,Staff,22,0,30,8
1649938239822,MATH 20E,A03,084140,Staff,23,0,30,7
1649938239822,MATH 20E,A04,084141,Staff,25,0,30,5
1649938245849,MATH 102,A01,084143,Harel; Guershon,16,0,30,14
1649938245849,MATH 102,A02,084144,Harel; Guershon,22,0,30,8
1649938251877,MATH 103B,A01,083456,Staff,0,8,30,30
1649938251877,MATH 103B,A02,083457,Staff,0,9,30,30
1649938257905,MATH 109,A01,084146,Salehi Golsefidy; Alireza,28,0,30,2
1649938257905,MATH 109,A02,084147,Salehi Golsefidy; Alireza,22,0,30,8
1649938263936,MATH 120A,A01,085445,Eggers; John Dietrich,20,0,35,15
1649938263936,MATH 120A,A02,085446,Eggers; John Dietrich,28,0,35,7
1649938269971,MATH 142B,A01,084149,Verstraete; Jacques Allan,0,10,30,30
1649938269971,MATH 142B,A02,084150,Verstraete; Jacques Allan,0,9,30,30
1649938276004,MATH 170A,A01,083459,Nie; Jiawang,0,2,30,30
1649938276004,MATH 170A,A02,083460,Nie; Jiawang,0,0,30,30
1649938276004,MATH 170A,A03,083461,Nie; Jiawang,7,0,30,23
1649938282031,MATH 193B,A01,083463,Staff,3,0,30,27
1649938282031,MATH 193B,A02,083464,Staff,10,0,30,20
1649938282031,MATH 193B,A03,083465,Staff,19,0,30,11
1649938288135,COGS 2,A01,083966,Boyle; Mary E. T.,18,0,30,12
1649938294166,COGS 9,A01,083968,Staff,41,0,60,19
1649938300192,COGS 14B,A01,083970,Staff,28,0,50,22
1649938306224,COGS 17,A01,092679,Staff,67,0,75,8
1649938312252,COGS 100,A01,083972,Staff,9,0,60,51
1649938324319,COGS 101C,A01,083976,Staff,19,0,30,11
1649938330358,COGS 102A,A01,083978,Johnson; Christine M.,17,0,30,13
1649938336385,COGS 107B,A01,083980,Staff,3,0,50,47
1649938342416,COGS 115,A01,083982,Staff,14,0,30,16
1649938348451,COGS 118B,A01,083367,Staff,0,11,40,40
1649938354480,COGS 172,A01,083984,Provenzano; Emily Kara,16,0,30,14
1649938360511,COGS 177,A00,083368,Staff,0,17,30,30
1649938366542,COGS 186,A01,083986,Staff,21,0,40,19
1649938372572,COGS 187A,A01,083988,Boyle; Mary E. T.,24,0,60,36
1649938378605,CSE 8A,A50,084003,Miranda; Gregory Joseph,0,0,15,15
1649938384634,CSE 11,A01,084005,Miranda; Gregory Joseph,22,0,55,33
1649938390670,CSE 20,A01,084007,Staff,9,0,20,11
1649938396704,CSE 21,A01,084009,Staff,10,0,50,40
1649938402737,CSE 30,A01,083370,Cao; Yingjun,0,20,40,40
1649938408772,CSE 100,A01,083372,Cao; Yingjun,0,23,40,40
1649938414799,CSE 101,A01,084011,Staff,0,49,40,40
1649938420842,CSE 141,A01,083374,Eldon; John,0,51,75,75
1649938426871,CSE 141L,A01,083376,Eldon; John,0,56,75,75
1649938432899,CSE 175,A01,084013,Kumar; Rakesh,22,0,25,3
1649938438927,CSE 190,A00,092508,Dubnov; Shlomo,15,0,15,0
1649938444954,ECE 5,A01,084049,Morris; Karcher William,15,0,20,5
1649938451001,ECE 100,A01,084051,Baghdadchi; Saharnaz,1,0,20,19
1649938451001,ECE 100,A02,091916,Baghdadchi; Saharnaz,16,0,20,4
1649938457035,ECE 101,A01,084053,Baghdadchi; Saharnaz,5,0,37,32
1649938457035,ECE 101,A02,084054,Baghdadchi; Saharnaz,33,0,37,4
1649938463063,ECE 107,A01,083390,Staff,28,0,40,12
1649938469096,ECE 148,A01,084056,Silberman; Jack,7,0,12,5
1649938475211,ECE 180,A00,083391,Abi Samra; Nicholas Camill,25,0,30,5
1649938475211,ECE 180,B00,083392,Abi Samra; Nicholas Camill,22,0,30,8
1649938481241,MATH 10B,A01,084110,Staff,8,0,30,22
1649938481241,MATH 10B,A02,084111,Staff,29,0,30,1
1649938481241,MATH 10B,A03,084112,Staff,28,0,30,2
1649938487273,MATH 10C,A01,083443,Staff,9,0,30,21
1649938487273,MATH 10C,A02,083444,Staff,16,0,30,14
1649938487273,MATH 10C,B01,084114,Staff,25,0,30,5
1649938487273,MATH 10C,B02,084115,Staff,29,0,30,1
1649938493308,MATH 18,A01,084117,Harel; Guershon,27,0,30,3
1649938493308,MATH 18,A02,084119,Harel; Guershon,29,0,30,1
1649938493308,MATH 18,A03,084120,Harel; Guershon,30,0,30,0
1649938493308,MATH 18,A04,084121,Harel; Guershon,29,0,30,1
1649938499337,MATH 20B,A01,084124,Um; Ko Woon,31,0,35,4
1649938499337,MATH 20B,B01,084126,Um; Ko Woon,32,0,35,3
1649938505364,MATH 20C,A01,083446,Hammock; Frances H,17,0,30,13
1649938505364,MATH 20C,A02,083447,Hammock; Frances H,28,0,30,2
1649938505364,MATH 20C,A03,083448,Hammock; Frances H,30,0,30,0
1649938505364,MATH 20C,A04,083449,Hammock; Frances H,30,0,30,0
1649938505364,MATH 20C,B01,083451,Hammock; Frances H,25,0,30,5
1649938505364,MATH 20C,B02,083452,Hammock; Frances H,27,0,30,3
1649938505364,MATH 20C,B03,083453,Hammock; Frances H,26,0,30,4
1649938505364,MATH 20C,B04,083454,Hammock; Frances H,30,0,30,0
1649938511397,MATH 20D,A01,084128,Staff,26,0,30,4
1649938511397,MATH 20D,A02,084129,Staff,30,0,30,0
1649938511397,MATH 20D,A03,084130,Staff,29,0,30,1
1649938511397,MATH 20D,B01,084133,Staff,21,0,30,9
1649938511397,MATH 20D,B02,084134,Staff,27,0,30,3
1649938511397,MATH 20D,B03,084135,Staff,30,0,30,0
1649938517428,MATH 20E,A01,084138,Staff,22,0,30,8
1649938517428,MATH 20E,A02,084139,Staff,22,0,30,8
1649938517428,MATH 20E,A03,084140,Staff,23,0,30,7
1649938517428,MATH 20E,A04,084141,Staff,25,0,30,5
1649938523459,MATH 102,A01,084143,Harel; Guershon,16,0,30,14
1649938523459,MATH 102,A02,084144,Harel; Guershon,22,0,30,8
1649938529491,MATH 103B,A01,083456,Staff,0,8,30,30
1649938529491,MATH 103B,A02,083457,Staff,0,9,30,30
1649938535526,MATH 109,A01,084146,Salehi Golsefidy; Alireza,28,0,30,2
1649938535526,MATH 109,A02,084147,Salehi Golsefidy; Alireza,22,0,30,8
1649938541555,MATH 120A,A01,085445,Eggers; John Dietrich,20,0,35,15
1649938541555,MATH 120A,A02,085446,Eggers; John Dietrich,28,0,35,7
1649938547592,MATH 142B,A01,084149,Verstraete; Jacques Allan,0,10,30,30
1649938547592,MATH 142B,A02,084150,Verstraete; Jacques Allan,0,9,30,30
1649938553621,MATH 170A,A01,083459,Nie; Jiawang,0,2,30,30
1649938553621,MATH 170A,A02,083460,Nie; Jiawang,0,0,30,30
1649938553621,MATH 170A,A03,083461,Nie; Jiawang,7,0,30,23
1649938559649,MATH 193B,A01,083463,Staff,3,0,30,27
1649938559649,MATH 193B,A02,083464,Staff,10,0,30,20
1649938559649,MATH 193B,A03,083465,Staff,19,0,30,11
1649938565717,COGS 2,A01,083966,Boyle; Mary E. T.,18,0,30,12
1649938571747,COGS 9,A01,083968,Staff,41,0,60,19
1649938577778,COGS 14B,A01,083970,Staff,28,0,50,22
1649938583809,COGS 17,A01,092679,Staff,67,0,75,8
1649938589837,COGS 100,A01,083972,Staff,9,0,60,51
1649938601900,COGS 101C,A01,083976,Staff,19,0,30,11
1649938607937,COGS 102A,A01,083978,Johnson; Christine M.,17,0,30,13
1649938613963,COGS 107B,A01,083980,Staff,3,0,50,47
1649938619990,COGS 115,A01,083982,Staff,14,0,30,16
1649938626022,COGS 118B,A01,083367,Staff,0,11,40,40
1649938632051,COGS 172,A01,083984,Provenzano; Emily Kara,16,0,30,14
1649938638084,COGS 177,A00,083368,Staff,0,17,30,30
1649938644109,COGS 186,A01,083986,Staff,21,0,40,19
1649938650142,COGS 187A,A01,083988,Boyle; Mary E. T.,24,0,60,36
1649938656171,CSE 8A,A50,084003,Miranda; Gregory Joseph,0,0,15,15
1649938662196,CSE 11,A01,084005,Miranda; Gregory Joseph,22,0,55,33
1649938668226,CSE 20,A01,084007,Staff,9,0,20,11
1649938674256,CSE 21,A01,084009,Staff,10,0,50,40
1649938680286,CSE 30,A01,083370,Cao; Yingjun,0,20,40,40
1649938686311,CSE 100,A01,083372,Cao; Yingjun,0,23,40,40
1649938692338,CSE 101,A01,084011,Staff,0,49,40,40
1649938698371,CSE 141,A01,083374,Eldon; John,0,51,75,75
1649938704408,CSE 141L,A01,083376,Eldon; John,0,56,75,75
1649938710435,CSE 175,A01,084013,Kumar; Rakesh,22,0,25,3
1649938716473,CSE 190,A00,092508,Dubnov; Shlomo,15,0,15,0
1649938722504,ECE 5,A01,084049,Morris; Karcher William,15,0,20,5
1649938728540,ECE 100,A01,084051,Baghdadchi; Saharnaz,1,0,20,19
1649938728540,ECE 100,A02,091916,Baghdadchi; Saharnaz,16,0,20,4
1649938734580,ECE 101,A01,084053,Baghdadchi; Saharnaz,5,0,37,32
1649938734580,ECE 101,A02,084054,Baghdadchi; Saharnaz,33,0,37,4
1649938740623,ECE 107,A01,083390,Staff,28,0,40,12
1649938746658,ECE 148,A01,084056,Silberman; Jack,7,0,12,5
1649938752684,ECE 180,A00,083391,Abi Samra; Nicholas Camill,25,0,30,5
1649938752684,ECE 180,B00,083392,Abi Samra; Nicholas Camill,22,0,30,8
1649938758712,MATH 10B,A01,084110,Staff,8,0,30,22
1649938758712,MATH 10B,A02,084111,Staff,29,0,30,1
1649938758712,MATH 10B,A03,084112,Staff,28,0,30,2
1649938764742,MATH 10C,A01,083443,Staff,9,0,30,21
1649938764742,MATH 10C,A02,083444,Staff,16,0,30,14
1649938764742,MATH 10C,B01,084114,Staff,25,0,30,5
1649938764742,MATH 10C,B02,084115,Staff,29,0,30,1
1649938770770,MATH 18,A01,084117,Harel; Guershon,27,0,30,3
1649938770770,MATH 18,A02,084119,Harel; Guershon,29,0,30,1
1649938770770,MATH 18,A03,084120,Harel; Guershon,30,0,30,0
1649938770770,MATH 18,A04,084121,Harel; Guershon,29,0,30,1
1649938776797,MATH 20B,A01,084124,Um; Ko Woon,31,0,35,4
1649938776797,MATH 20B,B01,084126,Um; Ko Woon,32,0,35,3
1649938782826,MATH 20C,A01,083446,Hammock; Frances H,17,0,30,13
1649938782826,MATH 20C,A02,083447,Hammock; Frances H,28,0,30,2
1649938782826,MATH 20C,A03,083448,Hammock; Frances H,30,0,30,0
1649938782826,MATH 20C,A04,083449,Hammock; Frances H,30,0,30,0
1649938782826,MATH 20C,B01,083451,Hammock; Frances H,25,0,30,5
1649938782826,MATH 20C,B02,083452,Hammock; Frances H,27,0,30,3
1649938782826,MATH 20C,B03,083453,Hammock; Frances H,26,0,30,4
1649938782826,MATH 20C,B04,083454,Hammock; Frances H,30,0,30,0
1649938788854,MATH 20D,A01,084128,Staff,26,0,30,4
1649938788854,MATH 20D,A02,084129,Staff,30,0,30,0
1649938788854,MATH 20D,A03,084130,Staff,29,0,30,1
1649938788854,MATH 20D,B01,084133,Staff,21,0,30,9
1649938788854,MATH 20D,B02,084134,Staff,27,0,30,3
1649938788854,MATH 20D,B03,084135,Staff,30,0,30,0
1649938794880,MATH 20E,A01,084138,Staff,22,0,30,8
1649938794880,MATH 20E,A02,084139,Staff,22,0,30,8
1649938794880,MATH 20E,A03,084140,Staff,23,0,30,7
1649938794880,MATH 20E,A04,084141,Staff,25,0,30,5
1649938800907,MATH 102,A01,084143,Harel; Guershon,16,0,30,14
1649938800907,MATH 102,A02,084144,Harel; Guershon,22,0,30,8
1649938806932,MATH 103B,A01,083456,Staff,0,8,30,30
1649938806932,MATH 103B,A02,083457,Staff,0,9,30,30
1649938812964,MATH 109,A01,084146,Salehi Golsefidy; Alireza,28,0,30,2
1649938812964,MATH 109,A02,084147,Salehi Golsefidy; Alireza,22,0,30,8
1649938818997,MATH 120A,A01,085445,Eggers; John Dietrich,20,0,35,15
1649938818997,MATH 120A,A02,085446,Eggers; John Dietrich,28,0,35,7
1649938825028,MATH 142B,A01,084149,Verstraete; Jacques Allan,0,10,30,30
1649938825028,MATH 142B,A02,084150,Verstraete; Jacques Allan,0,9,30,30
1649938831060,MATH 170A,A01,083459,Nie; Jiawang,0,2,30,30
1649938831060,MATH 170A,A02,083460,Nie; Jiawang,0,0,30,30
1649938831060,MATH 170A,A03,083461,Nie; Jiawang,7,0,30,23
1649938837088,MATH 193B,A01,083463,Staff,3,0,30,27
1649938837088,MATH 193B,A02,083464,Staff,10,0,30,20
1649938837088,MATH 193B,A03,083465,Staff,19,0,30,11
1649938843220,COGS 2,A01,083966,Boyle; Mary E. T.,18,0,30,12
1649938849304,COGS 9,A01,083968,Staff,41,0,60,19
1649938855335,COGS 14B,A01,083970,Staff,28,0,50,22
1649938861369,COGS 17,A01,092679,Staff,67,0,75,8
1649938867401,COGS 100,A01,083972,Staff,9,0,60,51
1649938879458,COGS 101C,A01,083976,Staff,19,0,30,11
1649938885485,COGS 102A,A01,083978,Johnson; Christine M.,17,0,30,13
1649938891520,COGS 107B,A01,083980,Staff,3,0,50,47
1649938897546,COGS 115,A01,083982,Staff,14,0,30,16
1649938903576,COGS 118B,A01,083367,Staff,0,11,40,40
1649938909608,COGS 172,A01,083984,Provenzano; Emily Kara,16,0,30,14
1649938915635,COGS 177,A00,083368,Staff,0,17,30,30
1649938921666,COGS 186,A01,083986,Staff,21,0,40,19
1649938927692,COGS 187A,A01,083988,Boyle; Mary E. T.,24,0,60,36
1649938933718,CSE 8A,A50,084003,Miranda; Gregory Joseph,0,0,15,15
1649938939743,CSE 11,A01,084005,Miranda; Gregory Joseph,22,0,55,33
1649938945776,CSE 20,A01,084007,Staff,9,0,20,11
1649938951804,CSE 21,A01,084009,Staff,10,0,50,40
1649938957835,CSE 30,A01,083370,Cao; Yingjun,0,20,40,40
1649938963862,CSE 100,A01,083372,Cao; Yingjun,0,23,40,40
1649938969889,CSE 101,A01,084011,Staff,0,49,40,40
1649938975914,CSE 141,A01,083374,Eldon; John,0,51,75,75
1649938981943,CSE 141L,A01,083376,Eldon; John,0,56,75,75
1649938987973,CSE 175,A01,084013,Kumar; Rakesh,22,0,25,3
1649938994002,CSE 190,A00,092508,Dubnov; Shlomo,15,0,15,0
1649939000039,ECE 5,A01,084049,Morris; Karcher William,15,0,20,5
1649939006068,ECE 100,A01,084051,Baghdadchi; Saharnaz,1,0,20,19
1649939006068,ECE 100,A02,091916,Baghdadchi; Saharnaz,16,0,20,4
1649939012095,ECE 101,A01,084053,Baghdadchi; Saharnaz,5,0,37,32
1649939012095,ECE 101,A02,084054,Baghdadchi; Saharnaz,33,0,37,4
1649939018123,ECE 107,A01,083390,Staff,28,0,40,12
1649939024155,ECE 148,A01,084056,Silberman; Jack,7,0,12,5
1649939030180,ECE 180,A00,083391,Abi Samra; Nicholas Camill,25,0,30,5
1649939030180,ECE 180,B00,083392,Abi Samra; Nicholas Camill,22,0,30,8
1649939036212,MATH 10B,A01,084110,Staff,8,0,30,22
1649939036212,MATH 10B,A02,084111,Staff,29,0,30,1
1649939036212,MATH 10B,A03,084112,Staff,28,0,30,2
1649939042248,MATH 10C,A01,083443,Staff,9,0,30,21
1649939042248,MATH 10C,A02,083444,Staff,16,0,30,14
1649939042248,MATH 10C,B01,084114,Staff,25,0,30,5
1649939042248,MATH 10C,B02,084115,Staff,29,0,30,1
1649939048279,MATH 18,A01,084117,Harel; Guershon,27,0,30,3
1649939048279,MATH 18,A02,084119,Harel; Guershon,29,0,30,1
1649939048279,MATH 18,A03,084120,Harel; Guershon,30,0,30,0
1649939048279,MATH 18,A04,084121,Harel; Guershon,29,0,30,1
1649939054314,MATH 20B,A01,084124,Um; Ko Woon,31,0,35,4
1649939054314,MATH 20B,B01,084126,Um; Ko Woon,32,0,35,3
1649939060345,MATH 20C,A01,083446,Hammock; Frances H,17,0,30,13
1649939060345,MATH 20C,A02,083447,Hammock; Frances H,28,0,30,2
1649939060345,MATH 20C,A03,083448,Hammock; Frances H,30,0,30,0
1649939060345,MATH 20C,A04,083449,Hammock; Frances H,30,0,30,0
1649939060345,MATH 20C,B01,083451,Hammock; Frances H,25,0,30,5
1649939060345,MATH 20C,B02,083452,Hammock; Frances H,27,0,30,3
1649939060345,MATH 20C,B03,083453,Hammock; Frances H,26,0,30,4
1649939060345,MATH 20C,B04,083454,Hammock; Frances H,30,0,30,0
1649939066379,MATH 20D,A01,084128,Staff,26,0,30,4
1649939066379,MATH 20D,A02,084129,Staff,30,0,30,0
1649939066379,MATH 20D,A03,084130,Staff,29,0,30,1
1649939066379,MATH 20D,B01,084133,Staff,21,0,30,9
1649939066379,MATH 20D,B02,084134,Staff,27,0,30,3
1649939066379,MATH 20D,B03,084135,Staff,30,0,30,0
1649939072500,MATH 20E,A01,084138,Staff,22,0,30,8
1649939072500,MATH 20E,A02,084139,Staff,22,0,30,8
1649939072500,MATH 20E,A03,084140,Staff,23,0,30,7
1649939072500,MATH 20E,A04,084141,Staff,25,0,30,5
1649939078530,MATH 102,A01,084143,Harel; Guershon,16,0,30,14
1649939078530,MATH 102,A02,084144,Harel; Guershon,22,0,30,8
1649939084557,MATH 103B,A01,083456,Staff,0,8,30,30
1649939084557,MATH 103B,A02,083457,Staff,0,9,30,30
1649939090595,MATH 109,A01,084146,Salehi Golsefidy; Alireza,28,0,30,2
1649939090595,MATH 109,A02,084147,Salehi Golsefidy; Alireza,22,0,30,8
1649939096620,MATH 120A,A01,085445,Eggers; John Dietrich,20,0,35,15
1649939096620,MATH 120A,A02,085446,Eggers; John Dietrich,28,0,35,7
1649939102651,MATH 142B,A01,084149,Verstraete; Jacques Allan,0,10,30,30
1649939102651,MATH 142B,A02,084150,Verstraete; Jacques Allan,0,9,30,30
1649939108678,MATH 170A,A01,083459,Nie; Jiawang,0,2,30,30
1649939108678,MATH 170A,A02,083460,Nie; Jiawang,0,0,30,30
1649939108678,MATH 170A,A03,083461,Nie; Jiawang,7,0,30,23
1649939114704,MATH 193B,A01,083463,Staff,3,0,30,27
1649939114704,MATH 193B,A02,083464,Staff,10,0,30,20
1649939114704,MATH 193B,A03,083465,Staff,19,0,30,11
1649939120776,COGS 2,A01,083966,Boyle; Mary E. T.,18,0,30,12
1649939126803,COGS 9,A01,083968,Staff,41,0,60,19
1649939132828,COGS 14B,A01,083970,Staff,28,0,50,22
1649939138855,COGS 17,A01,092679,Staff,67,0,75,8
1649939144885,COGS 100,A01,083972,Staff,9,0,60,51
1649939156948,COGS 101C,A01,083976,Staff,19,0,30,11
1649939162979,COGS 102A,A01,083978,Johnson; Christine M.,17,0,30,13
1649939169006,COGS 107B,A01,083980,Staff,3,0,50,47
1649939175036,COGS 115,A01,083982,Staff,14,0,30,16
1649939181064,COGS 118B,A01,083367,Staff,0,11,40,40
1649939187103,COGS 172,A01,083984,Provenzano; Emily Kara,16,0,30,14
1649939193130,COGS 177,A00,083368,Staff,0,17,30,30
1649939199154,COGS 186,A01,083986,Staff,21,0,40,19
1649939205190,COGS 187A,A01,083988,Boyle; Mary E. T.,24,0,60,36
1649939211229,CSE 8A,A50,084003,Miranda; Gregory Joseph,0,0,15,15
1649939217262,CSE 11,A01,084005,Miranda; Gregory Joseph,22,0,55,33
1649939223287,CSE 20,A01,084007,Staff,9,0,20,11
1649939229313,CSE 21,A01,084009,Staff,10,0,50,40
1649939235341,CSE 30,A01,083370,Cao; Yingjun,0,20,40,40
1649939241392,CSE 100,A01,083372,Cao; Yingjun,0,23,40,40
1649939247418,CSE 101,A01,084011,Staff,0,49,40,40
1649939253447,CSE 141,A01,083374,Eldon; John,0,51,75,75
1649939259476,CSE 141L,A01,083376,Eldon; John,0,56,75,75
1649939265510,CSE 175,A01,084013,Kumar; Rakesh,22,0,25,3
1649939271541,CSE 190,A00,092508,Dubnov; Shlomo,15,0,15,0
1649939277569,ECE 5,A01,084049,Morris; Karcher William,15,0,20,5
1649939283604,ECE 100,A01,084051,Baghdadchi; Saharnaz,1,0,20,19
1649939283604,ECE 100,A02,091916,Baghdadchi; Saharnaz,16,0,20,4
1649939289632,ECE 101,A01,084053,Baghdadchi; Saharnaz,5,0,37,32
1649939289632,ECE 101,A02,084054,Baghdadchi; Saharnaz,33,0,37,4
1649939295666,ECE 107,A01,083390,Staff,28,0,40,12
1649939301693,ECE 148,A01,084056,Silberman; Jack,7,0,12,5
1649939307718,ECE 180,A00,083391,Abi Samra; Nicholas Camill,25,0,30,5
1649939307718,ECE 180,B00,083392,Abi Samra; Nicholas Camill,22,0,30,8
1649939313758,MATH 10B,A01,084110,Staff,8,0,30,22
1649939313758,MATH 10B,A02,084111,Staff,29,0,30,1
1649939313758,MATH 10B,A03,084112,Staff,28,0,30,2
1649939319786,MATH 10C,A01,083443,Staff,9,0,30,21
1649939319786,MATH 10C,A02,083444,Staff,16,0,30,14
1649939319786,MATH 10C,B01,084114,Staff,25,0,30,5
1649939319786,MATH 10C,B02,084115,Staff,29,0,30,1
1649939325820,MATH 18,A01,084117,Harel; Guershon,27,0,30,3
1649939325820,MATH 18,A02,084119,Harel; Guershon,29,0,30,1
1649939325820,MATH 18,A03,084120,Harel; Guershon,30,0,30,0
1649939325820,MATH 18,A04,084121,Harel; Guershon,29,0,30,1
1649939331855,MATH 20B,A01,084124,Um; Ko Woon,31,0,35,4
1649939331855,MATH 20B,B01,084126,Um; Ko Woon,32,0,35,3
1649939337883,MATH 20C,A01,083446,Hammock; Frances H,17,0,30,13
1649939337883,MATH 20C,A02,083447,Hammock; Frances H,28,0,30,2
1649939337883,MATH 20C,A03,083448,Hammock; Frances H,30,0,30,0
1649939337883,MATH 20C,A04,083449,Hammock; Frances H,30,0,30,0
1649939337883,MATH 20C,B01,083451,Hammock; Frances H,25,0,30,5
1649939337883,MATH 20C,B02,083452,Hammock; Frances H,27,0,30,3
1649939337883,MATH 20C,B03,083453,Hammock; Frances H,26,0,30,4
1649939337883,MATH 20C,B04,083454,Hammock; Frances H,30,0,30,0
1649939343911,MATH 20D,A01,084128,Staff,26,0,30,4
1649939343911,MATH 20D,A02,084129,Staff,30,0,30,0
1649939343911,MATH 20D,A03,084130,Staff,29,0,30,1
1649939343911,MATH 20D,B01,084133,Staff,21,0,30,9
1649939343911,MATH 20D,B02,084134,Staff,27,0,30,3
1649939343911,MATH 20D,B03,084135,Staff,30,0,30,0
1649939349943,MATH 20E,A01,084138,Staff,22,0,30,8
1649939349943,MATH 20E,A02,084139,Staff,22,0,30,8
1649939349943,MATH 20E,A03,084140,Staff,23,0,30,7
1649939349943,MATH 20E,A04,084141,Staff,25,0,30,5
1649939355975,MATH 102,A01,084143,Harel; Guershon,16,0,30,14
1649939355975,MATH 102,A02,084144,Harel; Guershon,22,0,30,8
1649939362002,MATH 103B,A01,083456,Staff,0,8,30,30
1649939362002,MATH 103B,A02,083457,Staff,0,9,30,30
1649939368030,MATH 109,A01,084146,Salehi Golsefidy; Alireza,28,0,30,2
1649939368030,MATH 109,A02,084147,Salehi Golsefidy; Alireza,22,0,30,8
1649939374061,MATH 120A,A01,085445,Eggers; John Dietrich,20,0,35,15
1649939374061,MATH 120A,A02,085446,Eggers; John Dietrich,28,0,35,7
1649939380091,MATH 142B,A01,084149,Verstraete; Jacques Allan,0,10,30,30
1649939380091,MATH 142B,A02,084150,Verstraete; Jacques Allan,0,9,30,30
1649939386138,MATH 170A,A01,083459,Nie; Jiawang,0,2,30,30
1649939386138,MATH 170A,A02,083460,Nie; Jiawang,0,0,30,30
1649939386138,MATH 170A,A03,083461,Nie; Jiawang,7,0,30,23
1649939392167,MATH 193B,A01,083463,Staff,3,0,30,27
1649939392167,MATH 193B,A02,083464,Staff,10,0,30,20
1649939392167,MATH 193B,A03,083465,Staff,19,0,30,11
1649939398251,COGS 2,A01,083966,Boyle; Mary E. T.,18,0,30,12
1649939404281,COGS 9,A01,083968,Staff,41,0,60,19
1649939410311,COGS 14B,A01,083970,Staff,28,0,50,22
1649939416347,COGS 17,A01,092679,Staff,67,0,75,8
1649939422384,COGS 100,A01,083972,Staff,9,0,60,51
1649939434439,COGS 101C,A01,083976,Staff,19,0,30,11
1649939440465,COGS 102A,A01,083978,Johnson; Christine M.,17,0,30,13
1649939446495,COGS 107B,A01,083980,Staff,3,0,50,47
1649939452524,COGS 115,A01,083982,Staff,14,0,30,16
1649939458560,COGS 118B,A01,083367,Staff,0,11,40,40
1649939464585,COGS 172,A01,083984,Provenzano; Emily Kara,16,0,30,14
1649939470610,COGS 177,A00,083368,Staff,0,17,30,30
1649939476644,COGS 186,A01,083986,Staff,21,0,40,19
1649939482676,COGS 187A,A01,083988,Boyle; Mary E. T.,24,0,60,36
1649939488703,CSE 8A,A50,084003,Miranda; Gregory Joseph,0,0,15,15
1649939494730,CSE 11,A01,084005,Miranda; Gregory Joseph,22,0,55,33
1649939500760,CSE 20,A01,084007,Staff,9,0,20,11
1649939506789,CSE 21,A01,084009,Staff,10,0,50,40
1649939512827,CSE 30,A01,083370,Cao; Yingjun,0,20,40,40
1649939518856,CSE 100,A01,083372,Cao; Yingjun,0,23,40,40
1649939524891,CSE 101,A01,084011,Staff,0,49,40,40
1649939530921,CSE 141,A01,083374,Eldon; John,0,51,75,75
1649939536949,CSE 141L,A01,083376,Eldon; John,0,56,75,75
1649939542979,CSE 175,A01,084013,Kumar; Rakesh,22,0,25,3
1649939549008,CSE 190,A00,092508,Dubnov; Shlomo,15,0,15,0
1649939555040,ECE 5,A01,084049,Morris; Karcher William,15,0,20,5
1649939561076,ECE 100,A01,084051,Baghdadchi; Saharnaz,1,0,20,19
1649939561076,ECE 100,A02,091916,Baghdadchi; Saharnaz,16,0,20,4
1649939567101,ECE 101,A01,084053,Baghdadchi; Saharnaz,5,0,37,32
1649939567101,ECE 101,A02,084054,Baghdadchi; Saharnaz,33,0,37,4
1649939573141,ECE 107,A01,083390,Staff,28,0,40,12
1649939579176,ECE 148,A01,084056,Silberman; Jack,7,0,12,5
1649939585202,ECE 180,A00,083391,Abi Samra; Nicholas Camill,25,0,30,5
1649939585202,ECE 180,B00,083392,Abi Samra; Nicholas Camill,22,0,30,8
1649939591235,MATH 10B,A01,084110,Staff,8,0,30,22
1649939591235,MATH 10B,A02,084111,Staff,29,0,30,1
1649939591235,MATH 10B,A03,084112,Staff,28,0,30,2
1649939597271,MATH 10C,A01,083443,Staff,9,0,30,21
1649939597271,MATH 10C,A02,083444,Staff,16,0,30,14
1649939597271,MATH 10C,B01,084114,Staff,25,0,30,5
1649939597271,MATH 10C,B02,084115,Staff,29,0,30,1
1649939603312,MATH 18,A01,084117,Harel; Guershon,27,0,30,3
1649939603312,MATH 18,A02,084119,Harel; Guershon,29,0,30,1
1649939603312,MATH 18,A03,084120,Harel; Guershon,30,0,30,0
1649939603312,MATH 18,A04,084121,Harel; Guershon,29,0,30,1
1649939609339,MATH 20B,A01,084124,Um; Ko Woon,31,0,35,4
1649939609339,MATH 20B,B01,084126,Um; Ko Woon,32,0,35,3
1649939615369,MATH 20C,A01,083446,Hammock; Frances H,17,0,30,13
1649939615369,MATH 20C,A02,083447,Hammock; Frances H,28,0,30,2
1649939615369,MATH 20C,A03,083448,Hammock; Frances H,30,0,30,0
1649939615369,MATH 20C,A04,083449,Hammock; Frances H,30,0,30,0
1649939615369,MATH 20C,B01,083451,Hammock; Frances H,25,0,30,5
1649939615369,MATH 20C,B02,083452,Hammock; Frances H,27,0,30,3
1649939615369,MATH 20C,B03,083453,Hammock; Frances H,26,0,30,4
1649939615369,MATH 20C,B04,083454,Hammock; Frances H,30,0,30,0
1649939621398,MATH 20D,A01,084128,Staff,26,0,30,4
1649939621398,MATH 20D,A02,084129,Staff,30,0,30,0
1649939621398,MATH 20D,A03,084130,Staff,29,0,30,1
1649939621398,MATH 20D,B01,084133,Staff,21,0,30,9
1649939621398,MATH 20D,B02,084134,Staff,27,0,30,3
1649939621398,MATH 20D,B03,084135,Staff,30,0,30,0
1649939627424,MATH 20E,A01,084138,Staff,22,0,30,8
1649939627424,MATH 20E,A02,084139,Staff,22,0,30,8
1649939627424,MATH 20E,A03,084140,Staff,23,0,30,7
1649939627424,MATH 20E,A04,084141,Staff,25,0,30,5
1649939633453,MATH 102,A01,084143,Harel; Guershon,16,0,30,14
1649939633453,MATH 102,A02,084144,Harel; Guershon,22,0,30,8
1649939639477,MATH 103B,A01,083456,Staff,0,8,30,30
1649939639477,MATH 103B,A02,083457,Staff,0,9,30,30
1649939645510,MATH 109,A01,084146,Salehi Golsefidy; Alireza,28,0,30,2
1649939645510,MATH 109,A02,084147,Salehi Golsefidy; Alireza,22,0,30,8
1649939651553,MATH 120A,A01,085445,Eggers; John Dietrich,20,0,35,15
1649939651553,MATH 120A,A02,085446,Eggers; John Dietrich,28,0,35,7
1649939657579,MATH 142B,A01,084149,Verstraete; Jacques Allan,0,10,30,30
1649939657579,MATH 142B,A02,084150,Verstraete; Jacques Allan,0,9,30,30
1649939663605,MATH 170A,A01,083459,Nie; Jiawang,0,2,30,30
1649939663605,MATH 170A,A02,083460,Nie; Jiawang,0,0,30,30
1649939663605,MATH 170A,A03,083461,Nie; Jiawang,7,0,30,23
1649939669730,MATH 193B,A01,083463,Staff,3,0,30,27
1649939669730,MATH 193B,A02,083464,Staff,10,0,30,20
1649939669730,MATH 193B,A03,083465,Staff,19,0,30,11
1649939675820,COGS 2,A01,083966,Boyle; Mary E. T.,18,0,30,12
1649939681847,COGS 9,A01,083968,Staff,41,0,60,19
1649939687887,COGS 14B,A01,083970,Staff,28,0,50,22
1649939693917,COGS 17,A01,092679,Staff,67,0,75,8
1649939699945,COGS 100,A01,083972,Staff,9,0,60,51
1649939712001,COGS 101C,A01,083976,Staff,19,0,30,11
1649939718031,COGS 102A,A01,083978,Johnson; Christine M.,17,0,30,13
1649939724055,COGS 107B,A01,083980,Staff,3,0,50,47
1649939730078,COGS 115,A01,083982,Staff,14,0,30,16
1649939736106,COGS 118B,A01,083367,Staff,0,11,40,40
1649939742144,COGS 172,A01,083984,Provenzano; Emily Kara,16,0,30,14
1649939748169,COGS 177,A00,083368,Staff,0,17,30,30
1649939754194,COGS 186,A01,083986,Staff,21,0,40,19
1649939760224,COGS 187A,A01,083988,Boyle; Mary E. T.,24,0,60,36
1649939766257,CSE 8A,A50,084003,Miranda; Gregory Joseph,0,0,15,15
1649939772283,CSE 11,A01,084005,Miranda; Gregory Joseph,22,0,55,33
1649939778315,CSE 20,A01,084007,Staff,9,0,20,11
1649939784340,CSE 21,A01,084009,Staff,10,0,50,40
1649939790364,CSE 30,A01,083370,Cao; Yingjun,0,20,40,40
1649939796389,CSE 100,A01,083372,Cao; Yingjun,0,23,40,40
1649939802420,CSE 101,A01,084011,Staff,0,49,40,40
1649939808449,CSE 141,A01,083374,Eldon; John,0,51,75,75
1649939814475,CSE 141L,A01,083376,Eldon; John,0,56,75,75
1649939820499,CSE 175,A01,084013,Kumar; Rakesh,22,0,25,3
1649939826533,CSE 190,A00,092508,Dubnov; Shlomo,15,0,15,0
1649939832560,ECE 5,A01,084049,Morris; Karcher William,15,0,20,5
1649939838592,ECE 100,A01,084051,Baghdadchi; Saharnaz,1,0,20,19
1649939838592,ECE 100,A02,091916,Baghdadchi; Saharnaz,16,0,20,4
1649939844630,ECE 101,A01,084053,Baghdadchi; Saharnaz,5,0,37,32
1649939844630,ECE 101,A02,084054,Baghdadchi; Saharnaz,33,0,37,4
1649939850661,ECE 107,A01,083390,Staff,28,0,40,12
1649939856694,ECE 148,A01,084056,Silberman; Jack,7,0,12,5
1649939862725,ECE 180,A00,083391,Abi Samra; Nicholas Camill,25,0,30,5
1649939862725,ECE 180,B00,083392,Abi Samra; Nicholas Camill,22,0,30,8
1649939868765,MATH 10B,A01,084110,Staff,8,0,30,22
1649939868765,MATH 10B,A02,084111,Staff,29,0,30,1
1649939868765,MATH 10B,A03,084112,Staff,28,0,30,2
1649939874794,MATH 10C,A01,083443,Staff,9,0,30,21
1649939874794,MATH 10C,A02,083444,Staff,16,0,30,14
1649939874794,MATH 10C,B01,084114,Staff,25,0,30,5
1649939874794,MATH 10C,B02,084115,Staff,29,0,30,1
1649939880821,MATH 18,A01,084117,Harel; Guershon,27,0,30,3
1649939880821,MATH 18,A02,084119,Harel; Guershon,29,0,30,1
1649939880821,MATH 18,A03,084120,Harel; Guershon,30,0,30,0
1649939880821,MATH 18,A04,084121,Harel; Guershon,29,0,30,1
1649939886847,MATH 20B,A01,084124,Um; Ko Woon,31,0,35,4
1649939886847,MATH 20B,B01,084126,Um; Ko Woon,32,0,35,3
1649939892875,MATH 20C,A01,083446,Hammock; Frances H,17,0,30,13
1649939892875,MATH 20C,A02,083447,Hammock; Frances H,28,0,30,2
1649939892875,MATH 20C,A03,083448,Hammock; Frances H,30,0,30,0
1649939892875,MATH 20C,A04,083449,Hammock; Frances H,30,0,30,0
1649939892875,MATH 20C,B01,083451,Hammock; Frances H,25,0,30,5
1649939892875,MATH 20C,B02,083452,Hammock; Frances H,27,0,30,3
1649939892875,MATH 20C,B03,083453,Hammock; Frances H,26,0,30,4
1649939892875,MATH 20C,B04,083454,Hammock; Frances H,30,0,30,0
1649939898904,MATH 20D,A01,084128,Staff,26,0,30,4
1649939898904,MATH 20D,A02,084129,Staff,30,0,30,0
1649939898904,MATH 20D,A03,084130,Staff,29,0,30,1
1649939898904,MATH 20D,B01,084133,Staff,21,0,30,9
1649939898904,MATH 20D,B02,084134,Staff,27,0,30,3
1649939898904,MATH 20D,B03,084135,Staff,30,0,30,0
1649939904935,MATH 20E,A01,084138,Staff,22,0,30,8
1649939904935,MATH 20E,A02,084139,Staff,22,0,30,8
1649939904935,MATH 20E,A03,084140,Staff,23,0,30,7
1649939904935,MATH 20E,A04,084141,Staff,25,0,30,5
1649939910965,MATH 102,A01,084143,Harel; Guershon,16,0,30,14
1649939910965,MATH 102,A02,084144,Harel; Guershon,22,0,30,8
1649939916991,MATH 103B,A01,083456,Staff,0,8,30,30
1649939916991,MATH 103B,A02,083457,Staff,0,9,30,30
1649939923020,MATH 109,A01,084146,Salehi Golsefidy; Alireza,28,0,30,2
1649939923020,MATH 109,A02,084147,Salehi Golsefidy; Alireza,22,0,30,8
1649939929051,MATH 120A,A01,085445,Eggers; John Dietrich,20,0,35,15
1649939929051,MATH 120A,A02,085446,Eggers; John Dietrich,28,0,35,7
1649939935078,MATH 142B,A01,084149,Verstraete; Jacques Allan,0,10,30,30
1649939935078,MATH 142B,A02,084150,Verstraete; Jacques Allan,0,9,30,30
1649939941110,MATH 170A,A01,083459,Nie; Jiawang,0,2,30,30
1649939941110,MATH 170A,A02,083460,Nie; Jiawang,0,0,30,30
1649939941110,MATH 170A,A03,083461,Nie; Jiawang,7,0,30,23
1649939947140,MATH 193B,A01,083463,Staff,3,0,30,27
1649939947140,MATH 193B,A02,083464,Staff,10,0,30,20
1649939947140,MATH 193B,A03,083465,Staff,19,0,30,11
1649939953214,COGS 2,A01,083966,Boyle; Mary E. T.,18,0,30,12
1649939959239,COGS 9,A01,083968,Staff,41,0,60,19
1649939965264,COGS 14B,A01,083970,Staff,28,0,50,22
1649939971295,COGS 17,A01,092679,Staff,67,0,75,8
1649939977322,COGS 100,A01,083972,Staff,9,0,60,51
1649939989375,COGS 101C,A01,083976,Staff,19,0,30,11
1649939995405,COGS 102A,A01,083978,Johnson; Christine M.,17,0,30,13
1649940001430,COGS 107B,A01,083980,Staff,3,0,50,47
1649940007456,COGS 115,A01,083982,Staff,14,0,30,16
1649940013483,COGS 118B,A01,083367,Staff,0,11,40,40
1649940019510,COGS 172,A01,083984,Provenzano; Emily Kara,16,0,30,14
1649940025540,COGS 177,A00,083368,Staff,0,17,30,30
1649940031570,COGS 186,A01,083986,Staff,21,0,40,19
1649940037597,COGS 187A,A01,083988,Boyle; Mary E. T.,24,0,60,36
1649940043625,CSE 8A,A50,084003,Miranda; Gregory Joseph,0,0,15,15
1649940049655,CSE 11,A01,084005,Miranda; Gregory Joseph,22,0,55,33
1649940055681,CSE 20,A01,084007,Staff,9,0,20,11
1649940061710,CSE 21,A01,084009,Staff,10,0,50,40
1649940067736,CSE 30,A01,083370,Cao; Yingjun,0,20,40,40
1649940073763,CSE 100,A01,083372,Cao; Yingjun,0,23,40,40
1649940079788,CSE 101,A01,084011,Staff,0,49,40,40
1649940085835,CSE 141,A01,083374,Eldon; John,0,51,75,75
1649940091881,CSE 141L,A01,083376,Eldon; John,0,56,75,75
1649940097908,CSE 175,A01,084013,Kumar; Rakesh,22,0,25,3
1649940103933,CSE 190,A00,092508,Dubnov; Shlomo,15,0,15,0
1649940109960,ECE 5,A01,084049,Morris; Karcher William,15,0,20,5
1649940115986,ECE 100,A01,084051,Baghdadchi; Saharnaz,1,0,20,19
1649940115986,ECE 100,A02,091916,Baghdadchi; Saharnaz,16,0,20,4
1649940122026,ECE 101,A01,084053,Baghdadchi; Saharnaz,5,0,37,32
1649940122026,ECE 101,A02,084054,Baghdadchi; Saharnaz,33,0,37,4
1649940128057,ECE 107,A01,083390,Staff,28,0,40,12
1649940134096,ECE 148,A01,084056,Silberman; Jack,7,0,12,5
1649940140124,ECE 180,A00,083391,Abi Samra; Nicholas Camill,25,0,30,5
1649940140124,ECE 180,B00,083392,Abi Samra; Nicholas Camill,22,0,30,8
1649940146153,MATH 10B,A01,084110,Staff,8,0,30,22
1649940146153,MATH 10B,A02,084111,Staff,29,0,30,1
1649940146153,MATH 10B,A03,084112,Staff,28,0,30,2
1649940152181,MATH 10C,A01,083443,Staff,9,0,30,21
1649940152181,MATH 10C,A02,083444,Staff,16,0,30,14
1649940152181,MATH 10C,B01,084114,Staff,25,0,30,5
1649940152181,MATH 10C,B02,084115,Staff,29,0,30,1
1649940158208,MATH 18,A01,084117,Harel; Guershon,27,0,30,3
1649940158208,MATH 18,A02,084119,Harel; Guershon,29,0,30,1
1649940158208,MATH 18,A03,084120,Harel; Guershon,30,0,30,0
1649940158208,MATH 18,A04,084121,Harel; Guershon,29,0,30,1
1649940164236,MATH 20B,A01,084124,Um; Ko Woon,31,0,35,4
1649940164236,MATH 20B,B01,084126,Um; Ko Woon,32,0,35,3
1649940170262,MATH 20C,A01,083446,Hammock; Frances H,17,0,30,13
1649940170262,MATH 20C,A02,083447,Hammock; Frances H,28,0,30,2
1649940170262,MATH 20C,A03,083448,Hammock; Frances H,30,0,30,0
1649940170262,MATH 20C,A04,083449,Hammock; Frances H,30,0,30,0
1649940170262,MATH 20C,B01,083451,Hammock; Frances H,25,0,30,5
1649940170262,MATH 20C,B02,083452,Hammock; Frances H,27,0,30,3
1649940170262,MATH 20C,B03,083453,Hammock; Frances H,26,0,30,4
1649940170262,MATH 20C,B04,083454,Hammock; Frances H,30,0,30,0
1649940176288,MATH 20D,A01,084128,Staff,26,0,30,4
1649940176288,MATH 20D,A02,084129,Staff,30,0,30,0
1649940176288,MATH 20D,A03,084130,Staff,29,0,30,1
1649940176288,MATH 20D,B01,084133,Staff,21,0,30,9
1649940176288,MATH 20D,B02,084134,Staff,27,0,30,3
1649940176288,MATH 20D,B03,084135,Staff,30,0,30,0
1649940182317,MATH 20E,A01,084138,Staff,22,0,30,8
1649940182317,MATH 20E,A02,084139,Staff,22,0,30,8
1649940182317,MATH 20E,A03,084140,Staff,23,0,30,7
1649940182317,MATH 20E,A04,084141,Staff,25,0,30,5
1649940188352,MATH 102,A01,084143,Harel; Guershon,16,0,30,14
1649940188352,MATH 102,A02,084144,Harel; Guershon,22,0,30,8
1649940194384,MATH 103B,A01,083456,Staff,0,8,30,30
1649940194384,MATH 103B,A02,083457,Staff,0,9,30,30
1649940200412,MATH 109,A01,084146,Salehi Golsefidy; Alireza,28,0,30,2
1649940200412,MATH 109,A02,084147,Salehi Golsefidy; Alireza,22,0,30,8
1649940206442,MATH 120A,A01,085445,Eggers; John Dietrich,20,0,35,15
1649940206442,MATH 120A,A02,085446,Eggers; John Dietrich,28,0,35,7
1649940212467,MATH 142B,A01,084149,Verstraete; Jacques Allan,0,10,30,30
1649940212467,MATH 142B,A02,084150,Verstraete; Jacques Allan,0,9,30,30
1649940218494,MATH 170A,A01,083459,Nie; Jiawang,0,2,30,30
1649940218494,MATH 170A,A02,083460,Nie; Jiawang,0,0,30,30
1649940218494,MATH 170A,A03,083461,Nie; Jiawang,7,0,30,23
1649940224521,MATH 193B,A01,083463,Staff,3,0,30,27
1649940224521,MATH 193B,A02,083464,Staff,10,0,30,20
1649940224521,MATH 193B,A03,083465,Staff,19,0,30,11
1649940230593,COGS 2,A01,083966,Boyle; Mary E. T.,18,0,30,12
1649940236621,COGS 9,A01,083968,Staff,41,0,60,19
1649940242647,COGS 14B,A01,083970,Staff,28,0,50,22
1649940248672,COGS 17,A01,092679,Staff,67,0,75,8
1649940254701,COGS 100,A01,083972,Staff,9,0,60,51
1649940266830,COGS 101C,A01,083976,Staff,19,0,30,11
1649940272861,COGS 102A,A01,083978,Johnson; Christine M.,17,0,30,13
1649940278890,COGS 107B,A01,083980,Staff,3,0,50,47
1649940284921,COGS 115,A01,083982,Staff,14,0,30,16
1649940290946,COGS 118B,A01,083367,Staff,0,11,40,40
1649940296971,COGS 172,A01,083984,Provenzano; Emily Kara,16,0,30,14
1649940303001,COGS 177,A00,083368,Staff,0,17,30,30
1649940309026,COGS 186,A01,083986,Staff,21,0,40,19
1649940315066,COGS 187A,A01,083988,Boyle; Mary E. T.,24,0,60,36
1649940321099,CSE 8A,A50,084003,Miranda; Gregory Joseph,0,0,15,15
1649940327128,CSE 11,A01,084005,Miranda; Gregory Joseph,22,0,55,33
1649940333152,CSE 20,A01,084007,Staff,9,0,20,11
1649940339191,CSE 21,A01,084009,Staff,10,0,50,40
1649940345219,CSE 30,A01,083370,Cao; Yingjun,0,20,40,40
1649940351247,CSE 100,A01,083372,Cao; Yingjun,0,23,40,40
1649940357283,CSE 101,A01,084011,Staff,0,49,40,40
1649940363310,CSE 141,A01,083374,Eldon; John,0,51,75,75
1649940369347,CSE 141L,A01,083376,Eldon; John,0,56,75,75
1649940375372,CSE 175,A01,084013,Kumar; Rakesh,22,0,25,3
1649940381407,CSE 190,A00,092508,Dubnov; Shlomo,15,0,15,0
1649940387452,ECE 5,A01,084049,Morris; Karcher William,15,0,20,5
1649940393479,ECE 100,A01,084051,Baghdadchi; Saharnaz,1,0,20,19
1649940393479,ECE 100,A02,091916,Baghdadchi; Saharnaz,16,0,20,4
1649940399509,ECE 101,A01,084053,Baghdadchi; Saharnaz,5,0,37,32
1649940399509,ECE 101,A02,084054,Baghdadchi; Saharnaz,33,0,37,4
1649940405557,ECE 107,A01,083390,Staff,28,0,40,12
1649940411588,ECE 148,A01,084056,Silberman; Jack,7,0,12,5
1649940417617,ECE 180,A00,083391,Abi Samra; Nicholas Camill,25,0,30,5
1649940417617,ECE 180,B00,083392,Abi Samra; Nicholas Camill,22,0,30,8
1649940423645,MATH 10B,A01,084110,Staff,8,0,30,22
1649940423645,MATH 10B,A02,084111,Staff,29,0,30,1
1649940423645,MATH 10B,A03,084112,Staff,28,0,30,2
1649940429672,MATH 10C,A01,083443,Staff,9,0,30,21
1649940429672,MATH 10C,A02,083444,Staff,16,0,30,14
1649940429672,MATH 10C,B01,084114,Staff,25,0,30,5
1649940429672,MATH 10C,B02,084115,Staff,29,0,30,1
1649940435700,MATH 18,A01,084117,Harel; Guershon,27,0,30,3
1649940435700,MATH 18,A02,084119,Harel; Guershon,29,0,30,1
1649940435700,MATH 18,A03,084120,Harel; Guershon,30,0,30,0
1649940435700,MATH 18,A04,084121,Harel; Guershon,29,0,30,1
1649940441727,MATH 20B,A01,084124,Um; Ko Woon,31,0,35,4
1649940441727,MATH 20B,B01,084126,Um; Ko Woon,32,0,35,3
1649940447766,MATH 20C,A01,083446,Hammock; Frances H,17,0,30,13
1649940447766,MATH 20C,A02,083447,Hammock; Frances H,28,0,30,2
1649940447766,MATH 20C,A03,083448,Hammock; Frances H,30,0,30,0
1649940447766,MATH 20C,A04,083449,Hammock; Frances H,30,0,30,0
1649940447766,MATH 20C,B01,083451,Hammock; Frances H,25,0,30,5
1649940447766,MATH 20C,B02,083452,Hammock; Frances H,27,0,30,3
1649940447766,MATH 20C,B03,083453,Hammock; Frances H,26,0,30,4
1649940447766,MATH 20C,B04,083454,Hammock; Frances H,30,0,30,0
1649940453795,MATH 20D,A01,084128,Staff,26,0,30,4
1649940453795,MATH 20D,A02,084129,Staff,30,0,30,0
1649940453795,MATH 20D,A03,084130,Staff,29,0,30,1
1649940453795,MATH 20D,B01,084133,Staff,21,0,30,9
1649940453795,MATH 20D,B02,084134,Staff,27,0,30,3
1649940453795,MATH 20D,B03,084135,Staff,30,0,30,0
1649940459823,MATH 20E,A01,084138,Staff,22,0,30,8
1649940459823,MATH 20E,A02,084139,Staff,22,0,30,8
1649940459823,MATH 20E,A03,084140,Staff,23,0,30,7
1649940459823,MATH 20E,A04,084141,Staff,25,0,30,5
1649940465851,MATH 102,A01,084143,Harel; Guershon,16,0,30,14
1649940465851,MATH 102,A02,084144,Harel; Guershon,22,0,30,8
1649940471879,MATH 103B,A01,083456,Staff,0,8,30,30
1649940471879,MATH 103B,A02,083457,Staff,0,9,30,30
1649940477908,MATH 109,A01,084146,Salehi Golsefidy; Alireza,28,0,30,2
1649940477908,MATH 109,A02,084147,Salehi Golsefidy; Alireza,22,0,30,8
1649940483944,MATH 120A,A01,085445,Eggers; John Dietrich,20,0,35,15
1649940483944,MATH 120A,A02,085446,Eggers; John Dietrich,28,0,35,7
1649940489973,MATH 142B,A01,084149,Verstraete; Jacques Allan,0,10,30,30
1649940489973,MATH 142B,A02,084150,Verstraete; Jacques Allan,0,9,30,30
1649940496016,MATH 170A,A01,083459,Nie; Jiawang,0,2,30,30
1649940496016,MATH 170A,A02,083460,Nie; Jiawang,0,0,30,30
1649940496016,MATH 170A,A03,083461,Nie; Jiawang,7,0,30,23
1649940502046,MATH 193B,A01,083463,Staff,3,0,30,27
1649940502046,MATH 193B,A02,083464,Staff,10,0,30,20
1649940502046,MATH 193B,A03,083465,Staff,19,0,30,11
1649940508125,COGS 2,A01,083966,Boyle; Mary E. T.,18,0,30,12
1649940514155,COGS 9,A01,083968,Staff,41,0,60,19
1649940520183,COGS 14B,A01,083970,Staff,28,0,50,22
1649940526215,COGS 17,A01,092679,Staff,67,0,75,8
1649940532245,COGS 100,A01,083972,Staff,9,0,60,51
1649940544301,COGS 101C,A01,083976,Staff,19,0,30,11
1649940550338,COGS 102A,A01,083978,Johnson; Christine M.,17,0,30,13
1649940556382,COGS 107B,A01,083980,Staff,3,0,50,47
1649940562410,COGS 115,A01,083982,Staff,14,0,30,16
1649940568441,COGS 118B,A01,083367,Staff,0,11,40,40
1649940574476,COGS 172,A01,083984,Provenzano; Emily Kara,16,0,30,14
1649940580514,COGS 177,A00,083368,Staff,0,17,30,30
1649940586538,COGS 186,A01,083986,Staff,21,0,40,19
1649940592569,COGS 187A,A01,083988,Boyle; Mary E. T.,24,0,60,36
1649940598605,CSE 8A,A50,084003,Miranda; Gregory Joseph,0,0,15,15
1649940604633,CSE 11,A01,084005,Miranda; Gregory Joseph,22,0,55,33
1649940610660,CSE 20,A01,084007,Staff,9,0,20,11
1649940616702,CSE 21,A01,084009,Staff,10,0,50,40
1649940622731,CSE 30,A01,083370,Cao; Yingjun,0,20,40,40
1649940628756,CSE 100,A01,083372,Cao; Yingjun,0,23,40,40
1649940634781,CSE 101,A01,084011,Staff,0,49,40,40
1649940640810,CSE 141,A01,083374,Eldon; John,0,51,75,75
1649940646836,CSE 141L,A01,083376,Eldon; John,0,56,75,75
1649940652864,CSE 175,A01,084013,Kumar; Rakesh,22,0,25,3
1649940658891,CSE 190,A00,092508,Dubnov; Shlomo,15,0,15,0
1649940664918,ECE 5,A01,084049,Morris; Karcher William,15,0,20,5
1649940670949,ECE 100,A01,084051,Baghdadchi; Saharnaz,1,0,20,19
1649940670949,ECE 100,A02,091916,Baghdadchi; Saharnaz,16,0,20,4
1649940676982,ECE 101,A01,084053,Baghdadchi; Saharnaz,5,0,37,32
1649940676982,ECE 101,A02,084054,Baghdadchi; Saharnaz,33,0,37,4
1649940683011,ECE 107,A01,083390,Staff,28,0,40,12
1649940689044,ECE 148,A01,084056,Silberman; Jack,7,0,12,5
1649940695076,ECE 180,A00,083391,Abi Samra; Nicholas Camill,25,0,30,5
1649940695076,ECE 180,B00,083392,Abi Samra; Nicholas Camill,22,0,30,8
1649940701112,MATH 10B,A01,084110,Staff,8,0,30,22
1649940701112,MATH 10B,A02,084111,Staff,29,0,30,1
1649940701112,MATH 10B,A03,084112,Staff,28,0,30,2
1649940707141,MATH 10C,A01,083443,Staff,9,0,30,21
1649940707141,MATH 10C,A02,083444,Staff,16,0,30,14
1649940707141,MATH 10C,B01,084114,Staff,25,0,30,5
1649940707141,MATH 10C,B02,084115,Staff,29,0,30,1
1649940713179,MATH 18,A01,084117,Harel; Guershon,27,0,30,3
1649940713179,MATH 18,A02,084119,Harel; Guershon,29,0,30,1
1649940713179,MATH 18,A03,084120,Harel; Guershon,30,0,30,0
1649940713179,MATH 18,A04,084121,Harel; Guershon,29,0,30,1
1649940719205,MATH 20B,A01,084124,Um; Ko Woon,31,0,35,4
1649940719205,MATH 20B,B01,084126,Um; Ko Woon,32,0,35,3
1649940725241,MATH 20C,A01,083446,Hammock; Frances H,17,0,30,13
1649940725241,MATH 20C,A02,083447,Hammock; Frances H,28,0,30,2
1649940725241,MATH 20C,A03,083448,Hammock; Frances H,30,0,30,0
1649940725241,MATH 20C,A04,083449,Hammock; Frances H,30,0,30,0
1649940725241,MATH 20C,B01,083451,Hammock; Frances H,25,0,30,5
1649940725241,MATH 20C,B02,083452,Hammock; Frances H,27,0,30,3
1649940725241,MATH 20C,B03,083453,Hammock; Frances H,26,0,30,4
1649940725241,MATH 20C,B04,083454,Hammock; Frances H,30,0,30,0
1649940731274,MATH 20D,A01,084128,Staff,26,0,30,4
1649940731274,MATH 20D,A02,084129,Staff,30,0,30,0
1649940731274,MATH 20D,A03,084130,Staff,29,0,30,1
1649940731274,MATH 20D,B01,084133,Staff,21,0,30,9
1649940731274,MATH 20D,B02,084134,Staff,27,0,30,3
1649940731274,MATH 20D,B03,084135,Staff,30,0,30,0
1649940737303,MATH 20E,A01,084138,Staff,22,0,30,8
1649940737303,MATH 20E,A02,084139,Staff,22,0,30,8
1649940737303,MATH 20E,A03,084140,Staff,23,0,30,7
1649940737303,MATH 20E,A04,084141,Staff,25,0,30,5
1649940743332,MATH 102,A01,084143,Harel; Guershon,16,0,30,14
1649940743332,MATH 102,A02,084144,Harel; Guershon,22,0,30,8
1649940749358,MATH 103B,A01,083456,Staff,0,8,30,30
1649940749358,MATH 103B,A02,083457,Staff,0,9,30,30
1649940755386,MATH 109,A01,084146,Salehi Golsefidy; Alireza,28,0,30,2
1649940755386,MATH 109,A02,084147,Salehi Golsefidy; Alireza,22,0,30,8
1649940761415,MATH 120A,A01,085445,Eggers; John Dietrich,20,0,35,15
1649940761415,MATH 120A,A02,085446,Eggers; John Dietrich,28,0,35,7
1649940767447,MATH 142B,A01,084149,Verstraete; Jacques Allan,0,10,30,30
1649940767447,MATH 142B,A02,084150,Verstraete; Jacques Allan,0,9,30,30
1649940773482,MATH 170A,A01,083459,Nie; Jiawang,0,2,30,30
1649940773482,MATH 170A,A02,083460,Nie; Jiawang,0,0,30,30
1649940773482,MATH 170A,A03,083461,Nie; Jiawang,7,0,30,23
1649940779509,MATH 193B,A01,083463,Staff,3,0,30,27
1649940779509,MATH 193B,A02,083464,Staff,10,0,30,20
1649940779509,MATH 193B,A03,083465,Staff,19,0,30,11
1649940785595,COGS 2,A01,083966,Boyle; Mary E. T.,18,0,30,12
1649940791621,COGS 9,A01,083968,Staff,41,0,60,19
1649940797654,COGS 14B,A01,083970,Staff,28,0,50,22
1649940803687,COGS 17,A01,092679,Staff,67,0,75,8
1649940809714,COGS 100,A01,083972,Staff,9,0,60,51
1649940821767,COGS 101C,A01,083976,Staff,19,0,30,11
1649940827796,COGS 102A,A01,083978,Johnson; Christine M.,17,0,30,13
1649940833832,COGS 107B,A01,083980,Staff,3,0,50,47
1649940839858,COGS 115,A01,083982,Staff,14,0,30,16
1649940845885,COGS 118B,A01,083367,Staff,0,11,40,40
1649940851917,COGS 172,A01,083984,Provenzano; Emily Kara,16,0,30,14
1649940858040,COGS 177,A00,083368,Staff,0,17,30,30
1649940864069,COGS 186,A01,083986,Staff,21,0,40,19
1649940870096,COGS 187A,A01,083988,Boyle; Mary E. T.,24,0,60,36
1649940876125,CSE 8A,A50,084003,Miranda; Gregory Joseph,0,0,15,15
1649940882153,CSE 11,A01,084005,Miranda; Gregory Joseph,22,0,55,33
1649940888179,CSE 20,A01,084007,Staff,9,0,20,11
1649940894209,CSE 21,A01,084009,Staff,10,0,50,40
1649940900236,CSE 30,A01,083370,Cao; Yingjun,0,20,40,40
1649940906262,CSE 100,A01,083372,Cao; Yingjun,0,23,40,40
1649940912288,CSE 101,A01,084011,Staff,0,49,40,40
1649940918319,CSE 141,A01,083374,Eldon; John,0,51,75,75
1649940924344,CSE 141L,A01,083376,Eldon; John,0,56,75,75
1649940930370,CSE 175,A01,084013,Kumar; Rakesh,22,0,25,3
1649940936402,CSE 190,A00,092508,Dubnov; Shlomo,15,0,15,0
1649940942441,ECE 5,A01,084049,Morris; Karcher William,15,0,20,5
1649940948477,ECE 100,A01,084051,Baghdadchi; Saharnaz,1,0,20,19
1649940948477,ECE 100,A02,091916,Baghdadchi; Saharnaz,16,0,20,4
1649940954505,ECE 101,A01,084053,Baghdadchi; Saharnaz,5,0,37,32
1649940954505,ECE 101,A02,084054,Baghdadchi; Saharnaz,33,0,37,4
1649940960537,ECE 107,A01,083390,Staff,28,0,40,12
1649940966571,ECE 148,A01,084056,Silberman; Jack,7,0,12,5
1649940972596,ECE 180,A00,083391,Abi Samra; Nicholas Camill,25,0,30,5
1649940972596,ECE 180,B00,083392,Abi Samra; Nicholas Camill,22,0,30,8
1649940978631,MATH 10B,A01,084110,Staff,8,0,30,22
1649940978631,MATH 10B,A02,084111,Staff,29,0,30,1
1649940978631,MATH 10B,A03,084112,Staff,28,0,30,2
1649940984663,MATH 10C,A01,083443,Staff,9,0,30,21
1649940984663,MATH 10C,A02,083444,Staff,16,0,30,14
1649940984663,MATH 10C,B01,084114,Staff,25,0,30,5
1649940984663,MATH 10C,B02,084115,Staff,29,0,30,1
1649940990690,MATH 18,A01,084117,Harel; Guershon,27,0,30,3
1649940990690,MATH 18,A02,084119,Harel; Guershon,29,0,30,1
1649940990690,MATH 18,A03,084120,Harel; Guershon,30,0,30,0
1649940990690,MATH 18,A04,084121,Harel; Guershon,29,0,30,1
1649940996718,MATH 20B,A01,084124,Um; Ko Woon,31,0,35,4
1649940996718,MATH 20B,B01,084126,Um; Ko Woon,32,0,35,3
1649941002754,MATH 20C,A01,083446,Hammock; Frances H,17,0,30,13
1649941002754,MATH 20C,A02,083447,Hammock; Frances H,28,0,30,2
1649941002754,MATH 20C,A03,083448,Hammock; Frances H,30,0,30,0
1649941002754,MATH 20C,A04,083449,Hammock; Frances H,30,0,30,0
1649941002754,MATH 20C,B01,083451,Hammock; Frances H,25,0,30,5
1649941002754,MATH 20C,B02,083452,Hammock; Frances H,27,0,30,3
1649941002754,MATH 20C,B03,083453,Hammock; Frances H,26,0,30,4
1649941002754,MATH 20C,B04,083454,Hammock; Frances H,30,0,30,0
1649941008787,MATH 20D,A01,084128,Staff,26,0,30,4
1649941008787,MATH 20D,A02,084129,Staff,30,0,30,0
1649941008787,MATH 20D,A03,084130,Staff,29,0,30,1
1649941008787,MATH 20D,B01,084133,Staff,21,0,30,9
1649941008787,MATH 20D,B02,084134,Staff,27,0,30,3
1649941008787,MATH 20D,B03,084135,Staff,30,0,30,0
1649941014817,MATH 20E,A01,084138,Staff,22,0,30,8
1649941014817,MATH 20E,A02,084139,Staff,22,0,30,8
1649941014817,MATH 20E,A03,084140,Staff,23,0,30,7
1649941014817,MATH 20E,A04,084141,Staff,25,0,30,5
1649941020845,MATH 102,A01,084143,Harel; Guershon,16,0,30,14
1649941020845,MATH 102,A02,084144,Harel; Guershon,22,0,30,8
1649941026874,MATH 103B,A01,083456,Staff,0,8,30,30
1649941026874,MATH 103B,A02,083457,Staff,0,9,30,30
1649941032902,MATH 109,A01,084146,Salehi Golsefidy; Alireza,28,0,30,2
1649941032902,MATH 109,A02,084147,Salehi Golsefidy; Alireza,22,0,30,8
1649941038935,MATH 120A,A01,085445,Eggers; John Dietrich,20,0,35,15
1649941038935,MATH 120A,A02,085446,Eggers; John Dietrich,28,0,35,7
1649941044966,MATH 142B,A01,084149,Verstraete; Jacques Allan,0,10,30,30
1649941044966,MATH 142B,A02,084150,Verstraete; Jacques Allan,0,9,30,30
1649941051002,MATH 170A,A01,083459,Nie; Jiawang,0,2,30,30
1649941051002,MATH 170A,A02,083460,Nie; Jiawang,0,0,30,30
1649941051002,MATH 170A,A03,083461,Nie; Jiawang,7,0,30,23
1649941057031,MATH 193B,A01,083463,Staff,3,0,30,27
1649941057031,MATH 193B,A02,083464,Staff,10,0,30,20
1649941057031,MATH 193B,A03,083465,Staff,19,0,30,11
1649941063111,COGS 2,A01,083966,Boyle; Mary E. T.,18,0,30,12
1649941069148,COGS 9,A01,083968,Staff,41,0,60,19
1649941075175,COGS 14B,A01,083970,Staff,28,0,50,22
1649941081202,COGS 17,A01,092679,Staff,67,0,75,8
1649941087229,COGS 100,A01,083972,Staff,9,0,60,51
1649941099284,COGS 101C,A01,083976,Staff,19,0,30,11
1649941105325,COGS 102A,A01,083978,Johnson; Christine M.,17,0,30,13
1649941111350,COGS 107B,A01,083980,Staff,3,0,50,47
1649941117379,COGS 115,A01,083982,Staff,14,0,30,16
1649941123405,COGS 118B,A01,083367,Staff,0,11,40,40
1649941129432,COGS 172,A01,083984,Provenzano; Emily Kara,16,0,30,14
1649941135459,COGS 177,A00,083368,Staff,0,17,30,30
1649941141487,COGS 186,A01,083986,Staff,21,0,40,19
1649941147512,COGS 187A,A01,083988,Boyle; Mary E. T.,24,0,60,36
1649941153546,CSE 8A,A50,084003,Miranda; Gregory Joseph,0,0,15,15
1649941159572,CSE 11,A01,084005,Miranda; Gregory Joseph,22,0,55,33
1649941165601,CSE 20,A01,084007,Staff,9,0,20,11
1649941171627,CSE 21,A01,084009,Staff,10,0,50,40
1649941177661,CSE 30,A01,083370,Cao; Yingjun,0,20,40,40
1649941183690,CSE 100,A01,083372,Cao; Yingjun,0,23,40,40
1649941189717,CSE 101,A01,084011,Staff,0,49,40,40
1649941195743,CSE 141,A01,083374,Eldon; John,0,51,75,75
1649941201772,CSE 141L,A01,083376,Eldon; John,0,56,75,75
1649941207806,CSE 175,A01,084013,Kumar; Rakesh,22,0,25,3
1649941213836,CSE 190,A00,092508,Dubnov; Shlomo,15,0,15,0
1649941219867,ECE 5,A01,084049,Morris; Karcher William,15,0,20,5
1649941225901,ECE 100,A01,084051,Baghdadchi; Saharnaz,1,0,20,19
1649941225901,ECE 100,A02,091916,Baghdadchi; Saharnaz,16,0,20,4
1649941231930,ECE 101,A01,084053,Baghdadchi; Saharnaz,5,0,37,32
1649941231930,ECE 101,A02,084054,Baghdadchi; Saharnaz,33,0,37,4
1649941237958,ECE 107,A01,083390,Staff,28,0,40,12
1649941243990,ECE 148,A01,084056,Silberman; Jack,7,0,12,5
1649941250016,ECE 180,A00,083391,Abi Samra; Nicholas Camill,25,0,30,5
1649941250016,ECE 180,B00,083392,Abi Samra; Nicholas Camill,22,0,30,8
1649941256044,MATH 10B,A01,084110,Staff,8,0,30,22
1649941256044,MATH 10B,A02,084111,Staff,29,0,30,1
1649941256044,MATH 10B,A03,084112,Staff,28,0,30,2
1649941262072,MATH 10C,A01,083443,Staff,9,0,30,21
1649941262072,MATH 10C,A02,083444,Staff,16,0,30,14
1649941262072,MATH 10C,B01,084114,Staff,25,0,30,5
1649941262072,MATH 10C,B02,084115,Staff,29,0,30,1
1649941268106,MATH 18,A01,084117,Harel; Guershon,27,0,30,3
1649941268106,MATH 18,A02,084119,Harel; Guershon,29,0,30,1
1649941268106,MATH 18,A03,084120,Harel; Guershon,30,0,30,0
1649941268106,MATH 18,A04,084121,Harel; Guershon,29,0,30,1
1649941274133,MATH 20B,A01,084124,Um; Ko Woon,31,0,35,4
1649941274133,MATH 20B,B01,084126,Um; Ko Woon,32,0,35,3
1649941280162,MATH 20C,A01,083446,Hammock; Frances H,17,0,30,13
1649941280162,MATH 20C,A02,083447,Hammock; Frances H,28,0,30,2
1649941280162,MATH 20C,A03,083448,Hammock; Frances H,30,0,30,0
1649941280162,MATH 20C,A04,083449,Hammock; Frances H,30,0,30,0
1649941280162,MATH 20C,B01,083451,Hammock; Frances H,25,0,30,5
1649941280162,MATH 20C,B02,083452,Hammock; Frances H,27,0,30,3
1649941280162,MATH 20C,B03,083453,Hammock; Frances H,26,0,30,4
1649941280162,MATH 20C,B04,083454,Hammock; Frances H,30,0,30,0
1649941286192,MATH 20D,A01,084128,Staff,26,0,30,4
1649941286192,MATH 20D,A02,084129,Staff,30,0,30,0
1649941286192,MATH 20D,A03,084130,Staff,29,0,30,1
1649941286192,MATH 20D,B01,084133,Staff,21,0,30,9
1649941286192,MATH 20D,B02,084134,Staff,27,0,30,3
1649941286192,MATH 20D,B03,084135,Staff,30,0,30,0
1649941292223,MATH 20E,A01,084138,Staff,22,0,30,8
1649941292223,MATH 20E,A02,084139,Staff,22,0,30,8
1649941292223,MATH 20E,A03,084140,Staff,23,0,30,7
1649941292223,MATH 20E,A04,084141,Staff,25,0,30,5
1649941298250,MATH 102,A01,084143,Harel; Guershon,16,0,30,14
1649941298250,MATH 102,A02,084144,Harel; Guershon,22,0,30,8
1649941304276,MATH 103B,A01,083456,Staff,0,8,30,30
1649941304276,MATH 103B,A02,083457,Staff,0,9,30,30
1649941310308,MATH 109,A01,084146,Salehi Golsefidy; Alireza,28,0,30,2
1649941310308,MATH 109,A02,084147,Salehi Golsefidy; Alireza,22,0,30,8
1649941316340,MATH 120A,A01,085445,Eggers; John Dietrich,20,0,35,15
1649941316340,MATH 120A,A02,085446,Eggers; John Dietrich,28,0,35,7
1649941322371,MATH 142B,A01,084149,Verstraete; Jacques Allan,0,10,30,30
1649941322371,MATH 142B,A02,084150,Verstraete; Jacques Allan,0,9,30,30
1649941328416,MATH 170A,A01,083459,Nie; Jiawang,0,2,30,30
1649941328416,MATH 170A,A02,083460,Nie; Jiawang,0,0,30,30
1649941328416,MATH 170A,A03,083461,Nie; Jiawang,7,0,30,23
1649941334445,MATH 193B,A01,083463,Staff,3,0,30,27
1649941334445,MATH 193B,A02,083464,Staff,10,0,30,20
1649941334445,MATH 193B,A03,083465,Staff,19,0,30,11
1649941340508,COGS 2,A01,083966,Boyle; Mary E. T.,18,0,30,12
1649941346534,COGS 9,A01,083968,Staff,41,0,60,19
1649941352563,COGS 14B,A01,083970,Staff,28,0,50,22
1649941358590,COGS 17,A01,092679,Staff,67,0,75,8
1649941364615,COGS 100,A01,083972,Staff,9,0,60,51
1649941376666,COGS 101C,A01,083976,Staff,19,0,30,11
1649941382692,COGS 102A,A01,083978,Johnson; Christine M.,17,0,30,13
1649941388717,COGS 107B,A01,083980,Staff,3,0,50,47
1649941394747,COGS 115,A01,083982,Staff,14,0,30,16
1649941400772,COGS 118B,A01,083367,Staff,0,11,40,40
1649941406802,COGS 172,A01,083984,Provenzano; Emily Kara,16,0,30,14
1649941412838,COGS 177,A00,083368,Staff,0,17,30,30
1649941418874,COGS 186,A01,083986,Staff,21,0,40,19
1649941424909,COGS 187A,A01,083988,Boyle; Mary E. T.,24,0,60,36
1649941430953,CSE 8A,A50,084003,Miranda; Gregory Joseph,0,0,15,15
1649941436979,CSE 11,A01,084005,Miranda; Gregory Joseph,22,0,55,33
1649941443004,CSE 20,A01,084007,Staff,9,0,20,11
1649941449036,CSE 21,A01,084009,Staff,10,0,50,40
1649941455183,CSE 30,A01,083370,Cao; Yingjun,0,20,40,40
1649941461209,CSE 100,A01,083372,Cao; Yingjun,0,23,40,40
1649941467239,CSE 101,A01,084011,Staff,0,49,40,40
1649941473275,CSE 141,A01,083374,Eldon; John,0,51,75,75
1649941479298,CSE 141L,A01,083376,Eldon; John,0,56,75,75
1649941485323,CSE 175,A01,084013,Kumar; Rakesh,22,0,25,3
1649941491359,CSE 190,A00,092508,Dubnov; Shlomo,15,0,15,0
1649941497391,ECE 5,A01,084049,Morris; Karcher William,15,0,20,5
1649941503433,ECE 100,A01,084051,Baghdadchi; Saharnaz,1,0,20,19
1649941503433,ECE 100,A02,091916,Baghdadchi; Saharnaz,16,0,20,4
1649941509465,ECE 101,A01,084053,Baghdadchi; Saharnaz,5,0,37,32
1649941509465,ECE 101,A02,084054,Baghdadchi; Saharnaz,33,0,37,4
1649941515493,ECE 107,A01,083390,Staff,28,0,40,12
1649941521526,ECE 148,A01,084056,Silberman; Jack,7,0,12,5
1649941527561,ECE 180,A00,083391,Abi Samra; Nicholas Camill,25,0,30,5
1649941527561,ECE 180,B00,083392,Abi Samra; Nicholas Camill,22,0,30,8
1649941533588,MATH 10B,A01,084110,Staff,8,0,30,22
1649941533588,MATH 10B,A02,084111,Staff,29,0,30,1
1649941533588,MATH 10B,A03,084112,Staff,28,0,30,2
1649941539612,MATH 10C,A01,083443,Staff,9,0,30,21
1649941539612,MATH 10C,A02,083444,Staff,16,0,30,14
1649941539612,MATH 10C,B01,084114,Staff,25,0,30,5
1649941539612,MATH 10C,B02,084115,Staff,29,0,30,1
1649941545644,MATH 18,A01,084117,Harel; Guershon,27,0,30,3
1649941545644,MATH 18,A02,084119,Harel; Guershon,29,0,30,1
1649941545644,MATH 18,A03,084120,Harel; Guershon,30,0,30,0
1649941545644,MATH 18,A04,084121,Harel; Guershon,29,0,30,1
1649941551671,MATH 20B,A01,084124,Um; Ko Woon,31,0,35,4
1649941551671,MATH 20B,B01,084126,Um; Ko Woon,32,0,35,3
1649941557695,MATH 20C,A01,083446,Hammock; Frances H,17,0,30,13
1649941557695,MATH 20C,A02,083447,Hammock; Frances H,28,0,30,2
1649941557695,MATH 20C,A03,083448,Hammock; Frances H,30,0,30,0
1649941557695,MATH 20C,A04,083449,Hammock; Frances H,30,0,30,0
1649941557695,MATH 20C,B01,083451,Hammock; Frances H,25,0,30,5
1649941557695,MATH 20C,B02,083452,Hammock; Frances H,27,0,30,3
1649941557695,MATH 20C,B03,083453,Hammock; Frances H,26,0,30,4
1649941557695,MATH 20C,B04,083454,Hammock; Frances H,30,0,30,0
1649941563724,MATH 20D,A01,084128,Staff,26,0,30,4
1649941563724,MATH 20D,A02,084129,Staff,30,0,30,0
1649941563724,MATH 20D,A03,084130,Staff,29,0,30,1
1649941563724,MATH 20D,B01,084133,Staff,21,0,30,9
1649941563724,MATH 20D,B02,084134,Staff,27,0,30,3
1649941563724,MATH 20D,B03,084135,Staff,30,0,30,0
1649941569749,MATH 20E,A01,084138,Staff,22,0,30,8
1649941569749,MATH 20E,A02,084139,Staff,22,0,30,8
1649941569749,MATH 20E,A03,084140,Staff,23,0,30,7
1649941569749,MATH 20E,A04,084141,Staff,25,0,30,5
1649941575780,MATH 102,A01,084143,Harel; Guershon,16,0,30,14
1649941575780,MATH 102,A02,084144,Harel; Guershon,22,0,30,8
1649941581806,MATH 103B,A01,083456,Staff,0,8,30,30
1649941581806,MATH 103B,A02,083457,Staff,0,9,30,30
1649941587832,MATH 109,A01,084146,Salehi Golsefidy; Alireza,28,0,30,2
1649941587832,MATH 109,A02,084147,Salehi Golsefidy; Alireza,22,0,30,8
1649941593860,MATH 120A,A01,085445,Eggers; John Dietrich,20,0,35,15
1649941593860,MATH 120A,A02,085446,Eggers; John Dietrich,28,0,35,7
1649941599893,MATH 142B,A01,084149,Verstraete; Jacques Allan,0,10,30,30
1649941599893,MATH 142B,A02,084150,Verstraete; Jacques Allan,0,9,30,30
1649941605930,MATH 170A,A01,083459,Nie; Jiawang,0,2,30,30
1649941605930,MATH 170A,A02,083460,Nie; Jiawang,0,0,30,30
1649941605930,MATH 170A,A03,083461,Nie; Jiawang,7,0,30,23
1649941611971,MATH 193B,A01,083463,Staff,3,0,30,27
1649941611971,MATH 193B,A02,083464,Staff,10,0,30,20
1649941611971,MATH 193B,A03,083465,Staff,19,0,30,11
1649941618056,COGS 2,A01,083966,Boyle; Mary E. T.,18,0,30,12
1649941624099,COGS 9,A01,083968,Staff,41,0,60,19
1649941630141,COGS 14B,A01,083970,Staff,28,0,50,22
1649941636167,COGS 17,A01,092679,Staff,67,0,75,8
1649941642193,COGS 100,A01,083972,Staff,9,0,60,51
1649941654250,COGS 101C,A01,083976,Staff,19,0,30,11
1649941660279,COGS 102A,A01,083978,Johnson; Christine M.,17,0,30,13
1649941666308,COGS 107B,A01,083980,Staff,3,0,50,47
1649941672339,COGS 115,A01,083982,Staff,14,0,30,16
1649941678369,COGS 118B,A01,083367,Staff,0,11,40,40
1649941684398,COGS 172,A01,083984,Provenzano; Emily Kara,16,0,30,14
1649941690420,COGS 177,A00,083368,Staff,0,17,30,30
1649941696452,COGS 186,A01,083986,Staff,21,0,40,19
1649941702477,COGS 187A,A01,083988,Boyle; Mary E. T.,24,0,60,36
1649941708511,CSE 8A,A50,084003,Miranda; Gregory Joseph,0,0,15,15
1649941714539,CSE 11,A01,084005,Miranda; Gregory Joseph,22,0,55,33
1649941720567,CSE 20,A01,084007,Staff,9,0,20,11
1649941726595,CSE 21,A01,084009,Staff,10,0,50,40
1649941732620,CSE 30,A01,083370,Cao; Yingjun,0,20,40,40
1649941738651,CSE 100,A01,083372,Cao; Yingjun,0,23,40,40
1649941744678,CSE 101,A01,084011,Staff,0,49,40,40
1649941750718,CSE 141,A01,083374,Eldon; John,0,51,75,75
1649941756748,CSE 141L,A01,083376,Eldon; John,0,56,75,75
1649941762777,CSE 175,A01,084013,Kumar; Rakesh,22,0,25,3
1649941768804,CSE 190,A00,092508,Dubnov; Shlomo,15,0,15,0
1649941774838,ECE 5,A01,084049,Morris; Karcher William,15,0,20,5
1649941780867,ECE 100,A01,084051,Baghdadchi; Saharnaz,1,0,20,19
1649941780867,ECE 100,A02,091916,Baghdadchi; Saharnaz,16,0,20,4
1649941786900,ECE 101,A01,084053,Baghdadchi; Saharnaz,5,0,37,32
1649941786900,ECE 101,A02,084054,Baghdadchi; Saharnaz,33,0,37,4
1649941792931,ECE 107,A01,083390,Staff,28,0,40,12
1649941798963,ECE 148,A01,084056,Silberman; Jack,7,0,12,5
1649941804998,ECE 180,A00,083391,Abi Samra; Nicholas Camill,25,0,30,5
1649941804998,ECE 180,B00,083392,Abi Samra; Nicholas Camill,22,0,30,8
1649941811039,MATH 10B,A01,084110,Staff,8,0,30,22
1649941811039,MATH 10B,A02,084111,Staff,29,0,30,1
1649941811039,MATH 10B,A03,084112,Staff,28,0,30,2
1649941817081,MATH 10C,A01,083443,Staff,9,0,30,21
1649941817081,MATH 10C,A02,083444,Staff,16,0,30,14
1649941817081,MATH 10C,B01,084114,Staff,25,0,30,5
1649941817081,MATH 10C,B02,084115,Staff,29,0,30,1
1649941823112,MATH 18,A01,084117,Harel; Guershon,27,0,30,3
1649941823112,MATH 18,A02,084119,Harel; Guershon,29,0,30,1
1649941823112,MATH 18,A03,084120,Harel; Guershon,30,0,30,0
1649941823112,MATH 18,A04,084121,Harel; Guershon,29,0,30,1
1649941829137,MATH 20B,A01,084124,Um; Ko Woon,31,0,35,4
1649941829137,MATH 20B,B01,084126,Um; Ko Woon,32,0,35,3
1649941835169,MATH 20C,A01,083446,Hammock; Frances H,17,0,30,13
1649941835169,MATH 20C,A02,083447,Hammock; Frances H,28,0,30,2
1649941835169,MATH 20C,A03,083448,Hammock; Frances H,30,0,30,0
1649941835169,MATH 20C,A04,083449,Hammock; Frances H,30,0,30,0
1649941835169,MATH 20C,B01,083451,Hammock; Frances H,25,0,30,5
1649941835169,MATH 20C,B02,083452,Hammock; Frances H,27,0,30,3
1649941835169,MATH 20C,B03,083453,Hammock; Frances H,26,0,30,4
1649941835169,MATH 20C,B04,083454,Hammock; Frances H,30,0,30,0
1649941841196,MATH 20D,A01,084128,Staff,26,0,30,4
1649941841196,MATH 20D,A02,084129,Staff,30,0,30,0
1649941841196,MATH 20D,A03,084130,Staff,29,0,30,1
1649941841196,MATH 20D,B01,084133,Staff,21,0,30,9
1649941841196,MATH 20D,B02,084134,Staff,27,0,30,3
1649941841196,MATH 20D,B03,084135,Staff,30,0,30,0
1649941847222,MATH 20E,A01,084138,Staff,22,0,30,8
1649941847222,MATH 20E,A02,084139,Staff,22,0,30,8
1649941847222,MATH 20E,A03,084140,Staff,23,0,30,7
1649941847222,MATH 20E,A04,084141,Staff,25,0,30,5
1649941853248,MATH 102,A01,084143,Harel; Guershon,16,0,30,14
1649941853248,MATH 102,A02,084144,Harel; Guershon,22,0,30,8
1649941859278,MATH 103B,A01,083456,Staff,0,8,30,30
1649941859278,MATH 103B,A02,083457,Staff,0,9,30,30
1649941865320,MATH 109,A01,084146,Salehi Golsefidy; Alireza,28,0,30,2
1649941865320,MATH 109,A02,084147,Salehi Golsefidy; Alireza,22,0,30,8
1649941871352,MATH 120A,A01,085445,Eggers; John Dietrich,20,0,35,15
1649941871352,MATH 120A,A02,085446,Eggers; John Dietrich,28,0,35,7
1649941877380,MATH 142B,A01,084149,Verstraete; Jacques Allan,0,10,30,30
1649941877380,MATH 142B,A02,084150,Verstraete; Jacques Allan,0,9,30,30
1649941883413,MATH 170A,A01,083459,Nie; Jiawang,0,2,30,30
1649941883413,MATH 170A,A02,083460,Nie; Jiawang,0,0,30,30
1649941883413,MATH 170A,A03,083461,Nie; Jiawang,7,0,30,23
1649941889439,MATH 193B,A01,083463,Staff,3,0,30,27
1649941889439,MATH 193B,A02,083464,Staff,10,0,30,20
1649941889439,MATH 193B,A03,083465,Staff,19,0,30,11
1649941895505,COGS 2,A01,083966,Boyle; Mary E. T.,18,0,30,12
1649941901531,COGS 9,A01,083968,Staff,41,0,60,19
1649941907574,COGS 14B,A01,083970,Staff,28,0,50,22
1649941913603,COGS 17,A01,092679,Staff,67,0,75,8
1649941919631,COGS 100,A01,083972,Staff,9,0,60,51
1649941931685,COGS 101C,A01,083976,Staff,19,0,30,11
1649941937721,COGS 102A,A01,083978,Johnson; Christine M.,17,0,30,13
1649941943749,COGS 107B,A01,083980,Staff,3,0,50,47
1649941949773,COGS 115,A01,083982,Staff,14,0,30,16
1649941955804,COGS 118B,A01,083367,Staff,0,11,40,40
1649941961832,COGS 172,A01,083984,Provenzano; Emily Kara,16,0,30,14
1649941967858,COGS 177,A00,083368,Staff,0,17,30,30
1649941973883,COGS 186,A01,083986,Staff,21,0,40,19
1649941979911,COGS 187A,A01,083988,Boyle; Mary E. T.,24,0,60,36
1649941985958,CSE 8A,A50,084003,Miranda; Gregory Joseph,0,0,15,15
1649941992004,CSE 11,A01,084005,Miranda; Gregory Joseph,22,0,55,33
1649941998029,CSE 20,A01,084007,Staff,9,0,20,11
1649942004054,CSE 21,A01,084009,Staff,10,0,50,40
1649942010080,CSE 30,A01,083370,Cao; Yingjun,0,20,40,40
1649942016107,CSE 100,A01,083372,Cao; Yingjun,0,23,40,40
1649942022132,CSE 101,A01,084011,Staff,0,49,40,40
1649942028169,CSE 141,A01,083374,Eldon; John,0,51,75,75
1649942034197,CSE 141L,A01,083376,Eldon; John,0,56,75,75
1649942040225,CSE 175,A01,084013,Kumar; Rakesh,22,0,25,3
1649942046261,CSE 190,A00,092508,Dubnov; Shlomo,15,0,15,0
1649942052377,ECE 5,A01,084049,Morris; Karcher William,15,0,20,5
1649942058407,ECE 100,A01,084051,Baghdadchi; Saharnaz,1,0,20,19
1649942058407,ECE 100,A02,091916,Baghdadchi; Saharnaz,16,0,20,4
1649942064447,ECE 101,A01,084053,Baghdadchi; Saharnaz,5,0,37,32
1649942064447,ECE 101,A02,084054,Baghdadchi; Saharnaz,33,0,37,4
1649942070478,ECE 107,A01,083390,Staff,28,0,40,12
1649942076510,ECE 148,A01,084056,Silberman; Jack,7,0,12,5
1649942082543,ECE 180,A00,083391,Abi Samra; Nicholas Camill,25,0,30,5
1649942082543,ECE 180,B00,083392,Abi Samra; Nicholas Camill,22,0,30,8
1649942088572,MATH 10B,A01,084110,Staff,8,0,30,22
1649942088572,MATH 10B,A02,084111,Staff,29,0,30,1
1649942088572,MATH 10B,A03,084112,Staff,28,0,30,2
1649942094602,MATH 10C,A01,083443,Staff,9,0,30,21
1649942094602,MATH 10C,A02,083444,Staff,16,0,30,14
1649942094602,MATH 10C,B01,084114,Staff,25,0,30,5
1649942094602,MATH 10C,B02,084115,Staff,29,0,30,1
1649942100629,MATH 18,A01,084117,Harel; Guershon,27,0,30,3
1649942100629,MATH 18,A02,084119,Harel; Guershon,29,0,30,1
1649942100629,MATH 18,A03,084120,Harel; Guershon,30,0,30,0
1649942100629,MATH 18,A04,084121,Harel; Guershon,29,0,30,1
1649942106657,MATH 20B,A01,084124,Um; Ko Woon,31,0,35,4
1649942106657,MATH 20B,B01,084126,Um; Ko Woon,32,0,35,3
1649942112685,MATH 20C,A01,083446,Hammock; Frances H,17,0,30,13
1649942112685,MATH 20C,A02,083447,Hammock; Frances H,28,0,30,2
1649942112685,MATH 20C,A03,083448,Hammock; Frances H,30,0,30,0
1649942112685,MATH 20C,A04,083449,Hammock; Frances H,30,0,30,0
1649942112685,MATH 20C,B01,083451,Hammock; Frances H,25,0,30,5
1649942112685,MATH 20C,B02,083452,Hammock; Frances H,27,0,30,3
1649942112685,MATH 20C,B03,083453,Hammock; Frances H,26,0,30,4
1649942112685,MATH 20C,B04,083454,Hammock; Frances H,30,0,30,0
1649942118716,MATH 20D,A01,084128,Staff,26,0,30,4
1649942118716,MATH 20D,A02,084129,Staff,30,0,30,0
1649942118716,MATH 20D,A03,084130,Staff,29,0,30,1
1649942118716,MATH 20D,B01,084133,Staff,21,0,30,9
1649942118716,MATH 20D,B02,084134,Staff,27,0,30,3
1649942118716,MATH 20D,B03,084135,Staff,30,0,30,0
1649942124744,MATH 20E,A01,084138,Staff,22,0,30,8
1649942124744,MATH 20E,A02,084139,Staff,22,0,30,8
1649942124744,MATH 20E,A03,084140,Staff,23,0,30,7
1649942124744,MATH 20E,A04,084141,Staff,25,0,30,5
1649942130775,MATH 102,A01,084143,Harel; Guershon,16,0,30,14
1649942130775,MATH 102,A02,084144,Harel; Guershon,22,0,30,8
1649942136803,MATH 103B,A01,083456,Staff,0,8,30,30
1649942136803,MATH 103B,A02,083457,Staff,0,9,30,30
1649942142850,MATH 109,A01,084146,Salehi Golsefidy; Alireza,28,0,30,2
1649942142850,MATH 109,A02,084147,Salehi Golsefidy; Alireza,22,0,30,8
1649942148876,MATH 120A,A01,085445,Eggers; John Dietrich,20,0,35,15
1649942148876,MATH 120A,A02,085446,Eggers; John Dietrich,28,0,35,7
1649942154902,MATH 142B,A01,084149,Verstraete; Jacques Allan,0,10,30,30
1649942154902,MATH 142B,A02,084150,Verstraete; Jacques Allan,0,9,30,30
1649942160930,MATH 170A,A01,083459,Nie; Jiawang,0,2,30,30
1649942160930,MATH 170A,A02,083460,Nie; Jiawang,0,0,30,30
1649942160930,MATH 170A,A03,083461,Nie; Jiawang,7,0,30,23
1649942166957,MATH 193B,A01,083463,Staff,3,0,30,27
1649942166957,MATH 193B,A02,083464,Staff,10,0,30,20
1649942166957,MATH 193B,A03,083465,Staff,19,0,30,11
1649942173017,COGS 2,A01,083966,Boyle; Mary E. T.,18,0,30,12
1649942179048,COGS 9,A01,083968,Staff,41,0,60,19
1649942185077,COGS 14B,A01,083970,Staff,28,0,50,22
1649942191108,COGS 17,A01,092679,Staff,67,0,75,8
1649942197138,COGS 100,A01,083972,Staff,9,0,60,51
1649942209195,COGS 101C,A01,083976,Staff,19,0,30,11
1649942215220,COGS 102A,A01,083978,Johnson; Christine M.,17,0,30,13
1649942221244,COGS 107B,A01,083980,Staff,3,0,50,47
1649942227279,COGS 115,A01,083982,Staff,14,0,30,16
1649942233308,COGS 118B,A01,083367,Staff,0,11,40,40
1649942239359,COGS 172,A01,083984,Provenzano; Emily Kara,16,0,30,14
1649942245384,COGS 177,A00,083368,Staff,0,17,30,30
1649942251414,COGS 186,A01,083986,Staff,21,0,40,19
1649942257444,COGS 187A,A01,083988,Boyle; Mary E. T.,24,0,60,36
1649942263501,CSE 8A,A50,084003,Miranda; Gregory Joseph,0,0,15,15
1649942269531,CSE 11,A01,084005,Miranda; Gregory Joseph,22,0,55,33
1649942275562,CSE 20,A01,084007,Staff,9,0,20,11
1649942281592,CSE 21,A01,084009,Staff,10,0,50,40
1649942287624,CSE 30,A01,083370,Cao; Yingjun,0,20,40,40
1649942293663,CSE 100,A01,083372,Cao; Yingjun,0,23,40,40
1649942299690,CSE 101,A01,084011,Staff,0,49,40,40
1649942305715,CSE 141,A01,083374,Eldon; John,0,51,75,75
1649942311741,CSE 141L,A01,083376,Eldon; John,0,56,75,75
1649942317768,CSE 175,A01,084013,Kumar; Rakesh,22,0,25,3
1649942323804,CSE 190,A00,092508,Dubnov; Shlomo,15,0,15,0
1649942329847,ECE 5,A01,084049,Morris; Karcher William,15,0,20,5
1649942335873,ECE 100,A01,084051,Baghdadchi; Saharnaz,1,0,20,19
1649942335873,ECE 100,A02,091916,Baghdadchi; Saharnaz,16,0,20,4
1649942341906,ECE 101,A01,084053,Baghdadchi; Saharnaz,5,0,37,32
1649942341906,ECE 101,A02,084054,Baghdadchi; Saharnaz,33,0,37,4
1649942347930,ECE 107,A01,083390,Staff,28,0,40,12
1649942353963,ECE 148,A01,084056,Silberman; Jack,7,0,12,5
1649942359999,ECE 180,A00,083391,Abi Samra; Nicholas Camill,25,0,30,5
1649942359999,ECE 180,B00,083392,Abi Samra; Nicholas Camill,22,0,30,8
1649942366033,MATH 10B,A01,084110,Staff,8,0,30,22
1649942366033,MATH 10B,A02,084111,Staff,29,0,30,1
1649942366033,MATH 10B,A03,084112,Staff,28,0,30,2
1649942372067,MATH 10C,A01,083443,Staff,9,0,30,21
1649942372067,MATH 10C,A02,083444,Staff,16,0,30,14
1649942372067,MATH 10C,B01,084114,Staff,25,0,30,5
1649942372067,MATH 10C,B02,084115,Staff,29,0,30,1
1649942378099,MATH 18,A01,084117,Harel; Guershon,27,0,30,3
1649942378099,MATH 18,A02,084119,Harel; Guershon,29,0,30,1
1649942378099,MATH 18,A03,084120,Harel; Guershon,30,0,30,0
1649942378099,MATH 18,A04,084121,Harel; Guershon,29,0,30,1
1649942384127,MATH 20B,A01,084124,Um; Ko Woon,31,0,35,4
1649942384127,MATH 20B,B01,084126,Um; Ko Woon,32,0,35,3
1649942390153,MATH 20C,A01,083446,Hammock; Frances H,17,0,30,13
1649942390153,MATH 20C,A02,083447,Hammock; Frances H,28,0,30,2
1649942390153,MATH 20C,A03,083448,Hammock; Frances H,30,0,30,0
1649942390153,MATH 20C,A04,083449,Hammock; Frances H,30,0,30,0
1649942390153,MATH 20C,B01,083451,Hammock; Frances H,25,0,30,5
1649942390153,MATH 20C,B02,083452,Hammock; Frances H,27,0,30,3
1649942390153,MATH 20C,B03,083453,Hammock; Frances H,26,0,30,4
1649942390153,MATH 20C,B04,083454,Hammock; Frances H,30,0,30,0
1649942396180,MATH 20D,A01,084128,Staff,26,0,30,4
1649942396180,MATH 20D,A02,084129,Staff,30,0,30,0
1649942396180,MATH 20D,A03,084130,Staff,29,0,30,1
1649942396180,MATH 20D,B01,084133,Staff,21,0,30,9
1649942396180,MATH 20D,B02,084134,Staff,27,0,30,3
1649942396180,MATH 20D,B03,084135,Staff,30,0,30,0
1649942402212,MATH 20E,A01,084138,Staff,22,0,30,8
1649942402212,MATH 20E,A02,084139,Staff,22,0,30,8
1649942402212,MATH 20E,A03,084140,Staff,23,0,30,7
1649942402212,MATH 20E,A04,084141,Staff,25,0,30,5
1649942408240,MATH 102,A01,084143,Harel; Guershon,16,0,30,14
1649942408240,MATH 102,A02,084144,Harel; Guershon,22,0,30,8
1649942414277,MATH 103B,A01,083456,Staff,0,8,30,30
1649942414277,MATH 103B,A02,083457,Staff,0,9,30,30
1649942420309,MATH 109,A01,084146,Salehi Golsefidy; Alireza,28,0,30,2
1649942420309,MATH 109,A02,084147,Salehi Golsefidy; Alireza,22,0,30,8
1649942426340,MATH 120A,A01,085445,Eggers; John Dietrich,20,0,35,15
1649942426340,MATH 120A,A02,085446,Eggers; John Dietrich,28,0,35,7
1649942432366,MATH 142B,A01,084149,Verstraete; Jacques Allan,0,10,30,30
1649942432366,MATH 142B,A02,084150,Verstraete; Jacques Allan,0,9,30,30
1649942438398,MATH 170A,A01,083459,Nie; Jiawang,0,2,30,30
1649942438398,MATH 170A,A02,083460,Nie; Jiawang,0,0,30,30
1649942438398,MATH 170A,A03,083461,Nie; Jiawang,7,0,30,23
1649942444422,MATH 193B,A01,083463,Staff,3,0,30,27
1649942444422,MATH 193B,A02,083464,Staff,10,0,30,20
1649942444422,MATH 193B,A03,083465,Staff,19,0,30,11
1649942450495,COGS 2,A01,083966,Boyle; Mary E. T.,18,0,30,12
1649942456521,COGS 9,A01,083968,Staff,41,0,60,19
1649942462581,COGS 14B,A01,083970,Staff,28,0,50,22
1649942468617,COGS 17,A01,092679,Staff,67,0,75,8
1649942474670,COGS 100,A01,083972,Staff,9,0,60,51
1649942486763,COGS 101C,A01,083976,Staff,19,0,30,11
1649942492814,COGS 102A,A01,083978,Johnson; Christine M.,17,0,30,13
1649942498856,COGS 107B,A01,083980,Staff,3,0,50,47
1649942504894,COGS 115,A01,083982,Staff,14,0,30,16
1649942510928,COGS 118B,A01,083367,Staff,0,11,40,40
1649942516973,COGS 172,A01,083984,Provenzano; Emily Kara,16,0,30,14
1649942523012,COGS 177,A00,083368,Staff,0,17,30,30
1649942529055,COGS 186,A01,083986,Staff,21,0,40,19
1649942535089,COGS 187A,A01,083988,Boyle; Mary E. T.,24,0,60,36
1649942541120,CSE 8A,A50,084003,Miranda; Gregory Joseph,0,0,15,15
1649942547157,CSE 11,A01,084005,Miranda; Gregory Joseph,22,0,55,33
1649942553200,CSE 20,A01,084007,Staff,9,0,20,11
1649942559229,CSE 21,A01,084009,Staff,10,0,50,40
1649942565257,CSE 30,A01,083370,Cao; Yingjun,0,20,40,40
1649942571289,CSE 100,A01,083372,Cao; Yingjun,0,23,40,40
1649942577316,CSE 101,A01,084011,Staff,0,49,40,40
1649942583344,CSE 141,A01,083374,Eldon; John,0,51,75,75
1649942589372,CSE 141L,A01,083376,Eldon; John,0,56,75,75
1649942595401,CSE 175,A01,084013,Kumar; Rakesh,22,0,25,3
1649942601426,CSE 190,A00,092508,Dubnov; Shlomo,15,0,15,0
1649942607453,ECE 5,A01,084049,Morris; Karcher William,15,0,20,5
1649942613481,ECE 100,A01,084051,Baghdadchi; Saharnaz,1,0,20,19
1649942613481,ECE 100,A02,091916,Baghdadchi; Saharnaz,16,0,20,4
1649942619508,ECE 101,A01,084053,Baghdadchi; Saharnaz,5,0,37,32
1649942619508,ECE 101,A02,084054,Baghdadchi; Saharnaz,33,0,37,4
1649942625542,ECE 107,A01,083390,Staff,28,0,40,12
1649942631577,ECE 148,A01,084056,Silberman; Jack,7,0,12,5
1649942637603,ECE 180,A00,083391,Abi Samra; Nicholas Camill,25,0,30,5
1649942637603,ECE 180,B00,083392,Abi Samra; Nicholas Camill,22,0,30,8
1649942643636,MATH 10B,A01,084110,Staff,8,0,30,22
1649942643636,MATH 10B,A02,084111,Staff,29,0,30,1
1649942643636,MATH 10B,A03,084112,Staff,28,0,30,2
1649942649755,MATH 10C,A01,083443,Staff,9,0,30,21
1649942649755,MATH 10C,A02,083444,Staff,16,0,30,14
1649942649755,MATH 10C,B01,084114,Staff,25,0,30,5
1649942649755,MATH 10C,B02,084115,Staff,29,0,30,1
1649942655781,MATH 18,A01,084117,Harel; Guershon,27,0,30,3
1649942655781,MATH 18,A02,084119,Harel; Guershon,29,0,30,1
1649942655781,MATH 18,A03,084120,Harel; Guershon,30,0,30,0
1649942655781,MATH 18,A04,084121,Harel; Guershon,29,0,30,1
1649942661814,MATH 20B,A01,084124,Um; Ko Woon,31,0,35,4
1649942661814,MATH 20B,B01,084126,Um; Ko Woon,32,0,35,3
1649942667840,MATH 20C,A01,083446,Hammock; Frances H,17,0,30,13
1649942667840,MATH 20C,A02,083447,Hammock; Frances H,28,0,30,2
1649942667840,MATH 20C,A03,083448,Hammock; Frances H,30,0,30,0
1649942667840,MATH 20C,A04,083449,Hammock; Frances H,30,0,30,0
1649942667840,MATH 20C,B01,083451,Hammock; Frances H,25,0,30,5
1649942667840,MATH 20C,B02,083452,Hammock; Frances H,27,0,30,3
1649942667840,MATH 20C,B03,083453,Hammock; Frances H,26,0,30,4
1649942667840,MATH 20C,B04,083454,Hammock; Frances H,30,0,30,0
1649942673868,MATH 20D,A01,084128,Staff,26,0,30,4
1649942673868,MATH 20D,A02,084129,Staff,30,0,30,0
1649942673868,MATH 20D,A03,084130,Staff,29,0,30,1
1649942673868,MATH 20D,B01,084133,Staff,21,0,30,9
1649942673868,MATH 20D,B02,084134,Staff,27,0,30,3
1649942673868,MATH 20D,B03,084135,Staff,30,0,30,0
1649942679923,MATH 20E,A01,084138,Staff,22,0,30,8
1649942679923,MATH 20E,A02,084139,Staff,22,0,30,8
1649942679923,MATH 20E,A03,084140,Staff,23,0,30,7
1649942679923,MATH 20E,A04,084141,Staff,25,0,30,5
1649942685947,MATH 102,A01,084143,Harel; Guershon,16,0,30,14
1649942685947,MATH 102,A02,084144,Harel; Guershon,22,0,30,8
1649942691971,MATH 103B,A01,083456,Staff,0,8,30,30
1649942691971,MATH 103B,A02,083457,Staff,0,9,30,30
1649942697997,MATH 109,A01,084146,Salehi Golsefidy; Alireza,28,0,30,2
1649942697997,MATH 109,A02,084147,Salehi Golsefidy; Alireza,22,0,30,8
1649942704023,MATH 120A,A01,085445,Eggers; John Dietrich,20,0,35,15
1649942704023,MATH 120A,A02,085446,Eggers; John Dietrich,28,0,35,7
1649942710054,MATH 142B,A01,084149,Verstraete; Jacques Allan,0,10,30,30
1649942710054,MATH 142B,A02,084150,Verstraete; Jacques Allan,0,9,30,30
1649942716080,MATH 170A,A01,083459,Nie; Jiawang,0,2,30,30
1649942716080,MATH 170A,A02,083460,Nie; Jiawang,0,0,30,30
1649942716080,MATH 170A,A03,083461,Nie; Jiawang,7,0,30,23
1649942722106,MATH 193B,A01,083463,Staff,3,0,30,27
1649942722106,MATH 193B,A02,083464,Staff,10,0,30,20
1649942722106,MATH 193B,A03,083465,Staff,19,0,30,11
1649942728175,COGS 2,A01,083966,Boyle; Mary E. T.,18,0,30,12
1649942734200,COGS 9,A01,083968,Staff,41,0,60,19
1649942740230,COGS 14B,A01,083970,Staff,28,0,50,22
1649942746262,COGS 17,A01,092679,Staff,67,0,75,8
1649942752287,COGS 100,A01,083972,Staff,9,0,60,51
1649942764345,COGS 101C,A01,083976,Staff,19,0,30,11
1649942770374,COGS 102A,A01,083978,Johnson; Christine M.,17,0,30,13
1649942776403,COGS 107B,A01,083980,Staff,3,0,50,47
1649942782428,COGS 115,A01,083982,Staff,14,0,30,16
1649942788460,COGS 118B,A01,083367,Staff,0,11,40,40
1649942794487,COGS 172,A01,083984,Provenzano; Emily Kara,16,0,30,14
1649942800514,COGS 177,A00,083368,Staff,0,17,30,30
1649942806543,COGS 186,A01,083986,Staff,21,0,40,19
1649942812570,COGS 187A,A01,083988,Boyle; Mary E. T.,24,0,60,36
1649942818608,CSE 8A,A50,084003,Miranda; Gregory Joseph,0,0,15,15
1649942824634,CSE 11,A01,084005,Miranda; Gregory Joseph,22,0,55,33
1649942830660,CSE 20,A01,084007,Staff,9,0,20,11
1649942836703,CSE 21,A01,084009,Staff,10,0,50,40
1649942842733,CSE 30,A01,083370,Cao; Yingjun,0,20,40,40
1649942848758,CSE 100,A01,083372,Cao; Yingjun,0,23,40,40
1649942854788,CSE 101,A01,084011,Staff,0,49,40,40
1649942860818,CSE 141,A01,083374,Eldon; John,0,51,75,75
1649942866847,CSE 141L,A01,083376,Eldon; John,0,56,75,75
1649942872874,CSE 175,A01,084013,Kumar; Rakesh,22,0,25,3
1649942878904,CSE 190,A00,092508,Dubnov; Shlomo,15,0,15,0
1649942884932,ECE 5,A01,084049,Morris; Karcher William,15,0,20,5
1649942890970,ECE 100,A01,084051,Baghdadchi; Saharnaz,1,0,20,19
1649942890970,ECE 100,A02,091916,Baghdadchi; Saharnaz,16,0,20,4
1649942897002,ECE 101,A01,084053,Baghdadchi; Saharnaz,5,0,37,32
1649942897002,ECE 101,A02,084054,Baghdadchi; Saharnaz,33,0,37,4
1649942903031,ECE 107,A01,083390,Staff,28,0,40,12
1649942909076,ECE 148,A01,084056,Silberman; Jack,7,0,12,5
1649942915101,ECE 180,A00,083391,Abi Samra; Nicholas Camill,25,0,30,5
1649942915101,ECE 180,B00,083392,Abi Samra; Nicholas Camill,22,0,30,8
1649942921129,MATH 10B,A01,084110,Staff,8,0,30,22
1649942921129,MATH 10B,A02,084111,Staff,29,0,30,1
1649942921129,MATH 10B,A03,084112,Staff,28,0,30,2
1649942927163,MATH 10C,A01,083443,Staff,9,0,30,21
1649942927163,MATH 10C,A02,083444,Staff,16,0,30,14
1649942927163,MATH 10C,B01,084114,Staff,25,0,30,5
1649942927163,MATH 10C,B02,084115,Staff,29,0,30,1
1649942933191,MATH 18,A01,084117,Harel; Guershon,27,0,30,3
1649942933191,MATH 18,A02,084119,Harel; Guershon,29,0,30,1
1649942933191,MATH 18,A03,084120,Harel; Guershon,30,0,30,0
1649942933191,MATH 18,A04,084121,Harel; Guershon,29,0,30,1
1649942939231,MATH 20B,A01,084124,Um; Ko Woon,31,0,35,4
1649942939231,MATH 20B,B01,084126,Um; Ko Woon,32,0,35,3
1649942945258,MATH 20C,A01,083446,Hammock; Frances H,17,0,30,13
1649942945258,MATH 20C,A02,083447,Hammock; Frances H,28,0,30,2
1649942945258,MATH 20C,A03,083448,Hammock; Frances H,30,0,30,0
1649942945258,MATH 20C,A04,083449,Hammock; Frances H,30,0,30,0
1649942945258,MATH 20C,B01,083451,Hammock; Frances H,25,0,30,5
1649942945258,MATH 20C,B02,083452,Hammock; Frances H,27,0,30,3
1649942945258,MATH 20C,B03,083453,Hammock; Frances H,26,0,30,4
1649942945258,MATH 20C,B04,083454,Hammock; Frances H,30,0,30,0
1649942951286,MATH 20D,A01,084128,Staff,26,0,30,4
1649942951286,MATH 20D,A02,084129,Staff,30,0,30,0
1649942951286,MATH 20D,A03,084130,Staff,29,0,30,1
1649942951286,MATH 20D,B01,084133,Staff,21,0,30,9
1649942951286,MATH 20D,B02,084134,Staff,27,0,30,3
1649942951286,MATH 20D,B03,084135,Staff,30,0,30,0
1649942957326,MATH 20E,A01,084138,Staff,22,0,30,8
1649942957326,MATH 20E,A02,084139,Staff,22,0,30,8
1649942957326,MATH 20E,A03,084140,Staff,23,0,30,7
1649942957326,MATH 20E,A04,084141,Staff,25,0,30,5
1649942963351,MATH 102,A01,084143,Harel; Guershon,16,0,30,14
1649942963351,MATH 102,A02,084144,Harel; Guershon,22,0,30,8
1649942969378,MATH 103B,A01,083456,Staff,0,8,30,30
1649942969378,MATH 103B,A02,083457,Staff,0,9,30,30
1649942975409,MATH 109,A01,084146,Salehi Golsefidy; Alireza,28,0,30,2
1649942975409,MATH 109,A02,084147,Salehi Golsefidy; Alireza,22,0,30,8
1649942981443,MATH 120A,A01,085445,Eggers; John Dietrich,20,0,35,15
1649942981443,MATH 120A,A02,085446,Eggers; John Dietrich,28,0,35,7
1649942987471,MATH 142B,A01,084149,Verstraete; Jacques Allan,0,10,30,30
1649942987471,MATH 142B,A02,084150,Verstraete; Jacques Allan,0,9,30,30
1649942993502,MATH 170A,A01,083459,Nie; Jiawang,0,2,30,30
1649942993502,MATH 170A,A02,083460,Nie; Jiawang,0,0,30,30
1649942993502,MATH 170A,A03,083461,Nie; Jiawang,7,0,30,23
1649942999531,MATH 193B,A01,083463,Staff,3,0,30,27
1649942999531,MATH 193B,A02,083464,Staff,10,0,30,20
1649942999531,MATH 193B,A03,083465,Staff,19,0,30,11
1649943005620,COGS 2,A01,083966,Boyle; Mary E. T.,18,0,30,12
1649943011646,COGS 9,A01,083968,Staff,41,0,60,19
1649943017671,COGS 14B,A01,083970,Staff,28,0,50,22
1649943023704,COGS 17,A01,092679,Staff,67,0,75,8
1649943029749,COGS 100,A01,083972,Staff,9,0,60,51
1649943041798,COGS 101C,A01,083976,Staff,19,0,30,11
1649943047830,COGS 102A,A01,083978,Johnson; Christine M.,17,0,30,13
1649943053854,COGS 107B,A01,083980,Staff,3,0,50,47
1649943059880,COGS 115,A01,083982,Staff,14,0,30,16
1649943065913,COGS 118B,A01,083367,Staff,0,11,40,40
1649943071939,COGS 172,A01,083984,Provenzano; Emily Kara,16,0,30,14
1649943077963,COGS 177,A00,083368,Staff,0,17,30,30
1649943083994,COGS 186,A01,083986,Staff,21,0,40,19
1649943090023,COGS 187A,A01,083988,Boyle; Mary E. T.,24,0,60,36
1649943096054,CSE 8A,A50,084003,Miranda; Gregory Joseph,0,0,15,15
1649943102078,CSE 11,A01,084005,Miranda; Gregory Joseph,22,0,55,33
1649943108108,CSE 20,A01,084007,Staff,9,0,20,11
1649943114140,CSE 21,A01,084009,Staff,10,0,50,40
1649943120165,CSE 30,A01,083370,Cao; Yingjun,0,20,40,40
1649943126191,CSE 100,A01,083372,Cao; Yingjun,0,23,40,40
1649943132213,CSE 101,A01,084011,Staff,0,49,40,40
1649943138239,CSE 141,A01,083374,Eldon; John,0,51,75,75
1649943144265,CSE 141L,A01,083376,Eldon; John,0,56,75,75
1649943150292,CSE 175,A01,084013,Kumar; Rakesh,22,0,25,3
1649943156319,CSE 190,A00,092508,Dubnov; Shlomo,15,0,15,0
1649943162351,ECE 5,A01,084049,Morris; Karcher William,15,0,20,5
1649943168385,ECE 100,A01,084051,Baghdadchi; Saharnaz,1,0,20,19
1649943168385,ECE 100,A02,091916,Baghdadchi; Saharnaz,16,0,20,4
1649943174412,ECE 101,A01,084053,Baghdadchi; Saharnaz,5,0,37,32
1649943174412,ECE 101,A02,084054,Baghdadchi; Saharnaz,33,0,37,4
1649943180451,ECE 107,A01,083390,Staff,28,0,40,12
1649943186485,ECE 148,A01,084056,Silberman; Jack,7,0,12,5
1649943192520,ECE 180,A00,083391,Abi Samra; Nicholas Camill,25,0,30,5
1649943192520,ECE 180,B00,083392,Abi Samra; Nicholas Camill,22,0,30,8
1649943198550,MATH 10B,A01,084110,Staff,8,0,30,22
1649943198550,MATH 10B,A02,084111,Staff,29,0,30,1
1649943198550,MATH 10B,A03,084112,Staff,28,0,30,2
1649943204577,MATH 10C,A01,083443,Staff,9,0,30,21
1649943204577,MATH 10C,A02,083444,Staff,16,0,30,14
1649943204577,MATH 10C,B01,084114,Staff,25,0,30,5
1649943204577,MATH 10C,B02,084115,Staff,29,0,30,1
1649943210603,MATH 18,A01,084117,Harel; Guershon,27,0,30,3
1649943210603,MATH 18,A02,084119,Harel; Guershon,29,0,30,1
1649943210603,MATH 18,A03,084120,Harel; Guershon,30,0,30,0
1649943210603,MATH 18,A04,084121,Harel; Guershon,29,0,30,1
1649943216637,MATH 20B,A01,084124,Um; Ko Woon,31,0,35,4
1649943216637,MATH 20B,B01,084126,Um; Ko Woon,32,0,35,3
1649943222672,MATH 20C,A01,083446,Hammock; Frances H,17,0,30,13
1649943222672,MATH 20C,A02,083447,Hammock; Frances H,28,0,30,2
1649943222672,MATH 20C,A03,083448,Hammock; Frances H,30,0,30,0
1649943222672,MATH 20C,A04,083449,Hammock; Frances H,30,0,30,0
1649943222672,MATH 20C,B01,083451,Hammock; Frances H,25,0,30,5
1649943222672,MATH 20C,B02,083452,Hammock; Frances H,27,0,30,3
1649943222672,MATH 20C,B03,083453,Hammock; Frances H,26,0,30,4
1649943222672,MATH 20C,B04,083454,Hammock; Frances H,30,0,30,0
1649943228698,MATH 20D,A01,084128,Staff,26,0,30,4
1649943228698,MATH 20D,A02,084129,Staff,30,0,30,0
1649943228698,MATH 20D,A03,084130,Staff,29,0,30,1
1649943228698,MATH 20D,B01,084133,Staff,21,0,30,9
1649943228698,MATH 20D,B02,084134,Staff,27,0,30,3
1649943228698,MATH 20D,B03,084135,Staff,30,0,30,0
1649943234728,MATH 20E,A01,084138,Staff,22,0,30,8
1649943234728,MATH 20E,A02,084139,Staff,22,0,30,8
1649943234728,MATH 20E,A03,084140,Staff,23,0,30,7
1649943234728,MATH 20E,A04,084141,Staff,25,0,30,5
1649943240754,MATH 102,A01,084143,Harel; Guershon,16,0,30,14
1649943240754,MATH 102,A02,084144,Harel; Guershon,22,0,30,8
1649943246871,MATH 103B,A01,083456,Staff,0,8,30,30
1649943246871,MATH 103B,A02,083457,Staff,0,9,30,30
1649943252899,MATH 109,A01,084146,Salehi Golsefidy; Alireza,28,0,30,2
1649943252899,MATH 109,A02,084147,Salehi Golsefidy; Alireza,22,0,30,8
1649943258932,MATH 120A,A01,085445,Eggers; John Dietrich,20,0,35,15
1649943258932,MATH 120A,A02,085446,Eggers; John Dietrich,28,0,35,7
1649943264957,MATH 142B,A01,084149,Verstraete; Jacques Allan,0,10,30,30
1649943264957,MATH 142B,A02,084150,Verstraete; Jacques Allan,0,9,30,30
1649943270986,MATH 170A,A01,083459,Nie; Jiawang,0,2,30,30
1649943270986,MATH 170A,A02,083460,Nie; Jiawang,0,0,30,30
1649943270986,MATH 170A,A03,083461,Nie; Jiawang,7,0,30,23
1649943277012,MATH 193B,A01,083463,Staff,3,0,30,27
1649943277012,MATH 193B,A02,083464,Staff,10,0,30,20
1649943277012,MATH 193B,A03,083465,Staff,19,0,30,11
1649943283111,COGS 2,A01,083966,Boyle; Mary E. T.,18,0,30,12
1649943289137,COGS 9,A01,083968,Staff,41,0,60,19
1649943295168,COGS 14B,A01,083970,Staff,28,0,50,22
1649943301196,COGS 17,A01,092679,Staff,67,0,75,8
1649943307223,COGS 100,A01,083972,Staff,9,0,60,51
1649943319280,COGS 101C,A01,083976,Staff,19,0,30,11
1649943325311,COGS 102A,A01,083978,Johnson; Christine M.,17,0,30,13
1649943331344,COGS 107B,A01,083980,Staff,3,0,50,47
1649943337374,COGS 115,A01,083982,Staff,14,0,30,16
1649943343399,COGS 118B,A01,083367,Staff,0,11,40,40
1649943349429,COGS 172,A01,083984,Provenzano; Emily Kara,16,0,30,14
1649943355457,COGS 177,A00,083368,Staff,0,17,30,30
1649943361484,COGS 186,A01,083986,Staff,21,0,40,19
1649943367509,COGS 187A,A01,083988,Boyle; Mary E. T.,24,0,60,36
1649943373539,CSE 8A,A50,084003,Miranda; Gregory Joseph,0,0,15,15
1649943379569,CSE 11,A01,084005,Miranda; Gregory Joseph,22,0,55,33
1649943385599,CSE 20,A01,084007,Staff,9,0,20,11
1649943391625,CSE 21,A01,084009,Staff,10,0,50,40
1649943397655,CSE 30,A01,083370,Cao; Yingjun,0,20,40,40
1649943403682,CSE 100,A01,083372,Cao; Yingjun,0,23,40,40
1649943409722,CSE 101,A01,084011,Staff,0,49,40,40
1649943415749,CSE 141,A01,083374,Eldon; John,0,51,75,75
1649943421781,CSE 141L,A01,083376,Eldon; John,0,56,75,75
1649943427807,CSE 175,A01,084013,Kumar; Rakesh,22,0,25,3
1649943433834,CSE 190,A00,092508,Dubnov; Shlomo,15,0,15,0
1649943439867,ECE 5,A01,084049,Morris; Karcher William,15,0,20,5
1649943445892,ECE 100,A01,084051,Baghdadchi; Saharnaz,1,0,20,19
1649943445892,ECE 100,A02,091916,Baghdadchi; Saharnaz,16,0,20,4
1649943451922,ECE 101,A01,084053,Baghdadchi; Saharnaz,5,0,37,32
1649943451922,ECE 101,A02,084054,Baghdadchi; Saharnaz,33,0,37,4
1649943457960,ECE 107,A01,083390,Staff,28,0,40,12
1649943463991,ECE 148,A01,084056,Silberman; Jack,7,0,12,5
1649943470021,ECE 180,A00,083391,Abi Samra; Nicholas Camill,25,0,30,5
1649943470021,ECE 180,B00,083392,Abi Samra; Nicholas Camill,22,0,30,8
1649943476054,MATH 10B,A01,084110,Staff,8,0,30,22
1649943476054,MATH 10B,A02,084111,Staff,29,0,30,1
1649943476054,MATH 10B,A03,084112,Staff,28,0,30,2
1649943482082,MATH 10C,A01,083443,Staff,9,0,30,21
1649943482082,MATH 10C,A02,083444,Staff,16,0,30,14
1649943482082,MATH 10C,B01,084114,Staff,25,0,30,5
1649943482082,MATH 10C,B02,084115,Staff,29,0,30,1
1649943488107,MATH 18,A01,084117,Harel; Guershon,27,0,30,3
1649943488107,MATH 18,A02,084119,Harel; Guershon,29,0,30,1
1649943488107,MATH 18,A03,084120,Harel; Guershon,30,0,30,0
1649943488107,MATH 18,A04,084121,Harel; Guershon,29,0,30,1
1649943494132,MATH 20B,A01,084124,Um; Ko Woon,31,0,35,4
1649943494132,MATH 20B,B01,084126,Um; Ko Woon,32,0,35,3
1649943500162,MATH 20C,A01,083446,Hammock; Frances H,17,0,30,13
1649943500162,MATH 20C,A02,083447,Hammock; Frances H,28,0,30,2
1649943500162,MATH 20C,A03,083448,Hammock; Frances H,30,0,30,0
1649943500162,MATH 20C,A04,083449,Hammock; Frances H,30,0,30,0
1649943500162,MATH 20C,B01,083451,Hammock; Frances H,25,0,30,5
1649943500162,MATH 20C,B02,083452,Hammock; Frances H,27,0,30,3
1649943500162,MATH 20C,B03,083453,Hammock; Frances H,26,0,30,4
1649943500162,MATH 20C,B04,083454,Hammock; Frances H,30,0,30,0
1649943506191,MATH 20D,A01,084128,Staff,26,0,30,4
1649943506191,MATH 20D,A02,084129,Staff,30,0,30,0
1649943506191,MATH 20D,A03,084130,Staff,29,0,30,1
1649943506191,MATH 20D,B01,084133,Staff,21,0,30,9
1649943506191,MATH 20D,B02,084134,Staff,27,0,30,3
1649943506191,MATH 20D,B03,084135,Staff,30,0,30,0
1649943512235,MATH 20E,A01,084138,Staff,22,0,30,8
1649943512235,MATH 20E,A02,084139,Staff,22,0,30,8
1649943512235,MATH 20E,A03,084140,Staff,23,0,30,7
1649943512235,MATH 20E,A04,084141,Staff,25,0,30,5
1649943518266,MATH 102,A01,084143,Harel; Guershon,16,0,30,14
1649943518266,MATH 102,A02,084144,Harel; Guershon,22,0,30,8
1649943524293,MATH 103B,A01,083456,Staff,0,8,30,30
1649943524293,MATH 103B,A02,083457,Staff,0,9,30,30
1649943530324,MATH 109,A01,084146,Salehi Golsefidy; Alireza,28,0,30,2
1649943530324,MATH 109,A02,084147,Salehi Golsefidy; Alireza,22,0,30,8
1649943536354,MATH 120A,A01,085445,Eggers; John Dietrich,20,0,35,15
1649943536354,MATH 120A,A02,085446,Eggers; John Dietrich,28,0,35,7
1649943542381,MATH 142B,A01,084149,Verstraete; Jacques Allan,0,10,30,30
1649943542381,MATH 142B,A02,084150,Verstraete; Jacques Allan,0,9,30,30
1649943548414,MATH 170A,A01,083459,Nie; Jiawang,0,2,30,30
1649943548414,MATH 170A,A02,083460,Nie; Jiawang,0,0,30,30
1649943548414,MATH 170A,A03,083461,Nie; Jiawang,7,0,30,23
1649943554447,MATH 193B,A01,083463,Staff,3,0,30,27
1649943554447,MATH 193B,A02,083464,Staff,10,0,30,20
1649943554447,MATH 193B,A03,083465,Staff,19,0,30,11
1649943560500,COGS 2,A01,083966,Boyle; Mary E. T.,18,0,30,12
1649943566531,COGS 9,A01,083968,Staff,41,0,60,19
1649943572568,COGS 14B,A01,083970,Staff,28,0,50,22
1649943578593,COGS 17,A01,092679,Staff,67,0,75,8
1649943584616,COGS 100,A01,083972,Staff,9,0,60,51
1649943596673,COGS 101C,A01,083976,Staff,19,0,30,11
1649943602704,COGS 102A,A01,083978,Johnson; Christine M.,17,0,30,13
1649943608728,COGS 107B,A01,083980,Staff,3,0,50,47
1649943614757,COGS 115,A01,083982,Staff,14,0,30,16
1649943620782,COGS 118B,A01,083367,Staff,0,11,40,40
1649943626814,COGS 172,A01,083984,Provenzano; Emily Kara,16,0,30,14
1649943632840,COGS 177,A00,083368,Staff,0,17,30,30
1649943638865,COGS 186,A01,083986,Staff,21,0,40,19
1649943644890,COGS 187A,A01,083988,Boyle; Mary E. T.,24,0,60,36
1649943650924,CSE 8A,A50,084003,Miranda; Gregory Joseph,0,0,15,15
1649943656953,CSE 11,A01,084005,Miranda; Gregory Joseph,22,0,55,33
1649943662987,CSE 20,A01,084007,Staff,9,0,20,11
1649943669013,CSE 21,A01,084009,Staff,10,0,50,40
1649943675040,CSE 30,A01,083370,Cao; Yingjun,0,20,40,40
1649943681065,CSE 100,A01,083372,Cao; Yingjun,0,23,40,40
1649943687093,CSE 101,A01,084011,Staff,0,49,40,40
1649943693120,CSE 141,A01,083374,Eldon; John,0,51,75,75
1649943699153,CSE 141L,A01,083376,Eldon; John,0,56,75,75
1649943705181,CSE 175,A01,084013,Kumar; Rakesh,22,0,25,3
1649943711206,CSE 190,A00,092508,Dubnov; Shlomo,15,0,15,0
1649943717249,ECE 5,A01,084049,Morris; Karcher William,15,0,20,5
1649943723274,ECE 100,A01,084051,Baghdadchi; Saharnaz,1,0,20,19
1649943723274,ECE 100,A02,091916,Baghdadchi; Saharnaz,16,0,20,4
1649943729304,ECE 101,A01,084053,Baghdadchi; Saharnaz,5,0,37,32
1649943729304,ECE 101,A02,084054,Baghdadchi; Saharnaz,33,0,37,4
1649943735331,ECE 107,A01,083390,Staff,28,0,40,12
1649943741360,ECE 148,A01,084056,Silberman; Jack,7,0,12,5
1649943747385,ECE 180,A00,083391,Abi Samra; Nicholas Camill,25,0,30,5
1649943747385,ECE 180,B00,083392,Abi Samra; Nicholas Camill,22,0,30,8
1649943753409,MATH 10B,A01,084110,Staff,8,0,30,22
1649943753409,MATH 10B,A02,084111,Staff,29,0,30,1
1649943753409,MATH 10B,A03,084112,Staff,28,0,30,2
1649943759433,MATH 10C,A01,083443,Staff,9,0,30,21
1649943759433,MATH 10C,A02,083444,Staff,16,0,30,14
1649943759433,MATH 10C,B01,084114,Staff,25,0,30,5
1649943759433,MATH 10C,B02,084115,Staff,29,0,30,1
1649943765461,MATH 18,A01,084117,Harel; Guershon,27,0,30,3
1649943765461,MATH 18,A02,084119,Harel; Guershon,29,0,30,1
1649943765461,MATH 18,A03,084120,Harel; Guershon,30,0,30,0
1649943765461,MATH 18,A04,084121,Harel; Guershon,29,0,30,1
1649943771489,MATH 20B,A01,084124,Um; Ko Woon,31,0,35,4
1649943771489,MATH 20B,B01,084126,Um; Ko Woon,32,0,35,3
1649943777523,MATH 20C,A01,083446,Hammock; Frances H,17,0,30,13
1649943777523,MATH 20C,A02,083447,Hammock; Frances H,28,0,30,2
1649943777523,MATH 20C,A03,083448,Hammock; Frances H,30,0,30,0
1649943777523,MATH 20C,A04,083449,Hammock; Frances H,30,0,30,0
1649943777523,MATH 20C,B01,083451,Hammock; Frances H,25,0,30,5
1649943777523,MATH 20C,B02,083452,Hammock; Frances H,27,0,30,3
1649943777523,MATH 20C,B03,083453,Hammock; Frances H,26,0,30,4
1649943777523,MATH 20C,B04,083454,Hammock; Frances H,30,0,30,0
1649943783548,MATH 20D,A01,084128,Staff,26,0,30,4
1649943783548,MATH 20D,A02,084129,Staff,30,0,30,0
1649943783548,MATH 20D,A03,084130,Staff,29,0,30,1
1649943783548,MATH 20D,B01,084133,Staff,21,0,30,9
1649943783548,MATH 20D,B02,084134,Staff,27,0,30,3
1649943783548,MATH 20D,B03,084135,Staff,30,0,30,0
1649943789574,MATH 20E,A01,084138,Staff,22,0,30,8
1649943789574,MATH 20E,A02,084139,Staff,22,0,30,8
1649943789574,MATH 20E,A03,084140,Staff,23,0,30,7
1649943789574,MATH 20E,A04,084141,Staff,25,0,30,5
1649943795601,MATH 102,A01,084143,Harel; Guershon,16,0,30,14
1649943795601,MATH 102,A02,084144,Harel; Guershon,22,0,30,8
1649943801630,MATH 103B,A01,083456,Staff,0,8,30,30
1649943801630,MATH 103B,A02,083457,Staff,0,9,30,30
1649943807662,MATH 109,A01,084146,Salehi Golsefidy; Alireza,28,0,30,2
1649943807662,MATH 109,A02,084147,Salehi Golsefidy; Alireza,22,0,30,8
1649943813693,MATH 120A,A01,085445,Eggers; John Dietrich,20,0,35,15
1649943813693,MATH 120A,A02,085446,Eggers; John Dietrich,28,0,35,7
1649943819718,MATH 142B,A01,084149,Verstraete; Jacques Allan,0,10,30,30
1649943819718,MATH 142B,A02,084150,Verstraete; Jacques Allan,0,9,30,30
1649943825751,MATH 170A,A01,083459,Nie; Jiawang,0,2,30,30
1649943825751,MATH 170A,A02,083460,Nie; Jiawang,0,0,30,30
1649943825751,MATH 170A,A03,083461,Nie; Jiawang,7,0,30,23
1649943831776,MATH 193B,A01,083463,Staff,3,0,30,27
1649943831776,MATH 193B,A02,083464,Staff,10,0,30,20
1649943831776,MATH 193B,A03,083465,Staff,19,0,30,11
1649943837937,COGS 2,A01,083966,Boyle; Mary E. T.,18,0,30,12
1649943843961,COGS 9,A01,083968,Staff,41,0,60,19
1649943849987,COGS 14B,A01,083970,Staff,28,0,50,22
1649943856020,COGS 17,A01,092679,Staff,67,0,75,8
1649943862045,COGS 100,A01,083972,Staff,9,0,60,51
1649943874094,COGS 101C,A01,083976,Staff,19,0,30,11
1649943880126,COGS 102A,A01,083978,Johnson; Christine M.,17,0,30,13
1649943886151,COGS 107B,A01,083980,Staff,3,0,50,47
1649943892175,COGS 115,A01,083982,Staff,14,0,30,16
1649943898200,COGS 118B,A01,083367,Staff,0,11,40,40
1649943904229,COGS 172,A01,083984,Provenzano; Emily Kara,16,0,30,14
1649943910266,COGS 177,A00,083368,Staff,0,17,30,30
1649943916290,COGS 186,A01,083986,Staff,21,0,40,19
1649943922320,COGS 187A,A01,083988,Boyle; Mary E. T.,24,0,60,36
1649943928347,CSE 8A,A50,084003,Miranda; Gregory Joseph,0,0,15,15
1649943934373,CSE 11,A01,084005,Miranda; Gregory Joseph,22,0,55,33
1649943940399,CSE 20,A01,084007,Staff,9,0,20,11
1649943946424,CSE 21,A01,084009,Staff,10,0,50,40
1649943952460,CSE 30,A01,083370,Cao; Yingjun,0,20,40,40
1649943958484,CSE 100,A01,083372,Cao; Yingjun,0,23,40,40
1649943964510,CSE 101,A01,084011,Staff,0,49,40,40
1649943970535,CSE 141,A01,083374,Eldon; John,0,51,75,75
1649943976566,CSE 141L,A01,083376,Eldon; John,0,56,75,75
1649943982595,CSE 175,A01,084013,Kumar; Rakesh,22,0,25,3
1649943988623,CSE 190,A00,092508,Dubnov; Shlomo,15,0,15,0
1649943994650,ECE 5,A01,084049,Morris; Karcher William,15,0,20,5
1649944000686,ECE 100,A01,084051,Baghdadchi; Saharnaz,1,0,20,19
1649944000686,ECE 100,A02,091916,Baghdadchi; Saharnaz,16,0,20,4
1649944006711,ECE 101,A01,084053,Baghdadchi; Saharnaz,5,0,37,32
1649944006711,ECE 101,A02,084054,Baghdadchi; Saharnaz,33,0,37,4
1649944012743,ECE 107,A01,083390,Staff,28,0,40,12
1649944018769,ECE 148,A01,084056,Silberman; Jack,7,0,12,5
1649944024795,ECE 180,A00,083391,Abi Samra; Nicholas Camill,25,0,30,5
1649944024795,ECE 180,B00,083392,Abi Samra; Nicholas Camill,22,0,30,8
1649944030825,MATH 10B,A01,084110,Staff,8,0,30,22
1649944030825,MATH 10B,A02,084111,Staff,29,0,30,1
1649944030825,MATH 10B,A03,084112,Staff,28,0,30,2
1649944036852,MATH 10C,A01,083443,Staff,9,0,30,21
1649944036852,MATH 10C,A02,083444,Staff,16,0,30,14
1649944036852,MATH 10C,B01,084114,Staff,25,0,30,5
1649944036852,MATH 10C,B02,084115,Staff,29,0,30,1
1649944042878,MATH 18,A01,084117,Harel; Guershon,27,0,30,3
1649944042878,MATH 18,A02,084119,Harel; Guershon,29,0,30,1
1649944042878,MATH 18,A03,084120,Harel; Guershon,30,0,30,0
1649944042878,MATH 18,A04,084121,Harel; Guershon,29,0,30,1
1649944048909,MATH 20B,A01,084124,Um; Ko Woon,31,0,35,4
1649944048909,MATH 20B,B01,084126,Um; Ko Woon,32,0,35,3
1649944054951,MATH 20C,A01,083446,Hammock; Frances H,17,0,30,13
1649944054951,MATH 20C,A02,083447,Hammock; Frances H,28,0,30,2
1649944054951,MATH 20C,A03,083448,Hammock; Frances H,30,0,30,0
1649944054951,MATH 20C,A04,083449,Hammock; Frances H,30,0,30,0
1649944054951,MATH 20C,B01,083451,Hammock; Frances H,25,0,30,5
1649944054951,MATH 20C,B02,083452,Hammock; Frances H,27,0,30,3
1649944054951,MATH 20C,B03,083453,Hammock; Frances H,26,0,30,4
1649944054951,MATH 20C,B04,083454,Hammock; Frances H,30,0,30,0
1649944060983,MATH 20D,A01,084128,Staff,26,0,30,4
1649944060983,MATH 20D,A02,084129,Staff,30,0,30,0
1649944060983,MATH 20D,A03,084130,Staff,29,0,30,1
1649944060983,MATH 20D,B01,084133,Staff,21,0,30,9
1649944060983,MATH 20D,B02,084134,Staff,27,0,30,3
1649944060983,MATH 20D,B03,084135,Staff,30,0,30,0
1649944067012,MATH 20E,A01,084138,Staff,22,0,30,8
1649944067012,MATH 20E,A02,084139,Staff,22,0,30,8
1649944067012,MATH 20E,A03,084140,Staff,23,0,30,7
1649944067012,MATH 20E,A04,084141,Staff,25,0,30,5
1649944073042,MATH 102,A01,084143,Harel; Guershon,16,0,30,14
1649944073042,MATH 102,A02,084144,Harel; Guershon,22,0,30,8
1649944079067,MATH 103B,A01,083456,Staff,0,8,30,30
1649944079067,MATH 103B,A02,083457,Staff,0,9,30,30
1649944085094,MATH 109,A01,084146,Salehi Golsefidy; Alireza,28,0,30,2
1649944085094,MATH 109,A02,084147,Salehi Golsefidy; Alireza,22,0,30,8
1649944091119,MATH 120A,A01,085445,Eggers; John Dietrich,20,0,35,15
1649944091119,MATH 120A,A02,085446,Eggers; John Dietrich,28,0,35,7
1649944097144,MATH 142B,A01,084149,Verstraete; Jacques Allan,0,10,30,30
1649944097144,MATH 142B,A02,084150,Verstraete; Jacques Allan,0,9,30,30
1649944103170,MATH 170A,A01,083459,Nie; Jiawang,0,2,30,30
1649944103170,MATH 170A,A02,083460,Nie; Jiawang,0,0,30,30
1649944103170,MATH 170A,A03,083461,Nie; Jiawang,7,0,30,23
1649944109194,MATH 193B,A01,083463,Staff,3,0,30,27
1649944109194,MATH 193B,A02,083464,Staff,10,0,30,20
1649944109194,MATH 193B,A03,083465,Staff,19,0,30,11
1649944115252,COGS 2,A01,083966,Boyle; Mary E. T.,18,0,30,12
1649944121278,COGS 9,A01,083968,Staff,41,0,60,19
1649944127304,COGS 14B,A01,083970,Staff,28,0,50,22
1649944133329,COGS 17,A01,092679,Staff,67,0,75,8
1649944139353,COGS 100,A01,083972,Staff,9,0,60,51
1649944151412,COGS 101C,A01,083976,Staff,19,0,30,11
1649944157440,COGS 102A,A01,083978,Johnson; Christine M.,17,0,30,13
1649944163464,COGS 107B,A01,083980,Staff,3,0,50,47
1649944169507,COGS 115,A01,083982,Staff,14,0,30,16
1649944175531,COGS 118B,A01,083367,Staff,0,11,40,40
1649944181556,COGS 172,A01,083984,Provenzano; Emily Kara,16,0,30,14
1649944187581,COGS 177,A00,083368,Staff,0,17,30,30
1649944193606,COGS 186,A01,083986,Staff,21,0,40,19
1649944199630,COGS 187A,A01,083988,Boyle; Mary E. T.,24,0,60,36
1649944205664,CSE 8A,A50,084003,Miranda; Gregory Joseph,0,0,15,15
1649944211690,CSE 11,A01,084005,Miranda; Gregory Joseph,22,0,55,33
1649944217714,CSE 20,A01,084007,Staff,9,0,20,11
1649944223741,CSE 21,A01,084009,Staff,10,0,50,40
1649944229768,CSE 30,A01,083370,Cao; Yingjun,0,20,40,40
1649944235793,CSE 100,A01,083372,Cao; Yingjun,0,23,40,40
1649944241819,CSE 101,A01,084011,Staff,0,49,40,40
1649944247848,CSE 141,A01,083374,Eldon; John,0,51,75,75
1649944253877,CSE 141L,A01,083376,Eldon; John,0,56,75,75
1649944259903,CSE 175,A01,084013,Kumar; Rakesh,22,0,25,3
1649944265930,CSE 190,A00,092508,Dubnov; Shlomo,15,0,15,0
1649944271958,ECE 5,A01,084049,Morris; Karcher William,15,0,20,5
1649944277990,ECE 100,A01,084051,Baghdadchi; Saharnaz,1,0,20,19
1649944277990,ECE 100,A02,091916,Baghdadchi; Saharnaz,16,0,20,4
1649944284020,ECE 101,A01,084053,Baghdadchi; Saharnaz,5,0,37,32
1649944284020,ECE 101,A02,084054,Baghdadchi; Saharnaz,33,0,37,4
1649944290044,ECE 107,A01,083390,Staff,28,0,40,12
1649944296072,ECE 148,A01,084056,Silberman; Jack,7,0,12,5
1649944302096,ECE 180,A00,083391,Abi Samra; Nicholas Camill,25,0,30,5
1649944302096,ECE 180,B00,083392,Abi Samra; Nicholas Camill,22,0,30,8
1649944308132,MATH 10B,A01,084110,Staff,8,0,30,22
1649944308132,MATH 10B,A02,084111,Staff,29,0,30,1
1649944308132,MATH 10B,A03,084112,Staff,28,0,30,2
1649944314159,MATH 10C,A01,083443,Staff,9,0,30,21
1649944314159,MATH 10C,A02,083444,Staff,16,0,30,14
1649944314159,MATH 10C,B01,084114,Staff,25,0,30,5
1649944314159,MATH 10C,B02,084115,Staff,29,0,30,1
1649944320188,MATH 18,A01,084117,Harel; Guershon,27,0,30,3
1649944320188,MATH 18,A02,084119,Harel; Guershon,29,0,30,1
1649944320188,MATH 18,A03,084120,Harel; Guershon,30,0,30,0
1649944320188,MATH 18,A04,084121,Harel; Guershon,29,0,30,1
1649944326222,MATH 20B,A01,084124,Um; Ko Woon,31,0,35,4
1649944326222,MATH 20B,B01,084126,Um; Ko Woon,32,0,35,3
1649944332250,MATH 20C,A01,083446,Hammock; Frances H,17,0,30,13
1649944332250,MATH 20C,A02,083447,Hammock; Frances H,28,0,30,2
1649944332250,MATH 20C,A03,083448,Hammock; Frances H,30,0,30,0
1649944332250,MATH 20C,A04,083449,Hammock; Frances H,30,0,30,0
1649944332250,MATH 20C,B01,083451,Hammock; Frances H,25,0,30,5
1649944332250,MATH 20C,B02,083452,Hammock; Frances H,27,0,30,3
1649944332250,MATH 20C,B03,083453,Hammock; Frances H,26,0,30,4
1649944332250,MATH 20C,B04,083454,Hammock; Frances H,30,0,30,0
1649944338280,MATH 20D,A01,084128,Staff,26,0,30,4
1649944338280,MATH 20D,A02,084129,Staff,30,0,30,0
1649944338280,MATH 20D,A03,084130,Staff,29,0,30,1
1649944338280,MATH 20D,B01,084133,Staff,21,0,30,9
1649944338280,MATH 20D,B02,084134,Staff,27,0,30,3
1649944338280,MATH 20D,B03,084135,Staff,30,0,30,0
1649944344316,MATH 20E,A01,084138,Staff,22,0,30,8
1649944344316,MATH 20E,A02,084139,Staff,22,0,30,8
1649944344316,MATH 20E,A03,084140,Staff,23,0,30,7
1649944344316,MATH 20E,A04,084141,Staff,25,0,30,5
1649944350345,MATH 102,A01,084143,Harel; Guershon,16,0,30,14
1649944350345,MATH 102,A02,084144,Harel; Guershon,22,0,30,8
1649944356374,MATH 103B,A01,083456,Staff,0,8,30,30
1649944356374,MATH 103B,A02,083457,Staff,0,9,30,30
1649944362417,MATH 109,A01,084146,Salehi Golsefidy; Alireza,28,0,30,2
1649944362417,MATH 109,A02,084147,Salehi Golsefidy; Alireza,22,0,30,8
1649944368454,MATH 120A,A01,085445,Eggers; John Dietrich,20,0,35,15
1649944368454,MATH 120A,A02,085446,Eggers; John Dietrich,28,0,35,7
1649944374480,MATH 142B,A01,084149,Verstraete; Jacques Allan,0,10,30,30
1649944374480,MATH 142B,A02,084150,Verstraete; Jacques Allan,0,9,30,30
1649944380518,MATH 170A,A01,083459,Nie; Jiawang,0,2,30,30
1649944380518,MATH 170A,A02,083460,Nie; Jiawang,0,0,30,30
1649944380518,MATH 170A,A03,083461,Nie; Jiawang,7,0,30,23
1649944386544,MATH 193B,A01,083463,Staff,3,0,30,27
1649944386544,MATH 193B,A02,083464,Staff,10,0,30,20
1649944386544,MATH 193B,A03,083465,Staff,19,0,30,11
1649944392613,COGS 2,A01,083966,Boyle; Mary E. T.,18,0,30,12
1649944398638,COGS 9,A01,083968,Staff,41,0,60,19
1649944404672,COGS 14B,A01,083970,Staff,28,0,50,22
1649944410699,COGS 17,A01,092679,Staff,67,0,75,8
1649944416730,COGS 100,A01,083972,Staff,9,0,60,51
1649944428797,COGS 101C,A01,083976,Staff,19,0,30,11
1649944434948,COGS 102A,A01,083978,Johnson; Christine M.,17,0,30,13
1649944440975,COGS 107B,A01,083980,Staff,3,0,50,47
1649944447000,COGS 115,A01,083982,Staff,14,0,30,16
1649944453029,COGS 118B,A01,083367,Staff,0,11,40,40
1649944459058,COGS 172,A01,083984,Provenzano; Emily Kara,16,0,30,14
1649944465083,COGS 177,A00,083368,Staff,0,17,30,30
1649944471111,COGS 186,A01,083986,Staff,21,0,40,19
1649944477136,COGS 187A,A01,083988,Boyle; Mary E. T.,24,0,60,36
1649944483164,CSE 8A,A50,084003,Miranda; Gregory Joseph,0,0,15,15
1649944489206,CSE 11,A01,084005,Miranda; Gregory Joseph,22,0,55,33
1649944495233,CSE 20,A01,084007,Staff,9,0,20,11
1649944501261,CSE 21,A01,084009,Staff,10,0,50,40
1649944507285,CSE 30,A01,083370,Cao; Yingjun,0,20,40,40
1649944513322,CSE 100,A01,083372,Cao; Yingjun,0,23,40,40
1649944519351,CSE 101,A01,084011,Staff,0,49,40,40
1649944525375,CSE 141,A01,083374,Eldon; John,0,51,75,75
1649944531404,CSE 141L,A01,083376,Eldon; John,0,56,75,75
1649944537437,CSE 175,A01,084013,Kumar; Rakesh,22,0,25,3
1649944543463,CSE 190,A00,092508,Dubnov; Shlomo,15,0,15,0
1649944549489,ECE 5,A01,084049,Morris; Karcher William,15,0,20,5
1649944555522,ECE 100,A01,084051,Baghdadchi; Saharnaz,1,0,20,19
1649944555522,ECE 100,A02,091916,Baghdadchi; Saharnaz,16,0,20,4
1649944561547,ECE 101,A01,084053,Baghdadchi; Saharnaz,5,0,37,32
1649944561547,ECE 101,A02,084054,Baghdadchi; Saharnaz,33,0,37,4
1649944567572,ECE 107,A01,083390,Staff,28,0,40,12
1649944573598,ECE 148,A01,084056,Silberman; Jack,7,0,12,5
1649944579629,ECE 180,A00,083391,Abi Samra; Nicholas Camill,25,0,30,5
1649944579629,ECE 180,B00,083392,Abi Samra; Nicholas Camill,22,0,30,8
1649944585653,MATH 10B,A01,084110,Staff,8,0,30,22
1649944585653,MATH 10B,A02,084111,Staff,29,0,30,1
1649944585653,MATH 10B,A03,084112,Staff,28,0,30,2
1649944591681,MATH 10C,A01,083443,Staff,9,0,30,21
1649944591681,MATH 10C,A02,083444,Staff,16,0,30,14
1649944591681,MATH 10C,B01,084114,Staff,25,0,30,5
1649944591681,MATH 10C,B02,084115,Staff,29,0,30,1
1649944597706,MATH 18,A01,084117,Harel; Guershon,27,0,30,3
1649944597706,MATH 18,A02,084119,Harel; Guershon,29,0,30,1
1649944597706,MATH 18,A03,084120,Harel; Guershon,30,0,30,0
1649944597706,MATH 18,A04,084121,Harel; Guershon,29,0,30,1
1649944603732,MATH 20B,A01,084124,Um; Ko Woon,31,0,35,4
1649944603732,MATH 20B,B01,084126,Um; Ko Woon,32,0,35,3
1649944609765,MATH 20C,A01,083446,Hammock; Frances H,17,0,30,13
1649944609765,MATH 20C,A02,083447,Hammock; Frances H,28,0,30,2
1649944609765,MATH 20C,A03,083448,Hammock; Frances H,30,0,30,0
1649944609765,MATH 20C,A04,083449,Hammock; Frances H,30,0,30,0
1649944609765,MATH 20C,B01,083451,Hammock; Frances H,25,0,30,5
1649944609765,MATH 20C,B02,083452,Hammock; Frances H,27,0,30,3
1649944609765,MATH 20C,B03,083453,Hammock; Frances H,26,0,30,4
1649944609765,MATH 20C,B04,083454,Hammock; Frances H,30,0,30,0
1649944615794,MATH 20D,A01,084128,Staff,26,0,30,4
1649944615794,MATH 20D,A02,084129,Staff,30,0,30,0
1649944615794,MATH 20D,A03,084130,Staff,29,0,30,1
1649944615794,MATH 20D,B01,084133,Staff,21,0,30,9
1649944615794,MATH 20D,B02,084134,Staff,27,0,30,3
1649944615794,MATH 20D,B03,084135,Staff,30,0,30,0
1649944621818,MATH 20E,A01,084138,Staff,22,0,30,8
1649944621818,MATH 20E,A02,084139,Staff,22,0,30,8
1649944621818,MATH 20E,A03,084140,Staff,23,0,30,7
1649944621818,MATH 20E,A04,084141,Staff,25,0,30,5
1649944627845,MATH 102,A01,084143,Harel; Guershon,16,0,30,14
1649944627845,MATH 102,A02,084144,Harel; Guershon,22,0,30,8
1649944633869,MATH 103B,A01,083456,Staff,0,8,30,30
1649944633869,MATH 103B,A02,083457,Staff,0,9,30,30
1649944639899,MATH 109,A01,084146,Salehi Golsefidy; Alireza,28,0,30,2
1649944639899,MATH 109,A02,084147,Salehi Golsefidy; Alireza,22,0,30,8
1649944645930,MATH 120A,A01,085445,Eggers; John Dietrich,20,0,35,15
1649944645930,MATH 120A,A02,085446,Eggers; John Dietrich,28,0,35,7
1649944651961,MATH 142B,A01,084149,Verstraete; Jacques Allan,0,10,30,30
1649944651961,MATH 142B,A02,084150,Verstraete; Jacques Allan,0,9,30,30
1649944657988,MATH 170A,A01,083459,Nie; Jiawang,0,2,30,30
1649944657988,MATH 170A,A02,083460,Nie; Jiawang,0,0,30,30
1649944657988,MATH 170A,A03,083461,Nie; Jiawang,7,0,30,23
1649944664016,MATH 193B,A01,083463,Staff,3,0,30,27
1649944664016,MATH 193B,A02,083464,Staff,10,0,30,20
1649944664016,MATH 193B,A03,083465,Staff,19,0,30,11
1649944670096,COGS 2,A01,083966,Boyle; Mary E. T.,18,0,30,12
1649944676121,COGS 9,A01,083968,Staff,41,0,60,19
1649944682149,COGS 14B,A01,083970,Staff,28,0,50,22
1649944688177,COGS 17,A01,092679,Staff,67,0,75,8
1649944694201,COGS 100,A01,083972,Staff,9,0,60,51
1649944706261,COGS 101C,A01,083976,Staff,19,0,30,11
1649944712288,COGS 102A,A01,083978,Johnson; Christine M.,17,0,30,13
1649944718317,COGS 107B,A01,083980,Staff,3,0,50,47
1649944724352,COGS 115,A01,083982,Staff,14,0,30,16
1649944730381,COGS 118B,A01,083367,Staff,0,11,40,40
1649944736414,COGS 172,A01,083984,Provenzano; Emily Kara,16,0,30,14
1649944742447,COGS 177,A00,083368,Staff,0,17,30,30
1649944748474,COGS 186,A01,083986,Staff,21,0,40,19
1649944754504,COGS 187A,A01,083988,Boyle; Mary E. T.,24,0,60,36
1649944760536,CSE 8A,A50,084003,Miranda; Gregory Joseph,0,0,15,15
1649944766568,CSE 11,A01,084005,Miranda; Gregory Joseph,22,0,55,33
1649944772600,CSE 20,A01,084007,Staff,9,0,20,11
1649944778625,CSE 21,A01,084009,Staff,10,0,50,40
1649944784660,CSE 30,A01,083370,Cao; Yingjun,0,20,40,40
1649944790687,CSE 100,A01,083372,Cao; Yingjun,0,23,40,40
1649944796711,CSE 101,A01,084011,Staff,0,49,40,40
1649944802739,CSE 141,A01,083374,Eldon; John,0,51,75,75
1649944808768,CSE 141L,A01,083376,Eldon; John,0,56,75,75
1649944814803,CSE 175,A01,084013,Kumar; Rakesh,22,0,25,3
1649944820835,CSE 190,A00,092508,Dubnov; Shlomo,15,0,15,0
1649944826866,ECE 5,A01,084049,Morris; Karcher William,15,0,20,5
1649944832892,ECE 100,A01,084051,Baghdadchi; Saharnaz,1,0,20,19
1649944832892,ECE 100,A02,091916,Baghdadchi; Saharnaz,16,0,20,4
1649944838961,ECE 101,A01,084053,Baghdadchi; Saharnaz,5,0,37,32
1649944838961,ECE 101,A02,084054,Baghdadchi; Saharnaz,33,0,37,4
1649944844988,ECE 107,A01,083390,Staff,28,0,40,12
1649944851017,ECE 148,A01,084056,Silberman; Jack,7,0,12,5
1649944857043,ECE 180,A00,083391,Abi Samra; Nicholas Camill,25,0,30,5
1649944857043,ECE 180,B00,083392,Abi Samra; Nicholas Camill,22,0,30,8
1649944863070,MATH 10B,A01,084110,Staff,8,0,30,22
1649944863070,MATH 10B,A02,084111,Staff,29,0,30,1
1649944863070,MATH 10B,A03,084112,Staff,28,0,30,2
1649944869096,MATH 10C,A01,083443,Staff,9,0,30,21
1649944869096,MATH 10C,A02,083444,Staff,16,0,30,14
1649944869096,MATH 10C,B01,084114,Staff,25,0,30,5
1649944869096,MATH 10C,B02,084115,Staff,29,0,30,1
1649944875123,MATH 18,A01,084117,Harel; Guershon,27,0,30,3
1649944875123,MATH 18,A02,084119,Harel; Guershon,29,0,30,1
1649944875123,MATH 18,A03,084120,Harel; Guershon,30,0,30,0
1649944875123,MATH 18,A04,084121,Harel; Guershon,29,0,30,1
1649944881154,MATH 20B,A01,084124,Um; Ko Woon,31,0,35,4
1649944881154,MATH 20B,B01,084126,Um; Ko Woon,32,0,35,3
1649944887300,MATH 20C,A01,083446,Hammock; Frances H,17,0,30,13
1649944887300,MATH 20C,A02,083447,Hammock; Frances H,28,0,30,2
1649944887300,MATH 20C,A03,083448,Hammock; Frances H,30,0,30,0
1649944887300,MATH 20C,A04,083449,Hammock; Frances H,30,0,30,0
1649944887300,MATH 20C,B01,083451,Hammock; Frances H,25,0,30,5
1649944887300,MATH 20C,B02,083452,Hammock; Frances H,27,0,30,3
1649944887300,MATH 20C,B03,083453,Hammock; Frances H,26,0,30,4
1649944887300,MATH 20C,B04,083454,Hammock; Frances H,30,0,30,0
1649944893327,MATH 20D,A01,084128,Staff,26,0,30,4
1649944893327,MATH 20D,A02,084129,Staff,30,0,30,0
1649944893327,MATH 20D,A03,084130,Staff,29,0,30,1
1649944893327,MATH 20D,B01,084133,Staff,21,0,30,9
1649944893327,MATH 20D,B02,084134,Staff,27,0,30,3
1649944893327,MATH 20D,B03,084135,Staff,30,0,30,0
1649944899354,MATH 20E,A01,084138,Staff,22,0,30,8
1649944899354,MATH 20E,A02,084139,Staff,22,0,30,8
1649944899354,MATH 20E,A03,084140,Staff,23,0,30,7
1649944899354,MATH 20E,A04,084141,Staff,25,0,30,5
1649944905380,MATH 102,A01,084143,Harel; Guershon,16,0,30,14
1649944905380,MATH 102,A02,084144,Harel; Guershon,22,0,30,8
1649944911408,MATH 103B,A01,083456,Staff,0,8,30,30
1649944911408,MATH 103B,A02,083457,Staff,0,9,30,30
1649944917445,MATH 109,A01,084146,Salehi Golsefidy; Alireza,28,0,30,2
1649944917445,MATH 109,A02,084147,Salehi Golsefidy; Alireza,22,0,30,8
1649944923475,MATH 120A,A01,085445,Eggers; John Dietrich,20,0,35,15
1649944923475,MATH 120A,A02,085446,Eggers; John Dietrich,28,0,35,7
1649944929502,MATH 142B,A01,084149,Verstraete; Jacques Allan,0,10,30,30
1649944929502,MATH 142B,A02,084150,Verstraete; Jacques Allan,0,9,30,30
1649944935537,MATH 170A,A01,083459,Nie; Jiawang,0,2,30,30
1649944935537,MATH 170A,A02,083460,Nie; Jiawang,0,0,30,30
1649944935537,MATH 170A,A03,083461,Nie; Jiawang,7,0,30,23
1649944941562,MATH 193B,A01,083463,Staff,3,0,30,27
1649944941562,MATH 193B,A02,083464,Staff,10,0,30,20
1649944941562,MATH 193B,A03,083465,Staff,19,0,30,11
1649944947630,COGS 2,A01,083966,Boyle; Mary E. T.,18,0,30,12
1649944953667,COGS 9,A01,083968,Staff,41,0,60,19
1649944959692,COGS 14B,A01,083970,Staff,28,0,50,22
1649944965720,COGS 17,A01,092679,Staff,67,0,75,8
1649944971748,COGS 100,A01,083972,Staff,9,0,60,51
1649944983800,COGS 101C,A01,083976,Staff,19,0,30,11
1649944989831,COGS 102A,A01,083978,Johnson; Christine M.,17,0,30,13
1649944995857,COGS 107B,A01,083980,Staff,3,0,50,47
1649945001881,COGS 115,A01,083982,Staff,14,0,30,16
1649945007906,COGS 118B,A01,083367,Staff,0,11,40,40
1649945013932,COGS 172,A01,083984,Provenzano; Emily Kara,16,0,30,14
1649945019962,COGS 177,A00,083368,Staff,0,17,30,30
1649945025992,COGS 186,A01,083986,Staff,21,0,40,19
1649945032111,COGS 187A,A01,083988,Boyle; Mary E. T.,24,0,60,36
1649945038139,CSE 8A,A50,084003,Miranda; Gregory Joseph,0,0,15,15
1649945044164,CSE 11,A01,084005,Miranda; Gregory Joseph,22,0,55,33
1649945050198,CSE 20,A01,084007,Staff,9,0,20,11
1649945056223,CSE 21,A01,084009,Staff,10,0,50,40
1649945062263,CSE 30,A01,083370,Cao; Yingjun,0,20,40,40
1649945068287,CSE 100,A01,083372,Cao; Yingjun,0,23,40,40
1649945074313,CSE 101,A01,084011,Staff,0,49,40,40
1649945080342,CSE 141,A01,083374,Eldon; John,0,51,75,75
1649945086365,CSE 141L,A01,083376,Eldon; John,0,56,75,75
1649945092407,CSE 175,A01,084013,Kumar; Rakesh,22,0,25,3
1649945098432,CSE 190,A00,092508,Dubnov; Shlomo,15,0,15,0
1649945104459,ECE 5,A01,084049,Morris; Karcher William,15,0,20,5
1649945110485,ECE 100,A01,084051,Baghdadchi; Saharnaz,1,0,20,19
1649945110485,ECE 100,A02,091916,Baghdadchi; Saharnaz,16,0,20,4
1649945116518,ECE 101,A01,084053,Baghdadchi; Saharnaz,4,0,37,33
1649945116518,ECE 101,A02,084054,Baghdadchi; Saharnaz,33,0,37,4
1649945122544,ECE 107,A01,083390,Staff,28,0,40,12
1649945128576,ECE 148,A01,084056,Silberman; Jack,7,0,12,5
1649945134610,ECE 180,A00,083391,Abi Samra; Nicholas Camill,25,0,30,5
1649945134610,ECE 180,B00,083392,Abi Samra; Nicholas Camill,22,0,30,8
1649945140639,MATH 10B,A01,084110,Staff,8,0,30,22
1649945140639,MATH 10B,A02,084111,Staff,29,0,30,1
1649945140639,MATH 10B,A03,084112,Staff,28,0,30,2
1649945146665,MATH 10C,A01,083443,Staff,9,0,30,21
1649945146665,MATH 10C,A02,083444,Staff,16,0,30,14
1649945146665,MATH 10C,B01,084114,Staff,25,0,30,5
1649945146665,MATH 10C,B02,084115,Staff,29,0,30,1
1649945152694,MATH 18,A01,084117,Harel; Guershon,27,0,30,3
1649945152694,MATH 18,A02,084119,Harel; Guershon,29,0,30,1
1649945152694,MATH 18,A03,084120,Harel; Guershon,30,0,30,0
1649945152694,MATH 18,A04,084121,Harel; Guershon,29,0,30,1
1649945158723,MATH 20B,A01,084124,Um; Ko Woon,31,0,35,4
1649945158723,MATH 20B,B01,084126,Um; Ko Woon,32,0,35,3
1649945164749,MATH 20C,A01,083446,Hammock; Frances H,17,0,30,13
1649945164749,MATH 20C,A02,083447,Hammock; Frances H,28,0,30,2
1649945164749,MATH 20C,A03,083448,Hammock; Frances H,30,0,30,0
1649945164749,MATH 20C,A04,083449,Hammock; Frances H,30,0,30,0
1649945164749,MATH 20C,B01,083451,Hammock; Frances H,25,0,30,5
1649945164749,MATH 20C,B02,083452,Hammock; Frances H,27,0,30,3
1649945164749,MATH 20C,B03,083453,Hammock; Frances H,26,0,30,4
1649945164749,MATH 20C,B04,083454,Hammock; Frances H,30,0,30,0
1649945170777,MATH 20D,A01,084128,Staff,26,0,30,4
1649945170777,MATH 20D,A02,084129,Staff,30,0,30,0
1649945170777,MATH 20D,A03,084130,Staff,29,0,30,1
1649945170777,MATH 20D,B01,084133,Staff,21,0,30,9
1649945170777,MATH 20D,B02,084134,Staff,27,0,30,3
1649945170777,MATH 20D,B03,084135,Staff,30,0,30,0
1649945176806,MATH 20E,A01,084138,Staff,22,0,30,8
1649945176806,MATH 20E,A02,084139,Staff,22,0,30,8
1649945176806,MATH 20E,A03,084140,Staff,23,0,30,7
1649945176806,MATH 20E,A04,084141,Staff,25,0,30,5
1649945182834,MATH 102,A01,084143,Harel; Guershon,16,0,30,14
1649945182834,MATH 102,A02,084144,Harel; Guershon,22,0,30,8
1649945188864,MATH 103B,A01,083456,Staff,0,8,30,30
1649945188864,MATH 103B,A02,083457,Staff,0,9,30,30
1649945194892,MATH 109,A01,084146,Salehi Golsefidy; Alireza,28,0,30,2
1649945194892,MATH 109,A02,084147,Salehi Golsefidy; Alireza,22,0,30,8
1649945200917,MATH 120A,A01,085445,Eggers; John Dietrich,20,0,35,15
1649945200917,MATH 120A,A02,085446,Eggers; John Dietrich,28,0,35,7
1649945206941,MATH 142B,A01,084149,Verstraete; Jacques Allan,0,10,30,30
1649945206941,MATH 142B,A02,084150,Verstraete; Jacques Allan,0,9,30,30
1649945212973,MATH 170A,A01,083459,Nie; Jiawang,0,2,30,30
1649945212973,MATH 170A,A02,083460,Nie; Jiawang,0,0,30,30
1649945212973,MATH 170A,A03,083461,Nie; Jiawang,7,0,30,23
1649945218999,MATH 193B,A01,083463,Staff,3,0,30,27
1649945218999,MATH 193B,A02,083464,Staff,10,0,30,20
1649945218999,MATH 193B,A03,083465,Staff,19,0,30,11
1649945225066,COGS 2,A01,083966,Boyle; Mary E. T.,18,0,30,12
1649945231091,COGS 9,A01,083968,Staff,41,0,60,19
1649945237116,COGS 14B,A01,083970,Staff,28,0,50,22
1649945243143,COGS 17,A01,092679,Staff,67,0,75,8
1649945249170,COGS 100,A01,083972,Staff,9,0,60,51
1649945261219,COGS 101C,A01,083976,Staff,19,0,30,11
1649945267243,COGS 102A,A01,083978,Johnson; Christine M.,17,0,30,13
1649945273279,COGS 107B,A01,083980,Staff,3,0,50,47
1649945279306,COGS 115,A01,083982,Staff,14,0,30,16
1649945285341,COGS 118B,A01,083367,Staff,0,11,40,40
1649945291369,COGS 172,A01,083984,Provenzano; Emily Kara,16,0,30,14
1649945297392,COGS 177,A00,083368,Staff,0,17,30,30
1649945303418,COGS 186,A01,083986,Staff,21,0,40,19
1649945309446,COGS 187A,A01,083988,Boyle; Mary E. T.,24,0,60,36
1649945315469,CSE 8A,A50,084003,Miranda; Gregory Joseph,0,0,15,15
1649945321493,CSE 11,A01,084005,Miranda; Gregory Joseph,22,0,55,33
1649945327521,CSE 20,A01,084007,Staff,9,0,20,11
1649945333557,CSE 21,A01,084009,Staff,10,0,50,40
1649945339581,CSE 30,A01,083370,Cao; Yingjun,0,20,40,40
1649945345615,CSE 100,A01,083372,Cao; Yingjun,0,23,40,40
1649945351641,CSE 101,A01,084011,Staff,0,49,40,40
1649945357666,CSE 141,A01,083374,Eldon; John,0,51,75,75
1649945363691,CSE 141L,A01,083376,Eldon; John,0,56,75,75
1649945369720,CSE 175,A01,084013,Kumar; Rakesh,22,0,25,3
1649945375744,CSE 190,A00,092508,Dubnov; Shlomo,15,0,15,0
1649945381768,ECE 5,A01,084049,Morris; Karcher William,15,0,20,5
1649945387792,ECE 100,A01,084051,Baghdadchi; Saharnaz,1,0,20,19
1649945387792,ECE 100,A02,091916,Baghdadchi; Saharnaz,16,0,20,4
1649945393817,ECE 101,A01,084053,Baghdadchi; Saharnaz,4,0,37,33
1649945393817,ECE 101,A02,084054,Baghdadchi; Saharnaz,33,0,37,4
1649945399845,ECE 107,A01,083390,Staff,28,0,40,12
1649945405870,ECE 148,A01,084056,Silberman; Jack,7,0,12,5
1649945411898,ECE 180,A00,083391,Abi Samra; Nicholas Camill,25,0,30,5
1649945411898,ECE 180,B00,083392,Abi Samra; Nicholas Camill,22,0,30,8
1649945417926,MATH 10B,A01,084110,Staff,8,0,30,22
1649945417926,MATH 10B,A02,084111,Staff,29,0,30,1
1649945417926,MATH 10B,A03,084112,Staff,28,0,30,2
1649945423951,MATH 10C,A01,083443,Staff,9,0,30,21
1649945423951,MATH 10C,A02,083444,Staff,16,0,30,14
1649945423951,MATH 10C,B01,084114,Staff,25,0,30,5
1649945423951,MATH 10C,B02,084115,Staff,29,0,30,1
1649945429980,MATH 18,A01,084117,Harel; Guershon,27,0,30,3
1649945429980,MATH 18,A02,084119,Harel; Guershon,29,0,30,1
1649945429980,MATH 18,A03,084120,Harel; Guershon,30,0,30,0
1649945429980,MATH 18,A04,084121,Harel; Guershon,29,0,30,1
1649945436003,MATH 20B,A01,084124,Um; Ko Woon,31,0,35,4
1649945436003,MATH 20B,B01,084126,Um; Ko Woon,32,0,35,3
1649945442034,MATH 20C,A01,083446,Hammock; Frances H,17,0,30,13
1649945442034,MATH 20C,A02,083447,Hammock; Frances H,28,0,30,2
1649945442034,MATH 20C,A03,083448,Hammock; Frances H,30,0,30,0
1649945442034,MATH 20C,A04,083449,Hammock; Frances H,30,0,30,0
1649945442034,MATH 20C,B01,083451,Hammock; Frances H,25,0,30,5
1649945442034,MATH 20C,B02,083452,Hammock; Frances H,27,0,30,3
1649945442034,MATH 20C,B03,083453,Hammock; Frances H,26,0,30,4
1649945442034,MATH 20C,B04,083454,Hammock; Frances H,30,0,30,0
1649945448062,MATH 20D,A01,084128,Staff,26,0,30,4
1649945448062,MATH 20D,A02,084129,Staff,30,0,30,0
1649945448062,MATH 20D,A03,084130,Staff,29,0,30,1
1649945448062,MATH 20D,B01,084133,Staff,21,0,30,9
1649945448062,MATH 20D,B02,084134,Staff,27,0,30,3
1649945448062,MATH 20D,B03,084135,Staff,30,0,30,0
1649945454098,MATH 20E,A01,084138,Staff,22,0,30,8
1649945454098,MATH 20E,A02,084139,Staff,22,0,30,8
1649945454098,MATH 20E,A03,084140,Staff,23,0,30,7
1649945454098,MATH 20E,A04,084141,Staff,25,0,30,5
1649945460127,MATH 102,A01,084143,Harel; Guershon,16,0,30,14
1649945460127,MATH 102,A02,084144,Harel; Guershon,22,0,30,8
1649945466157,MATH 103B,A01,083456,Staff,0,8,30,30
1649945466157,MATH 103B,A02,083457,Staff,0,9,30,30
1649945472186,MATH 109,A01,084146,Salehi Golsefidy; Alireza,28,0,30,2
1649945472186,MATH 109,A02,084147,Salehi Golsefidy; Alireza,22,0,30,8
1649945478212,MATH 120A,A01,085445,Eggers; John Dietrich,20,0,35,15
1649945478212,MATH 120A,A02,085446,Eggers; John Dietrich,27,0,35,8
1649945484244,MATH 142B,A01,084149,Verstraete; Jacques Allan,0,10,30,30
1649945484244,MATH 142B,A02,084150,Verstraete; Jacques Allan,0,9,30,30
1649945490270,MATH 170A,A01,083459,Nie; Jiawang,0,2,30,30
1649945490270,MATH 170A,A02,083460,Nie; Jiawang,0,0,30,30
1649945490270,MATH 170A,A03,083461,Nie; Jiawang,7,0,30,23
1649945496293,MATH 193B,A01,083463,Staff,3,0,30,27
1649945496293,MATH 193B,A02,083464,Staff,10,0,30,20
1649945496293,MATH 193B,A03,083465,Staff,19,0,30,11
1649945502348,COGS 2,A01,083966,Boyle; Mary E. T.,18,0,30,12
1649945508377,COGS 9,A01,083968,Staff,41,0,60,19
1649945514404,COGS 14B,A01,083970,Staff,28,0,50,22
1649945520429,COGS 17,A01,092679,Staff,67,0,75,8
1649945526452,COGS 100,A01,083972,Staff,9,0,60,51
1649945538502,COGS 101C,A01,083976,Staff,19,0,30,11
1649945544526,COGS 102A,A01,083978,Johnson; Christine M.,17,0,30,13
1649945550559,COGS 107B,A01,083980,Staff,3,0,50,47
1649945556588,COGS 115,A01,083982,Staff,14,0,30,16
1649945562614,COGS 118B,A01,083367,Staff,0,11,40,40
1649945568639,COGS 172,A01,083984,Provenzano; Emily Kara,16,0,30,14
1649945574667,COGS 177,A00,083368,Staff,0,17,30,30
1649945580696,COGS 186,A01,083986,Staff,21,0,40,19
1649945586723,COGS 187A,A01,083988,Boyle; Mary E. T.,24,0,60,36
1649945592752,CSE 8A,A50,084003,Miranda; Gregory Joseph,0,0,15,15
1649945598778,CSE 11,A01,084005,Miranda; Gregory Joseph,22,0,55,33
1649945604803,CSE 20,A01,084007,Staff,9,0,20,11
1649945610828,CSE 21,A01,084009,Staff,10,0,50,40
1649945616860,CSE 30,A01,083370,Cao; Yingjun,0,20,40,40
1649945622886,CSE 100,A01,083372,Cao; Yingjun,0,23,40,40
1649945628986,CSE 101,A01,084011,Staff,0,49,40,40
1649945635019,CSE 141,A01,083374,Eldon; John,0,51,75,75
1649945641045,CSE 141L,A01,083376,Eldon; John,0,56,75,75
1649945647070,CSE 175,A01,084013,Kumar; Rakesh,22,0,25,3
1649945653095,CSE 190,A00,092508,Dubnov; Shlomo,15,0,15,0
1649945659120,ECE 5,A01,084049,Morris; Karcher William,15,0,20,5
1649945665144,ECE 100,A01,084051,Baghdadchi; Saharnaz,1,0,20,19
1649945665144,ECE 100,A02,091916,Baghdadchi; Saharnaz,16,0,20,4
1649945671169,ECE 101,A01,084053,Baghdadchi; Saharnaz,4,0,37,33
1649945671169,ECE 101,A02,084054,Baghdadchi; Saharnaz,33,0,37,4
1649945677191,ECE 107,A01,083390,Staff,28,0,40,12
1649945683218,ECE 148,A01,084056,Silberman; Jack,7,0,12,5
1649945689246,ECE 180,A00,083391,Abi Samra; Nicholas Camill,25,0,30,5
1649945689246,ECE 180,B00,083392,Abi Samra; Nicholas Camill,22,0,30,8
1649945695272,MATH 10B,A01,084110,Staff,8,0,30,22
1649945695272,MATH 10B,A02,084111,Staff,29,0,30,1
1649945695272,MATH 10B,A03,084112,Staff,28,0,30,2
1649945701296,MATH 10C,A01,083443,Staff,9,0,30,21
1649945701296,MATH 10C,A02,083444,Staff,16,0,30,14
1649945701296,MATH 10C,B01,084114,Staff,25,0,30,5
1649945701296,MATH 10C,B02,084115,Staff,29,0,30,1
1649945707324,MATH 18,A01,084117,Harel; Guershon,27,0,30,3
1649945707324,MATH 18,A02,084119,Harel; Guershon,29,0,30,1
1649945707324,MATH 18,A03,084120,Harel; Guershon,30,0,30,0
1649945707324,MATH 18,A04,084121,Harel; Guershon,29,0,30,1
1649945713349,MATH 20B,A01,084124,Um; Ko Woon,31,0,35,4
1649945713349,MATH 20B,B01,084126,Um; Ko Woon,32,0,35,3
1649945719375,MATH 20C,A01,083446,Hammock; Frances H,17,0,30,13
1649945719375,MATH 20C,A02,083447,Hammock; Frances H,28,0,30,2
1649945719375,MATH 20C,A03,083448,Hammock; Frances H,30,0,30,0
1649945719375,MATH 20C,A04,083449,Hammock; Frances H,30,0,30,0
1649945719375,MATH 20C,B01,083451,Hammock; Frances H,25,0,30,5
1649945719375,MATH 20C,B02,083452,Hammock; Frances H,27,0,30,3
1649945719375,MATH 20C,B03,083453,Hammock; Frances H,26,0,30,4
1649945719375,MATH 20C,B04,083454,Hammock; Frances H,30,0,30,0
1649945725410,MATH 20D,A01,084128,Staff,26,0,30,4
1649945725410,MATH 20D,A02,084129,Staff,30,0,30,0
1649945725410,MATH 20D,A03,084130,Staff,29,0,30,1
1649945725410,MATH 20D,B01,084133,Staff,21,0,30,9
1649945725410,MATH 20D,B02,084134,Staff,27,0,30,3
1649945725410,MATH 20D,B03,084135,Staff,30,0,30,0
1649945731435,MATH 20E,A01,084138,Staff,22,0,30,8
1649945731435,MATH 20E,A02,084139,Staff,22,0,30,8
1649945731435,MATH 20E,A03,084140,Staff,23,0,30,7
1649945731435,MATH 20E,A04,084141,Staff,25,0,30,5
1649945737460,MATH 102,A01,084143,Harel; Guershon,16,0,30,14
1649945737460,MATH 102,A02,084144,Harel; Guershon,22,0,30,8
1649945743483,MATH 103B,A01,083456,Staff,0,8,30,30
1649945743483,MATH 103B,A02,083457,Staff,0,9,30,30
1649945749510,MATH 109,A01,084146,Salehi Golsefidy; Alireza,28,0,30,2
1649945749510,MATH 109,A02,084147,Salehi Golsefidy; Alireza,22,0,30,8
1649945755539,MATH 120A,A01,085445,Eggers; John Dietrich,20,0,35,15
1649945755539,MATH 120A,A02,085446,Eggers; John Dietrich,27,0,35,8
1649945761576,MATH 142B,A01,084149,Verstraete; Jacques Allan,0,10,30,30
1649945761576,MATH 142B,A02,084150,Verstraete; Jacques Allan,0,9,30,30
1649945767604,MATH 170A,A01,083459,Nie; Jiawang,0,2,30,30
1649945767604,MATH 170A,A02,083460,Nie; Jiawang,0,0,30,30
1649945767604,MATH 170A,A03,083461,Nie; Jiawang,7,0,30,23
1649945773631,MATH 193B,A01,083463,Staff,3,0,30,27
1649945773631,MATH 193B,A02,083464,Staff,10,0,30,20
1649945773631,MATH 193B,A03,083465,Staff,19,0,30,11
1649945779706,COGS 2,A01,083966,Boyle; Mary E. T.,18,0,30,12
1649945785741,COGS 9,A01,083968,Staff,41,0,60,19
1649945791765,COGS 14B,A01,083970,Staff,28,0,50,22
1649945797789,COGS 17,A01,092679,Staff,67,0,75,8
1649945803813,COGS 100,A01,083972,Staff,9,0,60,51
1649945815866,COGS 101C,A01,083976,Staff,19,0,30,11
1649945821891,COGS 102A,A01,083978,Johnson; Christine M.,17,0,30,13
1649945827919,COGS 107B,A01,083980,Staff,3,0,50,47
1649945833943,COGS 115,A01,083982,Staff,13,0,30,17
1649945839971,COGS 118B,A01,083367,Staff,0,11,40,40
1649945845997,COGS 172,A01,083984,Provenzano; Emily Kara,16,0,30,14
1649945852022,COGS 177,A00,083368,Staff,0,17,30,30
1649945858049,COGS 186,A01,083986,Staff,21,0,40,19
1649945864078,COGS 187A,A01,083988,Boyle; Mary E. T.,24,0,60,36
1649945870102,CSE 8A,A50,084003,Miranda; Gregory Joseph,0,0,15,15
1649945876133,CSE 11,A01,084005,Miranda; Gregory Joseph,22,0,55,33
1649945882159,CSE 20,A01,084007,Staff,9,0,20,11
1649945888188,CSE 21,A01,084009,Staff,10,0,50,40
1649945894217,CSE 30,A01,083370,Cao; Yingjun,0,20,40,40
1649945900244,CSE 100,A01,083372,Cao; Yingjun,0,23,40,40
1649945906267,CSE 101,A01,084011,Staff,0,49,40,40
1649945912293,CSE 141,A01,083374,Eldon; John,0,51,75,75
1649945918321,CSE 141L,A01,083376,Eldon; John,0,56,75,75
1649945924347,CSE 175,A01,084013,Kumar; Rakesh,22,0,25,3
1649945930373,CSE 190,A00,092508,Dubnov; Shlomo,15,0,15,0
1649945936393,ECE 5,A01,084049,Morris; Karcher William,15,0,20,5
1649945942531,ECE 100,A01,084051,Baghdadchi; Saharnaz,1,0,20,19
1649945942531,ECE 100,A02,091916,Baghdadchi; Saharnaz,16,0,20,4
1649945948556,ECE 101,A01,084053,Baghdadchi; Saharnaz,4,0,37,33
1649945948556,ECE 101,A02,084054,Baghdadchi; Saharnaz,33,0,37,4
1649945954582,ECE 107,A01,083390,Staff,28,0,40,12
1649945960605,ECE 148,A01,084056,Silberman; Jack,7,0,12,5
1649945966633,ECE 180,A00,083391,Abi Samra; Nicholas Camill,25,0,30,5
1649945966633,ECE 180,B00,083392,Abi Samra; Nicholas Camill,22,0,30,8
1649945972659,MATH 10B,A01,084110,Staff,8,0,30,22
1649945972659,MATH 10B,A02,084111,Staff,29,0,30,1
1649945972659,MATH 10B,A03,084112,Staff,28,0,30,2
1649945978688,MATH 10C,A01,083443,Staff,9,0,30,21
1649945978688,MATH 10C,A02,083444,Staff,16,0,30,14
1649945978688,MATH 10C,B01,084114,Staff,25,0,30,5
1649945978688,MATH 10C,B02,084115,Staff,29,0,30,1
1649945984713,MATH 18,A01,084117,Harel; Guershon,27,0,30,3
1649945984713,MATH 18,A02,084119,Harel; Guershon,29,0,30,1
1649945984713,MATH 18,A03,084120,Harel; Guershon,30,0,30,0
1649945984713,MATH 18,A04,084121,Harel; Guershon,29,0,30,1
1649945990754,MATH 20B,A01,084124,Um; Ko Woon,31,0,35,4
1649945990754,MATH 20B,B01,084126,Um; Ko Woon,32,0,35,3
1649945996777,MATH 20C,A01,083446,Hammock; Frances H,17,0,30,13
1649945996777,MATH 20C,A02,083447,Hammock; Frances H,28,0,30,2
1649945996777,MATH 20C,A03,083448,Hammock; Frances H,30,0,30,0
1649945996777,MATH 20C,A04,083449,Hammock; Frances H,30,0,30,0
1649945996777,MATH 20C,B01,083451,Hammock; Frances H,25,0,30,5
1649945996777,MATH 20C,B02,083452,Hammock; Frances H,27,0,30,3
1649945996777,MATH 20C,B03,083453,Hammock; Frances H,26,0,30,4
1649945996777,MATH 20C,B04,083454,Hammock; Frances H,30,0,30,0
1649946002802,MATH 20D,A01,084128,Staff,26,0,30,4
1649946002802,MATH 20D,A02,084129,Staff,30,0,30,0
1649946002802,MATH 20D,A03,084130,Staff,29,0,30,1
1649946002802,MATH 20D,B01,084133,Staff,21,0,30,9
1649946002802,MATH 20D,B02,084134,Staff,27,0,30,3
1649946002802,MATH 20D,B03,084135,Staff,30,0,30,0
1649946008849,MATH 20E,A01,084138,Staff,22,0,30,8
1649946008849,MATH 20E,A02,084139,Staff,22,0,30,8
1649946008849,MATH 20E,A03,084140,Staff,23,0,30,7
1649946008849,MATH 20E,A04,084141,Staff,25,0,30,5
1649946014877,MATH 102,A01,084143,Harel; Guershon,16,0,30,14
1649946014877,MATH 102,A02,084144,Harel; Guershon,22,0,30,8
1649946020901,MATH 103B,A01,083456,Staff,0,8,30,30
1649946020901,MATH 103B,A02,083457,Staff,0,9,30,30
1649946026928,MATH 109,A01,084146,Salehi Golsefidy; Alireza,28,0,30,2
1649946026928,MATH 109,A02,084147,Salehi Golsefidy; Alireza,22,0,30,8
1649946032953,MATH 120A,A01,085445,Eggers; John Dietrich,20,0,35,15
1649946032953,MATH 120A,A02,085446,Eggers; John Dietrich,27,0,35,8
1649946038981,MATH 142B,A01,084149,Verstraete; Jacques Allan,0,10,30,30
1649946038981,MATH 142B,A02,084150,Verstraete; Jacques Allan,0,9,30,30
1649946045010,MATH 170A,A01,083459,Nie; Jiawang,0,2,30,30
1649946045010,MATH 170A,A02,083460,Nie; Jiawang,0,0,30,30
1649946045010,MATH 170A,A03,083461,Nie; Jiawang,7,0,30,23
1649946051038,MATH 193B,A01,083463,Staff,3,0,30,27
1649946051038,MATH 193B,A02,083464,Staff,10,0,30,20
1649946051038,MATH 193B,A03,083465,Staff,19,0,30,11
1649946057103,COGS 2,A01,083966,Boyle; Mary E. T.,18,0,30,12
1649946063127,COGS 9,A01,083968,Staff,41,0,60,19
1649946069151,COGS 14B,A01,083970,Staff,28,0,50,22
1649946075173,COGS 17,A01,092679,Staff,67,0,75,8
1649946081196,COGS 100,A01,083972,Staff,9,0,60,51
1649946093252,COGS 101C,A01,083976,Staff,19,0,30,11
1649946099273,COGS 102A,A01,083978,Johnson; Christine M.,17,0,30,13
1649946105298,COGS 107B,A01,083980,Staff,3,0,50,47
1649946111322,COGS 115,A01,083982,Staff,13,0,30,17
1649946117349,COGS 118B,A01,083367,Staff,0,11,40,40
1649946123373,COGS 172,A01,083984,Provenzano; Emily Kara,16,0,30,14
1649946129399,COGS 177,A00,083368,Staff,0,17,30,30
1649946135432,COGS 186,A01,083986,Staff,21,0,40,19
1649946141463,COGS 187A,A01,083988,Boyle; Mary E. T.,24,0,60,36
1649946147490,CSE 8A,A50,084003,Miranda; Gregory Joseph,0,0,15,15
1649946153518,CSE 11,A01,084005,Miranda; Gregory Joseph,22,0,55,33
1649946159549,CSE 20,A01,084007,Staff,9,0,20,11
1649946165573,CSE 21,A01,084009,Staff,10,0,50,40
1649946171600,CSE 30,A01,083370,Cao; Yingjun,0,20,40,40
1649946177627,CSE 100,A01,083372,Cao; Yingjun,0,23,40,40
1649946183651,CSE 101,A01,084011,Staff,0,49,40,40
1649946189673,CSE 141,A01,083374,Eldon; John,0,51,75,75
1649946195700,CSE 141L,A01,083376,Eldon; John,0,56,75,75
1649946201726,CSE 175,A01,084013,Kumar; Rakesh,22,0,25,3
1649946207751,CSE 190,A00,092508,Dubnov; Shlomo,15,0,15,0
1649946213777,ECE 5,A01,084049,Morris; Karcher William,15,0,20,5
1649946219809,ECE 100,A01,084051,Baghdadchi; Saharnaz,1,0,20,19
1649946219809,ECE 100,A02,091916,Baghdadchi; Saharnaz,16,0,20,4
1649946225926,ECE 101,A01,084053,Baghdadchi; Saharnaz,4,0,37,33
1649946225926,ECE 101,A02,084054,Baghdadchi; Saharnaz,33,0,37,4
1649946231953,ECE 107,A01,083390,Staff,28,0,40,12
1649946237978,ECE 148,A01,084056,Silberman; Jack,7,0,12,5
1649946244005,ECE 180,A00,083391,Abi Samra; Nicholas Camill,25,0,30,5
1649946244005,ECE 180,B00,083392,Abi Samra; Nicholas Camill,22,0,30,8
1649946250038,MATH 10B,A01,084110,Staff,8,0,30,22
1649946250038,MATH 10B,A02,084111,Staff,29,0,30,1
1649946250038,MATH 10B,A03,084112,Staff,28,0,30,2
1649946256083,MATH 10C,A01,083443,Staff,9,0,30,21
1649946256083,MATH 10C,A02,083444,Staff,16,0,30,14
1649946256083,MATH 10C,B01,084114,Staff,25,0,30,5
1649946256083,MATH 10C,B02,084115,Staff,29,0,30,1
1649946262111,MATH 18,A01,084117,Harel; Guershon,27,0,30,3
1649946262111,MATH 18,A02,084119,Harel; Guershon,29,0,30,1
1649946262111,MATH 18,A03,084120,Harel; Guershon,30,0,30,0
1649946262111,MATH 18,A04,084121,Harel; Guershon,29,0,30,1
1649946268136,MATH 20B,A01,084124,Um; Ko Woon,31,0,35,4
1649946268136,MATH 20B,B01,084126,Um; Ko Woon,32,0,35,3
1649946274166,MATH 20C,A01,083446,Hammock; Frances H,17,0,30,13
1649946274166,MATH 20C,A02,083447,Hammock; Frances H,28,0,30,2
1649946274166,MATH 20C,A03,083448,Hammock; Frances H,30,0,30,0
1649946274166,MATH 20C,A04,083449,Hammock; Frances H,30,0,30,0
1649946274166,MATH 20C,B01,083451,Hammock; Frances H,25,0,30,5
1649946274166,MATH 20C,B02,083452,Hammock; Frances H,27,0,30,3
1649946274166,MATH 20C,B03,083453,Hammock; Frances H,26,0,30,4
1649946274166,MATH 20C,B04,083454,Hammock; Frances H,30,0,30,0
1649946280194,MATH 20D,A01,084128,Staff,26,0,30,4
1649946280194,MATH 20D,A02,084129,Staff,30,0,30,0
1649946280194,MATH 20D,A03,084130,Staff,29,0,30,1
1649946280194,MATH 20D,B01,084133,Staff,21,0,30,9
1649946280194,MATH 20D,B02,084134,Staff,27,0,30,3
1649946280194,MATH 20D,B03,084135,Staff,30,0,30,0
1649946286217,MATH 20E,A01,084138,Staff,22,0,30,8
1649946286217,MATH 20E,A02,084139,Staff,22,0,30,8
1649946286217,MATH 20E,A03,084140,Staff,23,0,30,7
1649946286217,MATH 20E,A04,084141,Staff,25,0,30,5
1649946292241,MATH 102,A01,084143,Harel; Guershon,16,0,30,14
1649946292241,MATH 102,A02,084144,Harel; Guershon,22,0,30,8
1649946298269,MATH 103B,A01,083456,Staff,0,8,30,30
1649946298269,MATH 103B,A02,083457,Staff,0,9,30,30
1649946304295,MATH 109,A01,084146,Salehi Golsefidy; Alireza,28,0,30,2
1649946304295,MATH 109,A02,084147,Salehi Golsefidy; Alireza,22,0,30,8
1649946310319,MATH 120A,A01,085445,Eggers; John Dietrich,20,0,35,15
1649946310319,MATH 120A,A02,085446,Eggers; John Dietrich,27,0,35,8
1649946316353,MATH 142B,A01,084149,Verstraete; Jacques Allan,0,10,30,30
1649946316353,MATH 142B,A02,084150,Verstraete; Jacques Allan,0,9,30,30
1649946322377,MATH 170A,A01,083459,Nie; Jiawang,0,2,30,30
1649946322377,MATH 170A,A02,083460,Nie; Jiawang,0,0,30,30
1649946322377,MATH 170A,A03,083461,Nie; Jiawang,7,0,30,23
1649946328406,MATH 193B,A01,083463,Staff,3,0,30,27
1649946328406,MATH 193B,A02,083464,Staff,10,0,30,20
1649946328406,MATH 193B,A03,083465,Staff,19,0,30,11
1649946334457,COGS 2,A01,083966,Boyle; Mary E. T.,18,0,30,12
1649946340480,COGS 9,A01,083968,Staff,41,0,60,19
1649946346511,COGS 14B,A01,083970,Staff,28,0,50,22
1649946352539,COGS 17,A01,092679,Staff,67,0,75,8
1649946358565,COGS 100,A01,083972,Staff,9,0,60,51
1649946370616,COGS 101C,A01,083976,Staff,19,0,30,11
1649946376639,COGS 102A,A01,083978,Johnson; Christine M.,17,0,30,13
1649946382663,COGS 107B,A01,083980,Staff,3,0,50,47
1649946388687,COGS 115,A01,083982,Staff,13,0,30,17
1649946394710,COGS 118B,A01,083367,Staff,0,11,40,40
1649946400738,COGS 172,A01,083984,Provenzano; Emily Kara,16,0,30,14
1649946406760,COGS 177,A00,083368,Staff,0,17,30,30
1649946412786,COGS 186,A01,083986,Staff,21,0,40,19
1649946418813,COGS 187A,A01,083988,Boyle; Mary E. T.,24,0,60,36
1649946424837,CSE 8A,A50,084003,Miranda; Gregory Joseph,0,0,15,15
1649946430860,CSE 11,A01,084005,Miranda; Gregory Joseph,22,0,55,33
1649946436887,CSE 20,A01,084007,Staff,9,0,20,11
1649946442913,CSE 21,A01,084009,Staff,10,0,50,40
1649946448938,CSE 30,A01,083370,Cao; Yingjun,0,20,40,40
1649946454964,CSE 100,A01,083372,Cao; Yingjun,0,23,40,40
1649946460988,CSE 101,A01,084011,Staff,0,49,40,40
1649946467015,CSE 141,A01,083374,Eldon; John,0,51,75,75
1649946473040,CSE 141L,A01,083376,Eldon; John,0,56,75,75
1649946479067,CSE 175,A01,084013,Kumar; Rakesh,22,0,25,3
1649946485089,CSE 190,A00,092508,Dubnov; Shlomo,15,0,15,0
1649946491116,ECE 5,A01,084049,Morris; Karcher William,15,0,20,5
1649946497141,ECE 100,A01,084051,Baghdadchi; Saharnaz,1,0,20,19
1649946497141,ECE 100,A02,091916,Baghdadchi; Saharnaz,16,0,20,4
1649946503171,ECE 101,A01,084053,Baghdadchi; Saharnaz,4,0,37,33
1649946503171,ECE 101,A02,084054,Baghdadchi; Saharnaz,33,0,37,4
1649946509199,ECE 107,A01,083390,Staff,28,0,40,12
1649946515223,ECE 148,A01,084056,Silberman; Jack,7,0,12,5
1649946521259,ECE 180,A00,083391,Abi Samra; Nicholas Camill,25,0,30,5
1649946521259,ECE 180,B00,083392,Abi Samra; Nicholas Camill,22,0,30,8
1649946527283,MATH 10B,A01,084110,Staff,8,0,30,22
1649946527283,MATH 10B,A02,084111,Staff,29,0,30,1
1649946527283,MATH 10B,A03,084112,Staff,28,0,30,2
1649946533317,MATH 10C,A01,083443,Staff,9,0,30,21
1649946533317,MATH 10C,A02,083444,Staff,16,0,30,14
1649946533317,MATH 10C,B01,084114,Staff,25,0,30,5
1649946533317,MATH 10C,B02,084115,Staff,29,0,30,1
1649946539346,MATH 18,A01,084117,Harel; Guershon,27,0,30,3
1649946539346,MATH 18,A02,084119,Harel; Guershon,29,0,30,1
1649946539346,MATH 18,A03,084120,Harel; Guershon,30,0,30,0
1649946539346,MATH 18,A04,084121,Harel; Guershon,29,0,30,1
1649946545369,MATH 20B,A01,084124,Um; Ko Woon,31,0,35,4
1649946545369,MATH 20B,B01,084126,Um; Ko Woon,32,0,35,3
1649946551393,MATH 20C,A01,083446,Hammock; Frances H,17,0,30,13
1649946551393,MATH 20C,A02,083447,Hammock; Frances H,28,0,30,2
1649946551393,MATH 20C,A03,083448,Hammock; Frances H,30,0,30,0
1649946551393,MATH 20C,A04,083449,Hammock; Frances H,30,0,30,0
1649946551393,MATH 20C,B01,083451,Hammock; Frances H,25,0,30,5
1649946551393,MATH 20C,B02,083452,Hammock; Frances H,27,0,30,3
1649946551393,MATH 20C,B03,083453,Hammock; Frances H,26,0,30,4
1649946551393,MATH 20C,B04,083454,Hammock; Frances H,30,0,30,0
1649946557424,MATH 20D,A01,084128,Staff,26,0,30,4
1649946557424,MATH 20D,A02,084129,Staff,30,0,30,0
1649946557424,MATH 20D,A03,084130,Staff,29,0,30,1
1649946557424,MATH 20D,B01,084133,Staff,21,0,30,9
1649946557424,MATH 20D,B02,084134,Staff,27,0,30,3
1649946557424,MATH 20D,B03,084135,Staff,30,0,30,0
1649946563451,MATH 20E,A01,084138,Staff,22,0,30,8
1649946563451,MATH 20E,A02,084139,Staff,22,0,30,8
1649946563451,MATH 20E,A03,084140,Staff,23,0,30,7
1649946563451,MATH 20E,A04,084141,Staff,25,0,30,5
1649946569475,MATH 102,A01,084143,Harel; Guershon,16,0,30,14
1649946569475,MATH 102,A02,084144,Harel; Guershon,22,0,30,8
1649946575500,MATH 103B,A01,083456,Staff,0,8,30,30
1649946575500,MATH 103B,A02,083457,Staff,0,9,30,30
1649946581524,MATH 109,A01,084146,Salehi Golsefidy; Alireza,28,0,30,2
1649946581524,MATH 109,A02,084147,Salehi Golsefidy; Alireza,22,0,30,8
1649946587547,MATH 120A,A01,085445,Eggers; John Dietrich,20,0,35,15
1649946587547,MATH 120A,A02,085446,Eggers; John Dietrich,27,0,35,8
1649946593569,MATH 142B,A01,084149,Verstraete; Jacques Allan,0,10,30,30
1649946593569,MATH 142B,A02,084150,Verstraete; Jacques Allan,0,9,30,30
1649946599593,MATH 170A,A01,083459,Nie; Jiawang,0,2,30,30
1649946599593,MATH 170A,A02,083460,Nie; Jiawang,0,0,30,30
1649946599593,MATH 170A,A03,083461,Nie; Jiawang,7,0,30,23
1649946605621,MATH 193B,A01,083463,Staff,3,0,30,27
1649946605621,MATH 193B,A02,083464,Staff,10,0,30,20
1649946605621,MATH 193B,A03,083465,Staff,19,0,30,11
1649946611673,COGS 2,A01,083966,Boyle; Mary E. T.,18,0,30,12
1649946617697,COGS 9,A01,083968,Staff,41,0,60,19
1649946623734,COGS 14B,A01,083970,Staff,28,0,50,22
1649946629766,COGS 17,A01,092679,Staff,67,0,75,8
1649946635791,COGS 100,A01,083972,Staff,9,0,60,51
1649946647843,COGS 101C,A01,083976,Staff,19,0,30,11
1649946653864,COGS 102A,A01,083978,Johnson; Christine M.,17,0,30,13
1649946659889,COGS 107B,A01,083980,Staff,3,0,50,47
1649946665917,COGS 115,A01,083982,Staff,13,0,30,17
1649946671939,COGS 118B,A01,083367,Staff,0,11,40,40
1649946677965,COGS 172,A01,083984,Provenzano; Emily Kara,16,0,30,14
1649946683987,COGS 177,A00,083368,Staff,0,17,30,30
1649946690011,COGS 186,A01,083986,Staff,21,0,40,19
1649946696037,COGS 187A,A01,083988,Boyle; Mary E. T.,24,0,60,36
1649946702059,CSE 8A,A50,084003,Miranda; Gregory Joseph,0,0,15,15
1649946708085,CSE 11,A01,084005,Miranda; Gregory Joseph,22,0,55,33
1649946714111,CSE 20,A01,084007,Staff,9,0,20,11
1649946720133,CSE 21,A01,084009,Staff,10,0,50,40
1649946726155,CSE 30,A01,083370,Cao; Yingjun,0,20,40,40
1649946732177,CSE 100,A01,083372,Cao; Yingjun,0,23,40,40
1649946738201,CSE 101,A01,084011,Staff,0,49,40,40
1649946744224,CSE 141,A01,083374,Eldon; John,0,51,75,75
1649946750247,CSE 141L,A01,083376,Eldon; John,0,56,75,75
1649946756270,CSE 175,A01,084013,Kumar; Rakesh,22,0,25,3
1649946762293,CSE 190,A00,092508,Dubnov; Shlomo,15,0,15,0
1649946768317,ECE 5,A01,084049,Morris; Karcher William,15,0,20,5
1649946774345,ECE 100,A01,084051,Baghdadchi; Saharnaz,1,0,20,19
1649946774345,ECE 100,A02,091916,Baghdadchi; Saharnaz,16,0,20,4
1649946780370,ECE 101,A01,084053,Baghdadchi; Saharnaz,4,0,37,33
1649946780370,ECE 101,A02,084054,Baghdadchi; Saharnaz,33,0,37,4
1649946786394,ECE 107,A01,083390,Staff,28,0,40,12
1649946792420,ECE 148,A01,084056,Silberman; Jack,7,0,12,5
1649946798444,ECE 180,A00,083391,Abi Samra; Nicholas Camill,25,0,30,5
1649946798444,ECE 180,B00,083392,Abi Samra; Nicholas Camill,22,0,30,8
1649946804469,MATH 10B,A01,084110,Staff,8,0,30,22
1649946804469,MATH 10B,A02,084111,Staff,29,0,30,1
1649946804469,MATH 10B,A03,084112,Staff,28,0,30,2
1649946810494,MATH 10C,A01,083443,Staff,9,0,30,21
1649946810494,MATH 10C,A02,083444,Staff,16,0,30,14
1649946810494,MATH 10C,B01,084114,Staff,25,0,30,5
1649946810494,MATH 10C,B02,084115,Staff,29,0,30,1
1649946816520,MATH 18,A01,084117,Harel; Guershon,27,0,30,3
1649946816520,MATH 18,A02,084119,Harel; Guershon,29,0,30,1
1649946816520,MATH 18,A03,084120,Harel; Guershon,30,0,30,0
1649946816520,MATH 18,A04,084121,Harel; Guershon,29,0,30,1
1649946822645,MATH 20B,A01,084124,Um; Ko Woon,31,0,35,4
1649946822645,MATH 20B,B01,084126,Um; Ko Woon,32,0,35,3
1649946828676,MATH 20C,A01,083446,Hammock; Frances H,17,0,30,13
1649946828676,MATH 20C,A02,083447,Hammock; Frances H,28,0,30,2
1649946828676,MATH 20C,A03,083448,Hammock; Frances H,30,0,30,0
1649946828676,MATH 20C,A04,083449,Hammock; Frances H,30,0,30,0
1649946828676,MATH 20C,B01,083451,Hammock; Frances H,25,0,30,5
1649946828676,MATH 20C,B02,083452,Hammock; Frances H,27,0,30,3
1649946828676,MATH 20C,B03,083453,Hammock; Frances H,26,0,30,4
1649946828676,MATH 20C,B04,083454,Hammock; Frances H,30,0,30,0
1649946834699,MATH 20D,A01,084128,Staff,26,0,30,4
1649946834699,MATH 20D,A02,084129,Staff,30,0,30,0
1649946834699,MATH 20D,A03,084130,Staff,29,0,30,1
1649946834699,MATH 20D,B01,084133,Staff,21,0,30,9
1649946834699,MATH 20D,B02,084134,Staff,27,0,30,3
1649946834699,MATH 20D,B03,084135,Staff,30,0,30,0
1649946840724,MATH 20E,A01,084138,Staff,22,0,30,8
1649946840724,MATH 20E,A02,084139,Staff,22,0,30,8
1649946840724,MATH 20E,A03,084140,Staff,23,0,30,7
1649946840724,MATH 20E,A04,084141,Staff,25,0,30,5
1649946846751,MATH 102,A01,084143,Harel; Guershon,16,0,30,14
1649946846751,MATH 102,A02,084144,Harel; Guershon,22,0,30,8
1649946852777,MATH 103B,A01,083456,Staff,0,8,30,30
1649946852777,MATH 103B,A02,083457,Staff,0,9,30,30
1649946858801,MATH 109,A01,084146,Salehi Golsefidy; Alireza,28,0,30,2
1649946858801,MATH 109,A02,084147,Salehi Golsefidy; Alireza,22,0,30,8
1649946864823,MATH 120A,A01,085445,Eggers; John Dietrich,20,0,35,15
1649946864823,MATH 120A,A02,085446,Eggers; John Dietrich,27,0,35,8
1649946870846,MATH 142B,A01,084149,Verstraete; Jacques Allan,0,10,30,30
1649946870846,MATH 142B,A02,084150,Verstraete; Jacques Allan,0,9,30,30
1649946876869,MATH 170A,A01,083459,Nie; Jiawang,0,2,30,30
1649946876869,MATH 170A,A02,083460,Nie; Jiawang,0,0,30,30
1649946876869,MATH 170A,A03,083461,Nie; Jiawang,7,0,30,23
1649946882892,MATH 193B,A01,083463,Staff,3,0,30,27
1649946882892,MATH 193B,A02,083464,Staff,10,0,30,20
1649946882892,MATH 193B,A03,083465,Staff,19,0,30,11
1649946888952,COGS 2,A01,083966,Boyle; Mary E. T.,18,0,30,12
1649946894976,COGS 9,A01,083968,Staff,41,0,60,19
1649946901001,COGS 14B,A01,083970,Staff,28,0,50,22
1649946907036,COGS 17,A01,092679,Staff,67,0,75,8
1649946913059,COGS 100,A01,083972,Staff,9,0,60,51
1649946925117,COGS 101C,A01,083976,Staff,19,0,30,11
1649946931142,COGS 102A,A01,083978,Johnson; Christine M.,17,0,30,13
1649946937166,COGS 107B,A01,083980,Staff,3,0,50,47
1649946943192,COGS 115,A01,083982,Staff,13,0,30,17
1649946949217,COGS 118B,A01,083367,Staff,0,11,40,40
1649946955240,COGS 172,A01,083984,Provenzano; Emily Kara,16,0,30,14
1649946961264,COGS 177,A00,083368,Staff,0,17,30,30
1649946967300,COGS 186,A01,083986,Staff,21,0,40,19
1649946973323,COGS 187A,A01,083988,Boyle; Mary E. T.,24,0,60,36
1649946979354,CSE 8A,A50,084003,Miranda; Gregory Joseph,0,0,15,15
1649946985377,CSE 11,A01,084005,Miranda; Gregory Joseph,22,0,55,33
1649946991407,CSE 20,A01,084007,Staff,9,0,20,11
1649946997429,CSE 21,A01,084009,Staff,10,0,50,40
1649947003453,CSE 30,A01,083370,Cao; Yingjun,0,20,40,40
1649947009541,CSE 100,A01,083372,Cao; Yingjun,0,23,40,40
1649947015569,CSE 101,A01,084011,Staff,0,49,40,40
1649947021594,CSE 141,A01,083374,Eldon; John,0,51,75,75
1649947027627,CSE 141L,A01,083376,Eldon; John,0,56,75,75
1649947033658,CSE 175,A01,084013,Kumar; Rakesh,22,0,25,3
1649947039682,CSE 190,A00,092508,Dubnov; Shlomo,15,0,15,0
1649947045709,ECE 5,A01,084049,Morris; Karcher William,15,0,20,5
1649947051745,ECE 100,A01,084051,Baghdadchi; Saharnaz,1,0,20,19
1649947051745,ECE 100,A02,091916,Baghdadchi; Saharnaz,16,0,20,4
1649947057769,ECE 101,A01,084053,Baghdadchi; Saharnaz,4,0,37,33
1649947057769,ECE 101,A02,084054,Baghdadchi; Saharnaz,33,0,37,4
1649947063791,ECE 107,A01,083390,Staff,28,0,40,12
1649947069814,ECE 148,A01,084056,Silberman; Jack,7,0,12,5
1649947075839,ECE 180,A00,083391,Abi Samra; Nicholas Camill,25,0,30,5
1649947075839,ECE 180,B00,083392,Abi Samra; Nicholas Camill,22,0,30,8
1649947081870,MATH 10B,A01,084110,Staff,8,0,30,22
1649947081870,MATH 10B,A02,084111,Staff,29,0,30,1
1649947081870,MATH 10B,A03,084112,Staff,28,0,30,2
1649947087896,MATH 10C,A01,083443,Staff,9,0,30,21
1649947087896,MATH 10C,A02,083444,Staff,16,0,30,14
1649947087896,MATH 10C,B01,084114,Staff,25,0,30,5
1649947087896,MATH 10C,B02,084115,Staff,29,0,30,1
1649947093932,MATH 18,A01,084117,Harel; Guershon,27,0,30,3
1649947093932,MATH 18,A02,084119,Harel; Guershon,29,0,30,1
1649947093932,MATH 18,A03,084120,Harel; Guershon,30,0,30,0
1649947093932,MATH 18,A04,084121,Harel; Guershon,29,0,30,1
1649947099960,MATH 20B,A01,084124,Um; Ko Woon,31,0,35,4
1649947099960,MATH 20B,B01,084126,Um; Ko Woon,32,0,35,3
1649947105985,MATH 20C,A01,083446,Hammock; Frances H,17,0,30,13
1649947105985,MATH 20C,A02,083447,Hammock; Frances H,28,0,30,2
1649947105985,MATH 20C,A03,083448,Hammock; Frances H,30,0,30,0
1649947105985,MATH 20C,A04,083449,Hammock; Frances H,30,0,30,0
1649947105985,MATH 20C,B01,083451,Hammock; Frances H,25,0,30,5
1649947105985,MATH 20C,B02,083452,Hammock; Frances H,27,0,30,3
1649947105985,MATH 20C,B03,083453,Hammock; Frances H,26,0,30,4
1649947105985,MATH 20C,B04,083454,Hammock; Frances H,30,0,30,0
1649947112014,MATH 20D,A01,084128,Staff,26,0,30,4
1649947112014,MATH 20D,A02,084129,Staff,30,0,30,0
1649947112014,MATH 20D,A03,084130,Staff,29,0,30,1
1649947112014,MATH 20D,B01,084133,Staff,21,0,30,9
1649947112014,MATH 20D,B02,084134,Staff,27,0,30,3
1649947112014,MATH 20D,B03,084135,Staff,30,0,30,0
1649947118044,MATH 20E,A01,084138,Staff,22,0,30,8
1649947118044,MATH 20E,A02,084139,Staff,22,0,30,8
1649947118044,MATH 20E,A03,084140,Staff,23,0,30,7
1649947118044,MATH 20E,A04,084141,Staff,25,0,30,5
1649947124068,MATH 102,A01,084143,Harel; Guershon,16,0,30,14
1649947124068,MATH 102,A02,084144,Harel; Guershon,22,0,30,8
1649947130096,MATH 103B,A01,083456,Staff,0,8,30,30
1649947130096,MATH 103B,A02,083457,Staff,0,9,30,30
1649947136125,MATH 109,A01,084146,Salehi Golsefidy; Alireza,28,0,30,2
1649947136125,MATH 109,A02,084147,Salehi Golsefidy; Alireza,22,0,30,8
1649947142154,MATH 120A,A01,085445,Eggers; John Dietrich,20,0,35,15
1649947142154,MATH 120A,A02,085446,Eggers; John Dietrich,27,0,35,8
1649947148178,MATH 142B,A01,084149,Verstraete; Jacques Allan,0,10,30,30
1649947148178,MATH 142B,A02,084150,Verstraete; Jacques Allan,0,9,30,30
1649947154200,MATH 170A,A01,083459,Nie; Jiawang,0,2,30,30
1649947154200,MATH 170A,A02,083460,Nie; Jiawang,0,0,30,30
1649947154200,MATH 170A,A03,083461,Nie; Jiawang,7,0,30,23
1649947160226,MATH 193B,A01,083463,Staff,3,0,30,27
1649947160226,MATH 193B,A02,083464,Staff,10,0,30,20
1649947160226,MATH 193B,A03,083465,Staff,19,0,30,11
1649947166283,COGS 2,A01,083966,Boyle; Mary E. T.,18,0,30,12
1649947172315,COGS 9,A01,083968,Staff,41,0,60,19
1649947178338,COGS 14B,A01,083970,Staff,28,0,50,22
1649947184365,COGS 17,A01,092679,Staff,67,0,75,8
1649947190391,COGS 100,A01,083972,Staff,9,0,60,51
1649947202449,COGS 101C,A01,083976,Staff,19,0,30,11
1649947208474,COGS 102A,A01,083978,Johnson; Christine M.,17,0,30,13
1649947214497,COGS 107B,A01,083980,Staff,3,0,50,47
1649947220519,COGS 115,A01,083982,Staff,13,0,30,17
1649947226550,COGS 118B,A01,083367,Staff,0,11,40,40
1649947232575,COGS 172,A01,083984,Provenzano; Emily Kara,16,0,30,14
1649947238599,COGS 177,A00,083368,Staff,0,17,30,30
1649947244624,COGS 186,A01,083986,Staff,21,0,40,19
1649947250648,COGS 187A,A01,083988,Boyle; Mary E. T.,24,0,60,36
1649947256679,CSE 8A,A50,084003,Miranda; Gregory Joseph,0,0,15,15
1649947262709,CSE 11,A01,084005,Miranda; Gregory Joseph,22,0,55,33
1649947268731,CSE 20,A01,084007,Staff,9,0,20,11
1649947274767,CSE 21,A01,084009,Staff,10,0,50,40
1649947280793,CSE 30,A01,083370,Cao; Yingjun,0,20,40,40
1649947286817,CSE 100,A01,083372,Cao; Yingjun,0,23,40,40
1649947292843,CSE 101,A01,084011,Staff,0,49,40,40
1649947298868,CSE 141,A01,083374,Eldon; John,0,51,75,75
1649947304894,CSE 141L,A01,083376,Eldon; John,0,56,75,75
1649947310917,CSE 175,A01,084013,Kumar; Rakesh,22,0,25,3
1649947316940,CSE 190,A00,092508,Dubnov; Shlomo,15,0,15,0
1649947322969,ECE 5,A01,084049,Morris; Karcher William,15,0,20,5
1649947329004,ECE 100,A01,084051,Baghdadchi; Saharnaz,1,0,20,19
1649947329004,ECE 100,A02,091916,Baghdadchi; Saharnaz,16,0,20,4
1649947335033,ECE 101,A01,084053,Baghdadchi; Saharnaz,4,0,37,33
1649947335033,ECE 101,A02,084054,Baghdadchi; Saharnaz,33,0,37,4
1649947341058,ECE 107,A01,083390,Staff,28,0,40,12
1649947347082,ECE 148,A01,084056,Silberman; Jack,7,0,12,5
1649947353110,ECE 180,A00,083391,Abi Samra; Nicholas Camill,25,0,30,5
1649947353110,ECE 180,B00,083392,Abi Samra; Nicholas Camill,22,0,30,8
1649947359137,MATH 10B,A01,084110,Staff,8,0,30,22
1649947359137,MATH 10B,A02,084111,Staff,29,0,30,1
1649947359137,MATH 10B,A03,084112,Staff,28,0,30,2
1649947365164,MATH 10C,A01,083443,Staff,9,0,30,21
1649947365164,MATH 10C,A02,083444,Staff,16,0,30,14
1649947365164,MATH 10C,B01,084114,Staff,25,0,30,5
1649947365164,MATH 10C,B02,084115,Staff,29,0,30,1
1649947371189,MATH 18,A01,084117,Harel; Guershon,27,0,30,3
1649947371189,MATH 18,A02,084119,Harel; Guershon,29,0,30,1
1649947371189,MATH 18,A03,084120,Harel; Guershon,30,0,30,0
1649947371189,MATH 18,A04,084121,Harel; Guershon,29,0,30,1
1649947377213,MATH 20B,A01,084124,Um; Ko Woon,31,0,35,4
1649947377213,MATH 20B,B01,084126,Um; Ko Woon,32,0,35,3
1649947383239,MATH 20C,A01,083446,Hammock; Frances H,17,0,30,13
1649947383239,MATH 20C,A02,083447,Hammock; Frances H,28,0,30,2
1649947383239,MATH 20C,A03,083448,Hammock; Frances H,30,0,30,0
1649947383239,MATH 20C,A04,083449,Hammock; Frances H,30,0,30,0
1649947383239,MATH 20C,B01,083451,Hammock; Frances H,25,0,30,5
1649947383239,MATH 20C,B02,083452,Hammock; Frances H,27,0,30,3
1649947383239,MATH 20C,B03,083453,Hammock; Frances H,26,0,30,4
1649947383239,MATH 20C,B04,083454,Hammock; Frances H,30,0,30,0
1649947389263,MATH 20D,A01,084128,Staff,26,0,30,4
1649947389263,MATH 20D,A02,084129,Staff,30,0,30,0
1649947389263,MATH 20D,A03,084130,Staff,29,0,30,1
1649947389263,MATH 20D,B01,084133,Staff,21,0,30,9
1649947389263,MATH 20D,B02,084134,Staff,27,0,30,3
1649947389263,MATH 20D,B03,084135,Staff,30,0,30,0
1649947395303,MATH 20E,A01,084138,Staff,22,0,30,8
1649947395303,MATH 20E,A02,084139,Staff,22,0,30,8
1649947395303,MATH 20E,A03,084140,Staff,23,0,30,7
1649947395303,MATH 20E,A04,084141,Staff,25,0,30,5
1649947401329,MATH 102,A01,084143,Harel; Guershon,16,0,30,14
1649947401329,MATH 102,A02,084144,Harel; Guershon,22,0,30,8
1649947407354,MATH 103B,A01,083456,Staff,0,8,30,30
1649947407354,MATH 103B,A02,083457,Staff,0,9,30,30
1649947413379,MATH 109,A01,084146,Salehi Golsefidy; Alireza,28,0,30,2
1649947413379,MATH 109,A02,084147,Salehi Golsefidy; Alireza,22,0,30,8
1649947419497,MATH 120A,A01,085445,Eggers; John Dietrich,20,0,35,15
1649947419497,MATH 120A,A02,085446,Eggers; John Dietrich,27,0,35,8
1649947425520,MATH 142B,A01,084149,Verstraete; Jacques Allan,0,10,30,30
1649947425520,MATH 142B,A02,084150,Verstraete; Jacques Allan,0,9,30,30
1649947431548,MATH 170A,A01,083459,Nie; Jiawang,0,2,30,30
1649947431548,MATH 170A,A02,083460,Nie; Jiawang,0,0,30,30
1649947431548,MATH 170A,A03,083461,Nie; Jiawang,7,0,30,23
1649947437587,MATH 193B,A01,083463,Staff,3,0,30,27
1649947437587,MATH 193B,A02,083464,Staff,10,0,30,20
1649947437587,MATH 193B,A03,083465,Staff,19,0,30,11
1649947443645,COGS 2,A01,083966,Boyle; Mary E. T.,18,0,30,12
1649947449692,COGS 9,A01,083968,Staff,41,0,60,19
1649947455719,COGS 14B,A01,083970,Staff,28,0,50,22
1649947461748,COGS 17,A01,092679,Staff,67,0,75,8
1649947467771,COGS 100,A01,083972,Staff,9,0,60,51
1649947479828,COGS 101C,A01,083976,Staff,19,0,30,11
1649947485853,COGS 102A,A01,083978,Johnson; Christine M.,17,0,30,13
1649947491879,COGS 107B,A01,083980,Staff,3,0,50,47
1649947497901,COGS 115,A01,083982,Staff,13,0,30,17
1649947503927,COGS 118B,A01,083367,Staff,0,11,40,40
1649947509957,COGS 172,A01,083984,Provenzano; Emily Kara,16,0,30,14
1649947515983,COGS 177,A00,083368,Staff,0,17,30,30
1649947522006,COGS 186,A01,083986,Staff,21,0,40,19
1649947528030,COGS 187A,A01,083988,Boyle; Mary E. T.,24,0,60,36
1649947534060,CSE 8A,A50,084003,Miranda; Gregory Joseph,0,0,15,15
1649947540084,CSE 11,A01,084005,Miranda; Gregory Joseph,22,0,55,33
1649947546193,CSE 20,A01,084007,Staff,9,0,20,11
1649947552226,CSE 21,A01,084009,Staff,10,0,50,40
1649947558252,CSE 30,A01,083370,Cao; Yingjun,0,20,40,40
1649947564278,CSE 100,A01,083372,Cao; Yingjun,0,23,40,40
1649947570316,CSE 101,A01,084011,Staff,0,49,40,40
1649947576347,CSE 141,A01,083374,Eldon; John,0,51,75,75
1649947582375,CSE 141L,A01,083376,Eldon; John,0,56,75,75
1649947588398,CSE 175,A01,084013,Kumar; Rakesh,22,0,25,3
1649947594422,CSE 190,A00,092508,Dubnov; Shlomo,15,0,15,0
1649947600446,ECE 5,A01,084049,Morris; Karcher William,15,0,20,5
1649947606480,ECE 100,A01,084051,Baghdadchi; Saharnaz,1,0,20,19
1649947606480,ECE 100,A02,091916,Baghdadchi; Saharnaz,16,0,20,4
1649947612504,ECE 101,A01,084053,Baghdadchi; Saharnaz,4,0,37,33
1649947612504,ECE 101,A02,084054,Baghdadchi; Saharnaz,33,0,37,4
1649947618531,ECE 107,A01,083390,Staff,28,0,40,12
1649947624554,ECE 148,A01,084056,Silberman; Jack,7,0,12,5
1649947630579,ECE 180,A00,083391,Abi Samra; Nicholas Camill,25,0,30,5
1649947630579,ECE 180,B00,083392,Abi Samra; Nicholas Camill,22,0,30,8
1649947636603,MATH 10B,A01,084110,Staff,8,0,30,22
1649947636603,MATH 10B,A02,084111,Staff,29,0,30,1
1649947636603,MATH 10B,A03,084112,Staff,28,0,30,2
1649947642629,MATH 10C,A01,083443,Staff,9,0,30,21
1649947642629,MATH 10C,A02,083444,Staff,16,0,30,14
1649947642629,MATH 10C,B01,084114,Staff,25,0,30,5
1649947642629,MATH 10C,B02,084115,Staff,29,0,30,1
1649947648652,MATH 18,A01,084117,Harel; Guershon,27,0,30,3
1649947648652,MATH 18,A02,084119,Harel; Guershon,29,0,30,1
1649947648652,MATH 18,A03,084120,Harel; Guershon,30,0,30,0
1649947648652,MATH 18,A04,084121,Harel; Guershon,29,0,30,1
1649947654677,MATH 20B,A01,084124,Um; Ko Woon,31,0,35,4
1649947654677,MATH 20B,B01,084126,Um; Ko Woon,32,0,35,3
1649947660703,MATH 20C,A01,083446,Hammock; Frances H,17,0,30,13
1649947660703,MATH 20C,A02,083447,Hammock; Frances H,28,0,30,2
1649947660703,MATH 20C,A03,083448,Hammock; Frances H,30,0,30,0
1649947660703,MATH 20C,A04,083449,Hammock; Frances H,30,0,30,0
1649947660703,MATH 20C,B01,083451,Hammock; Frances H,25,0,30,5
1649947660703,MATH 20C,B02,083452,Hammock; Frances H,27,0,30,3
1649947660703,MATH 20C,B03,083453,Hammock; Frances H,26,0,30,4
1649947660703,MATH 20C,B04,083454,Hammock; Frances H,30,0,30,0
1649947666725,MATH 20D,A01,084128,Staff,26,0,30,4
1649947666725,MATH 20D,A02,084129,Staff,30,0,30,0
1649947666725,MATH 20D,A03,084130,Staff,29,0,30,1
1649947666725,MATH 20D,B01,084133,Staff,21,0,30,9
1649947666725,MATH 20D,B02,084134,Staff,27,0,30,3
1649947666725,MATH 20D,B03,084135,Staff,30,0,30,0
1649947672750,MATH 20E,A01,084138,Staff,22,0,30,8
1649947672750,MATH 20E,A02,084139,Staff,22,0,30,8
1649947672750,MATH 20E,A03,084140,Staff,23,0,30,7
1649947672750,MATH 20E,A04,084141,Staff,25,0,30,5
1649947678781,MATH 102,A01,084143,Harel; Guershon,16,0,30,14
1649947678781,MATH 102,A02,084144,Harel; Guershon,22,0,30,8
1649947684809,MATH 103B,A01,083456,Staff,0,8,30,30
1649947684809,MATH 103B,A02,083457,Staff,0,9,30,30
1649947690834,MATH 109,A01,084146,Salehi Golsefidy; Alireza,28,0,30,2
1649947690834,MATH 109,A02,084147,Salehi Golsefidy; Alireza,22,0,30,8
1649947696856,MATH 120A,A01,085445,Eggers; John Dietrich,20,0,35,15
1649947696856,MATH 120A,A02,085446,Eggers; John Dietrich,27,0,35,8
1649947702885,MATH 142B,A01,084149,Verstraete; Jacques Allan,0,10,30,30
1649947702885,MATH 142B,A02,084150,Verstraete; Jacques Allan,0,9,30,30
1649947708924,MATH 170A,A01,083459,Nie; Jiawang,0,2,30,30
1649947708924,MATH 170A,A02,083460,Nie; Jiawang,0,0,30,30
1649947708924,MATH 170A,A03,083461,Nie; Jiawang,7,0,30,23
1649947714947,MATH 193B,A01,083463,Staff,3,0,30,27
1649947714947,MATH 193B,A02,083464,Staff,10,0,30,20
1649947714947,MATH 193B,A03,083465,Staff,19,0,30,11
1649947721009,COGS 2,A01,083966,Boyle; Mary E. T.,18,0,30,12
1649947727033,COGS 9,A01,083968,Staff,41,0,60,19
1649947733060,COGS 14B,A01,083970,Staff,28,0,50,22
1649947739083,COGS 17,A01,092679,Staff,67,0,75,8
1649947745111,COGS 100,A01,083972,Staff,9,0,60,51
1649947757161,COGS 101C,A01,083976,Staff,19,0,30,11
1649947763192,COGS 102A,A01,083978,Johnson; Christine M.,17,0,30,13
1649947769218,COGS 107B,A01,083980,Staff,3,0,50,47
1649947775243,COGS 115,A01,083982,Staff,13,0,30,17
1649947781267,COGS 118B,A01,083367,Staff,0,11,40,40
1649947787290,COGS 172,A01,083984,Provenzano; Emily Kara,16,0,30,14
1649947793315,COGS 177,A00,083368,Staff,0,17,30,30
1649947799338,COGS 186,A01,083986,Staff,21,0,40,19
1649947805363,COGS 187A,A01,083988,Boyle; Mary E. T.,24,0,60,36
1649947811386,CSE 8A,A50,084003,Miranda; Gregory Joseph,0,0,15,15
1649947817419,CSE 11,A01,084005,Miranda; Gregory Joseph,22,0,55,33
1649947823450,CSE 20,A01,084007,Staff,9,0,20,11
1649947829474,CSE 21,A01,084009,Staff,10,0,50,40
1649947835497,CSE 30,A01,083370,Cao; Yingjun,0,20,40,40
1649947841520,CSE 100,A01,083372,Cao; Yingjun,0,23,40,40
1649947847545,CSE 101,A01,084011,Staff,0,49,40,40
1649947853569,CSE 141,A01,083374,Eldon; John,0,51,75,75
1649947859596,CSE 141L,A01,083376,Eldon; John,0,56,75,75
1649947865620,CSE 175,A01,084013,Kumar; Rakesh,22,0,25,3
1649947871643,CSE 190,A00,092508,Dubnov; Shlomo,15,0,15,0
1649947877666,ECE 5,A01,084049,Morris; Karcher William,15,0,20,5
1649947883696,ECE 100,A01,084051,Baghdadchi; Saharnaz,1,0,20,19
1649947883696,ECE 100,A02,091916,Baghdadchi; Saharnaz,16,0,20,4
1649947889721,ECE 101,A01,084053,Baghdadchi; Saharnaz,4,0,37,33
1649947889721,ECE 101,A02,084054,Baghdadchi; Saharnaz,33,0,37,4
1649947895755,ECE 107,A01,083390,Staff,28,0,40,12
1649947901778,ECE 148,A01,084056,Silberman; Jack,7,0,12,5
1649947907809,ECE 180,A00,083391,Abi Samra; Nicholas Camill,25,0,30,5
1649947907809,ECE 180,B00,083392,Abi Samra; Nicholas Camill,22,0,30,8
1649947913834,MATH 10B,A01,084110,Staff,8,0,30,22
1649947913834,MATH 10B,A02,084111,Staff,29,0,30,1
1649947913834,MATH 10B,A03,084112,Staff,28,0,30,2
1649947919860,MATH 10C,A01,083443,Staff,9,0,30,21
1649947919860,MATH 10C,A02,083444,Staff,16,0,30,14
1649947919860,MATH 10C,B01,084114,Staff,25,0,30,5
1649947919860,MATH 10C,B02,084115,Staff,29,0,30,1
1649947925888,MATH 18,A01,084117,Harel; Guershon,27,0,30,3
1649947925888,MATH 18,A02,084119,Harel; Guershon,29,0,30,1
1649947925888,MATH 18,A03,084120,Harel; Guershon,30,0,30,0
1649947925888,MATH 18,A04,084121,Harel; Guershon,29,0,30,1
1649947931914,MATH 20B,A01,084124,Um; Ko Woon,31,0,35,4
1649947931914,MATH 20B,B01,084126,Um; Ko Woon,32,0,35,3
1649947937944,MATH 20C,A01,083446,Hammock; Frances H,17,0,30,13
1649947937944,MATH 20C,A02,083447,Hammock; Frances H,28,0,30,2
1649947937944,MATH 20C,A03,083448,Hammock; Frances H,30,0,30,0
1649947937944,MATH 20C,A04,083449,Hammock; Frances H,30,0,30,0
1649947937944,MATH 20C,B01,083451,Hammock; Frances H,25,0,30,5
1649947937944,MATH 20C,B02,083452,Hammock; Frances H,27,0,30,3
1649947937944,MATH 20C,B03,083453,Hammock; Frances H,26,0,30,4
1649947937944,MATH 20C,B04,083454,Hammock; Frances H,30,0,30,0
1649947943969,MATH 20D,A01,084128,Staff,26,0,30,4
1649947943969,MATH 20D,A02,084129,Staff,30,0,30,0
1649947943969,MATH 20D,A03,084130,Staff,29,0,30,1
1649947943969,MATH 20D,B01,084133,Staff,21,0,30,9
1649947943969,MATH 20D,B02,084134,Staff,27,0,30,3
1649947943969,MATH 20D,B03,084135,Staff,30,0,30,0
1649947949998,MATH 20E,A01,084138,Staff,22,0,30,8
1649947949998,MATH 20E,A02,084139,Staff,22,0,30,8
1649947949998,MATH 20E,A03,084140,Staff,23,0,30,7
1649947949998,MATH 20E,A04,084141,Staff,25,0,30,5
1649947956023,MATH 102,A01,084143,Harel; Guershon,16,0,30,14
1649947956023,MATH 102,A02,084144,Harel; Guershon,22,0,30,8
1649947962049,MATH 103B,A01,083456,Staff,0,8,30,30
1649947962049,MATH 103B,A02,083457,Staff,0,9,30,30
1649947968074,MATH 109,A01,084146,Salehi Golsefidy; Alireza,28,0,30,2
1649947968074,MATH 109,A02,084147,Salehi Golsefidy; Alireza,22,0,30,8
1649947974104,MATH 120A,A01,085445,Eggers; John Dietrich,20,0,35,15
1649947974104,MATH 120A,A02,085446,Eggers; John Dietrich,27,0,35,8
1649947980131,MATH 142B,A01,084149,Verstraete; Jacques Allan,0,10,30,30
1649947980131,MATH 142B,A02,084150,Verstraete; Jacques Allan,0,9,30,30
1649947986166,MATH 170A,A01,083459,Nie; Jiawang,0,2,30,30
1649947986166,MATH 170A,A02,083460,Nie; Jiawang,0,0,30,30
1649947986166,MATH 170A,A03,083461,Nie; Jiawang,7,0,30,23
1649947992190,MATH 193B,A01,083463,Staff,3,0,30,27
1649947992190,MATH 193B,A02,083464,Staff,10,0,30,20
1649947992190,MATH 193B,A03,083465,Staff,19,0,30,11
1649947998240,COGS 2,A01,083966,Boyle; Mary E. T.,18,0,30,12
1649948004267,COGS 9,A01,083968,Staff,41,0,60,19
1649948010379,COGS 14B,A01,083970,Staff,28,0,50,22
1649948016404,COGS 17,A01,092679,Staff,67,0,75,8
1649948022427,COGS 100,A01,083972,Staff,9,0,60,51
1649948034484,COGS 101C,A01,083976,Staff,19,0,30,11
1649948040507,COGS 102A,A01,083978,Johnson; Christine M.,17,0,30,13
1649948046532,COGS 107B,A01,083980,Staff,3,0,50,47
1649948052557,COGS 115,A01,083982,Staff,13,0,30,17
1649948058581,COGS 118B,A01,083367,Staff,0,11,40,40
1649948064610,COGS 172,A01,083984,Provenzano; Emily Kara,16,0,30,14
1649948070636,COGS 177,A00,083368,Staff,0,17,30,30
1649948076660,COGS 186,A01,083986,Staff,21,0,40,19
1649948082686,COGS 187A,A01,083988,Boyle; Mary E. T.,24,0,60,36
1649948088721,CSE 8A,A50,084003,Miranda; Gregory Joseph,0,0,15,15
1649948094759,CSE 11,A01,084005,Miranda; Gregory Joseph,22,0,55,33
1649948100787,CSE 20,A01,084007,Staff,9,0,20,11
1649948106813,CSE 21,A01,084009,Staff,10,0,50,40
1649948112839,CSE 30,A01,083370,Cao; Yingjun,0,20,40,40
1649948118863,CSE 100,A01,083372,Cao; Yingjun,0,23,40,40
1649948124891,CSE 101,A01,084011,Staff,0,49,40,40
1649948130915,CSE 141,A01,083374,Eldon; John,0,51,75,75
1649948136939,CSE 141L,A01,083376,Eldon; John,0,56,75,75
1649948142964,CSE 175,A01,084013,Kumar; Rakesh,22,0,25,3
1649948148990,CSE 190,A00,092508,Dubnov; Shlomo,15,0,15,0
1649948155017,ECE 5,A01,084049,Morris; Karcher William,15,0,20,5
1649948161041,ECE 100,A01,084051,Baghdadchi; Saharnaz,1,0,20,19
1649948161041,ECE 100,A02,091916,Baghdadchi; Saharnaz,16,0,20,4
1649948167070,ECE 101,A01,084053,Baghdadchi; Saharnaz,4,0,37,33
1649948167070,ECE 101,A02,084054,Baghdadchi; Saharnaz,33,0,37,4
1649948173100,ECE 107,A01,083390,Staff,28,0,40,12
1649948179125,ECE 148,A01,084056,Silberman; Jack,7,0,12,5
1649948185150,ECE 180,A00,083391,Abi Samra; Nicholas Camill,25,0,30,5
1649948185150,ECE 180,B00,083392,Abi Samra; Nicholas Camill,22,0,30,8
1649948191185,MATH 10B,A01,084110,Staff,8,0,30,22
1649948191185,MATH 10B,A02,084111,Staff,29,0,30,1
1649948191185,MATH 10B,A03,084112,Staff,28,0,30,2
1649948197208,MATH 10C,A01,083443,Staff,9,0,30,21
1649948197208,MATH 10C,A02,083444,Staff,16,0,30,14
1649948197208,MATH 10C,B01,084114,Staff,25,0,30,5
1649948197208,MATH 10C,B02,084115,Staff,29,0,30,1
1649948203233,MATH 18,A01,084117,Harel; Guershon,27,0,30,3
1649948203233,MATH 18,A02,084119,Harel; Guershon,29,0,30,1
1649948203233,MATH 18,A03,084120,Harel; Guershon,30,0,30,0
1649948203233,MATH 18,A04,084121,Harel; Guershon,29,0,30,1
1649948209256,MATH 20B,A01,084124,Um; Ko Woon,31,0,35,4
1649948209256,MATH 20B,B01,084126,Um; Ko Woon,32,0,35,3
1649948215283,MATH 20C,A01,083446,Hammock; Frances H,17,0,30,13
1649948215283,MATH 20C,A02,083447,Hammock; Frances H,28,0,30,2
1649948215283,MATH 20C,A03,083448,Hammock; Frances H,30,0,30,0
1649948215283,MATH 20C,A04,083449,Hammock; Frances H,30,0,30,0
1649948215283,MATH 20C,B01,083451,Hammock; Frances H,25,0,30,5
1649948215283,MATH 20C,B02,083452,Hammock; Frances H,27,0,30,3
1649948215283,MATH 20C,B03,083453,Hammock; Frances H,26,0,30,4
1649948215283,MATH 20C,B04,083454,Hammock; Frances H,30,0,30,0
1649948221309,MATH 20D,A01,084128,Staff,26,0,30,4
1649948221309,MATH 20D,A02,084129,Staff,30,0,30,0
1649948221309,MATH 20D,A03,084130,Staff,29,0,30,1
1649948221309,MATH 20D,B01,084133,Staff,21,0,30,9
1649948221309,MATH 20D,B02,084134,Staff,27,0,30,3
1649948221309,MATH 20D,B03,084135,Staff,30,0,30,0
1649948227334,MATH 20E,A01,084138,Staff,22,0,30,8
1649948227334,MATH 20E,A02,084139,Staff,22,0,30,8
1649948227334,MATH 20E,A03,084140,Staff,23,0,30,7
1649948227334,MATH 20E,A04,084141,Staff,25,0,30,5
1649948233358,MATH 102,A01,084143,Harel; Guershon,16,0,30,14
1649948233358,MATH 102,A02,084144,Harel; Guershon,22,0,30,8
1649948239381,MATH 103B,A01,083456,Staff,0,8,30,30
1649948239381,MATH 103B,A02,083457,Staff,0,9,30,30
1649948245409,MATH 109,A01,084146,Salehi Golsefidy; Alireza,28,0,30,2
1649948245409,MATH 109,A02,084147,Salehi Golsefidy; Alireza,22,0,30,8
1649948251436,MATH 120A,A01,085445,Eggers; John Dietrich,20,0,35,15
1649948251436,MATH 120A,A02,085446,Eggers; John Dietrich,27,0,35,8
1649948257461,MATH 142B,A01,084149,Verstraete; Jacques Allan,0,10,30,30
1649948257461,MATH 142B,A02,084150,Verstraete; Jacques Allan,0,9,30,30
1649948263492,MATH 170A,A01,083459,Nie; Jiawang,0,2,30,30
1649948263492,MATH 170A,A02,083460,Nie; Jiawang,0,0,30,30
1649948263492,MATH 170A,A03,083461,Nie; Jiawang,7,0,30,23
1649948269523,MATH 193B,A01,083463,Staff,3,0,30,27
1649948269523,MATH 193B,A02,083464,Staff,10,0,30,20
1649948269523,MATH 193B,A03,083465,Staff,19,0,30,11
1649948275577,COGS 2,A01,083966,Boyle; Mary E. T.,18,0,30,12
1649948281602,COGS 9,A01,083968,Staff,41,0,60,19
1649948287629,COGS 14B,A01,083970,Staff,28,0,50,22
1649948293653,COGS 17,A01,092679,Staff,67,0,75,8
1649948299680,COGS 100,A01,083972,Staff,9,0,60,51
1649948311728,COGS 101C,A01,083976,Staff,19,0,30,11
1649948317758,COGS 102A,A01,083978,Johnson; Christine M.,17,0,30,13
1649948323781,COGS 107B,A01,083980,Staff,3,0,50,47
1649948329806,COGS 115,A01,083982,Staff,13,0,30,17
1649948335829,COGS 118B,A01,083367,Staff,0,11,40,40
1649948341854,COGS 172,A01,083984,Provenzano; Emily Kara,16,0,30,14
1649948347880,COGS 177,A00,083368,Staff,0,17,30,30
1649948353906,COGS 186,A01,083986,Staff,21,0,40,19
1649948359943,COGS 187A,A01,083988,Boyle; Mary E. T.,24,0,60,36
1649948365968,CSE 8A,A50,084003,Miranda; Gregory Joseph,0,0,15,15
1649948371990,CSE 11,A01,084005,Miranda; Gregory Joseph,22,0,55,33
1649948378013,CSE 20,A01,084007,Staff,9,0,20,11
1649948384041,CSE 21,A01,084009,Staff,10,0,50,40
1649948390069,CSE 30,A01,083370,Cao; Yingjun,0,20,40,40
1649948396094,CSE 100,A01,083372,Cao; Yingjun,0,23,40,40
1649948402115,CSE 101,A01,084011,Staff,0,49,40,40
1649948408145,CSE 141,A01,083374,Eldon; John,0,52,75,75
1649948414181,CSE 141L,A01,083376,Eldon; John,0,56,75,75
1649948420209,CSE 175,A01,084013,Kumar; Rakesh,22,0,25,3
1649948426231,CSE 190,A00,092508,Dubnov; Shlomo,15,0,15,0
1649948432255,ECE 5,A01,084049,Morris; Karcher William,15,0,20,5
1649948438285,ECE 100,A01,084051,Baghdadchi; Saharnaz,1,0,20,19
1649948438285,ECE 100,A02,091916,Baghdadchi; Saharnaz,16,0,20,4
1649948444308,ECE 101,A01,084053,Baghdadchi; Saharnaz,4,0,37,33
1649948444308,ECE 101,A02,084054,Baghdadchi; Saharnaz,33,0,37,4
1649948450332,ECE 107,A01,083390,Staff,28,0,40,12
1649948456355,ECE 148,A01,084056,Silberman; Jack,7,0,12,5
1649948462382,ECE 180,A00,083391,Abi Samra; Nicholas Camill,25,0,30,5
1649948462382,ECE 180,B00,083392,Abi Samra; Nicholas Camill,22,0,30,8
1649948468405,MATH 10B,A01,084110,Staff,8,0,30,22
1649948468405,MATH 10B,A02,084111,Staff,29,0,30,1
1649948468405,MATH 10B,A03,084112,Staff,28,0,30,2
1649948474428,MATH 10C,A01,083443,Staff,9,0,30,21
1649948474428,MATH 10C,A02,083444,Staff,16,0,30,14
1649948474428,MATH 10C,B01,084114,Staff,25,0,30,5
1649948474428,MATH 10C,B02,084115,Staff,29,0,30,1
1649948480454,MATH 18,A01,084117,Harel; Guershon,27,0,30,3
1649948480454,MATH 18,A02,084119,Harel; Guershon,29,0,30,1
1649948480454,MATH 18,A03,084120,Harel; Guershon,30,0,30,0
1649948480454,MATH 18,A04,084121,Harel; Guershon,29,0,30,1
1649948486479,MATH 20B,A01,084124,Um; Ko Woon,31,0,35,4
1649948486479,MATH 20B,B01,084126,Um; Ko Woon,32,0,35,3
1649948492502,MATH 20C,A01,083446,Hammock; Frances H,17,0,30,13
1649948492502,MATH 20C,A02,083447,Hammock; Frances H,28,0,30,2
1649948492502,MATH 20C,A03,083448,Hammock; Frances H,30,0,30,0
1649948492502,MATH 20C,A04,083449,Hammock; Frances H,30,0,30,0
1649948492502,MATH 20C,B01,083451,Hammock; Frances H,25,0,30,5
1649948492502,MATH 20C,B02,083452,Hammock; Frances H,27,0,30,3
1649948492502,MATH 20C,B03,083453,Hammock; Frances H,26,0,30,4
1649948492502,MATH 20C,B04,083454,Hammock; Frances H,30,0,30,0
1649948498536,MATH 20D,A01,084128,Staff,26,0,30,4
1649948498536,MATH 20D,A02,084129,Staff,30,0,30,0
1649948498536,MATH 20D,A03,084130,Staff,29,0,30,1
1649948498536,MATH 20D,B01,084133,Staff,21,0,30,9
1649948498536,MATH 20D,B02,084134,Staff,27,0,30,3
1649948498536,MATH 20D,B03,084135,Staff,30,0,30,0
1649948504559,MATH 20E,A01,084138,Staff,22,0,30,8
1649948504559,MATH 20E,A02,084139,Staff,22,0,30,8
1649948504559,MATH 20E,A03,084140,Staff,23,0,30,7
1649948504559,MATH 20E,A04,084141,Staff,25,0,30,5
1649948510585,MATH 102,A01,084143,Harel; Guershon,16,0,30,14
1649948510585,MATH 102,A02,084144,Harel; Guershon,22,0,30,8
1649948516609,MATH 103B,A01,083456,Staff,0,8,30,30
1649948516609,MATH 103B,A02,083457,Staff,0,9,30,30
1649948522632,MATH 109,A01,084146,Salehi Golsefidy; Alireza,28,0,30,2
1649948522632,MATH 109,A02,084147,Salehi Golsefidy; Alireza,22,0,30,8
1649948528655,MATH 120A,A01,085445,Eggers; John Dietrich,20,0,35,15
1649948528655,MATH 120A,A02,085446,Eggers; John Dietrich,27,0,35,8
1649948534679,MATH 142B,A01,084149,Verstraete; Jacques Allan,0,10,30,30
1649948534679,MATH 142B,A02,084150,Verstraete; Jacques Allan,0,9,30,30
1649948540703,MATH 170A,A01,083459,Nie; Jiawang,0,2,30,30
1649948540703,MATH 170A,A02,083460,Nie; Jiawang,0,0,30,30
1649948540703,MATH 170A,A03,083461,Nie; Jiawang,7,0,30,23
1649948546731,MATH 193B,A01,083463,Staff,3,0,30,27
1649948546731,MATH 193B,A02,083464,Staff,10,0,30,20
1649948546731,MATH 193B,A03,083465,Staff,19,0,30,11
1649948552785,COGS 2,A01,083966,Boyle; Mary E. T.,18,0,30,12
1649948558817,COGS 9,A01,083968,Staff,39,0,60,21
1649948564841,COGS 14B,A01,083970,Staff,28,0,50,22
1649948570864,COGS 17,A01,092679,Staff,67,0,75,8
1649948576893,COGS 100,A01,083972,Staff,9,0,60,51
1649948588946,COGS 101C,A01,083976,Staff,19,0,30,11
1649948594975,COGS 102A,A01,083978,Johnson; Christine M.,17,0,30,13
1649948601006,COGS 107B,A01,083980,Staff,2,0,50,48
1649948607117,COGS 115,A01,083982,Staff,13,0,30,17
1649948613141,COGS 118B,A01,083367,Staff,0,11,40,40
1649948619168,COGS 172,A01,083984,Provenzano; Emily Kara,16,0,30,14
1649948625189,COGS 177,A00,083368,Staff,0,17,30,30
1649948631215,COGS 186,A01,083986,Staff,21,0,40,19
1649948637238,COGS 187A,A01,083988,Boyle; Mary E. T.,24,0,60,36
1649948643266,CSE 8A,A50,084003,Miranda; Gregory Joseph,0,0,15,15
1649948649288,CSE 11,A01,084005,Miranda; Gregory Joseph,22,0,55,33
1649948655331,CSE 20,A01,084007,Staff,9,0,20,11
1649948661354,CSE 21,A01,084009,Staff,10,0,50,40
1649948667381,CSE 30,A01,083370,Cao; Yingjun,0,20,40,40
1649948673403,CSE 100,A01,083372,Cao; Yingjun,0,24,40,40
1649948679438,CSE 101,A01,084011,Staff,0,49,40,40
1649948685461,CSE 141,A01,083374,Eldon; John,0,52,75,75
1649948691501,CSE 141L,A01,083376,Eldon; John,0,57,75,75
1649948697528,CSE 175,A01,084013,Kumar; Rakesh,22,0,25,3
1649948703552,CSE 190,A00,092508,Dubnov; Shlomo,15,0,15,0
1649948709580,ECE 5,A01,084049,Morris; Karcher William,15,0,20,5
1649948715608,ECE 100,A01,084051,Baghdadchi; Saharnaz,1,0,20,19
1649948715608,ECE 100,A02,091916,Baghdadchi; Saharnaz,16,0,20,4
1649948721635,ECE 101,A01,084053,Baghdadchi; Saharnaz,4,0,37,33
1649948721635,ECE 101,A02,084054,Baghdadchi; Saharnaz,33,0,37,4
1649948727657,ECE 107,A01,083390,Staff,28,0,40,12
1649948733681,ECE 148,A01,084056,Silberman; Jack,7,0,12,5
1649948739707,ECE 180,A00,083391,Abi Samra; Nicholas Camill,25,0,30,5
1649948739707,ECE 180,B00,083392,Abi Samra; Nicholas Camill,22,0,30,8
1649948745730,MATH 10B,A01,084110,Staff,8,0,30,22
1649948745730,MATH 10B,A02,084111,Staff,29,0,30,1
1649948745730,MATH 10B,A03,084112,Staff,28,0,30,2
1649948751754,MATH 10C,A01,083443,Staff,9,0,30,21
1649948751754,MATH 10C,A02,083444,Staff,16,0,30,14
1649948751754,MATH 10C,B01,084114,Staff,25,0,30,5
1649948751754,MATH 10C,B02,084115,Staff,29,0,30,1
1649948757783,MATH 18,A01,084117,Harel; Guershon,27,0,30,3
1649948757783,MATH 18,A02,084119,Harel; Guershon,29,0,30,1
1649948757783,MATH 18,A03,084120,Harel; Guershon,30,0,30,0
1649948757783,MATH 18,A04,084121,Harel; Guershon,29,0,30,1
1649948763806,MATH 20B,A01,084124,Um; Ko Woon,31,0,35,4
1649948763806,MATH 20B,B01,084126,Um; Ko Woon,32,0,35,3
1649948769838,MATH 20C,A01,083446,Hammock; Frances H,17,0,30,13
1649948769838,MATH 20C,A02,083447,Hammock; Frances H,28,0,30,2
1649948769838,MATH 20C,A03,083448,Hammock; Frances H,30,0,30,0
1649948769838,MATH 20C,A04,083449,Hammock; Frances H,30,0,30,0
1649948769838,MATH 20C,B01,083451,Hammock; Frances H,25,0,30,5
1649948769838,MATH 20C,B02,083452,Hammock; Frances H,27,0,30,3
1649948769838,MATH 20C,B03,083453,Hammock; Frances H,26,0,30,4
1649948769838,MATH 20C,B04,083454,Hammock; Frances H,30,0,30,0
1649948775862,MATH 20D,A01,084128,Staff,26,0,30,4
1649948775862,MATH 20D,A02,084129,Staff,30,0,30,0
1649948775862,MATH 20D,A03,084130,Staff,29,0,30,1
1649948775862,MATH 20D,B01,084133,Staff,21,0,30,9
1649948775862,MATH 20D,B02,084134,Staff,27,0,30,3
1649948775862,MATH 20D,B03,084135,Staff,30,0,30,0
1649948781889,MATH 20E,A01,084138,Staff,22,0,30,8
1649948781889,MATH 20E,A02,084139,Staff,22,0,30,8
1649948781889,MATH 20E,A03,084140,Staff,23,0,30,7
1649948781889,MATH 20E,A04,084141,Staff,25,0,30,5
1649948787916,MATH 102,A01,084143,Harel; Guershon,16,0,30,14
1649948787916,MATH 102,A02,084144,Harel; Guershon,22,0,30,8
1649948793942,MATH 103B,A01,083456,Staff,0,8,30,30
1649948793942,MATH 103B,A02,083457,Staff,0,9,30,30
1649948799969,MATH 109,A01,084146,Salehi Golsefidy; Alireza,28,0,30,2
1649948799969,MATH 109,A02,084147,Salehi Golsefidy; Alireza,22,0,30,8
1649948805993,MATH 120A,A01,085445,Eggers; John Dietrich,20,0,35,15
1649948805993,MATH 120A,A02,085446,Eggers; John Dietrich,27,0,35,8
1649948812018,MATH 142B,A01,084149,Verstraete; Jacques Allan,0,10,30,30
1649948812018,MATH 142B,A02,084150,Verstraete; Jacques Allan,0,9,30,30
1649948818046,MATH 170A,A01,083459,Nie; Jiawang,0,2,30,30
1649948818046,MATH 170A,A02,083460,Nie; Jiawang,0,0,30,30
1649948818046,MATH 170A,A03,083461,Nie; Jiawang,6,0,30,24
1649948824074,MATH 193B,A01,083463,Staff,3,0,30,27
1649948824074,MATH 193B,A02,083464,Staff,10,0,30,20
1649948824074,MATH 193B,A03,083465,Staff,19,0,30,11
1649948830138,COGS 2,A01,083966,Boyle; Mary E. T.,18,0,30,12
1649948836162,COGS 9,A01,083968,Staff,39,0,60,21
1649948842195,COGS 14B,A01,083970,Staff,28,0,50,22
1649948848223,COGS 17,A01,092679,Staff,67,0,75,8
1649948854252,COGS 100,A01,083972,Staff,9,0,60,51
1649948866306,COGS 101C,A01,083976,Staff,19,0,30,11
1649948872330,COGS 102A,A01,083978,Johnson; Christine M.,17,0,30,13
1649948878352,COGS 107B,A01,083980,Staff,2,0,50,48
1649948884379,COGS 115,A01,083982,Staff,13,0,30,17
1649948890402,COGS 118B,A01,083367,Staff,0,11,40,40
1649948896428,COGS 172,A01,083984,Provenzano; Emily Kara,16,0,30,14
1649948902461,COGS 177,A00,083368,Staff,0,17,30,30
1649948908488,COGS 186,A01,083986,Staff,21,0,40,19
1649948914514,COGS 187A,A01,083988,Boyle; Mary E. T.,24,0,60,36
1649948920537,CSE 8A,A50,084003,Miranda; Gregory Joseph,0,0,15,15
1649948926559,CSE 11,A01,084005,Miranda; Gregory Joseph,21,0,55,34
1649948932586,CSE 20,A01,084007,Staff,9,0,20,11
1649948938614,CSE 21,A01,084009,Staff,10,0,50,40
1649948944638,CSE 30,A01,083370,Cao; Yingjun,0,20,40,40
1649948950659,CSE 100,A01,083372,Cao; Yingjun,0,24,40,40
1649948956699,CSE 101,A01,084011,Staff,0,49,40,40
1649948962721,CSE 141,A01,083374,Eldon; John,0,52,75,75
1649948968749,CSE 141L,A01,083376,Eldon; John,0,57,75,75
1649948974773,CSE 175,A01,084013,Kumar; Rakesh,22,0,25,3
1649948980799,CSE 190,A00,092508,Dubnov; Shlomo,15,0,15,0
1649948986822,ECE 5,A01,084049,Morris; Karcher William,15,0,20,5
1649948992848,ECE 100,A01,084051,Baghdadchi; Saharnaz,1,0,20,19
1649948992848,ECE 100,A02,091916,Baghdadchi; Saharnaz,16,0,20,4
1649948998877,ECE 101,A01,084053,Baghdadchi; Saharnaz,4,0,37,33
1649948998877,ECE 101,A02,084054,Baghdadchi; Saharnaz,33,0,37,4
1649949004901,ECE 107,A01,083390,Staff,28,0,40,12
1649949010933,ECE 148,A01,084056,Silberman; Jack,7,0,12,5
1649949016958,ECE 180,A00,083391,Abi Samra; Nicholas Camill,25,0,30,5
1649949016958,ECE 180,B00,083392,Abi Samra; Nicholas Camill,22,0,30,8
1649949022981,MATH 10B,A01,084110,Staff,8,0,30,22
1649949022981,MATH 10B,A02,084111,Staff,29,0,30,1
1649949022981,MATH 10B,A03,084112,Staff,28,0,30,2
1649949029006,MATH 10C,A01,083443,Staff,9,0,30,21
1649949029006,MATH 10C,A02,083444,Staff,16,0,30,14
1649949029006,MATH 10C,B01,084114,Staff,25,0,30,5
1649949029006,MATH 10C,B02,084115,Staff,29,0,30,1
1649949035031,MATH 18,A01,084117,Harel; Guershon,27,0,30,3
1649949035031,MATH 18,A02,084119,Harel; Guershon,29,0,30,1
1649949035031,MATH 18,A03,084120,Harel; Guershon,30,0,30,0
1649949035031,MATH 18,A04,084121,Harel; Guershon,29,0,30,1
1649949041054,MATH 20B,A01,084124,Um; Ko Woon,31,0,35,4
1649949041054,MATH 20B,B01,084126,Um; Ko Woon,32,0,35,3
1649949047081,MATH 20C,A01,083446,Hammock; Frances H,17,0,30,13
1649949047081,MATH 20C,A02,083447,Hammock; Frances H,28,0,30,2
1649949047081,MATH 20C,A03,083448,Hammock; Frances H,30,0,30,0
1649949047081,MATH 20C,A04,083449,Hammock; Frances H,30,0,30,0
1649949047081,MATH 20C,B01,083451,Hammock; Frances H,25,0,30,5
1649949047081,MATH 20C,B02,083452,Hammock; Frances H,27,0,30,3
1649949047081,MATH 20C,B03,083453,Hammock; Frances H,26,0,30,4
1649949047081,MATH 20C,B04,083454,Hammock; Frances H,30,0,30,0
1649949053105,MATH 20D,A01,084128,Staff,26,0,30,4
1649949053105,MATH 20D,A02,084129,Staff,30,0,30,0
1649949053105,MATH 20D,A03,084130,Staff,29,0,30,1
1649949053105,MATH 20D,B01,084133,Staff,21,0,30,9
1649949053105,MATH 20D,B02,084134,Staff,27,0,30,3
1649949053105,MATH 20D,B03,084135,Staff,30,0,30,0
1649949059135,MATH 20E,A01,084138,Staff,22,0,30,8
1649949059135,MATH 20E,A02,084139,Staff,22,0,30,8
1649949059135,MATH 20E,A03,084140,Staff,23,0,30,7
1649949059135,MATH 20E,A04,084141,Staff,25,0,30,5
1649949065159,MATH 102,A01,084143,Harel; Guershon,16,0,30,14
1649949065159,MATH 102,A02,084144,Harel; Guershon,22,0,30,8
1649949071183,MATH 103B,A01,083456,Staff,0,8,30,30
1649949071183,MATH 103B,A02,083457,Staff,0,9,30,30
1649949077206,MATH 109,A01,084146,Salehi Golsefidy; Alireza,28,0,30,2
1649949077206,MATH 109,A02,084147,Salehi Golsefidy; Alireza,22,0,30,8
1649949083229,MATH 120A,A01,085445,Eggers; John Dietrich,20,0,35,15
1649949083229,MATH 120A,A02,085446,Eggers; John Dietrich,27,0,35,8
1649949089253,MATH 142B,A01,084149,Verstraete; Jacques Allan,0,10,30,30
1649949089253,MATH 142B,A02,084150,Verstraete; Jacques Allan,0,9,30,30
1649949095284,MATH 170A,A01,083459,Nie; Jiawang,0,2,30,30
1649949095284,MATH 170A,A02,083460,Nie; Jiawang,0,0,30,30
1649949095284,MATH 170A,A03,083461,Nie; Jiawang,5,0,30,25
1649949101308,MATH 193B,A01,083463,Staff,3,0,30,27
1649949101308,MATH 193B,A02,083464,Staff,10,0,30,20
1649949101308,MATH 193B,A03,083465,Staff,19,0,30,11
1649949107368,COGS 2,A01,083966,Boyle; Mary E. T.,18,0,30,12
1649949113400,COGS 9,A01,083968,Staff,39,0,60,21
1649949119427,COGS 14B,A01,083970,Staff,28,0,50,22
1649949125448,COGS 17,A01,092679,Staff,67,0,75,8
1649949131480,COGS 100,A01,083972,Staff,8,0,60,52
1649949143532,COGS 101C,A01,083976,Staff,19,0,30,11
1649949149559,COGS 102A,A01,083978,Johnson; Christine M.,17,0,30,13
1649949155585,COGS 107B,A01,083980,Staff,2,0,50,48
1649949161622,COGS 115,A01,083982,Staff,13,0,30,17
1649949167655,COGS 118B,A01,083367,Staff,0,11,40,40
1649949173683,COGS 172,A01,083984,Provenzano; Emily Kara,16,0,30,14
1649949179707,COGS 177,A00,083368,Staff,0,17,30,30
1649949185732,COGS 186,A01,083986,Staff,21,0,40,19
1649949191755,COGS 187A,A01,083988,Boyle; Mary E. T.,24,0,60,36
1649949197779,CSE 8A,A50,084003,Miranda; Gregory Joseph,0,0,15,15
1649949203922,CSE 11,A01,084005,Miranda; Gregory Joseph,20,0,55,35
1649949209944,CSE 20,A01,084007,Staff,9,0,20,11
1649949215971,CSE 21,A01,084009,Staff,10,0,50,40
1649949221995,CSE 30,A01,083370,Cao; Yingjun,0,20,40,40
1649949228022,CSE 100,A01,083372,Cao; Yingjun,0,24,40,40
1649949234047,CSE 101,A01,084011,Staff,0,49,40,40
1649949240070,CSE 141,A01,083374,Eldon; John,0,52,75,75
1649949246110,CSE 141L,A01,083376,Eldon; John,0,57,75,75
1649949252134,CSE 175,A01,084013,Kumar; Rakesh,22,0,25,3
1649949258160,CSE 190,A00,092508,Dubnov; Shlomo,15,0,15,0
1649949264183,ECE 5,A01,084049,Morris; Karcher William,15,0,20,5
1649949270209,ECE 100,A01,084051,Baghdadchi; Saharnaz,1,0,20,19
1649949270209,ECE 100,A02,091916,Baghdadchi; Saharnaz,16,0,20,4
1649949276231,ECE 101,A01,084053,Baghdadchi; Saharnaz,4,0,37,33
1649949276231,ECE 101,A02,084054,Baghdadchi; Saharnaz,33,0,37,4
1649949282256,ECE 107,A01,083390,Staff,28,0,40,12
1649949288279,ECE 148,A01,084056,Silberman; Jack,7,0,12,5
1649949294302,ECE 180,A00,083391,Abi Samra; Nicholas Camill,25,0,30,5
1649949294302,ECE 180,B00,083392,Abi Samra; Nicholas Camill,22,0,30,8
1649949300327,MATH 10B,A01,084110,Staff,8,0,30,22
1649949300327,MATH 10B,A02,084111,Staff,29,0,30,1
1649949300327,MATH 10B,A03,084112,Staff,28,0,30,2
1649949306350,MATH 10C,A01,083443,Staff,9,0,30,21
1649949306350,MATH 10C,A02,083444,Staff,16,0,30,14
1649949306350,MATH 10C,B01,084114,Staff,25,0,30,5
1649949306350,MATH 10C,B02,084115,Staff,29,0,30,1
1649949312374,MATH 18,A01,084117,Harel; Guershon,27,0,30,3
1649949312374,MATH 18,A02,084119,Harel; Guershon,29,0,30,1
1649949312374,MATH 18,A03,084120,Harel; Guershon,30,0,30,0
1649949312374,MATH 18,A04,084121,Harel; Guershon,29,0,30,1
1649949318403,MATH 20B,A01,084124,Um; Ko Woon,31,0,35,4
1649949318403,MATH 20B,B01,084126,Um; Ko Woon,32,0,35,3
1649949324432,MATH 20C,A01,083446,Hammock; Frances H,17,0,30,13
1649949324432,MATH 20C,A02,083447,Hammock; Frances H,28,0,30,2
1649949324432,MATH 20C,A03,083448,Hammock; Frances H,30,0,30,0
1649949324432,MATH 20C,A04,083449,Hammock; Frances H,30,0,30,0
1649949324432,MATH 20C,B01,083451,Hammock; Frances H,25,0,30,5
1649949324432,MATH 20C,B02,083452,Hammock; Frances H,27,0,30,3
1649949324432,MATH 20C,B03,083453,Hammock; Frances H,26,0,30,4
1649949324432,MATH 20C,B04,083454,Hammock; Frances H,30,0,30,0
1649949330460,MATH 20D,A01,084128,Staff,26,0,30,4
1649949330460,MATH 20D,A02,084129,Staff,30,0,30,0
1649949330460,MATH 20D,A03,084130,Staff,29,0,30,1
1649949330460,MATH 20D,B01,084133,Staff,21,0,30,9
1649949330460,MATH 20D,B02,084134,Staff,27,0,30,3
1649949330460,MATH 20D,B03,084135,Staff,30,0,30,0
1649949336482,MATH 20E,A01,084138,Staff,22,0,30,8
1649949336482,MATH 20E,A02,084139,Staff,22,0,30,8
1649949336482,MATH 20E,A03,084140,Staff,23,0,30,7
1649949336482,MATH 20E,A04,084141,Staff,25,0,30,5
1649949342517,MATH 102,A01,084143,Harel; Guershon,16,0,30,14
1649949342517,MATH 102,A02,084144,Harel; Guershon,22,0,30,8
1649949348539,MATH 103B,A01,083456,Staff,0,8,30,30
1649949348539,MATH 103B,A02,083457,Staff,0,9,30,30
1649949354562,MATH 109,A01,084146,Salehi Golsefidy; Alireza,28,0,30,2
1649949354562,MATH 109,A02,084147,Salehi Golsefidy; Alireza,22,0,30,8
1649949360589,MATH 120A,A01,085445,Eggers; John Dietrich,20,0,35,15
1649949360589,MATH 120A,A02,085446,Eggers; John Dietrich,27,0,35,8
1649949366613,MATH 142B,A01,084149,Verstraete; Jacques Allan,0,10,30,30
1649949366613,MATH 142B,A02,084150,Verstraete; Jacques Allan,0,9,30,30
1649949372636,MATH 170A,A01,083459,Nie; Jiawang,0,2,30,30
1649949372636,MATH 170A,A02,083460,Nie; Jiawang,0,0,30,30
1649949372636,MATH 170A,A03,083461,Nie; Jiawang,5,0,30,25
1649949378666,MATH 193B,A01,083463,Staff,3,0,30,27
1649949378666,MATH 193B,A02,083464,Staff,10,0,30,20
1649949378666,MATH 193B,A03,083465,Staff,19,0,30,11
1649949384715,COGS 2,A01,083966,Boyle; Mary E. T.,18,0,30,12
1649949390742,COGS 9,A01,083968,Staff,39,0,60,21
1649949396776,COGS 14B,A01,083970,Staff,28,0,50,22
1649949402809,COGS 17,A01,092679,Staff,67,0,75,8
1649949408832,COGS 100,A01,083972,Staff,8,0,60,52
1649949420898,COGS 101C,A01,083976,Staff,19,0,30,11
1649949426924,COGS 102A,A01,083978,Johnson; Christine M.,16,0,30,14
1649949432948,COGS 107B,A01,083980,Staff,2,0,50,48
1649949438977,COGS 115,A01,083982,Staff,13,0,30,17
1649949445002,COGS 118B,A01,083367,Staff,0,11,40,40
1649949451028,COGS 172,A01,083984,Provenzano; Emily Kara,16,0,30,14
1649949457053,COGS 177,A00,083368,Staff,0,17,30,30
1649949463077,COGS 186,A01,083986,Staff,21,0,40,19
1649949469103,COGS 187A,A01,083988,Boyle; Mary E. T.,24,0,60,36
1649949475137,CSE 8A,A50,084003,Miranda; Gregory Joseph,0,0,15,15
1649949481163,CSE 11,A01,084005,Miranda; Gregory Joseph,19,0,55,36
1649949487187,CSE 20,A01,084007,Staff,9,0,20,11
1649949493210,CSE 21,A01,084009,Staff,10,0,50,40
1649949499245,CSE 30,A01,083370,Cao; Yingjun,0,20,40,40
1649949505267,CSE 100,A01,083372,Cao; Yingjun,0,24,40,40
1649949511292,CSE 101,A01,084011,Staff,0,49,40,40
1649949517319,CSE 141,A01,083374,Eldon; John,0,52,75,75
1649949523354,CSE 141L,A01,083376,Eldon; John,0,57,75,75
1649949529384,CSE 175,A01,084013,Kumar; Rakesh,22,0,25,3
1649949535414,CSE 190,A00,092508,Dubnov; Shlomo,15,0,15,0
1649949541438,ECE 5,A01,084049,Morris; Karcher William,15,0,20,5
1649949547470,ECE 100,A01,084051,Baghdadchi; Saharnaz,1,0,20,19
1649949547470,ECE 100,A02,091916,Baghdadchi; Saharnaz,16,0,20,4
1649949553501,ECE 101,A01,084053,Baghdadchi; Saharnaz,4,0,37,33
1649949553501,ECE 101,A02,084054,Baghdadchi; Saharnaz,33,0,37,4
1649949559527,ECE 107,A01,083390,Staff,28,0,40,12
1649949565554,ECE 148,A01,084056,Silberman; Jack,7,0,12,5
1649949571576,ECE 180,A00,083391,Abi Samra; Nicholas Camill,25,0,30,5
1649949571576,ECE 180,B00,083392,Abi Samra; Nicholas Camill,22,0,30,8
1649949577604,MATH 10B,A01,084110,Staff,8,0,30,22
1649949577604,MATH 10B,A02,084111,Staff,29,0,30,1
1649949577604,MATH 10B,A03,084112,Staff,28,0,30,2
1649949583629,MATH 10C,A01,083443,Staff,9,0,30,21
1649949583629,MATH 10C,A02,083444,Staff,16,0,30,14
1649949583629,MATH 10C,B01,084114,Staff,25,0,30,5
1649949583629,MATH 10C,B02,084115,Staff,29,0,30,1
1649949589652,MATH 18,A01,084117,Harel; Guershon,27,0,30,3
1649949589652,MATH 18,A02,084119,Harel; Guershon,29,0,30,1
1649949589652,MATH 18,A03,084120,Harel; Guershon,30,0,30,0
1649949589652,MATH 18,A04,084121,Harel; Guershon,29,0,30,1
1649949595680,MATH 20B,A01,084124,Um; Ko Woon,31,0,35,4
1649949595680,MATH 20B,B01,084126,Um; Ko Woon,32,0,35,3
1649949601716,MATH 20C,A01,083446,Hammock; Frances H,17,0,30,13
1649949601716,MATH 20C,A02,083447,Hammock; Frances H,28,0,30,2
1649949601716,MATH 20C,A03,083448,Hammock; Frances H,30,0,30,0
1649949601716,MATH 20C,A04,083449,Hammock; Frances H,30,0,30,0
1649949601716,MATH 20C,B01,083451,Hammock; Frances H,25,0,30,5
1649949601716,MATH 20C,B02,083452,Hammock; Frances H,27,0,30,3
1649949601716,MATH 20C,B03,083453,Hammock; Frances H,26,0,30,4
1649949601716,MATH 20C,B04,083454,Hammock; Frances H,30,0,30,0
1649949607753,MATH 20D,A01,084128,Staff,26,0,30,4
1649949607753,MATH 20D,A02,084129,Staff,30,0,30,0
1649949607753,MATH 20D,A03,084130,Staff,29,0,30,1
1649949607753,MATH 20D,B01,084133,Staff,21,0,30,9
1649949607753,MATH 20D,B02,084134,Staff,27,0,30,3
1649949607753,MATH 20D,B03,084135,Staff,30,0,30,0
1649949613775,MATH 20E,A01,084138,Staff,22,0,30,8
1649949613775,MATH 20E,A02,084139,Staff,22,0,30,8
1649949613775,MATH 20E,A03,084140,Staff,23,0,30,7
1649949613775,MATH 20E,A04,084141,Staff,25,0,30,5
1649949619816,MATH 102,A01,084143,Harel; Guershon,16,0,30,14
1649949619816,MATH 102,A02,084144,Harel; Guershon,21,0,30,9
1649949625849,MATH 103B,A01,083456,Staff,0,8,30,30
1649949625849,MATH 103B,A02,083457,Staff,0,9,30,30
1649949631887,MATH 109,A01,084146,Salehi Golsefidy; Alireza,28,0,30,2
1649949631887,MATH 109,A02,084147,Salehi Golsefidy; Alireza,22,0,30,8
1649949637914,MATH 120A,A01,085445,Eggers; John Dietrich,20,0,35,15
1649949637914,MATH 120A,A02,085446,Eggers; John Dietrich,27,0,35,8
1649949643941,MATH 142B,A01,084149,Verstraete; Jacques Allan,0,10,30,30
1649949643941,MATH 142B,A02,084150,Verstraete; Jacques Allan,0,9,30,30
1649949649964,MATH 170A,A01,083459,Nie; Jiawang,0,2,30,30
1649949649964,MATH 170A,A02,083460,Nie; Jiawang,0,0,30,30
1649949649964,MATH 170A,A03,083461,Nie; Jiawang,5,0,30,25
1649949655988,MATH 193B,A01,083463,Staff,3,0,30,27
1649949655988,MATH 193B,A02,083464,Staff,10,0,30,20
1649949655988,MATH 193B,A03,083465,Staff,19,0,30,11
1649949662048,COGS 2,A01,083966,Boyle; Mary E. T.,18,0,30,12
1649949668071,COGS 9,A01,083968,Staff,39,0,60,21
1649949674095,COGS 14B,A01,083970,Staff,28,0,50,22
1649949680118,COGS 17,A01,092679,Staff,66,0,75,9
1649949686154,COGS 100,A01,083972,Staff,8,0,60,52
1649949698202,COGS 101C,A01,083976,Staff,19,0,30,11
1649949704226,COGS 102A,A01,083978,Johnson; Christine M.,16,0,30,14
1649949710249,COGS 107B,A01,083980,Staff,2,0,50,48
1649949716275,COGS 115,A01,083982,Staff,13,0,30,17
1649949722302,COGS 118B,A01,083367,Staff,0,11,40,40
1649949728330,COGS 172,A01,083984,Provenzano; Emily Kara,16,0,30,14
1649949734356,COGS 177,A00,083368,Staff,0,17,30,30
1649949740379,COGS 186,A01,083986,Staff,21,0,40,19
1649949746408,COGS 187A,A01,083988,Boyle; Mary E. T.,24,0,60,36
1649949752436,CSE 8A,A50,084003,Miranda; Gregory Joseph,0,0,15,15
1649949758467,CSE 11,A01,084005,Miranda; Gregory Joseph,19,0,55,36
1649949764490,CSE 20,A01,084007,Staff,9,0,20,11
1649949770514,CSE 21,A01,084009,Staff,10,0,50,40
1649949776541,CSE 30,A01,083370,Cao; Yingjun,0,20,40,40
1649949782567,CSE 100,A01,083372,Cao; Yingjun,0,26,40,40
1649949788593,CSE 101,A01,084011,Staff,0,50,40,40
1649949794618,CSE 141,A01,083374,Eldon; John,0,52,75,75
1649949800742,CSE 141L,A01,083376,Eldon; John,0,57,75,75
1649949806771,CSE 175,A01,084013,Kumar; Rakesh,22,0,25,3
1649949812794,CSE 190,A00,092508,Dubnov; Shlomo,15,0,15,0
1649949818819,ECE 5,A01,084049,Morris; Karcher William,15,0,20,5
1649949824853,ECE 100,A01,084051,Baghdadchi; Saharnaz,0,0,20,20
1649949824853,ECE 100,A02,091916,Baghdadchi; Saharnaz,16,0,20,4
1649949830875,ECE 101,A01,084053,Baghdadchi; Saharnaz,4,0,37,33
1649949830875,ECE 101,A02,084054,Baghdadchi; Saharnaz,33,0,37,4
1649949836905,ECE 107,A01,083390,Staff,28,0,40,12
1649949842930,ECE 148,A01,084056,Silberman; Jack,7,0,12,5
1649949848963,ECE 180,A00,083391,Abi Samra; Nicholas Camill,25,0,30,5
1649949848963,ECE 180,B00,083392,Abi Samra; Nicholas Camill,22,0,30,8
1649949854993,MATH 10B,A01,084110,Staff,8,0,30,22
1649949854993,MATH 10B,A02,084111,Staff,29,0,30,1
1649949854993,MATH 10B,A03,084112,Staff,28,0,30,2
1649949861021,MATH 10C,A01,083443,Staff,9,0,30,21
1649949861021,MATH 10C,A02,083444,Staff,16,0,30,14
1649949861021,MATH 10C,B01,084114,Staff,25,0,30,5
1649949861021,MATH 10C,B02,084115,Staff,29,0,30,1
1649949867050,MATH 18,A01,084117,Harel; Guershon,27,0,30,3
1649949867050,MATH 18,A02,084119,Harel; Guershon,29,0,30,1
1649949867050,MATH 18,A03,084120,Harel; Guershon,30,0,30,0
1649949867050,MATH 18,A04,084121,Harel; Guershon,29,0,30,1
1649949873079,MATH 20B,A01,084124,Um; Ko Woon,31,0,35,4
1649949873079,MATH 20B,B01,084126,Um; Ko Woon,32,0,35,3
1649949879107,MATH 20C,A01,083446,Hammock; Frances H,17,0,30,13
1649949879107,MATH 20C,A02,083447,Hammock; Frances H,28,0,30,2
1649949879107,MATH 20C,A03,083448,Hammock; Frances H,30,0,30,0
1649949879107,MATH 20C,A04,083449,Hammock; Frances H,30,0,30,0
1649949879107,MATH 20C,B01,083451,Hammock; Frances H,25,0,30,5
1649949879107,MATH 20C,B02,083452,Hammock; Frances H,27,0,30,3
1649949879107,MATH 20C,B03,083453,Hammock; Frances H,26,0,30,4
1649949879107,MATH 20C,B04,083454,Hammock; Frances H,30,0,30,0
1649949885135,MATH 20D,A01,084128,Staff,26,0,30,4
1649949885135,MATH 20D,A02,084129,Staff,30,0,30,0
1649949885135,MATH 20D,A03,084130,Staff,29,0,30,1
1649949885135,MATH 20D,B01,084133,Staff,21,0,30,9
1649949885135,MATH 20D,B02,084134,Staff,27,0,30,3
1649949885135,MATH 20D,B03,084135,Staff,30,0,30,0
1649949891161,MATH 20E,A01,084138,Staff,22,0,30,8
1649949891161,MATH 20E,A02,084139,Staff,22,0,30,8
1649949891161,MATH 20E,A03,084140,Staff,23,0,30,7
1649949891161,MATH 20E,A04,084141,Staff,25,0,30,5
1649949897187,MATH 102,A01,084143,Harel; Guershon,16,0,30,14
1649949897187,MATH 102,A02,084144,Harel; Guershon,21,0,30,9
1649949903215,MATH 103B,A01,083456,Staff,0,8,30,30
1649949903215,MATH 103B,A02,083457,Staff,0,9,30,30
1649949909238,MATH 109,A01,084146,Salehi Golsefidy; Alireza,28,0,30,2
1649949909238,MATH 109,A02,084147,Salehi Golsefidy; Alireza,22,0,30,8
1649949915261,MATH 120A,A01,085445,Eggers; John Dietrich,20,0,35,15
1649949915261,MATH 120A,A02,085446,Eggers; John Dietrich,27,0,35,8
1649949921288,MATH 142B,A01,084149,Verstraete; Jacques Allan,0,10,30,30
1649949921288,MATH 142B,A02,084150,Verstraete; Jacques Allan,0,9,30,30
1649949927315,MATH 170A,A01,083459,Nie; Jiawang,0,2,30,30
1649949927315,MATH 170A,A02,083460,Nie; Jiawang,0,0,30,30
1649949927315,MATH 170A,A03,083461,Nie; Jiawang,5,0,30,25
1649949933340,MATH 193B,A01,083463,Staff,3,0,30,27
1649949933340,MATH 193B,A02,083464,Staff,10,0,30,20
1649949933340,MATH 193B,A03,083465,Staff,19,0,30,11
1649949939404,COGS 2,A01,083966,Boyle; Mary E. T.,18,0,30,12
1649949945428,COGS 9,A01,083968,Staff,39,0,60,21
1649949951462,COGS 14B,A01,083970,Staff,28,0,50,22
1649949957490,COGS 17,A01,092679,Staff,66,0,75,9
1649949963515,COGS 100,A01,083972,Staff,8,0,60,52
1649949975573,COGS 101C,A01,083976,Staff,19,0,30,11
1649949981603,COGS 102A,A01,083978,Johnson; Christine M.,16,0,30,14
1649949987638,COGS 107B,A01,083980,Staff,2,0,50,48
1649949993661,COGS 115,A01,083982,Staff,13,0,30,17
1649949999685,COGS 118B,A01,083367,Staff,0,11,40,40
1649950005724,COGS 172,A01,083984,Provenzano; Emily Kara,16,0,30,14
1649950011746,COGS 177,A00,083368,Staff,0,17,30,30
1649950017769,COGS 186,A01,083986,Staff,21,0,40,19
1649950023794,COGS 187A,A01,083988,Boyle; Mary E. T.,24,0,60,36
1649950029821,CSE 8A,A50,084003,Miranda; Gregory Joseph,0,0,15,15
1649950035847,CSE 11,A01,084005,Miranda; Gregory Joseph,18,0,55,37
1649950041870,CSE 20,A01,084007,Staff,9,0,20,11
1649950047897,CSE 21,A01,084009,Staff,10,0,50,40
1649950053928,CSE 30,A01,083370,Cao; Yingjun,0,20,40,40
1649950059951,CSE 100,A01,083372,Cao; Yingjun,0,26,40,40
1649950065973,CSE 101,A01,084011,Staff,0,50,40,40
1649950071999,CSE 141,A01,083374,Eldon; John,0,52,75,75
1649950078039,CSE 141L,A01,083376,Eldon; John,0,57,75,75
1649950084063,CSE 175,A01,084013,Kumar; Rakesh,22,0,25,3
1649950090090,CSE 190,A00,092508,Dubnov; Shlomo,15,0,15,0
1649950096119,ECE 5,A01,084049,Morris; Karcher William,15,0,20,5
1649950102145,ECE 100,A01,084051,Baghdadchi; Saharnaz,0,0,20,20
1649950102145,ECE 100,A02,091916,Baghdadchi; Saharnaz,16,0,20,4
1649950108172,ECE 101,A01,084053,Baghdadchi; Saharnaz,4,0,37,33
1649950108172,ECE 101,A02,084054,Baghdadchi; Saharnaz,33,0,37,4
1649950114205,ECE 107,A01,083390,Staff,28,0,40,12
1649950120229,ECE 148,A01,084056,Silberman; Jack,7,0,12,5
1649950126257,ECE 180,A00,083391,Abi Samra; Nicholas Camill,25,0,30,5
1649950126257,ECE 180,B00,083392,Abi Samra; Nicholas Camill,22,0,30,8
1649950132282,MATH 10B,A01,084110,Staff,8,0,30,22
1649950132282,MATH 10B,A02,084111,Staff,29,0,30,1
1649950132282,MATH 10B,A03,084112,Staff,28,0,30,2
1649950138314,MATH 10C,A01,083443,Staff,9,0,30,21
1649950138314,MATH 10C,A02,083444,Staff,16,0,30,14
1649950138314,MATH 10C,B01,084114,Staff,25,0,30,5
1649950138314,MATH 10C,B02,084115,Staff,29,0,30,1
1649950144345,MATH 18,A01,084117,Harel; Guershon,27,0,30,3
1649950144345,MATH 18,A02,084119,Harel; Guershon,29,0,30,1
1649950144345,MATH 18,A03,084120,Harel; Guershon,30,0,30,0
1649950144345,MATH 18,A04,084121,Harel; Guershon,29,0,30,1
1649950150368,MATH 20B,A01,084124,Um; Ko Woon,31,0,35,4
1649950150368,MATH 20B,B01,084126,Um; Ko Woon,32,0,35,3
1649950156393,MATH 20C,A01,083446,Hammock; Frances H,17,0,30,13
1649950156393,MATH 20C,A02,083447,Hammock; Frances H,28,0,30,2
1649950156393,MATH 20C,A03,083448,Hammock; Frances H,30,0,30,0
1649950156393,MATH 20C,A04,083449,Hammock; Frances H,30,0,30,0
1649950156393,MATH 20C,B01,083451,Hammock; Frances H,25,0,30,5
1649950156393,MATH 20C,B02,083452,Hammock; Frances H,27,0,30,3
1649950156393,MATH 20C,B03,083453,Hammock; Frances H,26,0,30,4
1649950156393,MATH 20C,B04,083454,Hammock; Frances H,30,0,30,0
1649950162419,MATH 20D,A01,084128,Staff,25,0,30,5
1649950162419,MATH 20D,A02,084129,Staff,30,0,30,0
1649950162419,MATH 20D,A03,084130,Staff,29,0,30,1
1649950162419,MATH 20D,B01,084133,Staff,21,0,30,9
1649950162419,MATH 20D,B02,084134,Staff,27,0,30,3
1649950162419,MATH 20D,B03,084135,Staff,30,0,30,0
1649950168442,MATH 20E,A01,084138,Staff,22,0,30,8
1649950168442,MATH 20E,A02,084139,Staff,22,0,30,8
1649950168442,MATH 20E,A03,084140,Staff,23,0,30,7
1649950168442,MATH 20E,A04,084141,Staff,25,0,30,5
1649950174465,MATH 102,A01,084143,Harel; Guershon,16,0,30,14
1649950174465,MATH 102,A02,084144,Harel; Guershon,21,0,30,9
1649950180487,MATH 103B,A01,083456,Staff,0,8,30,30
1649950180487,MATH 103B,A02,083457,Staff,0,9,30,30
1649950186511,MATH 109,A01,084146,Salehi Golsefidy; Alireza,28,0,30,2
1649950186511,MATH 109,A02,084147,Salehi Golsefidy; Alireza,22,0,30,8
1649950192536,MATH 120A,A01,085445,Eggers; John Dietrich,20,0,35,15
1649950192536,MATH 120A,A02,085446,Eggers; John Dietrich,27,0,35,8
1649950198560,MATH 142B,A01,084149,Verstraete; Jacques Allan,0,10,30,30
1649950198560,MATH 142B,A02,084150,Verstraete; Jacques Allan,0,9,30,30
1649950204589,MATH 170A,A01,083459,Nie; Jiawang,0,2,30,30
1649950204589,MATH 170A,A02,083460,Nie; Jiawang,0,0,30,30
1649950204589,MATH 170A,A03,083461,Nie; Jiawang,5,0,30,25
1649950210616,MATH 193B,A01,083463,Staff,3,0,30,27
1649950210616,MATH 193B,A02,083464,Staff,10,0,30,20
1649950210616,MATH 193B,A03,083465,Staff,19,0,30,11
1649950216669,COGS 2,A01,083966,Boyle; Mary E. T.,18,0,30,12
1649950222700,COGS 9,A01,083968,Staff,39,0,60,21
1649950228723,COGS 14B,A01,083970,Staff,28,0,50,22
1649950234756,COGS 17,A01,092679,Staff,66,0,75,9
1649950240784,COGS 100,A01,083972,Staff,8,0,60,52
1649950252829,COGS 101C,A01,083976,Staff,19,0,30,11
1649950258862,COGS 102A,A01,083978,Johnson; Christine M.,16,0,30,14
1649950264883,COGS 107B,A01,083980,Staff,2,0,50,48
1649950270906,COGS 115,A01,083982,Staff,13,0,30,17
1649950276927,COGS 118B,A01,083367,Staff,0,11,40,40
1649950282952,COGS 172,A01,083984,Provenzano; Emily Kara,16,0,30,14
1649950288979,COGS 177,A00,083368,Staff,0,17,30,30
1649950295005,COGS 186,A01,083986,Staff,21,0,40,19
1649950301029,COGS 187A,A01,083988,Boyle; Mary E. T.,24,0,60,36
1649950307055,CSE 8A,A50,084003,Miranda; Gregory Joseph,0,1,15,15
1649950313078,CSE 11,A01,084005,Miranda; Gregory Joseph,18,0,55,37
1649950319106,CSE 20,A01,084007,Staff,9,0,20,11
1649950325127,CSE 21,A01,084009,Staff,10,0,50,40
1649950331152,CSE 30,A01,083370,Cao; Yingjun,0,20,40,40
1649950337174,CSE 100,A01,083372,Cao; Yingjun,0,26,40,40
1649950343196,CSE 101,A01,084011,Staff,0,50,40,40
1649950349219,CSE 141,A01,083374,Eldon; John,0,52,75,75
1649950355244,CSE 141L,A01,083376,Eldon; John,0,57,75,75
1649950361266,CSE 175,A01,084013,Kumar; Rakesh,22,0,25,3
1649950367294,CSE 190,A00,092508,Dubnov; Shlomo,15,0,15,0
1649950373318,ECE 5,A01,084049,Morris; Karcher William,15,0,20,5
1649950379343,ECE 100,A01,084051,Baghdadchi; Saharnaz,0,0,20,20
1649950379343,ECE 100,A02,091916,Baghdadchi; Saharnaz,16,0,20,4
1649950385366,ECE 101,A01,084053,Baghdadchi; Saharnaz,4,0,37,33
1649950385366,ECE 101,A02,084054,Baghdadchi; Saharnaz,32,0,37,5
1649950391389,ECE 107,A01,083390,Staff,28,0,40,12
1649950397508,ECE 148,A01,084056,Silberman; Jack,7,0,12,5
1649950403543,ECE 180,A00,083391,Abi Samra; Nicholas Camill,25,0,30,5
1649950403543,ECE 180,B00,083392,Abi Samra; Nicholas Camill,22,0,30,8
1649950409585,MATH 10B,A01,084110,Staff,8,0,30,22
1649950409585,MATH 10B,A02,084111,Staff,29,0,30,1
1649950409585,MATH 10B,A03,084112,Staff,28,0,30,2
1649950415613,MATH 10C,A01,083443,Staff,9,0,30,21
1649950415613,MATH 10C,A02,083444,Staff,16,0,30,14
1649950415613,MATH 10C,B01,084114,Staff,25,0,30,5
1649950415613,MATH 10C,B02,084115,Staff,29,0,30,1
1649950421705,MATH 18,A01,084117,Harel; Guershon,27,0,30,3
1649950421705,MATH 18,A02,084119,Harel; Guershon,29,0,30,1
1649950421705,MATH 18,A03,084120,Harel; Guershon,30,0,30,0
1649950421705,MATH 18,A04,084121,Harel; Guershon,29,0,30,1
1649950427727,MATH 20B,A01,084124,Um; Ko Woon,31,0,35,4
1649950427727,MATH 20B,B01,084126,Um; Ko Woon,32,0,35,3
1649950433756,MATH 20C,A01,083446,Hammock; Frances H,17,0,30,13
1649950433756,MATH 20C,A02,083447,Hammock; Frances H,28,0,30,2
1649950433756,MATH 20C,A03,083448,Hammock; Frances H,30,0,30,0
1649950433756,MATH 20C,A04,083449,Hammock; Frances H,30,0,30,0
1649950433756,MATH 20C,B01,083451,Hammock; Frances H,25,0,30,5
1649950433756,MATH 20C,B02,083452,Hammock; Frances H,27,0,30,3
1649950433756,MATH 20C,B03,083453,Hammock; Frances H,26,0,30,4
1649950433756,MATH 20C,B04,083454,Hammock; Frances H,30,0,30,0
1649950439783,MATH 20D,A01,084128,Staff,25,0,30,5
1649950439783,MATH 20D,A02,084129,Staff,30,0,30,0
1649950439783,MATH 20D,A03,084130,Staff,29,0,30,1
1649950439783,MATH 20D,B01,084133,Staff,20,0,30,10
1649950439783,MATH 20D,B02,084134,Staff,27,0,30,3
1649950439783,MATH 20D,B03,084135,Staff,30,0,30,0
1649950445813,MATH 20E,A01,084138,Staff,22,0,30,8
1649950445813,MATH 20E,A02,084139,Staff,22,0,30,8
1649950445813,MATH 20E,A03,084140,Staff,23,0,30,7
1649950445813,MATH 20E,A04,084141,Staff,25,0,30,5
1649950451840,MATH 102,A01,084143,Harel; Guershon,16,0,30,14
1649950451840,MATH 102,A02,084144,Harel; Guershon,21,0,30,9
1649950457879,MATH 103B,A01,083456,Staff,0,8,30,30
1649950457879,MATH 103B,A02,083457,Staff,0,9,30,30
1649950463906,MATH 109,A01,084146,Salehi Golsefidy; Alireza,28,0,30,2
1649950463906,MATH 109,A02,084147,Salehi Golsefidy; Alireza,22,0,30,8
1649950469944,MATH 120A,A01,085445,Eggers; John Dietrich,20,0,35,15
1649950469944,MATH 120A,A02,085446,Eggers; John Dietrich,27,0,35,8
1649950475974,MATH 142B,A01,084149,Verstraete; Jacques Allan,0,10,30,30
1649950475974,MATH 142B,A02,084150,Verstraete; Jacques Allan,0,9,30,30
1649950482015,MATH 170A,A01,083459,Nie; Jiawang,0,2,30,30
1649950482015,MATH 170A,A02,083460,Nie; Jiawang,0,0,30,30
1649950482015,MATH 170A,A03,083461,Nie; Jiawang,4,0,30,26
1649950488045,MATH 193B,A01,083463,Staff,3,0,30,27
1649950488045,MATH 193B,A02,083464,Staff,10,0,30,20
1649950488045,MATH 193B,A03,083465,Staff,19,0,30,11
1649950494129,COGS 2,A01,083966,Boyle; Mary E. T.,18,0,30,12
1649950500155,COGS 9,A01,083968,Staff,39,0,60,21
1649950506180,COGS 14B,A01,083970,Staff,28,0,50,22
1649950512201,COGS 17,A01,092679,Staff,66,0,75,9
1649950518224,COGS 100,A01,083972,Staff,8,0,60,52
1649950530269,COGS 101C,A01,083976,Staff,19,0,30,11
1649950536295,COGS 102A,A01,083978,Johnson; Christine M.,16,0,30,14
1649950542317,COGS 107B,A01,083980,Staff,2,0,50,48
1649950548338,COGS 115,A01,083982,Staff,13,0,30,17
1649950554372,COGS 118B,A01,083367,Staff,0,11,40,40
1649950560398,COGS 172,A01,083984,Provenzano; Emily Kara,16,0,30,14
1649950566421,COGS 177,A00,083368,Staff,0,17,30,30
1649950572446,COGS 186,A01,083986,Staff,21,0,40,19
1649950578476,COGS 187A,A01,083988,Boyle; Mary E. T.,24,0,60,36
1649950584504,CSE 8A,A50,084003,Miranda; Gregory Joseph,0,1,15,15
1649950590526,CSE 11,A01,084005,Miranda; Gregory Joseph,18,0,55,37
1649950596555,CSE 20,A01,084007,Staff,9,0,20,11
1649950602578,CSE 21,A01,084009,Staff,10,0,50,40
1649950608601,CSE 30,A01,083370,Cao; Yingjun,0,21,40,40
1649950614624,CSE 100,A01,083372,Cao; Yingjun,0,26,40,40
1649950620658,CSE 101,A01,084011,Staff,0,50,40,40
1649950626682,CSE 141,A01,083374,Eldon; John,0,52,75,75
1649950632706,CSE 141L,A01,083376,Eldon; John,0,57,75,75
1649950638730,CSE 175,A01,084013,Kumar; Rakesh,22,0,25,3
1649950644754,CSE 190,A00,092508,Dubnov; Shlomo,15,0,15,0
1649950650781,ECE 5,A01,084049,Morris; Karcher William,15,0,20,5
1649950656804,ECE 100,A01,084051,Baghdadchi; Saharnaz,0,0,20,20
1649950656804,ECE 100,A02,091916,Baghdadchi; Saharnaz,16,0,20,4
1649950662827,ECE 101,A01,084053,Baghdadchi; Saharnaz,4,0,37,33
1649950662827,ECE 101,A02,084054,Baghdadchi; Saharnaz,32,0,37,5
1649950668850,ECE 107,A01,083390,Staff,28,0,40,12
1649950674873,ECE 148,A01,084056,Silberman; Jack,7,0,12,5
1649950680896,ECE 180,A00,083391,Abi Samra; Nicholas Camill,25,0,30,5
1649950680896,ECE 180,B00,083392,Abi Samra; Nicholas Camill,22,0,30,8
1649950686919,MATH 10B,A01,084110,Staff,8,0,30,22
1649950686919,MATH 10B,A02,084111,Staff,29,0,30,1
1649950686919,MATH 10B,A03,084112,Staff,28,0,30,2
1649950692942,MATH 10C,A01,083443,Staff,9,0,30,21
1649950692942,MATH 10C,A02,083444,Staff,16,0,30,14
1649950692942,MATH 10C,B01,084114,Staff,25,0,30,5
1649950692942,MATH 10C,B02,084115,Staff,29,0,30,1
1649950698981,MATH 18,A01,084117,Harel; Guershon,27,0,30,3
1649950698981,MATH 18,A02,084119,Harel; Guershon,29,0,30,1
1649950698981,MATH 18,A03,084120,Harel; Guershon,30,0,30,0
1649950698981,MATH 18,A04,084121,Harel; Guershon,29,0,30,1
1649950705007,MATH 20B,A01,084124,Um; Ko Woon,31,0,35,4
1649950705007,MATH 20B,B01,084126,Um; Ko Woon,32,0,35,3
1649950711042,MATH 20C,A01,083446,Hammock; Frances H,17,0,30,13
1649950711042,MATH 20C,A02,083447,Hammock; Frances H,28,0,30,2
1649950711042,MATH 20C,A03,083448,Hammock; Frances H,30,0,30,0
1649950711042,MATH 20C,A04,083449,Hammock; Frances H,30,0,30,0
1649950711042,MATH 20C,B01,083451,Hammock; Frances H,25,0,30,5
1649950711042,MATH 20C,B02,083452,Hammock; Frances H,27,0,30,3
1649950711042,MATH 20C,B03,083453,Hammock; Frances H,26,0,30,4
1649950711042,MATH 20C,B04,083454,Hammock; Frances H,30,0,30,0
1649950717070,MATH 20D,A01,084128,Staff,25,0,30,5
1649950717070,MATH 20D,A02,084129,Staff,30,0,30,0
1649950717070,MATH 20D,A03,084130,Staff,29,0,30,1
1649950717070,MATH 20D,B01,084133,Staff,19,0,30,11
1649950717070,MATH 20D,B02,084134,Staff,27,0,30,3
1649950717070,MATH 20D,B03,084135,Staff,30,0,30,0
1649950723104,MATH 20E,A01,084138,Staff,22,0,30,8
1649950723104,MATH 20E,A02,084139,Staff,22,0,30,8
1649950723104,MATH 20E,A03,084140,Staff,23,0,30,7
1649950723104,MATH 20E,A04,084141,Staff,25,0,30,5
1649950729136,MATH 102,A01,084143,Harel; Guershon,16,0,30,14
1649950729136,MATH 102,A02,084144,Harel; Guershon,21,0,30,9
1649950735161,MATH 103B,A01,083456,Staff,0,8,30,30
1649950735161,MATH 103B,A02,083457,Staff,0,9,30,30
1649950741188,MATH 109,A01,084146,Salehi Golsefidy; Alireza,28,0,30,2
1649950741188,MATH 109,A02,084147,Salehi Golsefidy; Alireza,22,0,30,8
1649950747216,MATH 120A,A01,085445,Eggers; John Dietrich,20,0,35,15
1649950747216,MATH 120A,A02,085446,Eggers; John Dietrich,27,0,35,8
1649950753243,MATH 142B,A01,084149,Verstraete; Jacques Allan,0,10,30,30
1649950753243,MATH 142B,A02,084150,Verstraete; Jacques Allan,0,10,30,30
1649950759280,MATH 170A,A01,083459,Nie; Jiawang,0,2,30,30
1649950759280,MATH 170A,A02,083460,Nie; Jiawang,0,0,30,30
1649950759280,MATH 170A,A03,083461,Nie; Jiawang,4,0,30,26
1649950765306,MATH 193B,A01,083463,Staff,3,0,30,27
1649950765306,MATH 193B,A02,083464,Staff,10,0,30,20
1649950765306,MATH 193B,A03,083465,Staff,19,0,30,11
1649950771383,COGS 2,A01,083966,Boyle; Mary E. T.,18,0,30,12
1649950777414,COGS 9,A01,083968,Staff,39,0,60,21
1649950783440,COGS 14B,A01,083970,Staff,28,0,50,22
1649950789474,COGS 17,A01,092679,Staff,66,0,75,9
1649950795500,COGS 100,A01,083972,Staff,8,0,60,52
1649950807555,COGS 101C,A01,083976,Staff,19,0,30,11
1649950813586,COGS 102A,A01,083978,Johnson; Christine M.,16,0,30,14
1649950819618,COGS 107B,A01,083980,Staff,2,0,50,48
1649950825642,COGS 115,A01,083982,Staff,13,0,30,17
1649950831666,COGS 118B,A01,083367,Staff,0,11,40,40
1649950837697,COGS 172,A01,083984,Provenzano; Emily Kara,16,0,30,14
1649950843735,COGS 177,A00,083368,Staff,0,17,30,30
1649950849759,COGS 186,A01,083986,Staff,21,0,40,19
1649950855785,COGS 187A,A01,083988,Boyle; Mary E. T.,24,0,60,36
1649950861810,CSE 8A,A50,084003,Miranda; Gregory Joseph,0,1,15,15
1649950867834,CSE 11,A01,084005,Miranda; Gregory Joseph,18,0,55,37
1649950873858,CSE 20,A01,084007,Staff,9,0,20,11
1649950879883,CSE 21,A01,084009,Staff,9,0,50,41
1649950885906,CSE 30,A01,083370,Cao; Yingjun,0,21,40,40
1649950891927,CSE 100,A01,083372,Cao; Yingjun,0,26,40,40
1649950897952,CSE 101,A01,084011,Staff,0,50,40,40
1649950903975,CSE 141,A01,083374,Eldon; John,0,52,75,75
1649950909998,CSE 141L,A01,083376,Eldon; John,0,57,75,75
1649950916024,CSE 175,A01,084013,Kumar; Rakesh,22,0,25,3
1649950922050,CSE 190,A00,092508,Dubnov; Shlomo,15,0,15,0
1649950928085,ECE 5,A01,084049,Morris; Karcher William,15,0,20,5
1649950934108,ECE 100,A01,084051,Baghdadchi; Saharnaz,0,0,20,20
1649950934108,ECE 100,A02,091916,Baghdadchi; Saharnaz,16,0,20,4
1649950940135,ECE 101,A01,084053,Baghdadchi; Saharnaz,4,0,37,33
1649950940135,ECE 101,A02,084054,Baghdadchi; Saharnaz,32,0,37,5
1649950946165,ECE 107,A01,083390,Staff,28,0,40,12
1649950952188,ECE 148,A01,084056,Silberman; Jack,7,0,12,5
1649950958219,ECE 180,A00,083391,Abi Samra; Nicholas Camill,25,0,30,5
1649950958219,ECE 180,B00,083392,Abi Samra; Nicholas Camill,22,0,30,8
1649950964242,MATH 10B,A01,084110,Staff,8,0,30,22
1649950964242,MATH 10B,A02,084111,Staff,29,0,30,1
1649950964242,MATH 10B,A03,084112,Staff,28,0,30,2
1649950970264,MATH 10C,A01,083443,Staff,9,0,30,21
1649950970264,MATH 10C,A02,083444,Staff,16,0,30,14
1649950970264,MATH 10C,B01,084114,Staff,25,0,30,5
1649950970264,MATH 10C,B02,084115,Staff,29,0,30,1
1649950976287,MATH 18,A01,084117,Harel; Guershon,27,0,30,3
1649950976287,MATH 18,A02,084119,Harel; Guershon,29,0,30,1
1649950976287,MATH 18,A03,084120,Harel; Guershon,30,0,30,0
1649950976287,MATH 18,A04,084121,Harel; Guershon,29,0,30,1
1649950982315,MATH 20B,A01,084124,Um; Ko Woon,31,0,35,4
1649950982315,MATH 20B,B01,084126,Um; Ko Woon,32,0,35,3
1649950988340,MATH 20C,A01,083446,Hammock; Frances H,17,0,30,13
1649950988340,MATH 20C,A02,083447,Hammock; Frances H,28,0,30,2
1649950988340,MATH 20C,A03,083448,Hammock; Frances H,30,0,30,0
1649950988340,MATH 20C,A04,083449,Hammock; Frances H,30,0,30,0
1649950988340,MATH 20C,B01,083451,Hammock; Frances H,25,0,30,5
1649950988340,MATH 20C,B02,083452,Hammock; Frances H,27,0,30,3
1649950988340,MATH 20C,B03,083453,Hammock; Frances H,26,0,30,4
1649950988340,MATH 20C,B04,083454,Hammock; Frances H,30,0,30,0
1649950994447,MATH 20D,A01,084128,Staff,25,0,30,5
1649950994447,MATH 20D,A02,084129,Staff,30,0,30,0
1649950994447,MATH 20D,A03,084130,Staff,29,0,30,1
1649950994447,MATH 20D,B01,084133,Staff,18,0,30,12
1649950994447,MATH 20D,B02,084134,Staff,27,0,30,3
1649950994447,MATH 20D,B03,084135,Staff,30,0,30,0
1649951000474,MATH 20E,A01,084138,Staff,22,0,30,8
1649951000474,MATH 20E,A02,084139,Staff,21,0,30,9
1649951000474,MATH 20E,A03,084140,Staff,23,0,30,7
1649951000474,MATH 20E,A04,084141,Staff,25,0,30,5
1649951006501,MATH 102,A01,084143,Harel; Guershon,16,0,30,14
1649951006501,MATH 102,A02,084144,Harel; Guershon,21,0,30,9
1649951012525,MATH 103B,A01,083456,Staff,0,9,30,30
1649951012525,MATH 103B,A02,083457,Staff,0,9,30,30
1649951018549,MATH 109,A01,084146,Salehi Golsefidy; Alireza,28,0,30,2
1649951018549,MATH 109,A02,084147,Salehi Golsefidy; Alireza,22,0,30,8
1649951024575,MATH 120A,A01,085445,Eggers; John Dietrich,20,0,35,15
1649951024575,MATH 120A,A02,085446,Eggers; John Dietrich,27,0,35,8
1649951030600,MATH 142B,A01,084149,Verstraete; Jacques Allan,0,10,30,30
1649951030600,MATH 142B,A02,084150,Verstraete; Jacques Allan,0,10,30,30
1649951036624,MATH 170A,A01,083459,Nie; Jiawang,0,2,30,30
1649951036624,MATH 170A,A02,083460,Nie; Jiawang,0,0,30,30
1649951036624,MATH 170A,A03,083461,Nie; Jiawang,3,0,30,27
1649951042651,MATH 193B,A01,083463,Staff,3,0,30,27
1649951042651,MATH 193B,A02,083464,Staff,10,0,30,20
1649951042651,MATH 193B,A03,083465,Staff,19,0,30,11
1649951048711,COGS 2,A01,083966,Boyle; Mary E. T.,18,0,30,12
1649951054758,COGS 9,A01,083968,Staff,39,0,60,21
1649951060782,COGS 14B,A01,083970,Staff,27,0,50,23
1649951066811,COGS 17,A01,092679,Staff,65,0,75,10
1649951072838,COGS 100,A01,083972,Staff,8,0,60,52
1649951084892,COGS 101C,A01,083976,Staff,19,0,30,11
1649951090916,COGS 102A,A01,083978,Johnson; Christine M.,16,0,30,14
1649951096941,COGS 107B,A01,083980,Staff,2,0,50,48
1649951102975,COGS 115,A01,083982,Staff,13,0,30,17
1649951108999,COGS 118B,A01,083367,Staff,0,11,40,40
1649951115037,COGS 172,A01,083984,Provenzano; Emily Kara,16,0,30,14
1649951121058,COGS 177,A00,083368,Staff,0,17,30,30
1649951127086,COGS 186,A01,083986,Staff,21,0,40,19
1649951133111,COGS 187A,A01,083988,Boyle; Mary E. T.,24,0,60,36
1649951139135,CSE 8A,A50,084003,Miranda; Gregory Joseph,0,1,15,15
1649951145171,CSE 11,A01,084005,Miranda; Gregory Joseph,18,0,55,37
1649951151198,CSE 20,A01,084007,Staff,9,0,20,11
1649951157222,CSE 21,A01,084009,Staff,9,0,50,41
1649951163246,CSE 30,A01,083370,Cao; Yingjun,0,22,40,40
1649951169268,CSE 100,A01,083372,Cao; Yingjun,0,26,40,40
1649951175294,CSE 101,A01,084011,Staff,0,50,40,40
1649951181322,CSE 141,A01,083374,Eldon; John,0,52,75,75
1649951187361,CSE 141L,A01,083376,Eldon; John,0,57,75,75
1649951193393,CSE 175,A01,084013,Kumar; Rakesh,22,0,25,3
1649951199416,CSE 190,A00,092508,Dubnov; Shlomo,15,0,15,0
1649951205449,ECE 5,A01,084049,Morris; Karcher William,15,0,20,5
1649951211475,ECE 100,A01,084051,Baghdadchi; Saharnaz,0,0,20,20
1649951211475,ECE 100,A02,091916,Baghdadchi; Saharnaz,16,0,20,4
1649951217504,ECE 101,A01,084053,Baghdadchi; Saharnaz,4,0,37,33
1649951217504,ECE 101,A02,084054,Baghdadchi; Saharnaz,32,0,37,5
1649951223528,ECE 107,A01,083390,Staff,28,0,40,12
1649951229552,ECE 148,A01,084056,Silberman; Jack,7,0,12,5
1649951235580,ECE 180,A00,083391,Abi Samra; Nicholas Camill,25,0,30,5
1649951235580,ECE 180,B00,083392,Abi Samra; Nicholas Camill,22,0,30,8
1649951241603,MATH 10B,A01,084110,Staff,8,0,30,22
1649951241603,MATH 10B,A02,084111,Staff,29,0,30,1
1649951241603,MATH 10B,A03,084112,Staff,28,0,30,2
1649951247650,MATH 10C,A01,083443,Staff,9,0,30,21
1649951247650,MATH 10C,A02,083444,Staff,16,0,30,14
1649951247650,MATH 10C,B01,084114,Staff,25,0,30,5
1649951247650,MATH 10C,B02,084115,Staff,29,0,30,1
1649951253683,MATH 18,A01,084117,Harel; Guershon,27,0,30,3
1649951253683,MATH 18,A02,084119,Harel; Guershon,29,0,30,1
1649951253683,MATH 18,A03,084120,Harel; Guershon,30,0,30,0
1649951253683,MATH 18,A04,084121,Harel; Guershon,29,0,30,1
1649951259708,MATH 20B,A01,084124,Um; Ko Woon,31,0,35,4
1649951259708,MATH 20B,B01,084126,Um; Ko Woon,32,0,35,3
1649951265734,MATH 20C,A01,083446,Hammock; Frances H,17,0,30,13
1649951265734,MATH 20C,A02,083447,Hammock; Frances H,28,0,30,2
1649951265734,MATH 20C,A03,083448,Hammock; Frances H,30,0,30,0
1649951265734,MATH 20C,A04,083449,Hammock; Frances H,30,0,30,0
1649951265734,MATH 20C,B01,083451,Hammock; Frances H,25,0,30,5
1649951265734,MATH 20C,B02,083452,Hammock; Frances H,27,0,30,3
1649951265734,MATH 20C,B03,083453,Hammock; Frances H,26,0,30,4
1649951265734,MATH 20C,B04,083454,Hammock; Frances H,30,0,30,0
1649951271767,MATH 20D,A01,084128,Staff,25,0,30,5
1649951271767,MATH 20D,A02,084129,Staff,30,0,30,0
1649951271767,MATH 20D,A03,084130,Staff,29,0,30,1
1649951271767,MATH 20D,B01,084133,Staff,18,0,30,12
1649951271767,MATH 20D,B02,084134,Staff,27,0,30,3
1649951271767,MATH 20D,B03,084135,Staff,30,0,30,0
1649951277794,MATH 20E,A01,084138,Staff,22,0,30,8
1649951277794,MATH 20E,A02,084139,Staff,21,0,30,9
1649951277794,MATH 20E,A03,084140,Staff,23,0,30,7
1649951277794,MATH 20E,A04,084141,Staff,25,0,30,5
1649951283822,MATH 102,A01,084143,Harel; Guershon,16,0,30,14
1649951283822,MATH 102,A02,084144,Harel; Guershon,21,0,30,9
1649951289858,MATH 103B,A01,083456,Staff,0,9,30,30
1649951289858,MATH 103B,A02,083457,Staff,0,9,30,30
1649951295890,MATH 109,A01,084146,Salehi Golsefidy; Alireza,28,0,30,2
1649951295890,MATH 109,A02,084147,Salehi Golsefidy; Alireza,22,0,30,8
1649951301914,MATH 120A,A01,085445,Eggers; John Dietrich,20,0,35,15
1649951301914,MATH 120A,A02,085446,Eggers; John Dietrich,27,0,35,8
1649951307937,MATH 142B,A01,084149,Verstraete; Jacques Allan,0,10,30,30
1649951307937,MATH 142B,A02,084150,Verstraete; Jacques Allan,0,10,30,30
1649951313960,MATH 170A,A01,083459,Nie; Jiawang,0,2,30,30
1649951313960,MATH 170A,A02,083460,Nie; Jiawang,0,0,30,30
1649951313960,MATH 170A,A03,083461,Nie; Jiawang,3,0,30,27
1649951319983,MATH 193B,A01,083463,Staff,3,0,30,27
1649951319983,MATH 193B,A02,083464,Staff,10,0,30,20
1649951319983,MATH 193B,A03,083465,Staff,19,0,30,11
1649951326034,COGS 2,A01,083966,Boyle; Mary E. T.,18,0,30,12
1649951332057,COGS 9,A01,083968,Staff,39,0,60,21
1649951338082,COGS 14B,A01,083970,Staff,27,0,50,23
1649951344111,COGS 17,A01,092679,Staff,65,0,75,10
1649951350142,COGS 100,A01,083972,Staff,8,0,60,52
1649951362197,COGS 101C,A01,083976,Staff,19,0,30,11
1649951368223,COGS 102A,A01,083978,Johnson; Christine M.,16,0,30,14
1649951374262,COGS 107B,A01,083980,Staff,2,0,50,48
1649951380285,COGS 115,A01,083982,Staff,13,0,30,17
1649951386308,COGS 118B,A01,083367,Staff,0,11,40,40
1649951392333,COGS 172,A01,083984,Provenzano; Emily Kara,16,0,30,14
1649951398359,COGS 177,A00,083368,Staff,0,18,30,30
1649951404385,COGS 186,A01,083986,Staff,21,0,40,19
1649951410409,COGS 187A,A01,083988,Boyle; Mary E. T.,24,0,60,36
1649951416436,CSE 8A,A50,084003,Miranda; Gregory Joseph,0,1,15,15
1649951422469,CSE 11,A01,084005,Miranda; Gregory Joseph,18,0,55,37
1649951428508,CSE 20,A01,084007,Staff,9,0,20,11
1649951434537,CSE 21,A01,084009,Staff,9,0,50,41
1649951440566,CSE 30,A01,083370,Cao; Yingjun,0,22,40,40
1649951446592,CSE 100,A01,083372,Cao; Yingjun,0,26,40,40
1649951452629,CSE 101,A01,084011,Staff,0,50,40,40
1649951458652,CSE 141,A01,083374,Eldon; John,0,52,75,75
1649951464674,CSE 141L,A01,083376,Eldon; John,0,57,75,75
1649951470699,CSE 175,A01,084013,Kumar; Rakesh,22,0,25,3
1649951476722,CSE 190,A00,092508,Dubnov; Shlomo,15,0,15,0
1649951482750,ECE 5,A01,084049,Morris; Karcher William,15,0,20,5
1649951488774,ECE 100,A01,084051,Baghdadchi; Saharnaz,0,0,20,20
1649951488774,ECE 100,A02,091916,Baghdadchi; Saharnaz,16,0,20,4
1649951494798,ECE 101,A01,084053,Baghdadchi; Saharnaz,4,0,37,33
1649951494798,ECE 101,A02,084054,Baghdadchi; Saharnaz,32,0,37,5
1649951500824,ECE 107,A01,083390,Staff,28,0,40,12
1649951506847,ECE 148,A01,084056,Silberman; Jack,7,0,12,5
1649951512875,ECE 180,A00,083391,Abi Samra; Nicholas Camill,25,0,30,5
1649951512875,ECE 180,B00,083392,Abi Samra; Nicholas Camill,22,0,30,8
1649951518899,MATH 10B,A01,084110,Staff,8,0,30,22
1649951518899,MATH 10B,A02,084111,Staff,29,0,30,1
1649951518899,MATH 10B,A03,084112,Staff,28,0,30,2
1649951524921,MATH 10C,A01,083443,Staff,8,0,30,22
1649951524921,MATH 10C,A02,083444,Staff,16,0,30,14
1649951524921,MATH 10C,B01,084114,Staff,25,0,30,5
1649951524921,MATH 10C,B02,084115,Staff,29,0,30,1
1649951530949,MATH 18,A01,084117,Harel; Guershon,27,0,30,3
1649951530949,MATH 18,A02,084119,Harel; Guershon,29,0,30,1
1649951530949,MATH 18,A03,084120,Harel; Guershon,30,0,30,0
1649951530949,MATH 18,A04,084121,Harel; Guershon,29,0,30,1
1649951536976,MATH 20B,A01,084124,Um; Ko Woon,31,0,35,4
1649951536976,MATH 20B,B01,084126,Um; Ko Woon,32,0,35,3
1649951542999,MATH 20C,A01,083446,Hammock; Frances H,17,0,30,13
1649951542999,MATH 20C,A02,083447,Hammock; Frances H,28,0,30,2
1649951542999,MATH 20C,A03,083448,Hammock; Frances H,30,0,30,0
1649951542999,MATH 20C,A04,083449,Hammock; Frances H,29,0,30,1
1649951542999,MATH 20C,B01,083451,Hammock; Frances H,25,0,30,5
1649951542999,MATH 20C,B02,083452,Hammock; Frances H,27,0,30,3
1649951542999,MATH 20C,B03,083453,Hammock; Frances H,26,0,30,4
1649951542999,MATH 20C,B04,083454,Hammock; Frances H,30,0,30,0
1649951549026,MATH 20D,A01,084128,Staff,25,0,30,5
1649951549026,MATH 20D,A02,084129,Staff,30,0,30,0
1649951549026,MATH 20D,A03,084130,Staff,29,0,30,1
1649951549026,MATH 20D,B01,084133,Staff,18,0,30,12
1649951549026,MATH 20D,B02,084134,Staff,27,0,30,3
1649951549026,MATH 20D,B03,084135,Staff,30,0,30,0
1649951555052,MATH 20E,A01,084138,Staff,22,0,30,8
1649951555052,MATH 20E,A02,084139,Staff,21,0,30,9
1649951555052,MATH 20E,A03,084140,Staff,23,0,30,7
1649951555052,MATH 20E,A04,084141,Staff,25,0,30,5
1649951561087,MATH 102,A01,084143,Harel; Guershon,16,0,30,14
1649951561087,MATH 102,A02,084144,Harel; Guershon,21,0,30,9
1649951567117,MATH 103B,A01,083456,Staff,0,9,30,30
1649951567117,MATH 103B,A02,083457,Staff,0,9,30,30
1649951573148,MATH 109,A01,084146,Salehi Golsefidy; Alireza,28,0,30,2
1649951573148,MATH 109,A02,084147,Salehi Golsefidy; Alireza,22,0,30,8
1649951579171,MATH 120A,A01,085445,Eggers; John Dietrich,20,0,35,15
1649951579171,MATH 120A,A02,085446,Eggers; John Dietrich,27,0,35,8
1649951585194,MATH 142B,A01,084149,Verstraete; Jacques Allan,0,11,30,30
1649951585194,MATH 142B,A02,084150,Verstraete; Jacques Allan,0,10,30,30
1649951591315,MATH 170A,A01,083459,Nie; Jiawang,0,2,30,30
1649951591315,MATH 170A,A02,083460,Nie; Jiawang,0,0,30,30
1649951591315,MATH 170A,A03,083461,Nie; Jiawang,2,0,30,28
1649951597339,MATH 193B,A01,083463,Staff,3,0,30,27
1649951597339,MATH 193B,A02,083464,Staff,10,0,30,20
1649951597339,MATH 193B,A03,083465,Staff,19,0,30,11
1649951603395,COGS 2,A01,083966,Boyle; Mary E. T.,18,0,30,12
1649951609419,COGS 9,A01,083968,Staff,39,0,60,21
1649951615444,COGS 14B,A01,083970,Staff,27,0,50,23
1649951621467,COGS 17,A01,092679,Staff,65,0,75,10
1649951627490,COGS 100,A01,083972,Staff,7,0,60,53
1649951639554,COGS 101C,A01,083976,Staff,19,0,30,11
1649951645580,COGS 102A,A01,083978,Johnson; Christine M.,16,0,30,14
1649951651606,COGS 107B,A01,083980,Staff,2,0,50,48
1649951657627,COGS 115,A01,083982,Staff,13,0,30,17
1649951663659,COGS 118B,A01,083367,Staff,0,11,40,40
1649951669692,COGS 172,A01,083984,Provenzano; Emily Kara,16,0,30,14
1649951675719,COGS 177,A00,083368,Staff,0,18,30,30
1649951681747,COGS 186,A01,083986,Staff,21,0,40,19
1649951687779,COGS 187A,A01,083988,Boyle; Mary E. T.,24,0,60,36
1649951693806,CSE 8A,A50,084003,Miranda; Gregory Joseph,0,1,15,15
1649951699846,CSE 11,A01,084005,Miranda; Gregory Joseph,17,0,55,38
1649951705881,CSE 20,A01,084007,Staff,9,0,20,11
1649951711916,CSE 21,A01,084009,Staff,8,0,50,42
1649951717942,CSE 30,A01,083370,Cao; Yingjun,0,22,40,40
1649951723966,CSE 100,A01,083372,Cao; Yingjun,0,26,40,40
1649951729989,CSE 101,A01,084011,Staff,0,50,40,40
1649951736014,CSE 141,A01,083374,Eldon; John,0,52,75,75
1649951742049,CSE 141L,A01,083376,Eldon; John,0,57,75,75
1649951748082,CSE 175,A01,084013,Kumar; Rakesh,22,0,25,3
1649951754106,CSE 190,A00,092508,Dubnov; Shlomo,15,0,15,0
1649951766939,ECE 5,A01,084049,Morris; Karcher William,15,0,20,5
1649951772964,ECE 100,A01,084051,Baghdadchi; Saharnaz,0,0,20,20
1649951772964,ECE 100,A02,091916,Baghdadchi; Saharnaz,16,0,20,4
1649951778987,ECE 101,A01,084053,Baghdadchi; Saharnaz,4,0,37,33
1649951778987,ECE 101,A02,084054,Baghdadchi; Saharnaz,32,0,37,5
1649951785013,ECE 107,A01,083390,Staff,28,0,40,12
1649951791040,ECE 148,A01,084056,Silberman; Jack,7,0,12,5
1649951797101,ECE 180,A00,083391,Abi Samra; Nicholas Camill,25,0,30,5
1649951797101,ECE 180,B00,083392,Abi Samra; Nicholas Camill,22,0,30,8
1649951803128,MATH 10B,A01,084110,Staff,8,0,30,22
1649951803128,MATH 10B,A02,084111,Staff,29,0,30,1
1649951803128,MATH 10B,A03,084112,Staff,27,0,30,3
1649951809162,MATH 10C,A01,083443,Staff,8,0,30,22
1649951809162,MATH 10C,A02,083444,Staff,16,0,30,14
1649951809162,MATH 10C,B01,084114,Staff,25,0,30,5
1649951809162,MATH 10C,B02,084115,Staff,29,0,30,1
1649951815186,MATH 18,A01,084117,Harel; Guershon,27,0,30,3
1649951815186,MATH 18,A02,084119,Harel; Guershon,29,0,30,1
1649951815186,MATH 18,A03,084120,Harel; Guershon,30,0,30,0
1649951815186,MATH 18,A04,084121,Harel; Guershon,29,0,30,1
1649951821214,MATH 20B,A01,084124,Um; Ko Woon,31,0,35,4
1649951821214,MATH 20B,B01,084126,Um; Ko Woon,32,0,35,3
1649951827242,MATH 20C,A01,083446,Hammock; Frances H,17,0,30,13
1649951827242,MATH 20C,A02,083447,Hammock; Frances H,28,0,30,2
1649951827242,MATH 20C,A03,083448,Hammock; Frances H,30,0,30,0
1649951827242,MATH 20C,A04,083449,Hammock; Frances H,30,0,30,0
1649951827242,MATH 20C,B01,083451,Hammock; Frances H,25,0,30,5
1649951827242,MATH 20C,B02,083452,Hammock; Frances H,27,0,30,3
1649951827242,MATH 20C,B03,083453,Hammock; Frances H,26,0,30,4
1649951827242,MATH 20C,B04,083454,Hammock; Frances H,30,0,30,0
1649951833269,MATH 20D,A01,084128,Staff,25,0,30,5
1649951833269,MATH 20D,A02,084129,Staff,30,0,30,0
1649951833269,MATH 20D,A03,084130,Staff,29,0,30,1
1649951833269,MATH 20D,B01,084133,Staff,18,0,30,12
1649951833269,MATH 20D,B02,084134,Staff,27,0,30,3
1649951833269,MATH 20D,B03,084135,Staff,30,0,30,0
1649951839297,MATH 20E,A01,084138,Staff,22,0,30,8
1649951839297,MATH 20E,A02,084139,Staff,20,0,30,10
1649951839297,MATH 20E,A03,084140,Staff,23,0,30,7
1649951839297,MATH 20E,A04,084141,Staff,25,0,30,5
1649951845319,MATH 102,A01,084143,Harel; Guershon,16,0,30,14
1649951845319,MATH 102,A02,084144,Harel; Guershon,21,0,30,9
1649951851347,MATH 103B,A01,083456,Staff,0,9,30,30
1649951851347,MATH 103B,A02,083457,Staff,0,9,30,30
1649951857374,MATH 109,A01,084146,Salehi Golsefidy; Alireza,28,0,30,2
1649951857374,MATH 109,A02,084147,Salehi Golsefidy; Alireza,22,0,30,8
1649951863400,MATH 120A,A01,085445,Eggers; John Dietrich,20,0,35,15
1649951863400,MATH 120A,A02,085446,Eggers; John Dietrich,27,0,35,8
1649951869428,MATH 142B,A01,084149,Verstraete; Jacques Allan,0,11,30,30
1649951869428,MATH 142B,A02,084150,Verstraete; Jacques Allan,0,10,30,30
1649951875455,MATH 170A,A01,083459,Nie; Jiawang,0,2,30,30
1649951875455,MATH 170A,A02,083460,Nie; Jiawang,0,0,30,30
1649951875455,MATH 170A,A03,083461,Nie; Jiawang,2,0,30,28
1649951881479,MATH 193B,A01,083463,Staff,3,0,30,27
1649951881479,MATH 193B,A02,083464,Staff,10,0,30,20
1649951881479,MATH 193B,A03,083465,Staff,19,0,30,11
1649951887535,COGS 2,A01,083966,Boyle; Mary E. T.,17,0,30,13
1649951893559,COGS 9,A01,083968,Staff,39,0,60,21
1649951899594,COGS 14B,A01,083970,Staff,27,0,50,23
1649951905617,COGS 17,A01,092679,Staff,64,0,75,11
1649951911641,COGS 100,A01,083972,Staff,7,0,60,53
1649951923697,COGS 101C,A01,083976,Staff,19,0,30,11
1649951929724,COGS 102A,A01,083978,Johnson; Christine M.,16,0,30,14
1649951935748,COGS 107B,A01,083980,Staff,2,0,50,48
1649951941772,COGS 115,A01,083982,Staff,13,0,30,17
1649951947808,COGS 118B,A01,083367,Staff,0,11,40,40
1649951953834,COGS 172,A01,083984,Provenzano; Emily Kara,16,0,30,14
1649951959857,COGS 177,A00,083368,Staff,0,18,30,30
1649951965883,COGS 186,A01,083986,Staff,21,0,40,19
1649951971906,COGS 187A,A01,083988,Boyle; Mary E. T.,24,0,60,36
1649951977929,CSE 8A,A50,084003,Miranda; Gregory Joseph,0,1,15,15
1649951983957,CSE 11,A01,084005,Miranda; Gregory Joseph,17,0,55,38
1649951989982,CSE 20,A01,084007,Staff,9,0,20,11
1649951996006,CSE 21,A01,084009,Staff,8,0,50,42
1649952002045,CSE 30,A01,083370,Cao; Yingjun,0,23,40,40
1649952008072,CSE 100,A01,083372,Cao; Yingjun,0,26,40,40
1649952014114,CSE 101,A01,084011,Staff,0,50,40,40
1649952020138,CSE 141,A01,083374,Eldon; John,0,52,75,75
1649952026168,CSE 141L,A01,083376,Eldon; John,0,57,75,75
1649952032194,CSE 175,A01,084013,Kumar; Rakesh,22,0,25,3
1649952038233,CSE 190,A00,092508,Dubnov; Shlomo,15,0,15,0
1649952044263,ECE 5,A01,084049,Morris; Karcher William,15,0,20,5
1649952050285,ECE 100,A01,084051,Baghdadchi; Saharnaz,0,0,20,20
1649952050285,ECE 100,A02,091916,Baghdadchi; Saharnaz,16,0,20,4
1649952056309,ECE 101,A01,084053,Baghdadchi; Saharnaz,4,0,37,33
1649952056309,ECE 101,A02,084054,Baghdadchi; Saharnaz,32,0,37,5
1649952062343,ECE 107,A01,083390,Staff,28,0,40,12
1649952068366,ECE 148,A01,084056,Silberman; Jack,7,0,12,5
1649952074397,ECE 180,A00,083391,Abi Samra; Nicholas Camill,25,0,30,5
1649952074397,ECE 180,B00,083392,Abi Samra; Nicholas Camill,22,0,30,8
1649952080419,MATH 10B,A01,084110,Staff,8,0,30,22
1649952080419,MATH 10B,A02,084111,Staff,29,0,30,1
1649952080419,MATH 10B,A03,084112,Staff,27,0,30,3
1649952086443,MATH 10C,A01,083443,Staff,8,0,30,22
1649952086443,MATH 10C,A02,083444,Staff,16,0,30,14
1649952086443,MATH 10C,B01,084114,Staff,25,0,30,5
1649952086443,MATH 10C,B02,084115,Staff,29,0,30,1
1649952092466,MATH 18,A01,084117,Harel; Guershon,27,0,30,3
1649952092466,MATH 18,A02,084119,Harel; Guershon,29,0,30,1
1649952092466,MATH 18,A03,084120,Harel; Guershon,30,0,30,0
1649952092466,MATH 18,A04,084121,Harel; Guershon,29,0,30,1
1649952098488,MATH 20B,A01,084124,Um; Ko Woon,31,0,35,4
1649952098488,MATH 20B,B01,084126,Um; Ko Woon,32,0,35,3
1649952104533,MATH 20C,A01,083446,Hammock; Frances H,17,0,30,13
1649952104533,MATH 20C,A02,083447,Hammock; Frances H,28,0,30,2
1649952104533,MATH 20C,A03,083448,Hammock; Frances H,30,0,30,0
1649952104533,MATH 20C,A04,083449,Hammock; Frances H,30,0,30,0
1649952104533,MATH 20C,B01,083451,Hammock; Frances H,25,0,30,5
1649952104533,MATH 20C,B02,083452,Hammock; Frances H,27,0,30,3
1649952104533,MATH 20C,B03,083453,Hammock; Frances H,26,0,30,4
1649952104533,MATH 20C,B04,083454,Hammock; Frances H,30,0,30,0
1649952110565,MATH 20D,A01,084128,Staff,25,0,30,5
1649952110565,MATH 20D,A02,084129,Staff,30,0,30,0
1649952110565,MATH 20D,A03,084130,Staff,29,0,30,1
1649952110565,MATH 20D,B01,084133,Staff,18,0,30,12
1649952110565,MATH 20D,B02,084134,Staff,27,0,30,3
1649952110565,MATH 20D,B03,084135,Staff,30,0,30,0
1649952116592,MATH 20E,A01,084138,Staff,22,0,30,8
1649952116592,MATH 20E,A02,084139,Staff,19,0,30,11
1649952116592,MATH 20E,A03,084140,Staff,23,0,30,7
1649952116592,MATH 20E,A04,084141,Staff,25,0,30,5
1649952122623,MATH 102,A01,084143,Harel; Guershon,16,0,30,14
1649952122623,MATH 102,A02,084144,Harel; Guershon,21,0,30,9
1649952128664,MATH 103B,A01,083456,Staff,0,9,30,30
1649952128664,MATH 103B,A02,083457,Staff,0,9,30,30
1649952134696,MATH 109,A01,084146,Salehi Golsefidy; Alireza,28,0,30,2
1649952134696,MATH 109,A02,084147,Salehi Golsefidy; Alireza,22,0,30,8
1649952140734,MATH 120A,A01,085445,Eggers; John Dietrich,20,0,35,15
1649952140734,MATH 120A,A02,085446,Eggers; John Dietrich,27,0,35,8
1649952146772,MATH 142B,A01,084149,Verstraete; Jacques Allan,0,11,30,30
1649952146772,MATH 142B,A02,084150,Verstraete; Jacques Allan,0,10,30,30
1649952152795,MATH 170A,A01,083459,Nie; Jiawang,0,2,30,30
1649952152795,MATH 170A,A02,083460,Nie; Jiawang,0,1,30,30
1649952152795,MATH 170A,A03,083461,Nie; Jiawang,1,0,30,29
1649952158829,MATH 193B,A01,083463,Staff,3,0,30,27
1649952158829,MATH 193B,A02,083464,Staff,10,0,30,20
1649952158829,MATH 193B,A03,083465,Staff,19,0,30,11
1649952164894,COGS 2,A01,083966,Boyle; Mary E. T.,17,0,30,13
1649952170917,COGS 9,A01,083968,Staff,39,0,60,21
1649952176942,COGS 14B,A01,083970,Staff,27,0,50,23
1649952182969,COGS 17,A01,092679,Staff,65,0,75,10
1649952189110,COGS 100,A01,083972,Staff,7,0,60,53
1649952201157,COGS 101C,A01,083976,Staff,19,0,30,11
1649952207183,COGS 102A,A01,083978,Johnson; Christine M.,16,0,30,14
1649952213218,COGS 107B,A01,083980,Staff,2,0,50,48
1649952219241,COGS 115,A01,083982,Staff,13,0,30,17
1649952225264,COGS 118B,A01,083367,Staff,0,11,40,40
1649952231290,COGS 172,A01,083984,Provenzano; Emily Kara,16,0,30,14
1649952237313,COGS 177,A00,083368,Staff,0,18,30,30
1649952243335,COGS 186,A01,083986,Staff,21,0,40,19
1649952249361,COGS 187A,A01,083988,Boyle; Mary E. T.,24,0,60,36
1649952255398,CSE 8A,A50,084003,Miranda; Gregory Joseph,0,1,15,15
1649952261427,CSE 11,A01,084005,Miranda; Gregory Joseph,17,0,55,38
1649952267452,CSE 20,A01,084007,Staff,9,0,20,11
1649952273476,CSE 21,A01,084009,Staff,8,0,50,42
1649952279501,CSE 30,A01,083370,Cao; Yingjun,0,23,40,40
1649952285526,CSE 100,A01,083372,Cao; Yingjun,0,27,40,40
1649952291563,CSE 101,A01,084011,Staff,0,51,40,40
1649952297591,CSE 141,A01,083374,Eldon; John,0,53,75,75
1649952303615,CSE 141L,A01,083376,Eldon; John,0,58,75,75
1649952309639,CSE 175,A01,084013,Kumar; Rakesh,22,0,25,3
1649952315662,CSE 190,A00,092508,Dubnov; Shlomo,15,0,15,0
1649952321695,ECE 5,A01,084049,Morris; Karcher William,15,0,20,5
1649952327730,ECE 100,A01,084051,Baghdadchi; Saharnaz,0,0,20,20
1649952327730,ECE 100,A02,091916,Baghdadchi; Saharnaz,16,0,20,4
1649952333757,ECE 101,A01,084053,Baghdadchi; Saharnaz,4,0,37,33
1649952333757,ECE 101,A02,084054,Baghdadchi; Saharnaz,32,0,37,5
1649952339781,ECE 107,A01,083390,Staff,28,0,40,12
1649952345817,ECE 148,A01,084056,Silberman; Jack,7,0,12,5
1649952351850,ECE 180,A00,083391,Abi Samra; Nicholas Camill,25,0,30,5
1649952351850,ECE 180,B00,083392,Abi Samra; Nicholas Camill,22,0,30,8
1649952357884,MATH 10B,A01,084110,Staff,8,0,30,22
1649952357884,MATH 10B,A02,084111,Staff,29,0,30,1
1649952357884,MATH 10B,A03,084112,Staff,27,0,30,3
1649952363908,MATH 10C,A01,083443,Staff,8,0,30,22
1649952363908,MATH 10C,A02,083444,Staff,16,0,30,14
1649952363908,MATH 10C,B01,084114,Staff,25,0,30,5
1649952363908,MATH 10C,B02,084115,Staff,29,0,30,1
1649952369932,MATH 18,A01,084117,Harel; Guershon,27,0,30,3
1649952369932,MATH 18,A02,084119,Harel; Guershon,29,0,30,1
1649952369932,MATH 18,A03,084120,Harel; Guershon,30,0,30,0
1649952369932,MATH 18,A04,084121,Harel; Guershon,29,0,30,1
1649952375965,MATH 20B,A01,084124,Um; Ko Woon,31,0,35,4
1649952375965,MATH 20B,B01,084126,Um; Ko Woon,32,0,35,3
1649952382002,MATH 20C,A01,083446,Hammock; Frances H,17,0,30,13
1649952382002,MATH 20C,A02,083447,Hammock; Frances H,28,0,30,2
1649952382002,MATH 20C,A03,083448,Hammock; Frances H,30,0,30,0
1649952382002,MATH 20C,A04,083449,Hammock; Frances H,30,0,30,0
1649952382002,MATH 20C,B01,083451,Hammock; Frances H,25,0,30,5
1649952382002,MATH 20C,B02,083452,Hammock; Frances H,27,0,30,3
1649952382002,MATH 20C,B03,083453,Hammock; Frances H,26,0,30,4
1649952382002,MATH 20C,B04,083454,Hammock; Frances H,30,0,30,0
1649952388027,MATH 20D,A01,084128,Staff,24,0,30,6
1649952388027,MATH 20D,A02,084129,Staff,30,0,30,0
1649952388027,MATH 20D,A03,084130,Staff,29,0,30,1
1649952388027,MATH 20D,B01,084133,Staff,17,0,30,13
1649952388027,MATH 20D,B02,084134,Staff,27,0,30,3
1649952388027,MATH 20D,B03,084135,Staff,30,0,30,0
1649952394050,MATH 20E,A01,084138,Staff,22,0,30,8
1649952394050,MATH 20E,A02,084139,Staff,19,0,30,11
1649952394050,MATH 20E,A03,084140,Staff,23,0,30,7
1649952394050,MATH 20E,A04,084141,Staff,25,0,30,5
1649952400072,MATH 102,A01,084143,Harel; Guershon,16,0,30,14
1649952400072,MATH 102,A02,084144,Harel; Guershon,21,0,30,9
1649952406101,MATH 103B,A01,083456,Staff,0,9,30,30
1649952406101,MATH 103B,A02,083457,Staff,0,9,30,30
1649952412133,MATH 109,A01,084146,Salehi Golsefidy; Alireza,28,0,30,2
1649952412133,MATH 109,A02,084147,Salehi Golsefidy; Alireza,22,0,30,8
1649952418164,MATH 120A,A01,085445,Eggers; John Dietrich,20,0,35,15
1649952418164,MATH 120A,A02,085446,Eggers; John Dietrich,27,0,35,8
1649952424189,MATH 142B,A01,084149,Verstraete; Jacques Allan,0,11,30,30
1649952424189,MATH 142B,A02,084150,Verstraete; Jacques Allan,0,10,30,30
1649952430215,MATH 170A,A01,083459,Nie; Jiawang,0,2,30,30
1649952430215,MATH 170A,A02,083460,Nie; Jiawang,0,1,30,30
1649952430215,MATH 170A,A03,083461,Nie; Jiawang,1,0,30,29
1649952436243,MATH 193B,A01,083463,Staff,3,0,30,27
1649952436243,MATH 193B,A02,083464,Staff,10,0,30,20
1649952436243,MATH 193B,A03,083465,Staff,19,0,30,11
1649952442297,COGS 2,A01,083966,Boyle; Mary E. T.,17,0,30,13
1649952448325,COGS 9,A01,083968,Staff,39,0,60,21
1649952454361,COGS 14B,A01,083970,Staff,27,0,50,23
1649952460385,COGS 17,A01,092679,Staff,65,0,75,10
1649952466412,COGS 100,A01,083972,Staff,6,0,60,54
1649952478472,COGS 101C,A01,083976,Staff,19,0,30,11
1649952484499,COGS 102A,A01,083978,Johnson; Christine M.,16,0,30,14
1649952490530,COGS 107B,A01,083980,Staff,2,0,50,48
1649952496560,COGS 115,A01,083982,Staff,13,0,30,17
1649952502584,COGS 118B,A01,083367,Staff,0,11,40,40
1649952508623,COGS 172,A01,083984,Provenzano; Emily Kara,16,0,30,14
1649952514645,COGS 177,A00,083368,Staff,0,18,30,30
1649952520672,COGS 186,A01,083986,Staff,21,0,40,19
1649952526695,COGS 187A,A01,083988,Boyle; Mary E. T.,24,0,60,36
1649952532723,CSE 8A,A50,084003,Miranda; Gregory Joseph,0,1,15,15
1649952538749,CSE 11,A01,084005,Miranda; Gregory Joseph,17,0,55,38
1649952544772,CSE 20,A01,084007,Staff,9,0,20,11
1649952550806,CSE 21,A01,084009,Staff,8,0,50,42
1649952556842,CSE 30,A01,083370,Cao; Yingjun,0,23,40,40
1649952562869,CSE 100,A01,083372,Cao; Yingjun,0,27,40,40
1649952568905,CSE 101,A01,084011,Staff,0,51,40,40
1649952574933,CSE 141,A01,083374,Eldon; John,0,53,75,75
1649952580965,CSE 141L,A01,083376,Eldon; John,0,58,75,75
1649952586988,CSE 175,A01,084013,Kumar; Rakesh,22,0,25,3
1649952593016,CSE 190,A00,092508,Dubnov; Shlomo,15,0,15,0
1649952599040,ECE 5,A01,084049,Morris; Karcher William,15,0,20,5
1649952605070,ECE 100,A01,084051,Baghdadchi; Saharnaz,0,0,20,20
1649952605070,ECE 100,A02,091916,Baghdadchi; Saharnaz,16,0,20,4
1649952611095,ECE 101,A01,084053,Baghdadchi; Saharnaz,4,0,37,33
1649952611095,ECE 101,A02,084054,Baghdadchi; Saharnaz,32,0,37,5
1649952617123,ECE 107,A01,083390,Staff,28,0,40,12
1649952623144,ECE 148,A01,084056,Silberman; Jack,7,0,12,5
1649952629167,ECE 180,A00,083391,Abi Samra; Nicholas Camill,25,0,30,5
1649952629167,ECE 180,B00,083392,Abi Samra; Nicholas Camill,22,0,30,8
1649952635199,MATH 10B,A01,084110,Staff,8,0,30,22
1649952635199,MATH 10B,A02,084111,Staff,29,0,30,1
1649952635199,MATH 10B,A03,084112,Staff,27,0,30,3
1649952641236,MATH 10C,A01,083443,Staff,8,0,30,22
1649952641236,MATH 10C,A02,083444,Staff,16,0,30,14
1649952641236,MATH 10C,B01,084114,Staff,25,0,30,5
1649952641236,MATH 10C,B02,084115,Staff,29,0,30,1
1649952647264,MATH 18,A01,084117,Harel; Guershon,27,0,30,3
1649952647264,MATH 18,A02,084119,Harel; Guershon,29,0,30,1
1649952647264,MATH 18,A03,084120,Harel; Guershon,30,0,30,0
1649952647264,MATH 18,A04,084121,Harel; Guershon,29,0,30,1
1649952653288,MATH 20B,A01,084124,Um; Ko Woon,31,0,35,4
1649952653288,MATH 20B,B01,084126,Um; Ko Woon,32,0,35,3
1649952659311,MATH 20C,A01,083446,Hammock; Frances H,17,0,30,13
1649952659311,MATH 20C,A02,083447,Hammock; Frances H,28,0,30,2
1649952659311,MATH 20C,A03,083448,Hammock; Frances H,30,0,30,0
1649952659311,MATH 20C,A04,083449,Hammock; Frances H,30,0,30,0
1649952659311,MATH 20C,B01,083451,Hammock; Frances H,25,0,30,5
1649952659311,MATH 20C,B02,083452,Hammock; Frances H,27,0,30,3
1649952659311,MATH 20C,B03,083453,Hammock; Frances H,26,0,30,4
1649952659311,MATH 20C,B04,083454,Hammock; Frances H,30,0,30,0
1649952665333,MATH 20D,A01,084128,Staff,24,0,30,6
1649952665333,MATH 20D,A02,084129,Staff,30,0,30,0
1649952665333,MATH 20D,A03,084130,Staff,29,0,30,1
1649952665333,MATH 20D,B01,084133,Staff,17,0,30,13
1649952665333,MATH 20D,B02,084134,Staff,27,0,30,3
1649952665333,MATH 20D,B03,084135,Staff,30,0,30,0
1649952671363,MATH 20E,A01,084138,Staff,22,0,30,8
1649952671363,MATH 20E,A02,084139,Staff,19,0,30,11
1649952671363,MATH 20E,A03,084140,Staff,23,0,30,7
1649952671363,MATH 20E,A04,084141,Staff,25,0,30,5
1649952677388,MATH 102,A01,084143,Harel; Guershon,16,0,30,14
1649952677388,MATH 102,A02,084144,Harel; Guershon,21,0,30,9
1649952683418,MATH 103B,A01,083456,Staff,0,9,30,30
1649952683418,MATH 103B,A02,083457,Staff,0,9,30,30
1649952689444,MATH 109,A01,084146,Salehi Golsefidy; Alireza,28,0,30,2
1649952689444,MATH 109,A02,084147,Salehi Golsefidy; Alireza,22,0,30,8
1649952695471,MATH 120A,A01,085445,Eggers; John Dietrich,20,0,35,15
1649952695471,MATH 120A,A02,085446,Eggers; John Dietrich,27,0,35,8
1649952701507,MATH 142B,A01,084149,Verstraete; Jacques Allan,0,11,30,30
1649952701507,MATH 142B,A02,084150,Verstraete; Jacques Allan,0,10,30,30
1649952707532,MATH 170A,A01,083459,Nie; Jiawang,0,2,30,30
1649952707532,MATH 170A,A02,083460,Nie; Jiawang,0,1,30,30
1649952707532,MATH 170A,A03,083461,Nie; Jiawang,1,0,30,29
1649952713573,MATH 193B,A01,083463,Staff,3,0,30,27
1649952713573,MATH 193B,A02,083464,Staff,10,0,30,20
1649952713573,MATH 193B,A03,083465,Staff,19,0,30,11
1649952719630,COGS 2,A01,083966,Boyle; Mary E. T.,17,0,30,13
1649952725652,COGS 9,A01,083968,Staff,39,0,60,21
1649952731679,COGS 14B,A01,083970,Staff,26,0,50,24
1649952737702,COGS 17,A01,092679,Staff,65,0,75,10
1649952743730,COGS 100,A01,083972,Staff,5,0,60,55
1649952755779,COGS 101C,A01,083976,Staff,19,0,30,11
1649952761801,COGS 102A,A01,083978,Johnson; Christine M.,16,0,30,14
1649952767828,COGS 107B,A01,083980,Staff,2,0,50,48
1649952773853,COGS 115,A01,083982,Staff,13,0,30,17
1649952779877,COGS 118B,A01,083367,Staff,0,11,40,40
1649952785996,COGS 172,A01,083984,Provenzano; Emily Kara,16,0,30,14
1649952792019,COGS 177,A00,083368,Staff,0,18,30,30
1649952798056,COGS 186,A01,083986,Staff,21,0,40,19
1649952804089,COGS 187A,A01,083988,Boyle; Mary E. T.,24,0,60,36
1649952810113,CSE 8A,A50,084003,Miranda; Gregory Joseph,0,1,15,15
1649952816146,CSE 11,A01,084005,Miranda; Gregory Joseph,17,0,55,38
1649952822168,CSE 20,A01,084007,Staff,9,0,20,11
1649952828194,CSE 21,A01,084009,Staff,8,0,50,42
1649952834220,CSE 30,A01,083370,Cao; Yingjun,0,23,40,40
1649952840255,CSE 100,A01,083372,Cao; Yingjun,0,27,40,40
1649952846281,CSE 101,A01,084011,Staff,0,51,40,40
1649952852307,CSE 141,A01,083374,Eldon; John,0,53,75,75
1649952858344,CSE 141L,A01,083376,Eldon; John,0,58,75,75
1649952864371,CSE 175,A01,084013,Kumar; Rakesh,22,0,25,3
1649952870393,CSE 190,A00,092508,Dubnov; Shlomo,15,0,15,0
1649952876416,ECE 5,A01,084049,Morris; Karcher William,15,0,20,5
1649952882443,ECE 100,A01,084051,Baghdadchi; Saharnaz,0,0,20,20
1649952882443,ECE 100,A02,091916,Baghdadchi; Saharnaz,16,0,20,4
1649952888466,ECE 101,A01,084053,Baghdadchi; Saharnaz,4,0,37,33
1649952888466,ECE 101,A02,084054,Baghdadchi; Saharnaz,32,0,37,5
1649952894493,ECE 107,A01,083390,Staff,28,0,40,12
1649952900525,ECE 148,A01,084056,Silberman; Jack,7,0,12,5
1649952906557,ECE 180,A00,083391,Abi Samra; Nicholas Camill,25,0,30,5
1649952906557,ECE 180,B00,083392,Abi Samra; Nicholas Camill,22,0,30,8
1649952912585,MATH 10B,A01,084110,Staff,8,0,30,22
1649952912585,MATH 10B,A02,084111,Staff,29,0,30,1
1649952912585,MATH 10B,A03,084112,Staff,27,0,30,3
1649952918609,MATH 10C,A01,083443,Staff,8,0,30,22
1649952918609,MATH 10C,A02,083444,Staff,16,0,30,14
1649952918609,MATH 10C,B01,084114,Staff,25,0,30,5
1649952918609,MATH 10C,B02,084115,Staff,29,0,30,1
1649952924632,MATH 18,A01,084117,Harel; Guershon,27,0,30,3
1649952924632,MATH 18,A02,084119,Harel; Guershon,29,0,30,1
1649952924632,MATH 18,A03,084120,Harel; Guershon,30,0,30,0
1649952924632,MATH 18,A04,084121,Harel; Guershon,29,0,30,1
1649952930658,MATH 20B,A01,084124,Um; Ko Woon,31,0,35,4
1649952930658,MATH 20B,B01,084126,Um; Ko Woon,32,0,35,3
1649952936685,MATH 20C,A01,083446,Hammock; Frances H,17,0,30,13
1649952936685,MATH 20C,A02,083447,Hammock; Frances H,28,0,30,2
1649952936685,MATH 20C,A03,083448,Hammock; Frances H,30,0,30,0
1649952936685,MATH 20C,A04,083449,Hammock; Frances H,30,0,30,0
1649952936685,MATH 20C,B01,083451,Hammock; Frances H,25,0,30,5
1649952936685,MATH 20C,B02,083452,Hammock; Frances H,27,0,30,3
1649952936685,MATH 20C,B03,083453,Hammock; Frances H,26,0,30,4
1649952936685,MATH 20C,B04,083454,Hammock; Frances H,30,0,30,0
1649952942709,MATH 20D,A01,084128,Staff,24,0,30,6
1649952942709,MATH 20D,A02,084129,Staff,30,0,30,0
1649952942709,MATH 20D,A03,084130,Staff,29,0,30,1
1649952942709,MATH 20D,B01,084133,Staff,17,0,30,13
1649952942709,MATH 20D,B02,084134,Staff,27,0,30,3
1649952942709,MATH 20D,B03,084135,Staff,30,0,30,0
1649952948734,MATH 20E,A01,084138,Staff,22,0,30,8
1649952948734,MATH 20E,A02,084139,Staff,19,0,30,11
1649952948734,MATH 20E,A03,084140,Staff,23,0,30,7
1649952948734,MATH 20E,A04,084141,Staff,25,0,30,5
1649952954761,MATH 102,A01,084143,Harel; Guershon,16,0,30,14
1649952954761,MATH 102,A02,084144,Harel; Guershon,21,0,30,9
1649952960792,MATH 103B,A01,083456,Staff,0,9,30,30
1649952960792,MATH 103B,A02,083457,Staff,0,9,30,30
1649952966835,MATH 109,A01,084146,Salehi Golsefidy; Alireza,28,0,30,2
1649952966835,MATH 109,A02,084147,Salehi Golsefidy; Alireza,22,0,30,8
1649952972860,MATH 120A,A01,085445,Eggers; John Dietrich,20,0,35,15
1649952972860,MATH 120A,A02,085446,Eggers; John Dietrich,27,0,35,8
1649952978882,MATH 142B,A01,084149,Verstraete; Jacques Allan,0,11,30,30
1649952978882,MATH 142B,A02,084150,Verstraete; Jacques Allan,0,11,30,30
1649952984911,MATH 170A,A01,083459,Nie; Jiawang,0,2,30,30
1649952984911,MATH 170A,A02,083460,Nie; Jiawang,0,1,30,30
1649952984911,MATH 170A,A03,083461,Nie; Jiawang,1,0,30,29
1649952990945,MATH 193B,A01,083463,Staff,3,0,30,27
1649952990945,MATH 193B,A02,083464,Staff,10,0,30,20
1649952990945,MATH 193B,A03,083465,Staff,18,0,30,12
1649952997006,COGS 2,A01,083966,Boyle; Mary E. T.,17,0,30,13
1649953003028,COGS 9,A01,083968,Staff,39,0,60,21
1649953009052,COGS 14B,A01,083970,Staff,26,0,50,24
1649953015075,COGS 17,A01,092679,Staff,65,0,75,10
1649953021101,COGS 100,A01,083972,Staff,5,0,60,55
1649953033151,COGS 101C,A01,083976,Staff,19,0,30,11
1649953039173,COGS 102A,A01,083978,Johnson; Christine M.,16,0,30,14
1649953045202,COGS 107B,A01,083980,Staff,2,0,50,48
1649953051224,COGS 115,A01,083982,Staff,13,0,30,17
1649953057247,COGS 118B,A01,083367,Staff,0,11,40,40
1649953063276,COGS 172,A01,083984,Provenzano; Emily Kara,16,0,30,14
1649953069299,COGS 177,A00,083368,Staff,0,18,30,30
1649953075325,COGS 186,A01,083986,Staff,21,0,40,19
1649953081364,COGS 187A,A01,083988,Boyle; Mary E. T.,24,0,60,36
1649953087388,CSE 8A,A50,084003,Miranda; Gregory Joseph,0,1,15,15
1649953093415,CSE 11,A01,084005,Miranda; Gregory Joseph,17,0,55,38
1649953099442,CSE 20,A01,084007,Staff,9,0,20,11
1649953105469,CSE 21,A01,084009,Staff,8,0,50,42
1649953111507,CSE 30,A01,083370,Cao; Yingjun,0,23,40,40
1649953117533,CSE 100,A01,083372,Cao; Yingjun,0,28,40,40
1649953123560,CSE 101,A01,084011,Staff,0,51,40,40
1649953129584,CSE 141,A01,083374,Eldon; John,0,53,75,75
1649953135617,CSE 141L,A01,083376,Eldon; John,0,58,75,75
1649953141640,CSE 175,A01,084013,Kumar; Rakesh,22,0,25,3
1649953147666,CSE 190,A00,092508,Dubnov; Shlomo,15,0,15,0
1649953153693,ECE 5,A01,084049,Morris; Karcher William,15,0,20,5
1649953159716,ECE 100,A01,084051,Baghdadchi; Saharnaz,0,0,20,20
1649953159716,ECE 100,A02,091916,Baghdadchi; Saharnaz,16,0,20,4
1649953165743,ECE 101,A01,084053,Baghdadchi; Saharnaz,4,0,37,33
1649953165743,ECE 101,A02,084054,Baghdadchi; Saharnaz,32,0,37,5
1649953171766,ECE 107,A01,083390,Staff,28,0,40,12
1649953177789,ECE 148,A01,084056,Silberman; Jack,7,0,12,5
1649953183810,ECE 180,A00,083391,Abi Samra; Nicholas Camill,25,0,30,5
1649953183810,ECE 180,B00,083392,Abi Samra; Nicholas Camill,22,0,30,8
1649953189845,MATH 10B,A01,084110,Staff,8,0,30,22
1649953189845,MATH 10B,A02,084111,Staff,29,0,30,1
1649953189845,MATH 10B,A03,084112,Staff,27,0,30,3
1649953195869,MATH 10C,A01,083443,Staff,8,0,30,22
1649953195869,MATH 10C,A02,083444,Staff,16,0,30,14
1649953195869,MATH 10C,B01,084114,Staff,25,0,30,5
1649953195869,MATH 10C,B02,084115,Staff,29,0,30,1
1649953201898,MATH 18,A01,084117,Harel; Guershon,27,0,30,3
1649953201898,MATH 18,A02,084119,Harel; Guershon,29,0,30,1
1649953201898,MATH 18,A03,084120,Harel; Guershon,30,0,30,0
1649953201898,MATH 18,A04,084121,Harel; Guershon,29,0,30,1
1649953207929,MATH 20B,A01,084124,Um; Ko Woon,31,0,35,4
1649953207929,MATH 20B,B01,084126,Um; Ko Woon,32,0,35,3
1649953213959,MATH 20C,A01,083446,Hammock; Frances H,17,0,30,13
1649953213959,MATH 20C,A02,083447,Hammock; Frances H,28,0,30,2
1649953213959,MATH 20C,A03,083448,Hammock; Frances H,30,0,30,0
1649953213959,MATH 20C,A04,083449,Hammock; Frances H,30,0,30,0
1649953213959,MATH 20C,B01,083451,Hammock; Frances H,25,0,30,5
1649953213959,MATH 20C,B02,083452,Hammock; Frances H,27,0,30,3
1649953213959,MATH 20C,B03,083453,Hammock; Frances H,26,0,30,4
1649953213959,MATH 20C,B04,083454,Hammock; Frances H,30,0,30,0
1649953219982,MATH 20D,A01,084128,Staff,24,0,30,6
1649953219982,MATH 20D,A02,084129,Staff,30,0,30,0
1649953219982,MATH 20D,A03,084130,Staff,29,0,30,1
1649953219982,MATH 20D,B01,084133,Staff,17,0,30,13
1649953219982,MATH 20D,B02,084134,Staff,27,0,30,3
1649953219982,MATH 20D,B03,084135,Staff,30,0,30,0
1649953226009,MATH 20E,A01,084138,Staff,22,0,30,8
1649953226009,MATH 20E,A02,084139,Staff,19,0,30,11
1649953226009,MATH 20E,A03,084140,Staff,23,0,30,7
1649953226009,MATH 20E,A04,084141,Staff,25,0,30,5
1649953232044,MATH 102,A01,084143,Harel; Guershon,16,0,30,14
1649953232044,MATH 102,A02,084144,Harel; Guershon,21,0,30,9
1649953238080,MATH 103B,A01,083456,Staff,0,9,30,30
1649953238080,MATH 103B,A02,083457,Staff,0,9,30,30
1649953244108,MATH 109,A01,084146,Salehi Golsefidy; Alireza,28,0,30,2
1649953244108,MATH 109,A02,084147,Salehi Golsefidy; Alireza,22,0,30,8
1649953250140,MATH 120A,A01,085445,Eggers; John Dietrich,20,0,35,15
1649953250140,MATH 120A,A02,085446,Eggers; John Dietrich,27,0,35,8
1649953256165,MATH 142B,A01,084149,Verstraete; Jacques Allan,0,11,30,30
1649953256165,MATH 142B,A02,084150,Verstraete; Jacques Allan,0,11,30,30
1649953262188,MATH 170A,A01,083459,Nie; Jiawang,0,2,30,30
1649953262188,MATH 170A,A02,083460,Nie; Jiawang,0,1,30,30
1649953262188,MATH 170A,A03,083461,Nie; Jiawang,1,0,30,29
1649953268220,MATH 193B,A01,083463,Staff,3,0,30,27
1649953268220,MATH 193B,A02,083464,Staff,10,0,30,20
1649953268220,MATH 193B,A03,083465,Staff,18,0,30,12
1649953274274,COGS 2,A01,083966,Boyle; Mary E. T.,17,0,30,13
1649953280311,COGS 9,A01,083968,Staff,39,0,60,21
1649953286336,COGS 14B,A01,083970,Staff,26,0,50,24
1649953292364,COGS 17,A01,092679,Staff,65,0,75,10
1649953298393,COGS 100,A01,083972,Staff,4,0,60,56
1649953310453,COGS 101C,A01,083976,Staff,19,0,30,11
1649953316479,COGS 102A,A01,083978,Johnson; Christine M.,16,0,30,14
1649953322504,COGS 107B,A01,083980,Staff,2,0,50,48
1649953328530,COGS 115,A01,083982,Staff,13,0,30,17
1649953334555,COGS 118B,A01,083367,Staff,0,11,40,40
1649953340585,COGS 172,A01,083984,Provenzano; Emily Kara,16,0,30,14
1649953346611,COGS 177,A00,083368,Staff,0,18,30,30
1649953352638,COGS 186,A01,083986,Staff,21,0,40,19
1649953358661,COGS 187A,A01,083988,Boyle; Mary E. T.,24,0,60,36
1649953364688,CSE 8A,A50,084003,Miranda; Gregory Joseph,0,2,15,15
1649953370713,CSE 11,A01,084005,Miranda; Gregory Joseph,17,0,55,38
1649953376737,CSE 20,A01,084007,Staff,9,0,20,11
1649953382874,CSE 21,A01,084009,Staff,8,0,50,42
1649953388901,CSE 30,A01,083370,Cao; Yingjun,0,23,40,40
1649953394926,CSE 100,A01,083372,Cao; Yingjun,0,28,40,40
1649953400950,CSE 101,A01,084011,Staff,0,51,40,40
1649953406973,CSE 141,A01,083374,Eldon; John,0,53,75,75
1649953413003,CSE 141L,A01,083376,Eldon; John,0,58,75,75
1649953419029,CSE 175,A01,084013,Kumar; Rakesh,22,0,25,3
1649953425057,CSE 190,A00,092508,Dubnov; Shlomo,15,0,15,0
1649953431083,ECE 5,A01,084049,Morris; Karcher William,15,0,20,5
1649953437120,ECE 100,A01,084051,Baghdadchi; Saharnaz,0,0,20,20
1649953437120,ECE 100,A02,091916,Baghdadchi; Saharnaz,16,0,20,4
1649953443143,ECE 101,A01,084053,Baghdadchi; Saharnaz,4,0,37,33
1649953443143,ECE 101,A02,084054,Baghdadchi; Saharnaz,32,0,37,5
1649953449172,ECE 107,A01,083390,Staff,28,0,40,12
1649953455194,ECE 148,A01,084056,Silberman; Jack,7,0,12,5
1649953461218,ECE 180,A00,083391,Abi Samra; Nicholas Camill,25,0,30,5
1649953461218,ECE 180,B00,083392,Abi Samra; Nicholas Camill,22,0,30,8
1649953467241,MATH 10B,A01,084110,Staff,8,0,30,22
1649953467241,MATH 10B,A02,084111,Staff,29,0,30,1
1649953467241,MATH 10B,A03,084112,Staff,27,0,30,3
1649953473264,MATH 10C,A01,083443,Staff,8,0,30,22
1649953473264,MATH 10C,A02,083444,Staff,15,0,30,15
1649953473264,MATH 10C,B01,084114,Staff,25,0,30,5
1649953473264,MATH 10C,B02,084115,Staff,28,0,30,2
1649953479289,MATH 18,A01,084117,Harel; Guershon,27,0,30,3
1649953479289,MATH 18,A02,084119,Harel; Guershon,29,0,30,1
1649953479289,MATH 18,A03,084120,Harel; Guershon,30,0,30,0
1649953479289,MATH 18,A04,084121,Harel; Guershon,29,0,30,1
1649953485322,MATH 20B,A01,084124,Um; Ko Woon,31,0,35,4
1649953485322,MATH 20B,B01,084126,Um; Ko Woon,32,0,35,3
1649953491355,MATH 20C,A01,083446,Hammock; Frances H,17,0,30,13
1649953491355,MATH 20C,A02,083447,Hammock; Frances H,28,0,30,2
1649953491355,MATH 20C,A03,083448,Hammock; Frances H,30,0,30,0
1649953491355,MATH 20C,A04,083449,Hammock; Frances H,30,0,30,0
1649953491355,MATH 20C,B01,083451,Hammock; Frances H,25,0,30,5
1649953491355,MATH 20C,B02,083452,Hammock; Frances H,27,0,30,3
1649953491355,MATH 20C,B03,083453,Hammock; Frances H,26,0,30,4
1649953491355,MATH 20C,B04,083454,Hammock; Frances H,30,0,30,0
1649953497382,MATH 20D,A01,084128,Staff,24,0,30,6
1649953497382,MATH 20D,A02,084129,Staff,30,0,30,0
1649953497382,MATH 20D,A03,084130,Staff,29,0,30,1
1649953497382,MATH 20D,B01,084133,Staff,17,0,30,13
1649953497382,MATH 20D,B02,084134,Staff,27,0,30,3
1649953497382,MATH 20D,B03,084135,Staff,30,0,30,0
1649953503425,MATH 20E,A01,084138,Staff,22,0,30,8
1649953503425,MATH 20E,A02,084139,Staff,19,0,30,11
1649953503425,MATH 20E,A03,084140,Staff,23,0,30,7
1649953503425,MATH 20E,A04,084141,Staff,25,0,30,5
1649953509447,MATH 102,A01,084143,Harel; Guershon,16,0,30,14
1649953509447,MATH 102,A02,084144,Harel; Guershon,21,0,30,9
1649953515475,MATH 103B,A01,083456,Staff,0,9,30,30
1649953515475,MATH 103B,A02,083457,Staff,0,9,30,30
1649953521498,MATH 109,A01,084146,Salehi Golsefidy; Alireza,27,0,30,3
1649953521498,MATH 109,A02,084147,Salehi Golsefidy; Alireza,22,0,30,8
1649953527528,MATH 120A,A01,085445,Eggers; John Dietrich,20,0,35,15
1649953527528,MATH 120A,A02,085446,Eggers; John Dietrich,27,0,35,8
1649953533555,MATH 142B,A01,084149,Verstraete; Jacques Allan,0,11,30,30
1649953533555,MATH 142B,A02,084150,Verstraete; Jacques Allan,0,11,30,30
1649953539579,MATH 170A,A01,083459,Nie; Jiawang,0,2,30,30
1649953539579,MATH 170A,A02,083460,Nie; Jiawang,0,1,30,30
1649953539579,MATH 170A,A03,083461,Nie; Jiawang,0,0,30,30
1649953545601,MATH 193B,A01,083463,Staff,2,0,30,28
1649953545601,MATH 193B,A02,083464,Staff,10,0,30,20
1649953545601,MATH 193B,A03,083465,Staff,18,0,30,12
1649953551660,COGS 2,A01,083966,Boyle; Mary E. T.,17,0,30,13
1649953557686,COGS 9,A01,083968,Staff,39,0,60,21
1649953563709,COGS 14B,A01,083970,Staff,26,0,50,24
1649953569736,COGS 17,A01,092679,Staff,65,0,75,10
1649953575758,COGS 100,A01,083972,Staff,4,0,60,56
1649953587813,COGS 101C,A01,083976,Staff,19,0,30,11
1649953593841,COGS 102A,A01,083978,Johnson; Christine M.,16,0,30,14
1649953599875,COGS 107B,A01,083980,Staff,2,0,50,48
1649953605899,COGS 115,A01,083982,Staff,13,0,30,17
1649953611924,COGS 118B,A01,083367,Staff,0,11,40,40
1649953617948,COGS 172,A01,083984,Provenzano; Emily Kara,16,0,30,14
1649953623984,COGS 177,A00,083368,Staff,0,18,30,30
1649953630007,COGS 186,A01,083986,Staff,21,0,40,19
1649953636030,COGS 187A,A01,083988,Boyle; Mary E. T.,24,0,60,36
1649953642052,CSE 8A,A50,084003,Miranda; Gregory Joseph,0,2,15,15
1649953648076,CSE 11,A01,084005,Miranda; Gregory Joseph,17,0,55,38
1649953654100,CSE 20,A01,084007,Staff,9,0,20,11
1649953660123,CSE 21,A01,084009,Staff,8,0,50,42
1649953666145,CSE 30,A01,083370,Cao; Yingjun,0,23,40,40
1649953672170,CSE 100,A01,083372,Cao; Yingjun,0,28,40,40
1649953678193,CSE 101,A01,084011,Staff,0,51,40,40
1649953684226,CSE 141,A01,083374,Eldon; John,0,53,75,75
1649953690249,CSE 141L,A01,083376,Eldon; John,0,58,75,75
1649953696272,CSE 175,A01,084013,Kumar; Rakesh,22,0,25,3
1649953702313,CSE 190,A00,092508,Dubnov; Shlomo,15,0,15,0
1649953708338,ECE 5,A01,084049,Morris; Karcher William,15,0,20,5
1649953714375,ECE 100,A01,084051,Baghdadchi; Saharnaz,0,0,20,20
1649953714375,ECE 100,A02,091916,Baghdadchi; Saharnaz,16,0,20,4
1649953720400,ECE 101,A01,084053,Baghdadchi; Saharnaz,4,0,37,33
1649953720400,ECE 101,A02,084054,Baghdadchi; Saharnaz,32,0,37,5
1649953726429,ECE 107,A01,083390,Staff,28,0,40,12
1649953732458,ECE 148,A01,084056,Silberman; Jack,7,0,12,5
1649953738493,ECE 180,A00,083391,Abi Samra; Nicholas Camill,25,0,30,5
1649953738493,ECE 180,B00,083392,Abi Samra; Nicholas Camill,22,0,30,8
1649953744521,MATH 10B,A01,084110,Staff,8,0,30,22
1649953744521,MATH 10B,A02,084111,Staff,29,0,30,1
1649953744521,MATH 10B,A03,084112,Staff,27,0,30,3
1649953750548,MATH 10C,A01,083443,Staff,8,0,30,22
1649953750548,MATH 10C,A02,083444,Staff,15,0,30,15
1649953750548,MATH 10C,B01,084114,Staff,25,0,30,5
1649953750548,MATH 10C,B02,084115,Staff,28,0,30,2
1649953756570,MATH 18,A01,084117,Harel; Guershon,27,0,30,3
1649953756570,MATH 18,A02,084119,Harel; Guershon,29,0,30,1
1649953756570,MATH 18,A03,084120,Harel; Guershon,30,0,30,0
1649953756570,MATH 18,A04,084121,Harel; Guershon,29,0,30,1
1649953762594,MATH 20B,A01,084124,Um; Ko Woon,31,0,35,4
1649953762594,MATH 20B,B01,084126,Um; Ko Woon,32,0,35,3
1649953768628,MATH 20C,A01,083446,Hammock; Frances H,17,0,30,13
1649953768628,MATH 20C,A02,083447,Hammock; Frances H,28,0,30,2
1649953768628,MATH 20C,A03,083448,Hammock; Frances H,30,0,30,0
1649953768628,MATH 20C,A04,083449,Hammock; Frances H,30,0,30,0
1649953768628,MATH 20C,B01,083451,Hammock; Frances H,25,0,30,5
1649953768628,MATH 20C,B02,083452,Hammock; Frances H,27,0,30,3
1649953768628,MATH 20C,B03,083453,Hammock; Frances H,26,0,30,4
1649953768628,MATH 20C,B04,083454,Hammock; Frances H,30,0,30,0
1649953774654,MATH 20D,A01,084128,Staff,24,0,30,6
1649953774654,MATH 20D,A02,084129,Staff,30,0,30,0
1649953774654,MATH 20D,A03,084130,Staff,29,0,30,1
1649953774654,MATH 20D,B01,084133,Staff,17,0,30,13
1649953774654,MATH 20D,B02,084134,Staff,27,0,30,3
1649953774654,MATH 20D,B03,084135,Staff,30,0,30,0
1649953780680,MATH 20E,A01,084138,Staff,22,0,30,8
1649953780680,MATH 20E,A02,084139,Staff,19,0,30,11
1649953780680,MATH 20E,A03,084140,Staff,23,0,30,7
1649953780680,MATH 20E,A04,084141,Staff,25,0,30,5
1649953786721,MATH 102,A01,084143,Harel; Guershon,16,0,30,14
1649953786721,MATH 102,A02,084144,Harel; Guershon,21,0,30,9
1649953792744,MATH 103B,A01,083456,Staff,0,9,30,30
1649953792744,MATH 103B,A02,083457,Staff,0,9,30,30
1649953798781,MATH 109,A01,084146,Salehi Golsefidy; Alireza,27,0,30,3
1649953798781,MATH 109,A02,084147,Salehi Golsefidy; Alireza,22,0,30,8
1649953804809,MATH 120A,A01,085445,Eggers; John Dietrich,20,0,35,15
1649953804809,MATH 120A,A02,085446,Eggers; John Dietrich,27,0,35,8
1649953810831,MATH 142B,A01,084149,Verstraete; Jacques Allan,0,11,30,30
1649953810831,MATH 142B,A02,084150,Verstraete; Jacques Allan,0,11,30,30
1649953816863,MATH 170A,A01,083459,Nie; Jiawang,0,3,30,30
1649953816863,MATH 170A,A02,083460,Nie; Jiawang,0,1,30,30
1649953816863,MATH 170A,A03,083461,Nie; Jiawang,0,0,30,30
1649953822887,MATH 193B,A01,083463,Staff,2,0,30,28
1649953822887,MATH 193B,A02,083464,Staff,10,0,30,20
1649953822887,MATH 193B,A03,083465,Staff,18,0,30,12
1649953828956,COGS 2,A01,083966,Boyle; Mary E. T.,17,0,30,13
1649953834993,COGS 9,A01,083968,Staff,39,0,60,21
1649953841021,COGS 14B,A01,083970,Staff,26,0,50,24
1649953847045,COGS 17,A01,092679,Staff,65,0,75,10
1649953853071,COGS 100,A01,083972,Staff,4,0,60,56
1649953865131,COGS 101C,A01,083976,Staff,19,0,30,11
1649953871164,COGS 102A,A01,083978,Johnson; Christine M.,16,0,30,14
1649953877189,COGS 107B,A01,083980,Staff,2,0,50,48
1649953883212,COGS 115,A01,083982,Staff,13,0,30,17
1649953889241,COGS 118B,A01,083367,Staff,0,11,40,40
1649953895268,COGS 172,A01,083984,Provenzano; Emily Kara,16,0,30,14
1649953901291,COGS 177,A00,083368,Staff,0,18,30,30
1649953907322,COGS 186,A01,083986,Staff,21,0,40,19
1649953913354,COGS 187A,A01,083988,Boyle; Mary E. T.,24,0,60,36
1649953919387,CSE 8A,A50,084003,Miranda; Gregory Joseph,0,3,15,15
1649953925412,CSE 11,A01,084005,Miranda; Gregory Joseph,17,0,55,38
1649953931439,CSE 20,A01,084007,Staff,9,0,20,11
1649953937462,CSE 21,A01,084009,Staff,8,0,50,42
1649953943489,CSE 30,A01,083370,Cao; Yingjun,0,23,40,40
1649953949527,CSE 100,A01,083372,Cao; Yingjun,0,29,40,40
1649953955577,CSE 101,A01,084011,Staff,0,51,40,40
1649953961600,CSE 141,A01,083374,Eldon; John,0,53,75,75
1649953967636,CSE 141L,A01,083376,Eldon; John,0,58,75,75
1649953973659,CSE 175,A01,084013,Kumar; Rakesh,22,0,25,3
1649953979789,CSE 190,A00,092508,Dubnov; Shlomo,15,0,15,0
1649953985835,ECE 5,A01,084049,Morris; Karcher William,15,0,20,5
1649953991877,ECE 100,A01,084051,Baghdadchi; Saharnaz,0,0,20,20
1649953991877,ECE 100,A02,091916,Baghdadchi; Saharnaz,16,0,20,4
1649953997900,ECE 101,A01,084053,Baghdadchi; Saharnaz,4,0,37,33
1649953997900,ECE 101,A02,084054,Baghdadchi; Saharnaz,32,0,37,5
1649954003935,ECE 107,A01,083390,Staff,28,0,40,12
1649954009959,ECE 148,A01,084056,Silberman; Jack,7,0,12,5
1649954015989,ECE 180,A00,083391,Abi Samra; Nicholas Camill,25,0,30,5
1649954015989,ECE 180,B00,083392,Abi Samra; Nicholas Camill,22,0,30,8
1649954022017,MATH 10B,A01,084110,Staff,8,0,30,22
1649954022017,MATH 10B,A02,084111,Staff,29,0,30,1
1649954022017,MATH 10B,A03,084112,Staff,27,0,30,3
1649954028039,MATH 10C,A01,083443,Staff,8,0,30,22
1649954028039,MATH 10C,A02,083444,Staff,15,0,30,15
1649954028039,MATH 10C,B01,084114,Staff,25,0,30,5
1649954028039,MATH 10C,B02,084115,Staff,28,0,30,2
1649954034062,MATH 18,A01,084117,Harel; Guershon,27,0,30,3
1649954034062,MATH 18,A02,084119,Harel; Guershon,29,0,30,1
1649954034062,MATH 18,A03,084120,Harel; Guershon,30,0,30,0
1649954034062,MATH 18,A04,084121,Harel; Guershon,29,0,30,1
1649954040084,MATH 20B,A01,084124,Um; Ko Woon,31,0,35,4
1649954040084,MATH 20B,B01,084126,Um; Ko Woon,32,0,35,3
1649954046114,MATH 20C,A01,083446,Hammock; Frances H,17,0,30,13
1649954046114,MATH 20C,A02,083447,Hammock; Frances H,28,0,30,2
1649954046114,MATH 20C,A03,083448,Hammock; Frances H,30,0,30,0
1649954046114,MATH 20C,A04,083449,Hammock; Frances H,30,0,30,0
1649954046114,MATH 20C,B01,083451,Hammock; Frances H,25,0,30,5
1649954046114,MATH 20C,B02,083452,Hammock; Frances H,27,0,30,3
1649954046114,MATH 20C,B03,083453,Hammock; Frances H,26,0,30,4
1649954046114,MATH 20C,B04,083454,Hammock; Frances H,30,0,30,0
1649954052141,MATH 20D,A01,084128,Staff,24,0,30,6
1649954052141,MATH 20D,A02,084129,Staff,30,0,30,0
1649954052141,MATH 20D,A03,084130,Staff,29,0,30,1
1649954052141,MATH 20D,B01,084133,Staff,17,0,30,13
1649954052141,MATH 20D,B02,084134,Staff,27,0,30,3
1649954052141,MATH 20D,B03,084135,Staff,30,0,30,0
1649954058163,MATH 20E,A01,084138,Staff,22,0,30,8
1649954058163,MATH 20E,A02,084139,Staff,19,0,30,11
1649954058163,MATH 20E,A03,084140,Staff,22,0,30,8
1649954058163,MATH 20E,A04,084141,Staff,25,0,30,5
1649954064193,MATH 102,A01,084143,Harel; Guershon,16,0,30,14
1649954064193,MATH 102,A02,084144,Harel; Guershon,21,0,30,9
1649954070221,MATH 103B,A01,083456,Staff,0,9,30,30
1649954070221,MATH 103B,A02,083457,Staff,0,9,30,30
1649954076248,MATH 109,A01,084146,Salehi Golsefidy; Alireza,27,0,30,3
1649954076248,MATH 109,A02,084147,Salehi Golsefidy; Alireza,22,0,30,8
1649954082285,MATH 120A,A01,085445,Eggers; John Dietrich,20,0,35,15
1649954082285,MATH 120A,A02,085446,Eggers; John Dietrich,27,0,35,8
1649954088307,MATH 142B,A01,084149,Verstraete; Jacques Allan,0,11,30,30
1649954088307,MATH 142B,A02,084150,Verstraete; Jacques Allan,0,11,30,30
1649954094336,MATH 170A,A01,083459,Nie; Jiawang,0,3,30,30
1649954094336,MATH 170A,A02,083460,Nie; Jiawang,0,1,30,30
1649954094336,MATH 170A,A03,083461,Nie; Jiawang,0,0,30,30
1649954100364,MATH 193B,A01,083463,Staff,2,0,30,28
1649954100364,MATH 193B,A02,083464,Staff,10,0,30,20
1649954100364,MATH 193B,A03,083465,Staff,18,0,30,12
1649954106418,COGS 2,A01,083966,Boyle; Mary E. T.,17,0,30,13
1649954112455,COGS 9,A01,083968,Staff,38,0,60,22
1649954118485,COGS 14B,A01,083970,Staff,26,0,50,24
1649954124507,COGS 17,A01,092679,Staff,65,0,75,10
1649954130534,COGS 100,A01,083972,Staff,4,0,60,56
1649954142579,COGS 101C,A01,083976,Staff,19,0,30,11
1649954148602,COGS 102A,A01,083978,Johnson; Christine M.,16,0,30,14
1649954154628,COGS 107B,A01,083980,Staff,2,0,50,48
1649954160656,COGS 115,A01,083982,Staff,13,0,30,17
1649954166688,COGS 118B,A01,083367,Staff,0,11,40,40
1649954172711,COGS 172,A01,083984,Provenzano; Emily Kara,16,0,30,14
1649954178737,COGS 177,A00,083368,Staff,0,18,30,30
1649954184760,COGS 186,A01,083986,Staff,21,0,40,19
1649954190782,COGS 187A,A01,083988,Boyle; Mary E. T.,24,0,60,36
1649954196811,CSE 8A,A50,084003,Miranda; Gregory Joseph,0,3,15,15
1649954202840,CSE 11,A01,084005,Miranda; Gregory Joseph,17,0,55,38
1649954208863,CSE 20,A01,084007,Staff,9,0,20,11
1649954214891,CSE 21,A01,084009,Staff,7,0,50,43
1649954220920,CSE 30,A01,083370,Cao; Yingjun,0,25,40,40
1649954226955,CSE 100,A01,083372,Cao; Yingjun,0,29,40,40
1649954232979,CSE 101,A01,084011,Staff,0,51,40,40
1649954239002,CSE 141,A01,083374,Eldon; John,0,53,75,75
1649954245027,CSE 141L,A01,083376,Eldon; John,0,58,75,75
1649954251051,CSE 175,A01,084013,Kumar; Rakesh,22,0,25,3
1649954257081,CSE 190,A00,092508,Dubnov; Shlomo,15,0,15,0
1649954263104,ECE 5,A01,084049,Morris; Karcher William,15,0,20,5
1649954269136,ECE 100,A01,084051,Baghdadchi; Saharnaz,0,0,20,20
1649954269136,ECE 100,A02,091916,Baghdadchi; Saharnaz,16,0,20,4
1649954275162,ECE 101,A01,084053,Baghdadchi; Saharnaz,3,0,37,34
1649954275162,ECE 101,A02,084054,Baghdadchi; Saharnaz,32,0,37,5
1649954281186,ECE 107,A01,083390,Staff,28,0,40,12
1649954287214,ECE 148,A01,084056,Silberman; Jack,7,0,12,5
1649954293242,ECE 180,A00,083391,Abi Samra; Nicholas Camill,25,0,30,5
1649954293242,ECE 180,B00,083392,Abi Samra; Nicholas Camill,22,0,30,8
1649954299276,MATH 10B,A01,084110,Staff,8,0,30,22
1649954299276,MATH 10B,A02,084111,Staff,29,0,30,1
1649954299276,MATH 10B,A03,084112,Staff,27,0,30,3
1649954305305,MATH 10C,A01,083443,Staff,8,0,30,22
1649954305305,MATH 10C,A02,083444,Staff,15,0,30,15
1649954305305,MATH 10C,B01,084114,Staff,25,0,30,5
1649954305305,MATH 10C,B02,084115,Staff,28,0,30,2
1649954311332,MATH 18,A01,084117,Harel; Guershon,27,0,30,3
1649954311332,MATH 18,A02,084119,Harel; Guershon,29,0,30,1
1649954311332,MATH 18,A03,084120,Harel; Guershon,30,0,30,0
1649954311332,MATH 18,A04,084121,Harel; Guershon,29,0,30,1
1649954317370,MATH 20B,A01,084124,Um; Ko Woon,31,0,35,4
1649954317370,MATH 20B,B01,084126,Um; Ko Woon,32,0,35,3
1649954323400,MATH 20C,A01,083446,Hammock; Frances H,17,0,30,13
1649954323400,MATH 20C,A02,083447,Hammock; Frances H,28,0,30,2
1649954323400,MATH 20C,A03,083448,Hammock; Frances H,30,0,30,0
1649954323400,MATH 20C,A04,083449,Hammock; Frances H,30,0,30,0
1649954323400,MATH 20C,B01,083451,Hammock; Frances H,25,0,30,5
1649954323400,MATH 20C,B02,083452,Hammock; Frances H,27,0,30,3
1649954323400,MATH 20C,B03,083453,Hammock; Frances H,26,0,30,4
1649954323400,MATH 20C,B04,083454,Hammock; Frances H,30,0,30,0
1649954329424,MATH 20D,A01,084128,Staff,24,0,30,6
1649954329424,MATH 20D,A02,084129,Staff,30,0,30,0
1649954329424,MATH 20D,A03,084130,Staff,29,0,30,1
1649954329424,MATH 20D,B01,084133,Staff,17,0,30,13
1649954329424,MATH 20D,B02,084134,Staff,27,0,30,3
1649954329424,MATH 20D,B03,084135,Staff,30,0,30,0
1649954335447,MATH 20E,A01,084138,Staff,22,0,30,8
1649954335447,MATH 20E,A02,084139,Staff,19,0,30,11
1649954335447,MATH 20E,A03,084140,Staff,22,0,30,8
1649954335447,MATH 20E,A04,084141,Staff,25,0,30,5
1649954341470,MATH 102,A01,084143,Harel; Guershon,16,0,30,14
1649954341470,MATH 102,A02,084144,Harel; Guershon,21,0,30,9
1649954347505,MATH 103B,A01,083456,Staff,0,9,30,30
1649954347505,MATH 103B,A02,083457,Staff,0,9,30,30
1649954353532,MATH 109,A01,084146,Salehi Golsefidy; Alireza,27,0,30,3
1649954353532,MATH 109,A02,084147,Salehi Golsefidy; Alireza,22,0,30,8
1649954359563,MATH 120A,A01,085445,Eggers; John Dietrich,20,0,35,15
1649954359563,MATH 120A,A02,085446,Eggers; John Dietrich,27,0,35,8
1649954365595,MATH 142B,A01,084149,Verstraete; Jacques Allan,0,11,30,30
1649954365595,MATH 142B,A02,084150,Verstraete; Jacques Allan,0,11,30,30
1649954371630,MATH 170A,A01,083459,Nie; Jiawang,0,3,30,30
1649954371630,MATH 170A,A02,083460,Nie; Jiawang,0,1,30,30
1649954371630,MATH 170A,A03,083461,Nie; Jiawang,0,0,30,30
1649954377671,MATH 193B,A01,083463,Staff,1,0,30,29
1649954377671,MATH 193B,A02,083464,Staff,10,0,30,20
1649954377671,MATH 193B,A03,083465,Staff,18,0,30,12
1649954383750,COGS 2,A01,083966,Boyle; Mary E. T.,17,0,30,13
1649954389778,COGS 9,A01,083968,Staff,38,0,60,22
1649954395801,COGS 14B,A01,083970,Staff,26,0,50,24
1649954401824,COGS 17,A01,092679,Staff,65,0,75,10
1649954407847,COGS 100,A01,083972,Staff,4,0,60,56
1649954419895,COGS 101C,A01,083976,Staff,19,0,30,11
1649954425918,COGS 102A,A01,083978,Johnson; Christine M.,16,0,30,14
1649954431940,COGS 107B,A01,083980,Staff,2,0,50,48
1649954437964,COGS 115,A01,083982,Staff,13,0,30,17
1649954443991,COGS 118B,A01,083367,Staff,0,11,40,40
1649954450022,COGS 172,A01,083984,Provenzano; Emily Kara,16,0,30,14
1649954456051,COGS 177,A00,083368,Staff,0,18,30,30
1649954462094,COGS 186,A01,083986,Staff,21,0,40,19
1649954468117,COGS 187A,A01,083988,Boyle; Mary E. T.,24,0,60,36
1649954474140,CSE 8A,A50,084003,Miranda; Gregory Joseph,0,3,15,15
1649954480166,CSE 11,A01,084005,Miranda; Gregory Joseph,17,0,55,38
1649954486189,CSE 20,A01,084007,Staff,8,0,20,12
1649954492224,CSE 21,A01,084009,Staff,7,0,50,43
1649954498247,CSE 30,A01,083370,Cao; Yingjun,0,25,40,40
1649954504283,CSE 100,A01,083372,Cao; Yingjun,0,29,40,40
1649954510310,CSE 101,A01,084011,Staff,0,51,40,40
1649954516332,CSE 141,A01,083374,Eldon; John,0,53,75,75
1649954522359,CSE 141L,A01,083376,Eldon; John,0,58,75,75
1649954528391,CSE 175,A01,084013,Kumar; Rakesh,22,0,25,3
1649954534414,CSE 190,A00,092508,Dubnov; Shlomo,15,0,15,0
1649954540452,ECE 5,A01,084049,Morris; Karcher William,15,0,20,5
1649954546485,ECE 100,A01,084051,Baghdadchi; Saharnaz,0,0,20,20
1649954546485,ECE 100,A02,091916,Baghdadchi; Saharnaz,16,0,20,4
1649954552508,ECE 101,A01,084053,Baghdadchi; Saharnaz,3,0,37,34
1649954552508,ECE 101,A02,084054,Baghdadchi; Saharnaz,32,0,37,5
1649954558542,ECE 107,A01,083390,Staff,28,0,40,12
1649954564564,ECE 148,A01,084056,Silberman; Jack,7,0,12,5
1649954570595,ECE 180,A00,083391,Abi Samra; Nicholas Camill,25,0,30,5
1649954570595,ECE 180,B00,083392,Abi Samra; Nicholas Camill,22,0,30,8
1649954576723,MATH 10B,A01,084110,Staff,8,0,30,22
1649954576723,MATH 10B,A02,084111,Staff,29,0,30,1
1649954576723,MATH 10B,A03,084112,Staff,27,0,30,3
1649954582752,MATH 10C,A01,083443,Staff,8,0,30,22
1649954582752,MATH 10C,A02,083444,Staff,15,0,30,15
1649954582752,MATH 10C,B01,084114,Staff,25,0,30,5
1649954582752,MATH 10C,B02,084115,Staff,28,0,30,2
1649954588774,MATH 18,A01,084117,Harel; Guershon,27,0,30,3
1649954588774,MATH 18,A02,084119,Harel; Guershon,29,0,30,1
1649954588774,MATH 18,A03,084120,Harel; Guershon,30,0,30,0
1649954588774,MATH 18,A04,084121,Harel; Guershon,29,0,30,1
1649954594814,MATH 20B,A01,084124,Um; Ko Woon,31,0,35,4
1649954594814,MATH 20B,B01,084126,Um; Ko Woon,32,0,35,3
1649954600845,MATH 20C,A01,083446,Hammock; Frances H,17,0,30,13
1649954600845,MATH 20C,A02,083447,Hammock; Frances H,28,0,30,2
1649954600845,MATH 20C,A03,083448,Hammock; Frances H,30,0,30,0
1649954600845,MATH 20C,A04,083449,Hammock; Frances H,30,0,30,0
1649954600845,MATH 20C,B01,083451,Hammock; Frances H,24,0,30,6
1649954600845,MATH 20C,B02,083452,Hammock; Frances H,27,0,30,3
1649954600845,MATH 20C,B03,083453,Hammock; Frances H,26,0,30,4
1649954600845,MATH 20C,B04,083454,Hammock; Frances H,30,0,30,0
1649954606874,MATH 20D,A01,084128,Staff,24,0,30,6
1649954606874,MATH 20D,A02,084129,Staff,30,0,30,0
1649954606874,MATH 20D,A03,084130,Staff,29,0,30,1
1649954606874,MATH 20D,B01,084133,Staff,17,0,30,13
1649954606874,MATH 20D,B02,084134,Staff,27,0,30,3
1649954606874,MATH 20D,B03,084135,Staff,30,0,30,0
1649954612901,MATH 20E,A01,084138,Staff,22,0,30,8
1649954612901,MATH 20E,A02,084139,Staff,19,0,30,11
1649954612901,MATH 20E,A03,084140,Staff,22,0,30,8
1649954612901,MATH 20E,A04,084141,Staff,25,0,30,5
1649954618938,MATH 102,A01,084143,Harel; Guershon,16,0,30,14
1649954618938,MATH 102,A02,084144,Harel; Guershon,21,0,30,9
1649954624976,MATH 103B,A01,083456,Staff,0,9,30,30
1649954624976,MATH 103B,A02,083457,Staff,0,9,30,30
1649954631004,MATH 109,A01,084146,Salehi Golsefidy; Alireza,27,0,30,3
1649954631004,MATH 109,A02,084147,Salehi Golsefidy; Alireza,22,0,30,8
1649954637030,MATH 120A,A01,085445,Eggers; John Dietrich,20,0,35,15
1649954637030,MATH 120A,A02,085446,Eggers; John Dietrich,27,0,35,8
1649954643056,MATH 142B,A01,084149,Verstraete; Jacques Allan,0,11,30,30
1649954643056,MATH 142B,A02,084150,Verstraete; Jacques Allan,0,11,30,30
1649954649080,MATH 170A,A01,083459,Nie; Jiawang,0,3,30,30
1649954649080,MATH 170A,A02,083460,Nie; Jiawang,0,1,30,30
1649954649080,MATH 170A,A03,083461,Nie; Jiawang,0,0,30,30
1649954655103,MATH 193B,A01,083463,Staff,1,0,30,29
1649954655103,MATH 193B,A02,083464,Staff,10,0,30,20
1649954655103,MATH 193B,A03,083465,Staff,18,0,30,12
1649954661181,COGS 2,A01,083966,Boyle; Mary E. T.,17,0,30,13
1649954667206,COGS 9,A01,083968,Staff,38,0,60,22
1649954673250,COGS 14B,A01,083970,Staff,25,0,50,25
1649954679278,COGS 17,A01,092679,Staff,65,0,75,10
1649954685302,COGS 100,A01,083972,Staff,4,0,60,56
1649954697350,COGS 101C,A01,083976,Staff,19,0,30,11
1649954703383,COGS 102A,A01,083978,Johnson; Christine M.,16,0,30,14
1649954709410,COGS 107B,A01,083980,Staff,2,0,50,48
1649954715445,COGS 115,A01,083982,Staff,13,0,30,17
1649954721468,COGS 118B,A01,083367,Staff,0,11,40,40
1649954727495,COGS 172,A01,083984,Provenzano; Emily Kara,16,0,30,14
1649954733524,COGS 177,A00,083368,Staff,0,18,30,30
1649954739551,COGS 186,A01,083986,Staff,21,0,40,19
1649954745576,COGS 187A,A01,083988,Boyle; Mary E. T.,24,0,60,36
1649954751603,CSE 8A,A50,084003,Miranda; Gregory Joseph,0,3,15,15
1649954757637,CSE 11,A01,084005,Miranda; Gregory Joseph,17,0,55,38
1649954763666,CSE 20,A01,084007,Staff,8,0,20,12
1649954769691,CSE 21,A01,084009,Staff,7,0,50,43
1649954775716,CSE 30,A01,083370,Cao; Yingjun,0,25,40,40
1649954781749,CSE 100,A01,083372,Cao; Yingjun,0,29,40,40
1649954787775,CSE 101,A01,084011,Staff,0,51,40,40
1649954793807,CSE 141,A01,083374,Eldon; John,0,53,75,75
1649954799834,CSE 141L,A01,083376,Eldon; John,0,58,75,75
1649954805857,CSE 175,A01,084013,Kumar; Rakesh,22,0,25,3
1649954811880,CSE 190,A00,092508,Dubnov; Shlomo,15,0,15,0
1649954817904,ECE 5,A01,084049,Morris; Karcher William,15,0,20,5
1649954823930,ECE 100,A01,084051,Baghdadchi; Saharnaz,0,0,20,20
1649954823930,ECE 100,A02,091916,Baghdadchi; Saharnaz,16,0,20,4
1649954829954,ECE 101,A01,084053,Baghdadchi; Saharnaz,3,0,37,34
1649954829954,ECE 101,A02,084054,Baghdadchi; Saharnaz,32,0,37,5
1649954835981,ECE 107,A01,083390,Staff,28,0,40,12
1649954842003,ECE 148,A01,084056,Silberman; Jack,7,0,12,5
1649954848027,ECE 180,A00,083391,Abi Samra; Nicholas Camill,25,0,30,5
1649954848027,ECE 180,B00,083392,Abi Samra; Nicholas Camill,22,0,30,8
1649954854050,MATH 10B,A01,084110,Staff,8,0,30,22
1649954854050,MATH 10B,A02,084111,Staff,29,0,30,1
1649954854050,MATH 10B,A03,084112,Staff,27,0,30,3
1649954860076,MATH 10C,A01,083443,Staff,8,0,30,22
1649954860076,MATH 10C,A02,083444,Staff,15,0,30,15
1649954860076,MATH 10C,B01,084114,Staff,25,0,30,5
1649954860076,MATH 10C,B02,084115,Staff,28,0,30,2
1649954866114,MATH 18,A01,084117,Harel; Guershon,27,0,30,3
1649954866114,MATH 18,A02,084119,Harel; Guershon,28,0,30,2
1649954866114,MATH 18,A03,084120,Harel; Guershon,30,0,30,0
1649954866114,MATH 18,A04,084121,Harel; Guershon,29,0,30,1
1649954872143,MATH 20B,A01,084124,Um; Ko Woon,31,0,35,4
1649954872143,MATH 20B,B01,084126,Um; Ko Woon,32,0,35,3
1649954878170,MATH 20C,A01,083446,Hammock; Frances H,17,0,30,13
1649954878170,MATH 20C,A02,083447,Hammock; Frances H,28,0,30,2
1649954878170,MATH 20C,A03,083448,Hammock; Frances H,30,0,30,0
1649954878170,MATH 20C,A04,083449,Hammock; Frances H,30,0,30,0
1649954878170,MATH 20C,B01,083451,Hammock; Frances H,24,0,30,6
1649954878170,MATH 20C,B02,083452,Hammock; Frances H,27,0,30,3
1649954878170,MATH 20C,B03,083453,Hammock; Frances H,26,0,30,4
1649954878170,MATH 20C,B04,083454,Hammock; Frances H,30,0,30,0
1649954884200,MATH 20D,A01,084128,Staff,24,0,30,6
1649954884200,MATH 20D,A02,084129,Staff,30,0,30,0
1649954884200,MATH 20D,A03,084130,Staff,29,0,30,1
1649954884200,MATH 20D,B01,084133,Staff,17,0,30,13
1649954884200,MATH 20D,B02,084134,Staff,27,0,30,3
1649954884200,MATH 20D,B03,084135,Staff,30,0,30,0
1649954890224,MATH 20E,A01,084138,Staff,22,0,30,8
1649954890224,MATH 20E,A02,084139,Staff,19,0,30,11
1649954890224,MATH 20E,A03,084140,Staff,22,0,30,8
1649954890224,MATH 20E,A04,084141,Staff,25,0,30,5
1649954896251,MATH 102,A01,084143,Harel; Guershon,16,0,30,14
1649954896251,MATH 102,A02,084144,Harel; Guershon,21,0,30,9
1649954902288,MATH 103B,A01,083456,Staff,0,9,30,30
1649954902288,MATH 103B,A02,083457,Staff,0,9,30,30
1649954908311,MATH 109,A01,084146,Salehi Golsefidy; Alireza,27,0,30,3
1649954908311,MATH 109,A02,084147,Salehi Golsefidy; Alireza,22,0,30,8
1649954914334,MATH 120A,A01,085445,Eggers; John Dietrich,20,0,35,15
1649954914334,MATH 120A,A02,085446,Eggers; John Dietrich,27,0,35,8
1649954920371,MATH 142B,A01,084149,Verstraete; Jacques Allan,0,12,30,30
1649954920371,MATH 142B,A02,084150,Verstraete; Jacques Allan,0,11,30,30
1649954926402,MATH 170A,A01,083459,Nie; Jiawang,0,3,30,30
1649954926402,MATH 170A,A02,083460,Nie; Jiawang,0,1,30,30
1649954926402,MATH 170A,A03,083461,Nie; Jiawang,0,0,30,30
1649954932425,MATH 193B,A01,083463,Staff,1,0,30,29
1649954932425,MATH 193B,A02,083464,Staff,10,0,30,20
1649954932425,MATH 193B,A03,083465,Staff,18,0,30,12
1649954938483,COGS 2,A01,083966,Boyle; Mary E. T.,17,0,30,13
1649954944509,COGS 9,A01,083968,Staff,38,0,60,22
1649954950543,COGS 14B,A01,083970,Staff,25,0,50,25
1649954956570,COGS 17,A01,092679,Staff,65,0,75,10
1649954962610,COGS 100,A01,083972,Staff,4,0,60,56
1649954974655,COGS 101C,A01,083976,Staff,19,0,30,11
1649954980682,COGS 102A,A01,083978,Johnson; Christine M.,16,0,30,14
1649954986720,COGS 107B,A01,083980,Staff,2,0,50,48
1649954992750,COGS 115,A01,083982,Staff,13,0,30,17
1649954998774,COGS 118B,A01,083367,Staff,0,11,40,40
1649955004800,COGS 172,A01,083984,Provenzano; Emily Kara,16,0,30,14
1649955010824,COGS 177,A00,083368,Staff,0,18,30,30
1649955016859,COGS 186,A01,083986,Staff,21,0,40,19
1649955022883,COGS 187A,A01,083988,Boyle; Mary E. T.,24,0,60,36
1649955028906,CSE 8A,A50,084003,Miranda; Gregory Joseph,0,3,15,15
1649955034933,CSE 11,A01,084005,Miranda; Gregory Joseph,17,0,55,38
1649955040960,CSE 20,A01,084007,Staff,8,0,20,12
1649955046989,CSE 21,A01,084009,Staff,7,0,50,43
1649955053012,CSE 30,A01,083370,Cao; Yingjun,0,25,40,40
1649955059045,CSE 100,A01,083372,Cao; Yingjun,0,29,40,40
1649955065071,CSE 101,A01,084011,Staff,0,51,40,40
1649955071097,CSE 141,A01,083374,Eldon; John,0,53,75,75
1649955077121,CSE 141L,A01,083376,Eldon; John,0,58,75,75
1649955083142,CSE 175,A01,084013,Kumar; Rakesh,22,0,25,3
1649955089166,CSE 190,A00,092508,Dubnov; Shlomo,15,0,15,0
1649955095194,ECE 5,A01,084049,Morris; Karcher William,15,0,20,5
1649955101218,ECE 100,A01,084051,Baghdadchi; Saharnaz,0,0,20,20
1649955101218,ECE 100,A02,091916,Baghdadchi; Saharnaz,16,0,20,4
1649955107241,ECE 101,A01,084053,Baghdadchi; Saharnaz,3,0,37,34
1649955107241,ECE 101,A02,084054,Baghdadchi; Saharnaz,32,0,37,5
1649955113267,ECE 107,A01,083390,Staff,28,0,40,12
1649955119296,ECE 148,A01,084056,Silberman; Jack,7,0,12,5
1649955125324,ECE 180,A00,083391,Abi Samra; Nicholas Camill,25,0,30,5
1649955125324,ECE 180,B00,083392,Abi Samra; Nicholas Camill,22,0,30,8
1649955131350,MATH 10B,A01,084110,Staff,8,0,30,22
1649955131350,MATH 10B,A02,084111,Staff,29,0,30,1
1649955131350,MATH 10B,A03,084112,Staff,27,0,30,3
1649955137384,MATH 10C,A01,083443,Staff,8,0,30,22
1649955137384,MATH 10C,A02,083444,Staff,15,0,30,15
1649955137384,MATH 10C,B01,084114,Staff,25,0,30,5
1649955137384,MATH 10C,B02,084115,Staff,28,0,30,2
1649955143411,MATH 18,A01,084117,Harel; Guershon,27,0,30,3
1649955143411,MATH 18,A02,084119,Harel; Guershon,28,0,30,2
1649955143411,MATH 18,A03,084120,Harel; Guershon,30,0,30,0
1649955143411,MATH 18,A04,084121,Harel; Guershon,29,0,30,1
1649955149434,MATH 20B,A01,084124,Um; Ko Woon,31,0,35,4
1649955149434,MATH 20B,B01,084126,Um; Ko Woon,32,0,35,3
1649955155470,MATH 20C,A01,083446,Hammock; Frances H,17,0,30,13
1649955155470,MATH 20C,A02,083447,Hammock; Frances H,28,0,30,2
1649955155470,MATH 20C,A03,083448,Hammock; Frances H,30,0,30,0
1649955155470,MATH 20C,A04,083449,Hammock; Frances H,30,0,30,0
1649955155470,MATH 20C,B01,083451,Hammock; Frances H,23,0,30,7
1649955155470,MATH 20C,B02,083452,Hammock; Frances H,27,0,30,3
1649955155470,MATH 20C,B03,083453,Hammock; Frances H,26,0,30,4
1649955155470,MATH 20C,B04,083454,Hammock; Frances H,30,0,30,0
1649955161499,MATH 20D,A01,084128,Staff,24,0,30,6
1649955161499,MATH 20D,A02,084129,Staff,30,0,30,0
1649955161499,MATH 20D,A03,084130,Staff,29,0,30,1
1649955161499,MATH 20D,B01,084133,Staff,17,0,30,13
1649955161499,MATH 20D,B02,084134,Staff,27,0,30,3
1649955161499,MATH 20D,B03,084135,Staff,30,0,30,0
1649955167524,MATH 20E,A01,084138,Staff,22,0,30,8
1649955167524,MATH 20E,A02,084139,Staff,19,0,30,11
1649955167524,MATH 20E,A03,084140,Staff,22,0,30,8
1649955167524,MATH 20E,A04,084141,Staff,25,0,30,5
1649955173642,MATH 102,A01,084143,Harel; Guershon,16,0,30,14
1649955173642,MATH 102,A02,084144,Harel; Guershon,21,0,30,9
1649955179664,MATH 103B,A01,083456,Staff,0,9,30,30
1649955179664,MATH 103B,A02,083457,Staff,0,9,30,30
1649955185687,MATH 109,A01,084146,Salehi Golsefidy; Alireza,27,0,30,3
1649955185687,MATH 109,A02,084147,Salehi Golsefidy; Alireza,22,0,30,8
1649955191713,MATH 120A,A01,085445,Eggers; John Dietrich,20,0,35,15
1649955191713,MATH 120A,A02,085446,Eggers; John Dietrich,27,0,35,8
1649955197744,MATH 142B,A01,084149,Verstraete; Jacques Allan,0,12,30,30
1649955197744,MATH 142B,A02,084150,Verstraete; Jacques Allan,0,11,30,30
1649955203768,MATH 170A,A01,083459,Nie; Jiawang,0,3,30,30
1649955203768,MATH 170A,A02,083460,Nie; Jiawang,0,1,30,30
1649955203768,MATH 170A,A03,083461,Nie; Jiawang,0,0,30,30
1649955209800,MATH 193B,A01,083463,Staff,1,0,30,29
1649955209800,MATH 193B,A02,083464,Staff,10,0,30,20
1649955209800,MATH 193B,A03,083465,Staff,18,0,30,12
1649955215865,COGS 2,A01,083966,Boyle; Mary E. T.,17,0,30,13
1649955221890,COGS 9,A01,083968,Staff,38,0,60,22
1649955227913,COGS 14B,A01,083970,Staff,25,0,50,25
1649955233943,COGS 17,A01,092679,Staff,65,0,75,10
1649955239965,COGS 100,A01,083972,Staff,4,0,60,56
1649955252019,COGS 101C,A01,083976,Staff,19,0,30,11
1649955258048,COGS 102A,A01,083978,Johnson; Christine M.,16,0,30,14
1649955264070,COGS 107B,A01,083980,Staff,2,0,50,48
1649955270095,COGS 115,A01,083982,Staff,13,0,30,17
1649955276126,COGS 118B,A01,083367,Staff,0,11,40,40
1649955282151,COGS 172,A01,083984,Provenzano; Emily Kara,16,0,30,14
1649955288178,COGS 177,A00,083368,Staff,0,18,30,30
1649955294214,COGS 186,A01,083986,Staff,21,0,40,19
1649955300246,COGS 187A,A01,083988,Boyle; Mary E. T.,24,0,60,36
1649955306268,CSE 8A,A50,084003,Miranda; Gregory Joseph,0,3,15,15
1649955312306,CSE 11,A01,084005,Miranda; Gregory Joseph,17,0,55,38
1649955318332,CSE 20,A01,084007,Staff,8,0,20,12
1649955324374,CSE 21,A01,084009,Staff,6,0,50,44
1649955330399,CSE 30,A01,083370,Cao; Yingjun,0,27,40,40
1649955336427,CSE 100,A01,083372,Cao; Yingjun,0,29,40,40
1649955342450,CSE 101,A01,084011,Staff,0,52,40,40
1649955348474,CSE 141,A01,083374,Eldon; John,0,53,75,75
1649955354511,CSE 141L,A01,083376,Eldon; John,0,58,75,75
1649955360537,CSE 175,A01,084013,Kumar; Rakesh,22,0,25,3
1649955366561,CSE 190,A00,092508,Dubnov; Shlomo,15,0,15,0
1649955372601,ECE 5,A01,084049,Morris; Karcher William,15,0,20,5
1649955378631,ECE 100,A01,084051,Baghdadchi; Saharnaz,0,0,20,20
1649955378631,ECE 100,A02,091916,Baghdadchi; Saharnaz,16,0,20,4
1649955384654,ECE 101,A01,084053,Baghdadchi; Saharnaz,3,0,37,34
1649955384654,ECE 101,A02,084054,Baghdadchi; Saharnaz,32,0,37,5
1649955390678,ECE 107,A01,083390,Staff,28,0,40,12
1649955396704,ECE 148,A01,084056,Silberman; Jack,7,0,12,5
1649955402729,ECE 180,A00,083391,Abi Samra; Nicholas Camill,25,0,30,5
1649955402729,ECE 180,B00,083392,Abi Samra; Nicholas Camill,22,0,30,8
1649955408757,MATH 10B,A01,084110,Staff,8,0,30,22
1649955408757,MATH 10B,A02,084111,Staff,29,0,30,1
1649955408757,MATH 10B,A03,084112,Staff,27,0,30,3
1649955414781,MATH 10C,A01,083443,Staff,8,0,30,22
1649955414781,MATH 10C,A02,083444,Staff,15,0,30,15
1649955414781,MATH 10C,B01,084114,Staff,25,0,30,5
1649955414781,MATH 10C,B02,084115,Staff,28,0,30,2
1649955420822,MATH 18,A01,084117,Harel; Guershon,27,0,30,3
1649955420822,MATH 18,A02,084119,Harel; Guershon,28,0,30,2
1649955420822,MATH 18,A03,084120,Harel; Guershon,30,0,30,0
1649955420822,MATH 18,A04,084121,Harel; Guershon,29,0,30,1
1649955426845,MATH 20B,A01,084124,Um; Ko Woon,31,0,35,4
1649955426845,MATH 20B,B01,084126,Um; Ko Woon,32,0,35,3
1649955432878,MATH 20C,A01,083446,Hammock; Frances H,16,0,30,14
1649955432878,MATH 20C,A02,083447,Hammock; Frances H,28,0,30,2
1649955432878,MATH 20C,A03,083448,Hammock; Frances H,30,0,30,0
1649955432878,MATH 20C,A04,083449,Hammock; Frances H,30,0,30,0
1649955432878,MATH 20C,B01,083451,Hammock; Frances H,24,0,30,6
1649955432878,MATH 20C,B02,083452,Hammock; Frances H,27,0,30,3
1649955432878,MATH 20C,B03,083453,Hammock; Frances H,26,0,30,4
1649955432878,MATH 20C,B04,083454,Hammock; Frances H,30,0,30,0
1649955438906,MATH 20D,A01,084128,Staff,24,0,30,6
1649955438906,MATH 20D,A02,084129,Staff,30,0,30,0
1649955438906,MATH 20D,A03,084130,Staff,29,0,30,1
1649955438906,MATH 20D,B01,084133,Staff,17,0,30,13
1649955438906,MATH 20D,B02,084134,Staff,27,0,30,3
1649955438906,MATH 20D,B03,084135,Staff,30,0,30,0
1649955444934,MATH 20E,A01,084138,Staff,22,0,30,8
1649955444934,MATH 20E,A02,084139,Staff,19,0,30,11
1649955444934,MATH 20E,A03,084140,Staff,22,0,30,8
1649955444934,MATH 20E,A04,084141,Staff,25,0,30,5
1649955450975,MATH 102,A01,084143,Harel; Guershon,16,0,30,14
1649955450975,MATH 102,A02,084144,Harel; Guershon,21,0,30,9
1649955456999,MATH 103B,A01,083456,Staff,0,9,30,30
1649955456999,MATH 103B,A02,083457,Staff,0,9,30,30
1649955463041,MATH 109,A01,084146,Salehi Golsefidy; Alireza,27,0,30,3
1649955463041,MATH 109,A02,084147,Salehi Golsefidy; Alireza,22,0,30,8
1649955469066,MATH 120A,A01,085445,Eggers; John Dietrich,20,0,35,15
1649955469066,MATH 120A,A02,085446,Eggers; John Dietrich,27,0,35,8
1649955475092,MATH 142B,A01,084149,Verstraete; Jacques Allan,0,12,30,30
1649955475092,MATH 142B,A02,084150,Verstraete; Jacques Allan,0,11,30,30
1649955481145,MATH 170A,A01,083459,Nie; Jiawang,0,3,30,30
1649955481145,MATH 170A,A02,083460,Nie; Jiawang,0,1,30,30
1649955481145,MATH 170A,A03,083461,Nie; Jiawang,0,0,30,30
1649955487167,MATH 193B,A01,083463,Staff,1,0,30,29
1649955487167,MATH 193B,A02,083464,Staff,10,0,30,20
1649955487167,MATH 193B,A03,083465,Staff,18,0,30,12
1649955493234,COGS 2,A01,083966,Boyle; Mary E. T.,17,0,30,13
1649955499260,COGS 9,A01,083968,Staff,38,0,60,22
1649955505283,COGS 14B,A01,083970,Staff,25,0,50,25
1649955511307,COGS 17,A01,092679,Staff,65,0,75,10
1649955517341,COGS 100,A01,083972,Staff,4,0,60,56
1649955529391,COGS 101C,A01,083976,Staff,19,0,30,11
1649955535426,COGS 102A,A01,083978,Johnson; Christine M.,16,0,30,14
1649955541449,COGS 107B,A01,083980,Staff,2,0,50,48
1649955547473,COGS 115,A01,083982,Staff,13,0,30,17
1649955553503,COGS 118B,A01,083367,Staff,0,11,40,40
1649955559527,COGS 172,A01,083984,Provenzano; Emily Kara,16,0,30,14
1649955565558,COGS 177,A00,083368,Staff,0,18,30,30
1649955571585,COGS 186,A01,083986,Staff,21,0,40,19
1649955577608,COGS 187A,A01,083988,Boyle; Mary E. T.,24,0,60,36
1649955583635,CSE 8A,A50,084003,Miranda; Gregory Joseph,0,3,15,15
1649955589669,CSE 11,A01,084005,Miranda; Gregory Joseph,17,0,55,38
1649955595714,CSE 20,A01,084007,Staff,8,0,20,12
1649955601739,CSE 21,A01,084009,Staff,6,0,50,44
1649955607762,CSE 30,A01,083370,Cao; Yingjun,0,27,40,40
1649955613790,CSE 100,A01,083372,Cao; Yingjun,0,29,40,40
1649955619814,CSE 101,A01,084011,Staff,0,52,40,40
1649955625841,CSE 141,A01,083374,Eldon; John,0,53,75,75
1649955631865,CSE 141L,A01,083376,Eldon; John,0,58,75,75
1649955637887,CSE 175,A01,084013,Kumar; Rakesh,22,0,25,3
1649955643991,CSE 190,A00,092508,Dubnov; Shlomo,15,0,15,0
1649955650013,ECE 5,A01,084049,Morris; Karcher William,15,0,20,5
1649955656055,ECE 100,A01,084051,Baghdadchi; Saharnaz,0,0,20,20
1649955656055,ECE 100,A02,091916,Baghdadchi; Saharnaz,16,0,20,4
1649955662080,ECE 101,A01,084053,Baghdadchi; Saharnaz,3,0,37,34
1649955662080,ECE 101,A02,084054,Baghdadchi; Saharnaz,32,0,37,5
1649955668113,ECE 107,A01,083390,Staff,28,0,40,12
1649955674139,ECE 148,A01,084056,Silberman; Jack,7,0,12,5
1649955680163,ECE 180,A00,083391,Abi Samra; Nicholas Camill,25,0,30,5
1649955680163,ECE 180,B00,083392,Abi Samra; Nicholas Camill,22,0,30,8
1649955686192,MATH 10B,A01,084110,Staff,8,0,30,22
1649955686192,MATH 10B,A02,084111,Staff,29,0,30,1
1649955686192,MATH 10B,A03,084112,Staff,27,0,30,3
1649955692217,MATH 10C,A01,083443,Staff,8,0,30,22
1649955692217,MATH 10C,A02,083444,Staff,15,0,30,15
1649955692217,MATH 10C,B01,084114,Staff,25,0,30,5
1649955692217,MATH 10C,B02,084115,Staff,28,0,30,2
1649955698246,MATH 18,A01,084117,Harel; Guershon,27,0,30,3
1649955698246,MATH 18,A02,084119,Harel; Guershon,28,0,30,2
1649955698246,MATH 18,A03,084120,Harel; Guershon,30,0,30,0
1649955698246,MATH 18,A04,084121,Harel; Guershon,29,0,30,1
1649955704274,MATH 20B,A01,084124,Um; Ko Woon,31,0,35,4
1649955704274,MATH 20B,B01,084126,Um; Ko Woon,32,0,35,3
1649955710309,MATH 20C,A01,083446,Hammock; Frances H,16,0,30,14
1649955710309,MATH 20C,A02,083447,Hammock; Frances H,28,0,30,2
1649955710309,MATH 20C,A03,083448,Hammock; Frances H,30,0,30,0
1649955710309,MATH 20C,A04,083449,Hammock; Frances H,30,0,30,0
1649955710309,MATH 20C,B01,083451,Hammock; Frances H,24,0,30,6
1649955710309,MATH 20C,B02,083452,Hammock; Frances H,27,0,30,3
1649955710309,MATH 20C,B03,083453,Hammock; Frances H,26,0,30,4
1649955710309,MATH 20C,B04,083454,Hammock; Frances H,30,0,30,0
1649955716345,MATH 20D,A01,084128,Staff,24,0,30,6
1649955716345,MATH 20D,A02,084129,Staff,30,0,30,0
1649955716345,MATH 20D,A03,084130,Staff,29,0,30,1
1649955716345,MATH 20D,B01,084133,Staff,17,0,30,13
1649955716345,MATH 20D,B02,084134,Staff,27,0,30,3
1649955716345,MATH 20D,B03,084135,Staff,30,0,30,0
1649955722381,MATH 20E,A01,084138,Staff,22,0,30,8
1649955722381,MATH 20E,A02,084139,Staff,19,0,30,11
1649955722381,MATH 20E,A03,084140,Staff,22,0,30,8
1649955722381,MATH 20E,A04,084141,Staff,25,0,30,5
1649955728419,MATH 102,A01,084143,Harel; Guershon,16,0,30,14
1649955728419,MATH 102,A02,084144,Harel; Guershon,21,0,30,9
1649955734442,MATH 103B,A01,083456,Staff,0,9,30,30
1649955734442,MATH 103B,A02,083457,Staff,0,9,30,30
1649955740475,MATH 109,A01,084146,Salehi Golsefidy; Alireza,27,0,30,3
1649955740475,MATH 109,A02,084147,Salehi Golsefidy; Alireza,22,0,30,8
1649955746501,MATH 120A,A01,085445,Eggers; John Dietrich,20,0,35,15
1649955746501,MATH 120A,A02,085446,Eggers; John Dietrich,27,0,35,8
1649955752539,MATH 142B,A01,084149,Verstraete; Jacques Allan,0,12,30,30
1649955752539,MATH 142B,A02,084150,Verstraete; Jacques Allan,0,11,30,30
1649955758571,MATH 170A,A01,083459,Nie; Jiawang,0,3,30,30
1649955758571,MATH 170A,A02,083460,Nie; Jiawang,0,1,30,30
1649955758571,MATH 170A,A03,083461,Nie; Jiawang,0,0,30,30
1649955764606,MATH 193B,A01,083463,Staff,1,0,30,29
1649955764606,MATH 193B,A02,083464,Staff,10,0,30,20
1649955764606,MATH 193B,A03,083465,Staff,18,0,30,12
1649955770788,COGS 2,A01,083966,Boyle; Mary E. T.,17,0,30,13
1649955776823,COGS 9,A01,083968,Staff,38,0,60,22
1649955782856,COGS 14B,A01,083970,Staff,25,0,50,25
1649955788893,COGS 17,A01,092679,Staff,64,0,75,11
1649955794921,COGS 100,A01,083972,Staff,4,0,60,56
1649955806993,COGS 101C,A01,083976,Staff,19,0,30,11
1649955813019,COGS 102A,A01,083978,Johnson; Christine M.,16,0,30,14
1649955819044,COGS 107B,A01,083980,Staff,2,0,50,48
1649955825070,COGS 115,A01,083982,Staff,13,0,30,17
1649955831101,COGS 118B,A01,083367,Staff,0,11,40,40
1649955837124,COGS 172,A01,083984,Provenzano; Emily Kara,16,0,30,14
1649955843145,COGS 177,A00,083368,Staff,0,19,30,30
1649955849168,COGS 186,A01,083986,Staff,21,0,40,19
1649955855193,COGS 187A,A01,083988,Boyle; Mary E. T.,24,0,60,36
1649955861215,CSE 8A,A50,084003,Miranda; Gregory Joseph,0,3,15,15
1649955867238,CSE 11,A01,084005,Miranda; Gregory Joseph,17,0,55,38
1649955873261,CSE 20,A01,084007,Staff,8,0,20,12
1649955879288,CSE 21,A01,084009,Staff,6,0,50,44
1649955885316,CSE 30,A01,083370,Cao; Yingjun,0,28,40,40
1649955891339,CSE 100,A01,083372,Cao; Yingjun,0,29,40,40
1649955897363,CSE 101,A01,084011,Staff,0,52,40,40
1649955903400,CSE 141,A01,083374,Eldon; John,0,53,75,75
1649955909422,CSE 141L,A01,083376,Eldon; John,0,58,75,75
1649955915447,CSE 175,A01,084013,Kumar; Rakesh,22,0,25,3
1649955921471,CSE 190,A00,092508,Dubnov; Shlomo,15,0,15,0
1649955927506,ECE 5,A01,084049,Morris; Karcher William,15,0,20,5
1649955933530,ECE 100,A01,084051,Baghdadchi; Saharnaz,0,0,20,20
1649955933530,ECE 100,A02,091916,Baghdadchi; Saharnaz,16,0,20,4
1649955939567,ECE 101,A01,084053,Baghdadchi; Saharnaz,3,0,37,34
1649955939567,ECE 101,A02,084054,Baghdadchi; Saharnaz,32,0,37,5
1649955945608,ECE 107,A01,083390,Staff,28,0,40,12
1649955951640,ECE 148,A01,084056,Silberman; Jack,7,0,12,5
1649955957666,ECE 180,A00,083391,Abi Samra; Nicholas Camill,25,0,30,5
1649955957666,ECE 180,B00,083392,Abi Samra; Nicholas Camill,22,0,30,8
1649955963696,MATH 10B,A01,084110,Staff,8,0,30,22
1649955963696,MATH 10B,A02,084111,Staff,29,0,30,1
1649955963696,MATH 10B,A03,084112,Staff,27,0,30,3
1649955970305,MATH 10C,A01,083443,Staff,8,0,30,22
1649955970305,MATH 10C,A02,083444,Staff,15,0,30,15
1649955970305,MATH 10C,B01,084114,Staff,25,0,30,5
1649955970305,MATH 10C,B02,084115,Staff,28,0,30,2
1649955976329,MATH 18,A01,084117,Harel; Guershon,27,0,30,3
1649955976329,MATH 18,A02,084119,Harel; Guershon,28,0,30,2
1649955976329,MATH 18,A03,084120,Harel; Guershon,30,0,30,0
1649955976329,MATH 18,A04,084121,Harel; Guershon,29,0,30,1
1649955982359,MATH 20B,A01,084124,Um; Ko Woon,31,0,35,4
1649955982359,MATH 20B,B01,084126,Um; Ko Woon,32,0,35,3
1649955988396,MATH 20C,A01,083446,Hammock; Frances H,16,0,30,14
1649955988396,MATH 20C,A02,083447,Hammock; Frances H,28,0,30,2
1649955988396,MATH 20C,A03,083448,Hammock; Frances H,29,0,30,1
1649955988396,MATH 20C,A04,083449,Hammock; Frances H,30,0,30,0
1649955988396,MATH 20C,B01,083451,Hammock; Frances H,24,0,30,6
1649955988396,MATH 20C,B02,083452,Hammock; Frances H,27,0,30,3
1649955988396,MATH 20C,B03,083453,Hammock; Frances H,26,0,30,4
1649955988396,MATH 20C,B04,083454,Hammock; Frances H,30,0,30,0
1649955994423,MATH 20D,A01,084128,Staff,24,0,30,6
1649955994423,MATH 20D,A02,084129,Staff,30,0,30,0
1649955994423,MATH 20D,A03,084130,Staff,29,0,30,1
1649955994423,MATH 20D,B01,084133,Staff,17,0,30,13
1649955994423,MATH 20D,B02,084134,Staff,27,0,30,3
1649955994423,MATH 20D,B03,084135,Staff,30,0,30,0
1649956000456,MATH 20E,A01,084138,Staff,22,0,30,8
1649956000456,MATH 20E,A02,084139,Staff,18,0,30,12
1649956000456,MATH 20E,A03,084140,Staff,22,0,30,8
1649956000456,MATH 20E,A04,084141,Staff,25,0,30,5
1649956006483,MATH 102,A01,084143,Harel; Guershon,16,0,30,14
1649956006483,MATH 102,A02,084144,Harel; Guershon,21,0,30,9
1649956012515,MATH 103B,A01,083456,Staff,0,9,30,30
1649956012515,MATH 103B,A02,083457,Staff,0,9,30,30
1649956018557,MATH 109,A01,084146,Salehi Golsefidy; Alireza,27,0,30,3
1649956018557,MATH 109,A02,084147,Salehi Golsefidy; Alireza,22,0,30,8
1649956024582,MATH 120A,A01,085445,Eggers; John Dietrich,20,0,35,15
1649956024582,MATH 120A,A02,085446,Eggers; John Dietrich,27,0,35,8
1649956030610,MATH 142B,A01,084149,Verstraete; Jacques Allan,0,12,30,30
1649956030610,MATH 142B,A02,084150,Verstraete; Jacques Allan,0,11,30,30
1649956036649,MATH 170A,A01,083459,Nie; Jiawang,0,3,30,30
1649956036649,MATH 170A,A02,083460,Nie; Jiawang,0,1,30,30
1649956036649,MATH 170A,A03,083461,Nie; Jiawang,0,1,30,30
1649956042679,MATH 193B,A01,083463,Staff,1,0,30,29
1649956042679,MATH 193B,A02,083464,Staff,10,0,30,20
1649956042679,MATH 193B,A03,083465,Staff,18,0,30,12
1649956048728,COGS 2,A01,083966,Boyle; Mary E. T.,17,0,30,13
1649956054750,COGS 9,A01,083968,Staff,38,0,60,22
1649956060780,COGS 14B,A01,083970,Staff,26,0,50,24
1649956066804,COGS 17,A01,092679,Staff,64,0,75,11
1649956072830,COGS 100,A01,083972,Staff,4,0,60,56
1649956084896,COGS 101C,A01,083976,Staff,19,0,30,11
1649956090922,COGS 102A,A01,083978,Johnson; Christine M.,16,0,30,14
1649956096948,COGS 107B,A01,083980,Staff,2,0,50,48
1649956102970,COGS 115,A01,083982,Staff,13,0,30,17
1649956109009,COGS 118B,A01,083367,Staff,0,11,40,40
1649956115035,COGS 172,A01,083984,Provenzano; Emily Kara,16,0,30,14
1649956121060,COGS 177,A00,083368,Staff,0,19,30,30
1649956127082,COGS 186,A01,083986,Staff,21,0,40,19
1649956133110,COGS 187A,A01,083988,Boyle; Mary E. T.,24,0,60,36
1649956139153,CSE 8A,A50,084003,Miranda; Gregory Joseph,0,3,15,15
1649956145176,CSE 11,A01,084005,Miranda; Gregory Joseph,17,0,55,38
1649956151199,CSE 20,A01,084007,Staff,8,0,20,12
1649956157227,CSE 21,A01,084009,Staff,5,0,50,45
1649956163250,CSE 30,A01,083370,Cao; Yingjun,0,28,40,40
1649956169273,CSE 100,A01,083372,Cao; Yingjun,0,29,40,40
1649956175301,CSE 101,A01,084011,Staff,0,52,40,40
1649956181327,CSE 141,A01,083374,Eldon; John,0,53,75,75
1649956187360,CSE 141L,A01,083376,Eldon; John,0,58,75,75
1649956193387,CSE 175,A01,084013,Kumar; Rakesh,22,0,25,3
1649956199417,CSE 190,A00,092508,Dubnov; Shlomo,15,0,15,0
1649956205444,ECE 5,A01,084049,Morris; Karcher William,15,0,20,5
1649956211470,ECE 100,A01,084051,Baghdadchi; Saharnaz,0,0,20,20
1649956211470,ECE 100,A02,091916,Baghdadchi; Saharnaz,16,0,20,4
1649956217496,ECE 101,A01,084053,Baghdadchi; Saharnaz,3,0,37,34
1649956217496,ECE 101,A02,084054,Baghdadchi; Saharnaz,32,0,37,5
1649956223518,ECE 107,A01,083390,Staff,28,0,40,12
1649956229542,ECE 148,A01,084056,Silberman; Jack,7,0,12,5
1649956235572,ECE 180,A00,083391,Abi Samra; Nicholas Camill,25,0,30,5
1649956235572,ECE 180,B00,083392,Abi Samra; Nicholas Camill,22,0,30,8
1649956241594,MATH 10B,A01,084110,Staff,8,0,30,22
1649956241594,MATH 10B,A02,084111,Staff,29,0,30,1
1649956241594,MATH 10B,A03,084112,Staff,27,0,30,3
1649956247618,MATH 10C,A01,083443,Staff,7,0,30,23
1649956247618,MATH 10C,A02,083444,Staff,15,0,30,15
1649956247618,MATH 10C,B01,084114,Staff,25,0,30,5
1649956247618,MATH 10C,B02,084115,Staff,28,0,30,2
1649956253646,MATH 18,A01,084117,Harel; Guershon,27,0,30,3
1649956253646,MATH 18,A02,084119,Harel; Guershon,28,0,30,2
1649956253646,MATH 18,A03,084120,Harel; Guershon,30,0,30,0
1649956253646,MATH 18,A04,084121,Harel; Guershon,29,0,30,1
1649956259671,MATH 20B,A01,084124,Um; Ko Woon,31,0,35,4
1649956259671,MATH 20B,B01,084126,Um; Ko Woon,32,0,35,3
1649956265698,MATH 20C,A01,083446,Hammock; Frances H,16,0,30,14
1649956265698,MATH 20C,A02,083447,Hammock; Frances H,28,0,30,2
1649956265698,MATH 20C,A03,083448,Hammock; Frances H,29,0,30,1
1649956265698,MATH 20C,A04,083449,Hammock; Frances H,30,0,30,0
1649956265698,MATH 20C,B01,083451,Hammock; Frances H,24,0,30,6
1649956265698,MATH 20C,B02,083452,Hammock; Frances H,27,0,30,3
1649956265698,MATH 20C,B03,083453,Hammock; Frances H,26,0,30,4
1649956265698,MATH 20C,B04,083454,Hammock; Frances H,30,0,30,0
1649956271726,MATH 20D,A01,084128,Staff,24,0,30,6
1649956271726,MATH 20D,A02,084129,Staff,30,0,30,0
1649956271726,MATH 20D,A03,084130,Staff,29,0,30,1
1649956271726,MATH 20D,B01,084133,Staff,17,0,30,13
1649956271726,MATH 20D,B02,084134,Staff,27,0,30,3
1649956271726,MATH 20D,B03,084135,Staff,30,0,30,0
1649956277750,MATH 20E,A01,084138,Staff,22,0,30,8
1649956277750,MATH 20E,A02,084139,Staff,17,0,30,13
1649956277750,MATH 20E,A03,084140,Staff,22,0,30,8
1649956277750,MATH 20E,A04,084141,Staff,25,0,30,5
1649956283782,MATH 102,A01,084143,Harel; Guershon,16,0,30,14
1649956283782,MATH 102,A02,084144,Harel; Guershon,21,0,30,9
1649956289811,MATH 103B,A01,083456,Staff,0,10,30,30
1649956289811,MATH 103B,A02,083457,Staff,0,9,30,30
1649956295836,MATH 109,A01,084146,Salehi Golsefidy; Alireza,27,0,30,3
1649956295836,MATH 109,A02,084147,Salehi Golsefidy; Alireza,22,0,30,8
1649956301860,MATH 120A,A01,085445,Eggers; John Dietrich,20,0,35,15
1649956301860,MATH 120A,A02,085446,Eggers; John Dietrich,27,0,35,8
1649956307886,MATH 142B,A01,084149,Verstraete; Jacques Allan,0,12,30,30
1649956307886,MATH 142B,A02,084150,Verstraete; Jacques Allan,0,11,30,30
1649956313917,MATH 170A,A01,083459,Nie; Jiawang,0,3,30,30
1649956313917,MATH 170A,A02,083460,Nie; Jiawang,0,1,30,30
1649956313917,MATH 170A,A03,083461,Nie; Jiawang,0,1,30,30
1649956319940,MATH 193B,A01,083463,Staff,1,0,30,29
1649956319940,MATH 193B,A02,083464,Staff,10,0,30,20
1649956319940,MATH 193B,A03,083465,Staff,18,0,30,12
1649956325995,COGS 2,A01,083966,Boyle; Mary E. T.,17,0,30,13
1649956332021,COGS 9,A01,083968,Staff,38,0,60,22
1649956338045,COGS 14B,A01,083970,Staff,26,0,50,24
1649956344072,COGS 17,A01,092679,Staff,64,0,75,11
1649956350099,COGS 100,A01,083972,Staff,4,0,60,56
1649956362246,COGS 101C,A01,083976,Staff,19,0,30,11
1649956368273,COGS 102A,A01,083978,Johnson; Christine M.,15,0,30,15
1649956374299,COGS 107B,A01,083980,Staff,2,0,50,48
1649956380322,COGS 115,A01,083982,Staff,13,0,30,17
1649956386350,COGS 118B,A01,083367,Staff,0,11,40,40
1649956392376,COGS 172,A01,083984,Provenzano; Emily Kara,16,0,30,14
1649956398399,COGS 177,A00,083368,Staff,0,19,30,30
1649956404423,COGS 186,A01,083986,Staff,21,0,40,19
1649956410449,COGS 187A,A01,083988,Boyle; Mary E. T.,23,0,60,37
1649956416476,CSE 8A,A50,084003,Miranda; Gregory Joseph,0,3,15,15
1649956422503,CSE 11,A01,084005,Miranda; Gregory Joseph,16,0,55,39
1649956428532,CSE 20,A01,084007,Staff,8,0,20,12
1649956434563,CSE 21,A01,084009,Staff,5,0,50,45
1649956440590,CSE 30,A01,083370,Cao; Yingjun,0,28,40,40
1649956446613,CSE 100,A01,083372,Cao; Yingjun,0,29,40,40
1649956452639,CSE 101,A01,084011,Staff,0,52,40,40
1649956458671,CSE 141,A01,083374,Eldon; John,0,53,75,75
1649956464706,CSE 141L,A01,083376,Eldon; John,0,58,75,75
1649956470729,CSE 175,A01,084013,Kumar; Rakesh,22,0,25,3
1649956476752,CSE 190,A00,092508,Dubnov; Shlomo,15,0,15,0
1649956482781,ECE 5,A01,084049,Morris; Karcher William,15,0,20,5
1649956488812,ECE 100,A01,084051,Baghdadchi; Saharnaz,0,0,20,20
1649956488812,ECE 100,A02,091916,Baghdadchi; Saharnaz,16,0,20,4
1649956494836,ECE 101,A01,084053,Baghdadchi; Saharnaz,3,0,37,34
1649956494836,ECE 101,A02,084054,Baghdadchi; Saharnaz,32,0,37,5
1649956500867,ECE 107,A01,083390,Staff,28,0,40,12
1649956506902,ECE 148,A01,084056,Silberman; Jack,7,0,12,5
1649956512925,ECE 180,A00,083391,Abi Samra; Nicholas Camill,25,0,30,5
1649956512925,ECE 180,B00,083392,Abi Samra; Nicholas Camill,22,0,30,8
1649956518954,MATH 10B,A01,084110,Staff,8,0,30,22
1649956518954,MATH 10B,A02,084111,Staff,29,0,30,1
1649956518954,MATH 10B,A03,084112,Staff,27,0,30,3
1649956524978,MATH 10C,A01,083443,Staff,6,0,30,24
1649956524978,MATH 10C,A02,083444,Staff,14,0,30,16
1649956524978,MATH 10C,B01,084114,Staff,25,0,30,5
1649956524978,MATH 10C,B02,084115,Staff,28,0,30,2
1649956531005,MATH 18,A01,084117,Harel; Guershon,27,0,30,3
1649956531005,MATH 18,A02,084119,Harel; Guershon,28,0,30,2
1649956531005,MATH 18,A03,084120,Harel; Guershon,30,0,30,0
1649956531005,MATH 18,A04,084121,Harel; Guershon,29,0,30,1
1649956537028,MATH 20B,A01,084124,Um; Ko Woon,31,0,35,4
1649956537028,MATH 20B,B01,084126,Um; Ko Woon,32,0,35,3
1649956543059,MATH 20C,A01,083446,Hammock; Frances H,16,0,30,14
1649956543059,MATH 20C,A02,083447,Hammock; Frances H,28,0,30,2
1649956543059,MATH 20C,A03,083448,Hammock; Frances H,29,0,30,1
1649956543059,MATH 20C,A04,083449,Hammock; Frances H,30,0,30,0
1649956543059,MATH 20C,B01,083451,Hammock; Frances H,24,0,30,6
1649956543059,MATH 20C,B02,083452,Hammock; Frances H,27,0,30,3
1649956543059,MATH 20C,B03,083453,Hammock; Frances H,26,0,30,4
1649956543059,MATH 20C,B04,083454,Hammock; Frances H,30,0,30,0
1649956549092,MATH 20D,A01,084128,Staff,24,0,30,6
1649956549092,MATH 20D,A02,084129,Staff,30,0,30,0
1649956549092,MATH 20D,A03,084130,Staff,29,0,30,1
1649956549092,MATH 20D,B01,084133,Staff,17,0,30,13
1649956549092,MATH 20D,B02,084134,Staff,27,0,30,3
1649956549092,MATH 20D,B03,084135,Staff,30,0,30,0
1649956555135,MATH 20E,A01,084138,Staff,22,0,30,8
1649956555135,MATH 20E,A02,084139,Staff,17,0,30,13
1649956555135,MATH 20E,A03,084140,Staff,22,0,30,8
1649956555135,MATH 20E,A04,084141,Staff,25,0,30,5
1649956561158,MATH 102,A01,084143,Harel; Guershon,16,0,30,14
1649956561158,MATH 102,A02,084144,Harel; Guershon,21,0,30,9
1649956567182,MATH 103B,A01,083456,Staff,0,10,30,30
1649956567182,MATH 103B,A02,083457,Staff,0,9,30,30
1649956573205,MATH 109,A01,084146,Salehi Golsefidy; Alireza,27,0,30,3
1649956573205,MATH 109,A02,084147,Salehi Golsefidy; Alireza,22,0,30,8
1649956579240,MATH 120A,A01,085445,Eggers; John Dietrich,20,0,35,15
1649956579240,MATH 120A,A02,085446,Eggers; John Dietrich,27,0,35,8
1649956585272,MATH 142B,A01,084149,Verstraete; Jacques Allan,0,12,30,30
1649956585272,MATH 142B,A02,084150,Verstraete; Jacques Allan,0,11,30,30
1649956591296,MATH 170A,A01,083459,Nie; Jiawang,0,3,30,30
1649956591296,MATH 170A,A02,083460,Nie; Jiawang,0,2,30,30
1649956591296,MATH 170A,A03,083461,Nie; Jiawang,0,1,30,30
1649956597319,MATH 193B,A01,083463,Staff,1,0,30,29
1649956597319,MATH 193B,A02,083464,Staff,10,0,30,20
1649956597319,MATH 193B,A03,083465,Staff,18,0,30,12
1649956603380,COGS 2,A01,083966,Boyle; Mary E. T.,17,0,30,13
1649956609403,COGS 9,A01,083968,Staff,38,0,60,22
1649956615429,COGS 14B,A01,083970,Staff,26,0,50,24
1649956621456,COGS 17,A01,092679,Staff,64,0,75,11
1649956627483,COGS 100,A01,083972,Staff,4,0,60,56
1649956639555,COGS 101C,A01,083976,Staff,19,0,30,11
1649956645590,COGS 102A,A01,083978,Johnson; Christine M.,15,0,30,15
1649956651614,COGS 107B,A01,083980,Staff,1,0,50,49
1649956657640,COGS 115,A01,083982,Staff,13,0,30,17
1649956663663,COGS 118B,A01,083367,Staff,0,11,40,40
1649956669700,COGS 172,A01,083984,Provenzano; Emily Kara,16,0,30,14
1649956675726,COGS 177,A00,083368,Staff,0,19,30,30
1649956681755,COGS 186,A01,083986,Staff,21,0,40,19
1649956687780,COGS 187A,A01,083988,Boyle; Mary E. T.,23,0,60,37
1649956693809,CSE 8A,A50,084003,Miranda; Gregory Joseph,0,3,15,15
1649956699833,CSE 11,A01,084005,Miranda; Gregory Joseph,16,0,55,39
1649956705859,CSE 20,A01,084007,Staff,8,0,20,12
1649956711884,CSE 21,A01,084009,Staff,5,0,50,45
1649956717912,CSE 30,A01,083370,Cao; Yingjun,0,28,40,40
1649956723935,CSE 100,A01,083372,Cao; Yingjun,0,30,40,40
1649956729963,CSE 101,A01,084011,Staff,0,52,40,40
1649956735986,CSE 141,A01,083374,Eldon; John,0,53,75,75
1649956742013,CSE 141L,A01,083376,Eldon; John,0,58,75,75
1649956748040,CSE 175,A01,084013,Kumar; Rakesh,22,0,25,3
1649956754062,CSE 190,A00,092508,Dubnov; Shlomo,15,0,15,0
1649956760086,ECE 5,A01,084049,Morris; Karcher William,15,0,20,5
1649956766124,ECE 100,A01,084051,Baghdadchi; Saharnaz,0,0,20,20
1649956766124,ECE 100,A02,091916,Baghdadchi; Saharnaz,16,0,20,4
1649956772153,ECE 101,A01,084053,Baghdadchi; Saharnaz,3,0,37,34
1649956772153,ECE 101,A02,084054,Baghdadchi; Saharnaz,32,0,37,5
1649956778184,ECE 107,A01,083390,Staff,28,0,40,12
1649956784214,ECE 148,A01,084056,Silberman; Jack,7,0,12,5
1649956790242,ECE 180,A00,083391,Abi Samra; Nicholas Camill,25,0,30,5
1649956790242,ECE 180,B00,083392,Abi Samra; Nicholas Camill,22,0,30,8
1649956796266,MATH 10B,A01,084110,Staff,8,0,30,22
1649956796266,MATH 10B,A02,084111,Staff,29,0,30,1
1649956796266,MATH 10B,A03,084112,Staff,27,0,30,3
1649956802301,MATH 10C,A01,083443,Staff,6,0,30,24
1649956802301,MATH 10C,A02,083444,Staff,14,0,30,16
1649956802301,MATH 10C,B01,084114,Staff,25,0,30,5
1649956802301,MATH 10C,B02,084115,Staff,28,0,30,2
1649956808324,MATH 18,A01,084117,Harel; Guershon,27,0,30,3
1649956808324,MATH 18,A02,084119,Harel; Guershon,28,0,30,2
1649956808324,MATH 18,A03,084120,Harel; Guershon,30,0,30,0
1649956808324,MATH 18,A04,084121,Harel; Guershon,29,0,30,1
1649956814352,MATH 20B,A01,084124,Um; Ko Woon,31,0,35,4
1649956814352,MATH 20B,B01,084126,Um; Ko Woon,32,0,35,3
1649956820377,MATH 20C,A01,083446,Hammock; Frances H,16,0,30,14
1649956820377,MATH 20C,A02,083447,Hammock; Frances H,28,0,30,2
1649956820377,MATH 20C,A03,083448,Hammock; Frances H,29,0,30,1
1649956820377,MATH 20C,A04,083449,Hammock; Frances H,30,0,30,0
1649956820377,MATH 20C,B01,083451,Hammock; Frances H,24,0,30,6
1649956820377,MATH 20C,B02,083452,Hammock; Frances H,27,0,30,3
1649956820377,MATH 20C,B03,083453,Hammock; Frances H,26,0,30,4
1649956820377,MATH 20C,B04,083454,Hammock; Frances H,30,0,30,0
1649956826411,MATH 20D,A01,084128,Staff,24,0,30,6
1649956826411,MATH 20D,A02,084129,Staff,30,0,30,0
1649956826411,MATH 20D,A03,084130,Staff,29,0,30,1
1649956826411,MATH 20D,B01,084133,Staff,17,0,30,13
1649956826411,MATH 20D,B02,084134,Staff,27,0,30,3
1649956826411,MATH 20D,B03,084135,Staff,30,0,30,0
1649956832450,MATH 20E,A01,084138,Staff,22,0,30,8
1649956832450,MATH 20E,A02,084139,Staff,17,0,30,13
1649956832450,MATH 20E,A03,084140,Staff,22,0,30,8
1649956832450,MATH 20E,A04,084141,Staff,25,0,30,5
1649956838476,MATH 102,A01,084143,Harel; Guershon,16,0,30,14
1649956838476,MATH 102,A02,084144,Harel; Guershon,21,0,30,9
1649956844502,MATH 103B,A01,083456,Staff,0,10,30,30
1649956844502,MATH 103B,A02,083457,Staff,0,9,30,30
1649956850527,MATH 109,A01,084146,Salehi Golsefidy; Alireza,27,0,30,3
1649956850527,MATH 109,A02,084147,Salehi Golsefidy; Alireza,22,0,30,8
1649956856557,MATH 120A,A01,085445,Eggers; John Dietrich,20,0,35,15
1649956856557,MATH 120A,A02,085446,Eggers; John Dietrich,27,0,35,8
1649956862585,MATH 142B,A01,084149,Verstraete; Jacques Allan,0,12,30,30
1649956862585,MATH 142B,A02,084150,Verstraete; Jacques Allan,0,11,30,30
1649956868613,MATH 170A,A01,083459,Nie; Jiawang,0,3,30,30
1649956868613,MATH 170A,A02,083460,Nie; Jiawang,0,2,30,30
1649956868613,MATH 170A,A03,083461,Nie; Jiawang,0,1,30,30
1649956874639,MATH 193B,A01,083463,Staff,1,0,30,29
1649956874639,MATH 193B,A02,083464,Staff,10,0,30,20
1649956874639,MATH 193B,A03,083465,Staff,18,0,30,12
1649956880694,COGS 2,A01,083966,Boyle; Mary E. T.,17,0,30,13
1649956886738,COGS 9,A01,083968,Staff,38,0,60,22
1649956892774,COGS 14B,A01,083970,Staff,26,0,50,24
1649956898798,COGS 17,A01,092679,Staff,64,0,75,11
1649956904824,COGS 100,A01,083972,Staff,2,0,60,58
1649956916896,COGS 101C,A01,083976,Staff,19,0,30,11
1649956922921,COGS 102A,A01,083978,Johnson; Christine M.,15,0,30,15
1649956928950,COGS 107B,A01,083980,Staff,1,0,50,49
1649956934977,COGS 115,A01,083982,Staff,13,0,30,17
1649956941004,COGS 118B,A01,083367,Staff,0,11,40,40
1649956947028,COGS 172,A01,083984,Provenzano; Emily Kara,16,0,30,14
1649956953053,COGS 177,A00,083368,Staff,0,19,30,30
1649956959165,COGS 186,A01,083986,Staff,21,0,40,19
1649956965188,COGS 187A,A01,083988,Boyle; Mary E. T.,23,0,60,37
1649956971213,CSE 8A,A50,084003,Miranda; Gregory Joseph,0,4,15,15
1649956977243,CSE 11,A01,084005,Miranda; Gregory Joseph,13,0,55,42
1649956983270,CSE 20,A01,084007,Staff,8,0,20,12
1649956989293,CSE 21,A01,084009,Staff,5,0,50,45
1649956995330,CSE 30,A01,083370,Cao; Yingjun,0,28,40,40
1649957001360,CSE 100,A01,083372,Cao; Yingjun,0,31,40,40
1649957007389,CSE 101,A01,084011,Staff,0,52,40,40
1649957013418,CSE 141,A01,083374,Eldon; John,0,53,75,75
1649957019441,CSE 141L,A01,083376,Eldon; John,0,58,75,75
1649957025467,CSE 175,A01,084013,Kumar; Rakesh,22,0,25,3
1649957031491,CSE 190,A00,092508,Dubnov; Shlomo,15,0,15,0
1649957037517,ECE 5,A01,084049,Morris; Karcher William,15,0,20,5
1649957043550,ECE 100,A01,084051,Baghdadchi; Saharnaz,0,0,20,20
1649957043550,ECE 100,A02,091916,Baghdadchi; Saharnaz,16,0,20,4
1649957049576,ECE 101,A01,084053,Baghdadchi; Saharnaz,3,0,37,34
1649957049576,ECE 101,A02,084054,Baghdadchi; Saharnaz,32,0,37,5
1649957055601,ECE 107,A01,083390,Staff,28,0,40,12
1649957061624,ECE 148,A01,084056,Silberman; Jack,7,0,12,5
1649957067656,ECE 180,A00,083391,Abi Samra; Nicholas Camill,25,0,30,5
1649957067656,ECE 180,B00,083392,Abi Samra; Nicholas Camill,22,0,30,8
1649957073683,MATH 10B,A01,084110,Staff,8,0,30,22
1649957073683,MATH 10B,A02,084111,Staff,29,0,30,1
1649957073683,MATH 10B,A03,084112,Staff,27,0,30,3
1649957079712,MATH 10C,A01,083443,Staff,5,0,30,25
1649957079712,MATH 10C,A02,083444,Staff,14,0,30,16
1649957079712,MATH 10C,B01,084114,Staff,25,0,30,5
1649957079712,MATH 10C,B02,084115,Staff,28,0,30,2
1649957085737,MATH 18,A01,084117,Harel; Guershon,27,0,30,3
1649957085737,MATH 18,A02,084119,Harel; Guershon,28,0,30,2
1649957085737,MATH 18,A03,084120,Harel; Guershon,30,0,30,0
1649957085737,MATH 18,A04,084121,Harel; Guershon,29,0,30,1
1649957091760,MATH 20B,A01,084124,Um; Ko Woon,31,0,35,4
1649957091760,MATH 20B,B01,084126,Um; Ko Woon,32,0,35,3
1649957097785,MATH 20C,A01,083446,Hammock; Frances H,16,0,30,14
1649957097785,MATH 20C,A02,083447,Hammock; Frances H,28,0,30,2
1649957097785,MATH 20C,A03,083448,Hammock; Frances H,29,0,30,1
1649957097785,MATH 20C,A04,083449,Hammock; Frances H,30,0,30,0
1649957097785,MATH 20C,B01,083451,Hammock; Frances H,24,0,30,6
1649957097785,MATH 20C,B02,083452,Hammock; Frances H,27,0,30,3
1649957097785,MATH 20C,B03,083453,Hammock; Frances H,26,0,30,4
1649957097785,MATH 20C,B04,083454,Hammock; Frances H,30,0,30,0
1649957103809,MATH 20D,A01,084128,Staff,24,0,30,6
1649957103809,MATH 20D,A02,084129,Staff,30,0,30,0
1649957103809,MATH 20D,A03,084130,Staff,29,0,30,1
1649957103809,MATH 20D,B01,084133,Staff,17,0,30,13
1649957103809,MATH 20D,B02,084134,Staff,27,0,30,3
1649957103809,MATH 20D,B03,084135,Staff,30,0,30,0
1649957109834,MATH 20E,A01,084138,Staff,22,0,30,8
1649957109834,MATH 20E,A02,084139,Staff,17,0,30,13
1649957109834,MATH 20E,A03,084140,Staff,22,0,30,8
1649957109834,MATH 20E,A04,084141,Staff,25,0,30,5
1649957115858,MATH 102,A01,084143,Harel; Guershon,16,0,30,14
1649957115858,MATH 102,A02,084144,Harel; Guershon,21,0,30,9
1649957121897,MATH 103B,A01,083456,Staff,0,10,30,30
1649957121897,MATH 103B,A02,083457,Staff,0,9,30,30
1649957127925,MATH 109,A01,084146,Salehi Golsefidy; Alireza,27,0,30,3
1649957127925,MATH 109,A02,084147,Salehi Golsefidy; Alireza,22,0,30,8
1649957133953,MATH 120A,A01,085445,Eggers; John Dietrich,20,0,35,15
1649957133953,MATH 120A,A02,085446,Eggers; John Dietrich,27,0,35,8
1649957139980,MATH 142B,A01,084149,Verstraete; Jacques Allan,0,12,30,30
1649957139980,MATH 142B,A02,084150,Verstraete; Jacques Allan,0,11,30,30
1649957146005,MATH 170A,A01,083459,Nie; Jiawang,0,3,30,30
1649957146005,MATH 170A,A02,083460,Nie; Jiawang,0,2,30,30
1649957146005,MATH 170A,A03,083461,Nie; Jiawang,0,1,30,30
1649957152035,MATH 193B,A01,083463,Staff,1,0,30,29
1649957152035,MATH 193B,A02,083464,Staff,10,0,30,20
1649957152035,MATH 193B,A03,083465,Staff,18,0,30,12
1649957158090,COGS 2,A01,083966,Boyle; Mary E. T.,17,0,30,13
1649957164112,COGS 9,A01,083968,Staff,38,0,60,22
1649957170134,COGS 14B,A01,083970,Staff,25,0,50,25
1649957176160,COGS 17,A01,092679,Staff,64,0,75,11
1649957182182,COGS 100,A01,083972,Staff,2,0,60,58
1649957194230,COGS 101C,A01,083976,Staff,18,0,30,12
1649957200258,COGS 102A,A01,083978,Johnson; Christine M.,15,0,30,15
1649957206280,COGS 107B,A01,083980,Staff,1,0,50,49
1649957212306,COGS 115,A01,083982,Staff,13,0,30,17
1649957218346,COGS 118B,A01,083367,Staff,0,11,40,40
1649957224370,COGS 172,A01,083984,Provenzano; Emily Kara,16,0,30,14
1649957230393,COGS 177,A00,083368,Staff,0,19,30,30
1649957236427,COGS 186,A01,083986,Staff,21,0,40,19
1649957242454,COGS 187A,A01,083988,Boyle; Mary E. T.,23,0,60,37
1649957248481,CSE 8A,A50,084003,Miranda; Gregory Joseph,0,4,15,15
1649957254514,CSE 11,A01,084005,Miranda; Gregory Joseph,13,0,55,42
1649957260538,CSE 20,A01,084007,Staff,8,0,20,12
1649957266574,CSE 21,A01,084009,Staff,5,0,50,45
1649957272616,CSE 30,A01,083370,Cao; Yingjun,0,28,40,40
1649957278643,CSE 100,A01,083372,Cao; Yingjun,0,31,40,40
1649957284669,CSE 101,A01,084011,Staff,0,52,40,40
1649957290693,CSE 141,A01,083374,Eldon; John,0,53,75,75
1649957296715,CSE 141L,A01,083376,Eldon; John,0,58,75,75
1649957302738,CSE 175,A01,084013,Kumar; Rakesh,22,0,25,3
1649957308769,CSE 190,A00,092508,Dubnov; Shlomo,15,0,15,0
1649957314791,ECE 5,A01,084049,Morris; Karcher William,15,0,20,5
1649957320816,ECE 100,A01,084051,Baghdadchi; Saharnaz,0,0,20,20
1649957320816,ECE 100,A02,091916,Baghdadchi; Saharnaz,16,0,20,4
1649957326839,ECE 101,A01,084053,Baghdadchi; Saharnaz,3,0,37,34
1649957326839,ECE 101,A02,084054,Baghdadchi; Saharnaz,32,0,37,5
1649957332876,ECE 107,A01,083390,Staff,28,0,40,12
1649957338901,ECE 148,A01,084056,Silberman; Jack,7,0,12,5
1649957344935,ECE 180,A00,083391,Abi Samra; Nicholas Camill,25,0,30,5
1649957344935,ECE 180,B00,083392,Abi Samra; Nicholas Camill,22,0,30,8
1649957350958,MATH 10B,A01,084110,Staff,8,0,30,22
1649957350958,MATH 10B,A02,084111,Staff,29,0,30,1
1649957350958,MATH 10B,A03,084112,Staff,27,0,30,3
1649957356987,MATH 10C,A01,083443,Staff,5,0,30,25
1649957356987,MATH 10C,A02,083444,Staff,14,0,30,16
1649957356987,MATH 10C,B01,084114,Staff,25,0,30,5
1649957356987,MATH 10C,B02,084115,Staff,28,0,30,2
1649957363010,MATH 18,A01,084117,Harel; Guershon,27,0,30,3
1649957363010,MATH 18,A02,084119,Harel; Guershon,28,0,30,2
1649957363010,MATH 18,A03,084120,Harel; Guershon,30,0,30,0
1649957363010,MATH 18,A04,084121,Harel; Guershon,29,0,30,1
1649957369044,MATH 20B,A01,084124,Um; Ko Woon,31,0,35,4
1649957369044,MATH 20B,B01,084126,Um; Ko Woon,32,0,35,3
1649957375073,MATH 20C,A01,083446,Hammock; Frances H,16,0,30,14
1649957375073,MATH 20C,A02,083447,Hammock; Frances H,28,0,30,2
1649957375073,MATH 20C,A03,083448,Hammock; Frances H,29,0,30,1
1649957375073,MATH 20C,A04,083449,Hammock; Frances H,30,0,30,0
1649957375073,MATH 20C,B01,083451,Hammock; Frances H,24,0,30,6
1649957375073,MATH 20C,B02,083452,Hammock; Frances H,27,0,30,3
1649957375073,MATH 20C,B03,083453,Hammock; Frances H,26,0,30,4
1649957375073,MATH 20C,B04,083454,Hammock; Frances H,30,0,30,0
1649957381096,MATH 20D,A01,084128,Staff,24,0,30,6
1649957381096,MATH 20D,A02,084129,Staff,30,0,30,0
1649957381096,MATH 20D,A03,084130,Staff,29,0,30,1
1649957381096,MATH 20D,B01,084133,Staff,17,0,30,13
1649957381096,MATH 20D,B02,084134,Staff,27,0,30,3
1649957381096,MATH 20D,B03,084135,Staff,30,0,30,0
1649957387121,MATH 20E,A01,084138,Staff,22,0,30,8
1649957387121,MATH 20E,A02,084139,Staff,17,0,30,13
1649957387121,MATH 20E,A03,084140,Staff,21,0,30,9
1649957387121,MATH 20E,A04,084141,Staff,25,0,30,5
1649957393148,MATH 102,A01,084143,Harel; Guershon,16,0,30,14
1649957393148,MATH 102,A02,084144,Harel; Guershon,21,0,30,9
1649957399180,MATH 103B,A01,083456,Staff,0,10,30,30
1649957399180,MATH 103B,A02,083457,Staff,0,9,30,30
1649957405206,MATH 109,A01,084146,Salehi Golsefidy; Alireza,27,0,30,3
1649957405206,MATH 109,A02,084147,Salehi Golsefidy; Alireza,22,0,30,8
1649957411236,MATH 120A,A01,085445,Eggers; John Dietrich,19,0,35,16
1649957411236,MATH 120A,A02,085446,Eggers; John Dietrich,27,0,35,8
1649957417261,MATH 142B,A01,084149,Verstraete; Jacques Allan,0,12,30,30
1649957417261,MATH 142B,A02,084150,Verstraete; Jacques Allan,0,11,30,30
1649957423290,MATH 170A,A01,083459,Nie; Jiawang,0,3,30,30
1649957423290,MATH 170A,A02,083460,Nie; Jiawang,0,2,30,30
1649957423290,MATH 170A,A03,083461,Nie; Jiawang,0,1,30,30
1649957429344,MATH 193B,A01,083463,Staff,1,0,30,29
1649957429344,MATH 193B,A02,083464,Staff,10,0,30,20
1649957429344,MATH 193B,A03,083465,Staff,18,0,30,12
1649957435405,COGS 2,A01,083966,Boyle; Mary E. T.,17,0,30,13
1649957441430,COGS 9,A01,083968,Staff,38,0,60,22
1649957447454,COGS 14B,A01,083970,Staff,25,0,50,25
1649957453485,COGS 17,A01,092679,Staff,64,0,75,11
1649957459507,COGS 100,A01,083972,Staff,2,0,60,58
1649957471571,COGS 101C,A01,083976,Staff,18,0,30,12
1649957477597,COGS 102A,A01,083978,Johnson; Christine M.,15,0,30,15
1649957483626,COGS 107B,A01,083980,Staff,1,0,50,49
1649957489652,COGS 115,A01,083982,Staff,13,0,30,17
1649957495678,COGS 118B,A01,083367,Staff,0,11,40,40
1649957501726,COGS 172,A01,083984,Provenzano; Emily Kara,16,0,30,14
1649957507754,COGS 177,A00,083368,Staff,0,19,30,30
1649957513781,COGS 186,A01,083986,Staff,21,0,40,19
1649957519806,COGS 187A,A01,083988,Boyle; Mary E. T.,23,0,60,37
1649957525846,CSE 8A,A50,084003,Miranda; Gregory Joseph,0,4,15,15
1649957531875,CSE 11,A01,084005,Miranda; Gregory Joseph,13,0,55,42
1649957537902,CSE 20,A01,084007,Staff,8,0,20,12
1649957543930,CSE 21,A01,084009,Staff,5,0,50,45
1649957549982,CSE 30,A01,083370,Cao; Yingjun,0,29,40,40
1649957556115,CSE 100,A01,083372,Cao; Yingjun,0,31,40,40
1649957562160,CSE 101,A01,084011,Staff,0,52,40,40
1649957568186,CSE 141,A01,083374,Eldon; John,0,53,75,75
1649957574212,CSE 141L,A01,083376,Eldon; John,0,58,75,75
1649957580238,CSE 175,A01,084013,Kumar; Rakesh,22,0,25,3
1649957586273,CSE 190,A00,092508,Dubnov; Shlomo,15,0,15,0
1649957592301,ECE 5,A01,084049,Morris; Karcher William,15,0,20,5
1649957598354,ECE 100,A01,084051,Baghdadchi; Saharnaz,0,0,20,20
1649957598354,ECE 100,A02,091916,Baghdadchi; Saharnaz,16,0,20,4
1649957604405,ECE 101,A01,084053,Baghdadchi; Saharnaz,3,0,37,34
1649957604405,ECE 101,A02,084054,Baghdadchi; Saharnaz,32,0,37,5
1649957610431,ECE 107,A01,083390,Staff,28,0,40,12
1649957616458,ECE 148,A01,084056,Silberman; Jack,7,0,12,5
1649957622486,ECE 180,A00,083391,Abi Samra; Nicholas Camill,25,0,30,5
1649957622486,ECE 180,B00,083392,Abi Samra; Nicholas Camill,22,0,30,8
1649957628531,MATH 10B,A01,084110,Staff,8,0,30,22
1649957628531,MATH 10B,A02,084111,Staff,29,0,30,1
1649957628531,MATH 10B,A03,084112,Staff,27,0,30,3
1649957634555,MATH 10C,A01,083443,Staff,5,0,30,25
1649957634555,MATH 10C,A02,083444,Staff,14,0,30,16
1649957634555,MATH 10C,B01,084114,Staff,25,0,30,5
1649957634555,MATH 10C,B02,084115,Staff,28,0,30,2
1649957640585,MATH 18,A01,084117,Harel; Guershon,27,0,30,3
1649957640585,MATH 18,A02,084119,Harel; Guershon,28,0,30,2
1649957640585,MATH 18,A03,084120,Harel; Guershon,30,0,30,0
1649957640585,MATH 18,A04,084121,Harel; Guershon,29,0,30,1
1649957646619,MATH 20B,A01,084124,Um; Ko Woon,31,0,35,4
1649957646619,MATH 20B,B01,084126,Um; Ko Woon,32,0,35,3
1649957652645,MATH 20C,A01,083446,Hammock; Frances H,15,0,30,15
1649957652645,MATH 20C,A02,083447,Hammock; Frances H,28,0,30,2
1649957652645,MATH 20C,A03,083448,Hammock; Frances H,29,0,30,1
1649957652645,MATH 20C,A04,083449,Hammock; Frances H,30,0,30,0
1649957652645,MATH 20C,B01,083451,Hammock; Frances H,24,0,30,6
1649957652645,MATH 20C,B02,083452,Hammock; Frances H,27,0,30,3
1649957652645,MATH 20C,B03,083453,Hammock; Frances H,26,0,30,4
1649957652645,MATH 20C,B04,083454,Hammock; Frances H,30,0,30,0
1649957658676,MATH 20D,A01,084128,Staff,24,0,30,6
1649957658676,MATH 20D,A02,084129,Staff,30,0,30,0
1649957658676,MATH 20D,A03,084130,Staff,29,0,30,1
1649957658676,MATH 20D,B01,084133,Staff,17,0,30,13
1649957658676,MATH 20D,B02,084134,Staff,27,0,30,3
1649957658676,MATH 20D,B03,084135,Staff,30,0,30,0
1649957664699,MATH 20E,A01,084138,Staff,21,0,30,9
1649957664699,MATH 20E,A02,084139,Staff,17,0,30,13
1649957664699,MATH 20E,A03,084140,Staff,20,0,30,10
1649957664699,MATH 20E,A04,084141,Staff,25,0,30,5
1649957670725,MATH 102,A01,084143,Harel; Guershon,16,0,30,14
1649957670725,MATH 102,A02,084144,Harel; Guershon,21,0,30,9
1649957676749,MATH 103B,A01,083456,Staff,0,10,30,30
1649957676749,MATH 103B,A02,083457,Staff,0,10,30,30
1649957682778,MATH 109,A01,084146,Salehi Golsefidy; Alireza,27,0,30,3
1649957682778,MATH 109,A02,084147,Salehi Golsefidy; Alireza,22,0,30,8
1649957688819,MATH 120A,A01,085445,Eggers; John Dietrich,19,0,35,16
1649957688819,MATH 120A,A02,085446,Eggers; John Dietrich,27,0,35,8
1649957694854,MATH 142B,A01,084149,Verstraete; Jacques Allan,0,12,30,30
1649957694854,MATH 142B,A02,084150,Verstraete; Jacques Allan,0,11,30,30
1649957700878,MATH 170A,A01,083459,Nie; Jiawang,0,3,30,30
1649957700878,MATH 170A,A02,083460,Nie; Jiawang,0,2,30,30
1649957700878,MATH 170A,A03,083461,Nie; Jiawang,0,1,30,30
1649957706922,MATH 193B,A01,083463,Staff,1,0,30,29
1649957706922,MATH 193B,A02,083464,Staff,10,0,30,20
1649957706922,MATH 193B,A03,083465,Staff,18,0,30,12
1649957712977,COGS 2,A01,083966,Boyle; Mary E. T.,17,0,30,13
1649957719013,COGS 9,A01,083968,Staff,38,0,60,22
1649957725037,COGS 14B,A01,083970,Staff,24,0,50,26
1649957731075,COGS 17,A01,092679,Staff,63,0,75,12
1649957737113,COGS 100,A01,083972,Staff,2,0,60,58
1649957749164,COGS 101C,A01,083976,Staff,18,0,30,12
1649957755189,COGS 102A,A01,083978,Johnson; Christine M.,15,0,30,15
1649957761212,COGS 107B,A01,083980,Staff,1,0,50,49
1649957767239,COGS 115,A01,083982,Staff,13,0,30,17
1649957773268,COGS 118B,A01,083367,Staff,0,11,40,40
1649957779317,COGS 172,A01,083984,Provenzano; Emily Kara,16,0,30,14
1649957785369,COGS 177,A00,083368,Staff,0,19,30,30
1649957791401,COGS 186,A01,083986,Staff,21,0,40,19
1649957797424,COGS 187A,A01,083988,Boyle; Mary E. T.,23,0,60,37
1649957803461,CSE 8A,A50,084003,Miranda; Gregory Joseph,0,4,15,15
1649957809486,CSE 11,A01,084005,Miranda; Gregory Joseph,13,0,55,42
1649957815512,CSE 20,A01,084007,Staff,8,0,20,12
1649957821545,CSE 21,A01,084009,Staff,4,0,50,46
1649957827574,CSE 30,A01,083370,Cao; Yingjun,0,30,40,40
1649957833600,CSE 100,A01,083372,Cao; Yingjun,0,31,40,40
1649957839628,CSE 101,A01,084011,Staff,0,52,40,40
1649957845652,CSE 141,A01,083374,Eldon; John,0,54,75,75
1649957851682,CSE 141L,A01,083376,Eldon; John,0,59,75,75
1649957857712,CSE 175,A01,084013,Kumar; Rakesh,22,0,25,3
1649957863757,CSE 190,A00,092508,Dubnov; Shlomo,15,0,15,0
1649957869788,ECE 5,A01,084049,Morris; Karcher William,15,0,20,5
1649957875822,ECE 100,A01,084051,Baghdadchi; Saharnaz,0,0,20,20
1649957875822,ECE 100,A02,091916,Baghdadchi; Saharnaz,16,0,20,4
1649957881852,ECE 101,A01,084053,Baghdadchi; Saharnaz,3,0,37,34
1649957881852,ECE 101,A02,084054,Baghdadchi; Saharnaz,32,0,37,5
1649957887880,ECE 107,A01,083390,Staff,28,0,40,12
1649957893947,ECE 148,A01,084056,Silberman; Jack,7,0,12,5
1649957899987,ECE 180,A00,083391,Abi Samra; Nicholas Camill,25,0,30,5
1649957899987,ECE 180,B00,083392,Abi Samra; Nicholas Camill,22,0,30,8
1649957906014,MATH 10B,A01,084110,Staff,8,0,30,22
1649957906014,MATH 10B,A02,084111,Staff,29,0,30,1
1649957906014,MATH 10B,A03,084112,Staff,27,0,30,3
1649957912047,MATH 10C,A01,083443,Staff,5,0,30,25
1649957912047,MATH 10C,A02,083444,Staff,14,0,30,16
1649957912047,MATH 10C,B01,084114,Staff,25,0,30,5
1649957912047,MATH 10C,B02,084115,Staff,28,0,30,2
1649957918084,MATH 18,A01,084117,Harel; Guershon,26,0,30,4
1649957918084,MATH 18,A02,084119,Harel; Guershon,28,0,30,2
1649957918084,MATH 18,A03,084120,Harel; Guershon,30,0,30,0
1649957918084,MATH 18,A04,084121,Harel; Guershon,29,0,30,1
1649957924107,MATH 20B,A01,084124,Um; Ko Woon,31,0,35,4
1649957924107,MATH 20B,B01,084126,Um; Ko Woon,32,0,35,3
1649957930203,MATH 20C,A01,083446,Hammock; Frances H,15,0,30,15
1649957930203,MATH 20C,A02,083447,Hammock; Frances H,28,0,30,2
1649957930203,MATH 20C,A03,083448,Hammock; Frances H,29,0,30,1
1649957930203,MATH 20C,A04,083449,Hammock; Frances H,30,0,30,0
1649957930203,MATH 20C,B01,083451,Hammock; Frances H,24,0,30,6
1649957930203,MATH 20C,B02,083452,Hammock; Frances H,27,0,30,3
1649957930203,MATH 20C,B03,083453,Hammock; Frances H,26,0,30,4
1649957930203,MATH 20C,B04,083454,Hammock; Frances H,30,0,30,0
1649957936227,MATH 20D,A01,084128,Staff,24,0,30,6
1649957936227,MATH 20D,A02,084129,Staff,30,0,30,0
1649957936227,MATH 20D,A03,084130,Staff,29,0,30,1
1649957936227,MATH 20D,B01,084133,Staff,17,0,30,13
1649957936227,MATH 20D,B02,084134,Staff,27,0,30,3
1649957936227,MATH 20D,B03,084135,Staff,30,0,30,0
1649957942253,MATH 20E,A01,084138,Staff,21,0,30,9
1649957942253,MATH 20E,A02,084139,Staff,17,0,30,13
1649957942253,MATH 20E,A03,084140,Staff,20,0,30,10
1649957942253,MATH 20E,A04,084141,Staff,25,0,30,5
1649957948276,MATH 102,A01,084143,Harel; Guershon,16,0,30,14
1649957948276,MATH 102,A02,084144,Harel; Guershon,21,0,30,9
1649957954303,MATH 103B,A01,083456,Staff,0,10,30,30
1649957954303,MATH 103B,A02,083457,Staff,0,10,30,30
1649957960330,MATH 109,A01,084146,Salehi Golsefidy; Alireza,27,0,30,3
1649957960330,MATH 109,A02,084147,Salehi Golsefidy; Alireza,22,0,30,8
1649957966357,MATH 120A,A01,085445,Eggers; John Dietrich,19,0,35,16
1649957966357,MATH 120A,A02,085446,Eggers; John Dietrich,27,0,35,8
1649957972388,MATH 142B,A01,084149,Verstraete; Jacques Allan,0,12,30,30
1649957972388,MATH 142B,A02,084150,Verstraete; Jacques Allan,0,11,30,30
1649957978420,MATH 170A,A01,083459,Nie; Jiawang,0,3,30,30
1649957978420,MATH 170A,A02,083460,Nie; Jiawang,0,2,30,30
1649957978420,MATH 170A,A03,083461,Nie; Jiawang,0,1,30,30
1649957984457,MATH 193B,A01,083463,Staff,1,0,30,29
1649957984457,MATH 193B,A02,083464,Staff,10,0,30,20
1649957984457,MATH 193B,A03,083465,Staff,18,0,30,12
1649957990514,COGS 2,A01,083966,Boyle; Mary E. T.,17,0,30,13
1649957996550,COGS 9,A01,083968,Staff,37,0,60,23
1649958002578,COGS 14B,A01,083970,Staff,24,0,50,26
1649958008604,COGS 17,A01,092679,Staff,63,0,75,12
1649958014628,COGS 100,A01,083972,Staff,1,0,60,59
1649958026683,COGS 101C,A01,083976,Staff,18,0,30,12
1649958032718,COGS 102A,A01,083978,Johnson; Christine M.,15,0,30,15
1649958038739,COGS 107B,A01,083980,Staff,1,0,50,49
1649958044762,COGS 115,A01,083982,Staff,13,0,30,17
1649958050785,COGS 118B,A01,083367,Staff,0,11,40,40
1649958056819,COGS 172,A01,083984,Provenzano; Emily Kara,16,0,30,14
1649958062848,COGS 177,A00,083368,Staff,0,19,30,30
1649958068884,COGS 186,A01,083986,Staff,21,0,40,19
1649958074906,COGS 187A,A01,083988,Boyle; Mary E. T.,23,0,60,37
1649958080940,CSE 8A,A50,084003,Miranda; Gregory Joseph,0,4,15,15
1649958086967,CSE 11,A01,084005,Miranda; Gregory Joseph,13,0,55,42
1649958092995,CSE 20,A01,084007,Staff,8,0,20,12
1649958099022,CSE 21,A01,084009,Staff,4,0,50,46
1649958105046,CSE 30,A01,083370,Cao; Yingjun,0,30,40,40
1649958111084,CSE 100,A01,083372,Cao; Yingjun,0,31,40,40
1649958117117,CSE 101,A01,084011,Staff,0,52,40,40
1649958123147,CSE 141,A01,083374,Eldon; John,0,54,75,75
1649958129176,CSE 141L,A01,083376,Eldon; John,0,59,75,75
1649958135203,CSE 175,A01,084013,Kumar; Rakesh,22,0,25,3
1649958141240,CSE 190,A00,092508,Dubnov; Shlomo,15,0,15,0
1649958147263,ECE 5,A01,084049,Morris; Karcher William,15,0,20,5
1649958153407,ECE 100,A01,084051,Baghdadchi; Saharnaz,0,0,20,20
1649958153407,ECE 100,A02,091916,Baghdadchi; Saharnaz,16,0,20,4
1649958159438,ECE 101,A01,084053,Baghdadchi; Saharnaz,3,0,37,34
1649958159438,ECE 101,A02,084054,Baghdadchi; Saharnaz,32,0,37,5
1649958165466,ECE 107,A01,083390,Staff,28,0,40,12
1649958171503,ECE 148,A01,084056,Silberman; Jack,7,0,12,5
1649958177546,ECE 180,A00,083391,Abi Samra; Nicholas Camill,25,0,30,5
1649958177546,ECE 180,B00,083392,Abi Samra; Nicholas Camill,22,0,30,8
1649958183572,MATH 10B,A01,084110,Staff,8,0,30,22
1649958183572,MATH 10B,A02,084111,Staff,29,0,30,1
1649958183572,MATH 10B,A03,084112,Staff,27,0,30,3
1649958189600,MATH 10C,A01,083443,Staff,5,0,30,25
1649958189600,MATH 10C,A02,083444,Staff,14,0,30,16
1649958189600,MATH 10C,B01,084114,Staff,25,0,30,5
1649958189600,MATH 10C,B02,084115,Staff,28,0,30,2
1649958195640,MATH 18,A01,084117,Harel; Guershon,26,0,30,4
1649958195640,MATH 18,A02,084119,Harel; Guershon,28,0,30,2
1649958195640,MATH 18,A03,084120,Harel; Guershon,30,0,30,0
1649958195640,MATH 18,A04,084121,Harel; Guershon,29,0,30,1
1649958201668,MATH 20B,A01,084124,Um; Ko Woon,31,0,35,4
1649958201668,MATH 20B,B01,084126,Um; Ko Woon,32,0,35,3
1649958207702,MATH 20C,A01,083446,Hammock; Frances H,14,0,30,16
1649958207702,MATH 20C,A02,083447,Hammock; Frances H,28,0,30,2
1649958207702,MATH 20C,A03,083448,Hammock; Frances H,29,0,30,1
1649958207702,MATH 20C,A04,083449,Hammock; Frances H,30,0,30,0
1649958207702,MATH 20C,B01,083451,Hammock; Frances H,24,0,30,6
1649958207702,MATH 20C,B02,083452,Hammock; Frances H,27,0,30,3
1649958207702,MATH 20C,B03,083453,Hammock; Frances H,26,0,30,4
1649958207702,MATH 20C,B04,083454,Hammock; Frances H,30,0,30,0
1649958213729,MATH 20D,A01,084128,Staff,24,0,30,6
1649958213729,MATH 20D,A02,084129,Staff,30,0,30,0
1649958213729,MATH 20D,A03,084130,Staff,29,0,30,1
1649958213729,MATH 20D,B01,084133,Staff,17,0,30,13
1649958213729,MATH 20D,B02,084134,Staff,27,0,30,3
1649958213729,MATH 20D,B03,084135,Staff,30,0,30,0
1649958219759,MATH 20E,A01,084138,Staff,21,0,30,9
1649958219759,MATH 20E,A02,084139,Staff,17,0,30,13
1649958219759,MATH 20E,A03,084140,Staff,20,0,30,10
1649958219759,MATH 20E,A04,084141,Staff,25,0,30,5
1649958225788,MATH 102,A01,084143,Harel; Guershon,16,0,30,14
1649958225788,MATH 102,A02,084144,Harel; Guershon,20,0,30,10
1649958231819,MATH 103B,A01,083456,Staff,0,10,30,30
1649958231819,MATH 103B,A02,083457,Staff,0,10,30,30
1649958237843,MATH 109,A01,084146,Salehi Golsefidy; Alireza,27,0,30,3
1649958237843,MATH 109,A02,084147,Salehi Golsefidy; Alireza,21,0,30,9
1649958243868,MATH 120A,A01,085445,Eggers; John Dietrich,19,0,35,16
1649958243868,MATH 120A,A02,085446,Eggers; John Dietrich,27,0,35,8
1649958249898,MATH 142B,A01,084149,Verstraete; Jacques Allan,0,12,30,30
1649958249898,MATH 142B,A02,084150,Verstraete; Jacques Allan,0,11,30,30
1649958255931,MATH 170A,A01,083459,Nie; Jiawang,0,3,30,30
1649958255931,MATH 170A,A02,083460,Nie; Jiawang,0,2,30,30
1649958255931,MATH 170A,A03,083461,Nie; Jiawang,0,2,30,30
1649958261964,MATH 193B,A01,083463,Staff,1,0,30,29
1649958261964,MATH 193B,A02,083464,Staff,10,0,30,20
1649958261964,MATH 193B,A03,083465,Staff,18,0,30,12
1649958268038,COGS 2,A01,083966,Boyle; Mary E. T.,17,0,30,13
1649958274071,COGS 9,A01,083968,Staff,37,0,60,23
1649958280095,COGS 14B,A01,083970,Staff,24,0,50,26
1649958286120,COGS 17,A01,092679,Staff,63,0,75,12
1649958292144,COGS 100,A01,083972,Staff,1,0,60,59
1649958304190,COGS 101C,A01,083976,Staff,17,0,30,13
1649958310214,COGS 102A,A01,083978,Johnson; Christine M.,15,0,30,15
1649958316236,COGS 107B,A01,083980,Staff,1,0,50,49
1649958322276,COGS 115,A01,083982,Staff,13,0,30,17
1649958328301,COGS 118B,A01,083367,Staff,0,11,40,40
1649958334324,COGS 172,A01,083984,Provenzano; Emily Kara,16,0,30,14
1649958340347,COGS 177,A00,083368,Staff,0,19,30,30
1649958346370,COGS 186,A01,083986,Staff,21,0,40,19
1649958352401,COGS 187A,A01,083988,Boyle; Mary E. T.,23,0,60,37
1649958358427,CSE 8A,A50,084003,Miranda; Gregory Joseph,0,4,15,15
1649958364451,CSE 11,A01,084005,Miranda; Gregory Joseph,13,0,55,42
1649958370477,CSE 20,A01,084007,Staff,8,0,20,12
1649958376514,CSE 21,A01,084009,Staff,4,0,50,46
1649958382543,CSE 30,A01,083370,Cao; Yingjun,0,30,40,40
1649958388566,CSE 100,A01,083372,Cao; Yingjun,0,31,40,40
1649958394600,CSE 101,A01,084011,Staff,0,52,40,40
1649958400626,CSE 141,A01,083374,Eldon; John,0,55,75,75
1649958406652,CSE 141L,A01,083376,Eldon; John,0,60,75,75
1649958412677,CSE 175,A01,084013,Kumar; Rakesh,22,0,25,3
1649958418716,CSE 190,A00,092508,Dubnov; Shlomo,15,0,15,0
1649958424749,ECE 5,A01,084049,Morris; Karcher William,15,0,20,5
1649958430776,ECE 100,A01,084051,Baghdadchi; Saharnaz,0,0,20,20
1649958430776,ECE 100,A02,091916,Baghdadchi; Saharnaz,16,0,20,4
1649958436811,ECE 101,A01,084053,Baghdadchi; Saharnaz,3,0,37,34
1649958436811,ECE 101,A02,084054,Baghdadchi; Saharnaz,32,0,37,5
1649958442835,ECE 107,A01,083390,Staff,28,0,40,12
1649958448859,ECE 148,A01,084056,Silberman; Jack,7,0,12,5
1649958454882,ECE 180,A00,083391,Abi Samra; Nicholas Camill,25,0,30,5
1649958454882,ECE 180,B00,083392,Abi Samra; Nicholas Camill,22,0,30,8
1649958460913,MATH 10B,A01,084110,Staff,8,0,30,22
1649958460913,MATH 10B,A02,084111,Staff,29,0,30,1
1649958460913,MATH 10B,A03,084112,Staff,27,0,30,3
1649958466940,MATH 10C,A01,083443,Staff,5,0,30,25
1649958466940,MATH 10C,A02,083444,Staff,14,0,30,16
1649958466940,MATH 10C,B01,084114,Staff,25,0,30,5
1649958466940,MATH 10C,B02,084115,Staff,28,0,30,2
1649958472962,MATH 18,A01,084117,Harel; Guershon,26,0,30,4
1649958472962,MATH 18,A02,084119,Harel; Guershon,28,0,30,2
1649958472962,MATH 18,A03,084120,Harel; Guershon,30,0,30,0
1649958472962,MATH 18,A04,084121,Harel; Guershon,29,0,30,1
1649958478993,MATH 20B,A01,084124,Um; Ko Woon,31,0,35,4
1649958478993,MATH 20B,B01,084126,Um; Ko Woon,32,0,35,3
1649958485033,MATH 20C,A01,083446,Hammock; Frances H,14,0,30,16
1649958485033,MATH 20C,A02,083447,Hammock; Frances H,28,0,30,2
1649958485033,MATH 20C,A03,083448,Hammock; Frances H,29,0,30,1
1649958485033,MATH 20C,A04,083449,Hammock; Frances H,30,0,30,0
1649958485033,MATH 20C,B01,083451,Hammock; Frances H,24,0,30,6
1649958485033,MATH 20C,B02,083452,Hammock; Frances H,27,0,30,3
1649958485033,MATH 20C,B03,083453,Hammock; Frances H,26,0,30,4
1649958485033,MATH 20C,B04,083454,Hammock; Frances H,30,0,30,0
1649958491057,MATH 20D,A01,084128,Staff,24,0,30,6
1649958491057,MATH 20D,A02,084129,Staff,30,0,30,0
1649958491057,MATH 20D,A03,084130,Staff,29,0,30,1
1649958491057,MATH 20D,B01,084133,Staff,17,0,30,13
1649958491057,MATH 20D,B02,084134,Staff,27,0,30,3
1649958491057,MATH 20D,B03,084135,Staff,30,0,30,0
1649958497083,MATH 20E,A01,084138,Staff,21,0,30,9
1649958497083,MATH 20E,A02,084139,Staff,17,0,30,13
1649958497083,MATH 20E,A03,084140,Staff,20,0,30,10
1649958497083,MATH 20E,A04,084141,Staff,25,0,30,5
1649958503118,MATH 102,A01,084143,Harel; Guershon,16,0,30,14
1649958503118,MATH 102,A02,084144,Harel; Guershon,20,0,30,10
1649958509146,MATH 103B,A01,083456,Staff,0,10,30,30
1649958509146,MATH 103B,A02,083457,Staff,0,10,30,30
1649958515178,MATH 109,A01,084146,Salehi Golsefidy; Alireza,27,0,30,3
1649958515178,MATH 109,A02,084147,Salehi Golsefidy; Alireza,21,0,30,9
1649958521219,MATH 120A,A01,085445,Eggers; John Dietrich,19,0,35,16
1649958521219,MATH 120A,A02,085446,Eggers; John Dietrich,27,0,35,8
1649958527304,MATH 142B,A01,084149,Verstraete; Jacques Allan,0,12,30,30
1649958527304,MATH 142B,A02,084150,Verstraete; Jacques Allan,0,11,30,30
1649958533344,MATH 170A,A01,083459,Nie; Jiawang,0,3,30,30
1649958533344,MATH 170A,A02,083460,Nie; Jiawang,0,2,30,30
1649958533344,MATH 170A,A03,083461,Nie; Jiawang,0,2,30,30
1649958539367,MATH 193B,A01,083463,Staff,1,0,30,29
1649958539367,MATH 193B,A02,083464,Staff,10,0,30,20
1649958539367,MATH 193B,A03,083465,Staff,18,0,30,12
1649958545428,COGS 2,A01,083966,Boyle; Mary E. T.,17,0,30,13
1649958551464,COGS 9,A01,083968,Staff,37,0,60,23
1649958557489,COGS 14B,A01,083970,Staff,24,0,50,26
1649958563513,COGS 17,A01,092679,Staff,63,0,75,12
1649958569542,COGS 100,A01,083972,Staff,1,0,60,59
1649958581588,COGS 101C,A01,083976,Staff,17,0,30,13
1649958587623,COGS 102A,A01,083978,Johnson; Christine M.,15,0,30,15
1649958593644,COGS 107B,A01,083980,Staff,1,0,50,49
1649958599683,COGS 115,A01,083982,Staff,13,0,30,17
1649958605713,COGS 118B,A01,083367,Staff,0,11,40,40
1649958611739,COGS 172,A01,083984,Provenzano; Emily Kara,16,0,30,14
1649958617766,COGS 177,A00,083368,Staff,0,19,30,30
1649958623793,COGS 186,A01,083986,Staff,21,0,40,19
1649958629827,COGS 187A,A01,083988,Boyle; Mary E. T.,23,0,60,37
1649958635866,CSE 8A,A50,084003,Miranda; Gregory Joseph,0,4,15,15
1649958641892,CSE 11,A01,084005,Miranda; Gregory Joseph,13,0,55,42
1649958647915,CSE 20,A01,084007,Staff,8,0,20,12
1649958653956,CSE 21,A01,084009,Staff,3,0,50,47
1649958659984,CSE 30,A01,083370,Cao; Yingjun,0,30,40,40
1649958666010,CSE 100,A01,083372,Cao; Yingjun,0,31,40,40
1649958672033,CSE 101,A01,084011,Staff,0,52,40,40
1649958678061,CSE 141,A01,083374,Eldon; John,0,55,75,75
1649958684093,CSE 141L,A01,083376,Eldon; John,0,60,75,75
1649958690135,CSE 175,A01,084013,Kumar; Rakesh,22,0,25,3
1649958696158,CSE 190,A00,092508,Dubnov; Shlomo,15,0,15,0
1649958702191,ECE 5,A01,084049,Morris; Karcher William,15,0,20,5
1649958708212,ECE 100,A01,084051,Baghdadchi; Saharnaz,0,0,20,20
1649958708212,ECE 100,A02,091916,Baghdadchi; Saharnaz,16,0,20,4
1649958714253,ECE 101,A01,084053,Baghdadchi; Saharnaz,3,0,37,34
1649958714253,ECE 101,A02,084054,Baghdadchi; Saharnaz,32,0,37,5
1649958720278,ECE 107,A01,083390,Staff,28,0,40,12
1649958726309,ECE 148,A01,084056,Silberman; Jack,7,0,12,5
1649958732336,ECE 180,A00,083391,Abi Samra; Nicholas Camill,25,0,30,5
1649958732336,ECE 180,B00,083392,Abi Samra; Nicholas Camill,22,0,30,8
1649958738372,MATH 10B,A01,084110,Staff,8,0,30,22
1649958738372,MATH 10B,A02,084111,Staff,29,0,30,1
1649958738372,MATH 10B,A03,084112,Staff,27,0,30,3
1649958744396,MATH 10C,A01,083443,Staff,5,0,30,25
1649958744396,MATH 10C,A02,083444,Staff,14,0,30,16
1649958744396,MATH 10C,B01,084114,Staff,25,0,30,5
1649958744396,MATH 10C,B02,084115,Staff,28,0,30,2
1649958750530,MATH 18,A01,084117,Harel; Guershon,26,0,30,4
1649958750530,MATH 18,A02,084119,Harel; Guershon,28,0,30,2
1649958750530,MATH 18,A03,084120,Harel; Guershon,30,0,30,0
1649958750530,MATH 18,A04,084121,Harel; Guershon,29,0,30,1
1649958756558,MATH 20B,A01,084124,Um; Ko Woon,31,0,35,4
1649958756558,MATH 20B,B01,084126,Um; Ko Woon,32,0,35,3
1649958762600,MATH 20C,A01,083446,Hammock; Frances H,14,0,30,16
1649958762600,MATH 20C,A02,083447,Hammock; Frances H,28,0,30,2
1649958762600,MATH 20C,A03,083448,Hammock; Frances H,29,0,30,1
1649958762600,MATH 20C,A04,083449,Hammock; Frances H,30,0,30,0
1649958762600,MATH 20C,B01,083451,Hammock; Frances H,24,0,30,6
1649958762600,MATH 20C,B02,083452,Hammock; Frances H,27,0,30,3
1649958762600,MATH 20C,B03,083453,Hammock; Frances H,26,0,30,4
1649958762600,MATH 20C,B04,083454,Hammock; Frances H,30,0,30,0
1649958768624,MATH 20D,A01,084128,Staff,24,0,30,6
1649958768624,MATH 20D,A02,084129,Staff,30,0,30,0
1649958768624,MATH 20D,A03,084130,Staff,29,0,30,1
1649958768624,MATH 20D,B01,084133,Staff,16,0,30,14
1649958768624,MATH 20D,B02,084134,Staff,27,0,30,3
1649958768624,MATH 20D,B03,084135,Staff,30,0,30,0
1649958774646,MATH 20E,A01,084138,Staff,21,0,30,9
1649958774646,MATH 20E,A02,084139,Staff,17,0,30,13
1649958774646,MATH 20E,A03,084140,Staff,20,0,30,10
1649958774646,MATH 20E,A04,084141,Staff,25,0,30,5
1649958780673,MATH 102,A01,084143,Harel; Guershon,16,0,30,14
1649958780673,MATH 102,A02,084144,Harel; Guershon,20,0,30,10
1649958786695,MATH 103B,A01,083456,Staff,0,10,30,30
1649958786695,MATH 103B,A02,083457,Staff,0,10,30,30
1649958799416,MATH 109,A01,084146,Salehi Golsefidy; Alireza,27,0,30,3
1649958799416,MATH 109,A02,084147,Salehi Golsefidy; Alireza,20,0,30,10
1649958805439,MATH 120A,A01,085445,Eggers; John Dietrich,19,0,35,16
1649958805439,MATH 120A,A02,085446,Eggers; John Dietrich,27,0,35,8
1649958811466,MATH 142B,A01,084149,Verstraete; Jacques Allan,0,12,30,30
1649958811466,MATH 142B,A02,084150,Verstraete; Jacques Allan,0,11,30,30
1649958817496,MATH 170A,A01,083459,Nie; Jiawang,0,3,30,30
1649958817496,MATH 170A,A02,083460,Nie; Jiawang,0,2,30,30
1649958817496,MATH 170A,A03,083461,Nie; Jiawang,0,2,30,30
1649958823547,MATH 193B,A01,083463,Staff,1,0,30,29
1649958823547,MATH 193B,A02,083464,Staff,10,0,30,20
1649958823547,MATH 193B,A03,083465,Staff,18,0,30,12
1649958829630,COGS 2,A01,083966,Boyle; Mary E. T.,17,0,30,13
1649958835667,COGS 9,A01,083968,Staff,37,0,60,23
1649958841699,COGS 14B,A01,083970,Staff,24,0,50,26
1649958847723,COGS 17,A01,092679,Staff,63,0,75,12
1649958853745,COGS 100,A01,083972,Staff,0,1,60,60
1649958865802,COGS 101C,A01,083976,Staff,17,0,30,13
1649958871824,COGS 102A,A01,083978,Johnson; Christine M.,14,0,30,16
1649958877848,COGS 107B,A01,083980,Staff,1,0,50,49
1649958883877,COGS 115,A01,083982,Staff,12,0,30,18
1649958889917,COGS 118B,A01,083367,Staff,0,11,40,40
1649958895963,COGS 172,A01,083984,Provenzano; Emily Kara,16,0,30,14
1649958902005,COGS 177,A00,083368,Staff,0,19,30,30
1649958908030,COGS 186,A01,083986,Staff,21,0,40,19
1649958914053,COGS 187A,A01,083988,Boyle; Mary E. T.,23,0,60,37
1649958920094,CSE 8A,A50,084003,Miranda; Gregory Joseph,0,4,15,15
1649958926142,CSE 11,A01,084005,Miranda; Gregory Joseph,13,0,55,42
1649958932168,CSE 20,A01,084007,Staff,8,0,20,12
1649958938193,CSE 21,A01,084009,Staff,3,0,50,47
1649958944218,CSE 30,A01,083370,Cao; Yingjun,0,31,40,40
1649958950248,CSE 100,A01,083372,Cao; Yingjun,0,32,40,40
1649958956282,CSE 101,A01,084011,Staff,0,52,40,40
1649958962330,CSE 141,A01,083374,Eldon; John,0,55,75,75
1649958968364,CSE 141L,A01,083376,Eldon; John,0,60,75,75
1649958974402,CSE 175,A01,084013,Kumar; Rakesh,22,0,25,3
1649958980426,CSE 190,A00,092508,Dubnov; Shlomo,15,0,15,0
1649958986469,ECE 5,A01,084049,Morris; Karcher William,15,0,20,5
1649958992522,ECE 100,A01,084051,Baghdadchi; Saharnaz,0,0,20,20
1649958992522,ECE 100,A02,091916,Baghdadchi; Saharnaz,16,0,20,4
1649958998546,ECE 101,A01,084053,Baghdadchi; Saharnaz,3,0,37,34
1649958998546,ECE 101,A02,084054,Baghdadchi; Saharnaz,32,0,37,5
1649959004569,ECE 107,A01,083390,Staff,28,0,40,12
1649959010603,ECE 148,A01,084056,Silberman; Jack,7,0,12,5
1649959016630,ECE 180,A00,083391,Abi Samra; Nicholas Camill,25,0,30,5
1649959016630,ECE 180,B00,083392,Abi Samra; Nicholas Camill,22,0,30,8
1649959022654,MATH 10B,A01,084110,Staff,8,0,30,22
1649959022654,MATH 10B,A02,084111,Staff,29,0,30,1
1649959022654,MATH 10B,A03,084112,Staff,26,0,30,4
1649959028685,MATH 10C,A01,083443,Staff,5,0,30,25
1649959028685,MATH 10C,A02,083444,Staff,14,0,30,16
1649959028685,MATH 10C,B01,084114,Staff,25,0,30,5
1649959028685,MATH 10C,B02,084115,Staff,28,0,30,2
1649959034728,MATH 18,A01,084117,Harel; Guershon,26,0,30,4
1649959034728,MATH 18,A02,084119,Harel; Guershon,28,0,30,2
1649959034728,MATH 18,A03,084120,Harel; Guershon,30,0,30,0
1649959034728,MATH 18,A04,084121,Harel; Guershon,29,0,30,1
1649959040753,MATH 20B,A01,084124,Um; Ko Woon,31,0,35,4
1649959040753,MATH 20B,B01,084126,Um; Ko Woon,32,0,35,3
1649959046788,MATH 20C,A01,083446,Hammock; Frances H,14,0,30,16
1649959046788,MATH 20C,A02,083447,Hammock; Frances H,28,0,30,2
1649959046788,MATH 20C,A03,083448,Hammock; Frances H,29,0,30,1
1649959046788,MATH 20C,A04,083449,Hammock; Frances H,30,0,30,0
1649959046788,MATH 20C,B01,083451,Hammock; Frances H,24,0,30,6
1649959046788,MATH 20C,B02,083452,Hammock; Frances H,27,0,30,3
1649959046788,MATH 20C,B03,083453,Hammock; Frances H,26,0,30,4
1649959046788,MATH 20C,B04,083454,Hammock; Frances H,30,0,30,0
1649959052821,MATH 20D,A01,084128,Staff,24,0,30,6
1649959052821,MATH 20D,A02,084129,Staff,30,0,30,0
1649959052821,MATH 20D,A03,084130,Staff,29,0,30,1
1649959052821,MATH 20D,B01,084133,Staff,16,0,30,14
1649959052821,MATH 20D,B02,084134,Staff,26,0,30,4
1649959052821,MATH 20D,B03,084135,Staff,30,0,30,0
1649959058846,MATH 20E,A01,084138,Staff,21,0,30,9
1649959058846,MATH 20E,A02,084139,Staff,17,0,30,13
1649959058846,MATH 20E,A03,084140,Staff,20,0,30,10
1649959058846,MATH 20E,A04,084141,Staff,25,0,30,5
1649959064871,MATH 102,A01,084143,Harel; Guershon,16,0,30,14
1649959064871,MATH 102,A02,084144,Harel; Guershon,20,0,30,10
1649959070898,MATH 103B,A01,083456,Staff,0,10,30,30
1649959070898,MATH 103B,A02,083457,Staff,0,10,30,30
1649959076925,MATH 109,A01,084146,Salehi Golsefidy; Alireza,27,0,30,3
1649959076925,MATH 109,A02,084147,Salehi Golsefidy; Alireza,20,0,30,10
1649959082952,MATH 120A,A01,085445,Eggers; John Dietrich,19,0,35,16
1649959082952,MATH 120A,A02,085446,Eggers; John Dietrich,27,0,35,8
1649959088976,MATH 142B,A01,084149,Verstraete; Jacques Allan,0,12,30,30
1649959088976,MATH 142B,A02,084150,Verstraete; Jacques Allan,0,11,30,30
1649959095012,MATH 170A,A01,083459,Nie; Jiawang,0,3,30,30
1649959095012,MATH 170A,A02,083460,Nie; Jiawang,0,2,30,30
1649959095012,MATH 170A,A03,083461,Nie; Jiawang,0,2,30,30
1649959101053,MATH 193B,A01,083463,Staff,1,0,30,29
1649959101053,MATH 193B,A02,083464,Staff,10,0,30,20
1649959101053,MATH 193B,A03,083465,Staff,18,0,30,12
1649959107114,COGS 2,A01,083966,Boyle; Mary E. T.,17,0,30,13
1649959113148,COGS 9,A01,083968,Staff,37,0,60,23
1649959119172,COGS 14B,A01,083970,Staff,24,0,50,26
1649959125208,COGS 17,A01,092679,Staff,61,0,75,14
1649959131233,COGS 100,A01,083972,Staff,0,2,60,60
1649959143293,COGS 101C,A01,083976,Staff,17,0,30,13
1649959149327,COGS 102A,A01,083978,Johnson; Christine M.,14,0,30,16
1649959155364,COGS 107B,A01,083980,Staff,1,0,50,49
1649959161386,COGS 115,A01,083982,Staff,12,0,30,18
1649959167438,COGS 118B,A01,083367,Staff,0,11,40,40
1649959173463,COGS 172,A01,083984,Provenzano; Emily Kara,16,0,30,14
1649959179490,COGS 177,A00,083368,Staff,0,19,30,30
1649959185513,COGS 186,A01,083986,Staff,21,0,40,19
1649959191546,COGS 187A,A01,083988,Boyle; Mary E. T.,23,0,60,37
1649959197574,CSE 8A,A50,084003,Miranda; Gregory Joseph,0,4,15,15
1649959203603,CSE 11,A01,084005,Miranda; Gregory Joseph,12,0,55,43
1649959209636,CSE 20,A01,084007,Staff,8,0,20,12
1649959215679,CSE 21,A01,084009,Staff,3,0,50,47
1649959221703,CSE 30,A01,083370,Cao; Yingjun,0,31,40,40
1649959227727,CSE 100,A01,083372,Cao; Yingjun,0,32,40,40
1649959233750,CSE 101,A01,084011,Staff,0,52,40,40
1649959239778,CSE 141,A01,083374,Eldon; John,0,55,75,75
1649959245800,CSE 141L,A01,083376,Eldon; John,0,60,75,75
1649959251846,CSE 175,A01,084013,Kumar; Rakesh,22,0,25,3
1649959257870,CSE 190,A00,092508,Dubnov; Shlomo,15,0,15,0
1649959263905,ECE 5,A01,084049,Morris; Karcher William,15,0,20,5
1649959269932,ECE 100,A01,084051,Baghdadchi; Saharnaz,0,0,20,20
1649959269932,ECE 100,A02,091916,Baghdadchi; Saharnaz,16,0,20,4
1649959275955,ECE 101,A01,084053,Baghdadchi; Saharnaz,3,0,37,34
1649959275955,ECE 101,A02,084054,Baghdadchi; Saharnaz,32,0,37,5
1649959281979,ECE 107,A01,083390,Staff,28,0,40,12
1649959288003,ECE 148,A01,084056,Silberman; Jack,7,0,12,5
1649959294026,ECE 180,A00,083391,Abi Samra; Nicholas Camill,25,0,30,5
1649959294026,ECE 180,B00,083392,Abi Samra; Nicholas Camill,22,0,30,8
1649959300065,MATH 10B,A01,084110,Staff,8,0,30,22
1649959300065,MATH 10B,A02,084111,Staff,29,0,30,1
1649959300065,MATH 10B,A03,084112,Staff,26,0,30,4
1649959306097,MATH 10C,A01,083443,Staff,5,0,30,25
1649959306097,MATH 10C,A02,083444,Staff,14,0,30,16
1649959306097,MATH 10C,B01,084114,Staff,25,0,30,5
1649959306097,MATH 10C,B02,084115,Staff,28,0,30,2
1649959312124,MATH 18,A01,084117,Harel; Guershon,26,0,30,4
1649959312124,MATH 18,A02,084119,Harel; Guershon,28,0,30,2
1649959312124,MATH 18,A03,084120,Harel; Guershon,30,0,30,0
1649959312124,MATH 18,A04,084121,Harel; Guershon,29,0,30,1
1649959318163,MATH 20B,A01,084124,Um; Ko Woon,31,0,35,4
1649959318163,MATH 20B,B01,084126,Um; Ko Woon,32,0,35,3
1649959324205,MATH 20C,A01,083446,Hammock; Frances H,14,0,30,16
1649959324205,MATH 20C,A02,083447,Hammock; Frances H,28,0,30,2
1649959324205,MATH 20C,A03,083448,Hammock; Frances H,29,0,30,1
1649959324205,MATH 20C,A04,083449,Hammock; Frances H,30,0,30,0
1649959324205,MATH 20C,B01,083451,Hammock; Frances H,24,0,30,6
1649959324205,MATH 20C,B02,083452,Hammock; Frances H,27,0,30,3
1649959324205,MATH 20C,B03,083453,Hammock; Frances H,26,0,30,4
1649959324205,MATH 20C,B04,083454,Hammock; Frances H,30,0,30,0
1649959330258,MATH 20D,A01,084128,Staff,24,0,30,6
1649959330258,MATH 20D,A02,084129,Staff,30,0,30,0
1649959330258,MATH 20D,A03,084130,Staff,29,0,30,1
1649959330258,MATH 20D,B01,084133,Staff,16,0,30,14
1649959330258,MATH 20D,B02,084134,Staff,26,0,30,4
1649959330258,MATH 20D,B03,084135,Staff,30,0,30,0
1649959336287,MATH 20E,A01,084138,Staff,21,0,30,9
1649959336287,MATH 20E,A02,084139,Staff,17,0,30,13
1649959336287,MATH 20E,A03,084140,Staff,20,0,30,10
1649959336287,MATH 20E,A04,084141,Staff,25,0,30,5
1649959342317,MATH 102,A01,084143,Harel; Guershon,16,0,30,14
1649959342317,MATH 102,A02,084144,Harel; Guershon,20,0,30,10
1649959348356,MATH 103B,A01,083456,Staff,0,10,30,30
1649959348356,MATH 103B,A02,083457,Staff,0,10,30,30
1649959354481,MATH 109,A01,084146,Salehi Golsefidy; Alireza,27,0,30,3
1649959354481,MATH 109,A02,084147,Salehi Golsefidy; Alireza,20,0,30,10
1649959360507,MATH 120A,A01,085445,Eggers; John Dietrich,19,0,35,16
1649959360507,MATH 120A,A02,085446,Eggers; John Dietrich,27,0,35,8
1649959366530,MATH 142B,A01,084149,Verstraete; Jacques Allan,0,12,30,30
1649959366530,MATH 142B,A02,084150,Verstraete; Jacques Allan,0,11,30,30
1649959372553,MATH 170A,A01,083459,Nie; Jiawang,0,3,30,30
1649959372553,MATH 170A,A02,083460,Nie; Jiawang,0,2,30,30
1649959372553,MATH 170A,A03,083461,Nie; Jiawang,0,2,30,30
1649959378586,MATH 193B,A01,083463,Staff,1,0,30,29
1649959378586,MATH 193B,A02,083464,Staff,10,0,30,20
1649959378586,MATH 193B,A03,083465,Staff,18,0,30,12
1649959384647,COGS 2,A01,083966,Boyle; Mary E. T.,17,0,30,13
1649959390674,COGS 9,A01,083968,Staff,37,0,60,23
1649959396698,COGS 14B,A01,083970,Staff,24,0,50,26
1649959402724,COGS 17,A01,092679,Staff,61,0,75,14
1649959408752,COGS 100,A01,083972,Staff,0,2,60,60
1649959420812,COGS 101C,A01,083976,Staff,17,0,30,13
1649959426834,COGS 102A,A01,083978,Johnson; Christine M.,14,0,30,16
1649959432872,COGS 107B,A01,083980,Staff,1,0,50,49
1649959438898,COGS 115,A01,083982,Staff,12,0,30,18
1649959444928,COGS 118B,A01,083367,Staff,0,11,40,40
1649959450972,COGS 172,A01,083984,Provenzano; Emily Kara,16,0,30,14
1649959456994,COGS 177,A00,083368,Staff,0,19,30,30
1649959463024,COGS 186,A01,083986,Staff,21,0,40,19
1649959469049,COGS 187A,A01,083988,Boyle; Mary E. T.,23,0,60,37
1649959475076,CSE 8A,A50,084003,Miranda; Gregory Joseph,0,4,15,15
1649959481100,CSE 11,A01,084005,Miranda; Gregory Joseph,12,0,55,43
1649959487121,CSE 20,A01,084007,Staff,8,0,20,12
1649959493150,CSE 21,A01,084009,Staff,3,0,50,47
1649959499182,CSE 30,A01,083370,Cao; Yingjun,0,31,40,40
1649959505215,CSE 100,A01,083372,Cao; Yingjun,0,32,40,40
1649959511242,CSE 101,A01,084011,Staff,0,52,40,40
1649959517282,CSE 141,A01,083374,Eldon; John,0,55,75,75
1649959523316,CSE 141L,A01,083376,Eldon; John,0,60,75,75
1649959529341,CSE 175,A01,084013,Kumar; Rakesh,22,0,25,3
1649959535367,CSE 190,A00,092508,Dubnov; Shlomo,15,0,15,0
1649959541402,ECE 5,A01,084049,Morris; Karcher William,15,0,20,5
1649959547449,ECE 100,A01,084051,Baghdadchi; Saharnaz,0,0,20,20
1649959547449,ECE 100,A02,091916,Baghdadchi; Saharnaz,16,0,20,4
1649959553478,ECE 101,A01,084053,Baghdadchi; Saharnaz,3,0,37,34
1649959553478,ECE 101,A02,084054,Baghdadchi; Saharnaz,32,0,37,5
1649959559512,ECE 107,A01,083390,Staff,28,0,40,12
1649959565555,ECE 148,A01,084056,Silberman; Jack,7,0,12,5
1649959571587,ECE 180,A00,083391,Abi Samra; Nicholas Camill,25,0,30,5
1649959571587,ECE 180,B00,083392,Abi Samra; Nicholas Camill,22,0,30,8
1649959577625,MATH 10B,A01,084110,Staff,8,0,30,22
1649959577625,MATH 10B,A02,084111,Staff,29,0,30,1
1649959577625,MATH 10B,A03,084112,Staff,26,0,30,4
1649959583648,MATH 10C,A01,083443,Staff,5,0,30,25
1649959583648,MATH 10C,A02,083444,Staff,14,0,30,16
1649959583648,MATH 10C,B01,084114,Staff,25,0,30,5
1649959583648,MATH 10C,B02,084115,Staff,28,0,30,2
1649959589690,MATH 18,A01,084117,Harel; Guershon,26,0,30,4
1649959589690,MATH 18,A02,084119,Harel; Guershon,28,0,30,2
1649959589690,MATH 18,A03,084120,Harel; Guershon,30,0,30,0
1649959589690,MATH 18,A04,084121,Harel; Guershon,29,0,30,1
1649959595724,MATH 20B,A01,084124,Um; Ko Woon,31,0,35,4
1649959595724,MATH 20B,B01,084126,Um; Ko Woon,32,0,35,3
1649959601747,MATH 20C,A01,083446,Hammock; Frances H,13,0,30,17
1649959601747,MATH 20C,A02,083447,Hammock; Frances H,28,0,30,2
1649959601747,MATH 20C,A03,083448,Hammock; Frances H,29,0,30,1
1649959601747,MATH 20C,A04,083449,Hammock; Frances H,30,0,30,0
1649959601747,MATH 20C,B01,083451,Hammock; Frances H,24,0,30,6
1649959601747,MATH 20C,B02,083452,Hammock; Frances H,27,0,30,3
1649959601747,MATH 20C,B03,083453,Hammock; Frances H,26,0,30,4
1649959601747,MATH 20C,B04,083454,Hammock; Frances H,30,0,30,0
1649959607785,MATH 20D,A01,084128,Staff,24,0,30,6
1649959607785,MATH 20D,A02,084129,Staff,30,0,30,0
1649959607785,MATH 20D,A03,084130,Staff,29,0,30,1
1649959607785,MATH 20D,B01,084133,Staff,16,0,30,14
1649959607785,MATH 20D,B02,084134,Staff,26,0,30,4
1649959607785,MATH 20D,B03,084135,Staff,30,0,30,0
1649959613828,MATH 20E,A01,084138,Staff,21,0,30,9
1649959613828,MATH 20E,A02,084139,Staff,17,0,30,13
1649959613828,MATH 20E,A03,084140,Staff,20,0,30,10
1649959613828,MATH 20E,A04,084141,Staff,25,0,30,5
1649959619851,MATH 102,A01,084143,Harel; Guershon,16,0,30,14
1649959619851,MATH 102,A02,084144,Harel; Guershon,20,0,30,10
1649959625888,MATH 103B,A01,083456,Staff,0,10,30,30
1649959625888,MATH 103B,A02,083457,Staff,0,10,30,30
1649959631910,MATH 109,A01,084146,Salehi Golsefidy; Alireza,27,0,30,3
1649959631910,MATH 109,A02,084147,Salehi Golsefidy; Alireza,19,0,30,11
1649959637934,MATH 120A,A01,085445,Eggers; John Dietrich,19,0,35,16
1649959637934,MATH 120A,A02,085446,Eggers; John Dietrich,27,0,35,8
1649959643964,MATH 142B,A01,084149,Verstraete; Jacques Allan,0,12,30,30
1649959643964,MATH 142B,A02,084150,Verstraete; Jacques Allan,0,11,30,30
1649959649993,MATH 170A,A01,083459,Nie; Jiawang,0,3,30,30
1649959649993,MATH 170A,A02,083460,Nie; Jiawang,0,2,30,30
1649959649993,MATH 170A,A03,083461,Nie; Jiawang,0,3,30,30
1649959656017,MATH 193B,A01,083463,Staff,1,0,30,29
1649959656017,MATH 193B,A02,083464,Staff,10,0,30,20
1649959656017,MATH 193B,A03,083465,Staff,18,0,30,12
1649959662082,COGS 2,A01,083966,Boyle; Mary E. T.,17,0,30,13
1649959668123,COGS 9,A01,083968,Staff,37,0,60,23
1649959674155,COGS 14B,A01,083970,Staff,23,0,50,27
1649959680190,COGS 17,A01,092679,Staff,61,0,75,14
1649959686212,COGS 100,A01,083972,Staff,0,3,60,60
1649959698261,COGS 101C,A01,083976,Staff,17,0,30,13
1649959704291,COGS 102A,A01,083978,Johnson; Christine M.,14,0,30,16
1649959710324,COGS 107B,A01,083980,Staff,1,0,50,49
1649959716357,COGS 115,A01,083982,Staff,12,0,30,18
1649959722379,COGS 118B,A01,083367,Staff,0,11,40,40
1649959728404,COGS 172,A01,083984,Provenzano; Emily Kara,16,0,30,14
1649959734428,COGS 177,A00,083368,Staff,0,19,30,30
1649959740465,COGS 186,A01,083986,Staff,21,0,40,19
1649959746492,COGS 187A,A01,083988,Boyle; Mary E. T.,23,0,60,37
1649959752519,CSE 8A,A50,084003,Miranda; Gregory Joseph,0,4,15,15
1649959758557,CSE 11,A01,084005,Miranda; Gregory Joseph,12,0,55,43
1649959764592,CSE 20,A01,084007,Staff,8,0,20,12
1649959770616,CSE 21,A01,084009,Staff,3,0,50,47
1649959776642,CSE 30,A01,083370,Cao; Yingjun,0,31,40,40
1649959782667,CSE 100,A01,083372,Cao; Yingjun,0,33,40,40
1649959788691,CSE 101,A01,084011,Staff,0,52,40,40
1649959794714,CSE 141,A01,083374,Eldon; John,0,55,75,75
1649959800737,CSE 141L,A01,083376,Eldon; John,0,60,75,75
1649959806768,CSE 175,A01,084013,Kumar; Rakesh,22,0,25,3
1649959812797,CSE 190,A00,092508,Dubnov; Shlomo,15,0,15,0
1649959818833,ECE 5,A01,084049,Morris; Karcher William,15,0,20,5
1649959824859,ECE 100,A01,084051,Baghdadchi; Saharnaz,0,0,20,20
1649959824859,ECE 100,A02,091916,Baghdadchi; Saharnaz,16,0,20,4
1649959830892,ECE 101,A01,084053,Baghdadchi; Saharnaz,3,0,37,34
1649959830892,ECE 101,A02,084054,Baghdadchi; Saharnaz,32,0,37,5
1649959836937,ECE 107,A01,083390,Staff,28,0,40,12
1649959842964,ECE 148,A01,084056,Silberman; Jack,7,0,12,5
1649959849002,ECE 180,A00,083391,Abi Samra; Nicholas Camill,25,0,30,5
1649959849002,ECE 180,B00,083392,Abi Samra; Nicholas Camill,22,0,30,8
1649959855025,MATH 10B,A01,084110,Staff,8,0,30,22
1649959855025,MATH 10B,A02,084111,Staff,29,0,30,1
1649959855025,MATH 10B,A03,084112,Staff,26,0,30,4
1649959861055,MATH 10C,A01,083443,Staff,5,0,30,25
1649959861055,MATH 10C,A02,083444,Staff,14,0,30,16
1649959861055,MATH 10C,B01,084114,Staff,25,0,30,5
1649959861055,MATH 10C,B02,084115,Staff,28,0,30,2
1649959867087,MATH 18,A01,084117,Harel; Guershon,26,0,30,4
1649959867087,MATH 18,A02,084119,Harel; Guershon,28,0,30,2
1649959867087,MATH 18,A03,084120,Harel; Guershon,30,0,30,0
1649959867087,MATH 18,A04,084121,Harel; Guershon,29,0,30,1
1649959873117,MATH 20B,A01,084124,Um; Ko Woon,31,0,35,4
1649959873117,MATH 20B,B01,084126,Um; Ko Woon,32,0,35,3
1649959879155,MATH 20C,A01,083446,Hammock; Frances H,13,0,30,17
1649959879155,MATH 20C,A02,083447,Hammock; Frances H,28,0,30,2
1649959879155,MATH 20C,A03,083448,Hammock; Frances H,29,0,30,1
1649959879155,MATH 20C,A04,083449,Hammock; Frances H,30,0,30,0
1649959879155,MATH 20C,B01,083451,Hammock; Frances H,24,0,30,6
1649959879155,MATH 20C,B02,083452,Hammock; Frances H,27,0,30,3
1649959879155,MATH 20C,B03,083453,Hammock; Frances H,26,0,30,4
1649959879155,MATH 20C,B04,083454,Hammock; Frances H,30,0,30,0
1649959885195,MATH 20D,A01,084128,Staff,24,0,30,6
1649959885195,MATH 20D,A02,084129,Staff,30,0,30,0
1649959885195,MATH 20D,A03,084130,Staff,28,0,30,2
1649959885195,MATH 20D,B01,084133,Staff,16,0,30,14
1649959885195,MATH 20D,B02,084134,Staff,26,0,30,4
1649959885195,MATH 20D,B03,084135,Staff,30,0,30,0
1649959891224,MATH 20E,A01,084138,Staff,21,0,30,9
1649959891224,MATH 20E,A02,084139,Staff,17,0,30,13
1649959891224,MATH 20E,A03,084140,Staff,20,0,30,10
1649959891224,MATH 20E,A04,084141,Staff,25,0,30,5
1649959897266,MATH 102,A01,084143,Harel; Guershon,16,0,30,14
1649959897266,MATH 102,A02,084144,Harel; Guershon,20,0,30,10
1649959903301,MATH 103B,A01,083456,Staff,0,10,30,30
1649959903301,MATH 103B,A02,083457,Staff,0,10,30,30
1649959909333,MATH 109,A01,084146,Salehi Golsefidy; Alireza,27,0,30,3
1649959909333,MATH 109,A02,084147,Salehi Golsefidy; Alireza,19,0,30,11
1649959915356,MATH 120A,A01,085445,Eggers; John Dietrich,19,0,35,16
1649959915356,MATH 120A,A02,085446,Eggers; John Dietrich,27,0,35,8
1649959921379,MATH 142B,A01,084149,Verstraete; Jacques Allan,0,12,30,30
1649959921379,MATH 142B,A02,084150,Verstraete; Jacques Allan,0,11,30,30
1649959927405,MATH 170A,A01,083459,Nie; Jiawang,0,3,30,30
1649959927405,MATH 170A,A02,083460,Nie; Jiawang,0,2,30,30
1649959927405,MATH 170A,A03,083461,Nie; Jiawang,0,3,30,30
1649959933432,MATH 193B,A01,083463,Staff,1,0,30,29
1649959933432,MATH 193B,A02,083464,Staff,10,0,30,20
1649959933432,MATH 193B,A03,083465,Staff,18,0,30,12
1649959939500,COGS 2,A01,083966,Boyle; Mary E. T.,17,0,30,13
1649959945626,COGS 9,A01,083968,Staff,37,0,60,23
1649959951668,COGS 14B,A01,083970,Staff,23,0,50,27
1649959957690,COGS 17,A01,092679,Staff,61,0,75,14
1649959963714,COGS 100,A01,083972,Staff,0,4,60,60
1649959975773,COGS 101C,A01,083976,Staff,17,0,30,13
1649959981797,COGS 102A,A01,083978,Johnson; Christine M.,14,0,30,16
1649959987822,COGS 107B,A01,083980,Staff,0,0,50,50
1649959993851,COGS 115,A01,083982,Staff,12,0,30,18
1649959999896,COGS 118B,A01,083367,Staff,0,11,40,40
1649960005931,COGS 172,A01,083984,Provenzano; Emily Kara,16,0,30,14
1649960011955,COGS 177,A00,083368,Staff,0,19,30,30
1649960017979,COGS 186,A01,083986,Staff,21,0,40,19
1649960024003,COGS 187A,A01,083988,Boyle; Mary E. T.,23,0,60,37
1649960030039,CSE 8A,A50,084003,Miranda; Gregory Joseph,0,4,15,15
1649960036066,CSE 11,A01,084005,Miranda; Gregory Joseph,12,0,55,43
1649960042105,CSE 20,A01,084007,Staff,8,0,20,12
1649960048132,CSE 21,A01,084009,Staff,2,0,50,48
1649960054155,CSE 30,A01,083370,Cao; Yingjun,0,32,40,40
1649960060182,CSE 100,A01,083372,Cao; Yingjun,0,34,40,40
1649960066205,CSE 101,A01,084011,Staff,0,52,40,40
1649960072229,CSE 141,A01,083374,Eldon; John,0,55,75,75
1649960078254,CSE 141L,A01,083376,Eldon; John,0,60,75,75
1649960084284,CSE 175,A01,084013,Kumar; Rakesh,22,0,25,3
1649960090310,CSE 190,A00,092508,Dubnov; Shlomo,15,0,15,0
1649960096336,ECE 5,A01,084049,Morris; Karcher William,15,0,20,5
1649960102360,ECE 100,A01,084051,Baghdadchi; Saharnaz,0,0,20,20
1649960102360,ECE 100,A02,091916,Baghdadchi; Saharnaz,16,0,20,4
1649960108391,ECE 101,A01,084053,Baghdadchi; Saharnaz,3,0,37,34
1649960108391,ECE 101,A02,084054,Baghdadchi; Saharnaz,32,0,37,5
1649960114430,ECE 107,A01,083390,Staff,28,0,40,12
1649960120473,ECE 148,A01,084056,Silberman; Jack,7,0,12,5
1649960126516,ECE 180,A00,083391,Abi Samra; Nicholas Camill,25,0,30,5
1649960126516,ECE 180,B00,083392,Abi Samra; Nicholas Camill,22,0,30,8
1649960132540,MATH 10B,A01,084110,Staff,8,0,30,22
1649960132540,MATH 10B,A02,084111,Staff,29,0,30,1
1649960132540,MATH 10B,A03,084112,Staff,26,0,30,4
1649960138588,MATH 10C,A01,083443,Staff,5,0,30,25
1649960138588,MATH 10C,A02,083444,Staff,14,0,30,16
1649960138588,MATH 10C,B01,084114,Staff,25,0,30,5
1649960138588,MATH 10C,B02,084115,Staff,28,0,30,2
1649960144624,MATH 18,A01,084117,Harel; Guershon,26,0,30,4
1649960144624,MATH 18,A02,084119,Harel; Guershon,28,0,30,2
1649960144624,MATH 18,A03,084120,Harel; Guershon,30,0,30,0
1649960144624,MATH 18,A04,084121,Harel; Guershon,29,0,30,1
1649960150652,MATH 20B,A01,084124,Um; Ko Woon,31,0,35,4
1649960150652,MATH 20B,B01,084126,Um; Ko Woon,32,0,35,3
1649960156681,MATH 20C,A01,083446,Hammock; Frances H,13,0,30,17
1649960156681,MATH 20C,A02,083447,Hammock; Frances H,28,0,30,2
1649960156681,MATH 20C,A03,083448,Hammock; Frances H,29,0,30,1
1649960156681,MATH 20C,A04,083449,Hammock; Frances H,30,0,30,0
1649960156681,MATH 20C,B01,083451,Hammock; Frances H,24,0,30,6
1649960156681,MATH 20C,B02,083452,Hammock; Frances H,27,0,30,3
1649960156681,MATH 20C,B03,083453,Hammock; Frances H,26,0,30,4
1649960156681,MATH 20C,B04,083454,Hammock; Frances H,30,0,30,0
1649960162710,MATH 20D,A01,084128,Staff,24,0,30,6
1649960162710,MATH 20D,A02,084129,Staff,30,0,30,0
1649960162710,MATH 20D,A03,084130,Staff,28,0,30,2
1649960162710,MATH 20D,B01,084133,Staff,16,0,30,14
1649960162710,MATH 20D,B02,084134,Staff,26,0,30,4
1649960162710,MATH 20D,B03,084135,Staff,30,0,30,0
1649960168737,MATH 20E,A01,084138,Staff,21,0,30,9
1649960168737,MATH 20E,A02,084139,Staff,17,0,30,13
1649960168737,MATH 20E,A03,084140,Staff,20,0,30,10
1649960168737,MATH 20E,A04,084141,Staff,25,0,30,5
1649960174769,MATH 102,A01,084143,Harel; Guershon,16,0,30,14
1649960174769,MATH 102,A02,084144,Harel; Guershon,20,0,30,10
1649960180792,MATH 103B,A01,083456,Staff,0,10,30,30
1649960180792,MATH 103B,A02,083457,Staff,0,10,30,30
1649960186815,MATH 109,A01,084146,Salehi Golsefidy; Alireza,27,0,30,3
1649960186815,MATH 109,A02,084147,Salehi Golsefidy; Alireza,19,0,30,11
1649960192839,MATH 120A,A01,085445,Eggers; John Dietrich,19,0,35,16
1649960192839,MATH 120A,A02,085446,Eggers; John Dietrich,27,0,35,8
1649960198873,MATH 142B,A01,084149,Verstraete; Jacques Allan,0,12,30,30
1649960198873,MATH 142B,A02,084150,Verstraete; Jacques Allan,0,11,30,30
1649960204895,MATH 170A,A01,083459,Nie; Jiawang,0,3,30,30
1649960204895,MATH 170A,A02,083460,Nie; Jiawang,0,2,30,30
1649960204895,MATH 170A,A03,083461,Nie; Jiawang,0,3,30,30
1649960210921,MATH 193B,A01,083463,Staff,1,0,30,29
1649960210921,MATH 193B,A02,083464,Staff,10,0,30,20
1649960210921,MATH 193B,A03,083465,Staff,18,0,30,12
1649960216984,COGS 2,A01,083966,Boyle; Mary E. T.,17,0,30,13
1649960223008,COGS 9,A01,083968,Staff,37,0,60,23
1649960229054,COGS 14B,A01,083970,Staff,23,0,50,27
1649960235085,COGS 17,A01,092679,Staff,62,0,75,13
1649960241111,COGS 100,A01,083972,Staff,0,4,60,60
1649960253157,COGS 101C,A01,083976,Staff,17,0,30,13
1649960259179,COGS 102A,A01,083978,Johnson; Christine M.,14,0,30,16
1649960265221,COGS 107B,A01,083980,Staff,0,0,50,50
1649960271248,COGS 115,A01,083982,Staff,12,0,30,18
1649960277270,COGS 118B,A01,083367,Staff,0,11,40,40
1649960283306,COGS 172,A01,083984,Provenzano; Emily Kara,16,0,30,14
1649960289357,COGS 177,A00,083368,Staff,0,19,30,30
1649960295393,COGS 186,A01,083986,Staff,21,0,40,19
1649960301419,COGS 187A,A01,083988,Boyle; Mary E. T.,23,0,60,37
1649960307446,CSE 8A,A50,084003,Miranda; Gregory Joseph,0,4,15,15
1649960313475,CSE 11,A01,084005,Miranda; Gregory Joseph,12,0,55,43
1649960319503,CSE 20,A01,084007,Staff,8,0,20,12
1649960325526,CSE 21,A01,084009,Staff,1,0,50,49
1649960331552,CSE 30,A01,083370,Cao; Yingjun,0,32,40,40
1649960337592,CSE 100,A01,083372,Cao; Yingjun,0,35,40,40
1649960343619,CSE 101,A01,084011,Staff,0,52,40,40
1649960349641,CSE 141,A01,083374,Eldon; John,0,55,75,75
1649960355664,CSE 141L,A01,083376,Eldon; John,0,60,75,75
1649960361686,CSE 175,A01,084013,Kumar; Rakesh,22,0,25,3
1649960367711,CSE 190,A00,092508,Dubnov; Shlomo,15,0,15,0
1649960373735,ECE 5,A01,084049,Morris; Karcher William,15,0,20,5
1649960379759,ECE 100,A01,084051,Baghdadchi; Saharnaz,0,0,20,20
1649960379759,ECE 100,A02,091916,Baghdadchi; Saharnaz,16,0,20,4
1649960385782,ECE 101,A01,084053,Baghdadchi; Saharnaz,3,0,37,34
1649960385782,ECE 101,A02,084054,Baghdadchi; Saharnaz,32,0,37,5
1649960391817,ECE 107,A01,083390,Staff,28,0,40,12
1649960397841,ECE 148,A01,084056,Silberman; Jack,7,0,12,5
1649960403866,ECE 180,A00,083391,Abi Samra; Nicholas Camill,25,0,30,5
1649960403866,ECE 180,B00,083392,Abi Samra; Nicholas Camill,22,0,30,8
1649960409888,MATH 10B,A01,084110,Staff,8,0,30,22
1649960409888,MATH 10B,A02,084111,Staff,29,0,30,1
1649960409888,MATH 10B,A03,084112,Staff,26,0,30,4
1649960415916,MATH 10C,A01,083443,Staff,5,0,30,25
1649960415916,MATH 10C,A02,083444,Staff,14,0,30,16
1649960415916,MATH 10C,B01,084114,Staff,25,0,30,5
1649960415916,MATH 10C,B02,084115,Staff,28,0,30,2
1649960421944,MATH 18,A01,084117,Harel; Guershon,26,0,30,4
1649960421944,MATH 18,A02,084119,Harel; Guershon,28,0,30,2
1649960421944,MATH 18,A03,084120,Harel; Guershon,30,0,30,0
1649960421944,MATH 18,A04,084121,Harel; Guershon,29,0,30,1
1649960427969,MATH 20B,A01,084124,Um; Ko Woon,31,0,35,4
1649960427969,MATH 20B,B01,084126,Um; Ko Woon,32,0,35,3
1649960434003,MATH 20C,A01,083446,Hammock; Frances H,13,0,30,17
1649960434003,MATH 20C,A02,083447,Hammock; Frances H,28,0,30,2
1649960434003,MATH 20C,A03,083448,Hammock; Frances H,29,0,30,1
1649960434003,MATH 20C,A04,083449,Hammock; Frances H,30,0,30,0
1649960434003,MATH 20C,B01,083451,Hammock; Frances H,24,0,30,6
1649960434003,MATH 20C,B02,083452,Hammock; Frances H,27,0,30,3
1649960434003,MATH 20C,B03,083453,Hammock; Frances H,26,0,30,4
1649960434003,MATH 20C,B04,083454,Hammock; Frances H,30,0,30,0
1649960440033,MATH 20D,A01,084128,Staff,24,0,30,6
1649960440033,MATH 20D,A02,084129,Staff,30,0,30,0
1649960440033,MATH 20D,A03,084130,Staff,28,0,30,2
1649960440033,MATH 20D,B01,084133,Staff,16,0,30,14
1649960440033,MATH 20D,B02,084134,Staff,26,0,30,4
1649960440033,MATH 20D,B03,084135,Staff,30,0,30,0
1649960446061,MATH 20E,A01,084138,Staff,21,0,30,9
1649960446061,MATH 20E,A02,084139,Staff,17,0,30,13
1649960446061,MATH 20E,A03,084140,Staff,20,0,30,10
1649960446061,MATH 20E,A04,084141,Staff,25,0,30,5
1649960452088,MATH 102,A01,084143,Harel; Guershon,16,0,30,14
1649960452088,MATH 102,A02,084144,Harel; Guershon,20,0,30,10
1649960458131,MATH 103B,A01,083456,Staff,0,10,30,30
1649960458131,MATH 103B,A02,083457,Staff,0,10,30,30
1649960464156,MATH 109,A01,084146,Salehi Golsefidy; Alireza,27,0,30,3
1649960464156,MATH 109,A02,084147,Salehi Golsefidy; Alireza,19,0,30,11
1649960470193,MATH 120A,A01,085445,Eggers; John Dietrich,19,0,35,16
1649960470193,MATH 120A,A02,085446,Eggers; John Dietrich,27,0,35,8
1649960476220,MATH 142B,A01,084149,Verstraete; Jacques Allan,0,12,30,30
1649960476220,MATH 142B,A02,084150,Verstraete; Jacques Allan,0,11,30,30
1649960482246,MATH 170A,A01,083459,Nie; Jiawang,0,3,30,30
1649960482246,MATH 170A,A02,083460,Nie; Jiawang,0,2,30,30
1649960482246,MATH 170A,A03,083461,Nie; Jiawang,0,3,30,30
1649960488287,MATH 193B,A01,083463,Staff,1,0,30,29
1649960488287,MATH 193B,A02,083464,Staff,10,0,30,20
1649960488287,MATH 193B,A03,083465,Staff,18,0,30,12
1649960494361,COGS 2,A01,083966,Boyle; Mary E. T.,17,0,30,13
1649960500414,COGS 9,A01,083968,Staff,36,0,60,24
1649960506437,COGS 14B,A01,083970,Staff,23,0,50,27
1649960512469,COGS 17,A01,092679,Staff,62,0,75,13
1649960518492,COGS 100,A01,083972,Staff,0,3,60,60
1649960530550,COGS 101C,A01,083976,Staff,17,0,30,13
1649960536578,COGS 102A,A01,083978,Johnson; Christine M.,14,0,30,16
1649960542812,COGS 107B,A01,083980,Staff,0,0,50,50
1649960548839,COGS 115,A01,083982,Staff,12,0,30,18
1649960554875,COGS 118B,A01,083367,Staff,0,11,40,40
1649960560901,COGS 172,A01,083984,Provenzano; Emily Kara,16,0,30,14
1649960566924,COGS 177,A00,083368,Staff,0,19,30,30
1649960572950,COGS 186,A01,083986,Staff,21,0,40,19
1649960579001,COGS 187A,A01,083988,Boyle; Mary E. T.,23,0,60,37
1649960585029,CSE 8A,A50,084003,Miranda; Gregory Joseph,0,4,15,15
1649960591057,CSE 11,A01,084005,Miranda; Gregory Joseph,12,0,55,43
1649960597080,CSE 20,A01,084007,Staff,8,0,20,12
1649960603110,CSE 21,A01,084009,Staff,0,0,50,50
1649960609138,CSE 30,A01,083370,Cao; Yingjun,0,33,40,40
1649960615166,CSE 100,A01,083372,Cao; Yingjun,0,35,40,40
1649960621199,CSE 101,A01,084011,Staff,0,52,40,40
1649960627235,CSE 141,A01,083374,Eldon; John,0,55,75,75
1649960633263,CSE 141L,A01,083376,Eldon; John,0,60,75,75
1649960639292,CSE 175,A01,084013,Kumar; Rakesh,22,0,25,3
1649960645325,CSE 190,A00,092508,Dubnov; Shlomo,15,0,15,0
1649960651351,ECE 5,A01,084049,Morris; Karcher William,15,0,20,5
1649960657392,ECE 100,A01,084051,Baghdadchi; Saharnaz,0,0,20,20
1649960657392,ECE 100,A02,091916,Baghdadchi; Saharnaz,16,0,20,4
1649960663418,ECE 101,A01,084053,Baghdadchi; Saharnaz,3,0,37,34
1649960663418,ECE 101,A02,084054,Baghdadchi; Saharnaz,32,0,37,5
1649960669454,ECE 107,A01,083390,Staff,28,0,40,12
1649960675478,ECE 148,A01,084056,Silberman; Jack,7,0,12,5
1649960681501,ECE 180,A00,083391,Abi Samra; Nicholas Camill,25,0,30,5
1649960681501,ECE 180,B00,083392,Abi Samra; Nicholas Camill,22,0,30,8
1649960687541,MATH 10B,A01,084110,Staff,8,0,30,22
1649960687541,MATH 10B,A02,084111,Staff,29,0,30,1
1649960687541,MATH 10B,A03,084112,Staff,26,0,30,4
1649960693566,MATH 10C,A01,083443,Staff,5,0,30,25
1649960693566,MATH 10C,A02,083444,Staff,13,0,30,17
1649960693566,MATH 10C,B01,084114,Staff,25,0,30,5
1649960693566,MATH 10C,B02,084115,Staff,28,0,30,2
1649960699589,MATH 18,A01,084117,Harel; Guershon,26,0,30,4
1649960699589,MATH 18,A02,084119,Harel; Guershon,28,0,30,2
1649960699589,MATH 18,A03,084120,Harel; Guershon,30,0,30,0
1649960699589,MATH 18,A04,084121,Harel; Guershon,29,0,30,1
1649960705625,MATH 20B,A01,084124,Um; Ko Woon,31,0,35,4
1649960705625,MATH 20B,B01,084126,Um; Ko Woon,32,0,35,3
1649960711653,MATH 20C,A01,083446,Hammock; Frances H,13,0,30,17
1649960711653,MATH 20C,A02,083447,Hammock; Frances H,28,0,30,2
1649960711653,MATH 20C,A03,083448,Hammock; Frances H,29,0,30,1
1649960711653,MATH 20C,A04,083449,Hammock; Frances H,30,0,30,0
1649960711653,MATH 20C,B01,083451,Hammock; Frances H,24,0,30,6
1649960711653,MATH 20C,B02,083452,Hammock; Frances H,27,0,30,3
1649960711653,MATH 20C,B03,083453,Hammock; Frances H,26,0,30,4
1649960711653,MATH 20C,B04,083454,Hammock; Frances H,30,0,30,0
1649960717677,MATH 20D,A01,084128,Staff,24,0,30,6
1649960717677,MATH 20D,A02,084129,Staff,30,0,30,0
1649960717677,MATH 20D,A03,084130,Staff,28,0,30,2
1649960717677,MATH 20D,B01,084133,Staff,16,0,30,14
1649960717677,MATH 20D,B02,084134,Staff,25,0,30,5
1649960717677,MATH 20D,B03,084135,Staff,30,0,30,0
1649960723704,MATH 20E,A01,084138,Staff,21,0,30,9
1649960723704,MATH 20E,A02,084139,Staff,17,0,30,13
1649960723704,MATH 20E,A03,084140,Staff,20,0,30,10
1649960723704,MATH 20E,A04,084141,Staff,25,0,30,5
1649960729728,MATH 102,A01,084143,Harel; Guershon,16,0,30,14
1649960729728,MATH 102,A02,084144,Harel; Guershon,20,0,30,10
1649960735752,MATH 103B,A01,083456,Staff,0,10,30,30
1649960735752,MATH 103B,A02,083457,Staff,0,10,30,30
1649960741779,MATH 109,A01,084146,Salehi Golsefidy; Alireza,27,0,30,3
1649960741779,MATH 109,A02,084147,Salehi Golsefidy; Alireza,19,0,30,11
1649960747826,MATH 120A,A01,085445,Eggers; John Dietrich,19,0,35,16
1649960747826,MATH 120A,A02,085446,Eggers; John Dietrich,27,0,35,8
1649960753861,MATH 142B,A01,084149,Verstraete; Jacques Allan,0,12,30,30
1649960753861,MATH 142B,A02,084150,Verstraete; Jacques Allan,0,12,30,30
1649960759894,MATH 170A,A01,083459,Nie; Jiawang,0,3,30,30
1649960759894,MATH 170A,A02,083460,Nie; Jiawang,0,2,30,30
1649960759894,MATH 170A,A03,083461,Nie; Jiawang,0,3,30,30
1649960765938,MATH 193B,A01,083463,Staff,1,0,30,29
1649960765938,MATH 193B,A02,083464,Staff,10,0,30,20
1649960765938,MATH 193B,A03,083465,Staff,18,0,30,12
1649960771998,COGS 2,A01,083966,Boyle; Mary E. T.,17,0,30,13
1649960778021,COGS 9,A01,083968,Staff,36,0,60,24
1649960784043,COGS 14B,A01,083970,Staff,23,0,50,27
1649960790081,COGS 17,A01,092679,Staff,62,0,75,13
1649960796104,COGS 100,A01,083972,Staff,0,3,60,60
1649960808163,COGS 101C,A01,083976,Staff,17,0,30,13
1649960814187,COGS 102A,A01,083978,Johnson; Christine M.,14,0,30,16
1649960820237,COGS 107B,A01,083980,Staff,0,0,50,50
1649960826265,COGS 115,A01,083982,Staff,12,0,30,18
1649960832288,COGS 118B,A01,083367,Staff,0,11,40,40
1649960838326,COGS 172,A01,083984,Provenzano; Emily Kara,16,0,30,14
1649960844368,COGS 177,A00,083368,Staff,0,19,30,30
1649960850400,COGS 186,A01,083986,Staff,21,0,40,19
1649960856426,COGS 187A,A01,083988,Boyle; Mary E. T.,23,0,60,37
1649960862463,CSE 8A,A50,084003,Miranda; Gregory Joseph,0,4,15,15
1649960868500,CSE 11,A01,084005,Miranda; Gregory Joseph,10,0,55,45
1649960874538,CSE 20,A01,084007,Staff,8,0,20,12
1649960880562,CSE 21,A01,084009,Staff,0,0,50,50
1649960886603,CSE 30,A01,083370,Cao; Yingjun,0,34,40,40
1649960892634,CSE 100,A01,083372,Cao; Yingjun,0,37,40,40
1649960898661,CSE 101,A01,084011,Staff,0,53,40,40
1649960904697,CSE 141,A01,083374,Eldon; John,0,55,75,75
1649960910725,CSE 141L,A01,083376,Eldon; John,0,60,75,75
1649960916749,CSE 175,A01,084013,Kumar; Rakesh,22,0,25,3
1649960922786,CSE 190,A00,092508,Dubnov; Shlomo,15,0,15,0
1649960928816,ECE 5,A01,084049,Morris; Karcher William,15,0,20,5
1649960934848,ECE 100,A01,084051,Baghdadchi; Saharnaz,0,0,20,20
1649960934848,ECE 100,A02,091916,Baghdadchi; Saharnaz,15,0,20,5
1649960940875,ECE 101,A01,084053,Baghdadchi; Saharnaz,3,0,37,34
1649960940875,ECE 101,A02,084054,Baghdadchi; Saharnaz,32,0,37,5
1649960946900,ECE 107,A01,083390,Staff,28,0,40,12
1649960952937,ECE 148,A01,084056,Silberman; Jack,7,0,12,5
1649960958963,ECE 180,A00,083391,Abi Samra; Nicholas Camill,25,0,30,5
1649960958963,ECE 180,B00,083392,Abi Samra; Nicholas Camill,22,0,30,8
1649960964997,MATH 10B,A01,084110,Staff,8,0,30,22
1649960964997,MATH 10B,A02,084111,Staff,29,0,30,1
1649960964997,MATH 10B,A03,084112,Staff,26,0,30,4
1649960971027,MATH 10C,A01,083443,Staff,5,0,30,25
1649960971027,MATH 10C,A02,083444,Staff,13,0,30,17
1649960971027,MATH 10C,B01,084114,Staff,25,0,30,5
1649960971027,MATH 10C,B02,084115,Staff,28,0,30,2
1649960977059,MATH 18,A01,084117,Harel; Guershon,26,0,30,4
1649960977059,MATH 18,A02,084119,Harel; Guershon,28,0,30,2
1649960977059,MATH 18,A03,084120,Harel; Guershon,30,0,30,0
1649960977059,MATH 18,A04,084121,Harel; Guershon,29,0,30,1
1649960983097,MATH 20B,A01,084124,Um; Ko Woon,31,0,35,4
1649960983097,MATH 20B,B01,084126,Um; Ko Woon,32,0,35,3
1649960989126,MATH 20C,A01,083446,Hammock; Frances H,13,0,30,17
1649960989126,MATH 20C,A02,083447,Hammock; Frances H,28,0,30,2
1649960989126,MATH 20C,A03,083448,Hammock; Frances H,29,0,30,1
1649960989126,MATH 20C,A04,083449,Hammock; Frances H,30,0,30,0
1649960989126,MATH 20C,B01,083451,Hammock; Frances H,24,0,30,6
1649960989126,MATH 20C,B02,083452,Hammock; Frances H,27,0,30,3
1649960989126,MATH 20C,B03,083453,Hammock; Frances H,26,0,30,4
1649960989126,MATH 20C,B04,083454,Hammock; Frances H,30,0,30,0
1649960995152,MATH 20D,A01,084128,Staff,24,0,30,6
1649960995152,MATH 20D,A02,084129,Staff,30,0,30,0
1649960995152,MATH 20D,A03,084130,Staff,28,0,30,2
1649960995152,MATH 20D,B01,084133,Staff,16,0,30,14
1649960995152,MATH 20D,B02,084134,Staff,25,0,30,5
1649960995152,MATH 20D,B03,084135,Staff,30,0,30,0
1649961001184,MATH 20E,A01,084138,Staff,21,0,30,9
1649961001184,MATH 20E,A02,084139,Staff,17,0,30,13
1649961001184,MATH 20E,A03,084140,Staff,20,0,30,10
1649961001184,MATH 20E,A04,084141,Staff,25,0,30,5
1649961007219,MATH 102,A01,084143,Harel; Guershon,16,0,30,14
1649961007219,MATH 102,A02,084144,Harel; Guershon,20,0,30,10
1649961013252,MATH 103B,A01,083456,Staff,0,12,30,30
1649961013252,MATH 103B,A02,083457,Staff,0,10,30,30
1649961019286,MATH 109,A01,084146,Salehi Golsefidy; Alireza,27,0,30,3
1649961019286,MATH 109,A02,084147,Salehi Golsefidy; Alireza,19,0,30,11
1649961025325,MATH 120A,A01,085445,Eggers; John Dietrich,19,0,35,16
1649961025325,MATH 120A,A02,085446,Eggers; John Dietrich,27,0,35,8
1649961031351,MATH 142B,A01,084149,Verstraete; Jacques Allan,0,12,30,30
1649961031351,MATH 142B,A02,084150,Verstraete; Jacques Allan,0,12,30,30
1649961037381,MATH 170A,A01,083459,Nie; Jiawang,0,3,30,30
1649961037381,MATH 170A,A02,083460,Nie; Jiawang,0,3,30,30
1649961037381,MATH 170A,A03,083461,Nie; Jiawang,0,3,30,30
1649961043408,MATH 193B,A01,083463,Staff,1,0,30,29
1649961043408,MATH 193B,A02,083464,Staff,10,0,30,20
1649961043408,MATH 193B,A03,083465,Staff,18,0,30,12
1649961049469,COGS 2,A01,083966,Boyle; Mary E. T.,17,0,30,13
1649961055492,COGS 9,A01,083968,Staff,36,0,60,24
1649961061525,COGS 14B,A01,083970,Staff,22,0,50,28
1649961067554,COGS 17,A01,092679,Staff,62,0,75,13
1649961073588,COGS 100,A01,083972,Staff,0,3,60,60
1649961085644,COGS 101C,A01,083976,Staff,17,0,30,13
1649961091666,COGS 102A,A01,083978,Johnson; Christine M.,14,0,30,16
1649961097698,COGS 107B,A01,083980,Staff,0,0,50,50
1649961103721,COGS 115,A01,083982,Staff,12,0,30,18
1649961109744,COGS 118B,A01,083367,Staff,0,11,40,40
1649961115776,COGS 172,A01,083984,Provenzano; Emily Kara,16,0,30,14
1649961121803,COGS 177,A00,083368,Staff,0,19,30,30
1649961127827,COGS 186,A01,083986,Staff,21,0,40,19
1649961133851,COGS 187A,A01,083988,Boyle; Mary E. T.,23,0,60,37
1649961139990,CSE 8A,A50,084003,Miranda; Gregory Joseph,0,4,15,15
1649961146013,CSE 11,A01,084005,Miranda; Gregory Joseph,10,0,55,45
1649961152043,CSE 20,A01,084007,Staff,8,0,20,12
1649961158071,CSE 21,A01,084009,Staff,0,0,50,50
1649961164104,CSE 30,A01,083370,Cao; Yingjun,0,35,40,40
1649961170135,CSE 100,A01,083372,Cao; Yingjun,0,39,40,40
1649961176164,CSE 101,A01,084011,Staff,0,54,40,40
1649961182190,CSE 141,A01,083374,Eldon; John,0,55,75,75
1649961188227,CSE 141L,A01,083376,Eldon; John,0,60,75,75
1649961194258,CSE 175,A01,084013,Kumar; Rakesh,22,0,25,3
1649961200282,CSE 190,A00,092508,Dubnov; Shlomo,15,0,15,0
1649961206309,ECE 5,A01,084049,Morris; Karcher William,15,0,20,5
1649961212332,ECE 100,A01,084051,Baghdadchi; Saharnaz,0,0,20,20
1649961212332,ECE 100,A02,091916,Baghdadchi; Saharnaz,15,0,20,5
1649961218370,ECE 101,A01,084053,Baghdadchi; Saharnaz,3,0,37,34
1649961218370,ECE 101,A02,084054,Baghdadchi; Saharnaz,31,0,37,6
1649961224397,ECE 107,A01,083390,Staff,28,0,40,12
1649961230436,ECE 148,A01,084056,Silberman; Jack,7,0,12,5
1649961236462,ECE 180,A00,083391,Abi Samra; Nicholas Camill,25,0,30,5
1649961236462,ECE 180,B00,083392,Abi Samra; Nicholas Camill,22,0,30,8
1649961242488,MATH 10B,A01,084110,Staff,8,0,30,22
1649961242488,MATH 10B,A02,084111,Staff,29,0,30,1
1649961242488,MATH 10B,A03,084112,Staff,26,0,30,4
1649961248528,MATH 10C,A01,083443,Staff,4,0,30,26
1649961248528,MATH 10C,A02,083444,Staff,13,0,30,17
1649961248528,MATH 10C,B01,084114,Staff,25,0,30,5
1649961248528,MATH 10C,B02,084115,Staff,28,0,30,2
1649961254552,MATH 18,A01,084117,Harel; Guershon,26,0,30,4
1649961254552,MATH 18,A02,084119,Harel; Guershon,28,0,30,2
1649961254552,MATH 18,A03,084120,Harel; Guershon,30,0,30,0
1649961254552,MATH 18,A04,084121,Harel; Guershon,29,0,30,1
1649961260575,MATH 20B,A01,084124,Um; Ko Woon,31,0,35,4
1649961260575,MATH 20B,B01,084126,Um; Ko Woon,32,0,35,3
1649961266606,MATH 20C,A01,083446,Hammock; Frances H,13,0,30,17
1649961266606,MATH 20C,A02,083447,Hammock; Frances H,28,0,30,2
1649961266606,MATH 20C,A03,083448,Hammock; Frances H,29,0,30,1
1649961266606,MATH 20C,A04,083449,Hammock; Frances H,30,0,30,0
1649961266606,MATH 20C,B01,083451,Hammock; Frances H,24,0,30,6
1649961266606,MATH 20C,B02,083452,Hammock; Frances H,27,0,30,3
1649961266606,MATH 20C,B03,083453,Hammock; Frances H,26,0,30,4
1649961266606,MATH 20C,B04,083454,Hammock; Frances H,30,0,30,0
1649961272635,MATH 20D,A01,084128,Staff,24,0,30,6
1649961272635,MATH 20D,A02,084129,Staff,30,0,30,0
1649961272635,MATH 20D,A03,084130,Staff,28,0,30,2
1649961272635,MATH 20D,B01,084133,Staff,16,0,30,14
1649961272635,MATH 20D,B02,084134,Staff,25,0,30,5
1649961272635,MATH 20D,B03,084135,Staff,30,0,30,0
1649961278665,MATH 20E,A01,084138,Staff,21,0,30,9
1649961278665,MATH 20E,A02,084139,Staff,17,0,30,13
1649961278665,MATH 20E,A03,084140,Staff,20,0,30,10
1649961278665,MATH 20E,A04,084141,Staff,25,0,30,5
1649961284689,MATH 102,A01,084143,Harel; Guershon,16,0,30,14
1649961284689,MATH 102,A02,084144,Harel; Guershon,20,0,30,10
1649961290719,MATH 103B,A01,083456,Staff,0,12,30,30
1649961290719,MATH 103B,A02,083457,Staff,0,10,30,30
1649961296753,MATH 109,A01,084146,Salehi Golsefidy; Alireza,27,0,30,3
1649961296753,MATH 109,A02,084147,Salehi Golsefidy; Alireza,19,0,30,11
1649961302778,MATH 120A,A01,085445,Eggers; John Dietrich,19,0,35,16
1649961302778,MATH 120A,A02,085446,Eggers; John Dietrich,27,0,35,8
1649961308812,MATH 142B,A01,084149,Verstraete; Jacques Allan,0,12,30,30
1649961308812,MATH 142B,A02,084150,Verstraete; Jacques Allan,0,12,30,30
1649961314843,MATH 170A,A01,083459,Nie; Jiawang,0,3,30,30
1649961314843,MATH 170A,A02,083460,Nie; Jiawang,0,3,30,30
1649961314843,MATH 170A,A03,083461,Nie; Jiawang,0,3,30,30
1649961320886,MATH 193B,A01,083463,Staff,1,0,30,29
1649961320886,MATH 193B,A02,083464,Staff,10,0,30,20
1649961320886,MATH 193B,A03,083465,Staff,18,0,30,12
1649961326942,COGS 2,A01,083966,Boyle; Mary E. T.,17,0,30,13
1649961332970,COGS 9,A01,083968,Staff,36,0,60,24
1649961338996,COGS 14B,A01,083970,Staff,22,0,50,28
1649961345028,COGS 17,A01,092679,Staff,62,0,75,13
1649961351050,COGS 100,A01,083972,Staff,0,3,60,60
1649961363099,COGS 101C,A01,083976,Staff,17,0,30,13
1649961369122,COGS 102A,A01,083978,Johnson; Christine M.,14,0,30,16
1649961375147,COGS 107B,A01,083980,Staff,0,0,50,50
1649961381174,COGS 115,A01,083982,Staff,12,0,30,18
1649961387196,COGS 118B,A01,083367,Staff,0,11,40,40
1649961393220,COGS 172,A01,083984,Provenzano; Emily Kara,16,0,30,14
1649961399252,COGS 177,A00,083368,Staff,0,19,30,30
1649961405274,COGS 186,A01,083986,Staff,21,0,40,19
1649961411299,COGS 187A,A01,083988,Boyle; Mary E. T.,23,0,60,37
1649961417322,CSE 8A,A50,084003,Miranda; Gregory Joseph,0,4,15,15
1649961423354,CSE 11,A01,084005,Miranda; Gregory Joseph,10,0,55,45
1649961429377,CSE 20,A01,084007,Staff,8,0,20,12
1649961435416,CSE 21,A01,084009,Staff,0,1,50,50
1649961441449,CSE 30,A01,083370,Cao; Yingjun,0,36,40,40
1649961447478,CSE 100,A01,083372,Cao; Yingjun,0,39,40,40
1649961453515,CSE 101,A01,084011,Staff,0,54,40,40
1649961459551,CSE 141,A01,083374,Eldon; John,0,55,75,75
1649961465585,CSE 141L,A01,083376,Eldon; John,0,60,75,75
1649961471612,CSE 175,A01,084013,Kumar; Rakesh,22,0,25,3
1649961477635,CSE 190,A00,092508,Dubnov; Shlomo,15,0,15,0
1649961483664,ECE 5,A01,084049,Morris; Karcher William,15,0,20,5
1649961489692,ECE 100,A01,084051,Baghdadchi; Saharnaz,0,0,20,20
1649961489692,ECE 100,A02,091916,Baghdadchi; Saharnaz,15,0,20,5
1649961495722,ECE 101,A01,084053,Baghdadchi; Saharnaz,3,0,37,34
1649961495722,ECE 101,A02,084054,Baghdadchi; Saharnaz,31,0,37,6
1649961501756,ECE 107,A01,083390,Staff,28,0,40,12
1649961507783,ECE 148,A01,084056,Silberman; Jack,7,0,12,5
1649961513814,ECE 180,A00,083391,Abi Samra; Nicholas Camill,25,0,30,5
1649961513814,ECE 180,B00,083392,Abi Samra; Nicholas Camill,22,0,30,8
1649961519841,MATH 10B,A01,084110,Staff,8,0,30,22
1649961519841,MATH 10B,A02,084111,Staff,29,0,30,1
1649961519841,MATH 10B,A03,084112,Staff,26,0,30,4
1649961525873,MATH 10C,A01,083443,Staff,4,0,30,26
1649961525873,MATH 10C,A02,083444,Staff,13,0,30,17
1649961525873,MATH 10C,B01,084114,Staff,25,0,30,5
1649961525873,MATH 10C,B02,084115,Staff,28,0,30,2
1649961531897,MATH 18,A01,084117,Harel; Guershon,26,0,30,4
1649961531897,MATH 18,A02,084119,Harel; Guershon,28,0,30,2
1649961531897,MATH 18,A03,084120,Harel; Guershon,30,0,30,0
1649961531897,MATH 18,A04,084121,Harel; Guershon,29,0,30,1
1649961537927,MATH 20B,A01,084124,Um; Ko Woon,31,0,35,4
1649961537927,MATH 20B,B01,084126,Um; Ko Woon,32,0,35,3
1649961543958,MATH 20C,A01,083446,Hammock; Frances H,13,0,30,17
1649961543958,MATH 20C,A02,083447,Hammock; Frances H,28,0,30,2
1649961543958,MATH 20C,A03,083448,Hammock; Frances H,29,0,30,1
1649961543958,MATH 20C,A04,083449,Hammock; Frances H,30,0,30,0
1649961543958,MATH 20C,B01,083451,Hammock; Frances H,24,0,30,6
1649961543958,MATH 20C,B02,083452,Hammock; Frances H,27,0,30,3
1649961543958,MATH 20C,B03,083453,Hammock; Frances H,26,0,30,4
1649961543958,MATH 20C,B04,083454,Hammock; Frances H,30,0,30,0
1649961549986,MATH 20D,A01,084128,Staff,24,0,30,6
1649961549986,MATH 20D,A02,084129,Staff,30,0,30,0
1649961549986,MATH 20D,A03,084130,Staff,28,0,30,2
1649961549986,MATH 20D,B01,084133,Staff,15,0,30,15
1649961549986,MATH 20D,B02,084134,Staff,25,0,30,5
1649961549986,MATH 20D,B03,084135,Staff,30,0,30,0
1649961556021,MATH 20E,A01,084138,Staff,21,0,30,9
1649961556021,MATH 20E,A02,084139,Staff,17,0,30,13
1649961556021,MATH 20E,A03,084140,Staff,20,0,30,10
1649961556021,MATH 20E,A04,084141,Staff,25,0,30,5
1649961562045,MATH 102,A01,084143,Harel; Guershon,16,0,30,14
1649961562045,MATH 102,A02,084144,Harel; Guershon,20,0,30,10
1649961568070,MATH 103B,A01,083456,Staff,0,12,30,30
1649961568070,MATH 103B,A02,083457,Staff,0,10,30,30
1649961574110,MATH 109,A01,084146,Salehi Golsefidy; Alireza,27,0,30,3
1649961574110,MATH 109,A02,084147,Salehi Golsefidy; Alireza,19,0,30,11
1649961580152,MATH 120A,A01,085445,Eggers; John Dietrich,19,0,35,16
1649961580152,MATH 120A,A02,085446,Eggers; John Dietrich,27,0,35,8
1649961586198,MATH 142B,A01,084149,Verstraete; Jacques Allan,0,12,30,30
1649961586198,MATH 142B,A02,084150,Verstraete; Jacques Allan,0,12,30,30
1649961592224,MATH 170A,A01,083459,Nie; Jiawang,0,3,30,30
1649961592224,MATH 170A,A02,083460,Nie; Jiawang,0,3,30,30
1649961592224,MATH 170A,A03,083461,Nie; Jiawang,0,3,30,30
1649961598274,MATH 193B,A01,083463,Staff,1,0,30,29
1649961598274,MATH 193B,A02,083464,Staff,10,0,30,20
1649961598274,MATH 193B,A03,083465,Staff,18,0,30,12
1649961604343,COGS 2,A01,083966,Boyle; Mary E. T.,17,0,30,13
1649961610371,COGS 9,A01,083968,Staff,35,0,60,25
1649961616393,COGS 14B,A01,083970,Staff,22,0,50,28
1649961622420,COGS 17,A01,092679,Staff,62,0,75,13
1649961628463,COGS 100,A01,083972,Staff,0,3,60,60
1649961640525,COGS 101C,A01,083976,Staff,17,0,30,13
1649961646553,COGS 102A,A01,083978,Johnson; Christine M.,14,0,30,16
1649961652580,COGS 107B,A01,083980,Staff,0,1,50,50
1649961658606,COGS 115,A01,083982,Staff,12,0,30,18
1649961664629,COGS 118B,A01,083367,Staff,0,11,40,40
1649961670660,COGS 172,A01,083984,Provenzano; Emily Kara,16,0,30,14
1649961676684,COGS 177,A00,083368,Staff,0,19,30,30
1649961682719,COGS 186,A01,083986,Staff,22,0,40,18
1649961688743,COGS 187A,A01,083988,Boyle; Mary E. T.,23,0,60,37
1649961694767,CSE 8A,A50,084003,Miranda; Gregory Joseph,0,4,15,15
1649961700793,CSE 11,A01,084005,Miranda; Gregory Joseph,10,0,55,45
1649961706819,CSE 20,A01,084007,Staff,7,0,20,13
1649961712854,CSE 21,A01,084009,Staff,0,3,50,50
1649961718879,CSE 30,A01,083370,Cao; Yingjun,0,36,40,40
1649961724903,CSE 100,A01,083372,Cao; Yingjun,0,39,40,40
1649961730929,CSE 101,A01,084011,Staff,0,54,40,40
1649961737800,CSE 141,A01,083374,Eldon; John,0,55,75,75
1649961743833,CSE 141L,A01,083376,Eldon; John,0,60,75,75
1649961749863,CSE 175,A01,084013,Kumar; Rakesh,22,0,25,3
1649961755887,CSE 190,A00,092508,Dubnov; Shlomo,15,0,15,0
1649961761909,ECE 5,A01,084049,Morris; Karcher William,15,0,20,5
1649961767953,ECE 100,A01,084051,Baghdadchi; Saharnaz,0,0,20,20
1649961767953,ECE 100,A02,091916,Baghdadchi; Saharnaz,15,0,20,5
1649961773975,ECE 101,A01,084053,Baghdadchi; Saharnaz,3,0,37,34
1649961773975,ECE 101,A02,084054,Baghdadchi; Saharnaz,31,0,37,6
1649961780003,ECE 107,A01,083390,Staff,28,0,40,12
1649961786026,ECE 148,A01,084056,Silberman; Jack,7,0,12,5
1649961792052,ECE 180,A00,083391,Abi Samra; Nicholas Camill,25,0,30,5
1649961792052,ECE 180,B00,083392,Abi Samra; Nicholas Camill,22,0,30,8
1649961798078,MATH 10B,A01,084110,Staff,8,0,30,22
1649961798078,MATH 10B,A02,084111,Staff,29,0,30,1
1649961798078,MATH 10B,A03,084112,Staff,26,0,30,4
1649961804105,MATH 10C,A01,083443,Staff,4,0,30,26
1649961804105,MATH 10C,A02,083444,Staff,13,0,30,17
1649961804105,MATH 10C,B01,084114,Staff,25,0,30,5
1649961804105,MATH 10C,B02,084115,Staff,28,0,30,2
1649961810127,MATH 18,A01,084117,Harel; Guershon,26,0,30,4
1649961810127,MATH 18,A02,084119,Harel; Guershon,28,0,30,2
1649961810127,MATH 18,A03,084120,Harel; Guershon,30,0,30,0
1649961810127,MATH 18,A04,084121,Harel; Guershon,29,0,30,1
1649961816168,MATH 20B,A01,084124,Um; Ko Woon,31,0,35,4
1649961816168,MATH 20B,B01,084126,Um; Ko Woon,32,0,35,3
1649961822208,MATH 20C,A01,083446,Hammock; Frances H,13,0,30,17
1649961822208,MATH 20C,A02,083447,Hammock; Frances H,28,0,30,2
1649961822208,MATH 20C,A03,083448,Hammock; Frances H,29,0,30,1
1649961822208,MATH 20C,A04,083449,Hammock; Frances H,30,0,30,0
1649961822208,MATH 20C,B01,083451,Hammock; Frances H,24,0,30,6
1649961822208,MATH 20C,B02,083452,Hammock; Frances H,27,0,30,3
1649961822208,MATH 20C,B03,083453,Hammock; Frances H,26,0,30,4
1649961822208,MATH 20C,B04,083454,Hammock; Frances H,30,0,30,0
1649961828237,MATH 20D,A01,084128,Staff,24,0,30,6
1649961828237,MATH 20D,A02,084129,Staff,30,0,30,0
1649961828237,MATH 20D,A03,084130,Staff,28,0,30,2
1649961828237,MATH 20D,B01,084133,Staff,15,0,30,15
1649961828237,MATH 20D,B02,084134,Staff,25,0,30,5
1649961828237,MATH 20D,B03,084135,Staff,30,0,30,0
1649961834264,MATH 20E,A01,084138,Staff,21,0,30,9
1649961834264,MATH 20E,A02,084139,Staff,17,0,30,13
1649961834264,MATH 20E,A03,084140,Staff,20,0,30,10
1649961834264,MATH 20E,A04,084141,Staff,25,0,30,5
1649961840300,MATH 102,A01,084143,Harel; Guershon,16,0,30,14
1649961840300,MATH 102,A02,084144,Harel; Guershon,20,0,30,10
1649961846324,MATH 103B,A01,083456,Staff,0,12,30,30
1649961846324,MATH 103B,A02,083457,Staff,0,10,30,30
1649961852345,MATH 109,A01,084146,Salehi Golsefidy; Alireza,27,0,30,3
1649961852345,MATH 109,A02,084147,Salehi Golsefidy; Alireza,19,0,30,11
1649961858369,MATH 120A,A01,085445,Eggers; John Dietrich,19,0,35,16
1649961858369,MATH 120A,A02,085446,Eggers; John Dietrich,27,0,35,8
1649961864391,MATH 142B,A01,084149,Verstraete; Jacques Allan,0,12,30,30
1649961864391,MATH 142B,A02,084150,Verstraete; Jacques Allan,0,12,30,30
1649961870414,MATH 170A,A01,083459,Nie; Jiawang,0,3,30,30
1649961870414,MATH 170A,A02,083460,Nie; Jiawang,0,3,30,30
1649961870414,MATH 170A,A03,083461,Nie; Jiawang,0,3,30,30
1649961876438,MATH 193B,A01,083463,Staff,1,0,30,29
1649961876438,MATH 193B,A02,083464,Staff,10,0,30,20
1649961876438,MATH 193B,A03,083465,Staff,18,0,30,12
1649961882506,COGS 2,A01,083966,Boyle; Mary E. T.,17,0,30,13
1649961888533,COGS 9,A01,083968,Staff,35,0,60,25
1649961894556,COGS 14B,A01,083970,Staff,22,0,50,28
1649961900585,COGS 17,A01,092679,Staff,62,0,75,13
1649961906613,COGS 100,A01,083972,Staff,0,3,60,60
1649961918685,COGS 101C,A01,083976,Staff,17,0,30,13
1649961924721,COGS 102A,A01,083978,Johnson; Christine M.,14,0,30,16
1649961930764,COGS 107B,A01,083980,Staff,0,1,50,50
1649961936800,COGS 115,A01,083982,Staff,12,0,30,18
1649961942830,COGS 118B,A01,083367,Staff,0,11,40,40
1649961948855,COGS 172,A01,083984,Provenzano; Emily Kara,16,0,30,14
1649961954889,COGS 177,A00,083368,Staff,0,19,30,30
1649961960916,COGS 186,A01,083986,Staff,21,0,40,19
1649961966941,COGS 187A,A01,083988,Boyle; Mary E. T.,23,0,60,37
1649961972968,CSE 8A,A50,084003,Miranda; Gregory Joseph,0,4,15,15
1649961978997,CSE 11,A01,084005,Miranda; Gregory Joseph,10,0,55,45
1649961985023,CSE 20,A01,084007,Staff,6,0,20,14
1649961991057,CSE 21,A01,084009,Staff,0,4,50,50
1649961997091,CSE 30,A01,083370,Cao; Yingjun,0,36,40,40
1649962003119,CSE 100,A01,083372,Cao; Yingjun,0,39,40,40
1649962009142,CSE 101,A01,084011,Staff,0,53,40,40
1649962015171,CSE 141,A01,083374,Eldon; John,0,55,75,75
1649962021194,CSE 141L,A01,083376,Eldon; John,0,60,75,75
1649962027217,CSE 175,A01,084013,Kumar; Rakesh,22,0,25,3
1649962033247,CSE 190,A00,092508,Dubnov; Shlomo,15,0,15,0
1649962039274,ECE 5,A01,084049,Morris; Karcher William,15,0,20,5
1649962045311,ECE 100,A01,084051,Baghdadchi; Saharnaz,0,0,20,20
1649962045311,ECE 100,A02,091916,Baghdadchi; Saharnaz,15,0,20,5
1649962051334,ECE 101,A01,084053,Baghdadchi; Saharnaz,3,0,37,34
1649962051334,ECE 101,A02,084054,Baghdadchi; Saharnaz,31,0,37,6
1649962057361,ECE 107,A01,083390,Staff,28,0,40,12
1649962063384,ECE 148,A01,084056,Silberman; Jack,7,0,12,5
1649962069408,ECE 180,A00,083391,Abi Samra; Nicholas Camill,25,0,30,5
1649962069408,ECE 180,B00,083392,Abi Samra; Nicholas Camill,22,0,30,8
1649962075443,MATH 10B,A01,084110,Staff,8,0,30,22
1649962075443,MATH 10B,A02,084111,Staff,29,0,30,1
1649962075443,MATH 10B,A03,084112,Staff,26,0,30,4
1649962081469,MATH 10C,A01,083443,Staff,2,0,30,28
1649962081469,MATH 10C,A02,083444,Staff,12,0,30,18
1649962081469,MATH 10C,B01,084114,Staff,25,0,30,5
1649962081469,MATH 10C,B02,084115,Staff,28,0,30,2
1649962087492,MATH 18,A01,084117,Harel; Guershon,26,0,30,4
1649962087492,MATH 18,A02,084119,Harel; Guershon,28,0,30,2
1649962087492,MATH 18,A03,084120,Harel; Guershon,30,0,30,0
1649962087492,MATH 18,A04,084121,Harel; Guershon,29,0,30,1
1649962093530,MATH 20B,A01,084124,Um; Ko Woon,31,0,35,4
1649962093530,MATH 20B,B01,084126,Um; Ko Woon,32,0,35,3
1649962099553,MATH 20C,A01,083446,Hammock; Frances H,13,0,30,17
1649962099553,MATH 20C,A02,083447,Hammock; Frances H,28,0,30,2
1649962099553,MATH 20C,A03,083448,Hammock; Frances H,29,0,30,1
1649962099553,MATH 20C,A04,083449,Hammock; Frances H,30,0,30,0
1649962099553,MATH 20C,B01,083451,Hammock; Frances H,24,0,30,6
1649962099553,MATH 20C,B02,083452,Hammock; Frances H,27,0,30,3
1649962099553,MATH 20C,B03,083453,Hammock; Frances H,26,0,30,4
1649962099553,MATH 20C,B04,083454,Hammock; Frances H,30,0,30,0
1649962105577,MATH 20D,A01,084128,Staff,24,0,30,6
1649962105577,MATH 20D,A02,084129,Staff,30,0,30,0
1649962105577,MATH 20D,A03,084130,Staff,28,0,30,2
1649962105577,MATH 20D,B01,084133,Staff,15,0,30,15
1649962105577,MATH 20D,B02,084134,Staff,25,0,30,5
1649962105577,MATH 20D,B03,084135,Staff,30,0,30,0
1649962111605,MATH 20E,A01,084138,Staff,21,0,30,9
1649962111605,MATH 20E,A02,084139,Staff,16,0,30,14
1649962111605,MATH 20E,A03,084140,Staff,20,0,30,10
1649962111605,MATH 20E,A04,084141,Staff,25,0,30,5
1649962117629,MATH 102,A01,084143,Harel; Guershon,16,0,30,14
1649962117629,MATH 102,A02,084144,Harel; Guershon,20,0,30,10
1649962123660,MATH 103B,A01,083456,Staff,0,12,30,30
1649962123660,MATH 103B,A02,083457,Staff,0,10,30,30
1649962129687,MATH 109,A01,084146,Salehi Golsefidy; Alireza,27,0,30,3
1649962129687,MATH 109,A02,084147,Salehi Golsefidy; Alireza,19,0,30,11
1649962135712,MATH 120A,A01,085445,Eggers; John Dietrich,19,0,35,16
1649962135712,MATH 120A,A02,085446,Eggers; John Dietrich,27,0,35,8
1649962141741,MATH 142B,A01,084149,Verstraete; Jacques Allan,0,12,30,30
1649962141741,MATH 142B,A02,084150,Verstraete; Jacques Allan,0,12,30,30
1649962147776,MATH 170A,A01,083459,Nie; Jiawang,0,3,30,30
1649962147776,MATH 170A,A02,083460,Nie; Jiawang,0,3,30,30
1649962147776,MATH 170A,A03,083461,Nie; Jiawang,0,3,30,30
1649962153799,MATH 193B,A01,083463,Staff,1,0,30,29
1649962153799,MATH 193B,A02,083464,Staff,10,0,30,20
1649962153799,MATH 193B,A03,083465,Staff,18,0,30,12
1649962159851,COGS 2,A01,083966,Boyle; Mary E. T.,17,0,30,13
1649962165875,COGS 9,A01,083968,Staff,34,0,60,26
1649962171898,COGS 14B,A01,083970,Staff,22,0,50,28
1649962177921,COGS 17,A01,092679,Staff,62,0,75,13
1649962183950,COGS 100,A01,083972,Staff,0,3,60,60
1649962195995,COGS 101C,A01,083976,Staff,17,0,30,13
1649962202018,COGS 102A,A01,083978,Johnson; Christine M.,14,0,30,16
1649962208041,COGS 107B,A01,083980,Staff,0,1,50,50
1649962214077,COGS 115,A01,083982,Staff,12,0,30,18
1649962220109,COGS 118B,A01,083367,Staff,0,11,40,40
1649962226132,COGS 172,A01,083984,Provenzano; Emily Kara,16,0,30,14
1649962232156,COGS 177,A00,083368,Staff,0,19,30,30
1649962238181,COGS 186,A01,083986,Staff,21,0,40,19
1649962244213,COGS 187A,A01,083988,Boyle; Mary E. T.,23,0,60,37
1649962250237,CSE 8A,A50,084003,Miranda; Gregory Joseph,0,4,15,15
1649962256264,CSE 11,A01,084005,Miranda; Gregory Joseph,10,0,55,45
1649962262287,CSE 20,A01,084007,Staff,6,0,20,14
1649962268312,CSE 21,A01,084009,Staff,0,4,50,50
1649962274346,CSE 30,A01,083370,Cao; Yingjun,0,36,40,40
1649962280379,CSE 100,A01,083372,Cao; Yingjun,0,39,40,40
1649962286402,CSE 101,A01,084011,Staff,0,53,40,40
1649962292431,CSE 141,A01,083374,Eldon; John,0,55,75,75
1649962298472,CSE 141L,A01,083376,Eldon; John,0,60,75,75
1649962304511,CSE 175,A01,084013,Kumar; Rakesh,22,0,25,3
1649962310536,CSE 190,A00,092508,Dubnov; Shlomo,15,0,15,0
1649962316566,ECE 5,A01,084049,Morris; Karcher William,15,0,20,5
1649962322603,ECE 100,A01,084051,Baghdadchi; Saharnaz,0,0,20,20
1649962322603,ECE 100,A02,091916,Baghdadchi; Saharnaz,15,0,20,5
1649962328642,ECE 101,A01,084053,Baghdadchi; Saharnaz,3,0,37,34
1649962328642,ECE 101,A02,084054,Baghdadchi; Saharnaz,31,0,37,6
1649962334790,ECE 107,A01,083390,Staff,28,0,40,12
1649962340816,ECE 148,A01,084056,Silberman; Jack,7,0,12,5
1649962346866,ECE 180,A00,083391,Abi Samra; Nicholas Camill,25,0,30,5
1649962346866,ECE 180,B00,083392,Abi Samra; Nicholas Camill,22,0,30,8
1649962352894,MATH 10B,A01,084110,Staff,8,0,30,22
1649962352894,MATH 10B,A02,084111,Staff,29,0,30,1
1649962352894,MATH 10B,A03,084112,Staff,26,0,30,4
1649962358924,MATH 10C,A01,083443,Staff,2,0,30,28
1649962358924,MATH 10C,A02,083444,Staff,12,0,30,18
1649962358924,MATH 10C,B01,084114,Staff,25,0,30,5
1649962358924,MATH 10C,B02,084115,Staff,28,0,30,2
1649962364949,MATH 18,A01,084117,Harel; Guershon,26,0,30,4
1649962364949,MATH 18,A02,084119,Harel; Guershon,28,0,30,2
1649962364949,MATH 18,A03,084120,Harel; Guershon,30,0,30,0
1649962364949,MATH 18,A04,084121,Harel; Guershon,29,0,30,1
1649962370974,MATH 20B,A01,084124,Um; Ko Woon,31,0,35,4
1649962370974,MATH 20B,B01,084126,Um; Ko Woon,32,0,35,3
1649962377011,MATH 20C,A01,083446,Hammock; Frances H,13,0,30,17
1649962377011,MATH 20C,A02,083447,Hammock; Frances H,28,0,30,2
1649962377011,MATH 20C,A03,083448,Hammock; Frances H,29,0,30,1
1649962377011,MATH 20C,A04,083449,Hammock; Frances H,30,0,30,0
1649962377011,MATH 20C,B01,083451,Hammock; Frances H,24,0,30,6
1649962377011,MATH 20C,B02,083452,Hammock; Frances H,27,0,30,3
1649962377011,MATH 20C,B03,083453,Hammock; Frances H,26,0,30,4
1649962377011,MATH 20C,B04,083454,Hammock; Frances H,30,0,30,0
1649962383039,MATH 20D,A01,084128,Staff,24,0,30,6
1649962383039,MATH 20D,A02,084129,Staff,30,0,30,0
1649962383039,MATH 20D,A03,084130,Staff,28,0,30,2
1649962383039,MATH 20D,B01,084133,Staff,14,0,30,16
1649962383039,MATH 20D,B02,084134,Staff,25,0,30,5
1649962383039,MATH 20D,B03,084135,Staff,30,0,30,0
1649962389067,MATH 20E,A01,084138,Staff,21,0,30,9
1649962389067,MATH 20E,A02,084139,Staff,16,0,30,14
1649962389067,MATH 20E,A03,084140,Staff,20,0,30,10
1649962389067,MATH 20E,A04,084141,Staff,25,0,30,5
1649962395103,MATH 102,A01,084143,Harel; Guershon,16,0,30,14
1649962395103,MATH 102,A02,084144,Harel; Guershon,20,0,30,10
1649962401128,MATH 103B,A01,083456,Staff,0,12,30,30
1649962401128,MATH 103B,A02,083457,Staff,0,10,30,30
1649962407151,MATH 109,A01,084146,Salehi Golsefidy; Alireza,27,0,30,3
1649962407151,MATH 109,A02,084147,Salehi Golsefidy; Alireza,19,0,30,11
1649962413173,MATH 120A,A01,085445,Eggers; John Dietrich,18,0,35,17
1649962413173,MATH 120A,A02,085446,Eggers; John Dietrich,27,0,35,8
1649962419206,MATH 142B,A01,084149,Verstraete; Jacques Allan,0,12,30,30
1649962419206,MATH 142B,A02,084150,Verstraete; Jacques Allan,0,12,30,30
1649962425229,MATH 170A,A01,083459,Nie; Jiawang,0,3,30,30
1649962425229,MATH 170A,A02,083460,Nie; Jiawang,0,3,30,30
1649962425229,MATH 170A,A03,083461,Nie; Jiawang,0,3,30,30
1649962431272,MATH 193B,A01,083463,Staff,1,0,30,29
1649962431272,MATH 193B,A02,083464,Staff,10,0,30,20
1649962431272,MATH 193B,A03,083465,Staff,18,0,30,12
1649962437371,COGS 2,A01,083966,Boyle; Mary E. T.,17,0,30,13
1649962443398,COGS 9,A01,083968,Staff,34,0,60,26
1649962449438,COGS 14B,A01,083970,Staff,22,0,50,28
1649962455479,COGS 17,A01,092679,Staff,62,0,75,13
1649962461506,COGS 100,A01,083972,Staff,0,3,60,60
1649962473579,COGS 101C,A01,083976,Staff,17,0,30,13
1649962479614,COGS 102A,A01,083978,Johnson; Christine M.,14,0,30,16
1649962485642,COGS 107B,A01,083980,Staff,0,1,50,50
1649962491680,COGS 115,A01,083982,Staff,12,0,30,18
1649962497724,COGS 118B,A01,083367,Staff,0,11,40,40
1649962503752,COGS 172,A01,083984,Provenzano; Emily Kara,16,0,30,14
1649962509776,COGS 177,A00,083368,Staff,0,19,30,30
1649962515800,COGS 186,A01,083986,Staff,21,0,40,19
1649962521856,COGS 187A,A01,083988,Boyle; Mary E. T.,23,0,60,37
1649962527886,CSE 8A,A50,084003,Miranda; Gregory Joseph,0,4,15,15
1649962533908,CSE 11,A01,084005,Miranda; Gregory Joseph,9,0,55,46
1649962539935,CSE 20,A01,084007,Staff,5,0,20,15
1649962545968,CSE 21,A01,084009,Staff,0,4,50,50
1649962551992,CSE 30,A01,083370,Cao; Yingjun,0,38,40,40
1649962558014,CSE 100,A01,083372,Cao; Yingjun,0,39,40,40
1649962564061,CSE 101,A01,084011,Staff,0,53,40,40
1649962570082,CSE 141,A01,083374,Eldon; John,0,55,75,75
1649962576110,CSE 141L,A01,083376,Eldon; John,0,60,75,75
1649962582137,CSE 175,A01,084013,Kumar; Rakesh,22,0,25,3
1649962588160,CSE 190,A00,092508,Dubnov; Shlomo,15,0,15,0
1649962594200,ECE 5,A01,084049,Morris; Karcher William,15,0,20,5
1649962600223,ECE 100,A01,084051,Baghdadchi; Saharnaz,0,0,20,20
1649962600223,ECE 100,A02,091916,Baghdadchi; Saharnaz,15,0,20,5
1649962606267,ECE 101,A01,084053,Baghdadchi; Saharnaz,3,0,37,34
1649962606267,ECE 101,A02,084054,Baghdadchi; Saharnaz,31,0,37,6
1649962612293,ECE 107,A01,083390,Staff,28,0,40,12
1649962618329,ECE 148,A01,084056,Silberman; Jack,7,0,12,5
1649962624359,ECE 180,A00,083391,Abi Samra; Nicholas Camill,25,0,30,5
1649962624359,ECE 180,B00,083392,Abi Samra; Nicholas Camill,22,0,30,8
1649962630392,MATH 10B,A01,084110,Staff,8,0,30,22
1649962630392,MATH 10B,A02,084111,Staff,29,0,30,1
1649962630392,MATH 10B,A03,084112,Staff,26,0,30,4
1649962636421,MATH 10C,A01,083443,Staff,2,0,30,28
1649962636421,MATH 10C,A02,083444,Staff,12,0,30,18
1649962636421,MATH 10C,B01,084114,Staff,25,0,30,5
1649962636421,MATH 10C,B02,084115,Staff,28,0,30,2
1649962642471,MATH 18,A01,084117,Harel; Guershon,26,0,30,4
1649962642471,MATH 18,A02,084119,Harel; Guershon,28,0,30,2
1649962642471,MATH 18,A03,084120,Harel; Guershon,30,0,30,0
1649962642471,MATH 18,A04,084121,Harel; Guershon,29,0,30,1
1649962648497,MATH 20B,A01,084124,Um; Ko Woon,31,0,35,4
1649962648497,MATH 20B,B01,084126,Um; Ko Woon,32,0,35,3
1649962654521,MATH 20C,A01,083446,Hammock; Frances H,13,0,30,17
1649962654521,MATH 20C,A02,083447,Hammock; Frances H,28,0,30,2
1649962654521,MATH 20C,A03,083448,Hammock; Frances H,29,0,30,1
1649962654521,MATH 20C,A04,083449,Hammock; Frances H,30,0,30,0
1649962654521,MATH 20C,B01,083451,Hammock; Frances H,24,0,30,6
1649962654521,MATH 20C,B02,083452,Hammock; Frances H,27,0,30,3
1649962654521,MATH 20C,B03,083453,Hammock; Frances H,26,0,30,4
1649962654521,MATH 20C,B04,083454,Hammock; Frances H,30,0,30,0
1649962660553,MATH 20D,A01,084128,Staff,24,0,30,6
1649962660553,MATH 20D,A02,084129,Staff,30,0,30,0
1649962660553,MATH 20D,A03,084130,Staff,28,0,30,2
1649962660553,MATH 20D,B01,084133,Staff,14,0,30,16
1649962660553,MATH 20D,B02,084134,Staff,25,0,30,5
1649962660553,MATH 20D,B03,084135,Staff,30,0,30,0
1649962666593,MATH 20E,A01,084138,Staff,21,0,30,9
1649962666593,MATH 20E,A02,084139,Staff,16,0,30,14
1649962666593,MATH 20E,A03,084140,Staff,20,0,30,10
1649962666593,MATH 20E,A04,084141,Staff,25,0,30,5
1649962672625,MATH 102,A01,084143,Harel; Guershon,16,0,30,14
1649962672625,MATH 102,A02,084144,Harel; Guershon,20,0,30,10
1649962678663,MATH 103B,A01,083456,Staff,0,12,30,30
1649962678663,MATH 103B,A02,083457,Staff,0,10,30,30
1649962684685,MATH 109,A01,084146,Salehi Golsefidy; Alireza,27,0,30,3
1649962684685,MATH 109,A02,084147,Salehi Golsefidy; Alireza,19,0,30,11
1649962690712,MATH 120A,A01,085445,Eggers; John Dietrich,18,0,35,17
1649962690712,MATH 120A,A02,085446,Eggers; John Dietrich,27,0,35,8
1649962696749,MATH 142B,A01,084149,Verstraete; Jacques Allan,0,12,30,30
1649962696749,MATH 142B,A02,084150,Verstraete; Jacques Allan,0,12,30,30
1649962702772,MATH 170A,A01,083459,Nie; Jiawang,0,3,30,30
1649962702772,MATH 170A,A02,083460,Nie; Jiawang,0,3,30,30
1649962702772,MATH 170A,A03,083461,Nie; Jiawang,0,3,30,30
1649962708795,MATH 193B,A01,083463,Staff,1,0,30,29
1649962708795,MATH 193B,A02,083464,Staff,10,0,30,20
1649962708795,MATH 193B,A03,083465,Staff,18,0,30,12
1649962714863,COGS 2,A01,083966,Boyle; Mary E. T.,17,0,30,13
1649962720907,COGS 9,A01,083968,Staff,33,0,60,27
1649962726934,COGS 14B,A01,083970,Staff,22,0,50,28
1649962732958,COGS 17,A01,092679,Staff,62,0,75,13
1649962738986,COGS 100,A01,083972,Staff,0,3,60,60
1649962751037,COGS 101C,A01,083976,Staff,17,0,30,13
1649962757076,COGS 102A,A01,083978,Johnson; Christine M.,14,0,30,16
1649962763102,COGS 107B,A01,083980,Staff,0,2,50,50
1649962769136,COGS 115,A01,083982,Staff,12,0,30,18
1649962775159,COGS 118B,A01,083367,Staff,0,11,40,40
1649962781183,COGS 172,A01,083984,Provenzano; Emily Kara,16,0,30,14
1649962787207,COGS 177,A00,083368,Staff,0,19,30,30
1649962793235,COGS 186,A01,083986,Staff,21,0,40,19
1649962799279,COGS 187A,A01,083988,Boyle; Mary E. T.,23,0,60,37
1649962805305,CSE 8A,A50,084003,Miranda; Gregory Joseph,0,4,15,15
1649962811331,CSE 11,A01,084005,Miranda; Gregory Joseph,9,0,55,46
1649962817371,CSE 20,A01,084007,Staff,5,0,20,15
1649962823398,CSE 21,A01,084009,Staff,0,4,50,50
1649962829421,CSE 30,A01,083370,Cao; Yingjun,0,38,40,40
1649962835445,CSE 100,A01,083372,Cao; Yingjun,0,41,40,40
1649962841475,CSE 101,A01,084011,Staff,0,53,40,40
1649962847503,CSE 141,A01,083374,Eldon; John,0,55,75,75
1649962853542,CSE 141L,A01,083376,Eldon; John,0,60,75,75
1649962859579,CSE 175,A01,084013,Kumar; Rakesh,22,0,25,3
1649962865618,CSE 190,A00,092508,Dubnov; Shlomo,15,0,15,0
1649962871646,ECE 5,A01,084049,Morris; Karcher William,15,0,20,5
1649962877672,ECE 100,A01,084051,Baghdadchi; Saharnaz,0,0,20,20
1649962877672,ECE 100,A02,091916,Baghdadchi; Saharnaz,15,0,20,5
1649962883702,ECE 101,A01,084053,Baghdadchi; Saharnaz,3,0,37,34
1649962883702,ECE 101,A02,084054,Baghdadchi; Saharnaz,31,0,37,6
1649962889733,ECE 107,A01,083390,Staff,28,0,40,12
1649962895756,ECE 148,A01,084056,Silberman; Jack,7,0,12,5
1649962901787,ECE 180,A00,083391,Abi Samra; Nicholas Camill,25,0,30,5
1649962901787,ECE 180,B00,083392,Abi Samra; Nicholas Camill,22,0,30,8
1649962907823,MATH 10B,A01,084110,Staff,8,0,30,22
1649962907823,MATH 10B,A02,084111,Staff,29,0,30,1
1649962907823,MATH 10B,A03,084112,Staff,26,0,30,4
1649962913868,MATH 10C,A01,083443,Staff,2,0,30,28
1649962913868,MATH 10C,A02,083444,Staff,12,0,30,18
1649962913868,MATH 10C,B01,084114,Staff,25,0,30,5
1649962913868,MATH 10C,B02,084115,Staff,28,0,30,2
1649962919896,MATH 18,A01,084117,Harel; Guershon,26,0,30,4
1649962919896,MATH 18,A02,084119,Harel; Guershon,28,0,30,2
1649962919896,MATH 18,A03,084120,Harel; Guershon,30,0,30,0
1649962919896,MATH 18,A04,084121,Harel; Guershon,29,0,30,1
1649962925933,MATH 20B,A01,084124,Um; Ko Woon,31,0,35,4
1649962925933,MATH 20B,B01,084126,Um; Ko Woon,32,0,35,3
1649962932051,MATH 20C,A01,083446,Hammock; Frances H,13,0,30,17
1649962932051,MATH 20C,A02,083447,Hammock; Frances H,28,0,30,2
1649962932051,MATH 20C,A03,083448,Hammock; Frances H,29,0,30,1
1649962932051,MATH 20C,A04,083449,Hammock; Frances H,30,0,30,0
1649962932051,MATH 20C,B01,083451,Hammock; Frances H,23,0,30,7
1649962932051,MATH 20C,B02,083452,Hammock; Frances H,27,0,30,3
1649962932051,MATH 20C,B03,083453,Hammock; Frances H,26,0,30,4
1649962932051,MATH 20C,B04,083454,Hammock; Frances H,30,0,30,0
1649962938082,MATH 20D,A01,084128,Staff,24,0,30,6
1649962938082,MATH 20D,A02,084129,Staff,29,0,30,1
1649962938082,MATH 20D,A03,084130,Staff,28,0,30,2
1649962938082,MATH 20D,B01,084133,Staff,14,0,30,16
1649962938082,MATH 20D,B02,084134,Staff,25,0,30,5
1649962938082,MATH 20D,B03,084135,Staff,30,0,30,0
1649962944104,MATH 20E,A01,084138,Staff,21,0,30,9
1649962944104,MATH 20E,A02,084139,Staff,15,0,30,15
1649962944104,MATH 20E,A03,084140,Staff,20,0,30,10
1649962944104,MATH 20E,A04,084141,Staff,25,0,30,5
1649962950138,MATH 102,A01,084143,Harel; Guershon,16,0,30,14
1649962950138,MATH 102,A02,084144,Harel; Guershon,20,0,30,10
1649962956164,MATH 103B,A01,083456,Staff,0,12,30,30
1649962956164,MATH 103B,A02,083457,Staff,0,10,30,30
1649962962190,MATH 109,A01,084146,Salehi Golsefidy; Alireza,27,0,30,3
1649962962190,MATH 109,A02,084147,Salehi Golsefidy; Alireza,19,0,30,11
1649962968213,MATH 120A,A01,085445,Eggers; John Dietrich,18,0,35,17
1649962968213,MATH 120A,A02,085446,Eggers; John Dietrich,27,0,35,8
1649962974245,MATH 142B,A01,084149,Verstraete; Jacques Allan,0,12,30,30
1649962974245,MATH 142B,A02,084150,Verstraete; Jacques Allan,0,12,30,30
1649962980286,MATH 170A,A01,083459,Nie; Jiawang,0,4,30,30
1649962980286,MATH 170A,A02,083460,Nie; Jiawang,0,3,30,30
1649962980286,MATH 170A,A03,083461,Nie; Jiawang,0,3,30,30
1649962986308,MATH 193B,A01,083463,Staff,1,0,30,29
1649962986308,MATH 193B,A02,083464,Staff,10,0,30,20
1649962986308,MATH 193B,A03,083465,Staff,18,0,30,12
1649962992378,COGS 2,A01,083966,Boyle; Mary E. T.,17,0,30,13
1649962998401,COGS 9,A01,083968,Staff,33,0,60,27
1649963004423,COGS 14B,A01,083970,Staff,21,0,50,29
1649963010450,COGS 17,A01,092679,Staff,62,0,75,13
1649963016486,COGS 100,A01,083972,Staff,0,4,60,60
1649963028532,COGS 101C,A01,083976,Staff,17,0,30,13
1649963034562,COGS 102A,A01,083978,Johnson; Christine M.,14,0,30,16
1649963040597,COGS 107B,A01,083980,Staff,0,2,50,50
1649963046634,COGS 115,A01,083982,Staff,12,0,30,18
1649963052663,COGS 118B,A01,083367,Staff,0,11,40,40
1649963058700,COGS 172,A01,083984,Provenzano; Emily Kara,16,0,30,14
1649963064726,COGS 177,A00,083368,Staff,0,19,30,30
1649963070755,COGS 186,A01,083986,Staff,21,0,40,19
1649963076778,COGS 187A,A01,083988,Boyle; Mary E. T.,22,0,60,38
1649963082803,CSE 8A,A50,084003,Miranda; Gregory Joseph,0,4,15,15
1649963088827,CSE 11,A01,084005,Miranda; Gregory Joseph,9,0,55,46
1649963094849,CSE 20,A01,084007,Staff,5,0,20,15
1649963100873,CSE 21,A01,084009,Staff,0,4,50,50
1649963106896,CSE 30,A01,083370,Cao; Yingjun,0,38,40,40
1649963112934,CSE 100,A01,083372,Cao; Yingjun,0,41,40,40
1649963118957,CSE 101,A01,084011,Staff,0,53,40,40
1649963124980,CSE 141,A01,083374,Eldon; John,0,55,75,75
1649963131004,CSE 141L,A01,083376,Eldon; John,0,60,75,75
1649963137031,CSE 175,A01,084013,Kumar; Rakesh,22,0,25,3
1649963143055,CSE 190,A00,092508,Dubnov; Shlomo,15,0,15,0
1649963149100,ECE 5,A01,084049,Morris; Karcher William,15,0,20,5
1649963155142,ECE 100,A01,084051,Baghdadchi; Saharnaz,0,0,20,20
1649963155142,ECE 100,A02,091916,Baghdadchi; Saharnaz,15,0,20,5
1649963161168,ECE 101,A01,084053,Baghdadchi; Saharnaz,3,0,37,34
1649963161168,ECE 101,A02,084054,Baghdadchi; Saharnaz,31,0,37,6
1649963167202,ECE 107,A01,083390,Staff,28,0,40,12
1649963173227,ECE 148,A01,084056,Silberman; Jack,7,0,12,5
1649963179250,ECE 180,A00,083391,Abi Samra; Nicholas Camill,25,0,30,5
1649963179250,ECE 180,B00,083392,Abi Samra; Nicholas Camill,22,0,30,8
1649963191706,MATH 10B,A01,084110,Staff,8,0,30,22
1649963191706,MATH 10B,A02,084111,Staff,29,0,30,1
1649963191706,MATH 10B,A03,084112,Staff,26,0,30,4
1649963197731,MATH 10C,A01,083443,Staff,2,0,30,28
1649963197731,MATH 10C,A02,083444,Staff,12,0,30,18
1649963197731,MATH 10C,B01,084114,Staff,25,0,30,5
1649963197731,MATH 10C,B02,084115,Staff,28,0,30,2
1649963203764,MATH 18,A01,084117,Harel; Guershon,25,0,30,5
1649963203764,MATH 18,A02,084119,Harel; Guershon,28,0,30,2
1649963203764,MATH 18,A03,084120,Harel; Guershon,30,0,30,0
1649963203764,MATH 18,A04,084121,Harel; Guershon,29,0,30,1
1649963209786,MATH 20B,A01,084124,Um; Ko Woon,31,0,35,4
1649963209786,MATH 20B,B01,084126,Um; Ko Woon,32,0,35,3
1649963215827,MATH 20C,A01,083446,Hammock; Frances H,13,0,30,17
1649963215827,MATH 20C,A02,083447,Hammock; Frances H,28,0,30,2
1649963215827,MATH 20C,A03,083448,Hammock; Frances H,29,0,30,1
1649963215827,MATH 20C,A04,083449,Hammock; Frances H,30,0,30,0
1649963215827,MATH 20C,B01,083451,Hammock; Frances H,23,0,30,7
1649963215827,MATH 20C,B02,083452,Hammock; Frances H,27,0,30,3
1649963215827,MATH 20C,B03,083453,Hammock; Frances H,26,0,30,4
1649963215827,MATH 20C,B04,083454,Hammock; Frances H,30,0,30,0
1649963221855,MATH 20D,A01,084128,Staff,24,0,30,6
1649963221855,MATH 20D,A02,084129,Staff,30,0,30,0
1649963221855,MATH 20D,A03,084130,Staff,28,0,30,2
1649963221855,MATH 20D,B01,084133,Staff,13,0,30,17
1649963221855,MATH 20D,B02,084134,Staff,25,0,30,5
1649963221855,MATH 20D,B03,084135,Staff,30,0,30,0
1649963227881,MATH 20E,A01,084138,Staff,21,0,30,9
1649963227881,MATH 20E,A02,084139,Staff,15,0,30,15
1649963227881,MATH 20E,A03,084140,Staff,20,0,30,10
1649963227881,MATH 20E,A04,084141,Staff,25,0,30,5
1649963233909,MATH 102,A01,084143,Harel; Guershon,16,0,30,14
1649963233909,MATH 102,A02,084144,Harel; Guershon,20,0,30,10
1649963239931,MATH 103B,A01,083456,Staff,0,12,30,30
1649963239931,MATH 103B,A02,083457,Staff,0,10,30,30
1649963245954,MATH 109,A01,084146,Salehi Golsefidy; Alireza,27,0,30,3
1649963245954,MATH 109,A02,084147,Salehi Golsefidy; Alireza,19,0,30,11
1649963251980,MATH 120A,A01,085445,Eggers; John Dietrich,18,0,35,17
1649963251980,MATH 120A,A02,085446,Eggers; John Dietrich,27,0,35,8
1649963258007,MATH 142B,A01,084149,Verstraete; Jacques Allan,0,12,30,30
1649963258007,MATH 142B,A02,084150,Verstraete; Jacques Allan,0,12,30,30
1649963264032,MATH 170A,A01,083459,Nie; Jiawang,0,4,30,30
1649963264032,MATH 170A,A02,083460,Nie; Jiawang,0,3,30,30
1649963264032,MATH 170A,A03,083461,Nie; Jiawang,0,3,30,30
1649963270054,MATH 193B,A01,083463,Staff,1,0,30,29
1649963270054,MATH 193B,A02,083464,Staff,10,0,30,20
1649963270054,MATH 193B,A03,083465,Staff,18,0,30,12
1649963276113,COGS 2,A01,083966,Boyle; Mary E. T.,17,0,30,13
1649963282139,COGS 9,A01,083968,Staff,33,0,60,27
1649963288179,COGS 14B,A01,083970,Staff,21,0,50,29
1649963294205,COGS 17,A01,092679,Staff,62,0,75,13
1649963300228,COGS 100,A01,083972,Staff,0,4,60,60
1649963312295,COGS 101C,A01,083976,Staff,17,0,30,13
1649963318320,COGS 102A,A01,083978,Johnson; Christine M.,14,0,30,16
1649963324342,COGS 107B,A01,083980,Staff,0,2,50,50
1649963330373,COGS 115,A01,083982,Staff,12,0,30,18
1649963336396,COGS 118B,A01,083367,Staff,0,11,40,40
1649963342425,COGS 172,A01,083984,Provenzano; Emily Kara,16,0,30,14
1649963348451,COGS 177,A00,083368,Staff,0,19,30,30
1649963354474,COGS 186,A01,083986,Staff,21,0,40,19
1649963360509,COGS 187A,A01,083988,Boyle; Mary E. T.,21,0,60,39
1649963366533,CSE 8A,A50,084003,Miranda; Gregory Joseph,0,4,15,15
1649963372572,CSE 11,A01,084005,Miranda; Gregory Joseph,9,0,55,46
1649963378594,CSE 20,A01,084007,Staff,5,0,20,15
1649963384633,CSE 21,A01,084009,Staff,0,4,50,50
1649963390666,CSE 30,A01,083370,Cao; Yingjun,0,38,40,40
1649963396689,CSE 100,A01,083372,Cao; Yingjun,0,41,40,40
1649963402716,CSE 101,A01,084011,Staff,0,53,40,40
1649963408740,CSE 141,A01,083374,Eldon; John,0,55,75,75
1649963414776,CSE 141L,A01,083376,Eldon; John,0,60,75,75
1649963420803,CSE 175,A01,084013,Kumar; Rakesh,22,0,25,3
1649963426829,CSE 190,A00,092508,Dubnov; Shlomo,15,0,15,0
1649963432853,ECE 5,A01,084049,Morris; Karcher William,15,0,20,5
1649963438884,ECE 100,A01,084051,Baghdadchi; Saharnaz,0,0,20,20
1649963438884,ECE 100,A02,091916,Baghdadchi; Saharnaz,15,0,20,5
1649963444905,ECE 101,A01,084053,Baghdadchi; Saharnaz,3,0,37,34
1649963444905,ECE 101,A02,084054,Baghdadchi; Saharnaz,31,0,37,6
1649963450936,ECE 107,A01,083390,Staff,28,0,40,12
1649963456964,ECE 148,A01,084056,Silberman; Jack,7,0,12,5
1649963462988,ECE 180,A00,083391,Abi Samra; Nicholas Camill,25,0,30,5
1649963462988,ECE 180,B00,083392,Abi Samra; Nicholas Camill,22,0,30,8
1649963469018,MATH 10B,A01,084110,Staff,8,0,30,22
1649963469018,MATH 10B,A02,084111,Staff,29,0,30,1
1649963469018,MATH 10B,A03,084112,Staff,26,0,30,4
1649963475054,MATH 10C,A01,083443,Staff,2,0,30,28
1649963475054,MATH 10C,A02,083444,Staff,12,0,30,18
1649963475054,MATH 10C,B01,084114,Staff,25,0,30,5
1649963475054,MATH 10C,B02,084115,Staff,28,0,30,2
1649963481091,MATH 18,A01,084117,Harel; Guershon,25,0,30,5
1649963481091,MATH 18,A02,084119,Harel; Guershon,28,0,30,2
1649963481091,MATH 18,A03,084120,Harel; Guershon,30,0,30,0
1649963481091,MATH 18,A04,084121,Harel; Guershon,29,0,30,1
1649963487113,MATH 20B,A01,084124,Um; Ko Woon,31,0,35,4
1649963487113,MATH 20B,B01,084126,Um; Ko Woon,32,0,35,3
1649963493139,MATH 20C,A01,083446,Hammock; Frances H,13,0,30,17
1649963493139,MATH 20C,A02,083447,Hammock; Frances H,28,0,30,2
1649963493139,MATH 20C,A03,083448,Hammock; Frances H,29,0,30,1
1649963493139,MATH 20C,A04,083449,Hammock; Frances H,30,0,30,0
1649963493139,MATH 20C,B01,083451,Hammock; Frances H,22,0,30,8
1649963493139,MATH 20C,B02,083452,Hammock; Frances H,27,0,30,3
1649963493139,MATH 20C,B03,083453,Hammock; Frances H,26,0,30,4
1649963493139,MATH 20C,B04,083454,Hammock; Frances H,30,0,30,0
1649963499189,MATH 20D,A01,084128,Staff,23,0,30,7
1649963499189,MATH 20D,A02,084129,Staff,30,0,30,0
1649963499189,MATH 20D,A03,084130,Staff,28,0,30,2
1649963499189,MATH 20D,B01,084133,Staff,13,0,30,17
1649963499189,MATH 20D,B02,084134,Staff,25,0,30,5
1649963499189,MATH 20D,B03,084135,Staff,30,0,30,0
1649963505217,MATH 20E,A01,084138,Staff,21,0,30,9
1649963505217,MATH 20E,A02,084139,Staff,15,0,30,15
1649963505217,MATH 20E,A03,084140,Staff,20,0,30,10
1649963505217,MATH 20E,A04,084141,Staff,24,0,30,6
1649963511255,MATH 102,A01,084143,Harel; Guershon,16,0,30,14
1649963511255,MATH 102,A02,084144,Harel; Guershon,21,0,30,9
1649963517283,MATH 103B,A01,083456,Staff,0,12,30,30
1649963517283,MATH 103B,A02,083457,Staff,0,11,30,30
1649963523314,MATH 109,A01,084146,Salehi Golsefidy; Alireza,27,0,30,3
1649963523314,MATH 109,A02,084147,Salehi Golsefidy; Alireza,19,0,30,11
1649963529345,MATH 120A,A01,085445,Eggers; John Dietrich,18,0,35,17
1649963529345,MATH 120A,A02,085446,Eggers; John Dietrich,27,0,35,8
1649963535471,MATH 142B,A01,084149,Verstraete; Jacques Allan,0,12,30,30
1649963535471,MATH 142B,A02,084150,Verstraete; Jacques Allan,0,12,30,30
1649963541512,MATH 170A,A01,083459,Nie; Jiawang,0,4,30,30
1649963541512,MATH 170A,A02,083460,Nie; Jiawang,0,3,30,30
1649963541512,MATH 170A,A03,083461,Nie; Jiawang,0,3,30,30
1649963547539,MATH 193B,A01,083463,Staff,1,0,30,29
1649963547539,MATH 193B,A02,083464,Staff,10,0,30,20
1649963547539,MATH 193B,A03,083465,Staff,18,0,30,12
1649963553615,COGS 2,A01,083966,Boyle; Mary E. T.,17,0,30,13
1649963559641,COGS 9,A01,083968,Staff,34,0,60,26
1649963565664,COGS 14B,A01,083970,Staff,21,0,50,29
1649963571687,COGS 17,A01,092679,Staff,62,0,75,13
1649963577714,COGS 100,A01,083972,Staff,0,4,60,60
1649963589777,COGS 101C,A01,083976,Staff,17,0,30,13
1649963595803,COGS 102A,A01,083978,Johnson; Christine M.,14,0,30,16
1649963601836,COGS 107B,A01,083980,Staff,0,2,50,50
1649963607867,COGS 115,A01,083982,Staff,12,0,30,18
1649963613901,COGS 118B,A01,083367,Staff,0,11,40,40
1649963619945,COGS 172,A01,083984,Provenzano; Emily Kara,16,0,30,14
1649963625976,COGS 177,A00,083368,Staff,0,19,30,30
1649963632000,COGS 186,A01,083986,Staff,21,0,40,19
1649963638035,COGS 187A,A01,083988,Boyle; Mary E. T.,21,0,60,39
1649963644062,CSE 8A,A50,084003,Miranda; Gregory Joseph,0,4,15,15
1649963650091,CSE 11,A01,084005,Miranda; Gregory Joseph,9,0,55,46
1649963656115,CSE 20,A01,084007,Staff,5,0,20,15
1649963662141,CSE 21,A01,084009,Staff,0,5,50,50
1649963668165,CSE 30,A01,083370,Cao; Yingjun,0,38,40,40
1649963674199,CSE 100,A01,083372,Cao; Yingjun,0,41,40,40
1649963680228,CSE 101,A01,084011,Staff,0,53,40,40
1649963686254,CSE 141,A01,083374,Eldon; John,0,55,75,75
1649963692292,CSE 141L,A01,083376,Eldon; John,0,60,75,75
1649963698319,CSE 175,A01,084013,Kumar; Rakesh,22,0,25,3
1649963704362,CSE 190,A00,092508,Dubnov; Shlomo,15,0,15,0
1649963710385,ECE 5,A01,084049,Morris; Karcher William,15,0,20,5
1649963716414,ECE 100,A01,084051,Baghdadchi; Saharnaz,0,0,20,20
1649963716414,ECE 100,A02,091916,Baghdadchi; Saharnaz,15,0,20,5
1649963722454,ECE 101,A01,084053,Baghdadchi; Saharnaz,3,0,37,34
1649963722454,ECE 101,A02,084054,Baghdadchi; Saharnaz,31,0,37,6
1649963728477,ECE 107,A01,083390,Staff,28,0,40,12
1649963734516,ECE 148,A01,084056,Silberman; Jack,7,0,12,5
1649963740539,ECE 180,A00,083391,Abi Samra; Nicholas Camill,25,0,30,5
1649963740539,ECE 180,B00,083392,Abi Samra; Nicholas Camill,22,0,30,8
1649963746564,MATH 10B,A01,084110,Staff,8,0,30,22
1649963746564,MATH 10B,A02,084111,Staff,29,0,30,1
1649963746564,MATH 10B,A03,084112,Staff,26,0,30,4
1649963752587,MATH 10C,A01,083443,Staff,2,0,30,28
1649963752587,MATH 10C,A02,083444,Staff,12,0,30,18
1649963752587,MATH 10C,B01,084114,Staff,25,0,30,5
1649963752587,MATH 10C,B02,084115,Staff,28,0,30,2
1649963758617,MATH 18,A01,084117,Harel; Guershon,25,0,30,5
1649963758617,MATH 18,A02,084119,Harel; Guershon,27,0,30,3
1649963758617,MATH 18,A03,084120,Harel; Guershon,30,0,30,0
1649963758617,MATH 18,A04,084121,Harel; Guershon,29,0,30,1
1649963764641,MATH 20B,A01,084124,Um; Ko Woon,31,0,35,4
1649963764641,MATH 20B,B01,084126,Um; Ko Woon,32,0,35,3
1649963770677,MATH 20C,A01,083446,Hammock; Frances H,12,0,30,18
1649963770677,MATH 20C,A02,083447,Hammock; Frances H,28,0,30,2
1649963770677,MATH 20C,A03,083448,Hammock; Frances H,29,0,30,1
1649963770677,MATH 20C,A04,083449,Hammock; Frances H,30,0,30,0
1649963770677,MATH 20C,B01,083451,Hammock; Frances H,21,0,30,9
1649963770677,MATH 20C,B02,083452,Hammock; Frances H,27,0,30,3
1649963770677,MATH 20C,B03,083453,Hammock; Frances H,26,0,30,4
1649963770677,MATH 20C,B04,083454,Hammock; Frances H,30,0,30,0
1649963776705,MATH 20D,A01,084128,Staff,23,0,30,7
1649963776705,MATH 20D,A02,084129,Staff,30,0,30,0
1649963776705,MATH 20D,A03,084130,Staff,28,0,30,2
1649963776705,MATH 20D,B01,084133,Staff,13,0,30,17
1649963776705,MATH 20D,B02,084134,Staff,25,0,30,5
1649963776705,MATH 20D,B03,084135,Staff,30,0,30,0
1649963782745,MATH 20E,A01,084138,Staff,21,0,30,9
1649963782745,MATH 20E,A02,084139,Staff,15,0,30,15
1649963782745,MATH 20E,A03,084140,Staff,20,0,30,10
1649963782745,MATH 20E,A04,084141,Staff,24,0,30,6
1649963788780,MATH 102,A01,084143,Harel; Guershon,16,0,30,14
1649963788780,MATH 102,A02,084144,Harel; Guershon,21,0,30,9
1649963794807,MATH 103B,A01,083456,Staff,0,12,30,30
1649963794807,MATH 103B,A02,083457,Staff,0,11,30,30
1649963800831,MATH 109,A01,084146,Salehi Golsefidy; Alireza,27,0,30,3
1649963800831,MATH 109,A02,084147,Salehi Golsefidy; Alireza,19,0,30,11
1649963806854,MATH 120A,A01,085445,Eggers; John Dietrich,18,0,35,17
1649963806854,MATH 120A,A02,085446,Eggers; John Dietrich,27,0,35,8
1649963812877,MATH 142B,A01,084149,Verstraete; Jacques Allan,0,12,30,30
1649963812877,MATH 142B,A02,084150,Verstraete; Jacques Allan,0,12,30,30
1649963818912,MATH 170A,A01,083459,Nie; Jiawang,0,4,30,30
1649963818912,MATH 170A,A02,083460,Nie; Jiawang,0,3,30,30
1649963818912,MATH 170A,A03,083461,Nie; Jiawang,0,4,30,30
1649963824960,MATH 193B,A01,083463,Staff,1,0,30,29
1649963824960,MATH 193B,A02,083464,Staff,10,0,30,20
1649963824960,MATH 193B,A03,083465,Staff,18,0,30,12
1649963831035,COGS 2,A01,083966,Boyle; Mary E. T.,17,0,30,13
1649963837060,COGS 9,A01,083968,Staff,34,0,60,26
1649963843088,COGS 14B,A01,083970,Staff,21,0,50,29
1649963849113,COGS 17,A01,092679,Staff,62,0,75,13
1649963855148,COGS 100,A01,083972,Staff,0,5,60,60
1649963867210,COGS 101C,A01,083976,Staff,17,0,30,13
1649963873248,COGS 102A,A01,083978,Johnson; Christine M.,14,0,30,16
1649963879283,COGS 107B,A01,083980,Staff,0,2,50,50
1649963885321,COGS 115,A01,083982,Staff,12,0,30,18
1649963891349,COGS 118B,A01,083367,Staff,0,11,40,40
1649963897371,COGS 172,A01,083984,Provenzano; Emily Kara,16,0,30,14
1649963903394,COGS 177,A00,083368,Staff,0,19,30,30
1649963909422,COGS 186,A01,083986,Staff,21,0,40,19
1649963915457,COGS 187A,A01,083988,Boyle; Mary E. T.,21,0,60,39
1649963921482,CSE 8A,A50,084003,Miranda; Gregory Joseph,0,4,15,15
1649963927527,CSE 11,A01,084005,Miranda; Gregory Joseph,9,0,55,46
1649963933551,CSE 20,A01,084007,Staff,5,0,20,15
1649963939575,CSE 21,A01,084009,Staff,0,6,50,50
1649963945606,CSE 30,A01,083370,Cao; Yingjun,0,39,40,40
1649963951629,CSE 100,A01,083372,Cao; Yingjun,0,41,40,40
1649963957675,CSE 101,A01,084011,Staff,0,54,40,40
1649963963706,CSE 141,A01,083374,Eldon; John,0,56,75,75
1649963969747,CSE 141L,A01,083376,Eldon; John,0,61,75,75
1649963975793,CSE 175,A01,084013,Kumar; Rakesh,22,0,25,3
1649963981816,CSE 190,A00,092508,Dubnov; Shlomo,15,0,15,0
1649963987839,ECE 5,A01,084049,Morris; Karcher William,15,0,20,5
1649963993863,ECE 100,A01,084051,Baghdadchi; Saharnaz,0,0,20,20
1649963993863,ECE 100,A02,091916,Baghdadchi; Saharnaz,15,0,20,5
1649963999889,ECE 101,A01,084053,Baghdadchi; Saharnaz,3,0,37,34
1649963999889,ECE 101,A02,084054,Baghdadchi; Saharnaz,31,0,37,6
1649964005917,ECE 107,A01,083390,Staff,28,0,40,12
1649964011942,ECE 148,A01,084056,Silberman; Jack,7,0,12,5
1649964017966,ECE 180,A00,083391,Abi Samra; Nicholas Camill,25,0,30,5
1649964017966,ECE 180,B00,083392,Abi Samra; Nicholas Camill,22,0,30,8
1649964024012,MATH 10B,A01,084110,Staff,8,0,30,22
1649964024012,MATH 10B,A02,084111,Staff,29,0,30,1
1649964024012,MATH 10B,A03,084112,Staff,26,0,30,4
1649964030040,MATH 10C,A01,083443,Staff,2,0,30,28
1649964030040,MATH 10C,A02,083444,Staff,12,0,30,18
1649964030040,MATH 10C,B01,084114,Staff,25,0,30,5
1649964030040,MATH 10C,B02,084115,Staff,28,0,30,2
1649964036064,MATH 18,A01,084117,Harel; Guershon,25,0,30,5
1649964036064,MATH 18,A02,084119,Harel; Guershon,27,0,30,3
1649964036064,MATH 18,A03,084120,Harel; Guershon,30,0,30,0
1649964036064,MATH 18,A04,084121,Harel; Guershon,29,0,30,1
1649964042094,MATH 20B,A01,084124,Um; Ko Woon,31,0,35,4
1649964042094,MATH 20B,B01,084126,Um; Ko Woon,32,0,35,3
1649964048119,MATH 20C,A01,083446,Hammock; Frances H,12,0,30,18
1649964048119,MATH 20C,A02,083447,Hammock; Frances H,28,0,30,2
1649964048119,MATH 20C,A03,083448,Hammock; Frances H,28,0,30,2
1649964048119,MATH 20C,A04,083449,Hammock; Frances H,30,0,30,0
1649964048119,MATH 20C,B01,083451,Hammock; Frances H,21,0,30,9
1649964048119,MATH 20C,B02,083452,Hammock; Frances H,27,0,30,3
1649964048119,MATH 20C,B03,083453,Hammock; Frances H,26,0,30,4
1649964048119,MATH 20C,B04,083454,Hammock; Frances H,30,0,30,0
1649964054158,MATH 20D,A01,084128,Staff,23,0,30,7
1649964054158,MATH 20D,A02,084129,Staff,30,0,30,0
1649964054158,MATH 20D,A03,084130,Staff,28,0,30,2
1649964054158,MATH 20D,B01,084133,Staff,13,0,30,17
1649964054158,MATH 20D,B02,084134,Staff,25,0,30,5
1649964054158,MATH 20D,B03,084135,Staff,30,0,30,0
1649964060203,MATH 20E,A01,084138,Staff,21,0,30,9
1649964060203,MATH 20E,A02,084139,Staff,15,0,30,15
1649964060203,MATH 20E,A03,084140,Staff,20,0,30,10
1649964060203,MATH 20E,A04,084141,Staff,24,0,30,6
1649964066233,MATH 102,A01,084143,Harel; Guershon,16,0,30,14
1649964066233,MATH 102,A02,084144,Harel; Guershon,21,0,30,9
1649964072258,MATH 103B,A01,083456,Staff,0,12,30,30
1649964072258,MATH 103B,A02,083457,Staff,0,11,30,30
1649964078291,MATH 109,A01,084146,Salehi Golsefidy; Alireza,27,0,30,3
1649964078291,MATH 109,A02,084147,Salehi Golsefidy; Alireza,19,0,30,11
1649964084323,MATH 120A,A01,085445,Eggers; John Dietrich,18,0,35,17
1649964084323,MATH 120A,A02,085446,Eggers; John Dietrich,27,0,35,8
1649964090351,MATH 142B,A01,084149,Verstraete; Jacques Allan,0,12,30,30
1649964090351,MATH 142B,A02,084150,Verstraete; Jacques Allan,0,12,30,30
1649964096381,MATH 170A,A01,083459,Nie; Jiawang,0,4,30,30
1649964096381,MATH 170A,A02,083460,Nie; Jiawang,0,3,30,30
1649964096381,MATH 170A,A03,083461,Nie; Jiawang,0,4,30,30
1649964102416,MATH 193B,A01,083463,Staff,1,0,30,29
1649964102416,MATH 193B,A02,083464,Staff,10,0,30,20
1649964102416,MATH 193B,A03,083465,Staff,18,0,30,12
1649964108472,COGS 2,A01,083966,Boyle; Mary E. T.,17,0,30,13
1649964114499,COGS 9,A01,083968,Staff,34,0,60,26
1649964120535,COGS 14B,A01,083970,Staff,21,0,50,29
1649964126661,COGS 17,A01,092679,Staff,62,0,75,13
1649964132694,COGS 100,A01,083972,Staff,0,5,60,60
1649964144750,COGS 101C,A01,083976,Staff,17,0,30,13
1649964150798,COGS 102A,A01,083978,Johnson; Christine M.,14,0,30,16
1649964156834,COGS 107B,A01,083980,Staff,0,2,50,50
1649964162857,COGS 115,A01,083982,Staff,12,0,30,18
1649964168885,COGS 118B,A01,083367,Staff,0,11,40,40
1649964174908,COGS 172,A01,083984,Provenzano; Emily Kara,16,0,30,14
1649964180934,COGS 177,A00,083368,Staff,0,19,30,30
1649964186966,COGS 186,A01,083986,Staff,21,0,40,19
1649964192991,COGS 187A,A01,083988,Boyle; Mary E. T.,21,0,60,39
1649964199026,CSE 8A,A50,084003,Miranda; Gregory Joseph,0,4,15,15
1649964205051,CSE 11,A01,084005,Miranda; Gregory Joseph,8,0,55,47
1649964211100,CSE 20,A01,084007,Staff,5,0,20,15
1649964217124,CSE 21,A01,084009,Staff,0,7,50,50
1649964223148,CSE 30,A01,083370,Cao; Yingjun,0,40,40,40
1649964229174,CSE 100,A01,083372,Cao; Yingjun,0,41,40,40
1649964235205,CSE 101,A01,084011,Staff,0,54,40,40
1649964241236,CSE 141,A01,083374,Eldon; John,0,56,75,75
1649964247263,CSE 141L,A01,083376,Eldon; John,0,61,75,75
1649964253311,CSE 175,A01,084013,Kumar; Rakesh,22,0,25,3
1649964259333,CSE 190,A00,092508,Dubnov; Shlomo,15,0,15,0
1649964265360,ECE 5,A01,084049,Morris; Karcher William,15,0,20,5
1649964271386,ECE 100,A01,084051,Baghdadchi; Saharnaz,0,0,20,20
1649964271386,ECE 100,A02,091916,Baghdadchi; Saharnaz,15,0,20,5
1649964277420,ECE 101,A01,084053,Baghdadchi; Saharnaz,3,0,37,34
1649964277420,ECE 101,A02,084054,Baghdadchi; Saharnaz,31,0,37,6
1649964283456,ECE 107,A01,083390,Staff,28,0,40,12
1649964289479,ECE 148,A01,084056,Silberman; Jack,7,0,12,5
1649964295505,ECE 180,A00,083391,Abi Samra; Nicholas Camill,25,0,30,5
1649964295505,ECE 180,B00,083392,Abi Samra; Nicholas Camill,22,0,30,8
1649964301530,MATH 10B,A01,084110,Staff,8,0,30,22
1649964301530,MATH 10B,A02,084111,Staff,29,0,30,1
1649964301530,MATH 10B,A03,084112,Staff,26,0,30,4
1649964307571,MATH 10C,A01,083443,Staff,2,0,30,28
1649964307571,MATH 10C,A02,083444,Staff,12,0,30,18
1649964307571,MATH 10C,B01,084114,Staff,25,0,30,5
1649964307571,MATH 10C,B02,084115,Staff,28,0,30,2
1649964313600,MATH 18,A01,084117,Harel; Guershon,25,0,30,5
1649964313600,MATH 18,A02,084119,Harel; Guershon,27,0,30,3
1649964313600,MATH 18,A03,084120,Harel; Guershon,30,0,30,0
1649964313600,MATH 18,A04,084121,Harel; Guershon,29,0,30,1
1649964319647,MATH 20B,A01,084124,Um; Ko Woon,31,0,35,4
1649964319647,MATH 20B,B01,084126,Um; Ko Woon,31,0,35,4
1649964325678,MATH 20C,A01,083446,Hammock; Frances H,12,0,30,18
1649964325678,MATH 20C,A02,083447,Hammock; Frances H,28,0,30,2
1649964325678,MATH 20C,A03,083448,Hammock; Frances H,28,0,30,2
1649964325678,MATH 20C,A04,083449,Hammock; Frances H,30,0,30,0
1649964325678,MATH 20C,B01,083451,Hammock; Frances H,21,0,30,9
1649964325678,MATH 20C,B02,083452,Hammock; Frances H,26,0,30,4
1649964325678,MATH 20C,B03,083453,Hammock; Frances H,26,0,30,4
1649964325678,MATH 20C,B04,083454,Hammock; Frances H,30,0,30,0
1649964331704,MATH 20D,A01,084128,Staff,23,0,30,7
1649964331704,MATH 20D,A02,084129,Staff,30,0,30,0
1649964331704,MATH 20D,A03,084130,Staff,27,0,30,3
1649964331704,MATH 20D,B01,084133,Staff,13,0,30,17
1649964331704,MATH 20D,B02,084134,Staff,25,0,30,5
1649964331704,MATH 20D,B03,084135,Staff,30,0,30,0
1649964337727,MATH 20E,A01,084138,Staff,21,0,30,9
1649964337727,MATH 20E,A02,084139,Staff,15,0,30,15
1649964337727,MATH 20E,A03,084140,Staff,20,0,30,10
1649964337727,MATH 20E,A04,084141,Staff,24,0,30,6
1649964343754,MATH 102,A01,084143,Harel; Guershon,16,0,30,14
1649964343754,MATH 102,A02,084144,Harel; Guershon,21,0,30,9
1649964349777,MATH 103B,A01,083456,Staff,0,12,30,30
1649964349777,MATH 103B,A02,083457,Staff,0,12,30,30
1649964355800,MATH 109,A01,084146,Salehi Golsefidy; Alireza,26,0,30,4
1649964355800,MATH 109,A02,084147,Salehi Golsefidy; Alireza,19,0,30,11
1649964361845,MATH 120A,A01,085445,Eggers; John Dietrich,18,0,35,17
1649964361845,MATH 120A,A02,085446,Eggers; John Dietrich,27,0,35,8
1649964367880,MATH 142B,A01,084149,Verstraete; Jacques Allan,0,12,30,30
1649964367880,MATH 142B,A02,084150,Verstraete; Jacques Allan,0,12,30,30
1649964373908,MATH 170A,A01,083459,Nie; Jiawang,0,4,30,30
1649964373908,MATH 170A,A02,083460,Nie; Jiawang,0,3,30,30
1649964373908,MATH 170A,A03,083461,Nie; Jiawang,0,4,30,30
1649964379934,MATH 193B,A01,083463,Staff,1,0,30,29
1649964379934,MATH 193B,A02,083464,Staff,10,0,30,20
1649964379934,MATH 193B,A03,083465,Staff,18,0,30,12
1649964385999,COGS 2,A01,083966,Boyle; Mary E. T.,17,0,30,13
1649964392023,COGS 9,A01,083968,Staff,34,0,60,26
1649964398050,COGS 14B,A01,083970,Staff,21,0,50,29
1649964404077,COGS 17,A01,092679,Staff,62,0,75,13
1649964410105,COGS 100,A01,083972,Staff,0,5,60,60
1649964422158,COGS 101C,A01,083976,Staff,17,0,30,13
1649964428191,COGS 102A,A01,083978,Johnson; Christine M.,14,0,30,16
1649964434227,COGS 107B,A01,083980,Staff,0,2,50,50
1649964440259,COGS 115,A01,083982,Staff,12,0,30,18
1649964446285,COGS 118B,A01,083367,Staff,0,11,40,40
1649964452313,COGS 172,A01,083984,Provenzano; Emily Kara,16,0,30,14
1649964458336,COGS 177,A00,083368,Staff,0,19,30,30
1649964464370,COGS 186,A01,083986,Staff,21,0,40,19
1649964470402,COGS 187A,A01,083988,Boyle; Mary E. T.,21,0,60,39
1649964476430,CSE 8A,A50,084003,Miranda; Gregory Joseph,0,4,15,15
1649964482454,CSE 11,A01,084005,Miranda; Gregory Joseph,8,0,55,47
1649964488477,CSE 20,A01,084007,Staff,5,0,20,15
1649964494503,CSE 21,A01,084009,Staff,0,7,50,50
1649964500528,CSE 30,A01,083370,Cao; Yingjun,0,40,40,40
1649964506551,CSE 100,A01,083372,Cao; Yingjun,0,41,40,40
1649964512580,CSE 101,A01,084011,Staff,0,54,40,40
1649964518618,CSE 141,A01,083374,Eldon; John,0,56,75,75
1649964524660,CSE 141L,A01,083376,Eldon; John,0,61,75,75
1649964530685,CSE 175,A01,084013,Kumar; Rakesh,22,0,25,3
1649964536710,CSE 190,A00,092508,Dubnov; Shlomo,15,0,15,0
1649964542734,ECE 5,A01,084049,Morris; Karcher William,15,0,20,5
1649964548757,ECE 100,A01,084051,Baghdadchi; Saharnaz,0,0,20,20
1649964548757,ECE 100,A02,091916,Baghdadchi; Saharnaz,15,0,20,5
1649964554787,ECE 101,A01,084053,Baghdadchi; Saharnaz,3,0,37,34
1649964554787,ECE 101,A02,084054,Baghdadchi; Saharnaz,31,0,37,6
1649964560820,ECE 107,A01,083390,Staff,28,0,40,12
1649964566843,ECE 148,A01,084056,Silberman; Jack,7,0,12,5
1649964572872,ECE 180,A00,083391,Abi Samra; Nicholas Camill,25,0,30,5
1649964572872,ECE 180,B00,083392,Abi Samra; Nicholas Camill,22,0,30,8
1649964578898,MATH 10B,A01,084110,Staff,8,0,30,22
1649964578898,MATH 10B,A02,084111,Staff,29,0,30,1
1649964578898,MATH 10B,A03,084112,Staff,26,0,30,4
1649964584922,MATH 10C,A01,083443,Staff,2,0,30,28
1649964584922,MATH 10C,A02,083444,Staff,12,0,30,18
1649964584922,MATH 10C,B01,084114,Staff,25,0,30,5
1649964584922,MATH 10C,B02,084115,Staff,28,0,30,2
1649964590949,MATH 18,A01,084117,Harel; Guershon,25,0,30,5
1649964590949,MATH 18,A02,084119,Harel; Guershon,27,0,30,3
1649964590949,MATH 18,A03,084120,Harel; Guershon,30,0,30,0
1649964590949,MATH 18,A04,084121,Harel; Guershon,29,0,30,1
1649964596975,MATH 20B,A01,084124,Um; Ko Woon,31,0,35,4
1649964596975,MATH 20B,B01,084126,Um; Ko Woon,31,0,35,4
1649964603008,MATH 20C,A01,083446,Hammock; Frances H,12,0,30,18
1649964603008,MATH 20C,A02,083447,Hammock; Frances H,28,0,30,2
1649964603008,MATH 20C,A03,083448,Hammock; Frances H,28,0,30,2
1649964603008,MATH 20C,A04,083449,Hammock; Frances H,30,0,30,0
1649964603008,MATH 20C,B01,083451,Hammock; Frances H,21,0,30,9
1649964603008,MATH 20C,B02,083452,Hammock; Frances H,26,0,30,4
1649964603008,MATH 20C,B03,083453,Hammock; Frances H,26,0,30,4
1649964603008,MATH 20C,B04,083454,Hammock; Frances H,30,0,30,0
1649964609055,MATH 20D,A01,084128,Staff,23,0,30,7
1649964609055,MATH 20D,A02,084129,Staff,30,0,30,0
1649964609055,MATH 20D,A03,084130,Staff,27,0,30,3
1649964609055,MATH 20D,B01,084133,Staff,13,0,30,17
1649964609055,MATH 20D,B02,084134,Staff,25,0,30,5
1649964609055,MATH 20D,B03,084135,Staff,30,0,30,0
1649964615101,MATH 20E,A01,084138,Staff,21,0,30,9
1649964615101,MATH 20E,A02,084139,Staff,15,0,30,15
1649964615101,MATH 20E,A03,084140,Staff,20,0,30,10
1649964615101,MATH 20E,A04,084141,Staff,24,0,30,6
1649964621137,MATH 102,A01,084143,Harel; Guershon,16,0,30,14
1649964621137,MATH 102,A02,084144,Harel; Guershon,21,0,30,9
1649964627162,MATH 103B,A01,083456,Staff,0,12,30,30
1649964627162,MATH 103B,A02,083457,Staff,0,12,30,30
1649964633194,MATH 109,A01,084146,Salehi Golsefidy; Alireza,26,0,30,4
1649964633194,MATH 109,A02,084147,Salehi Golsefidy; Alireza,19,0,30,11
1649964639226,MATH 120A,A01,085445,Eggers; John Dietrich,18,0,35,17
1649964639226,MATH 120A,A02,085446,Eggers; John Dietrich,27,0,35,8
1649964645248,MATH 142B,A01,084149,Verstraete; Jacques Allan,0,12,30,30
1649964645248,MATH 142B,A02,084150,Verstraete; Jacques Allan,0,12,30,30
1649964651271,MATH 170A,A01,083459,Nie; Jiawang,0,4,30,30
1649964651271,MATH 170A,A02,083460,Nie; Jiawang,0,3,30,30
1649964651271,MATH 170A,A03,083461,Nie; Jiawang,0,4,30,30
1649964657297,MATH 193B,A01,083463,Staff,1,0,30,29
1649964657297,MATH 193B,A02,083464,Staff,10,0,30,20
1649964657297,MATH 193B,A03,083465,Staff,18,0,30,12
1649964663449,COGS 2,A01,083966,Boyle; Mary E. T.,17,0,30,13
1649964669472,COGS 9,A01,083968,Staff,34,0,60,26
1649964675494,COGS 14B,A01,083970,Staff,21,0,50,29
1649964681523,COGS 17,A01,092679,Staff,62,0,75,13
1649964687546,COGS 100,A01,083972,Staff,0,5,60,60
1649964699598,COGS 101C,A01,083976,Staff,17,0,30,13
1649964705623,COGS 102A,A01,083978,Johnson; Christine M.,14,0,30,16
1649964711659,COGS 107B,A01,083980,Staff,0,2,50,50
1649964717686,COGS 115,A01,083982,Staff,12,0,30,18
1649964723815,COGS 118B,A01,083367,Staff,0,11,40,40
1649964729854,COGS 172,A01,083984,Provenzano; Emily Kara,16,0,30,14
1649964735878,COGS 177,A00,083368,Staff,0,19,30,30
1649964741904,COGS 186,A01,083986,Staff,21,0,40,19
1649964747938,COGS 187A,A01,083988,Boyle; Mary E. T.,20,0,60,40
1649964753966,CSE 8A,A50,084003,Miranda; Gregory Joseph,0,4,15,15
1649964759995,CSE 11,A01,084005,Miranda; Gregory Joseph,6,0,55,49
1649964766021,CSE 20,A01,084007,Staff,5,0,20,15
1649964772047,CSE 21,A01,084009,Staff,0,8,50,50
1649964778072,CSE 30,A01,083370,Cao; Yingjun,0,41,40,40
1649964784096,CSE 100,A01,083372,Cao; Yingjun,0,41,40,40
1649964790123,CSE 101,A01,084011,Staff,0,54,40,40
1649964796157,CSE 141,A01,083374,Eldon; John,0,56,75,75
1649964802189,CSE 141L,A01,083376,Eldon; John,0,61,75,75
1649964808217,CSE 175,A01,084013,Kumar; Rakesh,22,0,25,3
1649964814248,CSE 190,A00,092508,Dubnov; Shlomo,15,0,15,0
1649964820272,ECE 5,A01,084049,Morris; Karcher William,15,0,20,5
1649964826307,ECE 100,A01,084051,Baghdadchi; Saharnaz,0,0,20,20
1649964826307,ECE 100,A02,091916,Baghdadchi; Saharnaz,15,0,20,5
1649964832340,ECE 101,A01,084053,Baghdadchi; Saharnaz,3,0,37,34
1649964832340,ECE 101,A02,084054,Baghdadchi; Saharnaz,31,0,37,6
1649964838364,ECE 107,A01,083390,Staff,28,0,40,12
1649964844390,ECE 148,A01,084056,Silberman; Jack,7,0,12,5
1649964850419,ECE 180,A00,083391,Abi Samra; Nicholas Camill,25,0,30,5
1649964850419,ECE 180,B00,083392,Abi Samra; Nicholas Camill,22,0,30,8
1649964856443,MATH 10B,A01,084110,Staff,8,0,30,22
1649964856443,MATH 10B,A02,084111,Staff,29,0,30,1
1649964856443,MATH 10B,A03,084112,Staff,26,0,30,4
1649964862471,MATH 10C,A01,083443,Staff,2,0,30,28
1649964862471,MATH 10C,A02,083444,Staff,12,0,30,18
1649964862471,MATH 10C,B01,084114,Staff,25,0,30,5
1649964862471,MATH 10C,B02,084115,Staff,28,0,30,2
1649964868508,MATH 18,A01,084117,Harel; Guershon,25,0,30,5
1649964868508,MATH 18,A02,084119,Harel; Guershon,27,0,30,3
1649964868508,MATH 18,A03,084120,Harel; Guershon,30,0,30,0
1649964868508,MATH 18,A04,084121,Harel; Guershon,29,0,30,1
1649964874536,MATH 20B,A01,084124,Um; Ko Woon,31,0,35,4
1649964874536,MATH 20B,B01,084126,Um; Ko Woon,31,0,35,4
1649964880566,MATH 20C,A01,083446,Hammock; Frances H,12,0,30,18
1649964880566,MATH 20C,A02,083447,Hammock; Frances H,28,0,30,2
1649964880566,MATH 20C,A03,083448,Hammock; Frances H,28,0,30,2
1649964880566,MATH 20C,A04,083449,Hammock; Frances H,30,0,30,0
1649964880566,MATH 20C,B01,083451,Hammock; Frances H,21,0,30,9
1649964880566,MATH 20C,B02,083452,Hammock; Frances H,26,0,30,4
1649964880566,MATH 20C,B03,083453,Hammock; Frances H,26,0,30,4
1649964880566,MATH 20C,B04,083454,Hammock; Frances H,30,0,30,0
1649964886591,MATH 20D,A01,084128,Staff,23,0,30,7
1649964886591,MATH 20D,A02,084129,Staff,30,0,30,0
1649964886591,MATH 20D,A03,084130,Staff,27,0,30,3
1649964886591,MATH 20D,B01,084133,Staff,13,0,30,17
1649964886591,MATH 20D,B02,084134,Staff,25,0,30,5
1649964886591,MATH 20D,B03,084135,Staff,30,0,30,0
1649964892613,MATH 20E,A01,084138,Staff,21,0,30,9
1649964892613,MATH 20E,A02,084139,Staff,15,0,30,15
1649964892613,MATH 20E,A03,084140,Staff,20,0,30,10
1649964892613,MATH 20E,A04,084141,Staff,24,0,30,6
1649964898669,MATH 102,A01,084143,Harel; Guershon,16,0,30,14
1649964898669,MATH 102,A02,084144,Harel; Guershon,21,0,30,9
1649964904696,MATH 103B,A01,083456,Staff,0,12,30,30
1649964904696,MATH 103B,A02,083457,Staff,0,12,30,30
1649964910723,MATH 109,A01,084146,Salehi Golsefidy; Alireza,25,0,30,5
1649964910723,MATH 109,A02,084147,Salehi Golsefidy; Alireza,19,0,30,11
1649964916752,MATH 120A,A01,085445,Eggers; John Dietrich,18,0,35,17
1649964916752,MATH 120A,A02,085446,Eggers; John Dietrich,27,0,35,8
1649964922774,MATH 142B,A01,084149,Verstraete; Jacques Allan,0,12,30,30
1649964922774,MATH 142B,A02,084150,Verstraete; Jacques Allan,0,12,30,30
1649964928805,MATH 170A,A01,083459,Nie; Jiawang,0,4,30,30
1649964928805,MATH 170A,A02,083460,Nie; Jiawang,0,3,30,30
1649964928805,MATH 170A,A03,083461,Nie; Jiawang,0,4,30,30
1649964934836,MATH 193B,A01,083463,Staff,1,0,30,29
1649964934836,MATH 193B,A02,083464,Staff,10,0,30,20
1649964934836,MATH 193B,A03,083465,Staff,18,0,30,12
1649964940895,COGS 2,A01,083966,Boyle; Mary E. T.,17,0,30,13
1649964946918,COGS 9,A01,083968,Staff,33,0,60,27
1649964952957,COGS 14B,A01,083970,Staff,21,0,50,29
1649964958980,COGS 17,A01,092679,Staff,61,0,75,14
1649964965004,COGS 100,A01,083972,Staff,0,5,60,60
1649964977069,COGS 101C,A01,083976,Staff,17,0,30,13
1649964983092,COGS 102A,A01,083978,Johnson; Christine M.,14,0,30,16
1649964989138,COGS 107B,A01,083980,Staff,0,2,50,50
1649964995163,COGS 115,A01,083982,Staff,12,0,30,18
1649965001204,COGS 118B,A01,083367,Staff,0,11,40,40
1649965007238,COGS 172,A01,083984,Provenzano; Emily Kara,16,0,30,14
1649965013271,COGS 177,A00,083368,Staff,0,19,30,30
1649965019296,COGS 186,A01,083986,Staff,21,0,40,19
1649965025346,COGS 187A,A01,083988,Boyle; Mary E. T.,20,0,60,40
1649965031371,CSE 8A,A50,084003,Miranda; Gregory Joseph,0,4,15,15
1649965037397,CSE 11,A01,084005,Miranda; Gregory Joseph,6,0,55,49
1649965043419,CSE 20,A01,084007,Staff,5,0,20,15
1649965049451,CSE 21,A01,084009,Staff,0,8,50,50
1649965055483,CSE 30,A01,083370,Cao; Yingjun,0,42,40,40
1649965061509,CSE 100,A01,083372,Cao; Yingjun,0,41,40,40
1649965067546,CSE 101,A01,084011,Staff,0,54,40,40
1649965073576,CSE 141,A01,083374,Eldon; John,0,56,75,75
1649965079600,CSE 141L,A01,083376,Eldon; John,0,61,75,75
1649965085623,CSE 175,A01,084013,Kumar; Rakesh,22,0,25,3
1649965091659,CSE 190,A00,092508,Dubnov; Shlomo,15,0,15,0
1649965097682,ECE 5,A01,084049,Morris; Karcher William,15,0,20,5
1649965103718,ECE 100,A01,084051,Baghdadchi; Saharnaz,0,0,20,20
1649965103718,ECE 100,A02,091916,Baghdadchi; Saharnaz,15,0,20,5
1649965109752,ECE 101,A01,084053,Baghdadchi; Saharnaz,3,0,37,34
1649965109752,ECE 101,A02,084054,Baghdadchi; Saharnaz,31,0,37,6
1649965115782,ECE 107,A01,083390,Staff,28,0,40,12
1649965121808,ECE 148,A01,084056,Silberman; Jack,7,0,12,5
1649965127846,ECE 180,A00,083391,Abi Samra; Nicholas Camill,25,0,30,5
1649965127846,ECE 180,B00,083392,Abi Samra; Nicholas Camill,22,0,30,8
1649965133880,MATH 10B,A01,084110,Staff,8,0,30,22
1649965133880,MATH 10B,A02,084111,Staff,29,0,30,1
1649965133880,MATH 10B,A03,084112,Staff,26,0,30,4
1649965139910,MATH 10C,A01,083443,Staff,1,0,30,29
1649965139910,MATH 10C,A02,083444,Staff,12,0,30,18
1649965139910,MATH 10C,B01,084114,Staff,25,0,30,5
1649965139910,MATH 10C,B02,084115,Staff,28,0,30,2
1649965145943,MATH 18,A01,084117,Harel; Guershon,25,0,30,5
1649965145943,MATH 18,A02,084119,Harel; Guershon,27,0,30,3
1649965145943,MATH 18,A03,084120,Harel; Guershon,30,0,30,0
1649965145943,MATH 18,A04,084121,Harel; Guershon,29,0,30,1
1649965151966,MATH 20B,A01,084124,Um; Ko Woon,31,0,35,4
1649965151966,MATH 20B,B01,084126,Um; Ko Woon,31,0,35,4
1649965157991,MATH 20C,A01,083446,Hammock; Frances H,12,0,30,18
1649965157991,MATH 20C,A02,083447,Hammock; Frances H,28,0,30,2
1649965157991,MATH 20C,A03,083448,Hammock; Frances H,28,0,30,2
1649965157991,MATH 20C,A04,083449,Hammock; Frances H,30,0,30,0
1649965157991,MATH 20C,B01,083451,Hammock; Frances H,20,0,30,10
1649965157991,MATH 20C,B02,083452,Hammock; Frances H,26,0,30,4
1649965157991,MATH 20C,B03,083453,Hammock; Frances H,26,0,30,4
1649965157991,MATH 20C,B04,083454,Hammock; Frances H,30,0,30,0
1649965164014,MATH 20D,A01,084128,Staff,23,0,30,7
1649965164014,MATH 20D,A02,084129,Staff,30,0,30,0
1649965164014,MATH 20D,A03,084130,Staff,27,0,30,3
1649965164014,MATH 20D,B01,084133,Staff,13,0,30,17
1649965164014,MATH 20D,B02,084134,Staff,25,0,30,5
1649965164014,MATH 20D,B03,084135,Staff,30,0,30,0
1649965170056,MATH 20E,A01,084138,Staff,20,0,30,10
1649965170056,MATH 20E,A02,084139,Staff,15,0,30,15
1649965170056,MATH 20E,A03,084140,Staff,20,0,30,10
1649965170056,MATH 20E,A04,084141,Staff,24,0,30,6
1649965176079,MATH 102,A01,084143,Harel; Guershon,16,0,30,14
1649965176079,MATH 102,A02,084144,Harel; Guershon,21,0,30,9
1649965182120,MATH 103B,A01,083456,Staff,0,12,30,30
1649965182120,MATH 103B,A02,083457,Staff,0,12,30,30
1649965188143,MATH 109,A01,084146,Salehi Golsefidy; Alireza,25,0,30,5
1649965188143,MATH 109,A02,084147,Salehi Golsefidy; Alireza,19,0,30,11
1649965194171,MATH 120A,A01,085445,Eggers; John Dietrich,18,0,35,17
1649965194171,MATH 120A,A02,085446,Eggers; John Dietrich,27,0,35,8
1649965200197,MATH 142B,A01,084149,Verstraete; Jacques Allan,0,12,30,30
1649965200197,MATH 142B,A02,084150,Verstraete; Jacques Allan,0,12,30,30
1649965206220,MATH 170A,A01,083459,Nie; Jiawang,0,4,30,30
1649965206220,MATH 170A,A02,083460,Nie; Jiawang,0,3,30,30
1649965206220,MATH 170A,A03,083461,Nie; Jiawang,0,4,30,30
1649965212242,MATH 193B,A01,083463,Staff,1,0,30,29
1649965212242,MATH 193B,A02,083464,Staff,10,0,30,20
1649965212242,MATH 193B,A03,083465,Staff,18,0,30,12
1649965218313,COGS 2,A01,083966,Boyle; Mary E. T.,17,0,30,13
1649965224343,COGS 9,A01,083968,Staff,33,0,60,27
1649965230366,COGS 14B,A01,083970,Staff,21,0,50,29
1649965236389,COGS 17,A01,092679,Staff,60,0,75,15
1649965242426,COGS 100,A01,083972,Staff,0,5,60,60
1649965254498,COGS 101C,A01,083976,Staff,17,0,30,13
1649965260527,COGS 102A,A01,083978,Johnson; Christine M.,14,0,30,16
1649965266552,COGS 107B,A01,083980,Staff,0,2,50,50
1649965272583,COGS 115,A01,083982,Staff,12,0,30,18
1649965278613,COGS 118B,A01,083367,Staff,0,11,40,40
1649965284636,COGS 172,A01,083984,Provenzano; Emily Kara,16,0,30,14
1649965290659,COGS 177,A00,083368,Staff,0,19,30,30
1649965296697,COGS 186,A01,083986,Staff,21,0,40,19
1649965302723,COGS 187A,A01,083988,Boyle; Mary E. T.,20,0,60,40
1649965308752,CSE 8A,A50,084003,Miranda; Gregory Joseph,0,4,15,15
1649965314775,CSE 11,A01,084005,Miranda; Gregory Joseph,5,0,55,50
1649965320879,CSE 20,A01,084007,Staff,5,0,20,15
1649965326915,CSE 21,A01,084009,Staff,0,9,50,50
1649965332948,CSE 30,A01,083370,Cao; Yingjun,0,44,40,40
1649965338976,CSE 100,A01,083372,Cao; Yingjun,0,41,40,40
1649965344997,CSE 101,A01,084011,Staff,0,54,40,40
1649965351020,CSE 141,A01,083374,Eldon; John,0,56,75,75
1649965357057,CSE 141L,A01,083376,Eldon; John,0,61,75,75
1649965363101,CSE 175,A01,084013,Kumar; Rakesh,22,0,25,3
1649965369132,CSE 190,A00,092508,Dubnov; Shlomo,15,0,15,0
1649965375159,ECE 5,A01,084049,Morris; Karcher William,15,0,20,5
1649965381183,ECE 100,A01,084051,Baghdadchi; Saharnaz,0,0,20,20
1649965381183,ECE 100,A02,091916,Baghdadchi; Saharnaz,15,0,20,5
1649965387211,ECE 101,A01,084053,Baghdadchi; Saharnaz,3,0,37,34
1649965387211,ECE 101,A02,084054,Baghdadchi; Saharnaz,31,0,37,6
1649965393241,ECE 107,A01,083390,Staff,28,0,40,12
1649965399278,ECE 148,A01,084056,Silberman; Jack,7,0,12,5
1649965405305,ECE 180,A00,083391,Abi Samra; Nicholas Camill,25,0,30,5
1649965405305,ECE 180,B00,083392,Abi Samra; Nicholas Camill,22,0,30,8
1649965411339,MATH 10B,A01,084110,Staff,8,0,30,22
1649965411339,MATH 10B,A02,084111,Staff,29,0,30,1
1649965411339,MATH 10B,A03,084112,Staff,26,0,30,4
1649965417368,MATH 10C,A01,083443,Staff,1,0,30,29
1649965417368,MATH 10C,A02,083444,Staff,12,0,30,18
1649965417368,MATH 10C,B01,084114,Staff,25,0,30,5
1649965417368,MATH 10C,B02,084115,Staff,28,0,30,2
1649965423391,MATH 18,A01,084117,Harel; Guershon,25,0,30,5
1649965423391,MATH 18,A02,084119,Harel; Guershon,28,0,30,2
1649965423391,MATH 18,A03,084120,Harel; Guershon,30,0,30,0
1649965423391,MATH 18,A04,084121,Harel; Guershon,29,0,30,1
1649965429416,MATH 20B,A01,084124,Um; Ko Woon,31,0,35,4
1649965429416,MATH 20B,B01,084126,Um; Ko Woon,31,0,35,4
1649965435448,MATH 20C,A01,083446,Hammock; Frances H,12,0,30,18
1649965435448,MATH 20C,A02,083447,Hammock; Frances H,28,0,30,2
1649965435448,MATH 20C,A03,083448,Hammock; Frances H,28,0,30,2
1649965435448,MATH 20C,A04,083449,Hammock; Frances H,30,0,30,0
1649965435448,MATH 20C,B01,083451,Hammock; Frances H,20,0,30,10
1649965435448,MATH 20C,B02,083452,Hammock; Frances H,26,0,30,4
1649965435448,MATH 20C,B03,083453,Hammock; Frances H,26,0,30,4
1649965435448,MATH 20C,B04,083454,Hammock; Frances H,30,0,30,0
1649965441471,MATH 20D,A01,084128,Staff,23,0,30,7
1649965441471,MATH 20D,A02,084129,Staff,30,0,30,0
1649965441471,MATH 20D,A03,084130,Staff,27,0,30,3
1649965441471,MATH 20D,B01,084133,Staff,12,0,30,18
1649965441471,MATH 20D,B02,084134,Staff,25,0,30,5
1649965441471,MATH 20D,B03,084135,Staff,30,0,30,0
1649965447496,MATH 20E,A01,084138,Staff,20,0,30,10
1649965447496,MATH 20E,A02,084139,Staff,15,0,30,15
1649965447496,MATH 20E,A03,084140,Staff,20,0,30,10
1649965447496,MATH 20E,A04,084141,Staff,24,0,30,6
1649965453525,MATH 102,A01,084143,Harel; Guershon,16,0,30,14
1649965453525,MATH 102,A02,084144,Harel; Guershon,21,0,30,9
1649965459555,MATH 103B,A01,083456,Staff,0,12,30,30
1649965459555,MATH 103B,A02,083457,Staff,0,12,30,30
1649965465579,MATH 109,A01,084146,Salehi Golsefidy; Alireza,25,0,30,5
1649965465579,MATH 109,A02,084147,Salehi Golsefidy; Alireza,19,0,30,11
1649965471610,MATH 120A,A01,085445,Eggers; John Dietrich,18,0,35,17
1649965471610,MATH 120A,A02,085446,Eggers; John Dietrich,27,0,35,8
1649965477639,MATH 142B,A01,084149,Verstraete; Jacques Allan,0,12,30,30
1649965477639,MATH 142B,A02,084150,Verstraete; Jacques Allan,0,12,30,30
1649965483665,MATH 170A,A01,083459,Nie; Jiawang,0,4,30,30
1649965483665,MATH 170A,A02,083460,Nie; Jiawang,0,3,30,30
1649965483665,MATH 170A,A03,083461,Nie; Jiawang,0,4,30,30
1649965489688,MATH 193B,A01,083463,Staff,1,0,30,29
1649965489688,MATH 193B,A02,083464,Staff,10,0,30,20
1649965489688,MATH 193B,A03,083465,Staff,18,0,30,12
1649965495751,COGS 2,A01,083966,Boyle; Mary E. T.,17,0,30,13
1649965501785,COGS 9,A01,083968,Staff,33,0,60,27
1649965507809,COGS 14B,A01,083970,Staff,21,0,50,29
1649965513835,COGS 17,A01,092679,Staff,60,0,75,15
1649965519861,COGS 100,A01,083972,Staff,0,5,60,60
1649965531926,COGS 101C,A01,083976,Staff,16,0,30,14
1649965537948,COGS 102A,A01,083978,Johnson; Christine M.,14,0,30,16
1649965543985,COGS 107B,A01,083980,Staff,0,2,50,50
1649965550010,COGS 115,A01,083982,Staff,12,0,30,18
1649965556042,COGS 118B,A01,083367,Staff,0,11,40,40
1649965562069,COGS 172,A01,083984,Provenzano; Emily Kara,16,0,30,14
1649965568098,COGS 177,A00,083368,Staff,0,19,30,30
1649965574133,COGS 186,A01,083986,Staff,21,0,40,19
1649965580156,COGS 187A,A01,083988,Boyle; Mary E. T.,20,0,60,40
1649965586190,CSE 8A,A50,084003,Miranda; Gregory Joseph,0,4,15,15
1649965592217,CSE 11,A01,084005,Miranda; Gregory Joseph,2,0,55,53
1649965598242,CSE 20,A01,084007,Staff,5,0,20,15
1649965604271,CSE 21,A01,084009,Staff,0,10,50,50
1649965610301,CSE 30,A01,083370,Cao; Yingjun,0,44,40,40
1649965616332,CSE 100,A01,083372,Cao; Yingjun,0,41,40,40
1649965622356,CSE 101,A01,084011,Staff,0,54,40,40
1649965628384,CSE 141,A01,083374,Eldon; John,0,56,75,75
1649965634421,CSE 141L,A01,083376,Eldon; John,0,61,75,75
1649965640467,CSE 175,A01,084013,Kumar; Rakesh,22,0,25,3
1649965646498,CSE 190,A00,092508,Dubnov; Shlomo,15,0,15,0
1649965652521,ECE 5,A01,084049,Morris; Karcher William,15,0,20,5
1649965658550,ECE 100,A01,084051,Baghdadchi; Saharnaz,0,0,20,20
1649965658550,ECE 100,A02,091916,Baghdadchi; Saharnaz,15,0,20,5
1649965664573,ECE 101,A01,084053,Baghdadchi; Saharnaz,3,0,37,34
1649965664573,ECE 101,A02,084054,Baghdadchi; Saharnaz,31,0,37,6
1649965670605,ECE 107,A01,083390,Staff,28,0,40,12
1649965676628,ECE 148,A01,084056,Silberman; Jack,7,0,12,5
1649965682651,ECE 180,A00,083391,Abi Samra; Nicholas Camill,25,0,30,5
1649965682651,ECE 180,B00,083392,Abi Samra; Nicholas Camill,22,0,30,8
1649965688675,MATH 10B,A01,084110,Staff,8,0,30,22
1649965688675,MATH 10B,A02,084111,Staff,29,0,30,1
1649965688675,MATH 10B,A03,084112,Staff,26,0,30,4
1649965694711,MATH 10C,A01,083443,Staff,1,0,30,29
1649965694711,MATH 10C,A02,083444,Staff,12,0,30,18
1649965694711,MATH 10C,B01,084114,Staff,25,0,30,5
1649965694711,MATH 10C,B02,084115,Staff,28,0,30,2
1649965700739,MATH 18,A01,084117,Harel; Guershon,25,0,30,5
1649965700739,MATH 18,A02,084119,Harel; Guershon,28,0,30,2
1649965700739,MATH 18,A03,084120,Harel; Guershon,30,0,30,0
1649965700739,MATH 18,A04,084121,Harel; Guershon,29,0,30,1
1649965706762,MATH 20B,A01,084124,Um; Ko Woon,31,0,35,4
1649965706762,MATH 20B,B01,084126,Um; Ko Woon,31,0,35,4
1649965712787,MATH 20C,A01,083446,Hammock; Frances H,12,0,30,18
1649965712787,MATH 20C,A02,083447,Hammock; Frances H,28,0,30,2
1649965712787,MATH 20C,A03,083448,Hammock; Frances H,28,0,30,2
1649965712787,MATH 20C,A04,083449,Hammock; Frances H,30,0,30,0
1649965712787,MATH 20C,B01,083451,Hammock; Frances H,20,0,30,10
1649965712787,MATH 20C,B02,083452,Hammock; Frances H,26,0,30,4
1649965712787,MATH 20C,B03,083453,Hammock; Frances H,26,0,30,4
1649965712787,MATH 20C,B04,083454,Hammock; Frances H,30,0,30,0
1649965718816,MATH 20D,A01,084128,Staff,23,0,30,7
1649965718816,MATH 20D,A02,084129,Staff,30,0,30,0
1649965718816,MATH 20D,A03,084130,Staff,27,0,30,3
1649965718816,MATH 20D,B01,084133,Staff,12,0,30,18
1649965718816,MATH 20D,B02,084134,Staff,25,0,30,5
1649965718816,MATH 20D,B03,084135,Staff,30,0,30,0
1649965724854,MATH 20E,A01,084138,Staff,20,0,30,10
1649965724854,MATH 20E,A02,084139,Staff,15,0,30,15
1649965724854,MATH 20E,A03,084140,Staff,20,0,30,10
1649965724854,MATH 20E,A04,084141,Staff,24,0,30,6
1649965730887,MATH 102,A01,084143,Harel; Guershon,16,0,30,14
1649965730887,MATH 102,A02,084144,Harel; Guershon,21,0,30,9
1649965736919,MATH 103B,A01,083456,Staff,0,12,30,30
1649965736919,MATH 103B,A02,083457,Staff,0,12,30,30
1649965742943,MATH 109,A01,084146,Salehi Golsefidy; Alireza,25,0,30,5
1649965742943,MATH 109,A02,084147,Salehi Golsefidy; Alireza,19,0,30,11
1649965748968,MATH 120A,A01,085445,Eggers; John Dietrich,18,0,35,17
1649965748968,MATH 120A,A02,085446,Eggers; John Dietrich,27,0,35,8
1649965754996,MATH 142B,A01,084149,Verstraete; Jacques Allan,0,12,30,30
1649965754996,MATH 142B,A02,084150,Verstraete; Jacques Allan,0,12,30,30
1649965761023,MATH 170A,A01,083459,Nie; Jiawang,0,4,30,30
1649965761023,MATH 170A,A02,083460,Nie; Jiawang,0,3,30,30
1649965761023,MATH 170A,A03,083461,Nie; Jiawang,0,4,30,30
1649965767047,MATH 193B,A01,083463,Staff,1,0,30,29
1649965767047,MATH 193B,A02,083464,Staff,10,0,30,20
1649965767047,MATH 193B,A03,083465,Staff,18,0,30,12
1649965773115,COGS 2,A01,083966,Boyle; Mary E. T.,17,0,30,13
1649965779138,COGS 9,A01,083968,Staff,33,0,60,27
1649965785164,COGS 14B,A01,083970,Staff,21,0,50,29
1649965791185,COGS 17,A01,092679,Staff,61,0,75,14
1649965797219,COGS 100,A01,083972,Staff,0,6,60,60
1649965809267,COGS 101C,A01,083976,Staff,16,0,30,14
1649965815291,COGS 102A,A01,083978,Johnson; Christine M.,14,0,30,16
1649965821322,COGS 107B,A01,083980,Staff,0,2,50,50
1649965827346,COGS 115,A01,083982,Staff,12,0,30,18
1649965833387,COGS 118B,A01,083367,Staff,0,11,40,40
1649965839411,COGS 172,A01,083984,Provenzano; Emily Kara,16,0,30,14
1649965845446,COGS 177,A00,083368,Staff,0,19,30,30
1649965851485,COGS 186,A01,083986,Staff,21,0,40,19
1649965857507,COGS 187A,A01,083988,Boyle; Mary E. T.,20,0,60,40
1649965863572,CSE 8A,A50,084003,Miranda; Gregory Joseph,0,4,15,15
1649965869596,CSE 11,A01,084005,Miranda; Gregory Joseph,2,0,55,53
1649965875619,CSE 20,A01,084007,Staff,5,0,20,15
1649965881644,CSE 21,A01,084009,Staff,0,10,50,50
1649965887666,CSE 30,A01,083370,Cao; Yingjun,0,45,40,40
1649965893690,CSE 100,A01,083372,Cao; Yingjun,0,41,40,40
1649965899715,CSE 101,A01,084011,Staff,0,53,40,40
1649965905742,CSE 141,A01,083374,Eldon; John,0,56,75,75
1649965911770,CSE 141L,A01,083376,Eldon; John,0,61,75,75
1649965917907,CSE 175,A01,084013,Kumar; Rakesh,22,0,25,3
1649965923941,CSE 190,A00,092508,Dubnov; Shlomo,15,0,15,0
1649965929982,ECE 5,A01,084049,Morris; Karcher William,15,0,20,5
1649965936007,ECE 100,A01,084051,Baghdadchi; Saharnaz,0,0,20,20
1649965936007,ECE 100,A02,091916,Baghdadchi; Saharnaz,15,0,20,5
1649965942030,ECE 101,A01,084053,Baghdadchi; Saharnaz,3,0,37,34
1649965942030,ECE 101,A02,084054,Baghdadchi; Saharnaz,31,0,37,6
1649965948060,ECE 107,A01,083390,Staff,28,0,40,12
1649965954084,ECE 148,A01,084056,Silberman; Jack,7,0,12,5
1649965960111,ECE 180,A00,083391,Abi Samra; Nicholas Camill,25,0,30,5
1649965960111,ECE 180,B00,083392,Abi Samra; Nicholas Camill,22,0,30,8
1649965966134,MATH 10B,A01,084110,Staff,8,0,30,22
1649965966134,MATH 10B,A02,084111,Staff,29,0,30,1
1649965966134,MATH 10B,A03,084112,Staff,26,0,30,4
1649965972161,MATH 10C,A01,083443,Staff,1,0,30,29
1649965972161,MATH 10C,A02,083444,Staff,12,0,30,18
1649965972161,MATH 10C,B01,084114,Staff,25,0,30,5
1649965972161,MATH 10C,B02,084115,Staff,28,0,30,2
1649965978185,MATH 18,A01,084117,Harel; Guershon,25,0,30,5
1649965978185,MATH 18,A02,084119,Harel; Guershon,28,0,30,2
1649965978185,MATH 18,A03,084120,Harel; Guershon,30,0,30,0
1649965978185,MATH 18,A04,084121,Harel; Guershon,29,0,30,1
1649965984208,MATH 20B,A01,084124,Um; Ko Woon,31,0,35,4
1649965984208,MATH 20B,B01,084126,Um; Ko Woon,31,0,35,4
1649965990234,MATH 20C,A01,083446,Hammock; Frances H,12,0,30,18
1649965990234,MATH 20C,A02,083447,Hammock; Frances H,28,0,30,2
1649965990234,MATH 20C,A03,083448,Hammock; Frances H,28,0,30,2
1649965990234,MATH 20C,A04,083449,Hammock; Frances H,30,0,30,0
1649965990234,MATH 20C,B01,083451,Hammock; Frances H,20,0,30,10
1649965990234,MATH 20C,B02,083452,Hammock; Frances H,26,0,30,4
1649965990234,MATH 20C,B03,083453,Hammock; Frances H,26,0,30,4
1649965990234,MATH 20C,B04,083454,Hammock; Frances H,30,0,30,0
1649965996269,MATH 20D,A01,084128,Staff,23,0,30,7
1649965996269,MATH 20D,A02,084129,Staff,30,0,30,0
1649965996269,MATH 20D,A03,084130,Staff,27,0,30,3
1649965996269,MATH 20D,B01,084133,Staff,12,0,30,18
1649965996269,MATH 20D,B02,084134,Staff,25,0,30,5
1649965996269,MATH 20D,B03,084135,Staff,29,0,30,1
1649966002297,MATH 20E,A01,084138,Staff,20,0,30,10
1649966002297,MATH 20E,A02,084139,Staff,15,0,30,15
1649966002297,MATH 20E,A03,084140,Staff,19,0,30,11
1649966002297,MATH 20E,A04,084141,Staff,24,0,30,6
1649966008320,MATH 102,A01,084143,Harel; Guershon,16,0,30,14
1649966008320,MATH 102,A02,084144,Harel; Guershon,21,0,30,9
1649966014344,MATH 103B,A01,083456,Staff,0,12,30,30
1649966014344,MATH 103B,A02,083457,Staff,0,12,30,30
1649966020369,MATH 109,A01,084146,Salehi Golsefidy; Alireza,25,0,30,5
1649966020369,MATH 109,A02,084147,Salehi Golsefidy; Alireza,19,0,30,11
1649966026399,MATH 120A,A01,085445,Eggers; John Dietrich,18,0,35,17
1649966026399,MATH 120A,A02,085446,Eggers; John Dietrich,27,0,35,8
1649966032423,MATH 142B,A01,084149,Verstraete; Jacques Allan,0,12,30,30
1649966032423,MATH 142B,A02,084150,Verstraete; Jacques Allan,0,12,30,30
1649966038447,MATH 170A,A01,083459,Nie; Jiawang,0,5,30,30
1649966038447,MATH 170A,A02,083460,Nie; Jiawang,0,4,30,30
1649966038447,MATH 170A,A03,083461,Nie; Jiawang,0,4,30,30
1649966044469,MATH 193B,A01,083463,Staff,1,0,30,29
1649966044469,MATH 193B,A02,083464,Staff,10,0,30,20
1649966044469,MATH 193B,A03,083465,Staff,18,0,30,12
1649966050525,COGS 2,A01,083966,Boyle; Mary E. T.,17,0,30,13
1649966056572,COGS 9,A01,083968,Staff,32,0,60,28
1649966062594,COGS 14B,A01,083970,Staff,19,0,50,31
1649966068621,COGS 17,A01,092679,Staff,61,0,75,14
1649966074642,COGS 100,A01,083972,Staff,0,7,60,60
1649966086701,COGS 101C,A01,083976,Staff,16,0,30,14
1649966092728,COGS 102A,A01,083978,Johnson; Christine M.,14,0,30,16
1649966098754,COGS 107B,A01,083980,Staff,0,2,50,50
1649966104785,COGS 115,A01,083982,Staff,12,0,30,18
1649966110813,COGS 118B,A01,083367,Staff,0,11,40,40
1649966116840,COGS 172,A01,083984,Provenzano; Emily Kara,16,0,30,14
1649966122866,COGS 177,A00,083368,Staff,0,19,30,30
1649966128906,COGS 186,A01,083986,Staff,21,0,40,19
1649966134945,COGS 187A,A01,083988,Boyle; Mary E. T.,20,0,60,40
1649966140978,CSE 8A,A50,084003,Miranda; Gregory Joseph,0,4,15,15
1649966147001,CSE 11,A01,084005,Miranda; Gregory Joseph,0,0,55,55
1649966153023,CSE 20,A01,084007,Staff,5,0,20,15
1649966159058,CSE 21,A01,084009,Staff,0,10,50,50
1649966165081,CSE 30,A01,083370,Cao; Yingjun,0,45,40,40
1649966171109,CSE 100,A01,083372,Cao; Yingjun,0,42,40,40
1649966177137,CSE 101,A01,084011,Staff,0,53,40,40
1649966183163,CSE 141,A01,083374,Eldon; John,0,56,75,75
1649966189191,CSE 141L,A01,083376,Eldon; John,0,62,75,75
1649966195214,CSE 175,A01,084013,Kumar; Rakesh,22,0,25,3
1649966201236,CSE 190,A00,092508,Dubnov; Shlomo,15,0,15,0
1649966207262,ECE 5,A01,084049,Morris; Karcher William,15,0,20,5
1649966213307,ECE 100,A01,084051,Baghdadchi; Saharnaz,0,0,20,20
1649966213307,ECE 100,A02,091916,Baghdadchi; Saharnaz,15,0,20,5
1649966219337,ECE 101,A01,084053,Baghdadchi; Saharnaz,3,0,37,34
1649966219337,ECE 101,A02,084054,Baghdadchi; Saharnaz,31,0,37,6
1649966225362,ECE 107,A01,083390,Staff,28,0,40,12
1649966231387,ECE 148,A01,084056,Silberman; Jack,7,0,12,5
1649966237414,ECE 180,A00,083391,Abi Samra; Nicholas Camill,25,0,30,5
1649966237414,ECE 180,B00,083392,Abi Samra; Nicholas Camill,22,0,30,8
1649966243452,MATH 10B,A01,084110,Staff,8,0,30,22
1649966243452,MATH 10B,A02,084111,Staff,28,0,30,2
1649966243452,MATH 10B,A03,084112,Staff,26,0,30,4
1649966249496,MATH 10C,A01,083443,Staff,1,0,30,29
1649966249496,MATH 10C,A02,083444,Staff,12,0,30,18
1649966249496,MATH 10C,B01,084114,Staff,25,0,30,5
1649966249496,MATH 10C,B02,084115,Staff,28,0,30,2
1649966255537,MATH 18,A01,084117,Harel; Guershon,25,0,30,5
1649966255537,MATH 18,A02,084119,Harel; Guershon,28,0,30,2
1649966255537,MATH 18,A03,084120,Harel; Guershon,30,0,30,0
1649966255537,MATH 18,A04,084121,Harel; Guershon,29,0,30,1
1649966261565,MATH 20B,A01,084124,Um; Ko Woon,31,0,35,4
1649966261565,MATH 20B,B01,084126,Um; Ko Woon,31,0,35,4
1649966267593,MATH 20C,A01,083446,Hammock; Frances H,12,0,30,18
1649966267593,MATH 20C,A02,083447,Hammock; Frances H,28,0,30,2
1649966267593,MATH 20C,A03,083448,Hammock; Frances H,28,0,30,2
1649966267593,MATH 20C,A04,083449,Hammock; Frances H,30,0,30,0
1649966267593,MATH 20C,B01,083451,Hammock; Frances H,20,0,30,10
1649966267593,MATH 20C,B02,083452,Hammock; Frances H,26,0,30,4
1649966267593,MATH 20C,B03,083453,Hammock; Frances H,26,0,30,4
1649966267593,MATH 20C,B04,083454,Hammock; Frances H,30,0,30,0
1649966273624,MATH 20D,A01,084128,Staff,23,0,30,7
1649966273624,MATH 20D,A02,084129,Staff,30,0,30,0
1649966273624,MATH 20D,A03,084130,Staff,27,0,30,3
1649966273624,MATH 20D,B01,084133,Staff,12,0,30,18
1649966273624,MATH 20D,B02,084134,Staff,25,0,30,5
1649966273624,MATH 20D,B03,084135,Staff,29,0,30,1
1649966279647,MATH 20E,A01,084138,Staff,19,0,30,11
1649966279647,MATH 20E,A02,084139,Staff,15,0,30,15
1649966279647,MATH 20E,A03,084140,Staff,19,0,30,11
1649966279647,MATH 20E,A04,084141,Staff,24,0,30,6
1649966285671,MATH 102,A01,084143,Harel; Guershon,16,0,30,14
1649966285671,MATH 102,A02,084144,Harel; Guershon,21,0,30,9
1649966291692,MATH 103B,A01,083456,Staff,0,12,30,30
1649966291692,MATH 103B,A02,083457,Staff,0,12,30,30
1649966297736,MATH 109,A01,084146,Salehi Golsefidy; Alireza,25,0,30,5
1649966297736,MATH 109,A02,084147,Salehi Golsefidy; Alireza,18,0,30,12
1649966303766,MATH 120A,A01,085445,Eggers; John Dietrich,18,0,35,17
1649966303766,MATH 120A,A02,085446,Eggers; John Dietrich,27,0,35,8
1649966309788,MATH 142B,A01,084149,Verstraete; Jacques Allan,0,12,30,30
1649966309788,MATH 142B,A02,084150,Verstraete; Jacques Allan,0,12,30,30
1649966315824,MATH 170A,A01,083459,Nie; Jiawang,0,5,30,30
1649966315824,MATH 170A,A02,083460,Nie; Jiawang,0,4,30,30
1649966315824,MATH 170A,A03,083461,Nie; Jiawang,0,4,30,30
1649966321850,MATH 193B,A01,083463,Staff,1,0,30,29
1649966321850,MATH 193B,A02,083464,Staff,10,0,30,20
1649966321850,MATH 193B,A03,083465,Staff,18,0,30,12
1649966327918,COGS 2,A01,083966,Boyle; Mary E. T.,17,0,30,13
1649966333944,COGS 9,A01,083968,Staff,32,0,60,28
1649966339976,COGS 14B,A01,083970,Staff,19,0,50,31
1649966346004,COGS 17,A01,092679,Staff,61,0,75,14
1649966352030,COGS 100,A01,083972,Staff,0,7,60,60
1649966364078,COGS 101C,A01,083976,Staff,16,0,30,14
1649966370100,COGS 102A,A01,083978,Johnson; Christine M.,14,0,30,16
1649966376136,COGS 107B,A01,083980,Staff,0,2,50,50
1649966382157,COGS 115,A01,083982,Staff,12,0,30,18
1649966388199,COGS 118B,A01,083367,Staff,0,11,40,40
1649966394223,COGS 172,A01,083984,Provenzano; Emily Kara,16,0,30,14
1649966400260,COGS 177,A00,083368,Staff,0,19,30,30
1649966406282,COGS 186,A01,083986,Staff,21,0,40,19
1649966412305,COGS 187A,A01,083988,Boyle; Mary E. T.,20,0,60,40
1649966418332,CSE 8A,A50,084003,Miranda; Gregory Joseph,0,4,15,15
1649966424370,CSE 11,A01,084005,Miranda; Gregory Joseph,0,0,55,55
1649966430399,CSE 20,A01,084007,Staff,5,0,20,15
1649966436430,CSE 21,A01,084009,Staff,0,10,50,50
1649966442456,CSE 30,A01,083370,Cao; Yingjun,0,45,40,40
1649966448480,CSE 100,A01,083372,Cao; Yingjun,0,42,40,40
1649966454504,CSE 101,A01,084011,Staff,0,53,40,40
1649966460529,CSE 141,A01,083374,Eldon; John,0,56,75,75
1649966466557,CSE 141L,A01,083376,Eldon; John,0,62,75,75
1649966472580,CSE 175,A01,084013,Kumar; Rakesh,22,0,25,3
1649966478603,CSE 190,A00,092508,Dubnov; Shlomo,15,0,15,0
1649966484660,ECE 5,A01,084049,Morris; Karcher William,15,0,20,5
1649966490692,ECE 100,A01,084051,Baghdadchi; Saharnaz,0,0,20,20
1649966490692,ECE 100,A02,091916,Baghdadchi; Saharnaz,15,0,20,5
1649966496732,ECE 101,A01,084053,Baghdadchi; Saharnaz,3,0,37,34
1649966496732,ECE 101,A02,084054,Baghdadchi; Saharnaz,31,0,37,6
1649966502759,ECE 107,A01,083390,Staff,28,0,40,12
1649966508785,ECE 148,A01,084056,Silberman; Jack,7,0,12,5
1649966514888,ECE 180,A00,083391,Abi Samra; Nicholas Camill,25,0,30,5
1649966514888,ECE 180,B00,083392,Abi Samra; Nicholas Camill,22,0,30,8
1649966520917,MATH 10B,A01,084110,Staff,7,0,30,23
1649966520917,MATH 10B,A02,084111,Staff,28,0,30,2
1649966520917,MATH 10B,A03,084112,Staff,26,0,30,4
1649966526947,MATH 10C,A01,083443,Staff,0,0,30,30
1649966526947,MATH 10C,A02,083444,Staff,12,0,30,18
1649966526947,MATH 10C,B01,084114,Staff,25,0,30,5
1649966526947,MATH 10C,B02,084115,Staff,28,0,30,2
1649966532970,MATH 18,A01,084117,Harel; Guershon,25,0,30,5
1649966532970,MATH 18,A02,084119,Harel; Guershon,28,0,30,2
1649966532970,MATH 18,A03,084120,Harel; Guershon,30,0,30,0
1649966532970,MATH 18,A04,084121,Harel; Guershon,29,0,30,1
1649966539007,MATH 20B,A01,084124,Um; Ko Woon,31,0,35,4
1649966539007,MATH 20B,B01,084126,Um; Ko Woon,31,0,35,4
1649966545032,MATH 20C,A01,083446,Hammock; Frances H,12,0,30,18
1649966545032,MATH 20C,A02,083447,Hammock; Frances H,28,0,30,2
1649966545032,MATH 20C,A03,083448,Hammock; Frances H,28,0,30,2
1649966545032,MATH 20C,A04,083449,Hammock; Frances H,30,0,30,0
1649966545032,MATH 20C,B01,083451,Hammock; Frances H,20,0,30,10
1649966545032,MATH 20C,B02,083452,Hammock; Frances H,26,0,30,4
1649966545032,MATH 20C,B03,083453,Hammock; Frances H,26,0,30,4
1649966545032,MATH 20C,B04,083454,Hammock; Frances H,30,0,30,0
1649966551056,MATH 20D,A01,084128,Staff,23,0,30,7
1649966551056,MATH 20D,A02,084129,Staff,30,0,30,0
1649966551056,MATH 20D,A03,084130,Staff,27,0,30,3
1649966551056,MATH 20D,B01,084133,Staff,12,0,30,18
1649966551056,MATH 20D,B02,084134,Staff,25,0,30,5
1649966551056,MATH 20D,B03,084135,Staff,29,0,30,1
1649966557097,MATH 20E,A01,084138,Staff,19,0,30,11
1649966557097,MATH 20E,A02,084139,Staff,15,0,30,15
1649966557097,MATH 20E,A03,084140,Staff,19,0,30,11
1649966557097,MATH 20E,A04,084141,Staff,24,0,30,6
1649966563137,MATH 102,A01,084143,Harel; Guershon,15,0,30,15
1649966563137,MATH 102,A02,084144,Harel; Guershon,21,0,30,9
1649966569167,MATH 103B,A01,083456,Staff,0,12,30,30
1649966569167,MATH 103B,A02,083457,Staff,0,12,30,30
1649966575192,MATH 109,A01,084146,Salehi Golsefidy; Alireza,24,0,30,6
1649966575192,MATH 109,A02,084147,Salehi Golsefidy; Alireza,18,0,30,12
1649966581214,MATH 120A,A01,085445,Eggers; John Dietrich,17,0,35,18
1649966581214,MATH 120A,A02,085446,Eggers; John Dietrich,27,0,35,8
1649966587246,MATH 142B,A01,084149,Verstraete; Jacques Allan,0,12,30,30
1649966587246,MATH 142B,A02,084150,Verstraete; Jacques Allan,0,12,30,30
1649966593292,MATH 170A,A01,083459,Nie; Jiawang,0,5,30,30
1649966593292,MATH 170A,A02,083460,Nie; Jiawang,0,5,30,30
1649966593292,MATH 170A,A03,083461,Nie; Jiawang,0,4,30,30
1649966599323,MATH 193B,A01,083463,Staff,1,0,30,29
1649966599323,MATH 193B,A02,083464,Staff,10,0,30,20
1649966599323,MATH 193B,A03,083465,Staff,18,0,30,12
1649966605375,COGS 2,A01,083966,Boyle; Mary E. T.,16,0,30,14
1649966611405,COGS 9,A01,083968,Staff,30,0,60,30
1649966617427,COGS 14B,A01,083970,Staff,18,0,50,32
1649966623451,COGS 17,A01,092679,Staff,60,0,75,15
1649966629483,COGS 100,A01,083972,Staff,0,7,60,60
1649966641558,COGS 101C,A01,083976,Staff,16,0,30,14
1649966647585,COGS 102A,A01,083978,Johnson; Christine M.,14,0,30,16
1649966653609,COGS 107B,A01,083980,Staff,0,2,50,50
1649966659639,COGS 115,A01,083982,Staff,12,0,30,18
1649966665678,COGS 118B,A01,083367,Staff,0,11,40,40
1649966671712,COGS 172,A01,083984,Provenzano; Emily Kara,16,0,30,14
1649966677735,COGS 177,A00,083368,Staff,0,19,30,30
1649966683759,COGS 186,A01,083986,Staff,21,0,40,19
1649966689786,COGS 187A,A01,083988,Boyle; Mary E. T.,20,0,60,40
1649966695817,CSE 8A,A50,084003,Miranda; Gregory Joseph,0,4,15,15
1649966701850,CSE 11,A01,084005,Miranda; Gregory Joseph,0,1,55,55
1649966707878,CSE 20,A01,084007,Staff,5,0,20,15
1649966713903,CSE 21,A01,084009,Staff,0,10,50,50
1649966719929,CSE 30,A01,083370,Cao; Yingjun,0,45,40,40
1649966725954,CSE 100,A01,083372,Cao; Yingjun,0,42,40,40
1649966731977,CSE 101,A01,084011,Staff,0,53,40,40
1649966738003,CSE 141,A01,083374,Eldon; John,0,56,75,75
1649966744036,CSE 141L,A01,083376,Eldon; John,0,62,75,75
1649966750057,CSE 175,A01,084013,Kumar; Rakesh,22,0,25,3
1649966756085,CSE 190,A00,092508,Dubnov; Shlomo,15,0,15,0
1649966762108,ECE 5,A01,084049,Morris; Karcher William,14,0,20,6
1649966768138,ECE 100,A01,084051,Baghdadchi; Saharnaz,0,0,20,20
1649966768138,ECE 100,A02,091916,Baghdadchi; Saharnaz,15,0,20,5
1649966774163,ECE 101,A01,084053,Baghdadchi; Saharnaz,2,0,37,35
1649966774163,ECE 101,A02,084054,Baghdadchi; Saharnaz,31,0,37,6
1649966780186,ECE 107,A01,083390,Staff,28,0,40,12
1649966786214,ECE 148,A01,084056,Silberman; Jack,7,0,12,5
1649966792242,ECE 180,A00,083391,Abi Samra; Nicholas Camill,25,0,30,5
1649966792242,ECE 180,B00,083392,Abi Samra; Nicholas Camill,22,0,30,8
1649966798265,MATH 10B,A01,084110,Staff,7,0,30,23
1649966798265,MATH 10B,A02,084111,Staff,28,0,30,2
1649966798265,MATH 10B,A03,084112,Staff,26,0,30,4
1649966804288,MATH 10C,A01,083443,Staff,0,0,30,30
1649966804288,MATH 10C,A02,083444,Staff,12,0,30,18
1649966804288,MATH 10C,B01,084114,Staff,25,0,30,5
1649966804288,MATH 10C,B02,084115,Staff,28,0,30,2
1649966810311,MATH 18,A01,084117,Harel; Guershon,25,0,30,5
1649966810311,MATH 18,A02,084119,Harel; Guershon,28,0,30,2
1649966810311,MATH 18,A03,084120,Harel; Guershon,30,0,30,0
1649966810311,MATH 18,A04,084121,Harel; Guershon,29,0,30,1
1649966816337,MATH 20B,A01,084124,Um; Ko Woon,31,0,35,4
1649966816337,MATH 20B,B01,084126,Um; Ko Woon,31,0,35,4
1649966822362,MATH 20C,A01,083446,Hammock; Frances H,12,0,30,18
1649966822362,MATH 20C,A02,083447,Hammock; Frances H,28,0,30,2
1649966822362,MATH 20C,A03,083448,Hammock; Frances H,28,0,30,2
1649966822362,MATH 20C,A04,083449,Hammock; Frances H,30,0,30,0
1649966822362,MATH 20C,B01,083451,Hammock; Frances H,20,0,30,10
1649966822362,MATH 20C,B02,083452,Hammock; Frances H,26,0,30,4
1649966822362,MATH 20C,B03,083453,Hammock; Frances H,26,0,30,4
1649966822362,MATH 20C,B04,083454,Hammock; Frances H,30,0,30,0
1649966828395,MATH 20D,A01,084128,Staff,23,0,30,7
1649966828395,MATH 20D,A02,084129,Staff,30,0,30,0
1649966828395,MATH 20D,A03,084130,Staff,27,0,30,3
1649966828395,MATH 20D,B01,084133,Staff,12,0,30,18
1649966828395,MATH 20D,B02,084134,Staff,25,0,30,5
1649966828395,MATH 20D,B03,084135,Staff,29,0,30,1
1649966834422,MATH 20E,A01,084138,Staff,19,0,30,11
1649966834422,MATH 20E,A02,084139,Staff,15,0,30,15
1649966834422,MATH 20E,A03,084140,Staff,19,0,30,11
1649966834422,MATH 20E,A04,084141,Staff,24,0,30,6
1649966840472,MATH 102,A01,084143,Harel; Guershon,15,0,30,15
1649966840472,MATH 102,A02,084144,Harel; Guershon,21,0,30,9
1649966846495,MATH 103B,A01,083456,Staff,0,12,30,30
1649966846495,MATH 103B,A02,083457,Staff,0,12,30,30
1649966852516,MATH 109,A01,084146,Salehi Golsefidy; Alireza,24,0,30,6
1649966852516,MATH 109,A02,084147,Salehi Golsefidy; Alireza,18,0,30,12
1649966858555,MATH 120A,A01,085445,Eggers; John Dietrich,17,0,35,18
1649966858555,MATH 120A,A02,085446,Eggers; John Dietrich,27,0,35,8
1649966864594,MATH 142B,A01,084149,Verstraete; Jacques Allan,0,12,30,30
1649966864594,MATH 142B,A02,084150,Verstraete; Jacques Allan,0,12,30,30
1649966870617,MATH 170A,A01,083459,Nie; Jiawang,0,5,30,30
1649966870617,MATH 170A,A02,083460,Nie; Jiawang,0,5,30,30
1649966870617,MATH 170A,A03,083461,Nie; Jiawang,0,4,30,30
1649966876644,MATH 193B,A01,083463,Staff,1,0,30,29
1649966876644,MATH 193B,A02,083464,Staff,10,0,30,20
1649966876644,MATH 193B,A03,083465,Staff,18,0,30,12
1649966882714,COGS 2,A01,083966,Boyle; Mary E. T.,16,0,30,14
1649966888748,COGS 9,A01,083968,Staff,30,0,60,30
1649966894772,COGS 14B,A01,083970,Staff,18,0,50,32
1649966900806,COGS 17,A01,092679,Staff,60,0,75,15
1649966906829,COGS 100,A01,083972,Staff,0,7,60,60
1649966918878,COGS 101C,A01,083976,Staff,16,0,30,14
1649966924907,COGS 102A,A01,083978,Johnson; Christine M.,14,0,30,16
1649966930932,COGS 107B,A01,083980,Staff,0,2,50,50
1649966936964,COGS 115,A01,083982,Staff,12,0,30,18
1649966943010,COGS 118B,A01,083367,Staff,0,11,40,40
1649966949036,COGS 172,A01,083984,Provenzano; Emily Kara,16,0,30,14
1649966955071,COGS 177,A00,083368,Staff,0,19,30,30
1649966961105,COGS 186,A01,083986,Staff,21,0,40,19
1649966967132,COGS 187A,A01,083988,Boyle; Mary E. T.,20,0,60,40
1649966973156,CSE 8A,A50,084003,Miranda; Gregory Joseph,0,4,15,15
1649966979180,CSE 11,A01,084005,Miranda; Gregory Joseph,0,1,55,55
1649966985206,CSE 20,A01,084007,Staff,5,0,20,15
1649966991227,CSE 21,A01,084009,Staff,0,10,50,50
1649966997253,CSE 30,A01,083370,Cao; Yingjun,0,45,40,40
1649967003282,CSE 100,A01,083372,Cao; Yingjun,0,42,40,40
1649967009307,CSE 101,A01,084011,Staff,0,53,40,40
1649967015330,CSE 141,A01,083374,Eldon; John,0,56,75,75
1649967021360,CSE 141L,A01,083376,Eldon; John,0,62,75,75
1649967027384,CSE 175,A01,084013,Kumar; Rakesh,22,0,25,3
1649967033415,CSE 190,A00,092508,Dubnov; Shlomo,15,0,15,0
1649967039437,ECE 5,A01,084049,Morris; Karcher William,14,0,20,6
1649967045461,ECE 100,A01,084051,Baghdadchi; Saharnaz,0,0,20,20
1649967045461,ECE 100,A02,091916,Baghdadchi; Saharnaz,15,0,20,5
1649967051488,ECE 101,A01,084053,Baghdadchi; Saharnaz,2,0,37,35
1649967051488,ECE 101,A02,084054,Baghdadchi; Saharnaz,31,0,37,6
1649967057515,ECE 107,A01,083390,Staff,28,0,40,12
1649967063545,ECE 148,A01,084056,Silberman; Jack,7,0,12,5
1649967069573,ECE 180,A00,083391,Abi Samra; Nicholas Camill,25,0,30,5
1649967069573,ECE 180,B00,083392,Abi Samra; Nicholas Camill,21,0,30,9
1649967075598,MATH 10B,A01,084110,Staff,7,0,30,23
1649967075598,MATH 10B,A02,084111,Staff,28,0,30,2
1649967075598,MATH 10B,A03,084112,Staff,26,0,30,4
1649967081643,MATH 10C,A01,083443,Staff,0,0,30,30
1649967081643,MATH 10C,A02,083444,Staff,12,0,30,18
1649967081643,MATH 10C,B01,084114,Staff,25,0,30,5
1649967081643,MATH 10C,B02,084115,Staff,28,0,30,2
1649967087671,MATH 18,A01,084117,Harel; Guershon,25,0,30,5
1649967087671,MATH 18,A02,084119,Harel; Guershon,28,0,30,2
1649967087671,MATH 18,A03,084120,Harel; Guershon,30,0,30,0
1649967087671,MATH 18,A04,084121,Harel; Guershon,29,0,30,1
1649967093694,MATH 20B,A01,084124,Um; Ko Woon,31,0,35,4
1649967093694,MATH 20B,B01,084126,Um; Ko Woon,31,0,35,4
1649967099718,MATH 20C,A01,083446,Hammock; Frances H,12,0,30,18
1649967099718,MATH 20C,A02,083447,Hammock; Frances H,28,0,30,2
1649967099718,MATH 20C,A03,083448,Hammock; Frances H,28,0,30,2
1649967099718,MATH 20C,A04,083449,Hammock; Frances H,30,0,30,0
1649967099718,MATH 20C,B01,083451,Hammock; Frances H,20,0,30,10
1649967099718,MATH 20C,B02,083452,Hammock; Frances H,26,0,30,4
1649967099718,MATH 20C,B03,083453,Hammock; Frances H,26,0,30,4
1649967099718,MATH 20C,B04,083454,Hammock; Frances H,30,0,30,0
1649967105757,MATH 20D,A01,084128,Staff,23,0,30,7
1649967105757,MATH 20D,A02,084129,Staff,30,0,30,0
1649967105757,MATH 20D,A03,084130,Staff,27,0,30,3
1649967105757,MATH 20D,B01,084133,Staff,12,0,30,18
1649967105757,MATH 20D,B02,084134,Staff,25,0,30,5
1649967105757,MATH 20D,B03,084135,Staff,29,0,30,1
1649967111859,MATH 20E,A01,084138,Staff,19,0,30,11
1649967111859,MATH 20E,A02,084139,Staff,15,0,30,15
1649967111859,MATH 20E,A03,084140,Staff,19,0,30,11
1649967111859,MATH 20E,A04,084141,Staff,24,0,30,6
1649967117886,MATH 102,A01,084143,Harel; Guershon,15,0,30,15
1649967117886,MATH 102,A02,084144,Harel; Guershon,21,0,30,9
1649967123938,MATH 103B,A01,083456,Staff,0,12,30,30
1649967123938,MATH 103B,A02,083457,Staff,0,12,30,30
1649967129977,MATH 109,A01,084146,Salehi Golsefidy; Alireza,24,0,30,6
1649967129977,MATH 109,A02,084147,Salehi Golsefidy; Alireza,18,0,30,12
1649967136003,MATH 120A,A01,085445,Eggers; John Dietrich,17,0,35,18
1649967136003,MATH 120A,A02,085446,Eggers; John Dietrich,27,0,35,8
1649967142026,MATH 142B,A01,084149,Verstraete; Jacques Allan,0,12,30,30
1649967142026,MATH 142B,A02,084150,Verstraete; Jacques Allan,0,12,30,30
1649967148048,MATH 170A,A01,083459,Nie; Jiawang,0,5,30,30
1649967148048,MATH 170A,A02,083460,Nie; Jiawang,0,5,30,30
1649967148048,MATH 170A,A03,083461,Nie; Jiawang,0,4,30,30
1649967154072,MATH 193B,A01,083463,Staff,1,0,30,29
1649967154072,MATH 193B,A02,083464,Staff,10,0,30,20
1649967154072,MATH 193B,A03,083465,Staff,18,0,30,12
1649967160136,COGS 2,A01,083966,Boyle; Mary E. T.,16,0,30,14
1649967166177,COGS 9,A01,083968,Staff,30,0,60,30
1649967172210,COGS 14B,A01,083970,Staff,18,0,50,32
1649967178239,COGS 17,A01,092679,Staff,60,0,75,15
1649967184264,COGS 100,A01,083972,Staff,0,7,60,60
1649967196326,COGS 101C,A01,083976,Staff,16,0,30,14
1649967202352,COGS 102A,A01,083978,Johnson; Christine M.,14,0,30,16
1649967208376,COGS 107B,A01,083980,Staff,0,2,50,50
1649967214399,COGS 115,A01,083982,Staff,12,0,30,18
1649967220425,COGS 118B,A01,083367,Staff,0,11,40,40
1649967226455,COGS 172,A01,083984,Provenzano; Emily Kara,16,0,30,14
1649967232478,COGS 177,A00,083368,Staff,0,19,30,30
1649967238507,COGS 186,A01,083986,Staff,21,0,40,19
1649967244548,COGS 187A,A01,083988,Boyle; Mary E. T.,20,0,60,40
1649967250574,CSE 8A,A50,084003,Miranda; Gregory Joseph,0,4,15,15
1649967256597,CSE 11,A01,084005,Miranda; Gregory Joseph,0,2,55,55
1649967262620,CSE 20,A01,084007,Staff,5,0,20,15
1649967268645,CSE 21,A01,084009,Staff,0,10,50,50
1649967274681,CSE 30,A01,083370,Cao; Yingjun,0,45,40,40
1649967280713,CSE 100,A01,083372,Cao; Yingjun,0,42,40,40
1649967286734,CSE 101,A01,084011,Staff,0,53,40,40
1649967292763,CSE 141,A01,083374,Eldon; John,0,56,75,75
1649967298789,CSE 141L,A01,083376,Eldon; John,0,62,75,75
1649967304818,CSE 175,A01,084013,Kumar; Rakesh,22,0,25,3
1649967310842,CSE 190,A00,092508,Dubnov; Shlomo,15,0,15,0
1649967316869,ECE 5,A01,084049,Morris; Karcher William,14,0,20,6
1649967322900,ECE 100,A01,084051,Baghdadchi; Saharnaz,0,0,20,20
1649967322900,ECE 100,A02,091916,Baghdadchi; Saharnaz,15,0,20,5
1649967328925,ECE 101,A01,084053,Baghdadchi; Saharnaz,2,0,37,35
1649967328925,ECE 101,A02,084054,Baghdadchi; Saharnaz,31,0,37,6
1649967334952,ECE 107,A01,083390,Staff,28,0,40,12
1649967340982,ECE 148,A01,084056,Silberman; Jack,7,0,12,5
1649967347011,ECE 180,A00,083391,Abi Samra; Nicholas Camill,25,0,30,5
1649967347011,ECE 180,B00,083392,Abi Samra; Nicholas Camill,21,0,30,9
1649967353033,MATH 10B,A01,084110,Staff,7,0,30,23
1649967353033,MATH 10B,A02,084111,Staff,28,0,30,2
1649967353033,MATH 10B,A03,084112,Staff,26,0,30,4
1649967359057,MATH 10C,A01,083443,Staff,0,0,30,30
1649967359057,MATH 10C,A02,083444,Staff,12,0,30,18
1649967359057,MATH 10C,B01,084114,Staff,25,0,30,5
1649967359057,MATH 10C,B02,084115,Staff,28,0,30,2
1649967365084,MATH 18,A01,084117,Harel; Guershon,25,0,30,5
1649967365084,MATH 18,A02,084119,Harel; Guershon,28,0,30,2
1649967365084,MATH 18,A03,084120,Harel; Guershon,30,0,30,0
1649967365084,MATH 18,A04,084121,Harel; Guershon,29,0,30,1
1649967371108,MATH 20B,A01,084124,Um; Ko Woon,31,0,35,4
1649967371108,MATH 20B,B01,084126,Um; Ko Woon,31,0,35,4
1649967377133,MATH 20C,A01,083446,Hammock; Frances H,12,0,30,18
1649967377133,MATH 20C,A02,083447,Hammock; Frances H,28,0,30,2
1649967377133,MATH 20C,A03,083448,Hammock; Frances H,28,0,30,2
1649967377133,MATH 20C,A04,083449,Hammock; Frances H,30,0,30,0
1649967377133,MATH 20C,B01,083451,Hammock; Frances H,20,0,30,10
1649967377133,MATH 20C,B02,083452,Hammock; Frances H,26,0,30,4
1649967377133,MATH 20C,B03,083453,Hammock; Frances H,26,0,30,4
1649967377133,MATH 20C,B04,083454,Hammock; Frances H,30,0,30,0
1649967383163,MATH 20D,A01,084128,Staff,23,0,30,7
1649967383163,MATH 20D,A02,084129,Staff,30,0,30,0
1649967383163,MATH 20D,A03,084130,Staff,27,0,30,3
1649967383163,MATH 20D,B01,084133,Staff,12,0,30,18
1649967383163,MATH 20D,B02,084134,Staff,25,0,30,5
1649967383163,MATH 20D,B03,084135,Staff,29,0,30,1
1649967389186,MATH 20E,A01,084138,Staff,19,0,30,11
1649967389186,MATH 20E,A02,084139,Staff,15,0,30,15
1649967389186,MATH 20E,A03,084140,Staff,19,0,30,11
1649967389186,MATH 20E,A04,084141,Staff,24,0,30,6
1649967395209,MATH 102,A01,084143,Harel; Guershon,15,0,30,15
1649967395209,MATH 102,A02,084144,Harel; Guershon,21,0,30,9
1649967401235,MATH 103B,A01,083456,Staff,0,12,30,30
1649967401235,MATH 103B,A02,083457,Staff,0,12,30,30
1649967407267,MATH 109,A01,084146,Salehi Golsefidy; Alireza,24,0,30,6
1649967407267,MATH 109,A02,084147,Salehi Golsefidy; Alireza,19,0,30,11
1649967413290,MATH 120A,A01,085445,Eggers; John Dietrich,17,0,35,18
1649967413290,MATH 120A,A02,085446,Eggers; John Dietrich,27,0,35,8
1649967419324,MATH 142B,A01,084149,Verstraete; Jacques Allan,0,12,30,30
1649967419324,MATH 142B,A02,084150,Verstraete; Jacques Allan,0,12,30,30
1649967425357,MATH 170A,A01,083459,Nie; Jiawang,1,4,30,29
1649967425357,MATH 170A,A02,083460,Nie; Jiawang,0,5,30,30
1649967425357,MATH 170A,A03,083461,Nie; Jiawang,0,4,30,30
1649967431382,MATH 193B,A01,083463,Staff,1,0,30,29
1649967431382,MATH 193B,A02,083464,Staff,10,0,30,20
1649967431382,MATH 193B,A03,083465,Staff,18,0,30,12
1649967437456,COGS 2,A01,083966,Boyle; Mary E. T.,16,0,30,14
1649967443486,COGS 9,A01,083968,Staff,30,0,60,30
1649967449512,COGS 14B,A01,083970,Staff,17,0,50,33
1649967455538,COGS 17,A01,092679,Staff,60,0,75,15
1649967461569,COGS 100,A01,083972,Staff,0,8,60,60
1649967473633,COGS 101C,A01,083976,Staff,16,0,30,14
1649967479660,COGS 102A,A01,083978,Johnson; Christine M.,14,0,30,16
1649967485692,COGS 107B,A01,083980,Staff,0,4,50,50
1649967491714,COGS 115,A01,083982,Staff,12,0,30,18
1649967497737,COGS 118B,A01,083367,Staff,0,11,40,40
1649967503763,COGS 172,A01,083984,Provenzano; Emily Kara,16,0,30,14
1649967509794,COGS 177,A00,083368,Staff,0,19,30,30
1649967515821,COGS 186,A01,083986,Staff,21,0,40,19
1649967521843,COGS 187A,A01,083988,Boyle; Mary E. T.,20,0,60,40
1649967527870,CSE 8A,A50,084003,Miranda; Gregory Joseph,0,4,15,15
1649967533893,CSE 11,A01,084005,Miranda; Gregory Joseph,0,2,55,55
1649967539917,CSE 20,A01,084007,Staff,5,0,20,15
1649967545950,CSE 21,A01,084009,Staff,0,10,50,50
1649967551983,CSE 30,A01,083370,Cao; Yingjun,0,45,40,40
1649967558028,CSE 100,A01,083372,Cao; Yingjun,0,42,40,40
1649967564056,CSE 101,A01,084011,Staff,0,53,40,40
1649967570081,CSE 141,A01,083374,Eldon; John,0,56,75,75
1649967576108,CSE 141L,A01,083376,Eldon; John,0,62,75,75
1649967582130,CSE 175,A01,084013,Kumar; Rakesh,22,0,25,3
1649967588164,CSE 190,A00,092508,Dubnov; Shlomo,15,0,15,0
1649967594203,ECE 5,A01,084049,Morris; Karcher William,14,0,20,6
1649967600239,ECE 100,A01,084051,Baghdadchi; Saharnaz,0,0,20,20
1649967600239,ECE 100,A02,091916,Baghdadchi; Saharnaz,15,0,20,5
1649967606263,ECE 101,A01,084053,Baghdadchi; Saharnaz,2,0,37,35
1649967606263,ECE 101,A02,084054,Baghdadchi; Saharnaz,31,0,37,6
1649967612289,ECE 107,A01,083390,Staff,28,0,40,12
1649967618314,ECE 148,A01,084056,Silberman; Jack,7,0,12,5
1649967624346,ECE 180,A00,083391,Abi Samra; Nicholas Camill,25,0,30,5
1649967624346,ECE 180,B00,083392,Abi Samra; Nicholas Camill,21,0,30,9
1649967630370,MATH 10B,A01,084110,Staff,7,0,30,23
1649967630370,MATH 10B,A02,084111,Staff,28,0,30,2
1649967630370,MATH 10B,A03,084112,Staff,26,0,30,4
1649967636395,MATH 10C,A01,083443,Staff,0,0,30,30
1649967636395,MATH 10C,A02,083444,Staff,12,0,30,18
1649967636395,MATH 10C,B01,084114,Staff,25,0,30,5
1649967636395,MATH 10C,B02,084115,Staff,28,0,30,2
1649967642418,MATH 18,A01,084117,Harel; Guershon,25,0,30,5
1649967642418,MATH 18,A02,084119,Harel; Guershon,28,0,30,2
1649967642418,MATH 18,A03,084120,Harel; Guershon,30,0,30,0
1649967642418,MATH 18,A04,084121,Harel; Guershon,29,0,30,1
1649967648446,MATH 20B,A01,084124,Um; Ko Woon,31,0,35,4
1649967648446,MATH 20B,B01,084126,Um; Ko Woon,31,0,35,4
1649967654478,MATH 20C,A01,083446,Hammock; Frances H,12,0,30,18
1649967654478,MATH 20C,A02,083447,Hammock; Frances H,28,0,30,2
1649967654478,MATH 20C,A03,083448,Hammock; Frances H,28,0,30,2
1649967654478,MATH 20C,A04,083449,Hammock; Frances H,30,0,30,0
1649967654478,MATH 20C,B01,083451,Hammock; Frances H,19,0,30,11
1649967654478,MATH 20C,B02,083452,Hammock; Frances H,26,0,30,4
1649967654478,MATH 20C,B03,083453,Hammock; Frances H,26,0,30,4
1649967654478,MATH 20C,B04,083454,Hammock; Frances H,30,0,30,0
1649967660504,MATH 20D,A01,084128,Staff,23,0,30,7
1649967660504,MATH 20D,A02,084129,Staff,30,0,30,0
1649967660504,MATH 20D,A03,084130,Staff,27,0,30,3
1649967660504,MATH 20D,B01,084133,Staff,12,0,30,18
1649967660504,MATH 20D,B02,084134,Staff,26,0,30,4
1649967660504,MATH 20D,B03,084135,Staff,29,0,30,1
1649967666530,MATH 20E,A01,084138,Staff,19,0,30,11
1649967666530,MATH 20E,A02,084139,Staff,15,0,30,15
1649967666530,MATH 20E,A03,084140,Staff,18,0,30,12
1649967666530,MATH 20E,A04,084141,Staff,24,0,30,6
1649967672560,MATH 102,A01,084143,Harel; Guershon,15,0,30,15
1649967672560,MATH 102,A02,084144,Harel; Guershon,21,0,30,9
1649967678600,MATH 103B,A01,083456,Staff,0,12,30,30
1649967678600,MATH 103B,A02,083457,Staff,0,12,30,30
1649967684633,MATH 109,A01,084146,Salehi Golsefidy; Alireza,24,0,30,6
1649967684633,MATH 109,A02,084147,Salehi Golsefidy; Alireza,20,0,30,10
1649967690660,MATH 120A,A01,085445,Eggers; John Dietrich,17,0,35,18
1649967690660,MATH 120A,A02,085446,Eggers; John Dietrich,27,0,35,8
1649967703407,MATH 142B,A01,084149,Verstraete; Jacques Allan,0,12,30,30
1649967703407,MATH 142B,A02,084150,Verstraete; Jacques Allan,0,12,30,30
1649967709430,MATH 170A,A01,083459,Nie; Jiawang,1,4,30,29
1649967709430,MATH 170A,A02,083460,Nie; Jiawang,0,5,30,30
1649967709430,MATH 170A,A03,083461,Nie; Jiawang,0,4,30,30
1649967715543,MATH 193B,A01,083463,Staff,1,0,30,29
1649967715543,MATH 193B,A02,083464,Staff,10,0,30,20
1649967715543,MATH 193B,A03,083465,Staff,18,0,30,12
1649967721607,COGS 2,A01,083966,Boyle; Mary E. T.,16,0,30,14
1649967727630,COGS 9,A01,083968,Staff,30,0,60,30
1649967733668,COGS 14B,A01,083970,Staff,17,0,50,33
1649967739694,COGS 17,A01,092679,Staff,60,0,75,15
1649967745726,COGS 100,A01,083972,Staff,0,8,60,60
1649967757788,COGS 101C,A01,083976,Staff,16,0,30,14
1649967763815,COGS 102A,A01,083978,Johnson; Christine M.,14,0,30,16
1649967769842,COGS 107B,A01,083980,Staff,0,4,50,50
1649967775865,COGS 115,A01,083982,Staff,12,0,30,18
1649967781893,COGS 118B,A01,083367,Staff,0,11,40,40
1649967787916,COGS 172,A01,083984,Provenzano; Emily Kara,15,0,30,15
1649967793949,COGS 177,A00,083368,Staff,0,19,30,30
1649967799984,COGS 186,A01,083986,Staff,21,0,40,19
1649967806008,COGS 187A,A01,083988,Boyle; Mary E. T.,20,0,60,40
1649967812037,CSE 8A,A50,084003,Miranda; Gregory Joseph,0,4,15,15
1649967818060,CSE 11,A01,084005,Miranda; Gregory Joseph,0,2,55,55
1649967824082,CSE 20,A01,084007,Staff,5,0,20,15
1649967830111,CSE 21,A01,084009,Staff,0,11,50,50
1649967836133,CSE 30,A01,083370,Cao; Yingjun,0,45,40,40
1649967842159,CSE 100,A01,083372,Cao; Yingjun,0,42,40,40
1649967848185,CSE 101,A01,084011,Staff,0,53,40,40
1649967854212,CSE 141,A01,083374,Eldon; John,0,57,75,75
1649967860235,CSE 141L,A01,083376,Eldon; John,0,63,75,75
1649967866262,CSE 175,A01,084013,Kumar; Rakesh,22,0,25,3
1649967872290,CSE 190,A00,092508,Dubnov; Shlomo,15,0,15,0
1649967878317,ECE 5,A01,084049,Morris; Karcher William,14,0,20,6
1649967884341,ECE 100,A01,084051,Baghdadchi; Saharnaz,0,0,20,20
1649967884341,ECE 100,A02,091916,Baghdadchi; Saharnaz,15,0,20,5
1649967890370,ECE 101,A01,084053,Baghdadchi; Saharnaz,2,0,37,35
1649967890370,ECE 101,A02,084054,Baghdadchi; Saharnaz,31,0,37,6
1649967896398,ECE 107,A01,083390,Staff,28,0,40,12
1649967902440,ECE 148,A01,084056,Silberman; Jack,7,0,12,5
1649967908465,ECE 180,A00,083391,Abi Samra; Nicholas Camill,25,0,30,5
1649967908465,ECE 180,B00,083392,Abi Samra; Nicholas Camill,21,0,30,9
1649967914489,MATH 10B,A01,084110,Staff,7,0,30,23
1649967914489,MATH 10B,A02,084111,Staff,28,0,30,2
1649967914489,MATH 10B,A03,084112,Staff,26,0,30,4
1649967920512,MATH 10C,A01,083443,Staff,0,0,30,30
1649967920512,MATH 10C,A02,083444,Staff,10,0,30,20
1649967920512,MATH 10C,B01,084114,Staff,25,0,30,5
1649967920512,MATH 10C,B02,084115,Staff,28,0,30,2
1649967926536,MATH 18,A01,084117,Harel; Guershon,25,0,30,5
1649967926536,MATH 18,A02,084119,Harel; Guershon,28,0,30,2
1649967926536,MATH 18,A03,084120,Harel; Guershon,30,0,30,0
1649967926536,MATH 18,A04,084121,Harel; Guershon,29,0,30,1
1649967932568,MATH 20B,A01,084124,Um; Ko Woon,31,0,35,4
1649967932568,MATH 20B,B01,084126,Um; Ko Woon,31,0,35,4
1649967938594,MATH 20C,A01,083446,Hammock; Frances H,12,0,30,18
1649967938594,MATH 20C,A02,083447,Hammock; Frances H,28,0,30,2
1649967938594,MATH 20C,A03,083448,Hammock; Frances H,28,0,30,2
1649967938594,MATH 20C,A04,083449,Hammock; Frances H,30,0,30,0
1649967938594,MATH 20C,B01,083451,Hammock; Frances H,19,0,30,11
1649967938594,MATH 20C,B02,083452,Hammock; Frances H,26,0,30,4
1649967938594,MATH 20C,B03,083453,Hammock; Frances H,26,0,30,4
1649967938594,MATH 20C,B04,083454,Hammock; Frances H,30,0,30,0
1649967944640,MATH 20D,A01,084128,Staff,22,0,30,8
1649967944640,MATH 20D,A02,084129,Staff,30,0,30,0
1649967944640,MATH 20D,A03,084130,Staff,27,0,30,3
1649967944640,MATH 20D,B01,084133,Staff,12,0,30,18
1649967944640,MATH 20D,B02,084134,Staff,25,0,30,5
1649967944640,MATH 20D,B03,084135,Staff,29,0,30,1
1649967950669,MATH 20E,A01,084138,Staff,19,0,30,11
1649967950669,MATH 20E,A02,084139,Staff,15,0,30,15
1649967950669,MATH 20E,A03,084140,Staff,18,0,30,12
1649967950669,MATH 20E,A04,084141,Staff,24,0,30,6
1649967956694,MATH 102,A01,084143,Harel; Guershon,15,0,30,15
1649967956694,MATH 102,A02,084144,Harel; Guershon,21,0,30,9
1649967962732,MATH 103B,A01,083456,Staff,0,12,30,30
1649967962732,MATH 103B,A02,083457,Staff,0,12,30,30
1649967968759,MATH 109,A01,084146,Salehi Golsefidy; Alireza,24,0,30,6
1649967968759,MATH 109,A02,084147,Salehi Golsefidy; Alireza,20,0,30,10
1649967974782,MATH 120A,A01,085445,Eggers; John Dietrich,17,0,35,18
1649967974782,MATH 120A,A02,085446,Eggers; John Dietrich,27,0,35,8
1649967980810,MATH 142B,A01,084149,Verstraete; Jacques Allan,0,12,30,30
1649967980810,MATH 142B,A02,084150,Verstraete; Jacques Allan,0,12,30,30
1649967986847,MATH 170A,A01,083459,Nie; Jiawang,1,4,30,29
1649967986847,MATH 170A,A02,083460,Nie; Jiawang,0,5,30,30
1649967986847,MATH 170A,A03,083461,Nie; Jiawang,0,5,30,30
1649967992880,MATH 193B,A01,083463,Staff,1,0,30,29
1649967992880,MATH 193B,A02,083464,Staff,10,0,30,20
1649967992880,MATH 193B,A03,083465,Staff,18,0,30,12
1649967998940,COGS 2,A01,083966,Boyle; Mary E. T.,16,0,30,14
1649968004969,COGS 9,A01,083968,Staff,30,0,60,30
1649968010998,COGS 14B,A01,083970,Staff,17,0,50,33
1649968017021,COGS 17,A01,092679,Staff,60,0,75,15
1649968023050,COGS 100,A01,083972,Staff,0,8,60,60
1649968035100,COGS 101C,A01,083976,Staff,16,0,30,14
1649968041123,COGS 102A,A01,083978,Johnson; Christine M.,14,0,30,16
1649968047147,COGS 107B,A01,083980,Staff,0,4,50,50
1649968053169,COGS 115,A01,083982,Staff,12,0,30,18
1649968059190,COGS 118B,A01,083367,Staff,0,11,40,40
1649968065224,COGS 172,A01,083984,Provenzano; Emily Kara,16,0,30,14
1649968071251,COGS 177,A00,083368,Staff,0,19,30,30
1649968077274,COGS 186,A01,083986,Staff,21,0,40,19
1649968083302,COGS 187A,A01,083988,Boyle; Mary E. T.,20,0,60,40
1649968089327,CSE 8A,A50,084003,Miranda; Gregory Joseph,0,4,15,15
1649968095352,CSE 11,A01,084005,Miranda; Gregory Joseph,0,2,55,55
1649968101383,CSE 20,A01,084007,Staff,5,0,20,15
1649968107414,CSE 21,A01,084009,Staff,0,11,50,50
1649968113450,CSE 30,A01,083370,Cao; Yingjun,0,46,40,40
1649968119480,CSE 100,A01,083372,Cao; Yingjun,0,42,40,40
1649968125501,CSE 101,A01,084011,Staff,0,53,40,40
1649968131528,CSE 141,A01,083374,Eldon; John,0,57,75,75
1649968137554,CSE 141L,A01,083376,Eldon; John,0,63,75,75
1649968143582,CSE 175,A01,084013,Kumar; Rakesh,22,0,25,3
1649968149608,CSE 190,A00,092508,Dubnov; Shlomo,15,0,15,0
1649968155631,ECE 5,A01,084049,Morris; Karcher William,14,0,20,6
1649968161655,ECE 100,A01,084051,Baghdadchi; Saharnaz,0,0,20,20
1649968161655,ECE 100,A02,091916,Baghdadchi; Saharnaz,15,0,20,5
1649968167681,ECE 101,A01,084053,Baghdadchi; Saharnaz,2,0,37,35
1649968167681,ECE 101,A02,084054,Baghdadchi; Saharnaz,31,0,37,6
1649968173715,ECE 107,A01,083390,Staff,28,0,40,12
1649968179748,ECE 148,A01,084056,Silberman; Jack,7,0,12,5
1649968185775,ECE 180,A00,083391,Abi Samra; Nicholas Camill,25,0,30,5
1649968185775,ECE 180,B00,083392,Abi Samra; Nicholas Camill,21,0,30,9
1649968191807,MATH 10B,A01,084110,Staff,7,0,30,23
1649968191807,MATH 10B,A02,084111,Staff,28,0,30,2
1649968191807,MATH 10B,A03,084112,Staff,26,0,30,4
1649968197836,MATH 10C,A01,083443,Staff,0,0,30,30
1649968197836,MATH 10C,A02,083444,Staff,10,0,30,20
1649968197836,MATH 10C,B01,084114,Staff,25,0,30,5
1649968197836,MATH 10C,B02,084115,Staff,28,0,30,2
1649968203861,MATH 18,A01,084117,Harel; Guershon,25,0,30,5
1649968203861,MATH 18,A02,084119,Harel; Guershon,28,0,30,2
1649968203861,MATH 18,A03,084120,Harel; Guershon,30,0,30,0
1649968203861,MATH 18,A04,084121,Harel; Guershon,29,0,30,1
1649968209888,MATH 20B,A01,084124,Um; Ko Woon,31,0,35,4
1649968209888,MATH 20B,B01,084126,Um; Ko Woon,30,0,35,5
1649968215912,MATH 20C,A01,083446,Hammock; Frances H,11,0,30,19
1649968215912,MATH 20C,A02,083447,Hammock; Frances H,28,0,30,2
1649968215912,MATH 20C,A03,083448,Hammock; Frances H,28,0,30,2
1649968215912,MATH 20C,A04,083449,Hammock; Frances H,30,0,30,0
1649968215912,MATH 20C,B01,083451,Hammock; Frances H,19,0,30,11
1649968215912,MATH 20C,B02,083452,Hammock; Frances H,26,0,30,4
1649968215912,MATH 20C,B03,083453,Hammock; Frances H,26,0,30,4
1649968215912,MATH 20C,B04,083454,Hammock; Frances H,30,0,30,0
1649968221938,MATH 20D,A01,084128,Staff,21,0,30,9
1649968221938,MATH 20D,A02,084129,Staff,30,0,30,0
1649968221938,MATH 20D,A03,084130,Staff,27,0,30,3
1649968221938,MATH 20D,B01,084133,Staff,12,0,30,18
1649968221938,MATH 20D,B02,084134,Staff,25,0,30,5
1649968221938,MATH 20D,B03,084135,Staff,29,0,30,1
1649968227962,MATH 20E,A01,084138,Staff,19,0,30,11
1649968227962,MATH 20E,A02,084139,Staff,15,0,30,15
1649968227962,MATH 20E,A03,084140,Staff,18,0,30,12
1649968227962,MATH 20E,A04,084141,Staff,24,0,30,6
1649968233993,MATH 102,A01,084143,Harel; Guershon,15,0,30,15
1649968233993,MATH 102,A02,084144,Harel; Guershon,21,0,30,9
1649968240022,MATH 103B,A01,083456,Staff,0,12,30,30
1649968240022,MATH 103B,A02,083457,Staff,0,12,30,30
1649968246046,MATH 109,A01,084146,Salehi Golsefidy; Alireza,24,0,30,6
1649968246046,MATH 109,A02,084147,Salehi Golsefidy; Alireza,20,0,30,10
1649968252076,MATH 120A,A01,085445,Eggers; John Dietrich,17,0,35,18
1649968252076,MATH 120A,A02,085446,Eggers; John Dietrich,27,0,35,8
1649968258106,MATH 142B,A01,084149,Verstraete; Jacques Allan,0,12,30,30
1649968258106,MATH 142B,A02,084150,Verstraete; Jacques Allan,0,12,30,30
1649968264129,MATH 170A,A01,083459,Nie; Jiawang,1,4,30,29
1649968264129,MATH 170A,A02,083460,Nie; Jiawang,0,5,30,30
1649968264129,MATH 170A,A03,083461,Nie; Jiawang,0,5,30,30
1649968270155,MATH 193B,A01,083463,Staff,1,0,30,29
1649968270155,MATH 193B,A02,083464,Staff,10,0,30,20
1649968270155,MATH 193B,A03,083465,Staff,18,0,30,12
1649968276228,COGS 2,A01,083966,Boyle; Mary E. T.,16,0,30,14
1649968282256,COGS 9,A01,083968,Staff,30,0,60,30
1649968288281,COGS 14B,A01,083970,Staff,17,0,50,33
1649968294312,COGS 17,A01,092679,Staff,58,0,75,17
1649968300339,COGS 100,A01,083972,Staff,0,8,60,60
1649968312474,COGS 101C,A01,083976,Staff,16,0,30,14
1649968318502,COGS 102A,A01,083978,Johnson; Christine M.,14,0,30,16
1649968324532,COGS 107B,A01,083980,Staff,0,4,50,50
1649968330559,COGS 115,A01,083982,Staff,12,0,30,18
1649968336588,COGS 118B,A01,083367,Staff,0,11,40,40
1649968342626,COGS 172,A01,083984,Provenzano; Emily Kara,16,0,30,14
1649968348653,COGS 177,A00,083368,Staff,0,19,30,30
1649968354683,COGS 186,A01,083986,Staff,21,0,40,19
1649968360705,COGS 187A,A01,083988,Boyle; Mary E. T.,20,0,60,40
1649968366731,CSE 8A,A50,084003,Miranda; Gregory Joseph,0,4,15,15
1649968372759,CSE 11,A01,084005,Miranda; Gregory Joseph,0,5,55,55
1649968378786,CSE 20,A01,084007,Staff,5,0,20,15
1649968384819,CSE 21,A01,084009,Staff,0,13,50,50
1649968390849,CSE 30,A01,083370,Cao; Yingjun,0,47,40,40
1649968396875,CSE 100,A01,083372,Cao; Yingjun,0,42,40,40
1649968402898,CSE 101,A01,084011,Staff,0,53,40,40
1649968408922,CSE 141,A01,083374,Eldon; John,0,57,75,75
1649968414945,CSE 141L,A01,083376,Eldon; John,0,63,75,75
1649968420969,CSE 175,A01,084013,Kumar; Rakesh,22,0,25,3
1649968426992,CSE 190,A00,092508,Dubnov; Shlomo,15,0,15,0
1649968433022,ECE 5,A01,084049,Morris; Karcher William,14,0,20,6
1649968439058,ECE 100,A01,084051,Baghdadchi; Saharnaz,0,0,20,20
1649968439058,ECE 100,A02,091916,Baghdadchi; Saharnaz,15,0,20,5
1649968445080,ECE 101,A01,084053,Baghdadchi; Saharnaz,2,0,37,35
1649968445080,ECE 101,A02,084054,Baghdadchi; Saharnaz,31,0,37,6
1649968451128,ECE 107,A01,083390,Staff,28,0,40,12
1649968457155,ECE 148,A01,084056,Silberman; Jack,7,0,12,5
1649968463177,ECE 180,A00,083391,Abi Samra; Nicholas Camill,25,0,30,5
1649968463177,ECE 180,B00,083392,Abi Samra; Nicholas Camill,21,0,30,9
1649968469203,MATH 10B,A01,084110,Staff,7,0,30,23
1649968469203,MATH 10B,A02,084111,Staff,28,0,30,2
1649968469203,MATH 10B,A03,084112,Staff,26,0,30,4
1649968475228,MATH 10C,A01,083443,Staff,0,0,30,30
1649968475228,MATH 10C,A02,083444,Staff,10,0,30,20
1649968475228,MATH 10C,B01,084114,Staff,24,0,30,6
1649968475228,MATH 10C,B02,084115,Staff,28,0,30,2
1649968481251,MATH 18,A01,084117,Harel; Guershon,24,0,30,6
1649968481251,MATH 18,A02,084119,Harel; Guershon,28,0,30,2
1649968481251,MATH 18,A03,084120,Harel; Guershon,30,0,30,0
1649968481251,MATH 18,A04,084121,Harel; Guershon,29,0,30,1
1649968487274,MATH 20B,A01,084124,Um; Ko Woon,31,0,35,4
1649968487274,MATH 20B,B01,084126,Um; Ko Woon,30,0,35,5
1649968493303,MATH 20C,A01,083446,Hammock; Frances H,11,0,30,19
1649968493303,MATH 20C,A02,083447,Hammock; Frances H,28,0,30,2
1649968493303,MATH 20C,A03,083448,Hammock; Frances H,28,0,30,2
1649968493303,MATH 20C,A04,083449,Hammock; Frances H,30,0,30,0
1649968493303,MATH 20C,B01,083451,Hammock; Frances H,19,0,30,11
1649968493303,MATH 20C,B02,083452,Hammock; Frances H,26,0,30,4
1649968493303,MATH 20C,B03,083453,Hammock; Frances H,26,0,30,4
1649968493303,MATH 20C,B04,083454,Hammock; Frances H,30,0,30,0
1649968499338,MATH 20D,A01,084128,Staff,21,0,30,9
1649968499338,MATH 20D,A02,084129,Staff,30,0,30,0
1649968499338,MATH 20D,A03,084130,Staff,27,0,30,3
1649968499338,MATH 20D,B01,084133,Staff,11,0,30,19
1649968499338,MATH 20D,B02,084134,Staff,25,0,30,5
1649968499338,MATH 20D,B03,084135,Staff,29,0,30,1
1649968505365,MATH 20E,A01,084138,Staff,19,0,30,11
1649968505365,MATH 20E,A02,084139,Staff,15,0,30,15
1649968505365,MATH 20E,A03,084140,Staff,17,0,30,13
1649968505365,MATH 20E,A04,084141,Staff,24,0,30,6
1649968511389,MATH 102,A01,084143,Harel; Guershon,15,0,30,15
1649968511389,MATH 102,A02,084144,Harel; Guershon,21,0,30,9
1649968517411,MATH 103B,A01,083456,Staff,0,12,30,30
1649968517411,MATH 103B,A02,083457,Staff,0,12,30,30
1649968523438,MATH 109,A01,084146,Salehi Golsefidy; Alireza,24,0,30,6
1649968523438,MATH 109,A02,084147,Salehi Golsefidy; Alireza,20,0,30,10
1649968529461,MATH 120A,A01,085445,Eggers; John Dietrich,17,0,35,18
1649968529461,MATH 120A,A02,085446,Eggers; John Dietrich,27,0,35,8
1649968535495,MATH 142B,A01,084149,Verstraete; Jacques Allan,0,12,30,30
1649968535495,MATH 142B,A02,084150,Verstraete; Jacques Allan,0,12,30,30
1649968541518,MATH 170A,A01,083459,Nie; Jiawang,1,4,30,29
1649968541518,MATH 170A,A02,083460,Nie; Jiawang,0,5,30,30
1649968541518,MATH 170A,A03,083461,Nie; Jiawang,0,5,30,30
1649968547548,MATH 193B,A01,083463,Staff,1,0,30,29
1649968547548,MATH 193B,A02,083464,Staff,10,0,30,20
1649968547548,MATH 193B,A03,083465,Staff,18,0,30,12
1649968553606,COGS 2,A01,083966,Boyle; Mary E. T.,16,0,30,14
1649968559638,COGS 9,A01,083968,Staff,30,0,60,30
1649968565672,COGS 14B,A01,083970,Staff,17,0,50,33
1649968571693,COGS 17,A01,092679,Staff,58,0,75,17
1649968577717,COGS 100,A01,083972,Staff,0,8,60,60
1649968589780,COGS 101C,A01,083976,Staff,16,0,30,14
1649968595811,COGS 102A,A01,083978,Johnson; Christine M.,14,0,30,16
1649968601849,COGS 107B,A01,083980,Staff,0,4,50,50
1649968607884,COGS 115,A01,083982,Staff,12,0,30,18
1649968613914,COGS 118B,A01,083367,Staff,0,11,40,40
1649968619935,COGS 172,A01,083984,Provenzano; Emily Kara,16,0,30,14
1649968625957,COGS 177,A00,083368,Staff,0,19,30,30
1649968631997,COGS 186,A01,083986,Staff,21,0,40,19
1649968638024,COGS 187A,A01,083988,Boyle; Mary E. T.,20,0,60,40
1649968644050,CSE 8A,A50,084003,Miranda; Gregory Joseph,0,4,15,15
1649968650078,CSE 11,A01,084005,Miranda; Gregory Joseph,0,5,55,55
1649968656103,CSE 20,A01,084007,Staff,5,0,20,15
1649968662135,CSE 21,A01,084009,Staff,0,13,50,50
1649968668170,CSE 30,A01,083370,Cao; Yingjun,0,47,40,40
1649968674196,CSE 100,A01,083372,Cao; Yingjun,0,42,40,40
1649968680224,CSE 101,A01,084011,Staff,0,53,40,40
1649968686250,CSE 141,A01,083374,Eldon; John,0,57,75,75
1649968692274,CSE 141L,A01,083376,Eldon; John,0,63,75,75
1649968698295,CSE 175,A01,084013,Kumar; Rakesh,22,0,25,3
1649968704317,CSE 190,A00,092508,Dubnov; Shlomo,15,0,15,0
1649968710342,ECE 5,A01,084049,Morris; Karcher William,14,0,20,6
1649968716364,ECE 100,A01,084051,Baghdadchi; Saharnaz,0,0,20,20
1649968716364,ECE 100,A02,091916,Baghdadchi; Saharnaz,15,0,20,5
1649968722385,ECE 101,A01,084053,Baghdadchi; Saharnaz,2,0,37,35
1649968722385,ECE 101,A02,084054,Baghdadchi; Saharnaz,31,0,37,6
1649968728412,ECE 107,A01,083390,Staff,28,0,40,12
1649968734448,ECE 148,A01,084056,Silberman; Jack,7,0,12,5
1649968740471,ECE 180,A00,083391,Abi Samra; Nicholas Camill,25,0,30,5
1649968740471,ECE 180,B00,083392,Abi Samra; Nicholas Camill,21,0,30,9
1649968746501,MATH 10B,A01,084110,Staff,7,0,30,23
1649968746501,MATH 10B,A02,084111,Staff,28,0,30,2
1649968746501,MATH 10B,A03,084112,Staff,26,0,30,4
1649968752533,MATH 10C,A01,083443,Staff,0,0,30,30
1649968752533,MATH 10C,A02,083444,Staff,10,0,30,20
1649968752533,MATH 10C,B01,084114,Staff,24,0,30,6
1649968752533,MATH 10C,B02,084115,Staff,28,0,30,2
1649968758561,MATH 18,A01,084117,Harel; Guershon,24,0,30,6
1649968758561,MATH 18,A02,084119,Harel; Guershon,28,0,30,2
1649968758561,MATH 18,A03,084120,Harel; Guershon,30,0,30,0
1649968758561,MATH 18,A04,084121,Harel; Guershon,29,0,30,1
1649968764591,MATH 20B,A01,084124,Um; Ko Woon,31,0,35,4
1649968764591,MATH 20B,B01,084126,Um; Ko Woon,30,0,35,5
1649968770614,MATH 20C,A01,083446,Hammock; Frances H,11,0,30,19
1649968770614,MATH 20C,A02,083447,Hammock; Frances H,28,0,30,2
1649968770614,MATH 20C,A03,083448,Hammock; Frances H,28,0,30,2
1649968770614,MATH 20C,A04,083449,Hammock; Frances H,30,0,30,0
1649968770614,MATH 20C,B01,083451,Hammock; Frances H,19,0,30,11
1649968770614,MATH 20C,B02,083452,Hammock; Frances H,26,0,30,4
1649968770614,MATH 20C,B03,083453,Hammock; Frances H,26,0,30,4
1649968770614,MATH 20C,B04,083454,Hammock; Frances H,30,0,30,0
1649968776642,MATH 20D,A01,084128,Staff,21,0,30,9
1649968776642,MATH 20D,A02,084129,Staff,30,0,30,0
1649968776642,MATH 20D,A03,084130,Staff,27,0,30,3
1649968776642,MATH 20D,B01,084133,Staff,11,0,30,19
1649968776642,MATH 20D,B02,084134,Staff,25,0,30,5
1649968776642,MATH 20D,B03,084135,Staff,29,0,30,1
1649968782676,MATH 20E,A01,084138,Staff,19,0,30,11
1649968782676,MATH 20E,A02,084139,Staff,15,0,30,15
1649968782676,MATH 20E,A03,084140,Staff,17,0,30,13
1649968782676,MATH 20E,A04,084141,Staff,24,0,30,6
1649968788698,MATH 102,A01,084143,Harel; Guershon,15,0,30,15
1649968788698,MATH 102,A02,084144,Harel; Guershon,21,0,30,9
1649968794727,MATH 103B,A01,083456,Staff,0,12,30,30
1649968794727,MATH 103B,A02,083457,Staff,0,12,30,30
1649968800760,MATH 109,A01,084146,Salehi Golsefidy; Alireza,24,0,30,6
1649968800760,MATH 109,A02,084147,Salehi Golsefidy; Alireza,20,0,30,10
1649968806789,MATH 120A,A01,085445,Eggers; John Dietrich,17,0,35,18
1649968806789,MATH 120A,A02,085446,Eggers; John Dietrich,27,0,35,8
1649968812813,MATH 142B,A01,084149,Verstraete; Jacques Allan,0,12,30,30
1649968812813,MATH 142B,A02,084150,Verstraete; Jacques Allan,0,12,30,30
1649968818850,MATH 170A,A01,083459,Nie; Jiawang,1,4,30,29
1649968818850,MATH 170A,A02,083460,Nie; Jiawang,0,5,30,30
1649968818850,MATH 170A,A03,083461,Nie; Jiawang,0,5,30,30
1649968824882,MATH 193B,A01,083463,Staff,1,0,30,29
1649968824882,MATH 193B,A02,083464,Staff,10,0,30,20
1649968824882,MATH 193B,A03,083465,Staff,18,0,30,12
1649968830944,COGS 2,A01,083966,Boyle; Mary E. T.,16,0,30,14
1649968836968,COGS 9,A01,083968,Staff,30,0,60,30
1649968842994,COGS 14B,A01,083970,Staff,17,0,50,33
1649968849017,COGS 17,A01,092679,Staff,58,0,75,17
1649968855040,COGS 100,A01,083972,Staff,0,8,60,60
1649968867092,COGS 101C,A01,083976,Staff,16,0,30,14
1649968873124,COGS 102A,A01,083978,Johnson; Christine M.,14,0,30,16
1649968879159,COGS 107B,A01,083980,Staff,0,4,50,50
1649968885182,COGS 115,A01,083982,Staff,12,0,30,18
1649968891204,COGS 118B,A01,083367,Staff,0,11,40,40
1649968897230,COGS 172,A01,083984,Provenzano; Emily Kara,16,0,30,14
1649968903341,COGS 177,A00,083368,Staff,0,19,30,30
1649968909367,COGS 186,A01,083986,Staff,21,0,40,19
1649968915393,COGS 187A,A01,083988,Boyle; Mary E. T.,20,0,60,40
1649968921413,CSE 8A,A50,084003,Miranda; Gregory Joseph,0,4,15,15
1649968927437,CSE 11,A01,084005,Miranda; Gregory Joseph,0,6,55,55
1649968933468,CSE 20,A01,084007,Staff,5,0,20,15
1649968939491,CSE 21,A01,084009,Staff,0,13,50,50
1649968945515,CSE 30,A01,083370,Cao; Yingjun,0,47,40,40
1649968951539,CSE 100,A01,083372,Cao; Yingjun,0,44,40,40
1649968957564,CSE 101,A01,084011,Staff,0,53,40,40
1649968963595,CSE 141,A01,083374,Eldon; John,0,57,75,75
1649968969629,CSE 141L,A01,083376,Eldon; John,0,63,75,75
1649968975654,CSE 175,A01,084013,Kumar; Rakesh,22,0,25,3
1649968981677,CSE 190,A00,092508,Dubnov; Shlomo,15,0,15,0
1649968987699,ECE 5,A01,084049,Morris; Karcher William,14,0,20,6
1649968993725,ECE 100,A01,084051,Baghdadchi; Saharnaz,0,0,20,20
1649968993725,ECE 100,A02,091916,Baghdadchi; Saharnaz,15,0,20,5
1649968999760,ECE 101,A01,084053,Baghdadchi; Saharnaz,2,0,37,35
1649968999760,ECE 101,A02,084054,Baghdadchi; Saharnaz,31,0,37,6
1649969005783,ECE 107,A01,083390,Staff,28,0,40,12
1649969011810,ECE 148,A01,084056,Silberman; Jack,7,0,12,5
1649969017837,ECE 180,A00,083391,Abi Samra; Nicholas Camill,25,0,30,5
1649969017837,ECE 180,B00,083392,Abi Samra; Nicholas Camill,21,0,30,9
1649969023874,MATH 10B,A01,084110,Staff,7,0,30,23
1649969023874,MATH 10B,A02,084111,Staff,28,0,30,2
1649969023874,MATH 10B,A03,084112,Staff,26,0,30,4
1649969029896,MATH 10C,A01,083443,Staff,0,0,30,30
1649969029896,MATH 10C,A02,083444,Staff,10,0,30,20
1649969029896,MATH 10C,B01,084114,Staff,24,0,30,6
1649969029896,MATH 10C,B02,084115,Staff,28,0,30,2
1649969035926,MATH 18,A01,084117,Harel; Guershon,24,0,30,6
1649969035926,MATH 18,A02,084119,Harel; Guershon,28,0,30,2
1649969035926,MATH 18,A03,084120,Harel; Guershon,30,0,30,0
1649969035926,MATH 18,A04,084121,Harel; Guershon,29,0,30,1
1649969041952,MATH 20B,A01,084124,Um; Ko Woon,31,0,35,4
1649969041952,MATH 20B,B01,084126,Um; Ko Woon,30,0,35,5
1649969047981,MATH 20C,A01,083446,Hammock; Frances H,11,0,30,19
1649969047981,MATH 20C,A02,083447,Hammock; Frances H,28,0,30,2
1649969047981,MATH 20C,A03,083448,Hammock; Frances H,28,0,30,2
1649969047981,MATH 20C,A04,083449,Hammock; Frances H,30,0,30,0
1649969047981,MATH 20C,B01,083451,Hammock; Frances H,19,0,30,11
1649969047981,MATH 20C,B02,083452,Hammock; Frances H,26,0,30,4
1649969047981,MATH 20C,B03,083453,Hammock; Frances H,26,0,30,4
1649969047981,MATH 20C,B04,083454,Hammock; Frances H,30,0,30,0
1649969054015,MATH 20D,A01,084128,Staff,21,0,30,9
1649969054015,MATH 20D,A02,084129,Staff,30,0,30,0
1649969054015,MATH 20D,A03,084130,Staff,27,0,30,3
1649969054015,MATH 20D,B01,084133,Staff,11,0,30,19
1649969054015,MATH 20D,B02,084134,Staff,24,0,30,6
1649969054015,MATH 20D,B03,084135,Staff,29,0,30,1
1649969060039,MATH 20E,A01,084138,Staff,19,0,30,11
1649969060039,MATH 20E,A02,084139,Staff,15,0,30,15
1649969060039,MATH 20E,A03,084140,Staff,17,0,30,13
1649969060039,MATH 20E,A04,084141,Staff,24,0,30,6
1649969066066,MATH 102,A01,084143,Harel; Guershon,15,0,30,15
1649969066066,MATH 102,A02,084144,Harel; Guershon,21,0,30,9
1649969072089,MATH 103B,A01,083456,Staff,0,12,30,30
1649969072089,MATH 103B,A02,083457,Staff,0,12,30,30
1649969078125,MATH 109,A01,084146,Salehi Golsefidy; Alireza,23,0,30,7
1649969078125,MATH 109,A02,084147,Salehi Golsefidy; Alireza,20,0,30,10
1649969084152,MATH 120A,A01,085445,Eggers; John Dietrich,17,0,35,18
1649969084152,MATH 120A,A02,085446,Eggers; John Dietrich,27,0,35,8
1649969090184,MATH 142B,A01,084149,Verstraete; Jacques Allan,0,12,30,30
1649969090184,MATH 142B,A02,084150,Verstraete; Jacques Allan,0,12,30,30
1649969096212,MATH 170A,A01,083459,Nie; Jiawang,1,6,30,29
1649969096212,MATH 170A,A02,083460,Nie; Jiawang,0,5,30,30
1649969096212,MATH 170A,A03,083461,Nie; Jiawang,0,5,30,30
1649969102238,MATH 193B,A01,083463,Staff,1,0,30,29
1649969102238,MATH 193B,A02,083464,Staff,10,0,30,20
1649969102238,MATH 193B,A03,083465,Staff,18,0,30,12
1649969108309,COGS 2,A01,083966,Boyle; Mary E. T.,16,0,30,14
1649969114335,COGS 9,A01,083968,Staff,30,0,60,30
1649969120371,COGS 14B,A01,083970,Staff,17,0,50,33
1649969126397,COGS 17,A01,092679,Staff,58,0,75,17
1649969132419,COGS 100,A01,083972,Staff,0,9,60,60
1649969144466,COGS 101C,A01,083976,Staff,16,0,30,14
1649969150489,COGS 102A,A01,083978,Johnson; Christine M.,14,0,30,16
1649969156510,COGS 107B,A01,083980,Staff,0,4,50,50
1649969162533,COGS 115,A01,083982,Staff,12,0,30,18
1649969168563,COGS 118B,A01,083367,Staff,0,11,40,40
1649969174585,COGS 172,A01,083984,Provenzano; Emily Kara,16,0,30,14
1649969180608,COGS 177,A00,083368,Staff,0,19,30,30
1649969186632,COGS 186,A01,083986,Staff,21,0,40,19
1649969192654,COGS 187A,A01,083988,Boyle; Mary E. T.,20,0,60,40
1649969198677,CSE 8A,A50,084003,Miranda; Gregory Joseph,0,4,15,15
1649969204706,CSE 11,A01,084005,Miranda; Gregory Joseph,0,7,55,55
1649969210730,CSE 20,A01,084007,Staff,5,0,20,15
1649969216762,CSE 21,A01,084009,Staff,0,13,50,50
1649969222788,CSE 30,A01,083370,Cao; Yingjun,0,47,40,40
1649969228823,CSE 100,A01,083372,Cao; Yingjun,0,44,40,40
1649969234848,CSE 101,A01,084011,Staff,0,53,40,40
1649969240875,CSE 141,A01,083374,Eldon; John,0,57,75,75
1649969246898,CSE 141L,A01,083376,Eldon; John,0,63,75,75
1649969252920,CSE 175,A01,084013,Kumar; Rakesh,22,0,25,3
1649969258944,CSE 190,A00,092508,Dubnov; Shlomo,15,0,15,0
1649969264967,ECE 5,A01,084049,Morris; Karcher William,14,0,20,6
1649969270989,ECE 100,A01,084051,Baghdadchi; Saharnaz,0,0,20,20
1649969270989,ECE 100,A02,091916,Baghdadchi; Saharnaz,15,0,20,5
1649969277013,ECE 101,A01,084053,Baghdadchi; Saharnaz,2,0,37,35
1649969277013,ECE 101,A02,084054,Baghdadchi; Saharnaz,31,0,37,6
1649969283035,ECE 107,A01,083390,Staff,28,0,40,12
1649969289066,ECE 148,A01,084056,Silberman; Jack,7,0,12,5
1649969295107,ECE 180,A00,083391,Abi Samra; Nicholas Camill,25,0,30,5
1649969295107,ECE 180,B00,083392,Abi Samra; Nicholas Camill,21,0,30,9
1649969301140,MATH 10B,A01,084110,Staff,7,0,30,23
1649969301140,MATH 10B,A02,084111,Staff,28,0,30,2
1649969301140,MATH 10B,A03,084112,Staff,26,0,30,4
1649969307166,MATH 10C,A01,083443,Staff,0,0,30,30
1649969307166,MATH 10C,A02,083444,Staff,10,0,30,20
1649969307166,MATH 10C,B01,084114,Staff,24,0,30,6
1649969307166,MATH 10C,B02,084115,Staff,28,0,30,2
1649969313189,MATH 18,A01,084117,Harel; Guershon,24,0,30,6
1649969313189,MATH 18,A02,084119,Harel; Guershon,28,0,30,2
1649969313189,MATH 18,A03,084120,Harel; Guershon,30,0,30,0
1649969313189,MATH 18,A04,084121,Harel; Guershon,29,0,30,1
1649969319211,MATH 20B,A01,084124,Um; Ko Woon,31,0,35,4
1649969319211,MATH 20B,B01,084126,Um; Ko Woon,30,0,35,5
1649969325239,MATH 20C,A01,083446,Hammock; Frances H,11,0,30,19
1649969325239,MATH 20C,A02,083447,Hammock; Frances H,28,0,30,2
1649969325239,MATH 20C,A03,083448,Hammock; Frances H,28,0,30,2
1649969325239,MATH 20C,A04,083449,Hammock; Frances H,30,0,30,0
1649969325239,MATH 20C,B01,083451,Hammock; Frances H,19,0,30,11
1649969325239,MATH 20C,B02,083452,Hammock; Frances H,26,0,30,4
1649969325239,MATH 20C,B03,083453,Hammock; Frances H,25,0,30,5
1649969325239,MATH 20C,B04,083454,Hammock; Frances H,30,0,30,0
1649969331266,MATH 20D,A01,084128,Staff,21,0,30,9
1649969331266,MATH 20D,A02,084129,Staff,30,0,30,0
1649969331266,MATH 20D,A03,084130,Staff,27,0,30,3
1649969331266,MATH 20D,B01,084133,Staff,11,0,30,19
1649969331266,MATH 20D,B02,084134,Staff,24,0,30,6
1649969331266,MATH 20D,B03,084135,Staff,29,0,30,1
1649969337292,MATH 20E,A01,084138,Staff,19,0,30,11
1649969337292,MATH 20E,A02,084139,Staff,15,0,30,15
1649969337292,MATH 20E,A03,084140,Staff,17,0,30,13
1649969337292,MATH 20E,A04,084141,Staff,23,0,30,7
1649969343327,MATH 102,A01,084143,Harel; Guershon,15,0,30,15
1649969343327,MATH 102,A02,084144,Harel; Guershon,21,0,30,9
1649969349358,MATH 103B,A01,083456,Staff,0,12,30,30
1649969349358,MATH 103B,A02,083457,Staff,0,12,30,30
1649969355386,MATH 109,A01,084146,Salehi Golsefidy; Alireza,23,0,30,7
1649969355386,MATH 109,A02,084147,Salehi Golsefidy; Alireza,20,0,30,10
1649969361423,MATH 120A,A01,085445,Eggers; John Dietrich,17,0,35,18
1649969361423,MATH 120A,A02,085446,Eggers; John Dietrich,27,0,35,8
1649969367446,MATH 142B,A01,084149,Verstraete; Jacques Allan,0,12,30,30
1649969367446,MATH 142B,A02,084150,Verstraete; Jacques Allan,0,12,30,30
1649969373475,MATH 170A,A01,083459,Nie; Jiawang,1,6,30,29
1649969373475,MATH 170A,A02,083460,Nie; Jiawang,0,6,30,30
1649969373475,MATH 170A,A03,083461,Nie; Jiawang,0,5,30,30
1649969379505,MATH 193B,A01,083463,Staff,1,0,30,29
1649969379505,MATH 193B,A02,083464,Staff,10,0,30,20
1649969379505,MATH 193B,A03,083465,Staff,18,0,30,12
1649969385565,COGS 2,A01,083966,Boyle; Mary E. T.,16,0,30,14
1649969391590,COGS 9,A01,083968,Staff,30,0,60,30
1649969397614,COGS 14B,A01,083970,Staff,17,0,50,33
1649969403638,COGS 17,A01,092679,Staff,58,0,75,17
1649969409661,COGS 100,A01,083972,Staff,0,9,60,60
1649969421714,COGS 101C,A01,083976,Staff,16,0,30,14
1649969427749,COGS 102A,A01,083978,Johnson; Christine M.,14,0,30,16
1649969433786,COGS 107B,A01,083980,Staff,0,4,50,50
1649969439809,COGS 115,A01,083982,Staff,12,0,30,18
1649969445833,COGS 118B,A01,083367,Staff,0,11,40,40
1649969451859,COGS 172,A01,083984,Provenzano; Emily Kara,16,0,30,14
1649969457880,COGS 177,A00,083368,Staff,0,19,30,30
1649969463909,COGS 186,A01,083986,Staff,21,0,40,19
1649969469934,COGS 187A,A01,083988,Boyle; Mary E. T.,20,0,60,40
1649969475974,CSE 8A,A50,084003,Miranda; Gregory Joseph,0,4,15,15
1649969482002,CSE 11,A01,084005,Miranda; Gregory Joseph,0,7,55,55
1649969488025,CSE 20,A01,084007,Staff,4,0,20,16
1649969494052,CSE 21,A01,084009,Staff,0,13,50,50
1649969500168,CSE 30,A01,083370,Cao; Yingjun,0,47,40,40
1649969506199,CSE 100,A01,083372,Cao; Yingjun,0,44,40,40
1649969512250,CSE 101,A01,084011,Staff,0,53,40,40
1649969518282,CSE 141,A01,083374,Eldon; John,0,57,75,75
1649969524308,CSE 141L,A01,083376,Eldon; John,0,63,75,75
1649969530333,CSE 175,A01,084013,Kumar; Rakesh,22,0,25,3
1649969536358,CSE 190,A00,092508,Dubnov; Shlomo,15,0,15,0
1649969542380,ECE 5,A01,084049,Morris; Karcher William,14,0,20,6
1649969548405,ECE 100,A01,084051,Baghdadchi; Saharnaz,0,0,20,20
1649969548405,ECE 100,A02,091916,Baghdadchi; Saharnaz,15,0,20,5
1649969554432,ECE 101,A01,084053,Baghdadchi; Saharnaz,2,0,37,35
1649969554432,ECE 101,A02,084054,Baghdadchi; Saharnaz,31,0,37,6
1649969560455,ECE 107,A01,083390,Staff,28,0,40,12
1649969566481,ECE 148,A01,084056,Silberman; Jack,7,0,12,5
1649969572511,ECE 180,A00,083391,Abi Samra; Nicholas Camill,25,0,30,5
1649969572511,ECE 180,B00,083392,Abi Samra; Nicholas Camill,21,0,30,9
1649969578543,MATH 10B,A01,084110,Staff,7,0,30,23
1649969578543,MATH 10B,A02,084111,Staff,27,0,30,3
1649969578543,MATH 10B,A03,084112,Staff,26,0,30,4
1649969584589,MATH 10C,A01,083443,Staff,0,0,30,30
1649969584589,MATH 10C,A02,083444,Staff,10,0,30,20
1649969584589,MATH 10C,B01,084114,Staff,24,0,30,6
1649969584589,MATH 10C,B02,084115,Staff,28,0,30,2
1649969590617,MATH 18,A01,084117,Harel; Guershon,24,0,30,6
1649969590617,MATH 18,A02,084119,Harel; Guershon,28,0,30,2
1649969590617,MATH 18,A03,084120,Harel; Guershon,30,0,30,0
1649969590617,MATH 18,A04,084121,Harel; Guershon,29,0,30,1
1649969596647,MATH 20B,A01,084124,Um; Ko Woon,31,0,35,4
1649969596647,MATH 20B,B01,084126,Um; Ko Woon,30,0,35,5
1649969602674,MATH 20C,A01,083446,Hammock; Frances H,11,0,30,19
1649969602674,MATH 20C,A02,083447,Hammock; Frances H,28,0,30,2
1649969602674,MATH 20C,A03,083448,Hammock; Frances H,28,0,30,2
1649969602674,MATH 20C,A04,083449,Hammock; Frances H,30,0,30,0
1649969602674,MATH 20C,B01,083451,Hammock; Frances H,19,0,30,11
1649969602674,MATH 20C,B02,083452,Hammock; Frances H,26,0,30,4
1649969602674,MATH 20C,B03,083453,Hammock; Frances H,25,0,30,5
1649969602674,MATH 20C,B04,083454,Hammock; Frances H,29,0,30,1
1649969608703,MATH 20D,A01,084128,Staff,21,0,30,9
1649969608703,MATH 20D,A02,084129,Staff,30,0,30,0
1649969608703,MATH 20D,A03,084130,Staff,27,0,30,3
1649969608703,MATH 20D,B01,084133,Staff,11,0,30,19
1649969608703,MATH 20D,B02,084134,Staff,24,0,30,6
1649969608703,MATH 20D,B03,084135,Staff,29,0,30,1
1649969614725,MATH 20E,A01,084138,Staff,19,0,30,11
1649969614725,MATH 20E,A02,084139,Staff,14,0,30,16
1649969614725,MATH 20E,A03,084140,Staff,17,0,30,13
1649969614725,MATH 20E,A04,084141,Staff,23,0,30,7
1649969620748,MATH 102,A01,084143,Harel; Guershon,15,0,30,15
1649969620748,MATH 102,A02,084144,Harel; Guershon,21,0,30,9
1649969626783,MATH 103B,A01,083456,Staff,0,12,30,30
1649969626783,MATH 103B,A02,083457,Staff,0,12,30,30
1649969632806,MATH 109,A01,084146,Salehi Golsefidy; Alireza,23,0,30,7
1649969632806,MATH 109,A02,084147,Salehi Golsefidy; Alireza,19,0,30,11
1649969638833,MATH 120A,A01,085445,Eggers; John Dietrich,17,0,35,18
1649969638833,MATH 120A,A02,085446,Eggers; John Dietrich,27,0,35,8
1649969644864,MATH 142B,A01,084149,Verstraete; Jacques Allan,0,12,30,30
1649969644864,MATH 142B,A02,084150,Verstraete; Jacques Allan,0,12,30,30
1649969650887,MATH 170A,A01,083459,Nie; Jiawang,1,6,30,29
1649969650887,MATH 170A,A02,083460,Nie; Jiawang,0,6,30,30
1649969650887,MATH 170A,A03,083461,Nie; Jiawang,0,5,30,30
1649969656921,MATH 193B,A01,083463,Staff,1,0,30,29
1649969656921,MATH 193B,A02,083464,Staff,10,0,30,20
1649969656921,MATH 193B,A03,083465,Staff,18,0,30,12
1649969662977,COGS 2,A01,083966,Boyle; Mary E. T.,16,0,30,14
1649969669009,COGS 9,A01,083968,Staff,29,0,60,31
1649969675035,COGS 14B,A01,083970,Staff,17,0,50,33
1649969681070,COGS 17,A01,092679,Staff,58,0,75,17
1649969687093,COGS 100,A01,083972,Staff,0,9,60,60
1649969699157,COGS 101C,A01,083976,Staff,16,0,30,14
1649969705179,COGS 102A,A01,083978,Johnson; Christine M.,14,0,30,16
1649969711202,COGS 107B,A01,083980,Staff,0,4,50,50
1649969717225,COGS 115,A01,083982,Staff,12,0,30,18
1649969723271,COGS 118B,A01,083367,Staff,0,11,40,40
1649969729298,COGS 172,A01,083984,Provenzano; Emily Kara,15,0,30,15
1649969735321,COGS 177,A00,083368,Staff,0,19,30,30
1649969741346,COGS 186,A01,083986,Staff,21,0,40,19
1649969747373,COGS 187A,A01,083988,Boyle; Mary E. T.,20,0,60,40
1649969753397,CSE 8A,A50,084003,Miranda; Gregory Joseph,0,4,15,15
1649969759422,CSE 11,A01,084005,Miranda; Gregory Joseph,0,7,55,55
1649969765444,CSE 20,A01,084007,Staff,4,0,20,16
1649969771469,CSE 21,A01,084009,Staff,0,13,50,50
1649969777503,CSE 30,A01,083370,Cao; Yingjun,0,47,40,40
1649969783536,CSE 100,A01,083372,Cao; Yingjun,0,44,40,40
1649969789572,CSE 101,A01,084011,Staff,0,53,40,40
1649969795598,CSE 141,A01,083374,Eldon; John,0,57,75,75
1649969801624,CSE 141L,A01,083376,Eldon; John,0,63,75,75
1649969807650,CSE 175,A01,084013,Kumar; Rakesh,22,0,25,3
1649969813679,CSE 190,A00,092508,Dubnov; Shlomo,15,0,15,0
1649969819711,ECE 5,A01,084049,Morris; Karcher William,14,0,20,6
1649969825741,ECE 100,A01,084051,Baghdadchi; Saharnaz,0,0,20,20
1649969825741,ECE 100,A02,091916,Baghdadchi; Saharnaz,15,0,20,5
1649969831764,ECE 101,A01,084053,Baghdadchi; Saharnaz,2,0,37,35
1649969831764,ECE 101,A02,084054,Baghdadchi; Saharnaz,31,0,37,6
1649969837788,ECE 107,A01,083390,Staff,28,0,40,12
1649969843834,ECE 148,A01,084056,Silberman; Jack,7,0,12,5
1649969849857,ECE 180,A00,083391,Abi Samra; Nicholas Camill,25,0,30,5
1649969849857,ECE 180,B00,083392,Abi Samra; Nicholas Camill,21,0,30,9
1649969855884,MATH 10B,A01,084110,Staff,7,0,30,23
1649969855884,MATH 10B,A02,084111,Staff,27,0,30,3
1649969855884,MATH 10B,A03,084112,Staff,26,0,30,4
1649969861908,MATH 10C,A01,083443,Staff,0,0,30,30
1649969861908,MATH 10C,A02,083444,Staff,10,0,30,20
1649969861908,MATH 10C,B01,084114,Staff,24,0,30,6
1649969861908,MATH 10C,B02,084115,Staff,28,0,30,2
1649969867947,MATH 18,A01,084117,Harel; Guershon,24,0,30,6
1649969867947,MATH 18,A02,084119,Harel; Guershon,28,0,30,2
1649969867947,MATH 18,A03,084120,Harel; Guershon,30,0,30,0
1649969867947,MATH 18,A04,084121,Harel; Guershon,29,0,30,1
1649969873979,MATH 20B,A01,084124,Um; Ko Woon,31,0,35,4
1649969873979,MATH 20B,B01,084126,Um; Ko Woon,30,0,35,5
1649969880011,MATH 20C,A01,083446,Hammock; Frances H,11,0,30,19
1649969880011,MATH 20C,A02,083447,Hammock; Frances H,28,0,30,2
1649969880011,MATH 20C,A03,083448,Hammock; Frances H,28,0,30,2
1649969880011,MATH 20C,A04,083449,Hammock; Frances H,30,0,30,0
1649969880011,MATH 20C,B01,083451,Hammock; Frances H,19,0,30,11
1649969880011,MATH 20C,B02,083452,Hammock; Frances H,26,0,30,4
1649969880011,MATH 20C,B03,083453,Hammock; Frances H,25,0,30,5
1649969880011,MATH 20C,B04,083454,Hammock; Frances H,28,0,30,2
1649969886063,MATH 20D,A01,084128,Staff,21,0,30,9
1649969886063,MATH 20D,A02,084129,Staff,30,0,30,0
1649969886063,MATH 20D,A03,084130,Staff,27,0,30,3
1649969886063,MATH 20D,B01,084133,Staff,11,0,30,19
1649969886063,MATH 20D,B02,084134,Staff,24,0,30,6
1649969886063,MATH 20D,B03,084135,Staff,29,0,30,1
1649969892088,MATH 20E,A01,084138,Staff,19,0,30,11
1649969892088,MATH 20E,A02,084139,Staff,14,0,30,16
1649969892088,MATH 20E,A03,084140,Staff,17,0,30,13
1649969892088,MATH 20E,A04,084141,Staff,23,0,30,7
1649969898114,MATH 102,A01,084143,Harel; Guershon,15,0,30,15
1649969898114,MATH 102,A02,084144,Harel; Guershon,21,0,30,9
1649969904145,MATH 103B,A01,083456,Staff,0,12,30,30
1649969904145,MATH 103B,A02,083457,Staff,0,12,30,30
1649969910167,MATH 109,A01,084146,Salehi Golsefidy; Alireza,23,0,30,7
1649969910167,MATH 109,A02,084147,Salehi Golsefidy; Alireza,19,0,30,11
1649969916193,MATH 120A,A01,085445,Eggers; John Dietrich,17,0,35,18
1649969916193,MATH 120A,A02,085446,Eggers; John Dietrich,27,0,35,8
1649969922222,MATH 142B,A01,084149,Verstraete; Jacques Allan,0,12,30,30
1649969922222,MATH 142B,A02,084150,Verstraete; Jacques Allan,0,12,30,30
1649969928243,MATH 170A,A01,083459,Nie; Jiawang,1,6,30,29
1649969928243,MATH 170A,A02,083460,Nie; Jiawang,0,6,30,30
1649969928243,MATH 170A,A03,083461,Nie; Jiawang,0,5,30,30
1649969934270,MATH 193B,A01,083463,Staff,1,0,30,29
1649969934270,MATH 193B,A02,083464,Staff,10,0,30,20
1649969934270,MATH 193B,A03,083465,Staff,18,0,30,12
1649969940348,COGS 2,A01,083966,Boyle; Mary E. T.,16,0,30,14
1649969946375,COGS 9,A01,083968,Staff,28,0,60,32
1649969952403,COGS 14B,A01,083970,Staff,17,0,50,33
1649969958425,COGS 17,A01,092679,Staff,58,0,75,17
1649969964449,COGS 100,A01,083972,Staff,0,9,60,60
1649969976509,COGS 101C,A01,083976,Staff,16,0,30,14
1649969982538,COGS 102A,A01,083978,Johnson; Christine M.,14,0,30,16
1649969988566,COGS 107B,A01,083980,Staff,0,4,50,50
1649969994589,COGS 115,A01,083982,Staff,12,0,30,18
1649970000616,COGS 118B,A01,083367,Staff,0,11,40,40
1649970006656,COGS 172,A01,083984,Provenzano; Emily Kara,15,0,30,15
1649970012680,COGS 177,A00,083368,Staff,0,19,30,30
1649970018702,COGS 186,A01,083986,Staff,21,0,40,19
1649970024728,COGS 187A,A01,083988,Boyle; Mary E. T.,20,0,60,40
1649970030755,CSE 8A,A50,084003,Miranda; Gregory Joseph,0,4,15,15
1649970036787,CSE 11,A01,084005,Miranda; Gregory Joseph,0,8,55,55
1649970042809,CSE 20,A01,084007,Staff,4,0,20,16
1649970048831,CSE 21,A01,084009,Staff,0,13,50,50
1649970054860,CSE 30,A01,083370,Cao; Yingjun,0,47,40,40
1649970060889,CSE 100,A01,083372,Cao; Yingjun,0,44,40,40
1649970066947,CSE 101,A01,084011,Staff,0,53,40,40
1649970072967,CSE 141,A01,083374,Eldon; John,0,57,75,75
1649970078993,CSE 141L,A01,083376,Eldon; John,0,63,75,75
1649970085027,CSE 175,A01,084013,Kumar; Rakesh,22,0,25,3
1649970091049,CSE 190,A00,092508,Dubnov; Shlomo,15,0,15,0
1649970097144,ECE 5,A01,084049,Morris; Karcher William,14,0,20,6
1649970103170,ECE 100,A01,084051,Baghdadchi; Saharnaz,0,0,20,20
1649970103170,ECE 100,A02,091916,Baghdadchi; Saharnaz,15,0,20,5
1649970109196,ECE 101,A01,084053,Baghdadchi; Saharnaz,2,0,37,35
1649970109196,ECE 101,A02,084054,Baghdadchi; Saharnaz,31,0,37,6
1649970115219,ECE 107,A01,083390,Staff,28,0,40,12
1649970121244,ECE 148,A01,084056,Silberman; Jack,7,0,12,5
1649970127279,ECE 180,A00,083391,Abi Samra; Nicholas Camill,25,0,30,5
1649970127279,ECE 180,B00,083392,Abi Samra; Nicholas Camill,21,0,30,9
1649970133304,MATH 10B,A01,084110,Staff,7,0,30,23
1649970133304,MATH 10B,A02,084111,Staff,27,0,30,3
1649970133304,MATH 10B,A03,084112,Staff,26,0,30,4
1649970139335,MATH 10C,A01,083443,Staff,0,0,30,30
1649970139335,MATH 10C,A02,083444,Staff,9,0,30,21
1649970139335,MATH 10C,B01,084114,Staff,24,0,30,6
1649970139335,MATH 10C,B02,084115,Staff,28,0,30,2
1649970145367,MATH 18,A01,084117,Harel; Guershon,24,0,30,6
1649970145367,MATH 18,A02,084119,Harel; Guershon,28,0,30,2
1649970145367,MATH 18,A03,084120,Harel; Guershon,30,0,30,0
1649970145367,MATH 18,A04,084121,Harel; Guershon,29,0,30,1
1649970151394,MATH 20B,A01,084124,Um; Ko Woon,31,0,35,4
1649970151394,MATH 20B,B01,084126,Um; Ko Woon,30,0,35,5
1649970157436,MATH 20C,A01,083446,Hammock; Frances H,11,0,30,19
1649970157436,MATH 20C,A02,083447,Hammock; Frances H,28,0,30,2
1649970157436,MATH 20C,A03,083448,Hammock; Frances H,28,0,30,2
1649970157436,MATH 20C,A04,083449,Hammock; Frances H,30,0,30,0
1649970157436,MATH 20C,B01,083451,Hammock; Frances H,18,0,30,12
1649970157436,MATH 20C,B02,083452,Hammock; Frances H,26,0,30,4
1649970157436,MATH 20C,B03,083453,Hammock; Frances H,25,0,30,5
1649970157436,MATH 20C,B04,083454,Hammock; Frances H,28,0,30,2
1649970163475,MATH 20D,A01,084128,Staff,21,0,30,9
1649970163475,MATH 20D,A02,084129,Staff,30,0,30,0
1649970163475,MATH 20D,A03,084130,Staff,27,0,30,3
1649970163475,MATH 20D,B01,084133,Staff,11,0,30,19
1649970163475,MATH 20D,B02,084134,Staff,24,0,30,6
1649970163475,MATH 20D,B03,084135,Staff,29,0,30,1
1649970169500,MATH 20E,A01,084138,Staff,19,0,30,11
1649970169500,MATH 20E,A02,084139,Staff,14,0,30,16
1649970169500,MATH 20E,A03,084140,Staff,17,0,30,13
1649970169500,MATH 20E,A04,084141,Staff,23,0,30,7
1649970175530,MATH 102,A01,084143,Harel; Guershon,15,0,30,15
1649970175530,MATH 102,A02,084144,Harel; Guershon,21,0,30,9
1649970181553,MATH 103B,A01,083456,Staff,0,13,30,30
1649970181553,MATH 103B,A02,083457,Staff,0,12,30,30
1649970187589,MATH 109,A01,084146,Salehi Golsefidy; Alireza,23,0,30,7
1649970187589,MATH 109,A02,084147,Salehi Golsefidy; Alireza,19,0,30,11
1649970193623,MATH 120A,A01,085445,Eggers; John Dietrich,17,0,35,18
1649970193623,MATH 120A,A02,085446,Eggers; John Dietrich,27,0,35,8
1649970199651,MATH 142B,A01,084149,Verstraete; Jacques Allan,0,12,30,30
1649970199651,MATH 142B,A02,084150,Verstraete; Jacques Allan,0,12,30,30
1649970205684,MATH 170A,A01,083459,Nie; Jiawang,1,6,30,29
1649970205684,MATH 170A,A02,083460,Nie; Jiawang,0,6,30,30
1649970205684,MATH 170A,A03,083461,Nie; Jiawang,0,5,30,30
1649970211709,MATH 193B,A01,083463,Staff,1,0,30,29
1649970211709,MATH 193B,A02,083464,Staff,10,0,30,20
1649970211709,MATH 193B,A03,083465,Staff,18,0,30,12
1649970217758,COGS 2,A01,083966,Boyle; Mary E. T.,16,0,30,14
1649970223781,COGS 9,A01,083968,Staff,27,0,60,33
1649970229803,COGS 14B,A01,083970,Staff,17,0,50,33
1649970235830,COGS 17,A01,092679,Staff,57,0,75,18
1649970241853,COGS 100,A01,083972,Staff,0,10,60,60
1649970253912,COGS 101C,A01,083976,Staff,16,0,30,14
1649970259937,COGS 102A,A01,083978,Johnson; Christine M.,14,0,30,16
1649970265960,COGS 107B,A01,083980,Staff,0,4,50,50
1649970271990,COGS 115,A01,083982,Staff,12,0,30,18
1649970278020,COGS 118B,A01,083367,Staff,0,11,40,40
1649970284054,COGS 172,A01,083984,Provenzano; Emily Kara,15,0,30,15
1649970290076,COGS 177,A00,083368,Staff,0,19,30,30
1649970296100,COGS 186,A01,083986,Staff,21,0,40,19
1649970302137,COGS 187A,A01,083988,Boyle; Mary E. T.,20,0,60,40
1649970308162,CSE 8A,A50,084003,Miranda; Gregory Joseph,0,4,15,15
1649970314189,CSE 11,A01,084005,Miranda; Gregory Joseph,0,9,55,55
1649970320222,CSE 20,A01,084007,Staff,4,0,20,16
1649970326244,CSE 21,A01,084009,Staff,0,13,50,50
1649970332272,CSE 30,A01,083370,Cao; Yingjun,0,48,40,40
1649970338296,CSE 100,A01,083372,Cao; Yingjun,0,45,40,40
1649970344318,CSE 101,A01,084011,Staff,0,53,40,40
1649970350345,CSE 141,A01,083374,Eldon; John,0,57,75,75
1649970356379,CSE 141L,A01,083376,Eldon; John,0,63,75,75
1649970362405,CSE 175,A01,084013,Kumar; Rakesh,22,0,25,3
1649970368431,CSE 190,A00,092508,Dubnov; Shlomo,15,0,15,0
1649970374457,ECE 5,A01,084049,Morris; Karcher William,14,0,20,6
1649970380479,ECE 100,A01,084051,Baghdadchi; Saharnaz,0,0,20,20
1649970380479,ECE 100,A02,091916,Baghdadchi; Saharnaz,15,0,20,5
1649970386508,ECE 101,A01,084053,Baghdadchi; Saharnaz,2,0,37,35
1649970386508,ECE 101,A02,084054,Baghdadchi; Saharnaz,31,0,37,6
1649970392534,ECE 107,A01,083390,Staff,28,0,40,12
1649970398572,ECE 148,A01,084056,Silberman; Jack,7,0,12,5
1649970404612,ECE 180,A00,083391,Abi Samra; Nicholas Camill,25,0,30,5
1649970404612,ECE 180,B00,083392,Abi Samra; Nicholas Camill,21,0,30,9
1649970410640,MATH 10B,A01,084110,Staff,7,0,30,23
1649970410640,MATH 10B,A02,084111,Staff,27,0,30,3
1649970410640,MATH 10B,A03,084112,Staff,26,0,30,4
1649970416671,MATH 10C,A01,083443,Staff,0,0,30,30
1649970416671,MATH 10C,A02,083444,Staff,9,0,30,21
1649970416671,MATH 10C,B01,084114,Staff,24,0,30,6
1649970416671,MATH 10C,B02,084115,Staff,28,0,30,2
1649970422693,MATH 18,A01,084117,Harel; Guershon,24,0,30,6
1649970422693,MATH 18,A02,084119,Harel; Guershon,28,0,30,2
1649970422693,MATH 18,A03,084120,Harel; Guershon,30,0,30,0
1649970422693,MATH 18,A04,084121,Harel; Guershon,29,0,30,1
1649970428715,MATH 20B,A01,084124,Um; Ko Woon,30,0,35,5
1649970428715,MATH 20B,B01,084126,Um; Ko Woon,30,0,35,5
1649970434739,MATH 20C,A01,083446,Hammock; Frances H,11,0,30,19
1649970434739,MATH 20C,A02,083447,Hammock; Frances H,28,0,30,2
1649970434739,MATH 20C,A03,083448,Hammock; Frances H,28,0,30,2
1649970434739,MATH 20C,A04,083449,Hammock; Frances H,30,0,30,0
1649970434739,MATH 20C,B01,083451,Hammock; Frances H,18,0,30,12
1649970434739,MATH 20C,B02,083452,Hammock; Frances H,26,0,30,4
1649970434739,MATH 20C,B03,083453,Hammock; Frances H,25,0,30,5
1649970434739,MATH 20C,B04,083454,Hammock; Frances H,28,0,30,2
1649970440762,MATH 20D,A01,084128,Staff,21,0,30,9
1649970440762,MATH 20D,A02,084129,Staff,30,0,30,0
1649970440762,MATH 20D,A03,084130,Staff,27,0,30,3
1649970440762,MATH 20D,B01,084133,Staff,11,0,30,19
1649970440762,MATH 20D,B02,084134,Staff,24,0,30,6
1649970440762,MATH 20D,B03,084135,Staff,29,0,30,1
1649970446792,MATH 20E,A01,084138,Staff,19,0,30,11
1649970446792,MATH 20E,A02,084139,Staff,14,0,30,16
1649970446792,MATH 20E,A03,084140,Staff,17,0,30,13
1649970446792,MATH 20E,A04,084141,Staff,23,0,30,7
1649970452814,MATH 102,A01,084143,Harel; Guershon,15,0,30,15
1649970452814,MATH 102,A02,084144,Harel; Guershon,21,0,30,9
1649970458847,MATH 103B,A01,083456,Staff,0,13,30,30
1649970458847,MATH 103B,A02,083457,Staff,0,12,30,30
1649970464877,MATH 109,A01,084146,Salehi Golsefidy; Alireza,22,0,30,8
1649970464877,MATH 109,A02,084147,Salehi Golsefidy; Alireza,19,0,30,11
1649970470912,MATH 120A,A01,085445,Eggers; John Dietrich,17,0,35,18
1649970470912,MATH 120A,A02,085446,Eggers; John Dietrich,27,0,35,8
1649970476936,MATH 142B,A01,084149,Verstraete; Jacques Allan,0,12,30,30
1649970476936,MATH 142B,A02,084150,Verstraete; Jacques Allan,0,12,30,30
1649970482967,MATH 170A,A01,083459,Nie; Jiawang,1,6,30,29
1649970482967,MATH 170A,A02,083460,Nie; Jiawang,0,6,30,30
1649970482967,MATH 170A,A03,083461,Nie; Jiawang,0,5,30,30
1649970488990,MATH 193B,A01,083463,Staff,1,0,30,29
1649970488990,MATH 193B,A02,083464,Staff,10,0,30,20
1649970488990,MATH 193B,A03,083465,Staff,18,0,30,12
1649970495051,COGS 2,A01,083966,Boyle; Mary E. T.,16,0,30,14
1649970501094,COGS 9,A01,083968,Staff,27,0,60,33
1649970507129,COGS 14B,A01,083970,Staff,17,0,50,33
1649970513152,COGS 17,A01,092679,Staff,57,0,75,18
1649970519182,COGS 100,A01,083972,Staff,0,10,60,60
1649970531272,COGS 101C,A01,083976,Staff,16,0,30,14
1649970537312,COGS 102A,A01,083978,Johnson; Christine M.,14,0,30,16
1649970543337,COGS 107B,A01,083980,Staff,0,4,50,50
1649970549367,COGS 115,A01,083982,Staff,12,0,30,18
1649970555388,COGS 118B,A01,083367,Staff,0,12,40,40
1649970561417,COGS 172,A01,083984,Provenzano; Emily Kara,15,0,30,15
1649970567445,COGS 177,A00,083368,Staff,0,19,30,30
1649970573469,COGS 186,A01,083986,Staff,21,0,40,19
1649970579492,COGS 187A,A01,083988,Boyle; Mary E. T.,20,0,60,40
1649970585515,CSE 8A,A50,084003,Miranda; Gregory Joseph,0,4,15,15
1649970591539,CSE 11,A01,084005,Miranda; Gregory Joseph,0,9,55,55
1649970597565,CSE 20,A01,084007,Staff,4,0,20,16
1649970603590,CSE 21,A01,084009,Staff,0,13,50,50
1649970609615,CSE 30,A01,083370,Cao; Yingjun,0,48,40,40
1649970615637,CSE 100,A01,083372,Cao; Yingjun,0,44,40,40
1649970621665,CSE 101,A01,084011,Staff,0,53,40,40
1649970627687,CSE 141,A01,083374,Eldon; John,0,57,75,75
1649970633724,CSE 141L,A01,083376,Eldon; John,0,63,75,75
1649970639748,CSE 175,A01,084013,Kumar; Rakesh,22,0,25,3
1649970645776,CSE 190,A00,092508,Dubnov; Shlomo,15,0,15,0
1649970651803,ECE 5,A01,084049,Morris; Karcher William,13,0,20,7
1649970657827,ECE 100,A01,084051,Baghdadchi; Saharnaz,0,0,20,20
1649970657827,ECE 100,A02,091916,Baghdadchi; Saharnaz,15,0,20,5
1649970663858,ECE 101,A01,084053,Baghdadchi; Saharnaz,2,0,37,35
1649970663858,ECE 101,A02,084054,Baghdadchi; Saharnaz,31,0,37,6
1649970669882,ECE 107,A01,083390,Staff,28,0,40,12
1649970675908,ECE 148,A01,084056,Silberman; Jack,7,0,12,5
1649970681939,ECE 180,A00,083391,Abi Samra; Nicholas Camill,25,0,30,5
1649970681939,ECE 180,B00,083392,Abi Samra; Nicholas Camill,21,0,30,9
1649970687974,MATH 10B,A01,084110,Staff,6,0,30,24
1649970687974,MATH 10B,A02,084111,Staff,27,0,30,3
1649970687974,MATH 10B,A03,084112,Staff,26,0,30,4
1649970694101,MATH 10C,A01,083443,Staff,0,0,30,30
1649970694101,MATH 10C,A02,083444,Staff,8,0,30,22
1649970694101,MATH 10C,B01,084114,Staff,24,0,30,6
1649970694101,MATH 10C,B02,084115,Staff,28,0,30,2
1649970700135,MATH 18,A01,084117,Harel; Guershon,24,0,30,6
1649970700135,MATH 18,A02,084119,Harel; Guershon,28,0,30,2
1649970700135,MATH 18,A03,084120,Harel; Guershon,30,0,30,0
1649970700135,MATH 18,A04,084121,Harel; Guershon,29,0,30,1
1649970706163,MATH 20B,A01,084124,Um; Ko Woon,30,0,35,5
1649970706163,MATH 20B,B01,084126,Um; Ko Woon,30,0,35,5
1649970712186,MATH 20C,A01,083446,Hammock; Frances H,11,0,30,19
1649970712186,MATH 20C,A02,083447,Hammock; Frances H,28,0,30,2
1649970712186,MATH 20C,A03,083448,Hammock; Frances H,28,0,30,2
1649970712186,MATH 20C,A04,083449,Hammock; Frances H,30,0,30,0
1649970712186,MATH 20C,B01,083451,Hammock; Frances H,18,0,30,12
1649970712186,MATH 20C,B02,083452,Hammock; Frances H,26,0,30,4
1649970712186,MATH 20C,B03,083453,Hammock; Frances H,25,0,30,5
1649970712186,MATH 20C,B04,083454,Hammock; Frances H,28,0,30,2
1649970718209,MATH 20D,A01,084128,Staff,21,0,30,9
1649970718209,MATH 20D,A02,084129,Staff,30,0,30,0
1649970718209,MATH 20D,A03,084130,Staff,27,0,30,3
1649970718209,MATH 20D,B01,084133,Staff,11,0,30,19
1649970718209,MATH 20D,B02,084134,Staff,24,0,30,6
1649970718209,MATH 20D,B03,084135,Staff,29,0,30,1
1649970724232,MATH 20E,A01,084138,Staff,19,0,30,11
1649970724232,MATH 20E,A02,084139,Staff,14,0,30,16
1649970724232,MATH 20E,A03,084140,Staff,17,0,30,13
1649970724232,MATH 20E,A04,084141,Staff,23,0,30,7
1649970730255,MATH 102,A01,084143,Harel; Guershon,15,0,30,15
1649970730255,MATH 102,A02,084144,Harel; Guershon,21,0,30,9
1649970736276,MATH 103B,A01,083456,Staff,0,12,30,30
1649970736276,MATH 103B,A02,083457,Staff,0,12,30,30
1649970742306,MATH 109,A01,084146,Salehi Golsefidy; Alireza,21,0,30,9
1649970742306,MATH 109,A02,084147,Salehi Golsefidy; Alireza,19,0,30,11
1649970748329,MATH 120A,A01,085445,Eggers; John Dietrich,17,0,35,18
1649970748329,MATH 120A,A02,085446,Eggers; John Dietrich,27,0,35,8
1649970754354,MATH 142B,A01,084149,Verstraete; Jacques Allan,0,12,30,30
1649970754354,MATH 142B,A02,084150,Verstraete; Jacques Allan,0,12,30,30
1649970760381,MATH 170A,A01,083459,Nie; Jiawang,1,6,30,29
1649970760381,MATH 170A,A02,083460,Nie; Jiawang,0,6,30,30
1649970760381,MATH 170A,A03,083461,Nie; Jiawang,0,6,30,30
1649970766407,MATH 193B,A01,083463,Staff,1,0,30,29
1649970766407,MATH 193B,A02,083464,Staff,10,0,30,20
1649970766407,MATH 193B,A03,083465,Staff,18,0,30,12
1649970772469,COGS 2,A01,083966,Boyle; Mary E. T.,16,0,30,14
1649970778499,COGS 9,A01,083968,Staff,26,0,60,34
1649970784530,COGS 14B,A01,083970,Staff,16,0,50,34
1649970790573,COGS 17,A01,092679,Staff,57,0,75,18
1649970796607,COGS 100,A01,083972,Staff,0,10,60,60
1649970808672,COGS 101C,A01,083976,Staff,16,0,30,14
1649970814699,COGS 102A,A01,083978,Johnson; Christine M.,14,0,30,16
1649970820720,COGS 107B,A01,083980,Staff,0,4,50,50
1649970826743,COGS 115,A01,083982,Staff,12,0,30,18
1649970832782,COGS 118B,A01,083367,Staff,0,12,40,40
1649970838808,COGS 172,A01,083984,Provenzano; Emily Kara,15,0,30,15
1649970844911,COGS 177,A00,083368,Staff,0,19,30,30
1649970850933,COGS 186,A01,083986,Staff,21,0,40,19
1649970856957,COGS 187A,A01,083988,Boyle; Mary E. T.,20,0,60,40
1649970862982,CSE 8A,A50,084003,Miranda; Gregory Joseph,0,4,15,15
1649970869007,CSE 11,A01,084005,Miranda; Gregory Joseph,0,9,55,55
1649970875044,CSE 20,A01,084007,Staff,4,0,20,16
1649970881069,CSE 21,A01,084009,Staff,0,13,50,50
1649970887096,CSE 30,A01,083370,Cao; Yingjun,0,48,40,40
1649970893122,CSE 100,A01,083372,Cao; Yingjun,0,44,40,40
1649970899145,CSE 101,A01,084011,Staff,0,53,40,40
1649970905168,CSE 141,A01,083374,Eldon; John,0,57,75,75
1649970911222,CSE 141L,A01,083376,Eldon; John,0,63,75,75
1649970917244,CSE 175,A01,084013,Kumar; Rakesh,22,0,25,3
1649970923269,CSE 190,A00,092508,Dubnov; Shlomo,15,0,15,0
1649970929299,ECE 5,A01,084049,Morris; Karcher William,13,0,20,7
1649970935327,ECE 100,A01,084051,Baghdadchi; Saharnaz,0,0,20,20
1649970935327,ECE 100,A02,091916,Baghdadchi; Saharnaz,15,0,20,5
1649970941355,ECE 101,A01,084053,Baghdadchi; Saharnaz,2,0,37,35
1649970941355,ECE 101,A02,084054,Baghdadchi; Saharnaz,31,0,37,6
1649970947380,ECE 107,A01,083390,Staff,28,0,40,12
1649970953405,ECE 148,A01,084056,Silberman; Jack,7,0,12,5
1649970959428,ECE 180,A00,083391,Abi Samra; Nicholas Camill,25,0,30,5
1649970959428,ECE 180,B00,083392,Abi Samra; Nicholas Camill,21,0,30,9
1649970965461,MATH 10B,A01,084110,Staff,6,0,30,24
1649970965461,MATH 10B,A02,084111,Staff,27,0,30,3
1649970965461,MATH 10B,A03,084112,Staff,26,0,30,4
1649970971497,MATH 10C,A01,083443,Staff,0,0,30,30
1649970971497,MATH 10C,A02,083444,Staff,8,0,30,22
1649970971497,MATH 10C,B01,084114,Staff,24,0,30,6
1649970971497,MATH 10C,B02,084115,Staff,28,0,30,2
1649970977523,MATH 18,A01,084117,Harel; Guershon,24,0,30,6
1649970977523,MATH 18,A02,084119,Harel; Guershon,28,0,30,2
1649970977523,MATH 18,A03,084120,Harel; Guershon,30,0,30,0
1649970977523,MATH 18,A04,084121,Harel; Guershon,29,0,30,1
1649970983558,MATH 20B,A01,084124,Um; Ko Woon,30,0,35,5
1649970983558,MATH 20B,B01,084126,Um; Ko Woon,29,0,35,6
1649970989587,MATH 20C,A01,083446,Hammock; Frances H,11,0,30,19
1649970989587,MATH 20C,A02,083447,Hammock; Frances H,28,0,30,2
1649970989587,MATH 20C,A03,083448,Hammock; Frances H,28,0,30,2
1649970989587,MATH 20C,A04,083449,Hammock; Frances H,30,0,30,0
1649970989587,MATH 20C,B01,083451,Hammock; Frances H,18,0,30,12
1649970989587,MATH 20C,B02,083452,Hammock; Frances H,26,0,30,4
1649970989587,MATH 20C,B03,083453,Hammock; Frances H,25,0,30,5
1649970989587,MATH 20C,B04,083454,Hammock; Frances H,28,0,30,2
1649970995620,MATH 20D,A01,084128,Staff,21,0,30,9
1649970995620,MATH 20D,A02,084129,Staff,30,0,30,0
1649970995620,MATH 20D,A03,084130,Staff,27,0,30,3
1649970995620,MATH 20D,B01,084133,Staff,11,0,30,19
1649970995620,MATH 20D,B02,084134,Staff,24,0,30,6
1649970995620,MATH 20D,B03,084135,Staff,29,0,30,1
1649971001647,MATH 20E,A01,084138,Staff,19,0,30,11
1649971001647,MATH 20E,A02,084139,Staff,14,0,30,16
1649971001647,MATH 20E,A03,084140,Staff,17,0,30,13
1649971001647,MATH 20E,A04,084141,Staff,23,0,30,7
1649971007678,MATH 102,A01,084143,Harel; Guershon,15,0,30,15
1649971007678,MATH 102,A02,084144,Harel; Guershon,21,0,30,9
1649971013708,MATH 103B,A01,083456,Staff,0,12,30,30
1649971013708,MATH 103B,A02,083457,Staff,0,12,30,30
1649971019744,MATH 109,A01,084146,Salehi Golsefidy; Alireza,22,0,30,8
1649971019744,MATH 109,A02,084147,Salehi Golsefidy; Alireza,19,0,30,11
1649971025772,MATH 120A,A01,085445,Eggers; John Dietrich,17,0,35,18
1649971025772,MATH 120A,A02,085446,Eggers; John Dietrich,27,0,35,8
1649971031801,MATH 142B,A01,084149,Verstraete; Jacques Allan,0,12,30,30
1649971031801,MATH 142B,A02,084150,Verstraete; Jacques Allan,0,12,30,30
1649971037826,MATH 170A,A01,083459,Nie; Jiawang,1,6,30,29
1649971037826,MATH 170A,A02,083460,Nie; Jiawang,0,6,30,30
1649971037826,MATH 170A,A03,083461,Nie; Jiawang,0,6,30,30
1649971043856,MATH 193B,A01,083463,Staff,1,0,30,29
1649971043856,MATH 193B,A02,083464,Staff,10,0,30,20
1649971043856,MATH 193B,A03,083465,Staff,18,0,30,12
1649971049915,COGS 2,A01,083966,Boyle; Mary E. T.,15,0,30,15
1649971055956,COGS 9,A01,083968,Staff,26,0,60,34
1649971061983,COGS 14B,A01,083970,Staff,16,0,50,34
1649971068007,COGS 17,A01,092679,Staff,57,0,75,18
1649971074030,COGS 100,A01,083972,Staff,0,10,60,60
1649971086146,COGS 101C,A01,083976,Staff,16,0,30,14
1649971092183,COGS 102A,A01,083978,Johnson; Christine M.,14,0,30,16
1649971098218,COGS 107B,A01,083980,Staff,0,4,50,50
1649971104250,COGS 115,A01,083982,Staff,12,0,30,18
1649971110272,COGS 118B,A01,083367,Staff,0,12,40,40
1649971116297,COGS 172,A01,083984,Provenzano; Emily Kara,15,0,30,15
1649971122324,COGS 177,A00,083368,Staff,0,19,30,30
1649971128361,COGS 186,A01,083986,Staff,21,0,40,19
1649971134384,COGS 187A,A01,083988,Boyle; Mary E. T.,20,0,60,40
1649971140409,CSE 8A,A50,084003,Miranda; Gregory Joseph,0,4,15,15
1649971146441,CSE 11,A01,084005,Miranda; Gregory Joseph,0,9,55,55
1649971152480,CSE 20,A01,084007,Staff,4,0,20,16
1649971158503,CSE 21,A01,084009,Staff,0,13,50,50
1649971164541,CSE 30,A01,083370,Cao; Yingjun,0,49,40,40
1649971170568,CSE 100,A01,083372,Cao; Yingjun,0,44,40,40
1649971176591,CSE 101,A01,084011,Staff,0,53,40,40
1649971182620,CSE 141,A01,083374,Eldon; John,0,58,75,75
1649971188649,CSE 141L,A01,083376,Eldon; John,0,64,75,75
1649971194681,CSE 175,A01,084013,Kumar; Rakesh,22,0,25,3
1649971200707,CSE 190,A00,092508,Dubnov; Shlomo,15,0,15,0
1649971206737,ECE 5,A01,084049,Morris; Karcher William,13,0,20,7
1649971212763,ECE 100,A01,084051,Baghdadchi; Saharnaz,0,0,20,20
1649971212763,ECE 100,A02,091916,Baghdadchi; Saharnaz,15,0,20,5
1649971218789,ECE 101,A01,084053,Baghdadchi; Saharnaz,2,0,37,35
1649971218789,ECE 101,A02,084054,Baghdadchi; Saharnaz,31,0,37,6
1649971224815,ECE 107,A01,083390,Staff,27,0,40,13
1649971230835,ECE 148,A01,084056,Silberman; Jack,7,0,12,5
1649971236864,ECE 180,A00,083391,Abi Samra; Nicholas Camill,25,0,30,5
1649971236864,ECE 180,B00,083392,Abi Samra; Nicholas Camill,21,0,30,9
1649971242897,MATH 10B,A01,084110,Staff,6,0,30,24
1649971242897,MATH 10B,A02,084111,Staff,27,0,30,3
1649971242897,MATH 10B,A03,084112,Staff,26,0,30,4
1649971248921,MATH 10C,A01,083443,Staff,0,0,30,30
1649971248921,MATH 10C,A02,083444,Staff,7,0,30,23
1649971248921,MATH 10C,B01,084114,Staff,24,0,30,6
1649971248921,MATH 10C,B02,084115,Staff,28,0,30,2
1649971254963,MATH 18,A01,084117,Harel; Guershon,24,0,30,6
1649971254963,MATH 18,A02,084119,Harel; Guershon,28,0,30,2
1649971254963,MATH 18,A03,084120,Harel; Guershon,30,0,30,0
1649971254963,MATH 18,A04,084121,Harel; Guershon,29,0,30,1
1649971260987,MATH 20B,A01,084124,Um; Ko Woon,30,0,35,5
1649971260987,MATH 20B,B01,084126,Um; Ko Woon,29,0,35,6
1649971267012,MATH 20C,A01,083446,Hammock; Frances H,11,0,30,19
1649971267012,MATH 20C,A02,083447,Hammock; Frances H,28,0,30,2
1649971267012,MATH 20C,A03,083448,Hammock; Frances H,28,0,30,2
1649971267012,MATH 20C,A04,083449,Hammock; Frances H,30,0,30,0
1649971267012,MATH 20C,B01,083451,Hammock; Frances H,18,0,30,12
1649971267012,MATH 20C,B02,083452,Hammock; Frances H,26,0,30,4
1649971267012,MATH 20C,B03,083453,Hammock; Frances H,25,0,30,5
1649971267012,MATH 20C,B04,083454,Hammock; Frances H,28,0,30,2
1649971273037,MATH 20D,A01,084128,Staff,20,0,30,10
1649971273037,MATH 20D,A02,084129,Staff,30,0,30,0
1649971273037,MATH 20D,A03,084130,Staff,27,0,30,3
1649971273037,MATH 20D,B01,084133,Staff,11,0,30,19
1649971273037,MATH 20D,B02,084134,Staff,24,0,30,6
1649971273037,MATH 20D,B03,084135,Staff,29,0,30,1
1649971279066,MATH 20E,A01,084138,Staff,19,0,30,11
1649971279066,MATH 20E,A02,084139,Staff,14,0,30,16
1649971279066,MATH 20E,A03,084140,Staff,17,0,30,13
1649971279066,MATH 20E,A04,084141,Staff,23,0,30,7
1649971285100,MATH 102,A01,084143,Harel; Guershon,15,0,30,15
1649971285100,MATH 102,A02,084144,Harel; Guershon,21,0,30,9
1649971291225,MATH 103B,A01,083456,Staff,0,12,30,30
1649971291225,MATH 103B,A02,083457,Staff,0,12,30,30
1649971297248,MATH 109,A01,084146,Salehi Golsefidy; Alireza,22,0,30,8
1649971297248,MATH 109,A02,084147,Salehi Golsefidy; Alireza,19,0,30,11
1649971303273,MATH 120A,A01,085445,Eggers; John Dietrich,17,0,35,18
1649971303273,MATH 120A,A02,085446,Eggers; John Dietrich,27,0,35,8
1649971309308,MATH 142B,A01,084149,Verstraete; Jacques Allan,0,12,30,30
1649971309308,MATH 142B,A02,084150,Verstraete; Jacques Allan,0,12,30,30
1649971315341,MATH 170A,A01,083459,Nie; Jiawang,1,6,30,29
1649971315341,MATH 170A,A02,083460,Nie; Jiawang,0,6,30,30
1649971315341,MATH 170A,A03,083461,Nie; Jiawang,0,6,30,30
1649971321371,MATH 193B,A01,083463,Staff,1,0,30,29
1649971321371,MATH 193B,A02,083464,Staff,10,0,30,20
1649971321371,MATH 193B,A03,083465,Staff,18,0,30,12
1649971327427,COGS 2,A01,083966,Boyle; Mary E. T.,15,0,30,15
1649971333450,COGS 9,A01,083968,Staff,25,0,60,35
1649971339473,COGS 14B,A01,083970,Staff,16,0,50,34
1649971345496,COGS 17,A01,092679,Staff,57,0,75,18
1649971351529,COGS 100,A01,083972,Staff,0,10,60,60
1649971363584,COGS 101C,A01,083976,Staff,16,0,30,14
1649971369613,COGS 102A,A01,083978,Johnson; Christine M.,14,0,30,16
1649971375637,COGS 107B,A01,083980,Staff,0,4,50,50
1649971381663,COGS 115,A01,083982,Staff,12,0,30,18
1649971387685,COGS 118B,A01,083367,Staff,0,12,40,40
1649971393711,COGS 172,A01,083984,Provenzano; Emily Kara,15,0,30,15
1649971399737,COGS 177,A00,083368,Staff,0,19,30,30
1649971405769,COGS 186,A01,083986,Staff,21,0,40,19
1649971411795,COGS 187A,A01,083988,Boyle; Mary E. T.,20,0,60,40
1649971417818,CSE 8A,A50,084003,Miranda; Gregory Joseph,0,4,15,15
1649971423840,CSE 11,A01,084005,Miranda; Gregory Joseph,0,9,55,55
1649971429869,CSE 20,A01,084007,Staff,4,0,20,16
1649971435902,CSE 21,A01,084009,Staff,0,15,50,50
1649971441939,CSE 30,A01,083370,Cao; Yingjun,0,50,40,40
1649971447965,CSE 100,A01,083372,Cao; Yingjun,0,44,40,40
1649971453992,CSE 101,A01,084011,Staff,0,53,40,40
1649971460017,CSE 141,A01,083374,Eldon; John,0,58,75,75
1649971466044,CSE 141L,A01,083376,Eldon; John,0,64,75,75
1649971472067,CSE 175,A01,084013,Kumar; Rakesh,22,0,25,3
1649971478104,CSE 190,A00,092508,Dubnov; Shlomo,15,0,15,0
1649971484136,ECE 5,A01,084049,Morris; Karcher William,13,0,20,7
1649971490166,ECE 100,A01,084051,Baghdadchi; Saharnaz,0,0,20,20
1649971490166,ECE 100,A02,091916,Baghdadchi; Saharnaz,15,0,20,5
1649971496190,ECE 101,A01,084053,Baghdadchi; Saharnaz,2,0,37,35
1649971496190,ECE 101,A02,084054,Baghdadchi; Saharnaz,31,0,37,6
1649971502219,ECE 107,A01,083390,Staff,27,0,40,13
1649971508242,ECE 148,A01,084056,Silberman; Jack,7,0,12,5
1649971514278,ECE 180,A00,083391,Abi Samra; Nicholas Camill,25,0,30,5
1649971514278,ECE 180,B00,083392,Abi Samra; Nicholas Camill,21,0,30,9
1649971520309,MATH 10B,A01,084110,Staff,6,0,30,24
1649971520309,MATH 10B,A02,084111,Staff,27,0,30,3
1649971520309,MATH 10B,A03,084112,Staff,26,0,30,4
1649971526360,MATH 10C,A01,083443,Staff,0,0,30,30
1649971526360,MATH 10C,A02,083444,Staff,6,0,30,24
1649971526360,MATH 10C,B01,084114,Staff,24,0,30,6
1649971526360,MATH 10C,B02,084115,Staff,28,0,30,2
1649971532384,MATH 18,A01,084117,Harel; Guershon,24,0,30,6
1649971532384,MATH 18,A02,084119,Harel; Guershon,28,0,30,2
1649971532384,MATH 18,A03,084120,Harel; Guershon,30,0,30,0
1649971532384,MATH 18,A04,084121,Harel; Guershon,29,0,30,1
1649971538422,MATH 20B,A01,084124,Um; Ko Woon,30,0,35,5
1649971538422,MATH 20B,B01,084126,Um; Ko Woon,29,0,35,6
1649971544458,MATH 20C,A01,083446,Hammock; Frances H,11,0,30,19
1649971544458,MATH 20C,A02,083447,Hammock; Frances H,28,0,30,2
1649971544458,MATH 20C,A03,083448,Hammock; Frances H,28,0,30,2
1649971544458,MATH 20C,A04,083449,Hammock; Frances H,30,0,30,0
1649971544458,MATH 20C,B01,083451,Hammock; Frances H,18,0,30,12
1649971544458,MATH 20C,B02,083452,Hammock; Frances H,26,0,30,4
1649971544458,MATH 20C,B03,083453,Hammock; Frances H,25,0,30,5
1649971544458,MATH 20C,B04,083454,Hammock; Frances H,28,0,30,2
1649971550481,MATH 20D,A01,084128,Staff,21,0,30,9
1649971550481,MATH 20D,A02,084129,Staff,30,0,30,0
1649971550481,MATH 20D,A03,084130,Staff,27,0,30,3
1649971550481,MATH 20D,B01,084133,Staff,11,0,30,19
1649971550481,MATH 20D,B02,084134,Staff,24,0,30,6
1649971550481,MATH 20D,B03,084135,Staff,29,0,30,1
1649971556504,MATH 20E,A01,084138,Staff,18,0,30,12
1649971556504,MATH 20E,A02,084139,Staff,13,0,30,17
1649971556504,MATH 20E,A03,084140,Staff,17,0,30,13
1649971556504,MATH 20E,A04,084141,Staff,23,0,30,7
1649971562529,MATH 102,A01,084143,Harel; Guershon,15,0,30,15
1649971562529,MATH 102,A02,084144,Harel; Guershon,21,0,30,9
1649971568563,MATH 103B,A01,083456,Staff,0,12,30,30
1649971568563,MATH 103B,A02,083457,Staff,0,12,30,30
1649971574598,MATH 109,A01,084146,Salehi Golsefidy; Alireza,22,0,30,8
1649971574598,MATH 109,A02,084147,Salehi Golsefidy; Alireza,19,0,30,11
1649971580635,MATH 120A,A01,085445,Eggers; John Dietrich,17,0,35,18
1649971580635,MATH 120A,A02,085446,Eggers; John Dietrich,27,0,35,8
1649971586659,MATH 142B,A01,084149,Verstraete; Jacques Allan,0,12,30,30
1649971586659,MATH 142B,A02,084150,Verstraete; Jacques Allan,0,12,30,30
1649971592689,MATH 170A,A01,083459,Nie; Jiawang,1,7,30,29
1649971592689,MATH 170A,A02,083460,Nie; Jiawang,0,6,30,30
1649971592689,MATH 170A,A03,083461,Nie; Jiawang,0,6,30,30
1649971598718,MATH 193B,A01,083463,Staff,1,0,30,29
1649971598718,MATH 193B,A02,083464,Staff,10,0,30,20
1649971598718,MATH 193B,A03,083465,Staff,18,0,30,12
1649971604815,COGS 2,A01,083966,Boyle; Mary E. T.,15,0,30,15
1649971610842,COGS 9,A01,083968,Staff,24,0,60,36
1649971616868,COGS 14B,A01,083970,Staff,16,0,50,34
1649971622905,COGS 17,A01,092679,Staff,57,0,75,18
1649971628949,COGS 100,A01,083972,Staff,0,10,60,60
1649971640998,COGS 101C,A01,083976,Staff,16,0,30,14
1649971647024,COGS 102A,A01,083978,Johnson; Christine M.,14,0,30,16
1649971653056,COGS 107B,A01,083980,Staff,0,4,50,50
1649971659079,COGS 115,A01,083982,Staff,12,0,30,18
1649971665112,COGS 118B,A01,083367,Staff,0,12,40,40
1649971671145,COGS 172,A01,083984,Provenzano; Emily Kara,15,0,30,15
1649971677167,COGS 177,A00,083368,Staff,0,19,30,30
1649971683200,COGS 186,A01,083986,Staff,21,0,40,19
1649971689223,COGS 187A,A01,083988,Boyle; Mary E. T.,20,0,60,40
1649971695249,CSE 8A,A50,084003,Miranda; Gregory Joseph,0,4,15,15
1649971701284,CSE 11,A01,084005,Miranda; Gregory Joseph,0,9,55,55
1649971707319,CSE 20,A01,084007,Staff,4,0,20,16
1649971713349,CSE 21,A01,084009,Staff,0,16,50,50
1649971719380,CSE 30,A01,083370,Cao; Yingjun,0,50,40,40
1649971725401,CSE 100,A01,083372,Cao; Yingjun,0,44,40,40
1649971731424,CSE 101,A01,084011,Staff,0,53,40,40
1649971737449,CSE 141,A01,083374,Eldon; John,0,58,75,75
1649971743484,CSE 141L,A01,083376,Eldon; John,0,64,75,75
1649971749505,CSE 175,A01,084013,Kumar; Rakesh,22,0,25,3
1649971755532,CSE 190,A00,092508,Dubnov; Shlomo,15,0,15,0
1649971761555,ECE 5,A01,084049,Morris; Karcher William,13,0,20,7
1649971767579,ECE 100,A01,084051,Baghdadchi; Saharnaz,0,0,20,20
1649971767579,ECE 100,A02,091916,Baghdadchi; Saharnaz,15,0,20,5
1649971773606,ECE 101,A01,084053,Baghdadchi; Saharnaz,2,0,37,35
1649971773606,ECE 101,A02,084054,Baghdadchi; Saharnaz,31,0,37,6
1649971779630,ECE 107,A01,083390,Staff,27,0,40,13
1649971785652,ECE 148,A01,084056,Silberman; Jack,7,0,12,5
1649971791679,ECE 180,A00,083391,Abi Samra; Nicholas Camill,25,0,30,5
1649971791679,ECE 180,B00,083392,Abi Samra; Nicholas Camill,21,0,30,9
1649971797703,MATH 10B,A01,084110,Staff,6,0,30,24
1649971797703,MATH 10B,A02,084111,Staff,27,0,30,3
1649971797703,MATH 10B,A03,084112,Staff,26,0,30,4
1649971803733,MATH 10C,A01,083443,Staff,0,0,30,30
1649971803733,MATH 10C,A02,083444,Staff,6,0,30,24
1649971803733,MATH 10C,B01,084114,Staff,24,0,30,6
1649971803733,MATH 10C,B02,084115,Staff,28,0,30,2
1649971809759,MATH 18,A01,084117,Harel; Guershon,24,0,30,6
1649971809759,MATH 18,A02,084119,Harel; Guershon,28,0,30,2
1649971809759,MATH 18,A03,084120,Harel; Guershon,30,0,30,0
1649971809759,MATH 18,A04,084121,Harel; Guershon,29,0,30,1
1649971815783,MATH 20B,A01,084124,Um; Ko Woon,30,0,35,5
1649971815783,MATH 20B,B01,084126,Um; Ko Woon,29,0,35,6
1649971821808,MATH 20C,A01,083446,Hammock; Frances H,11,0,30,19
1649971821808,MATH 20C,A02,083447,Hammock; Frances H,27,0,30,3
1649971821808,MATH 20C,A03,083448,Hammock; Frances H,28,0,30,2
1649971821808,MATH 20C,A04,083449,Hammock; Frances H,30,0,30,0
1649971821808,MATH 20C,B01,083451,Hammock; Frances H,18,0,30,12
1649971821808,MATH 20C,B02,083452,Hammock; Frances H,26,0,30,4
1649971821808,MATH 20C,B03,083453,Hammock; Frances H,25,0,30,5
1649971821808,MATH 20C,B04,083454,Hammock; Frances H,28,0,30,2
1649971827838,MATH 20D,A01,084128,Staff,21,0,30,9
1649971827838,MATH 20D,A02,084129,Staff,30,0,30,0
1649971827838,MATH 20D,A03,084130,Staff,27,0,30,3
1649971827838,MATH 20D,B01,084133,Staff,11,0,30,19
1649971827838,MATH 20D,B02,084134,Staff,24,0,30,6
1649971827838,MATH 20D,B03,084135,Staff,29,0,30,1
1649971833882,MATH 20E,A01,084138,Staff,18,0,30,12
1649971833882,MATH 20E,A02,084139,Staff,13,0,30,17
1649971833882,MATH 20E,A03,084140,Staff,17,0,30,13
1649971833882,MATH 20E,A04,084141,Staff,23,0,30,7
1649971839911,MATH 102,A01,084143,Harel; Guershon,15,0,30,15
1649971839911,MATH 102,A02,084144,Harel; Guershon,21,0,30,9
1649971845950,MATH 103B,A01,083456,Staff,0,12,30,30
1649971845950,MATH 103B,A02,083457,Staff,0,12,30,30
1649971851982,MATH 109,A01,084146,Salehi Golsefidy; Alireza,22,0,30,8
1649971851982,MATH 109,A02,084147,Salehi Golsefidy; Alireza,19,0,30,11
1649971858004,MATH 120A,A01,085445,Eggers; John Dietrich,17,0,35,18
1649971858004,MATH 120A,A02,085446,Eggers; John Dietrich,27,0,35,8
1649971864033,MATH 142B,A01,084149,Verstraete; Jacques Allan,0,12,30,30
1649971864033,MATH 142B,A02,084150,Verstraete; Jacques Allan,0,12,30,30
1649971870060,MATH 170A,A01,083459,Nie; Jiawang,1,7,30,29
1649971870060,MATH 170A,A02,083460,Nie; Jiawang,0,6,30,30
1649971870060,MATH 170A,A03,083461,Nie; Jiawang,0,6,30,30
1649971876099,MATH 193B,A01,083463,Staff,1,0,30,29
1649971876099,MATH 193B,A02,083464,Staff,10,0,30,20
1649971876099,MATH 193B,A03,083465,Staff,18,0,30,12
1649971882247,COGS 2,A01,083966,Boyle; Mary E. T.,15,0,30,15
1649971888271,COGS 9,A01,083968,Staff,24,0,60,36
1649971894295,COGS 14B,A01,083970,Staff,16,0,50,34
1649971900346,COGS 17,A01,092679,Staff,57,0,75,18
1649971906374,COGS 100,A01,083972,Staff,0,10,60,60
1649971918440,COGS 101C,A01,083976,Staff,16,0,30,14
1649971924464,COGS 102A,A01,083978,Johnson; Christine M.,14,0,30,16
1649971930490,COGS 107B,A01,083980,Staff,0,4,50,50
1649971936527,COGS 115,A01,083982,Staff,12,0,30,18
1649971942564,COGS 118B,A01,083367,Staff,0,12,40,40
1649971948588,COGS 172,A01,083984,Provenzano; Emily Kara,15,0,30,15
1649971954621,COGS 177,A00,083368,Staff,0,19,30,30
1649971960647,COGS 186,A01,083986,Staff,21,0,40,19
1649971966673,COGS 187A,A01,083988,Boyle; Mary E. T.,20,0,60,40
1649971972705,CSE 8A,A50,084003,Miranda; Gregory Joseph,0,4,15,15
1649971978733,CSE 11,A01,084005,Miranda; Gregory Joseph,0,10,55,55
1649971984765,CSE 20,A01,084007,Staff,4,0,20,16
1649971990791,CSE 21,A01,084009,Staff,0,16,50,50
1649971996814,CSE 30,A01,083370,Cao; Yingjun,0,51,40,40
1649972002851,CSE 100,A01,083372,Cao; Yingjun,0,43,40,40
1649972008877,CSE 101,A01,084011,Staff,0,53,40,40
1649972014901,CSE 141,A01,083374,Eldon; John,0,58,75,75
1649972020927,CSE 141L,A01,083376,Eldon; John,0,64,75,75
1649972026952,CSE 175,A01,084013,Kumar; Rakesh,22,0,25,3
1649972032982,CSE 190,A00,092508,Dubnov; Shlomo,15,0,15,0
1649972039005,ECE 5,A01,084049,Morris; Karcher William,13,0,20,7
1649972045029,ECE 100,A01,084051,Baghdadchi; Saharnaz,0,0,20,20
1649972045029,ECE 100,A02,091916,Baghdadchi; Saharnaz,15,0,20,5
1649972051056,ECE 101,A01,084053,Baghdadchi; Saharnaz,2,0,37,35
1649972051056,ECE 101,A02,084054,Baghdadchi; Saharnaz,31,0,37,6
1649972057084,ECE 107,A01,083390,Staff,27,0,40,13
1649972063107,ECE 148,A01,084056,Silberman; Jack,7,0,12,5
1649972069130,ECE 180,A00,083391,Abi Samra; Nicholas Camill,25,0,30,5
1649972069130,ECE 180,B00,083392,Abi Samra; Nicholas Camill,21,0,30,9
1649972075171,MATH 10B,A01,084110,Staff,6,0,30,24
1649972075171,MATH 10B,A02,084111,Staff,28,0,30,2
1649972075171,MATH 10B,A03,084112,Staff,26,0,30,4
1649972081203,MATH 10C,A01,083443,Staff,0,0,30,30
1649972081203,MATH 10C,A02,083444,Staff,5,0,30,25
1649972081203,MATH 10C,B01,084114,Staff,24,0,30,6
1649972081203,MATH 10C,B02,084115,Staff,28,0,30,2
1649972087244,MATH 18,A01,084117,Harel; Guershon,24,0,30,6
1649972087244,MATH 18,A02,084119,Harel; Guershon,28,0,30,2
1649972087244,MATH 18,A03,084120,Harel; Guershon,30,0,30,0
1649972087244,MATH 18,A04,084121,Harel; Guershon,29,0,30,1
1649972093270,MATH 20B,A01,084124,Um; Ko Woon,30,0,35,5
1649972093270,MATH 20B,B01,084126,Um; Ko Woon,29,0,35,6
1649972099299,MATH 20C,A01,083446,Hammock; Frances H,10,0,30,20
1649972099299,MATH 20C,A02,083447,Hammock; Frances H,27,0,30,3
1649972099299,MATH 20C,A03,083448,Hammock; Frances H,28,0,30,2
1649972099299,MATH 20C,A04,083449,Hammock; Frances H,30,0,30,0
1649972099299,MATH 20C,B01,083451,Hammock; Frances H,16,0,30,14
1649972099299,MATH 20C,B02,083452,Hammock; Frances H,26,0,30,4
1649972099299,MATH 20C,B03,083453,Hammock; Frances H,25,0,30,5
1649972099299,MATH 20C,B04,083454,Hammock; Frances H,28,0,30,2
1649972105323,MATH 20D,A01,084128,Staff,20,0,30,10
1649972105323,MATH 20D,A02,084129,Staff,30,0,30,0
1649972105323,MATH 20D,A03,084130,Staff,27,0,30,3
1649972105323,MATH 20D,B01,084133,Staff,10,0,30,20
1649972105323,MATH 20D,B02,084134,Staff,24,0,30,6
1649972105323,MATH 20D,B03,084135,Staff,29,0,30,1
1649972111346,MATH 20E,A01,084138,Staff,18,0,30,12
1649972111346,MATH 20E,A02,084139,Staff,13,0,30,17
1649972111346,MATH 20E,A03,084140,Staff,16,0,30,14
1649972111346,MATH 20E,A04,084141,Staff,22,0,30,8
1649972117377,MATH 102,A01,084143,Harel; Guershon,15,0,30,15
1649972117377,MATH 102,A02,084144,Harel; Guershon,21,0,30,9
1649972123399,MATH 103B,A01,083456,Staff,0,12,30,30
1649972123399,MATH 103B,A02,083457,Staff,0,12,30,30
1649972129422,MATH 109,A01,084146,Salehi Golsefidy; Alireza,22,0,30,8
1649972129422,MATH 109,A02,084147,Salehi Golsefidy; Alireza,19,0,30,11
1649972135445,MATH 120A,A01,085445,Eggers; John Dietrich,17,0,35,18
1649972135445,MATH 120A,A02,085446,Eggers; John Dietrich,27,0,35,8
1649972141480,MATH 142B,A01,084149,Verstraete; Jacques Allan,0,12,30,30
1649972141480,MATH 142B,A02,084150,Verstraete; Jacques Allan,0,12,30,30
1649972147508,MATH 170A,A01,083459,Nie; Jiawang,1,7,30,29
1649972147508,MATH 170A,A02,083460,Nie; Jiawang,0,6,30,30
1649972147508,MATH 170A,A03,083461,Nie; Jiawang,0,6,30,30
1649972153532,MATH 193B,A01,083463,Staff,1,0,30,29
1649972153532,MATH 193B,A02,083464,Staff,10,0,30,20
1649972153532,MATH 193B,A03,083465,Staff,18,0,30,12
1649972159586,COGS 2,A01,083966,Boyle; Mary E. T.,15,0,30,15
1649972165610,COGS 9,A01,083968,Staff,23,0,60,37
1649972171643,COGS 14B,A01,083970,Staff,16,0,50,34
1649972177673,COGS 17,A01,092679,Staff,57,0,75,18
1649972183718,COGS 100,A01,083972,Staff,0,10,60,60
1649972195778,COGS 101C,A01,083976,Staff,16,0,30,14
1649972201800,COGS 102A,A01,083978,Johnson; Christine M.,14,0,30,16
1649972207825,COGS 107B,A01,083980,Staff,0,4,50,50
1649972213851,COGS 115,A01,083982,Staff,12,0,30,18
1649972219881,COGS 118B,A01,083367,Staff,0,12,40,40
1649972225921,COGS 172,A01,083984,Provenzano; Emily Kara,15,0,30,15
1649972231944,COGS 177,A00,083368,Staff,0,19,30,30
1649972237971,COGS 186,A01,083986,Staff,21,0,40,19
1649972244000,COGS 187A,A01,083988,Boyle; Mary E. T.,20,0,60,40
1649972250027,CSE 8A,A50,084003,Miranda; Gregory Joseph,0,4,15,15
1649972256050,CSE 11,A01,084005,Miranda; Gregory Joseph,0,11,55,55
1649972262078,CSE 20,A01,084007,Staff,4,0,20,16
1649972268101,CSE 21,A01,084009,Staff,0,16,50,50
1649972274130,CSE 30,A01,083370,Cao; Yingjun,0,51,40,40
1649972280155,CSE 100,A01,083372,Cao; Yingjun,0,42,40,40
1649972286176,CSE 101,A01,084011,Staff,0,53,40,40
1649972292207,CSE 141,A01,083374,Eldon; John,0,58,75,75
1649972298233,CSE 141L,A01,083376,Eldon; John,0,64,75,75
1649972304261,CSE 175,A01,084013,Kumar; Rakesh,22,0,25,3
1649972310283,CSE 190,A00,092508,Dubnov; Shlomo,15,0,15,0
1649972316313,ECE 5,A01,084049,Morris; Karcher William,13,0,20,7
1649972322340,ECE 100,A01,084051,Baghdadchi; Saharnaz,0,0,20,20
1649972322340,ECE 100,A02,091916,Baghdadchi; Saharnaz,15,0,20,5
1649972328369,ECE 101,A01,084053,Baghdadchi; Saharnaz,2,0,37,35
1649972328369,ECE 101,A02,084054,Baghdadchi; Saharnaz,31,0,37,6
1649972334400,ECE 107,A01,083390,Staff,27,0,40,13
1649972340427,ECE 148,A01,084056,Silberman; Jack,7,0,12,5
1649972346454,ECE 180,A00,083391,Abi Samra; Nicholas Camill,25,0,30,5
1649972346454,ECE 180,B00,083392,Abi Samra; Nicholas Camill,21,0,30,9
1649972352480,MATH 10B,A01,084110,Staff,6,0,30,24
1649972352480,MATH 10B,A02,084111,Staff,28,0,30,2
1649972352480,MATH 10B,A03,084112,Staff,26,0,30,4
1649972358504,MATH 10C,A01,083443,Staff,0,0,30,30
1649972358504,MATH 10C,A02,083444,Staff,3,0,30,27
1649972358504,MATH 10C,B01,084114,Staff,24,0,30,6
1649972358504,MATH 10C,B02,084115,Staff,28,0,30,2
1649972364528,MATH 18,A01,084117,Harel; Guershon,24,0,30,6
1649972364528,MATH 18,A02,084119,Harel; Guershon,28,0,30,2
1649972364528,MATH 18,A03,084120,Harel; Guershon,30,0,30,0
1649972364528,MATH 18,A04,084121,Harel; Guershon,29,0,30,1
1649972370556,MATH 20B,A01,084124,Um; Ko Woon,30,0,35,5
1649972370556,MATH 20B,B01,084126,Um; Ko Woon,29,0,35,6
1649972376585,MATH 20C,A01,083446,Hammock; Frances H,10,0,30,20
1649972376585,MATH 20C,A02,083447,Hammock; Frances H,27,0,30,3
1649972376585,MATH 20C,A03,083448,Hammock; Frances H,28,0,30,2
1649972376585,MATH 20C,A04,083449,Hammock; Frances H,30,0,30,0
1649972376585,MATH 20C,B01,083451,Hammock; Frances H,16,0,30,14
1649972376585,MATH 20C,B02,083452,Hammock; Frances H,26,0,30,4
1649972376585,MATH 20C,B03,083453,Hammock; Frances H,25,0,30,5
1649972376585,MATH 20C,B04,083454,Hammock; Frances H,28,0,30,2
1649972382619,MATH 20D,A01,084128,Staff,20,0,30,10
1649972382619,MATH 20D,A02,084129,Staff,30,0,30,0
1649972382619,MATH 20D,A03,084130,Staff,27,0,30,3
1649972382619,MATH 20D,B01,084133,Staff,10,0,30,20
1649972382619,MATH 20D,B02,084134,Staff,24,0,30,6
1649972382619,MATH 20D,B03,084135,Staff,29,0,30,1
1649972388650,MATH 20E,A01,084138,Staff,18,0,30,12
1649972388650,MATH 20E,A02,084139,Staff,12,0,30,18
1649972388650,MATH 20E,A03,084140,Staff,16,0,30,14
1649972388650,MATH 20E,A04,084141,Staff,22,0,30,8
1649972394679,MATH 102,A01,084143,Harel; Guershon,14,0,30,16
1649972394679,MATH 102,A02,084144,Harel; Guershon,21,0,30,9
1649972400705,MATH 103B,A01,083456,Staff,0,12,30,30
1649972400705,MATH 103B,A02,083457,Staff,0,12,30,30
1649972406755,MATH 109,A01,084146,Salehi Golsefidy; Alireza,22,0,30,8
1649972406755,MATH 109,A02,084147,Salehi Golsefidy; Alireza,19,0,30,11
1649972412793,MATH 120A,A01,085445,Eggers; John Dietrich,17,0,35,18
1649972412793,MATH 120A,A02,085446,Eggers; John Dietrich,27,0,35,8
1649972418831,MATH 142B,A01,084149,Verstraete; Jacques Allan,0,12,30,30
1649972418831,MATH 142B,A02,084150,Verstraete; Jacques Allan,0,12,30,30
1649972424855,MATH 170A,A01,083459,Nie; Jiawang,1,7,30,29
1649972424855,MATH 170A,A02,083460,Nie; Jiawang,0,6,30,30
1649972424855,MATH 170A,A03,083461,Nie; Jiawang,0,6,30,30
1649972430889,MATH 193B,A01,083463,Staff,1,0,30,29
1649972430889,MATH 193B,A02,083464,Staff,10,0,30,20
1649972430889,MATH 193B,A03,083465,Staff,18,0,30,12
1649972436954,COGS 2,A01,083966,Boyle; Mary E. T.,14,0,30,16
1649972442977,COGS 9,A01,083968,Staff,23,0,60,37
1649972449003,COGS 14B,A01,083970,Staff,16,0,50,34
1649972455043,COGS 17,A01,092679,Staff,57,0,75,18
1649972461067,COGS 100,A01,083972,Staff,0,10,60,60
1649972473129,COGS 101C,A01,083976,Staff,16,0,30,14
1649972479252,COGS 102A,A01,083978,Johnson; Christine M.,14,0,30,16
1649972485279,COGS 107B,A01,083980,Staff,0,4,50,50
1649972491302,COGS 115,A01,083982,Staff,12,0,30,18
1649972497333,COGS 118B,A01,083367,Staff,0,12,40,40
1649972503360,COGS 172,A01,083984,Provenzano; Emily Kara,15,0,30,15
1649972509384,COGS 177,A00,083368,Staff,0,19,30,30
1649972515417,COGS 186,A01,083986,Staff,21,0,40,19
1649972521440,COGS 187A,A01,083988,Boyle; Mary E. T.,20,0,60,40
1649972527472,CSE 8A,A50,084003,Miranda; Gregory Joseph,0,4,15,15
1649972533504,CSE 11,A01,084005,Miranda; Gregory Joseph,0,11,55,55
1649972539530,CSE 20,A01,084007,Staff,4,0,20,16
1649972545566,CSE 21,A01,084009,Staff,0,16,50,50
1649972551593,CSE 30,A01,083370,Cao; Yingjun,0,51,40,40
1649972557621,CSE 100,A01,083372,Cao; Yingjun,0,42,40,40
1649972563667,CSE 101,A01,084011,Staff,0,53,40,40
1649972569694,CSE 141,A01,083374,Eldon; John,0,58,75,75
1649972575722,CSE 141L,A01,083376,Eldon; John,0,64,75,75
1649972581753,CSE 175,A01,084013,Kumar; Rakesh,22,0,25,3
1649972587778,CSE 190,A00,092508,Dubnov; Shlomo,15,0,15,0
1649972593801,ECE 5,A01,084049,Morris; Karcher William,13,0,20,7
1649972599829,ECE 100,A01,084051,Baghdadchi; Saharnaz,0,0,20,20
1649972599829,ECE 100,A02,091916,Baghdadchi; Saharnaz,15,0,20,5
1649972605863,ECE 101,A01,084053,Baghdadchi; Saharnaz,2,0,37,35
1649972605863,ECE 101,A02,084054,Baghdadchi; Saharnaz,31,0,37,6
1649972611890,ECE 107,A01,083390,Staff,27,0,40,13
1649972617913,ECE 148,A01,084056,Silberman; Jack,7,0,12,5
1649972623936,ECE 180,A00,083391,Abi Samra; Nicholas Camill,25,0,30,5
1649972623936,ECE 180,B00,083392,Abi Samra; Nicholas Camill,21,0,30,9
1649972629959,MATH 10B,A01,084110,Staff,6,0,30,24
1649972629959,MATH 10B,A02,084111,Staff,28,0,30,2
1649972629959,MATH 10B,A03,084112,Staff,26,0,30,4
1649972635994,MATH 10C,A01,083443,Staff,0,0,30,30
1649972635994,MATH 10C,A02,083444,Staff,2,0,30,28
1649972635994,MATH 10C,B01,084114,Staff,23,0,30,7
1649972635994,MATH 10C,B02,084115,Staff,28,0,30,2
1649972642021,MATH 18,A01,084117,Harel; Guershon,24,0,30,6
1649972642021,MATH 18,A02,084119,Harel; Guershon,28,0,30,2
1649972642021,MATH 18,A03,084120,Harel; Guershon,30,0,30,0
1649972642021,MATH 18,A04,084121,Harel; Guershon,29,0,30,1
1649972648044,MATH 20B,A01,084124,Um; Ko Woon,30,0,35,5
1649972648044,MATH 20B,B01,084126,Um; Ko Woon,29,0,35,6
1649972654071,MATH 20C,A01,083446,Hammock; Frances H,10,0,30,20
1649972654071,MATH 20C,A02,083447,Hammock; Frances H,26,0,30,4
1649972654071,MATH 20C,A03,083448,Hammock; Frances H,28,0,30,2
1649972654071,MATH 20C,A04,083449,Hammock; Frances H,30,0,30,0
1649972654071,MATH 20C,B01,083451,Hammock; Frances H,16,0,30,14
1649972654071,MATH 20C,B02,083452,Hammock; Frances H,26,0,30,4
1649972654071,MATH 20C,B03,083453,Hammock; Frances H,25,0,30,5
1649972654071,MATH 20C,B04,083454,Hammock; Frances H,28,0,30,2
1649972660095,MATH 20D,A01,084128,Staff,20,0,30,10
1649972660095,MATH 20D,A02,084129,Staff,30,0,30,0
1649972660095,MATH 20D,A03,084130,Staff,27,0,30,3
1649972660095,MATH 20D,B01,084133,Staff,10,0,30,20
1649972660095,MATH 20D,B02,084134,Staff,24,0,30,6
1649972660095,MATH 20D,B03,084135,Staff,29,0,30,1
1649972666121,MATH 20E,A01,084138,Staff,17,0,30,13
1649972666121,MATH 20E,A02,084139,Staff,12,0,30,18
1649972666121,MATH 20E,A03,084140,Staff,16,0,30,14
1649972666121,MATH 20E,A04,084141,Staff,22,0,30,8
1649972672147,MATH 102,A01,084143,Harel; Guershon,14,0,30,16
1649972672147,MATH 102,A02,084144,Harel; Guershon,21,0,30,9
1649972678169,MATH 103B,A01,083456,Staff,0,12,30,30
1649972678169,MATH 103B,A02,083457,Staff,0,12,30,30
1649972684193,MATH 109,A01,084146,Salehi Golsefidy; Alireza,21,0,30,9
1649972684193,MATH 109,A02,084147,Salehi Golsefidy; Alireza,19,0,30,11
1649972690225,MATH 120A,A01,085445,Eggers; John Dietrich,17,0,35,18
1649972690225,MATH 120A,A02,085446,Eggers; John Dietrich,27,0,35,8
1649972696254,MATH 142B,A01,084149,Verstraete; Jacques Allan,0,12,30,30
1649972696254,MATH 142B,A02,084150,Verstraete; Jacques Allan,0,12,30,30
1649972702277,MATH 170A,A01,083459,Nie; Jiawang,1,7,30,29
1649972702277,MATH 170A,A02,083460,Nie; Jiawang,0,6,30,30
1649972702277,MATH 170A,A03,083461,Nie; Jiawang,0,7,30,30
1649972708301,MATH 193B,A01,083463,Staff,1,0,30,29
1649972708301,MATH 193B,A02,083464,Staff,10,0,30,20
1649972708301,MATH 193B,A03,083465,Staff,18,0,30,12
1649972714358,COGS 2,A01,083966,Boyle; Mary E. T.,14,0,30,16
1649972720400,COGS 9,A01,083968,Staff,22,0,60,38
1649972726441,COGS 14B,A01,083970,Staff,16,0,50,34
1649972732473,COGS 17,A01,092679,Staff,57,0,75,18
1649972738497,COGS 100,A01,083972,Staff,0,10,60,60
1649972750549,COGS 101C,A01,083976,Staff,15,0,30,15
1649972756577,COGS 102A,A01,083978,Johnson; Christine M.,14,0,30,16
1649972762601,COGS 107B,A01,083980,Staff,0,5,50,50
1649972768625,COGS 115,A01,083982,Staff,12,0,30,18
1649972774647,COGS 118B,A01,083367,Staff,0,12,40,40
1649972780674,COGS 172,A01,083984,Provenzano; Emily Kara,15,0,30,15
1649972786704,COGS 177,A00,083368,Staff,0,19,30,30
1649972792729,COGS 186,A01,083986,Staff,21,0,40,19
1649972798767,COGS 187A,A01,083988,Boyle; Mary E. T.,20,0,60,40
1649972804791,CSE 8A,A50,084003,Miranda; Gregory Joseph,0,4,15,15
1649972810816,CSE 11,A01,084005,Miranda; Gregory Joseph,0,11,55,55
1649972816838,CSE 20,A01,084007,Staff,3,0,20,17
1649972822862,CSE 21,A01,084009,Staff,0,17,50,50
1649972828888,CSE 30,A01,083370,Cao; Yingjun,0,52,40,40
1649972834916,CSE 100,A01,083372,Cao; Yingjun,0,42,40,40
1649972840939,CSE 101,A01,084011,Staff,0,53,40,40
1649972846966,CSE 141,A01,083374,Eldon; John,0,58,75,75
1649972852989,CSE 141L,A01,083376,Eldon; John,0,64,75,75
1649972859026,CSE 175,A01,084013,Kumar; Rakesh,22,0,25,3
1649972865046,CSE 190,A00,092508,Dubnov; Shlomo,15,0,15,0
1649972871068,ECE 5,A01,084049,Morris; Karcher William,13,0,20,7
1649972877108,ECE 100,A01,084051,Baghdadchi; Saharnaz,0,0,20,20
1649972877108,ECE 100,A02,091916,Baghdadchi; Saharnaz,15,0,20,5
1649972883132,ECE 101,A01,084053,Baghdadchi; Saharnaz,2,0,37,35
1649972883132,ECE 101,A02,084054,Baghdadchi; Saharnaz,31,0,37,6
1649972889155,ECE 107,A01,083390,Staff,27,0,40,13
1649972895181,ECE 148,A01,084056,Silberman; Jack,7,0,12,5
1649972901203,ECE 180,A00,083391,Abi Samra; Nicholas Camill,25,0,30,5
1649972901203,ECE 180,B00,083392,Abi Samra; Nicholas Camill,21,0,30,9
1649972907226,MATH 10B,A01,084110,Staff,5,0,30,25
1649972907226,MATH 10B,A02,084111,Staff,28,0,30,2
1649972907226,MATH 10B,A03,084112,Staff,26,0,30,4
1649972913250,MATH 10C,A01,083443,Staff,0,0,30,30
1649972913250,MATH 10C,A02,083444,Staff,2,0,30,28
1649972913250,MATH 10C,B01,084114,Staff,23,0,30,7
1649972913250,MATH 10C,B02,084115,Staff,28,0,30,2
1649972919271,MATH 18,A01,084117,Harel; Guershon,23,0,30,7
1649972919271,MATH 18,A02,084119,Harel; Guershon,28,0,30,2
1649972919271,MATH 18,A03,084120,Harel; Guershon,30,0,30,0
1649972919271,MATH 18,A04,084121,Harel; Guershon,29,0,30,1
1649972925298,MATH 20B,A01,084124,Um; Ko Woon,30,0,35,5
1649972925298,MATH 20B,B01,084126,Um; Ko Woon,29,0,35,6
1649972931333,MATH 20C,A01,083446,Hammock; Frances H,10,0,30,20
1649972931333,MATH 20C,A02,083447,Hammock; Frances H,26,0,30,4
1649972931333,MATH 20C,A03,083448,Hammock; Frances H,28,0,30,2
1649972931333,MATH 20C,A04,083449,Hammock; Frances H,30,0,30,0
1649972931333,MATH 20C,B01,083451,Hammock; Frances H,16,0,30,14
1649972931333,MATH 20C,B02,083452,Hammock; Frances H,26,0,30,4
1649972931333,MATH 20C,B03,083453,Hammock; Frances H,25,0,30,5
1649972931333,MATH 20C,B04,083454,Hammock; Frances H,28,0,30,2
1649972937356,MATH 20D,A01,084128,Staff,20,0,30,10
1649972937356,MATH 20D,A02,084129,Staff,30,0,30,0
1649972937356,MATH 20D,A03,084130,Staff,27,0,30,3
1649972937356,MATH 20D,B01,084133,Staff,10,0,30,20
1649972937356,MATH 20D,B02,084134,Staff,24,0,30,6
1649972937356,MATH 20D,B03,084135,Staff,29,0,30,1
1649972943379,MATH 20E,A01,084138,Staff,17,0,30,13
1649972943379,MATH 20E,A02,084139,Staff,12,0,30,18
1649972943379,MATH 20E,A03,084140,Staff,16,0,30,14
1649972943379,MATH 20E,A04,084141,Staff,22,0,30,8
1649972949412,MATH 102,A01,084143,Harel; Guershon,14,0,30,16
1649972949412,MATH 102,A02,084144,Harel; Guershon,21,0,30,9
1649972955434,MATH 103B,A01,083456,Staff,0,12,30,30
1649972955434,MATH 103B,A02,083457,Staff,0,12,30,30
1649972961460,MATH 109,A01,084146,Salehi Golsefidy; Alireza,21,0,30,9
1649972961460,MATH 109,A02,084147,Salehi Golsefidy; Alireza,19,0,30,11
1649972967489,MATH 120A,A01,085445,Eggers; John Dietrich,17,0,35,18
1649972967489,MATH 120A,A02,085446,Eggers; John Dietrich,27,0,35,8
1649972973514,MATH 142B,A01,084149,Verstraete; Jacques Allan,0,12,30,30
1649972973514,MATH 142B,A02,084150,Verstraete; Jacques Allan,0,12,30,30
1649972979534,MATH 170A,A01,083459,Nie; Jiawang,1,7,30,29
1649972979534,MATH 170A,A02,083460,Nie; Jiawang,0,6,30,30
1649972979534,MATH 170A,A03,083461,Nie; Jiawang,0,7,30,30
1649972985561,MATH 193B,A01,083463,Staff,1,0,30,29
1649972985561,MATH 193B,A02,083464,Staff,10,0,30,20
1649972985561,MATH 193B,A03,083465,Staff,18,0,30,12
1649972991634,COGS 2,A01,083966,Boyle; Mary E. T.,14,0,30,16
1649972997660,COGS 9,A01,083968,Staff,22,0,60,38
1649973003686,COGS 14B,A01,083970,Staff,16,0,50,34
1649973009717,COGS 17,A01,092679,Staff,57,0,75,18
1649973015750,COGS 100,A01,083972,Staff,0,10,60,60
1649973027798,COGS 101C,A01,083976,Staff,15,0,30,15
1649973033821,COGS 102A,A01,083978,Johnson; Christine M.,14,0,30,16
1649973039867,COGS 107B,A01,083980,Staff,0,5,50,50
1649973045894,COGS 115,A01,083982,Staff,12,0,30,18
1649973051917,COGS 118B,A01,083367,Staff,0,12,40,40
1649973057944,COGS 172,A01,083984,Provenzano; Emily Kara,15,0,30,15
1649973063969,COGS 177,A00,083368,Staff,0,19,30,30
1649973069993,COGS 186,A01,083986,Staff,21,0,40,19
1649973076110,COGS 187A,A01,083988,Boyle; Mary E. T.,20,0,60,40
1649973082135,CSE 8A,A50,084003,Miranda; Gregory Joseph,0,4,15,15
1649973088169,CSE 11,A01,084005,Miranda; Gregory Joseph,0,11,55,55
1649973094195,CSE 20,A01,084007,Staff,3,0,20,17
1649973100233,CSE 21,A01,084009,Staff,0,17,50,50
1649973106271,CSE 30,A01,083370,Cao; Yingjun,0,53,40,40
1649973112295,CSE 100,A01,083372,Cao; Yingjun,0,42,40,40
1649973118319,CSE 101,A01,084011,Staff,1,53,40,39
1649973124348,CSE 141,A01,083374,Eldon; John,0,58,75,75
1649973130375,CSE 141L,A01,083376,Eldon; John,0,64,75,75
1649973136399,CSE 175,A01,084013,Kumar; Rakesh,22,0,25,3
1649973142429,CSE 190,A00,092508,Dubnov; Shlomo,15,0,15,0
1649973148455,ECE 5,A01,084049,Morris; Karcher William,13,0,20,7
1649973154477,ECE 100,A01,084051,Baghdadchi; Saharnaz,0,0,20,20
1649973154477,ECE 100,A02,091916,Baghdadchi; Saharnaz,15,0,20,5
1649973160500,ECE 101,A01,084053,Baghdadchi; Saharnaz,2,0,37,35
1649973160500,ECE 101,A02,084054,Baghdadchi; Saharnaz,31,0,37,6
1649973166522,ECE 107,A01,083390,Staff,27,0,40,13
1649973172546,ECE 148,A01,084056,Silberman; Jack,7,0,12,5
1649973178587,ECE 180,A00,083391,Abi Samra; Nicholas Camill,25,0,30,5
1649973178587,ECE 180,B00,083392,Abi Samra; Nicholas Camill,21,0,30,9
1649973184613,MATH 10B,A01,084110,Staff,4,0,30,26
1649973184613,MATH 10B,A02,084111,Staff,28,0,30,2
1649973184613,MATH 10B,A03,084112,Staff,26,0,30,4
1649973190641,MATH 10C,A01,083443,Staff,0,0,30,30
1649973190641,MATH 10C,A02,083444,Staff,2,0,30,28
1649973190641,MATH 10C,B01,084114,Staff,23,0,30,7
1649973190641,MATH 10C,B02,084115,Staff,28,0,30,2
1649973196668,MATH 18,A01,084117,Harel; Guershon,23,0,30,7
1649973196668,MATH 18,A02,084119,Harel; Guershon,28,0,30,2
1649973196668,MATH 18,A03,084120,Harel; Guershon,30,0,30,0
1649973196668,MATH 18,A04,084121,Harel; Guershon,29,0,30,1
1649973202691,MATH 20B,A01,084124,Um; Ko Woon,30,0,35,5
1649973202691,MATH 20B,B01,084126,Um; Ko Woon,29,0,35,6
1649973208741,MATH 20C,A01,083446,Hammock; Frances H,10,0,30,20
1649973208741,MATH 20C,A02,083447,Hammock; Frances H,26,0,30,4
1649973208741,MATH 20C,A03,083448,Hammock; Frances H,28,0,30,2
1649973208741,MATH 20C,A04,083449,Hammock; Frances H,30,0,30,0
1649973208741,MATH 20C,B01,083451,Hammock; Frances H,16,0,30,14
1649973208741,MATH 20C,B02,083452,Hammock; Frances H,26,0,30,4
1649973208741,MATH 20C,B03,083453,Hammock; Frances H,25,0,30,5
1649973208741,MATH 20C,B04,083454,Hammock; Frances H,28,0,30,2
1649973214777,MATH 20D,A01,084128,Staff,20,0,30,10
1649973214777,MATH 20D,A02,084129,Staff,30,0,30,0
1649973214777,MATH 20D,A03,084130,Staff,27,0,30,3
1649973214777,MATH 20D,B01,084133,Staff,10,0,30,20
1649973214777,MATH 20D,B02,084134,Staff,24,0,30,6
1649973214777,MATH 20D,B03,084135,Staff,29,0,30,1
1649973220807,MATH 20E,A01,084138,Staff,17,0,30,13
1649973220807,MATH 20E,A02,084139,Staff,11,0,30,19
1649973220807,MATH 20E,A03,084140,Staff,16,0,30,14
1649973220807,MATH 20E,A04,084141,Staff,22,0,30,8
1649973226830,MATH 102,A01,084143,Harel; Guershon,14,0,30,16
1649973226830,MATH 102,A02,084144,Harel; Guershon,21,0,30,9
1649973232862,MATH 103B,A01,083456,Staff,0,12,30,30
1649973232862,MATH 103B,A02,083457,Staff,0,12,30,30
1649973238889,MATH 109,A01,084146,Salehi Golsefidy; Alireza,21,0,30,9
1649973238889,MATH 109,A02,084147,Salehi Golsefidy; Alireza,18,0,30,12
1649973244912,MATH 120A,A01,085445,Eggers; John Dietrich,17,0,35,18
1649973244912,MATH 120A,A02,085446,Eggers; John Dietrich,27,0,35,8
1649973250939,MATH 142B,A01,084149,Verstraete; Jacques Allan,0,12,30,30
1649973250939,MATH 142B,A02,084150,Verstraete; Jacques Allan,0,12,30,30
1649973256970,MATH 170A,A01,083459,Nie; Jiawang,1,7,30,29
1649973256970,MATH 170A,A02,083460,Nie; Jiawang,0,6,30,30
1649973256970,MATH 170A,A03,083461,Nie; Jiawang,0,7,30,30
1649973262996,MATH 193B,A01,083463,Staff,1,0,30,29
1649973262996,MATH 193B,A02,083464,Staff,10,0,30,20
1649973262996,MATH 193B,A03,083465,Staff,18,0,30,12
1649973269062,COGS 2,A01,083966,Boyle; Mary E. T.,14,0,30,16
1649973275089,COGS 9,A01,083968,Staff,22,0,60,38
1649973281114,COGS 14B,A01,083970,Staff,15,0,50,35
1649973287135,COGS 17,A01,092679,Staff,57,0,75,18
1649973293162,COGS 100,A01,083972,Staff,0,10,60,60
1649973305206,COGS 101C,A01,083976,Staff,15,0,30,15
1649973311241,COGS 102A,A01,083978,Johnson; Christine M.,14,0,30,16
1649973317263,COGS 107B,A01,083980,Staff,0,5,50,50
1649973323299,COGS 115,A01,083982,Staff,12,0,30,18
1649973329329,COGS 118B,A01,083367,Staff,0,12,40,40
1649973335363,COGS 172,A01,083984,Provenzano; Emily Kara,15,0,30,15
1649973341402,COGS 177,A00,083368,Staff,0,19,30,30
1649973363985,COGS 186,A01,083986,Staff,21,0,40,19
1649973370007,COGS 187A,A01,083988,Boyle; Mary E. T.,20,0,60,40
1649973376043,CSE 8A,A50,084003,Miranda; Gregory Joseph,0,4,15,15
1649973382068,CSE 11,A01,084005,Miranda; Gregory Joseph,0,11,55,55
1649973388091,CSE 20,A01,084007,Staff,3,0,20,17
1649973394120,CSE 21,A01,084009,Staff,0,18,50,50
1649973400149,CSE 30,A01,083370,Cao; Yingjun,0,53,40,40
1649973406174,CSE 100,A01,083372,Cao; Yingjun,0,42,40,40
1649973412196,CSE 101,A01,084011,Staff,1,53,40,39
1649973418224,CSE 141,A01,083374,Eldon; John,0,58,75,75
1649973424247,CSE 141L,A01,083376,Eldon; John,0,64,75,75
1649973430279,CSE 175,A01,084013,Kumar; Rakesh,22,0,25,3
1649973436314,CSE 190,A00,092508,Dubnov; Shlomo,15,0,15,0
1649973442342,ECE 5,A01,084049,Morris; Karcher William,13,0,20,7
1649973448364,ECE 100,A01,084051,Baghdadchi; Saharnaz,0,0,20,20
1649973448364,ECE 100,A02,091916,Baghdadchi; Saharnaz,15,0,20,5
1649973454387,ECE 101,A01,084053,Baghdadchi; Saharnaz,2,0,37,35
1649973454387,ECE 101,A02,084054,Baghdadchi; Saharnaz,31,0,37,6
1649973460416,ECE 107,A01,083390,Staff,27,0,40,13
1649973466449,ECE 148,A01,084056,Silberman; Jack,7,0,12,5
1649973472472,ECE 180,A00,083391,Abi Samra; Nicholas Camill,25,0,30,5
1649973472472,ECE 180,B00,083392,Abi Samra; Nicholas Camill,21,0,30,9
1649973478498,MATH 10B,A01,084110,Staff,3,0,30,27
1649973478498,MATH 10B,A02,084111,Staff,28,0,30,2
1649973478498,MATH 10B,A03,084112,Staff,26,0,30,4
1649973484532,MATH 10C,A01,083443,Staff,0,0,30,30
1649973484532,MATH 10C,A02,083444,Staff,2,0,30,28
1649973484532,MATH 10C,B01,084114,Staff,23,0,30,7
1649973484532,MATH 10C,B02,084115,Staff,28,0,30,2
1649973490559,MATH 18,A01,084117,Harel; Guershon,23,0,30,7
1649973490559,MATH 18,A02,084119,Harel; Guershon,28,0,30,2
1649973490559,MATH 18,A03,084120,Harel; Guershon,30,0,30,0
1649973490559,MATH 18,A04,084121,Harel; Guershon,29,0,30,1
1649973496585,MATH 20B,A01,084124,Um; Ko Woon,30,0,35,5
1649973496585,MATH 20B,B01,084126,Um; Ko Woon,29,0,35,6
1649973502610,MATH 20C,A01,083446,Hammock; Frances H,10,0,30,20
1649973502610,MATH 20C,A02,083447,Hammock; Frances H,26,0,30,4
1649973502610,MATH 20C,A03,083448,Hammock; Frances H,28,0,30,2
1649973502610,MATH 20C,A04,083449,Hammock; Frances H,30,0,30,0
1649973502610,MATH 20C,B01,083451,Hammock; Frances H,16,0,30,14
1649973502610,MATH 20C,B02,083452,Hammock; Frances H,26,0,30,4
1649973502610,MATH 20C,B03,083453,Hammock; Frances H,25,0,30,5
1649973502610,MATH 20C,B04,083454,Hammock; Frances H,28,0,30,2
1649973508642,MATH 20D,A01,084128,Staff,20,0,30,10
1649973508642,MATH 20D,A02,084129,Staff,30,0,30,0
1649973508642,MATH 20D,A03,084130,Staff,27,0,30,3
1649973508642,MATH 20D,B01,084133,Staff,10,0,30,20
1649973508642,MATH 20D,B02,084134,Staff,24,0,30,6
1649973508642,MATH 20D,B03,084135,Staff,29,0,30,1
1649973514669,MATH 20E,A01,084138,Staff,17,0,30,13
1649973514669,MATH 20E,A02,084139,Staff,11,0,30,19
1649973514669,MATH 20E,A03,084140,Staff,16,0,30,14
1649973514669,MATH 20E,A04,084141,Staff,22,0,30,8
1649973520708,MATH 102,A01,084143,Harel; Guershon,14,0,30,16
1649973520708,MATH 102,A02,084144,Harel; Guershon,21,0,30,9
1649973526740,MATH 103B,A01,083456,Staff,0,12,30,30
1649973526740,MATH 103B,A02,083457,Staff,0,12,30,30
1649973532763,MATH 109,A01,084146,Salehi Golsefidy; Alireza,21,0,30,9
1649973532763,MATH 109,A02,084147,Salehi Golsefidy; Alireza,18,0,30,12
1649973538796,MATH 120A,A01,085445,Eggers; John Dietrich,17,0,35,18
1649973538796,MATH 120A,A02,085446,Eggers; John Dietrich,27,0,35,8
1649973544823,MATH 142B,A01,084149,Verstraete; Jacques Allan,0,12,30,30
1649973544823,MATH 142B,A02,084150,Verstraete; Jacques Allan,0,12,30,30
1649973550853,MATH 170A,A01,083459,Nie; Jiawang,1,7,30,29
1649973550853,MATH 170A,A02,083460,Nie; Jiawang,0,6,30,30
1649973550853,MATH 170A,A03,083461,Nie; Jiawang,0,7,30,30
1649973556877,MATH 193B,A01,083463,Staff,1,0,30,29
1649973556877,MATH 193B,A02,083464,Staff,10,0,30,20
1649973556877,MATH 193B,A03,083465,Staff,18,0,30,12
1649973562925,COGS 2,A01,083966,Boyle; Mary E. T.,14,0,30,16
1649973568951,COGS 9,A01,083968,Staff,22,0,60,38
1649973574975,COGS 14B,A01,083970,Staff,15,0,50,35
1649973581001,COGS 17,A01,092679,Staff,57,0,75,18
1649973587023,COGS 100,A01,083972,Staff,0,10,60,60
1649973599086,COGS 101C,A01,083976,Staff,15,0,30,15
1649973605108,COGS 102A,A01,083978,Johnson; Christine M.,14,0,30,16
1649973611135,COGS 107B,A01,083980,Staff,0,5,50,50
1649973617163,COGS 115,A01,083982,Staff,11,0,30,19
1649973623187,COGS 118B,A01,083367,Staff,0,12,40,40
1649973629221,COGS 172,A01,083984,Provenzano; Emily Kara,15,0,30,15
1649973635255,COGS 177,A00,083368,Staff,0,19,30,30
1649973641279,COGS 186,A01,083986,Staff,21,0,40,19
1649973647305,COGS 187A,A01,083988,Boyle; Mary E. T.,20,0,60,40
1649973653330,CSE 8A,A50,084003,Miranda; Gregory Joseph,0,4,15,15
1649973659353,CSE 11,A01,084005,Miranda; Gregory Joseph,0,11,55,55
1649973665413,CSE 20,A01,084007,Staff,3,0,20,17
1649973671455,CSE 21,A01,084009,Staff,0,18,50,50
1649973677477,CSE 30,A01,083370,Cao; Yingjun,0,53,40,40
1649973683510,CSE 100,A01,083372,Cao; Yingjun,0,42,40,40
1649973689623,CSE 101,A01,084011,Staff,1,53,40,39
1649973695666,CSE 141,A01,083374,Eldon; John,0,58,75,75
1649973701690,CSE 141L,A01,083376,Eldon; John,0,64,75,75
1649973707715,CSE 175,A01,084013,Kumar; Rakesh,22,0,25,3
1649973713736,CSE 190,A00,092508,Dubnov; Shlomo,20,0,20,0
1649973719769,ECE 5,A01,084049,Morris; Karcher William,13,0,20,7
1649973725799,ECE 100,A01,084051,Baghdadchi; Saharnaz,0,0,20,20
1649973725799,ECE 100,A02,091916,Baghdadchi; Saharnaz,15,0,20,5
1649973731847,ECE 101,A01,084053,Baghdadchi; Saharnaz,2,0,37,35
1649973731847,ECE 101,A02,084054,Baghdadchi; Saharnaz,31,0,37,6
1649973737871,ECE 107,A01,083390,Staff,27,0,40,13
1649973743893,ECE 148,A01,084056,Silberman; Jack,7,0,12,5
1649973749919,ECE 180,A00,083391,Abi Samra; Nicholas Camill,25,0,30,5
1649973749919,ECE 180,B00,083392,Abi Samra; Nicholas Camill,21,0,30,9
1649973755942,MATH 10B,A01,084110,Staff,3,0,30,27
1649973755942,MATH 10B,A02,084111,Staff,28,0,30,2
1649973755942,MATH 10B,A03,084112,Staff,26,0,30,4
1649973761965,MATH 10C,A01,083443,Staff,0,0,30,30
1649973761965,MATH 10C,A02,083444,Staff,0,0,30,30
1649973761965,MATH 10C,B01,084114,Staff,23,0,30,7
1649973761965,MATH 10C,B02,084115,Staff,28,0,30,2
1649973767991,MATH 18,A01,084117,Harel; Guershon,23,0,30,7
1649973767991,MATH 18,A02,084119,Harel; Guershon,28,0,30,2
1649973767991,MATH 18,A03,084120,Harel; Guershon,30,0,30,0
1649973767991,MATH 18,A04,084121,Harel; Guershon,29,0,30,1
1649973774019,MATH 20B,A01,084124,Um; Ko Woon,30,0,35,5
1649973774019,MATH 20B,B01,084126,Um; Ko Woon,29,0,35,6
1649973780043,MATH 20C,A01,083446,Hammock; Frances H,10,0,30,20
1649973780043,MATH 20C,A02,083447,Hammock; Frances H,26,0,30,4
1649973780043,MATH 20C,A03,083448,Hammock; Frances H,28,0,30,2
1649973780043,MATH 20C,A04,083449,Hammock; Frances H,30,0,30,0
1649973780043,MATH 20C,B01,083451,Hammock; Frances H,16,0,30,14
1649973780043,MATH 20C,B02,083452,Hammock; Frances H,26,0,30,4
1649973780043,MATH 20C,B03,083453,Hammock; Frances H,25,0,30,5
1649973780043,MATH 20C,B04,083454,Hammock; Frances H,28,0,30,2
1649973786068,MATH 20D,A01,084128,Staff,20,0,30,10
1649973786068,MATH 20D,A02,084129,Staff,30,0,30,0
1649973786068,MATH 20D,A03,084130,Staff,27,0,30,3
1649973786068,MATH 20D,B01,084133,Staff,10,0,30,20
1649973786068,MATH 20D,B02,084134,Staff,24,0,30,6
1649973786068,MATH 20D,B03,084135,Staff,29,0,30,1
1649973792088,MATH 20E,A01,084138,Staff,17,0,30,13
1649973792088,MATH 20E,A02,084139,Staff,11,0,30,19
1649973792088,MATH 20E,A03,084140,Staff,16,0,30,14
1649973792088,MATH 20E,A04,084141,Staff,22,0,30,8
1649973798119,MATH 102,A01,084143,Harel; Guershon,14,0,30,16
1649973798119,MATH 102,A02,084144,Harel; Guershon,21,0,30,9
1649973804140,MATH 103B,A01,083456,Staff,0,12,30,30
1649973804140,MATH 103B,A02,083457,Staff,0,12,30,30
1649973810164,MATH 109,A01,084146,Salehi Golsefidy; Alireza,21,0,30,9
1649973810164,MATH 109,A02,084147,Salehi Golsefidy; Alireza,18,0,30,12
1649973816185,MATH 120A,A01,085445,Eggers; John Dietrich,17,0,35,18
1649973816185,MATH 120A,A02,085446,Eggers; John Dietrich,27,0,35,8
1649973822212,MATH 142B,A01,084149,Verstraete; Jacques Allan,0,12,30,30
1649973822212,MATH 142B,A02,084150,Verstraete; Jacques Allan,0,12,30,30
1649973828234,MATH 170A,A01,083459,Nie; Jiawang,1,7,30,29
1649973828234,MATH 170A,A02,083460,Nie; Jiawang,0,6,30,30
1649973828234,MATH 170A,A03,083461,Nie; Jiawang,0,7,30,30
1649973834256,MATH 193B,A01,083463,Staff,1,0,30,29
1649973834256,MATH 193B,A02,083464,Staff,10,0,30,20
1649973834256,MATH 193B,A03,083465,Staff,18,0,30,12
1649973840318,COGS 2,A01,083966,Boyle; Mary E. T.,14,0,30,16
1649973846347,COGS 9,A01,083968,Staff,21,0,60,39
1649973852380,COGS 14B,A01,083970,Staff,15,0,50,35
1649973858403,COGS 17,A01,092679,Staff,57,0,75,18
1649973864427,COGS 100,A01,083972,Staff,0,10,60,60
1649973876485,COGS 101C,A01,083976,Staff,15,0,30,15
1649973882513,COGS 102A,A01,083978,Johnson; Christine M.,14,0,30,16
1649973888534,COGS 107B,A01,083980,Staff,0,5,50,50
1649973894556,COGS 115,A01,083982,Staff,11,0,30,19
1649973900582,COGS 118B,A01,083367,Staff,0,12,40,40
1649973906614,COGS 172,A01,083984,Provenzano; Emily Kara,15,0,30,15
1649973912638,COGS 177,A00,083368,Staff,0,20,30,30
1649973918663,COGS 186,A01,083986,Staff,21,0,40,19
1649973924691,COGS 187A,A01,083988,Boyle; Mary E. T.,20,0,60,40
1649973930717,CSE 8A,A50,084003,Miranda; Gregory Joseph,0,4,15,15
1649973936740,CSE 11,A01,084005,Miranda; Gregory Joseph,0,11,55,55
1649973942764,CSE 20,A01,084007,Staff,3,0,20,17
1649973948787,CSE 21,A01,084009,Staff,0,18,50,50
1649973954818,CSE 30,A01,083370,Cao; Yingjun,0,55,40,40
1649973960841,CSE 100,A01,083372,Cao; Yingjun,0,43,40,40
1649973966865,CSE 101,A01,084011,Staff,1,54,40,39
1649973972888,CSE 141,A01,083374,Eldon; John,0,58,75,75
1649973978913,CSE 141L,A01,083376,Eldon; John,0,64,75,75
1649973984961,CSE 175,A01,084013,Kumar; Rakesh,22,0,25,3
1649973990989,CSE 190,A00,092508,Dubnov; Shlomo,20,0,20,0
1649973997028,ECE 5,A01,084049,Morris; Karcher William,13,0,20,7
1649974003055,ECE 100,A01,084051,Baghdadchi; Saharnaz,0,0,20,20
1649974003055,ECE 100,A02,091916,Baghdadchi; Saharnaz,15,0,20,5
1649974009091,ECE 101,A01,084053,Baghdadchi; Saharnaz,2,0,37,35
1649974009091,ECE 101,A02,084054,Baghdadchi; Saharnaz,31,0,37,6
1649974015120,ECE 107,A01,083390,Staff,27,0,40,13
1649974021148,ECE 148,A01,084056,Silberman; Jack,7,0,12,5
1649974027171,ECE 180,A00,083391,Abi Samra; Nicholas Camill,25,0,30,5
1649974027171,ECE 180,B00,083392,Abi Samra; Nicholas Camill,21,0,30,9
1649974033206,MATH 10B,A01,084110,Staff,3,0,30,27
1649974033206,MATH 10B,A02,084111,Staff,28,0,30,2
1649974033206,MATH 10B,A03,084112,Staff,26,0,30,4
1649974039237,MATH 10C,A01,083443,Staff,0,0,30,30
1649974039237,MATH 10C,A02,083444,Staff,0,1,30,30
1649974039237,MATH 10C,B01,084114,Staff,23,0,30,7
1649974039237,MATH 10C,B02,084115,Staff,28,0,30,2
1649974045263,MATH 18,A01,084117,Harel; Guershon,23,0,30,7
1649974045263,MATH 18,A02,084119,Harel; Guershon,28,0,30,2
1649974045263,MATH 18,A03,084120,Harel; Guershon,30,0,30,0
1649974045263,MATH 18,A04,084121,Harel; Guershon,29,0,30,1
1649974051287,MATH 20B,A01,084124,Um; Ko Woon,30,0,35,5
1649974051287,MATH 20B,B01,084126,Um; Ko Woon,29,0,35,6
1649974057311,MATH 20C,A01,083446,Hammock; Frances H,10,0,30,20
1649974057311,MATH 20C,A02,083447,Hammock; Frances H,26,0,30,4
1649974057311,MATH 20C,A03,083448,Hammock; Frances H,28,0,30,2
1649974057311,MATH 20C,A04,083449,Hammock; Frances H,30,0,30,0
1649974057311,MATH 20C,B01,083451,Hammock; Frances H,16,0,30,14
1649974057311,MATH 20C,B02,083452,Hammock; Frances H,26,0,30,4
1649974057311,MATH 20C,B03,083453,Hammock; Frances H,25,0,30,5
1649974057311,MATH 20C,B04,083454,Hammock; Frances H,28,0,30,2
1649974063344,MATH 20D,A01,084128,Staff,20,0,30,10
1649974063344,MATH 20D,A02,084129,Staff,30,0,30,0
1649974063344,MATH 20D,A03,084130,Staff,27,0,30,3
1649974063344,MATH 20D,B01,084133,Staff,10,0,30,20
1649974063344,MATH 20D,B02,084134,Staff,24,0,30,6
1649974063344,MATH 20D,B03,084135,Staff,29,0,30,1
1649974069371,MATH 20E,A01,084138,Staff,17,0,30,13
1649974069371,MATH 20E,A02,084139,Staff,11,0,30,19
1649974069371,MATH 20E,A03,084140,Staff,16,0,30,14
1649974069371,MATH 20E,A04,084141,Staff,22,0,30,8
1649974075400,MATH 102,A01,084143,Harel; Guershon,14,0,30,16
1649974075400,MATH 102,A02,084144,Harel; Guershon,21,0,30,9
1649974081422,MATH 103B,A01,083456,Staff,0,12,30,30
1649974081422,MATH 103B,A02,083457,Staff,0,12,30,30
1649974087455,MATH 109,A01,084146,Salehi Golsefidy; Alireza,21,0,30,9
1649974087455,MATH 109,A02,084147,Salehi Golsefidy; Alireza,18,0,30,12
1649974093478,MATH 120A,A01,085445,Eggers; John Dietrich,17,0,35,18
1649974093478,MATH 120A,A02,085446,Eggers; John Dietrich,27,0,35,8
1649974099507,MATH 142B,A01,084149,Verstraete; Jacques Allan,0,12,30,30
1649974099507,MATH 142B,A02,084150,Verstraete; Jacques Allan,0,12,30,30
1649974105531,MATH 170A,A01,083459,Nie; Jiawang,1,7,30,29
1649974105531,MATH 170A,A02,083460,Nie; Jiawang,0,6,30,30
1649974105531,MATH 170A,A03,083461,Nie; Jiawang,0,7,30,30
1649974111558,MATH 193B,A01,083463,Staff,1,0,30,29
1649974111558,MATH 193B,A02,083464,Staff,10,0,30,20
1649974111558,MATH 193B,A03,083465,Staff,18,0,30,12
1649974117609,COGS 2,A01,083966,Boyle; Mary E. T.,14,0,30,16
1649974123630,COGS 9,A01,083968,Staff,21,0,60,39
1649974129663,COGS 14B,A01,083970,Staff,15,0,50,35
1649974135686,COGS 17,A01,092679,Staff,57,0,75,18
1649974141708,COGS 100,A01,083972,Staff,0,10,60,60
1649974153756,COGS 101C,A01,083976,Staff,15,0,30,15
1649974159784,COGS 102A,A01,083978,Johnson; Christine M.,14,0,30,16
1649974165820,COGS 107B,A01,083980,Staff,0,5,50,50
1649974171842,COGS 115,A01,083982,Staff,11,0,30,19
1649974177869,COGS 118B,A01,083367,Staff,0,12,40,40
1649974183892,COGS 172,A01,083984,Provenzano; Emily Kara,15,0,30,15
1649974189921,COGS 177,A00,083368,Staff,0,20,30,30
1649974195947,COGS 186,A01,083986,Staff,21,0,40,19
1649974201979,COGS 187A,A01,083988,Boyle; Mary E. T.,20,0,60,40
1649974208008,CSE 8A,A50,084003,Miranda; Gregory Joseph,0,4,15,15
1649974214031,CSE 11,A01,084005,Miranda; Gregory Joseph,0,11,55,55
1649974220052,CSE 20,A01,084007,Staff,3,0,20,17
1649974226097,CSE 21,A01,084009,Staff,0,18,50,50
1649974232120,CSE 30,A01,083370,Cao; Yingjun,0,55,40,40
1649974238153,CSE 100,A01,083372,Cao; Yingjun,0,43,40,40
1649974244176,CSE 101,A01,084011,Staff,1,55,40,39
1649974250199,CSE 141,A01,083374,Eldon; John,0,58,75,75
1649974256224,CSE 141L,A01,083376,Eldon; John,0,64,75,75
1649974262249,CSE 175,A01,084013,Kumar; Rakesh,22,0,25,3
1649974268275,CSE 190,A00,092508,Dubnov; Shlomo,20,0,20,0
1649974274303,ECE 5,A01,084049,Morris; Karcher William,13,0,20,7
1649974280326,ECE 100,A01,084051,Baghdadchi; Saharnaz,0,0,20,20
1649974280326,ECE 100,A02,091916,Baghdadchi; Saharnaz,15,0,20,5
1649974286447,ECE 101,A01,084053,Baghdadchi; Saharnaz,2,0,37,35
1649974286447,ECE 101,A02,084054,Baghdadchi; Saharnaz,31,0,37,6
1649974292475,ECE 107,A01,083390,Staff,27,0,40,13
1649974298501,ECE 148,A01,084056,Silberman; Jack,7,0,12,5
1649974304523,ECE 180,A00,083391,Abi Samra; Nicholas Camill,25,0,30,5
1649974304523,ECE 180,B00,083392,Abi Samra; Nicholas Camill,21,0,30,9
1649974310553,MATH 10B,A01,084110,Staff,3,0,30,27
1649974310553,MATH 10B,A02,084111,Staff,28,0,30,2
1649974310553,MATH 10B,A03,084112,Staff,26,0,30,4
1649974316576,MATH 10C,A01,083443,Staff,0,0,30,30
1649974316576,MATH 10C,A02,083444,Staff,0,1,30,30
1649974316576,MATH 10C,B01,084114,Staff,23,0,30,7
1649974316576,MATH 10C,B02,084115,Staff,28,0,30,2
1649974322598,MATH 18,A01,084117,Harel; Guershon,23,0,30,7
1649974322598,MATH 18,A02,084119,Harel; Guershon,28,0,30,2
1649974322598,MATH 18,A03,084120,Harel; Guershon,30,0,30,0
1649974322598,MATH 18,A04,084121,Harel; Guershon,29,0,30,1
1649974328627,MATH 20B,A01,084124,Um; Ko Woon,30,0,35,5
1649974328627,MATH 20B,B01,084126,Um; Ko Woon,29,0,35,6
1649974334661,MATH 20C,A01,083446,Hammock; Frances H,10,0,30,20
1649974334661,MATH 20C,A02,083447,Hammock; Frances H,26,0,30,4
1649974334661,MATH 20C,A03,083448,Hammock; Frances H,28,0,30,2
1649974334661,MATH 20C,A04,083449,Hammock; Frances H,30,0,30,0
1649974334661,MATH 20C,B01,083451,Hammock; Frances H,16,0,30,14
1649974334661,MATH 20C,B02,083452,Hammock; Frances H,25,0,30,5
1649974334661,MATH 20C,B03,083453,Hammock; Frances H,25,0,30,5
1649974334661,MATH 20C,B04,083454,Hammock; Frances H,28,0,30,2
1649974340685,MATH 20D,A01,084128,Staff,20,0,30,10
1649974340685,MATH 20D,A02,084129,Staff,30,0,30,0
1649974340685,MATH 20D,A03,084130,Staff,27,0,30,3
1649974340685,MATH 20D,B01,084133,Staff,9,0,30,21
1649974340685,MATH 20D,B02,084134,Staff,24,0,30,6
1649974340685,MATH 20D,B03,084135,Staff,29,0,30,1
1649974346713,MATH 20E,A01,084138,Staff,17,0,30,13
1649974346713,MATH 20E,A02,084139,Staff,10,0,30,20
1649974346713,MATH 20E,A03,084140,Staff,16,0,30,14
1649974346713,MATH 20E,A04,084141,Staff,22,0,30,8
1649974352751,MATH 102,A01,084143,Harel; Guershon,14,0,30,16
1649974352751,MATH 102,A02,084144,Harel; Guershon,21,0,30,9
1649974358774,MATH 103B,A01,083456,Staff,0,12,30,30
1649974358774,MATH 103B,A02,083457,Staff,0,12,30,30
1649974364797,MATH 109,A01,084146,Salehi Golsefidy; Alireza,21,0,30,9
1649974364797,MATH 109,A02,084147,Salehi Golsefidy; Alireza,18,0,30,12
1649974370827,MATH 120A,A01,085445,Eggers; John Dietrich,17,0,35,18
1649974370827,MATH 120A,A02,085446,Eggers; John Dietrich,27,0,35,8
1649974376859,MATH 142B,A01,084149,Verstraete; Jacques Allan,0,12,30,30
1649974376859,MATH 142B,A02,084150,Verstraete; Jacques Allan,0,12,30,30
1649974382891,MATH 170A,A01,083459,Nie; Jiawang,1,7,30,29
1649974382891,MATH 170A,A02,083460,Nie; Jiawang,0,6,30,30
1649974382891,MATH 170A,A03,083461,Nie; Jiawang,0,7,30,30
1649974388916,MATH 193B,A01,083463,Staff,1,0,30,29
1649974388916,MATH 193B,A02,083464,Staff,10,0,30,20
1649974388916,MATH 193B,A03,083465,Staff,18,0,30,12
1649974394978,COGS 2,A01,083966,Boyle; Mary E. T.,14,0,30,16
1649974401012,COGS 9,A01,083968,Staff,21,0,60,39
1649974407039,COGS 14B,A01,083970,Staff,15,0,50,35
1649974413077,COGS 17,A01,092679,Staff,57,0,75,18
1649974419098,COGS 100,A01,083972,Staff,0,10,60,60
1649974431143,COGS 101C,A01,083976,Staff,15,0,30,15
1649974437164,COGS 102A,A01,083978,Johnson; Christine M.,14,0,30,16
1649974443197,COGS 107B,A01,083980,Staff,0,5,50,50
1649974449219,COGS 115,A01,083982,Staff,11,0,30,19
1649974455246,COGS 118B,A01,083367,Staff,0,12,40,40
1649974461269,COGS 172,A01,083984,Provenzano; Emily Kara,15,0,30,15
1649974467292,COGS 177,A00,083368,Staff,0,20,30,30
1649974473316,COGS 186,A01,083986,Staff,21,0,40,19
1649974479337,COGS 187A,A01,083988,Boyle; Mary E. T.,20,0,60,40
1649974485364,CSE 8A,A50,084003,Miranda; Gregory Joseph,0,4,15,15
1649974491388,CSE 11,A01,084005,Miranda; Gregory Joseph,0,11,55,55
1649974497421,CSE 20,A01,084007,Staff,3,0,20,17
1649974503443,CSE 21,A01,084009,Staff,0,18,50,50
1649974509465,CSE 30,A01,083370,Cao; Yingjun,0,54,40,40
1649974515487,CSE 100,A01,083372,Cao; Yingjun,0,43,40,40
1649974521513,CSE 101,A01,084011,Staff,1,55,40,39
1649974527535,CSE 141,A01,083374,Eldon; John,0,58,75,75
1649974533563,CSE 141L,A01,083376,Eldon; John,0,64,75,75
1649974539591,CSE 175,A01,084013,Kumar; Rakesh,22,0,25,3
1649974545615,CSE 190,A00,092508,Dubnov; Shlomo,20,0,20,0
1649974551645,ECE 5,A01,084049,Morris; Karcher William,13,0,20,7
1649974557667,ECE 100,A01,084051,Baghdadchi; Saharnaz,0,0,20,20
1649974557667,ECE 100,A02,091916,Baghdadchi; Saharnaz,15,0,20,5
1649974563691,ECE 101,A01,084053,Baghdadchi; Saharnaz,2,0,37,35
1649974563691,ECE 101,A02,084054,Baghdadchi; Saharnaz,31,0,37,6
1649974569717,ECE 107,A01,083390,Staff,27,0,40,13
1649974575744,ECE 148,A01,084056,Silberman; Jack,8,0,12,4
1649974581767,ECE 180,A00,083391,Abi Samra; Nicholas Camill,25,0,30,5
1649974581767,ECE 180,B00,083392,Abi Samra; Nicholas Camill,21,0,30,9
1649974587800,MATH 10B,A01,084110,Staff,3,0,30,27
1649974587800,MATH 10B,A02,084111,Staff,27,0,30,3
1649974587800,MATH 10B,A03,084112,Staff,26,0,30,4
1649974593830,MATH 10C,A01,083443,Staff,0,0,30,30
1649974593830,MATH 10C,A02,083444,Staff,0,1,30,30
1649974593830,MATH 10C,B01,084114,Staff,23,0,30,7
1649974593830,MATH 10C,B02,084115,Staff,28,0,30,2
1649974599854,MATH 18,A01,084117,Harel; Guershon,23,0,30,7
1649974599854,MATH 18,A02,084119,Harel; Guershon,28,0,30,2
1649974599854,MATH 18,A03,084120,Harel; Guershon,30,0,30,0
1649974599854,MATH 18,A04,084121,Harel; Guershon,29,0,30,1
1649974605890,MATH 20B,A01,084124,Um; Ko Woon,30,0,35,5
1649974605890,MATH 20B,B01,084126,Um; Ko Woon,29,0,35,6
1649974611913,MATH 20C,A01,083446,Hammock; Frances H,10,0,30,20
1649974611913,MATH 20C,A02,083447,Hammock; Frances H,26,0,30,4
1649974611913,MATH 20C,A03,083448,Hammock; Frances H,28,0,30,2
1649974611913,MATH 20C,A04,083449,Hammock; Frances H,30,0,30,0
1649974611913,MATH 20C,B01,083451,Hammock; Frances H,16,0,30,14
1649974611913,MATH 20C,B02,083452,Hammock; Frances H,25,0,30,5
1649974611913,MATH 20C,B03,083453,Hammock; Frances H,25,0,30,5
1649974611913,MATH 20C,B04,083454,Hammock; Frances H,28,0,30,2
1649974617938,MATH 20D,A01,084128,Staff,20,0,30,10
1649974617938,MATH 20D,A02,084129,Staff,30,0,30,0
1649974617938,MATH 20D,A03,084130,Staff,27,0,30,3
1649974617938,MATH 20D,B01,084133,Staff,9,0,30,21
1649974617938,MATH 20D,B02,084134,Staff,24,0,30,6
1649974617938,MATH 20D,B03,084135,Staff,29,0,30,1
1649974623969,MATH 20E,A01,084138,Staff,17,0,30,13
1649974623969,MATH 20E,A02,084139,Staff,11,0,30,19
1649974623969,MATH 20E,A03,084140,Staff,16,0,30,14
1649974623969,MATH 20E,A04,084141,Staff,22,0,30,8
1649974629992,MATH 102,A01,084143,Harel; Guershon,14,0,30,16
1649974629992,MATH 102,A02,084144,Harel; Guershon,21,0,30,9
1649974636019,MATH 103B,A01,083456,Staff,0,12,30,30
1649974636019,MATH 103B,A02,083457,Staff,0,12,30,30
1649974642044,MATH 109,A01,084146,Salehi Golsefidy; Alireza,20,0,30,10
1649974642044,MATH 109,A02,084147,Salehi Golsefidy; Alireza,18,0,30,12
1649974648069,MATH 120A,A01,085445,Eggers; John Dietrich,17,0,35,18
1649974648069,MATH 120A,A02,085446,Eggers; John Dietrich,27,0,35,8
1649974654092,MATH 142B,A01,084149,Verstraete; Jacques Allan,0,12,30,30
1649974654092,MATH 142B,A02,084150,Verstraete; Jacques Allan,0,12,30,30
1649974660116,MATH 170A,A01,083459,Nie; Jiawang,1,7,30,29
1649974660116,MATH 170A,A02,083460,Nie; Jiawang,0,6,30,30
1649974660116,MATH 170A,A03,083461,Nie; Jiawang,0,7,30,30
1649974666143,MATH 193B,A01,083463,Staff,1,0,30,29
1649974666143,MATH 193B,A02,083464,Staff,10,0,30,20
1649974666143,MATH 193B,A03,083465,Staff,18,0,30,12
1649974672205,COGS 2,A01,083966,Boyle; Mary E. T.,13,0,30,17
1649974678228,COGS 9,A01,083968,Staff,20,0,60,40
1649974684250,COGS 14B,A01,083970,Staff,15,0,50,35
1649974690278,COGS 17,A01,092679,Staff,56,0,75,19
1649974696306,COGS 100,A01,083972,Staff,0,10,60,60
1649974708361,COGS 101C,A01,083976,Staff,15,0,30,15
1649974714385,COGS 102A,A01,083978,Johnson; Christine M.,14,0,30,16
1649974720406,COGS 107B,A01,083980,Staff,0,5,50,50
1649974726440,COGS 115,A01,083982,Staff,11,0,30,19
1649974732466,COGS 118B,A01,083367,Staff,0,12,40,40
1649974738497,COGS 172,A01,083984,Provenzano; Emily Kara,15,0,30,15
1649974744523,COGS 177,A00,083368,Staff,0,20,30,30
1649974750545,COGS 186,A01,083986,Staff,21,0,40,19
1649974756577,COGS 187A,A01,083988,Boyle; Mary E. T.,20,0,60,40
1649974762617,CSE 8A,A50,084003,Miranda; Gregory Joseph,0,5,15,15
1649974768651,CSE 11,A01,084005,Miranda; Gregory Joseph,0,11,55,55
1649974774676,CSE 20,A01,084007,Staff,3,0,20,17
1649974780704,CSE 21,A01,084009,Staff,0,18,50,50
1649974786734,CSE 30,A01,083370,Cao; Yingjun,0,54,40,40
1649974792763,CSE 100,A01,083372,Cao; Yingjun,0,43,40,40
1649974798789,CSE 101,A01,084011,Staff,1,55,40,39
1649974804817,CSE 141,A01,083374,Eldon; John,0,58,75,75
1649974810848,CSE 141L,A01,083376,Eldon; John,0,64,75,75
1649974816878,CSE 175,A01,084013,Kumar; Rakesh,22,0,25,3
1649974822901,CSE 190,A00,092508,Dubnov; Shlomo,20,0,20,0
1649974828924,ECE 5,A01,084049,Morris; Karcher William,13,0,20,7
1649974834968,ECE 100,A01,084051,Baghdadchi; Saharnaz,0,0,20,20
1649974834968,ECE 100,A02,091916,Baghdadchi; Saharnaz,15,0,20,5
1649974840998,ECE 101,A01,084053,Baghdadchi; Saharnaz,2,0,37,35
1649974840998,ECE 101,A02,084054,Baghdadchi; Saharnaz,31,0,37,6
1649974847025,ECE 107,A01,083390,Staff,27,0,40,13
1649974853051,ECE 148,A01,084056,Silberman; Jack,8,0,12,4
1649974859078,ECE 180,A00,083391,Abi Samra; Nicholas Camill,25,0,30,5
1649974859078,ECE 180,B00,083392,Abi Samra; Nicholas Camill,21,0,30,9
1649974865103,MATH 10B,A01,084110,Staff,3,0,30,27
1649974865103,MATH 10B,A02,084111,Staff,27,0,30,3
1649974865103,MATH 10B,A03,084112,Staff,26,0,30,4
1649974871130,MATH 10C,A01,083443,Staff,0,0,30,30
1649974871130,MATH 10C,A02,083444,Staff,0,1,30,30
1649974871130,MATH 10C,B01,084114,Staff,23,0,30,7
1649974871130,MATH 10C,B02,084115,Staff,28,0,30,2
1649974877161,MATH 18,A01,084117,Harel; Guershon,23,0,30,7
1649974877161,MATH 18,A02,084119,Harel; Guershon,28,0,30,2
1649974877161,MATH 18,A03,084120,Harel; Guershon,30,0,30,0
1649974877161,MATH 18,A04,084121,Harel; Guershon,29,0,30,1
1649974883287,MATH 20B,A01,084124,Um; Ko Woon,30,0,35,5
1649974883287,MATH 20B,B01,084126,Um; Ko Woon,28,0,35,7
1649974889318,MATH 20C,A01,083446,Hammock; Frances H,10,0,30,20
1649974889318,MATH 20C,A02,083447,Hammock; Frances H,26,0,30,4
1649974889318,MATH 20C,A03,083448,Hammock; Frances H,28,0,30,2
1649974889318,MATH 20C,A04,083449,Hammock; Frances H,30,0,30,0
1649974889318,MATH 20C,B01,083451,Hammock; Frances H,16,0,30,14
1649974889318,MATH 20C,B02,083452,Hammock; Frances H,25,0,30,5
1649974889318,MATH 20C,B03,083453,Hammock; Frances H,25,0,30,5
1649974889318,MATH 20C,B04,083454,Hammock; Frances H,28,0,30,2
1649974895353,MATH 20D,A01,084128,Staff,20,0,30,10
1649974895353,MATH 20D,A02,084129,Staff,30,0,30,0
1649974895353,MATH 20D,A03,084130,Staff,27,0,30,3
1649974895353,MATH 20D,B01,084133,Staff,9,0,30,21
1649974895353,MATH 20D,B02,084134,Staff,24,0,30,6
1649974895353,MATH 20D,B03,084135,Staff,29,0,30,1
1649974901383,MATH 20E,A01,084138,Staff,17,0,30,13
1649974901383,MATH 20E,A02,084139,Staff,11,0,30,19
1649974901383,MATH 20E,A03,084140,Staff,16,0,30,14
1649974901383,MATH 20E,A04,084141,Staff,22,0,30,8
1649974907413,MATH 102,A01,084143,Harel; Guershon,14,0,30,16
1649974907413,MATH 102,A02,084144,Harel; Guershon,21,0,30,9
1649974913449,MATH 103B,A01,083456,Staff,0,12,30,30
1649974913449,MATH 103B,A02,083457,Staff,0,12,30,30
1649974919476,MATH 109,A01,084146,Salehi Golsefidy; Alireza,20,0,30,10
1649974919476,MATH 109,A02,084147,Salehi Golsefidy; Alireza,18,0,30,12
1649974925502,MATH 120A,A01,085445,Eggers; John Dietrich,17,0,35,18
1649974925502,MATH 120A,A02,085446,Eggers; John Dietrich,27,0,35,8
1649974931530,MATH 142B,A01,084149,Verstraete; Jacques Allan,0,12,30,30
1649974931530,MATH 142B,A02,084150,Verstraete; Jacques Allan,0,12,30,30
1649974937553,MATH 170A,A01,083459,Nie; Jiawang,1,7,30,29
1649974937553,MATH 170A,A02,083460,Nie; Jiawang,0,6,30,30
1649974937553,MATH 170A,A03,083461,Nie; Jiawang,0,7,30,30
1649974943579,MATH 193B,A01,083463,Staff,1,0,30,29
1649974943579,MATH 193B,A02,083464,Staff,10,0,30,20
1649974943579,MATH 193B,A03,083465,Staff,18,0,30,12
1649974949645,COGS 2,A01,083966,Boyle; Mary E. T.,13,0,30,17
1649974955671,COGS 9,A01,083968,Staff,20,0,60,40
1649974961697,COGS 14B,A01,083970,Staff,15,0,50,35
1649974967724,COGS 17,A01,092679,Staff,56,0,75,19
1649974973751,COGS 100,A01,083972,Staff,0,11,60,60
1649974985809,COGS 101C,A01,083976,Staff,15,0,30,15
1649974991833,COGS 102A,A01,083978,Johnson; Christine M.,14,0,30,16
1649974997857,COGS 107B,A01,083980,Staff,0,5,50,50
1649975003893,COGS 115,A01,083982,Staff,11,0,30,19
1649975009917,COGS 118B,A01,083367,Staff,0,12,40,40
1649975015938,COGS 172,A01,083984,Provenzano; Emily Kara,15,0,30,15
1649975021966,COGS 177,A00,083368,Staff,0,20,30,30
1649975027999,COGS 186,A01,083986,Staff,21,0,40,19
1649975034023,COGS 187A,A01,083988,Boyle; Mary E. T.,20,0,60,40
1649975040052,CSE 8A,A50,084003,Miranda; Gregory Joseph,0,5,15,15
1649975046088,CSE 11,A01,084005,Miranda; Gregory Joseph,0,13,55,55
1649975052110,CSE 20,A01,084007,Staff,3,0,20,17
1649975058142,CSE 21,A01,084009,Staff,0,18,50,50
1649975064170,CSE 30,A01,083370,Cao; Yingjun,0,54,40,40
1649975070215,CSE 100,A01,083372,Cao; Yingjun,0,43,40,40
1649975076237,CSE 101,A01,084011,Staff,1,55,40,39
1649975082268,CSE 141,A01,083374,Eldon; John,0,58,75,75
1649975088299,CSE 141L,A01,083376,Eldon; John,0,64,75,75
1649975094325,CSE 175,A01,084013,Kumar; Rakesh,22,0,25,3
1649975100355,CSE 190,A00,092508,Dubnov; Shlomo,20,0,20,0
1649975106377,ECE 5,A01,084049,Morris; Karcher William,13,0,20,7
1649975112400,ECE 100,A01,084051,Baghdadchi; Saharnaz,0,0,20,20
1649975112400,ECE 100,A02,091916,Baghdadchi; Saharnaz,15,0,20,5
1649975118424,ECE 101,A01,084053,Baghdadchi; Saharnaz,2,0,37,35
1649975118424,ECE 101,A02,084054,Baghdadchi; Saharnaz,31,0,37,6
1649975124447,ECE 107,A01,083390,Staff,27,0,40,13
1649975130470,ECE 148,A01,084056,Silberman; Jack,8,0,12,4
1649975136505,ECE 180,A00,083391,Abi Samra; Nicholas Camill,25,0,30,5
1649975136505,ECE 180,B00,083392,Abi Samra; Nicholas Camill,21,0,30,9
1649975142556,MATH 10B,A01,084110,Staff,3,0,30,27
1649975142556,MATH 10B,A02,084111,Staff,27,0,30,3
1649975142556,MATH 10B,A03,084112,Staff,26,0,30,4
1649975148594,MATH 10C,A01,083443,Staff,0,1,30,30
1649975148594,MATH 10C,A02,083444,Staff,0,1,30,30
1649975148594,MATH 10C,B01,084114,Staff,22,0,30,8
1649975148594,MATH 10C,B02,084115,Staff,28,0,30,2
1649975154618,MATH 18,A01,084117,Harel; Guershon,23,0,30,7
1649975154618,MATH 18,A02,084119,Harel; Guershon,28,0,30,2
1649975154618,MATH 18,A03,084120,Harel; Guershon,30,0,30,0
1649975154618,MATH 18,A04,084121,Harel; Guershon,29,0,30,1
1649975160656,MATH 20B,A01,084124,Um; Ko Woon,30,0,35,5
1649975160656,MATH 20B,B01,084126,Um; Ko Woon,28,0,35,7
1649975166682,MATH 20C,A01,083446,Hammock; Frances H,10,0,30,20
1649975166682,MATH 20C,A02,083447,Hammock; Frances H,26,0,30,4
1649975166682,MATH 20C,A03,083448,Hammock; Frances H,28,0,30,2
1649975166682,MATH 20C,A04,083449,Hammock; Frances H,30,0,30,0
1649975166682,MATH 20C,B01,083451,Hammock; Frances H,16,0,30,14
1649975166682,MATH 20C,B02,083452,Hammock; Frances H,25,0,30,5
1649975166682,MATH 20C,B03,083453,Hammock; Frances H,25,0,30,5
1649975166682,MATH 20C,B04,083454,Hammock; Frances H,28,0,30,2
1649975172705,MATH 20D,A01,084128,Staff,20,0,30,10
1649975172705,MATH 20D,A02,084129,Staff,30,0,30,0
1649975172705,MATH 20D,A03,084130,Staff,27,0,30,3
1649975172705,MATH 20D,B01,084133,Staff,9,0,30,21
1649975172705,MATH 20D,B02,084134,Staff,24,0,30,6
1649975172705,MATH 20D,B03,084135,Staff,29,0,30,1
1649975178739,MATH 20E,A01,084138,Staff,17,0,30,13
1649975178739,MATH 20E,A02,084139,Staff,10,0,30,20
1649975178739,MATH 20E,A03,084140,Staff,16,0,30,14
1649975178739,MATH 20E,A04,084141,Staff,22,0,30,8
1649975184779,MATH 102,A01,084143,Harel; Guershon,14,0,30,16
1649975184779,MATH 102,A02,084144,Harel; Guershon,21,0,30,9
1649975190802,MATH 103B,A01,083456,Staff,0,12,30,30
1649975190802,MATH 103B,A02,083457,Staff,0,12,30,30
1649975196829,MATH 109,A01,084146,Salehi Golsefidy; Alireza,20,0,30,10
1649975196829,MATH 109,A02,084147,Salehi Golsefidy; Alireza,18,0,30,12
1649975202857,MATH 120A,A01,085445,Eggers; John Dietrich,17,0,35,18
1649975202857,MATH 120A,A02,085446,Eggers; John Dietrich,27,0,35,8
1649975208879,MATH 142B,A01,084149,Verstraete; Jacques Allan,0,12,30,30
1649975208879,MATH 142B,A02,084150,Verstraete; Jacques Allan,0,12,30,30
1649975214902,MATH 170A,A01,083459,Nie; Jiawang,1,7,30,29
1649975214902,MATH 170A,A02,083460,Nie; Jiawang,0,6,30,30
1649975214902,MATH 170A,A03,083461,Nie; Jiawang,0,7,30,30
1649975220942,MATH 193B,A01,083463,Staff,1,0,30,29
1649975220942,MATH 193B,A02,083464,Staff,10,0,30,20
1649975220942,MATH 193B,A03,083465,Staff,18,0,30,12
1649975227004,COGS 2,A01,083966,Boyle; Mary E. T.,13,0,30,17
1649975233030,COGS 9,A01,083968,Staff,20,0,60,40
1649975239060,COGS 14B,A01,083970,Staff,14,0,50,36
1649975245097,COGS 17,A01,092679,Staff,56,0,75,19
1649975251119,COGS 100,A01,083972,Staff,0,11,60,60
1649975263178,COGS 101C,A01,083976,Staff,14,0,30,16
1649975269204,COGS 102A,A01,083978,Johnson; Christine M.,14,0,30,16
1649975275227,COGS 107B,A01,083980,Staff,0,5,50,50
1649975281250,COGS 115,A01,083982,Staff,11,0,30,19
1649975287275,COGS 118B,A01,083367,Staff,0,12,40,40
1649975293301,COGS 172,A01,083984,Provenzano; Emily Kara,15,0,30,15
1649975299324,COGS 177,A00,083368,Staff,0,20,30,30
1649975305357,COGS 186,A01,083986,Staff,21,0,40,19
1649975311382,COGS 187A,A01,083988,Boyle; Mary E. T.,20,0,60,40
1649975317407,CSE 8A,A50,084003,Miranda; Gregory Joseph,0,5,15,15
1649975323435,CSE 11,A01,084005,Miranda; Gregory Joseph,0,13,55,55
1649975329459,CSE 20,A01,084007,Staff,3,0,20,17
1649975335499,CSE 21,A01,084009,Staff,0,18,50,50
1649975341523,CSE 30,A01,083370,Cao; Yingjun,0,54,40,40
1649975347555,CSE 100,A01,083372,Cao; Yingjun,0,43,40,40
1649975353578,CSE 101,A01,084011,Staff,1,55,40,39
1649975359606,CSE 141,A01,083374,Eldon; John,0,58,75,75
1649975365629,CSE 141L,A01,083376,Eldon; John,0,64,75,75
1649975371666,CSE 175,A01,084013,Kumar; Rakesh,22,0,25,3
1649975377703,CSE 190,A00,092508,Dubnov; Shlomo,20,0,20,0
1649975383727,ECE 5,A01,084049,Morris; Karcher William,13,0,20,7
1649975389752,ECE 100,A01,084051,Baghdadchi; Saharnaz,0,0,20,20
1649975389752,ECE 100,A02,091916,Baghdadchi; Saharnaz,15,0,20,5
1649975395781,ECE 101,A01,084053,Baghdadchi; Saharnaz,2,0,37,35
1649975395781,ECE 101,A02,084054,Baghdadchi; Saharnaz,31,0,37,6
1649975401811,ECE 107,A01,083390,Staff,27,0,40,13
1649975407836,ECE 148,A01,084056,Silberman; Jack,8,0,12,4
1649975413866,ECE 180,A00,083391,Abi Samra; Nicholas Camill,25,0,30,5
1649975413866,ECE 180,B00,083392,Abi Samra; Nicholas Camill,21,0,30,9
1649975419889,MATH 10B,A01,084110,Staff,3,0,30,27
1649975419889,MATH 10B,A02,084111,Staff,27,0,30,3
1649975419889,MATH 10B,A03,084112,Staff,26,0,30,4
1649975425914,MATH 10C,A01,083443,Staff,0,1,30,30
1649975425914,MATH 10C,A02,083444,Staff,0,1,30,30
1649975425914,MATH 10C,B01,084114,Staff,22,0,30,8
1649975425914,MATH 10C,B02,084115,Staff,28,0,30,2
1649975431941,MATH 18,A01,084117,Harel; Guershon,23,0,30,7
1649975431941,MATH 18,A02,084119,Harel; Guershon,28,0,30,2
1649975431941,MATH 18,A03,084120,Harel; Guershon,30,0,30,0
1649975431941,MATH 18,A04,084121,Harel; Guershon,29,0,30,1
1649975437993,MATH 20B,A01,084124,Um; Ko Woon,30,0,35,5
1649975437993,MATH 20B,B01,084126,Um; Ko Woon,28,0,35,7
1649975444026,MATH 20C,A01,083446,Hammock; Frances H,10,0,30,20
1649975444026,MATH 20C,A02,083447,Hammock; Frances H,26,0,30,4
1649975444026,MATH 20C,A03,083448,Hammock; Frances H,28,0,30,2
1649975444026,MATH 20C,A04,083449,Hammock; Frances H,30,0,30,0
1649975444026,MATH 20C,B01,083451,Hammock; Frances H,16,0,30,14
1649975444026,MATH 20C,B02,083452,Hammock; Frances H,25,0,30,5
1649975444026,MATH 20C,B03,083453,Hammock; Frances H,25,0,30,5
1649975444026,MATH 20C,B04,083454,Hammock; Frances H,28,0,30,2
1649975450049,MATH 20D,A01,084128,Staff,20,0,30,10
1649975450049,MATH 20D,A02,084129,Staff,30,0,30,0
1649975450049,MATH 20D,A03,084130,Staff,27,0,30,3
1649975450049,MATH 20D,B01,084133,Staff,9,0,30,21
1649975450049,MATH 20D,B02,084134,Staff,24,0,30,6
1649975450049,MATH 20D,B03,084135,Staff,28,0,30,2
1649975456076,MATH 20E,A01,084138,Staff,17,0,30,13
1649975456076,MATH 20E,A02,084139,Staff,10,0,30,20
1649975456076,MATH 20E,A03,084140,Staff,16,0,30,14
1649975456076,MATH 20E,A04,084141,Staff,22,0,30,8
1649975462106,MATH 102,A01,084143,Harel; Guershon,14,0,30,16
1649975462106,MATH 102,A02,084144,Harel; Guershon,21,0,30,9
1649975468128,MATH 103B,A01,083456,Staff,0,12,30,30
1649975468128,MATH 103B,A02,083457,Staff,0,12,30,30
1649975474152,MATH 109,A01,084146,Salehi Golsefidy; Alireza,19,0,30,11
1649975474152,MATH 109,A02,084147,Salehi Golsefidy; Alireza,18,0,30,12
1649975480256,MATH 120A,A01,085445,Eggers; John Dietrich,17,0,35,18
1649975480256,MATH 120A,A02,085446,Eggers; John Dietrich,27,0,35,8
1649975486286,MATH 142B,A01,084149,Verstraete; Jacques Allan,0,12,30,30
1649975486286,MATH 142B,A02,084150,Verstraete; Jacques Allan,0,12,30,30
1649975492310,MATH 170A,A01,083459,Nie; Jiawang,1,7,30,29
1649975492310,MATH 170A,A02,083460,Nie; Jiawang,0,6,30,30
1649975492310,MATH 170A,A03,083461,Nie; Jiawang,0,7,30,30
1649975498345,MATH 193B,A01,083463,Staff,1,0,30,29
1649975498345,MATH 193B,A02,083464,Staff,10,0,30,20
1649975498345,MATH 193B,A03,083465,Staff,18,0,30,12
1649975504423,COGS 2,A01,083966,Boyle; Mary E. T.,13,0,30,17
1649975510444,COGS 9,A01,083968,Staff,20,0,60,40
1649975516473,COGS 14B,A01,083970,Staff,14,0,50,36
1649975522495,COGS 17,A01,092679,Staff,56,0,75,19
1649975528524,COGS 100,A01,083972,Staff,0,11,60,60
1649975540578,COGS 101C,A01,083976,Staff,14,0,30,16
1649975546611,COGS 102A,A01,083978,Johnson; Christine M.,14,0,30,16
1649975552633,COGS 107B,A01,083980,Staff,0,6,50,50
1649975558660,COGS 115,A01,083982,Staff,11,0,30,19
1649975564695,COGS 118B,A01,083367,Staff,0,12,40,40
1649975570722,COGS 172,A01,083984,Provenzano; Emily Kara,15,0,30,15
1649975576751,COGS 177,A00,083368,Staff,0,20,30,30
1649975582786,COGS 186,A01,083986,Staff,21,0,40,19
1649975588809,COGS 187A,A01,083988,Boyle; Mary E. T.,20,0,60,40
1649975594839,CSE 8A,A50,084003,Miranda; Gregory Joseph,0,5,15,15
1649975600861,CSE 11,A01,084005,Miranda; Gregory Joseph,0,13,55,55
1649975606886,CSE 20,A01,084007,Staff,3,0,20,17
1649975612917,CSE 21,A01,084009,Staff,0,18,50,50
1649975618952,CSE 30,A01,083370,Cao; Yingjun,0,54,40,40
1649975624976,CSE 100,A01,083372,Cao; Yingjun,0,43,40,40
1649975631004,CSE 101,A01,084011,Staff,1,55,40,39
1649975637027,CSE 141,A01,083374,Eldon; John,0,58,75,75
1649975643055,CSE 141L,A01,083376,Eldon; John,0,64,75,75
1649975649078,CSE 175,A01,084013,Kumar; Rakesh,22,0,25,3
1649975655100,CSE 190,A00,092508,Dubnov; Shlomo,20,0,20,0
1649975661126,ECE 5,A01,084049,Morris; Karcher William,13,0,20,7
1649975667153,ECE 100,A01,084051,Baghdadchi; Saharnaz,0,0,20,20
1649975667153,ECE 100,A02,091916,Baghdadchi; Saharnaz,15,0,20,5
1649975673179,ECE 101,A01,084053,Baghdadchi; Saharnaz,2,0,37,35
1649975673179,ECE 101,A02,084054,Baghdadchi; Saharnaz,31,0,37,6
1649975679222,ECE 107,A01,083390,Staff,27,0,40,13
1649975685243,ECE 148,A01,084056,Silberman; Jack,8,0,12,4
1649975691266,ECE 180,A00,083391,Abi Samra; Nicholas Camill,25,0,30,5
1649975691266,ECE 180,B00,083392,Abi Samra; Nicholas Camill,21,0,30,9
1649975697298,MATH 10B,A01,084110,Staff,3,0,30,27
1649975697298,MATH 10B,A02,084111,Staff,27,0,30,3
1649975697298,MATH 10B,A03,084112,Staff,26,0,30,4
1649975703324,MATH 10C,A01,083443,Staff,0,1,30,30
1649975703324,MATH 10C,A02,083444,Staff,0,2,30,30
1649975703324,MATH 10C,B01,084114,Staff,22,0,30,8
1649975703324,MATH 10C,B02,084115,Staff,28,0,30,2
1649975709359,MATH 18,A01,084117,Harel; Guershon,23,0,30,7
1649975709359,MATH 18,A02,084119,Harel; Guershon,28,0,30,2
1649975709359,MATH 18,A03,084120,Harel; Guershon,30,0,30,0
1649975709359,MATH 18,A04,084121,Harel; Guershon,29,0,30,1
1649975715381,MATH 20B,A01,084124,Um; Ko Woon,30,0,35,5
1649975715381,MATH 20B,B01,084126,Um; Ko Woon,28,0,35,7
1649975721405,MATH 20C,A01,083446,Hammock; Frances H,10,0,30,20
1649975721405,MATH 20C,A02,083447,Hammock; Frances H,26,0,30,4
1649975721405,MATH 20C,A03,083448,Hammock; Frances H,28,0,30,2
1649975721405,MATH 20C,A04,083449,Hammock; Frances H,29,0,30,1
1649975721405,MATH 20C,B01,083451,Hammock; Frances H,16,0,30,14
1649975721405,MATH 20C,B02,083452,Hammock; Frances H,25,0,30,5
1649975721405,MATH 20C,B03,083453,Hammock; Frances H,25,0,30,5
1649975721405,MATH 20C,B04,083454,Hammock; Frances H,28,0,30,2
1649975727429,MATH 20D,A01,084128,Staff,19,0,30,11
1649975727429,MATH 20D,A02,084129,Staff,30,0,30,0
1649975727429,MATH 20D,A03,084130,Staff,27,0,30,3
1649975727429,MATH 20D,B01,084133,Staff,9,0,30,21
1649975727429,MATH 20D,B02,084134,Staff,24,0,30,6
1649975727429,MATH 20D,B03,084135,Staff,28,0,30,2
1649975733453,MATH 20E,A01,084138,Staff,16,0,30,14
1649975733453,MATH 20E,A02,084139,Staff,10,0,30,20
1649975733453,MATH 20E,A03,084140,Staff,16,0,30,14
1649975733453,MATH 20E,A04,084141,Staff,21,0,30,9
1649975739481,MATH 102,A01,084143,Harel; Guershon,14,0,30,16
1649975739481,MATH 102,A02,084144,Harel; Guershon,21,0,30,9
1649975745515,MATH 103B,A01,083456,Staff,0,12,30,30
1649975745515,MATH 103B,A02,083457,Staff,0,12,30,30
1649975751544,MATH 109,A01,084146,Salehi Golsefidy; Alireza,19,0,30,11
1649975751544,MATH 109,A02,084147,Salehi Golsefidy; Alireza,18,0,30,12
1649975757572,MATH 120A,A01,085445,Eggers; John Dietrich,17,0,35,18
1649975757572,MATH 120A,A02,085446,Eggers; John Dietrich,27,0,35,8
1649975763602,MATH 142B,A01,084149,Verstraete; Jacques Allan,0,12,30,30
1649975763602,MATH 142B,A02,084150,Verstraete; Jacques Allan,0,12,30,30
1649975769626,MATH 170A,A01,083459,Nie; Jiawang,1,7,30,29
1649975769626,MATH 170A,A02,083460,Nie; Jiawang,0,6,30,30
1649975769626,MATH 170A,A03,083461,Nie; Jiawang,0,7,30,30
1649975775649,MATH 193B,A01,083463,Staff,1,0,30,29
1649975775649,MATH 193B,A02,083464,Staff,10,0,30,20
1649975775649,MATH 193B,A03,083465,Staff,18,0,30,12
1649975781710,COGS 2,A01,083966,Boyle; Mary E. T.,13,0,30,17
1649975787743,COGS 9,A01,083968,Staff,20,0,60,40
1649975793767,COGS 14B,A01,083970,Staff,15,0,50,35
1649975799790,COGS 17,A01,092679,Staff,56,0,75,19
1649975805814,COGS 100,A01,083972,Staff,0,11,60,60
1649975817863,COGS 101C,A01,083976,Staff,13,0,30,17
1649975823893,COGS 102A,A01,083978,Johnson; Christine M.,14,0,30,16
1649975829920,COGS 107B,A01,083980,Staff,0,6,50,50
1649975835944,COGS 115,A01,083982,Staff,11,0,30,19
1649975841970,COGS 118B,A01,083367,Staff,0,12,40,40
1649975848005,COGS 172,A01,083984,Provenzano; Emily Kara,15,0,30,15
1649975854031,COGS 177,A00,083368,Staff,0,20,30,30
1649975860073,COGS 186,A01,083986,Staff,21,0,40,19
1649975866103,COGS 187A,A01,083988,Boyle; Mary E. T.,20,0,60,40
1649975872129,CSE 8A,A50,084003,Miranda; Gregory Joseph,0,5,15,15
1649975878157,CSE 11,A01,084005,Miranda; Gregory Joseph,0,13,55,55
1649975884179,CSE 20,A01,084007,Staff,3,0,20,17
1649975890202,CSE 21,A01,084009,Staff,0,18,50,50
1649975896236,CSE 30,A01,083370,Cao; Yingjun,0,54,40,40
1649975902262,CSE 100,A01,083372,Cao; Yingjun,0,43,40,40
1649975908297,CSE 101,A01,084011,Staff,1,55,40,39
1649975914321,CSE 141,A01,083374,Eldon; John,0,58,75,75
1649975920345,CSE 141L,A01,083376,Eldon; John,0,64,75,75
1649975926398,CSE 175,A01,084013,Kumar; Rakesh,22,0,25,3
1649975932427,CSE 190,A00,092508,Dubnov; Shlomo,20,0,20,0
1649975938448,ECE 5,A01,084049,Morris; Karcher William,13,0,20,7
1649975944470,ECE 100,A01,084051,Baghdadchi; Saharnaz,0,0,20,20
1649975944470,ECE 100,A02,091916,Baghdadchi; Saharnaz,15,0,20,5
1649975950495,ECE 101,A01,084053,Baghdadchi; Saharnaz,2,0,37,35
1649975950495,ECE 101,A02,084054,Baghdadchi; Saharnaz,31,0,37,6
1649975956521,ECE 107,A01,083390,Staff,27,0,40,13
1649975962546,ECE 148,A01,084056,Silberman; Jack,8,0,12,4
1649975968580,ECE 180,A00,083391,Abi Samra; Nicholas Camill,25,0,30,5
1649975968580,ECE 180,B00,083392,Abi Samra; Nicholas Camill,21,0,30,9
1649975974609,MATH 10B,A01,084110,Staff,3,0,30,27
1649975974609,MATH 10B,A02,084111,Staff,27,0,30,3
1649975974609,MATH 10B,A03,084112,Staff,26,0,30,4
1649975980632,MATH 10C,A01,083443,Staff,0,1,30,30
1649975980632,MATH 10C,A02,083444,Staff,0,2,30,30
1649975980632,MATH 10C,B01,084114,Staff,22,0,30,8
1649975980632,MATH 10C,B02,084115,Staff,28,0,30,2
1649975986666,MATH 18,A01,084117,Harel; Guershon,23,0,30,7
1649975986666,MATH 18,A02,084119,Harel; Guershon,28,0,30,2
1649975986666,MATH 18,A03,084120,Harel; Guershon,30,0,30,0
1649975986666,MATH 18,A04,084121,Harel; Guershon,29,0,30,1
1649975992715,MATH 20B,A01,084124,Um; Ko Woon,30,0,35,5
1649975992715,MATH 20B,B01,084126,Um; Ko Woon,28,0,35,7
1649975998748,MATH 20C,A01,083446,Hammock; Frances H,10,0,30,20
1649975998748,MATH 20C,A02,083447,Hammock; Frances H,26,0,30,4
1649975998748,MATH 20C,A03,083448,Hammock; Frances H,28,0,30,2
1649975998748,MATH 20C,A04,083449,Hammock; Frances H,29,0,30,1
1649975998748,MATH 20C,B01,083451,Hammock; Frances H,16,0,30,14
1649975998748,MATH 20C,B02,083452,Hammock; Frances H,25,0,30,5
1649975998748,MATH 20C,B03,083453,Hammock; Frances H,25,0,30,5
1649975998748,MATH 20C,B04,083454,Hammock; Frances H,28,0,30,2
1649976004785,MATH 20D,A01,084128,Staff,19,0,30,11
1649976004785,MATH 20D,A02,084129,Staff,30,0,30,0
1649976004785,MATH 20D,A03,084130,Staff,27,0,30,3
1649976004785,MATH 20D,B01,084133,Staff,9,0,30,21
1649976004785,MATH 20D,B02,084134,Staff,24,0,30,6
1649976004785,MATH 20D,B03,084135,Staff,28,0,30,2
1649976010813,MATH 20E,A01,084138,Staff,16,0,30,14
1649976010813,MATH 20E,A02,084139,Staff,10,0,30,20
1649976010813,MATH 20E,A03,084140,Staff,16,0,30,14
1649976010813,MATH 20E,A04,084141,Staff,21,0,30,9
1649976016853,MATH 102,A01,084143,Harel; Guershon,14,0,30,16
1649976016853,MATH 102,A02,084144,Harel; Guershon,21,0,30,9
1649976022880,MATH 103B,A01,083456,Staff,0,12,30,30
1649976022880,MATH 103B,A02,083457,Staff,0,12,30,30
1649976028911,MATH 109,A01,084146,Salehi Golsefidy; Alireza,19,0,30,11
1649976028911,MATH 109,A02,084147,Salehi Golsefidy; Alireza,18,0,30,12
1649976034942,MATH 120A,A01,085445,Eggers; John Dietrich,16,0,35,19
1649976034942,MATH 120A,A02,085446,Eggers; John Dietrich,27,0,35,8
1649976040975,MATH 142B,A01,084149,Verstraete; Jacques Allan,0,12,30,30
1649976040975,MATH 142B,A02,084150,Verstraete; Jacques Allan,0,12,30,30
1649976047005,MATH 170A,A01,083459,Nie; Jiawang,1,7,30,29
1649976047005,MATH 170A,A02,083460,Nie; Jiawang,0,6,30,30
1649976047005,MATH 170A,A03,083461,Nie; Jiawang,0,7,30,30
1649976053029,MATH 193B,A01,083463,Staff,1,0,30,29
1649976053029,MATH 193B,A02,083464,Staff,10,0,30,20
1649976053029,MATH 193B,A03,083465,Staff,18,0,30,12
1649976059098,COGS 2,A01,083966,Boyle; Mary E. T.,13,0,30,17
1649976065121,COGS 9,A01,083968,Staff,20,0,60,40
1649976071262,COGS 14B,A01,083970,Staff,15,0,50,35
1649976077303,COGS 17,A01,092679,Staff,56,0,75,19
1649976083329,COGS 100,A01,083972,Staff,0,11,60,60
1649976095393,COGS 101C,A01,083976,Staff,13,0,30,17
1649976101419,COGS 102A,A01,083978,Johnson; Christine M.,14,0,30,16
1649976107451,COGS 107B,A01,083980,Staff,0,6,50,50
1649976113473,COGS 115,A01,083982,Staff,11,0,30,19
1649976119511,COGS 118B,A01,083367,Staff,0,12,40,40
1649976125559,COGS 172,A01,083984,Provenzano; Emily Kara,15,0,30,15
1649976131583,COGS 177,A00,083368,Staff,0,20,30,30
1649976137614,COGS 186,A01,083986,Staff,21,0,40,19
1649976143642,COGS 187A,A01,083988,Boyle; Mary E. T.,20,0,60,40
1649976149669,CSE 8A,A50,084003,Miranda; Gregory Joseph,0,5,15,15
1649976155692,CSE 11,A01,084005,Miranda; Gregory Joseph,0,13,55,55
1649976161715,CSE 20,A01,084007,Staff,3,0,20,17
1649976167758,CSE 21,A01,084009,Staff,0,18,50,50
1649976173791,CSE 30,A01,083370,Cao; Yingjun,0,54,40,40
1649976179818,CSE 100,A01,083372,Cao; Yingjun,0,43,40,40
1649976185840,CSE 101,A01,084011,Staff,1,55,40,39
1649976191875,CSE 141,A01,083374,Eldon; John,0,58,75,75
1649976197897,CSE 141L,A01,083376,Eldon; John,0,64,75,75
1649976203921,CSE 175,A01,084013,Kumar; Rakesh,22,0,25,3
1649976209944,CSE 190,A00,092508,Dubnov; Shlomo,20,0,20,0
1649976215966,ECE 5,A01,084049,Morris; Karcher William,13,0,20,7
1649976222000,ECE 100,A01,084051,Baghdadchi; Saharnaz,0,0,20,20
1649976222000,ECE 100,A02,091916,Baghdadchi; Saharnaz,15,0,20,5
1649976228033,ECE 101,A01,084053,Baghdadchi; Saharnaz,2,0,37,35
1649976228033,ECE 101,A02,084054,Baghdadchi; Saharnaz,31,0,37,6
1649976234055,ECE 107,A01,083390,Staff,27,0,40,13
1649976240081,ECE 148,A01,084056,Silberman; Jack,8,0,12,4
1649976246111,ECE 180,A00,083391,Abi Samra; Nicholas Camill,25,0,30,5
1649976246111,ECE 180,B00,083392,Abi Samra; Nicholas Camill,21,0,30,9
1649976252152,MATH 10B,A01,084110,Staff,3,0,30,27
1649976252152,MATH 10B,A02,084111,Staff,27,0,30,3
1649976252152,MATH 10B,A03,084112,Staff,26,0,30,4
1649976258184,MATH 10C,A01,083443,Staff,0,1,30,30
1649976258184,MATH 10C,A02,083444,Staff,0,2,30,30
1649976258184,MATH 10C,B01,084114,Staff,22,0,30,8
1649976258184,MATH 10C,B02,084115,Staff,28,0,30,2
1649976264208,MATH 18,A01,084117,Harel; Guershon,23,0,30,7
1649976264208,MATH 18,A02,084119,Harel; Guershon,28,0,30,2
1649976264208,MATH 18,A03,084120,Harel; Guershon,30,0,30,0
1649976264208,MATH 18,A04,084121,Harel; Guershon,29,0,30,1
1649976270238,MATH 20B,A01,084124,Um; Ko Woon,29,0,35,6
1649976270238,MATH 20B,B01,084126,Um; Ko Woon,28,0,35,7
1649976276266,MATH 20C,A01,083446,Hammock; Frances H,10,0,30,20
1649976276266,MATH 20C,A02,083447,Hammock; Frances H,26,0,30,4
1649976276266,MATH 20C,A03,083448,Hammock; Frances H,27,0,30,3
1649976276266,MATH 20C,A04,083449,Hammock; Frances H,29,0,30,1
1649976276266,MATH 20C,B01,083451,Hammock; Frances H,16,0,30,14
1649976276266,MATH 20C,B02,083452,Hammock; Frances H,25,0,30,5
1649976276266,MATH 20C,B03,083453,Hammock; Frances H,25,0,30,5
1649976276266,MATH 20C,B04,083454,Hammock; Frances H,28,0,30,2
1649976282305,MATH 20D,A01,084128,Staff,19,0,30,11
1649976282305,MATH 20D,A02,084129,Staff,30,0,30,0
1649976282305,MATH 20D,A03,084130,Staff,27,0,30,3
1649976282305,MATH 20D,B01,084133,Staff,8,0,30,22
1649976282305,MATH 20D,B02,084134,Staff,24,0,30,6
1649976282305,MATH 20D,B03,084135,Staff,28,0,30,2
1649976288327,MATH 20E,A01,084138,Staff,16,0,30,14
1649976288327,MATH 20E,A02,084139,Staff,10,0,30,20
1649976288327,MATH 20E,A03,084140,Staff,16,0,30,14
1649976288327,MATH 20E,A04,084141,Staff,21,0,30,9
1649976294348,MATH 102,A01,084143,Harel; Guershon,14,0,30,16
1649976294348,MATH 102,A02,084144,Harel; Guershon,21,0,30,9
1649976300376,MATH 103B,A01,083456,Staff,0,12,30,30
1649976300376,MATH 103B,A02,083457,Staff,0,12,30,30
1649976306398,MATH 109,A01,084146,Salehi Golsefidy; Alireza,18,0,30,12
1649976306398,MATH 109,A02,084147,Salehi Golsefidy; Alireza,18,0,30,12
1649976312433,MATH 120A,A01,085445,Eggers; John Dietrich,16,0,35,19
1649976312433,MATH 120A,A02,085446,Eggers; John Dietrich,27,0,35,8
1649976318457,MATH 142B,A01,084149,Verstraete; Jacques Allan,0,12,30,30
1649976318457,MATH 142B,A02,084150,Verstraete; Jacques Allan,0,12,30,30
1649976324481,MATH 170A,A01,083459,Nie; Jiawang,1,7,30,29
1649976324481,MATH 170A,A02,083460,Nie; Jiawang,0,6,30,30
1649976324481,MATH 170A,A03,083461,Nie; Jiawang,0,7,30,30
1649976330528,MATH 193B,A01,083463,Staff,1,0,30,29
1649976330528,MATH 193B,A02,083464,Staff,10,0,30,20
1649976330528,MATH 193B,A03,083465,Staff,18,0,30,12
1649976336583,COGS 2,A01,083966,Boyle; Mary E. T.,13,0,30,17
1649976342607,COGS 9,A01,083968,Staff,20,0,60,40
1649976348630,COGS 14B,A01,083970,Staff,15,0,50,35
1649976354659,COGS 17,A01,092679,Staff,56,0,75,19
1649976360682,COGS 100,A01,083972,Staff,0,11,60,60
1649976372730,COGS 101C,A01,083976,Staff,13,0,30,17
1649976378756,COGS 102A,A01,083978,Johnson; Christine M.,14,0,30,16
1649976384779,COGS 107B,A01,083980,Staff,0,6,50,50
1649976390803,COGS 115,A01,083982,Staff,11,0,30,19
1649976396838,COGS 118B,A01,083367,Staff,0,12,40,40
1649976402862,COGS 172,A01,083984,Provenzano; Emily Kara,15,0,30,15
1649976408887,COGS 177,A00,083368,Staff,0,20,30,30
1649976414918,COGS 186,A01,083986,Staff,21,0,40,19
1649976420942,COGS 187A,A01,083988,Boyle; Mary E. T.,20,0,60,40
1649976426969,CSE 8A,A50,084003,Miranda; Gregory Joseph,0,5,15,15
1649976432996,CSE 11,A01,084005,Miranda; Gregory Joseph,0,13,55,55
1649976439023,CSE 20,A01,084007,Staff,3,0,20,17
1649976445049,CSE 21,A01,084009,Staff,0,18,50,50
1649976451072,CSE 30,A01,083370,Cao; Yingjun,0,55,40,40
1649976457095,CSE 100,A01,083372,Cao; Yingjun,0,43,40,40
1649976463118,CSE 101,A01,084011,Staff,1,55,40,39
1649976469149,CSE 141,A01,083374,Eldon; John,0,58,75,75
1649976475175,CSE 141L,A01,083376,Eldon; John,0,64,75,75
1649976481216,CSE 175,A01,084013,Kumar; Rakesh,22,0,25,3
1649976487253,CSE 190,A00,092508,Dubnov; Shlomo,20,0,20,0
1649976493279,ECE 5,A01,084049,Morris; Karcher William,13,0,20,7
1649976499320,ECE 100,A01,084051,Baghdadchi; Saharnaz,0,0,20,20
1649976499320,ECE 100,A02,091916,Baghdadchi; Saharnaz,15,0,20,5
1649976505351,ECE 101,A01,084053,Baghdadchi; Saharnaz,2,0,37,35
1649976505351,ECE 101,A02,084054,Baghdadchi; Saharnaz,31,0,37,6
1649976511378,ECE 107,A01,083390,Staff,27,0,40,13
1649976517402,ECE 148,A01,084056,Silberman; Jack,8,0,12,4
1649976523426,ECE 180,A00,083391,Abi Samra; Nicholas Camill,25,0,30,5
1649976523426,ECE 180,B00,083392,Abi Samra; Nicholas Camill,21,0,30,9
1649976529456,MATH 10B,A01,084110,Staff,3,0,30,27
1649976529456,MATH 10B,A02,084111,Staff,27,0,30,3
1649976529456,MATH 10B,A03,084112,Staff,26,0,30,4
1649976535490,MATH 10C,A01,083443,Staff,0,1,30,30
1649976535490,MATH 10C,A02,083444,Staff,0,2,30,30
1649976535490,MATH 10C,B01,084114,Staff,22,0,30,8
1649976535490,MATH 10C,B02,084115,Staff,28,0,30,2
1649976541517,MATH 18,A01,084117,Harel; Guershon,23,0,30,7
1649976541517,MATH 18,A02,084119,Harel; Guershon,28,0,30,2
1649976541517,MATH 18,A03,084120,Harel; Guershon,30,0,30,0
1649976541517,MATH 18,A04,084121,Harel; Guershon,29,0,30,1
1649976547544,MATH 20B,A01,084124,Um; Ko Woon,29,0,35,6
1649976547544,MATH 20B,B01,084126,Um; Ko Woon,28,0,35,7
1649976553579,MATH 20C,A01,083446,Hammock; Frances H,10,0,30,20
1649976553579,MATH 20C,A02,083447,Hammock; Frances H,26,0,30,4
1649976553579,MATH 20C,A03,083448,Hammock; Frances H,27,0,30,3
1649976553579,MATH 20C,A04,083449,Hammock; Frances H,29,0,30,1
1649976553579,MATH 20C,B01,083451,Hammock; Frances H,15,0,30,15
1649976553579,MATH 20C,B02,083452,Hammock; Frances H,25,0,30,5
1649976553579,MATH 20C,B03,083453,Hammock; Frances H,25,0,30,5
1649976553579,MATH 20C,B04,083454,Hammock; Frances H,28,0,30,2
1649976559607,MATH 20D,A01,084128,Staff,19,0,30,11
1649976559607,MATH 20D,A02,084129,Staff,30,0,30,0
1649976559607,MATH 20D,A03,084130,Staff,27,0,30,3
1649976559607,MATH 20D,B01,084133,Staff,8,0,30,22
1649976559607,MATH 20D,B02,084134,Staff,24,0,30,6
1649976559607,MATH 20D,B03,084135,Staff,28,0,30,2
1649976565637,MATH 20E,A01,084138,Staff,16,0,30,14
1649976565637,MATH 20E,A02,084139,Staff,10,0,30,20
1649976565637,MATH 20E,A03,084140,Staff,16,0,30,14
1649976565637,MATH 20E,A04,084141,Staff,21,0,30,9
1649976571667,MATH 102,A01,084143,Harel; Guershon,14,0,30,16
1649976571667,MATH 102,A02,084144,Harel; Guershon,21,0,30,9
1649976577691,MATH 103B,A01,083456,Staff,0,12,30,30
1649976577691,MATH 103B,A02,083457,Staff,0,12,30,30
1649976583716,MATH 109,A01,084146,Salehi Golsefidy; Alireza,18,0,30,12
1649976583716,MATH 109,A02,084147,Salehi Golsefidy; Alireza,18,0,30,12
1649976589738,MATH 120A,A01,085445,Eggers; John Dietrich,16,0,35,19
1649976589738,MATH 120A,A02,085446,Eggers; John Dietrich,27,0,35,8
1649976595761,MATH 142B,A01,084149,Verstraete; Jacques Allan,0,12,30,30
1649976595761,MATH 142B,A02,084150,Verstraete; Jacques Allan,0,12,30,30
1649976601795,MATH 170A,A01,083459,Nie; Jiawang,1,7,30,29
1649976601795,MATH 170A,A02,083460,Nie; Jiawang,0,6,30,30
1649976601795,MATH 170A,A03,083461,Nie; Jiawang,0,7,30,30
1649976607821,MATH 193B,A01,083463,Staff,1,0,30,29
1649976607821,MATH 193B,A02,083464,Staff,10,0,30,20
1649976607821,MATH 193B,A03,083465,Staff,18,0,30,12
1649976613880,COGS 2,A01,083966,Boyle; Mary E. T.,13,0,30,17
1649976619907,COGS 9,A01,083968,Staff,20,0,60,40
1649976625938,COGS 14B,A01,083970,Staff,15,0,50,35
1649976631965,COGS 17,A01,092679,Staff,56,0,75,19
1649976637995,COGS 100,A01,083972,Staff,0,11,60,60
1649976650055,COGS 101C,A01,083976,Staff,13,0,30,17
1649976656078,COGS 102A,A01,083978,Johnson; Christine M.,14,0,30,16
1649976662115,COGS 107B,A01,083980,Staff,0,6,50,50
1649976668266,COGS 115,A01,083982,Staff,11,0,30,19
1649976674288,COGS 118B,A01,083367,Staff,0,12,40,40
1649976680315,COGS 172,A01,083984,Provenzano; Emily Kara,15,0,30,15
1649976686340,COGS 177,A00,083368,Staff,0,20,30,30
1649976692366,COGS 186,A01,083986,Staff,21,0,40,19
1649976698394,COGS 187A,A01,083988,Boyle; Mary E. T.,20,0,60,40
1649976704430,CSE 8A,A50,084003,Miranda; Gregory Joseph,0,5,15,15
1649976710455,CSE 11,A01,084005,Miranda; Gregory Joseph,0,13,55,55
1649976716488,CSE 20,A01,084007,Staff,3,0,20,17
1649976722528,CSE 21,A01,084009,Staff,0,19,50,50
1649976728554,CSE 30,A01,083370,Cao; Yingjun,0,55,40,40
1649976734579,CSE 100,A01,083372,Cao; Yingjun,0,43,40,40
1649976740609,CSE 101,A01,084011,Staff,1,55,40,39
1649976746635,CSE 141,A01,083374,Eldon; John,0,58,75,75
1649976752658,CSE 141L,A01,083376,Eldon; John,0,64,75,75
1649976758689,CSE 175,A01,084013,Kumar; Rakesh,22,0,25,3
1649976764711,CSE 190,A00,092508,Dubnov; Shlomo,20,0,20,0
1649976770742,ECE 5,A01,084049,Morris; Karcher William,13,0,20,7
1649976776765,ECE 100,A01,084051,Baghdadchi; Saharnaz,0,0,20,20
1649976776765,ECE 100,A02,091916,Baghdadchi; Saharnaz,15,0,20,5
1649976782806,ECE 101,A01,084053,Baghdadchi; Saharnaz,2,0,37,35
1649976782806,ECE 101,A02,084054,Baghdadchi; Saharnaz,31,0,37,6
1649976788834,ECE 107,A01,083390,Staff,27,0,40,13
1649976794858,ECE 148,A01,084056,Silberman; Jack,8,0,12,4
1649976800883,ECE 180,A00,083391,Abi Samra; Nicholas Camill,25,0,30,5
1649976800883,ECE 180,B00,083392,Abi Samra; Nicholas Camill,21,0,30,9
1649976806906,MATH 10B,A01,084110,Staff,3,0,30,27
1649976806906,MATH 10B,A02,084111,Staff,27,0,30,3
1649976806906,MATH 10B,A03,084112,Staff,26,0,30,4
1649976812929,MATH 10C,A01,083443,Staff,0,1,30,30
1649976812929,MATH 10C,A02,083444,Staff,0,2,30,30
1649976812929,MATH 10C,B01,084114,Staff,22,0,30,8
1649976812929,MATH 10C,B02,084115,Staff,28,0,30,2
1649976818957,MATH 18,A01,084117,Harel; Guershon,23,0,30,7
1649976818957,MATH 18,A02,084119,Harel; Guershon,28,0,30,2
1649976818957,MATH 18,A03,084120,Harel; Guershon,30,0,30,0
1649976818957,MATH 18,A04,084121,Harel; Guershon,29,0,30,1
1649976825014,MATH 20B,A01,084124,Um; Ko Woon,29,0,35,6
1649976825014,MATH 20B,B01,084126,Um; Ko Woon,28,0,35,7
1649976831047,MATH 20C,A01,083446,Hammock; Frances H,10,0,30,20
1649976831047,MATH 20C,A02,083447,Hammock; Frances H,26,0,30,4
1649976831047,MATH 20C,A03,083448,Hammock; Frances H,27,0,30,3
1649976831047,MATH 20C,A04,083449,Hammock; Frances H,29,0,30,1
1649976831047,MATH 20C,B01,083451,Hammock; Frances H,15,0,30,15
1649976831047,MATH 20C,B02,083452,Hammock; Frances H,24,0,30,6
1649976831047,MATH 20C,B03,083453,Hammock; Frances H,25,0,30,5
1649976831047,MATH 20C,B04,083454,Hammock; Frances H,28,0,30,2
1649976837071,MATH 20D,A01,084128,Staff,19,0,30,11
1649976837071,MATH 20D,A02,084129,Staff,30,0,30,0
1649976837071,MATH 20D,A03,084130,Staff,27,0,30,3
1649976837071,MATH 20D,B01,084133,Staff,8,0,30,22
1649976837071,MATH 20D,B02,084134,Staff,24,0,30,6
1649976837071,MATH 20D,B03,084135,Staff,28,0,30,2
1649976843107,MATH 20E,A01,084138,Staff,16,0,30,14
1649976843107,MATH 20E,A02,084139,Staff,9,0,30,21
1649976843107,MATH 20E,A03,084140,Staff,16,0,30,14
1649976843107,MATH 20E,A04,084141,Staff,21,0,30,9
1649976849132,MATH 102,A01,084143,Harel; Guershon,14,0,30,16
1649976849132,MATH 102,A02,084144,Harel; Guershon,21,0,30,9
1649976855154,MATH 103B,A01,083456,Staff,0,12,30,30
1649976855154,MATH 103B,A02,083457,Staff,0,12,30,30
1649976861182,MATH 109,A01,084146,Salehi Golsefidy; Alireza,18,0,30,12
1649976861182,MATH 109,A02,084147,Salehi Golsefidy; Alireza,18,0,30,12
1649976867209,MATH 120A,A01,085445,Eggers; John Dietrich,16,0,35,19
1649976867209,MATH 120A,A02,085446,Eggers; John Dietrich,27,0,35,8
1649976873232,MATH 142B,A01,084149,Verstraete; Jacques Allan,0,12,30,30
1649976873232,MATH 142B,A02,084150,Verstraete; Jacques Allan,0,12,30,30
1649976879268,MATH 170A,A01,083459,Nie; Jiawang,1,7,30,29
1649976879268,MATH 170A,A02,083460,Nie; Jiawang,0,6,30,30
1649976879268,MATH 170A,A03,083461,Nie; Jiawang,0,7,30,30
1649976885295,MATH 193B,A01,083463,Staff,1,0,30,29
1649976885295,MATH 193B,A02,083464,Staff,10,0,30,20
1649976885295,MATH 193B,A03,083465,Staff,18,0,30,12
1649976891359,COGS 2,A01,083966,Boyle; Mary E. T.,13,0,30,17
1649976897381,COGS 9,A01,083968,Staff,19,0,60,41
1649976903409,COGS 14B,A01,083970,Staff,15,0,50,35
1649976909432,COGS 17,A01,092679,Staff,56,0,75,19
1649976915459,COGS 100,A01,083972,Staff,0,11,60,60
1649976927506,COGS 101C,A01,083976,Staff,13,0,30,17
1649976933537,COGS 102A,A01,083978,Johnson; Christine M.,14,0,30,16
1649976939561,COGS 107B,A01,083980,Staff,0,6,50,50
1649976945585,COGS 115,A01,083982,Staff,11,0,30,19
1649976951611,COGS 118B,A01,083367,Staff,0,13,40,40
1649976957648,COGS 172,A01,083984,Provenzano; Emily Kara,15,0,30,15
1649976963677,COGS 177,A00,083368,Staff,0,20,30,30
1649976969706,COGS 186,A01,083986,Staff,21,0,40,19
1649976975741,COGS 187A,A01,083988,Boyle; Mary E. T.,20,0,60,40
1649976981768,CSE 8A,A50,084003,Miranda; Gregory Joseph,0,5,15,15
1649976987795,CSE 11,A01,084005,Miranda; Gregory Joseph,0,13,55,55
1649976993822,CSE 20,A01,084007,Staff,3,0,20,17
1649976999848,CSE 21,A01,084009,Staff,0,19,50,50
1649977005871,CSE 30,A01,083370,Cao; Yingjun,0,55,40,40
1649977011902,CSE 100,A01,083372,Cao; Yingjun,0,43,40,40
1649977017941,CSE 101,A01,084011,Staff,1,55,40,39
1649977023971,CSE 141,A01,083374,Eldon; John,0,58,75,75
1649977029997,CSE 141L,A01,083376,Eldon; John,0,64,75,75
1649977036023,CSE 175,A01,084013,Kumar; Rakesh,22,0,25,3
1649977042048,CSE 190,A00,092508,Dubnov; Shlomo,20,0,20,0
1649977048073,ECE 5,A01,084049,Morris; Karcher William,13,0,20,7
1649977054097,ECE 100,A01,084051,Baghdadchi; Saharnaz,0,0,20,20
1649977054097,ECE 100,A02,091916,Baghdadchi; Saharnaz,14,0,20,6
1649977060134,ECE 101,A01,084053,Baghdadchi; Saharnaz,2,0,37,35
1649977060134,ECE 101,A02,084054,Baghdadchi; Saharnaz,31,0,37,6
1649977066157,ECE 107,A01,083390,Staff,27,0,40,13
1649977072185,ECE 148,A01,084056,Silberman; Jack,8,0,12,4
1649977078213,ECE 180,A00,083391,Abi Samra; Nicholas Camill,25,0,30,5
1649977078213,ECE 180,B00,083392,Abi Samra; Nicholas Camill,21,0,30,9
1649977084256,MATH 10B,A01,084110,Staff,3,0,30,27
1649977084256,MATH 10B,A02,084111,Staff,27,0,30,3
1649977084256,MATH 10B,A03,084112,Staff,26,0,30,4
1649977090281,MATH 10C,A01,083443,Staff,0,1,30,30
1649977090281,MATH 10C,A02,083444,Staff,0,2,30,30
1649977090281,MATH 10C,B01,084114,Staff,22,0,30,8
1649977090281,MATH 10C,B02,084115,Staff,28,0,30,2
1649977096308,MATH 18,A01,084117,Harel; Guershon,23,0,30,7
1649977096308,MATH 18,A02,084119,Harel; Guershon,28,0,30,2
1649977096308,MATH 18,A03,084120,Harel; Guershon,30,0,30,0
1649977096308,MATH 18,A04,084121,Harel; Guershon,29,0,30,1
1649977102345,MATH 20B,A01,084124,Um; Ko Woon,29,0,35,6
1649977102345,MATH 20B,B01,084126,Um; Ko Woon,28,0,35,7
1649977108370,MATH 20C,A01,083446,Hammock; Frances H,9,0,30,21
1649977108370,MATH 20C,A02,083447,Hammock; Frances H,26,0,30,4
1649977108370,MATH 20C,A03,083448,Hammock; Frances H,27,0,30,3
1649977108370,MATH 20C,A04,083449,Hammock; Frances H,29,0,30,1
1649977108370,MATH 20C,B01,083451,Hammock; Frances H,15,0,30,15
1649977108370,MATH 20C,B02,083452,Hammock; Frances H,24,0,30,6
1649977108370,MATH 20C,B03,083453,Hammock; Frances H,25,0,30,5
1649977108370,MATH 20C,B04,083454,Hammock; Frances H,28,0,30,2
1649977114398,MATH 20D,A01,084128,Staff,19,0,30,11
1649977114398,MATH 20D,A02,084129,Staff,30,0,30,0
1649977114398,MATH 20D,A03,084130,Staff,27,0,30,3
1649977114398,MATH 20D,B01,084133,Staff,8,0,30,22
1649977114398,MATH 20D,B02,084134,Staff,24,0,30,6
1649977114398,MATH 20D,B03,084135,Staff,28,0,30,2
1649977120427,MATH 20E,A01,084138,Staff,16,0,30,14
1649977120427,MATH 20E,A02,084139,Staff,9,0,30,21
1649977120427,MATH 20E,A03,084140,Staff,16,0,30,14
1649977120427,MATH 20E,A04,084141,Staff,21,0,30,9
1649977126451,MATH 102,A01,084143,Harel; Guershon,14,0,30,16
1649977126451,MATH 102,A02,084144,Harel; Guershon,21,0,30,9
1649977132476,MATH 103B,A01,083456,Staff,0,12,30,30
1649977132476,MATH 103B,A02,083457,Staff,0,12,30,30
1649977138500,MATH 109,A01,084146,Salehi Golsefidy; Alireza,18,0,30,12
1649977138500,MATH 109,A02,084147,Salehi Golsefidy; Alireza,18,0,30,12
1649977144531,MATH 120A,A01,085445,Eggers; John Dietrich,15,0,35,20
1649977144531,MATH 120A,A02,085446,Eggers; John Dietrich,27,0,35,8
1649977150558,MATH 142B,A01,084149,Verstraete; Jacques Allan,0,12,30,30
1649977150558,MATH 142B,A02,084150,Verstraete; Jacques Allan,0,12,30,30
1649977156581,MATH 170A,A01,083459,Nie; Jiawang,1,7,30,29
1649977156581,MATH 170A,A02,083460,Nie; Jiawang,0,7,30,30
1649977156581,MATH 170A,A03,083461,Nie; Jiawang,0,7,30,30
1649977162609,MATH 193B,A01,083463,Staff,1,0,30,29
1649977162609,MATH 193B,A02,083464,Staff,10,0,30,20
1649977162609,MATH 193B,A03,083465,Staff,18,0,30,12
1649977168664,COGS 2,A01,083966,Boyle; Mary E. T.,13,0,30,17
1649977174690,COGS 9,A01,083968,Staff,19,0,60,41
1649977180715,COGS 14B,A01,083970,Staff,15,0,50,35
1649977186741,COGS 17,A01,092679,Staff,56,0,75,19
1649977192770,COGS 100,A01,083972,Staff,0,11,60,60
1649977204828,COGS 101C,A01,083976,Staff,13,0,30,17
1649977210850,COGS 102A,A01,083978,Johnson; Christine M.,14,0,30,16
1649977216880,COGS 107B,A01,083980,Staff,0,6,50,50
1649977222904,COGS 115,A01,083982,Staff,11,0,30,19
1649977228930,COGS 118B,A01,083367,Staff,0,13,40,40
1649977234956,COGS 172,A01,083984,Provenzano; Emily Kara,15,0,30,15
1649977240981,COGS 177,A00,083368,Staff,0,20,30,30
1649977247013,COGS 186,A01,083986,Staff,21,0,40,19
1649977253036,COGS 187A,A01,083988,Boyle; Mary E. T.,20,0,60,40
1649977259059,CSE 8A,A50,084003,Miranda; Gregory Joseph,0,5,15,15
1649977265187,CSE 11,A01,084005,Miranda; Gregory Joseph,0,13,55,55
1649977271225,CSE 20,A01,084007,Staff,3,0,20,17
1649977277254,CSE 21,A01,084009,Staff,0,19,50,50
1649977283285,CSE 30,A01,083370,Cao; Yingjun,0,55,40,40
1649977289313,CSE 100,A01,083372,Cao; Yingjun,0,43,40,40
1649977295336,CSE 101,A01,084011,Staff,1,55,40,39
1649977301377,CSE 141,A01,083374,Eldon; John,0,58,75,75
1649977307398,CSE 141L,A01,083376,Eldon; John,0,64,75,75
1649977313424,CSE 175,A01,084013,Kumar; Rakesh,22,0,25,3
1649977319449,CSE 190,A00,092508,Dubnov; Shlomo,20,0,20,0
1649977325472,ECE 5,A01,084049,Morris; Karcher William,13,0,20,7
1649977331496,ECE 100,A01,084051,Baghdadchi; Saharnaz,0,0,20,20
1649977331496,ECE 100,A02,091916,Baghdadchi; Saharnaz,14,0,20,6
1649977337520,ECE 101,A01,084053,Baghdadchi; Saharnaz,2,0,37,35
1649977337520,ECE 101,A02,084054,Baghdadchi; Saharnaz,31,0,37,6
1649977343558,ECE 107,A01,083390,Staff,27,0,40,13
1649977349583,ECE 148,A01,084056,Silberman; Jack,8,0,12,4
1649977355608,ECE 180,A00,083391,Abi Samra; Nicholas Camill,25,0,30,5
1649977355608,ECE 180,B00,083392,Abi Samra; Nicholas Camill,21,0,30,9
1649977361634,MATH 10B,A01,084110,Staff,2,0,30,28
1649977361634,MATH 10B,A02,084111,Staff,27,0,30,3
1649977361634,MATH 10B,A03,084112,Staff,26,0,30,4
1649977367657,MATH 10C,A01,083443,Staff,0,1,30,30
1649977367657,MATH 10C,A02,083444,Staff,0,2,30,30
1649977367657,MATH 10C,B01,084114,Staff,22,0,30,8
1649977367657,MATH 10C,B02,084115,Staff,28,0,30,2
1649977373685,MATH 18,A01,084117,Harel; Guershon,23,0,30,7
1649977373685,MATH 18,A02,084119,Harel; Guershon,28,0,30,2
1649977373685,MATH 18,A03,084120,Harel; Guershon,30,0,30,0
1649977373685,MATH 18,A04,084121,Harel; Guershon,29,0,30,1
1649977379708,MATH 20B,A01,084124,Um; Ko Woon,28,0,35,7
1649977379708,MATH 20B,B01,084126,Um; Ko Woon,28,0,35,7
1649977385731,MATH 20C,A01,083446,Hammock; Frances H,9,0,30,21
1649977385731,MATH 20C,A02,083447,Hammock; Frances H,26,0,30,4
1649977385731,MATH 20C,A03,083448,Hammock; Frances H,27,0,30,3
1649977385731,MATH 20C,A04,083449,Hammock; Frances H,29,0,30,1
1649977385731,MATH 20C,B01,083451,Hammock; Frances H,15,0,30,15
1649977385731,MATH 20C,B02,083452,Hammock; Frances H,24,0,30,6
1649977385731,MATH 20C,B03,083453,Hammock; Frances H,25,0,30,5
1649977385731,MATH 20C,B04,083454,Hammock; Frances H,28,0,30,2
1649977391758,MATH 20D,A01,084128,Staff,19,0,30,11
1649977391758,MATH 20D,A02,084129,Staff,30,0,30,0
1649977391758,MATH 20D,A03,084130,Staff,27,0,30,3
1649977391758,MATH 20D,B01,084133,Staff,8,0,30,22
1649977391758,MATH 20D,B02,084134,Staff,24,0,30,6
1649977391758,MATH 20D,B03,084135,Staff,28,0,30,2
1649977397781,MATH 20E,A01,084138,Staff,16,0,30,14
1649977397781,MATH 20E,A02,084139,Staff,9,0,30,21
1649977397781,MATH 20E,A03,084140,Staff,15,0,30,15
1649977397781,MATH 20E,A04,084141,Staff,21,0,30,9
1649977403809,MATH 102,A01,084143,Harel; Guershon,14,0,30,16
1649977403809,MATH 102,A02,084144,Harel; Guershon,21,0,30,9
1649977409850,MATH 103B,A01,083456,Staff,0,12,30,30
1649977409850,MATH 103B,A02,083457,Staff,0,12,30,30
1649977415877,MATH 109,A01,084146,Salehi Golsefidy; Alireza,18,0,30,12
1649977415877,MATH 109,A02,084147,Salehi Golsefidy; Alireza,18,0,30,12
1649977421910,MATH 120A,A01,085445,Eggers; John Dietrich,15,0,35,20
1649977421910,MATH 120A,A02,085446,Eggers; John Dietrich,27,0,35,8
1649977427933,MATH 142B,A01,084149,Verstraete; Jacques Allan,0,12,30,30
1649977427933,MATH 142B,A02,084150,Verstraete; Jacques Allan,0,12,30,30
1649977433957,MATH 170A,A01,083459,Nie; Jiawang,1,7,30,29
1649977433957,MATH 170A,A02,083460,Nie; Jiawang,0,7,30,30
1649977433957,MATH 170A,A03,083461,Nie; Jiawang,0,7,30,30
1649977439990,MATH 193B,A01,083463,Staff,1,0,30,29
1649977439990,MATH 193B,A02,083464,Staff,10,0,30,20
1649977439990,MATH 193B,A03,083465,Staff,18,0,30,12
1649977446050,COGS 2,A01,083966,Boyle; Mary E. T.,13,0,30,17
1649977452089,COGS 9,A01,083968,Staff,19,0,60,41
1649977458135,COGS 14B,A01,083970,Staff,15,0,50,35
1649977464157,COGS 17,A01,092679,Staff,56,0,75,19
1649977470184,COGS 100,A01,083972,Staff,0,11,60,60
1649977482244,COGS 101C,A01,083976,Staff,13,0,30,17
1649977488281,COGS 102A,A01,083978,Johnson; Christine M.,14,0,30,16
1649977494303,COGS 107B,A01,083980,Staff,0,6,50,50
1649977500330,COGS 115,A01,083982,Staff,11,0,30,19
1649977506362,COGS 118B,A01,083367,Staff,0,13,40,40
1649977512391,COGS 172,A01,083984,Provenzano; Emily Kara,15,0,30,15
1649977518414,COGS 177,A00,083368,Staff,0,20,30,30
1649977524437,COGS 186,A01,083986,Staff,21,0,40,19
1649977530463,COGS 187A,A01,083988,Boyle; Mary E. T.,20,0,60,40
1649977536491,CSE 8A,A50,084003,Miranda; Gregory Joseph,0,5,15,15
1649977542514,CSE 11,A01,084005,Miranda; Gregory Joseph,0,14,55,55
1649977548541,CSE 20,A01,084007,Staff,2,0,20,18
1649977554564,CSE 21,A01,084009,Staff,0,19,50,50
1649977560599,CSE 30,A01,083370,Cao; Yingjun,0,56,40,40
1649977566621,CSE 100,A01,083372,Cao; Yingjun,0,43,40,40
1649977572647,CSE 101,A01,084011,Staff,1,55,40,39
1649977578671,CSE 141,A01,083374,Eldon; John,0,58,75,75
1649977584706,CSE 141L,A01,083376,Eldon; John,0,64,75,75
1649977590733,CSE 175,A01,084013,Kumar; Rakesh,22,0,25,3
1649977596769,CSE 190,A00,092508,Dubnov; Shlomo,20,0,20,0
1649977602810,ECE 5,A01,084049,Morris; Karcher William,13,0,20,7
1649977608834,ECE 100,A01,084051,Baghdadchi; Saharnaz,0,0,20,20
1649977608834,ECE 100,A02,091916,Baghdadchi; Saharnaz,14,0,20,6
1649977614858,ECE 101,A01,084053,Baghdadchi; Saharnaz,2,0,37,35
1649977614858,ECE 101,A02,084054,Baghdadchi; Saharnaz,31,0,37,6
1649977620885,ECE 107,A01,083390,Staff,27,0,40,13
1649977626912,ECE 148,A01,084056,Silberman; Jack,8,0,12,4
1649977632936,ECE 180,A00,083391,Abi Samra; Nicholas Camill,25,0,30,5
1649977632936,ECE 180,B00,083392,Abi Samra; Nicholas Camill,21,0,30,9
1649977638961,MATH 10B,A01,084110,Staff,2,0,30,28
1649977638961,MATH 10B,A02,084111,Staff,27,0,30,3
1649977638961,MATH 10B,A03,084112,Staff,26,0,30,4
1649977644988,MATH 10C,A01,083443,Staff,0,1,30,30
1649977644988,MATH 10C,A02,083444,Staff,0,2,30,30
1649977644988,MATH 10C,B01,084114,Staff,22,0,30,8
1649977644988,MATH 10C,B02,084115,Staff,28,0,30,2
1649977651023,MATH 18,A01,084117,Harel; Guershon,23,0,30,7
1649977651023,MATH 18,A02,084119,Harel; Guershon,28,0,30,2
1649977651023,MATH 18,A03,084120,Harel; Guershon,30,0,30,0
1649977651023,MATH 18,A04,084121,Harel; Guershon,29,0,30,1
1649977657055,MATH 20B,A01,084124,Um; Ko Woon,28,0,35,7
1649977657055,MATH 20B,B01,084126,Um; Ko Woon,28,0,35,7
1649977663085,MATH 20C,A01,083446,Hammock; Frances H,9,0,30,21
1649977663085,MATH 20C,A02,083447,Hammock; Frances H,26,0,30,4
1649977663085,MATH 20C,A03,083448,Hammock; Frances H,27,0,30,3
1649977663085,MATH 20C,A04,083449,Hammock; Frances H,29,0,30,1
1649977663085,MATH 20C,B01,083451,Hammock; Frances H,15,0,30,15
1649977663085,MATH 20C,B02,083452,Hammock; Frances H,24,0,30,6
1649977663085,MATH 20C,B03,083453,Hammock; Frances H,25,0,30,5
1649977663085,MATH 20C,B04,083454,Hammock; Frances H,28,0,30,2
1649977669108,MATH 20D,A01,084128,Staff,19,0,30,11
1649977669108,MATH 20D,A02,084129,Staff,30,0,30,0
1649977669108,MATH 20D,A03,084130,Staff,27,0,30,3
1649977669108,MATH 20D,B01,084133,Staff,8,0,30,22
1649977669108,MATH 20D,B02,084134,Staff,24,0,30,6
1649977669108,MATH 20D,B03,084135,Staff,28,0,30,2
1649977675135,MATH 20E,A01,084138,Staff,16,0,30,14
1649977675135,MATH 20E,A02,084139,Staff,9,0,30,21
1649977675135,MATH 20E,A03,084140,Staff,15,0,30,15
1649977675135,MATH 20E,A04,084141,Staff,21,0,30,9
1649977681158,MATH 102,A01,084143,Harel; Guershon,14,0,30,16
1649977681158,MATH 102,A02,084144,Harel; Guershon,21,0,30,9
1649977687181,MATH 103B,A01,083456,Staff,0,12,30,30
1649977687181,MATH 103B,A02,083457,Staff,0,12,30,30
1649977693208,MATH 109,A01,084146,Salehi Golsefidy; Alireza,18,0,30,12
1649977693208,MATH 109,A02,084147,Salehi Golsefidy; Alireza,18,0,30,12
1649977699231,MATH 120A,A01,085445,Eggers; John Dietrich,15,0,35,20
1649977699231,MATH 120A,A02,085446,Eggers; John Dietrich,27,0,35,8
1649977705257,MATH 142B,A01,084149,Verstraete; Jacques Allan,0,12,30,30
1649977705257,MATH 142B,A02,084150,Verstraete; Jacques Allan,0,12,30,30
1649977711283,MATH 170A,A01,083459,Nie; Jiawang,1,8,30,29
1649977711283,MATH 170A,A02,083460,Nie; Jiawang,0,7,30,30
1649977711283,MATH 170A,A03,083461,Nie; Jiawang,0,7,30,30
1649977717314,MATH 193B,A01,083463,Staff,1,0,30,29
1649977717314,MATH 193B,A02,083464,Staff,10,0,30,20
1649977717314,MATH 193B,A03,083465,Staff,18,0,30,12
1649977723381,COGS 2,A01,083966,Boyle; Mary E. T.,13,0,30,17
1649977729410,COGS 9,A01,083968,Staff,19,0,60,41
1649977735433,COGS 14B,A01,083970,Staff,13,0,50,37
1649977741461,COGS 17,A01,092679,Staff,56,0,75,19
1649977747487,COGS 100,A01,083972,Staff,0,12,60,60
1649977759538,COGS 101C,A01,083976,Staff,13,0,30,17
1649977765563,COGS 102A,A01,083978,Johnson; Christine M.,14,0,30,16
1649977771587,COGS 107B,A01,083980,Staff,0,6,50,50
1649977777611,COGS 115,A01,083982,Staff,11,0,30,19
1649977783634,COGS 118B,A01,083367,Staff,0,13,40,40
1649977789661,COGS 172,A01,083984,Provenzano; Emily Kara,15,0,30,15
1649977795694,COGS 177,A00,083368,Staff,0,20,30,30
1649977801734,COGS 186,A01,083986,Staff,21,0,40,19
1649977807762,COGS 187A,A01,083988,Boyle; Mary E. T.,20,0,60,40
1649977813794,CSE 8A,A50,084003,Miranda; Gregory Joseph,0,5,15,15
1649977819843,CSE 11,A01,084005,Miranda; Gregory Joseph,0,14,55,55
1649977825870,CSE 20,A01,084007,Staff,2,0,20,18
1649977831892,CSE 21,A01,084009,Staff,0,19,50,50
1649977837924,CSE 30,A01,083370,Cao; Yingjun,0,56,40,40
1649977843960,CSE 100,A01,083372,Cao; Yingjun,0,44,40,40
1649977849988,CSE 101,A01,084011,Staff,1,55,40,39
1649977856015,CSE 141,A01,083374,Eldon; John,0,58,75,75
1649977862132,CSE 141L,A01,083376,Eldon; John,0,64,75,75
1649977868159,CSE 175,A01,084013,Kumar; Rakesh,22,0,25,3
1649977874186,CSE 190,A00,092508,Dubnov; Shlomo,20,0,20,0
1649977880213,ECE 5,A01,084049,Morris; Karcher William,13,0,20,7
1649977886243,ECE 100,A01,084051,Baghdadchi; Saharnaz,0,0,20,20
1649977886243,ECE 100,A02,091916,Baghdadchi; Saharnaz,14,0,20,6
1649977892265,ECE 101,A01,084053,Baghdadchi; Saharnaz,2,0,37,35
1649977892265,ECE 101,A02,084054,Baghdadchi; Saharnaz,31,0,37,6
1649977898293,ECE 107,A01,083390,Staff,27,0,40,13
1649977904316,ECE 148,A01,084056,Silberman; Jack,8,0,12,4
1649977910342,ECE 180,A00,083391,Abi Samra; Nicholas Camill,25,0,30,5
1649977910342,ECE 180,B00,083392,Abi Samra; Nicholas Camill,21,0,30,9
1649977916378,MATH 10B,A01,084110,Staff,2,0,30,28
1649977916378,MATH 10B,A02,084111,Staff,26,0,30,4
1649977916378,MATH 10B,A03,084112,Staff,26,0,30,4
1649977922405,MATH 10C,A01,083443,Staff,0,2,30,30
1649977922405,MATH 10C,A02,083444,Staff,0,2,30,30
1649977922405,MATH 10C,B01,084114,Staff,22,0,30,8
1649977922405,MATH 10C,B02,084115,Staff,28,0,30,2
1649977928427,MATH 18,A01,084117,Harel; Guershon,23,0,30,7
1649977928427,MATH 18,A02,084119,Harel; Guershon,28,0,30,2
1649977928427,MATH 18,A03,084120,Harel; Guershon,30,0,30,0
1649977928427,MATH 18,A04,084121,Harel; Guershon,29,0,30,1
1649977934454,MATH 20B,A01,084124,Um; Ko Woon,28,0,35,7
1649977934454,MATH 20B,B01,084126,Um; Ko Woon,28,0,35,7
1649977940491,MATH 20C,A01,083446,Hammock; Frances H,9,0,30,21
1649977940491,MATH 20C,A02,083447,Hammock; Frances H,26,0,30,4
1649977940491,MATH 20C,A03,083448,Hammock; Frances H,27,0,30,3
1649977940491,MATH 20C,A04,083449,Hammock; Frances H,29,0,30,1
1649977940491,MATH 20C,B01,083451,Hammock; Frances H,15,0,30,15
1649977940491,MATH 20C,B02,083452,Hammock; Frances H,24,0,30,6
1649977940491,MATH 20C,B03,083453,Hammock; Frances H,25,0,30,5
1649977940491,MATH 20C,B04,083454,Hammock; Frances H,28,0,30,2
1649977946518,MATH 20D,A01,084128,Staff,19,0,30,11
1649977946518,MATH 20D,A02,084129,Staff,30,0,30,0
1649977946518,MATH 20D,A03,084130,Staff,27,0,30,3
1649977946518,MATH 20D,B01,084133,Staff,8,0,30,22
1649977946518,MATH 20D,B02,084134,Staff,24,0,30,6
1649977946518,MATH 20D,B03,084135,Staff,28,0,30,2
1649977952553,MATH 20E,A01,084138,Staff,16,0,30,14
1649977952553,MATH 20E,A02,084139,Staff,9,0,30,21
1649977952553,MATH 20E,A03,084140,Staff,15,0,30,15
1649977952553,MATH 20E,A04,084141,Staff,21,0,30,9
1649977958576,MATH 102,A01,084143,Harel; Guershon,14,0,30,16
1649977958576,MATH 102,A02,084144,Harel; Guershon,21,0,30,9
1649977964607,MATH 103B,A01,083456,Staff,0,12,30,30
1649977964607,MATH 103B,A02,083457,Staff,0,12,30,30
1649977970632,MATH 109,A01,084146,Salehi Golsefidy; Alireza,18,0,30,12
1649977970632,MATH 109,A02,084147,Salehi Golsefidy; Alireza,18,0,30,12
1649977976662,MATH 120A,A01,085445,Eggers; John Dietrich,15,0,35,20
1649977976662,MATH 120A,A02,085446,Eggers; John Dietrich,27,0,35,8
1649977982687,MATH 142B,A01,084149,Verstraete; Jacques Allan,0,12,30,30
1649977982687,MATH 142B,A02,084150,Verstraete; Jacques Allan,0,12,30,30
1649977988711,MATH 170A,A01,083459,Nie; Jiawang,1,8,30,29
1649977988711,MATH 170A,A02,083460,Nie; Jiawang,0,7,30,30
1649977988711,MATH 170A,A03,083461,Nie; Jiawang,0,7,30,30
1649977994749,MATH 193B,A01,083463,Staff,1,0,30,29
1649977994749,MATH 193B,A02,083464,Staff,10,0,30,20
1649977994749,MATH 193B,A03,083465,Staff,18,0,30,12
1649978000803,COGS 2,A01,083966,Boyle; Mary E. T.,13,0,30,17
1649978006829,COGS 9,A01,083968,Staff,19,0,60,41
1649978012852,COGS 14B,A01,083970,Staff,13,0,50,37
1649978018877,COGS 17,A01,092679,Staff,56,0,75,19
1649978024904,COGS 100,A01,083972,Staff,0,12,60,60
1649978036955,COGS 101C,A01,083976,Staff,13,0,30,17
1649978042981,COGS 102A,A01,083978,Johnson; Christine M.,14,0,30,16
1649978049010,COGS 107B,A01,083980,Staff,0,6,50,50
1649978055034,COGS 115,A01,083982,Staff,11,0,30,19
1649978061057,COGS 118B,A01,083367,Staff,0,13,40,40
1649978067098,COGS 172,A01,083984,Provenzano; Emily Kara,15,0,30,15
1649978073120,COGS 177,A00,083368,Staff,0,20,30,30
1649978079144,COGS 186,A01,083986,Staff,21,0,40,19
1649978085177,COGS 187A,A01,083988,Boyle; Mary E. T.,20,0,60,40
1649978091198,CSE 8A,A50,084003,Miranda; Gregory Joseph,0,5,15,15
1649978097233,CSE 11,A01,084005,Miranda; Gregory Joseph,0,15,55,55
1649978103259,CSE 20,A01,084007,Staff,2,0,20,18
1649978109284,CSE 21,A01,084009,Staff,0,19,50,50
1649978115309,CSE 30,A01,083370,Cao; Yingjun,0,56,40,40
1649978121336,CSE 100,A01,083372,Cao; Yingjun,0,44,40,40
1649978127372,CSE 101,A01,084011,Staff,1,55,40,39
1649978133401,CSE 141,A01,083374,Eldon; John,0,58,75,75
1649978139431,CSE 141L,A01,083376,Eldon; John,0,64,75,75
1649978145460,CSE 175,A01,084013,Kumar; Rakesh,22,0,25,3
1649978151491,CSE 190,A00,092508,Dubnov; Shlomo,20,0,20,0
1649978157514,ECE 5,A01,084049,Morris; Karcher William,13,0,20,7
1649978163826,ECE 100,A01,084051,Baghdadchi; Saharnaz,0,0,20,20
1649978163826,ECE 100,A02,091916,Baghdadchi; Saharnaz,14,0,20,6
1649978169854,ECE 101,A01,084053,Baghdadchi; Saharnaz,2,0,37,35
1649978169854,ECE 101,A02,084054,Baghdadchi; Saharnaz,31,0,37,6
1649978175878,ECE 107,A01,083390,Staff,27,0,40,13
1649978181901,ECE 148,A01,084056,Silberman; Jack,8,0,12,4
1649978187929,ECE 180,A00,083391,Abi Samra; Nicholas Camill,25,0,30,5
1649978187929,ECE 180,B00,083392,Abi Samra; Nicholas Camill,21,0,30,9
1649978193954,MATH 10B,A01,084110,Staff,1,0,30,29
1649978193954,MATH 10B,A02,084111,Staff,27,0,30,3
1649978193954,MATH 10B,A03,084112,Staff,26,0,30,4
1649978199978,MATH 10C,A01,083443,Staff,0,2,30,30
1649978199978,MATH 10C,A02,083444,Staff,0,2,30,30
1649978199978,MATH 10C,B01,084114,Staff,22,0,30,8
1649978199978,MATH 10C,B02,084115,Staff,28,0,30,2
1649978206006,MATH 18,A01,084117,Harel; Guershon,22,0,30,8
1649978206006,MATH 18,A02,084119,Harel; Guershon,28,0,30,2
1649978206006,MATH 18,A03,084120,Harel; Guershon,30,0,30,0
1649978206006,MATH 18,A04,084121,Harel; Guershon,29,0,30,1
1649978212030,MATH 20B,A01,084124,Um; Ko Woon,28,0,35,7
1649978212030,MATH 20B,B01,084126,Um; Ko Woon,28,0,35,7
1649978218060,MATH 20C,A01,083446,Hammock; Frances H,9,0,30,21
1649978218060,MATH 20C,A02,083447,Hammock; Frances H,26,0,30,4
1649978218060,MATH 20C,A03,083448,Hammock; Frances H,27,0,30,3
1649978218060,MATH 20C,A04,083449,Hammock; Frances H,29,0,30,1
1649978218060,MATH 20C,B01,083451,Hammock; Frances H,15,0,30,15
1649978218060,MATH 20C,B02,083452,Hammock; Frances H,24,0,30,6
1649978218060,MATH 20C,B03,083453,Hammock; Frances H,25,0,30,5
1649978218060,MATH 20C,B04,083454,Hammock; Frances H,28,0,30,2
1649978224085,MATH 20D,A01,084128,Staff,19,0,30,11
1649978224085,MATH 20D,A02,084129,Staff,30,0,30,0
1649978224085,MATH 20D,A03,084130,Staff,27,0,30,3
1649978224085,MATH 20D,B01,084133,Staff,8,0,30,22
1649978224085,MATH 20D,B02,084134,Staff,24,0,30,6
1649978224085,MATH 20D,B03,084135,Staff,28,0,30,2
1649978230117,MATH 20E,A01,084138,Staff,16,0,30,14
1649978230117,MATH 20E,A02,084139,Staff,9,0,30,21
1649978230117,MATH 20E,A03,084140,Staff,15,0,30,15
1649978230117,MATH 20E,A04,084141,Staff,21,0,30,9
1649978236146,MATH 102,A01,084143,Harel; Guershon,14,0,30,16
1649978236146,MATH 102,A02,084144,Harel; Guershon,21,0,30,9
1649978242177,MATH 103B,A01,083456,Staff,0,12,30,30
1649978242177,MATH 103B,A02,083457,Staff,0,12,30,30
1649978248209,MATH 109,A01,084146,Salehi Golsefidy; Alireza,18,0,30,12
1649978248209,MATH 109,A02,084147,Salehi Golsefidy; Alireza,18,0,30,12
1649978254236,MATH 120A,A01,085445,Eggers; John Dietrich,15,0,35,20
1649978254236,MATH 120A,A02,085446,Eggers; John Dietrich,27,0,35,8
1649978260264,MATH 142B,A01,084149,Verstraete; Jacques Allan,0,12,30,30
1649978260264,MATH 142B,A02,084150,Verstraete; Jacques Allan,0,12,30,30
1649978266299,MATH 170A,A01,083459,Nie; Jiawang,1,8,30,29
1649978266299,MATH 170A,A02,083460,Nie; Jiawang,0,7,30,30
1649978266299,MATH 170A,A03,083461,Nie; Jiawang,0,7,30,30
1649978272330,MATH 193B,A01,083463,Staff,1,0,30,29
1649978272330,MATH 193B,A02,083464,Staff,10,0,30,20
1649978272330,MATH 193B,A03,083465,Staff,18,0,30,12
1649978278394,COGS 2,A01,083966,Boyle; Mary E. T.,13,0,30,17
1649978284421,COGS 9,A01,083968,Staff,19,0,60,41
1649978290444,COGS 14B,A01,083970,Staff,13,0,50,37
1649978296477,COGS 17,A01,092679,Staff,56,0,75,19
1649978302500,COGS 100,A01,083972,Staff,0,12,60,60
1649978314559,COGS 101C,A01,083976,Staff,13,0,30,17
1649978320585,COGS 102A,A01,083978,Johnson; Christine M.,14,0,30,16
1649978326614,COGS 107B,A01,083980,Staff,0,6,50,50
1649978332637,COGS 115,A01,083982,Staff,11,0,30,19
1649978338661,COGS 118B,A01,083367,Staff,0,13,40,40
1649978344688,COGS 172,A01,083984,Provenzano; Emily Kara,15,0,30,15
1649978350709,COGS 177,A00,083368,Staff,0,20,30,30
1649978356733,COGS 186,A01,083986,Staff,21,0,40,19
1649978362759,COGS 187A,A01,083988,Boyle; Mary E. T.,20,0,60,40
1649978368784,CSE 8A,A50,084003,Miranda; Gregory Joseph,0,5,15,15
1649978374811,CSE 11,A01,084005,Miranda; Gregory Joseph,0,15,55,55
1649978380835,CSE 20,A01,084007,Staff,2,0,20,18
1649978386858,CSE 21,A01,084009,Staff,0,19,50,50
1649978392885,CSE 30,A01,083370,Cao; Yingjun,0,56,40,40
1649978398907,CSE 100,A01,083372,Cao; Yingjun,0,44,40,40
1649978404930,CSE 101,A01,084011,Staff,1,55,40,39
1649978410961,CSE 141,A01,083374,Eldon; John,0,58,75,75
1649978416983,CSE 141L,A01,083376,Eldon; John,0,64,75,75
1649978423028,CSE 175,A01,084013,Kumar; Rakesh,22,0,25,3
1649978429048,CSE 190,A00,092508,Dubnov; Shlomo,20,0,20,0
1649978435076,ECE 5,A01,084049,Morris; Karcher William,13,0,20,7
1649978441099,ECE 100,A01,084051,Baghdadchi; Saharnaz,0,0,20,20
1649978441099,ECE 100,A02,091916,Baghdadchi; Saharnaz,14,0,20,6
1649978447122,ECE 101,A01,084053,Baghdadchi; Saharnaz,2,0,37,35
1649978447122,ECE 101,A02,084054,Baghdadchi; Saharnaz,31,0,37,6
1649978453158,ECE 107,A01,083390,Staff,27,0,40,13
1649978459273,ECE 148,A01,084056,Silberman; Jack,8,0,12,4
1649978465294,ECE 180,A00,083391,Abi Samra; Nicholas Camill,25,0,30,5
1649978465294,ECE 180,B00,083392,Abi Samra; Nicholas Camill,21,0,30,9
1649978471324,MATH 10B,A01,084110,Staff,1,0,30,29
1649978471324,MATH 10B,A02,084111,Staff,27,0,30,3
1649978471324,MATH 10B,A03,084112,Staff,26,0,30,4
1649978477357,MATH 10C,A01,083443,Staff,0,2,30,30
1649978477357,MATH 10C,A02,083444,Staff,0,2,30,30
1649978477357,MATH 10C,B01,084114,Staff,22,0,30,8
1649978477357,MATH 10C,B02,084115,Staff,28,0,30,2
1649978483382,MATH 18,A01,084117,Harel; Guershon,22,0,30,8
1649978483382,MATH 18,A02,084119,Harel; Guershon,28,0,30,2
1649978483382,MATH 18,A03,084120,Harel; Guershon,30,0,30,0
1649978483382,MATH 18,A04,084121,Harel; Guershon,29,0,30,1
1649978489404,MATH 20B,A01,084124,Um; Ko Woon,27,0,35,8
1649978489404,MATH 20B,B01,084126,Um; Ko Woon,28,0,35,7
1649978495442,MATH 20C,A01,083446,Hammock; Frances H,9,0,30,21
1649978495442,MATH 20C,A02,083447,Hammock; Frances H,26,0,30,4
1649978495442,MATH 20C,A03,083448,Hammock; Frances H,27,0,30,3
1649978495442,MATH 20C,A04,083449,Hammock; Frances H,29,0,30,1
1649978495442,MATH 20C,B01,083451,Hammock; Frances H,15,0,30,15
1649978495442,MATH 20C,B02,083452,Hammock; Frances H,24,0,30,6
1649978495442,MATH 20C,B03,083453,Hammock; Frances H,25,0,30,5
1649978495442,MATH 20C,B04,083454,Hammock; Frances H,28,0,30,2
1649978501470,MATH 20D,A01,084128,Staff,19,0,30,11
1649978501470,MATH 20D,A02,084129,Staff,30,0,30,0
1649978501470,MATH 20D,A03,084130,Staff,27,0,30,3
1649978501470,MATH 20D,B01,084133,Staff,8,0,30,22
1649978501470,MATH 20D,B02,084134,Staff,24,0,30,6
1649978501470,MATH 20D,B03,084135,Staff,28,0,30,2
1649978507494,MATH 20E,A01,084138,Staff,16,0,30,14
1649978507494,MATH 20E,A02,084139,Staff,9,0,30,21
1649978507494,MATH 20E,A03,084140,Staff,15,0,30,15
1649978507494,MATH 20E,A04,084141,Staff,21,0,30,9
1649978513518,MATH 102,A01,084143,Harel; Guershon,13,0,30,17
1649978513518,MATH 102,A02,084144,Harel; Guershon,21,0,30,9
1649978519555,MATH 103B,A01,083456,Staff,0,12,30,30
1649978519555,MATH 103B,A02,083457,Staff,0,12,30,30
1649978525580,MATH 109,A01,084146,Salehi Golsefidy; Alireza,18,0,30,12
1649978525580,MATH 109,A02,084147,Salehi Golsefidy; Alireza,18,0,30,12
1649978531607,MATH 120A,A01,085445,Eggers; John Dietrich,15,0,35,20
1649978531607,MATH 120A,A02,085446,Eggers; John Dietrich,27,0,35,8
1649978537630,MATH 142B,A01,084149,Verstraete; Jacques Allan,0,12,30,30
1649978537630,MATH 142B,A02,084150,Verstraete; Jacques Allan,0,12,30,30
1649978543654,MATH 170A,A01,083459,Nie; Jiawang,1,8,30,29
1649978543654,MATH 170A,A02,083460,Nie; Jiawang,0,7,30,30
1649978543654,MATH 170A,A03,083461,Nie; Jiawang,0,7,30,30
1649978549685,MATH 193B,A01,083463,Staff,1,0,30,29
1649978549685,MATH 193B,A02,083464,Staff,10,0,30,20
1649978549685,MATH 193B,A03,083465,Staff,18,0,30,12
1649978555751,COGS 2,A01,083966,Boyle; Mary E. T.,13,0,30,17
1649978561777,COGS 9,A01,083968,Staff,19,0,60,41
1649978567800,COGS 14B,A01,083970,Staff,13,0,50,37
1649978573824,COGS 17,A01,092679,Staff,56,0,75,19
1649978579854,COGS 100,A01,083972,Staff,0,12,60,60
1649978591901,COGS 101C,A01,083976,Staff,13,0,30,17
1649978597934,COGS 102A,A01,083978,Johnson; Christine M.,14,0,30,16
1649978603957,COGS 107B,A01,083980,Staff,0,6,50,50
1649978609982,COGS 115,A01,083982,Staff,11,0,30,19
1649978616010,COGS 118B,A01,083367,Staff,0,13,40,40
1649978622051,COGS 172,A01,083984,Provenzano; Emily Kara,15,0,30,15
1649978628084,COGS 177,A00,083368,Staff,0,20,30,30
1649978634109,COGS 186,A01,083986,Staff,21,0,40,19
1649978640166,COGS 187A,A01,083988,Boyle; Mary E. T.,20,0,60,40
1649978646203,CSE 8A,A50,084003,Miranda; Gregory Joseph,0,5,15,15
1649978652229,CSE 11,A01,084005,Miranda; Gregory Joseph,0,15,55,55
1649978658255,CSE 20,A01,084007,Staff,2,0,20,18
1649978664276,CSE 21,A01,084009,Staff,0,19,50,50
1649978670299,CSE 30,A01,083370,Cao; Yingjun,0,56,40,40
1649978676321,CSE 100,A01,083372,Cao; Yingjun,0,44,40,40
1649978682348,CSE 101,A01,084011,Staff,1,55,40,39
1649978688370,CSE 141,A01,083374,Eldon; John,0,58,75,75
1649978694395,CSE 141L,A01,083376,Eldon; John,0,64,75,75
1649978700428,CSE 175,A01,084013,Kumar; Rakesh,22,0,25,3
1649978706452,CSE 190,A00,092508,Dubnov; Shlomo,20,0,20,0
1649978712475,ECE 5,A01,084049,Morris; Karcher William,13,0,20,7
1649978718503,ECE 100,A01,084051,Baghdadchi; Saharnaz,0,0,20,20
1649978718503,ECE 100,A02,091916,Baghdadchi; Saharnaz,14,0,20,6
1649978724526,ECE 101,A01,084053,Baghdadchi; Saharnaz,2,0,37,35
1649978724526,ECE 101,A02,084054,Baghdadchi; Saharnaz,31,0,37,6
1649978730556,ECE 107,A01,083390,Staff,27,0,40,13
1649978736578,ECE 148,A01,084056,Silberman; Jack,8,0,12,4
1649978742605,ECE 180,A00,083391,Abi Samra; Nicholas Camill,25,0,30,5
1649978742605,ECE 180,B00,083392,Abi Samra; Nicholas Camill,21,0,30,9
1649978748635,MATH 10B,A01,084110,Staff,1,0,30,29
1649978748635,MATH 10B,A02,084111,Staff,27,0,30,3
1649978748635,MATH 10B,A03,084112,Staff,26,0,30,4
1649978754663,MATH 10C,A01,083443,Staff,0,3,30,30
1649978754663,MATH 10C,A02,083444,Staff,0,2,30,30
1649978754663,MATH 10C,B01,084114,Staff,22,0,30,8
1649978754663,MATH 10C,B02,084115,Staff,28,0,30,2
1649978760691,MATH 18,A01,084117,Harel; Guershon,22,0,30,8
1649978760691,MATH 18,A02,084119,Harel; Guershon,28,0,30,2
1649978760691,MATH 18,A03,084120,Harel; Guershon,30,0,30,0
1649978760691,MATH 18,A04,084121,Harel; Guershon,29,0,30,1
1649978766719,MATH 20B,A01,084124,Um; Ko Woon,27,0,35,8
1649978766719,MATH 20B,B01,084126,Um; Ko Woon,28,0,35,7
1649978772752,MATH 20C,A01,083446,Hammock; Frances H,8,0,30,22
1649978772752,MATH 20C,A02,083447,Hammock; Frances H,26,0,30,4
1649978772752,MATH 20C,A03,083448,Hammock; Frances H,27,0,30,3
1649978772752,MATH 20C,A04,083449,Hammock; Frances H,29,0,30,1
1649978772752,MATH 20C,B01,083451,Hammock; Frances H,15,0,30,15
1649978772752,MATH 20C,B02,083452,Hammock; Frances H,24,0,30,6
1649978772752,MATH 20C,B03,083453,Hammock; Frances H,25,0,30,5
1649978772752,MATH 20C,B04,083454,Hammock; Frances H,28,0,30,2
1649978778777,MATH 20D,A01,084128,Staff,19,0,30,11
1649978778777,MATH 20D,A02,084129,Staff,30,0,30,0
1649978778777,MATH 20D,A03,084130,Staff,27,0,30,3
1649978778777,MATH 20D,B01,084133,Staff,8,0,30,22
1649978778777,MATH 20D,B02,084134,Staff,24,0,30,6
1649978778777,MATH 20D,B03,084135,Staff,28,0,30,2
1649978784801,MATH 20E,A01,084138,Staff,16,0,30,14
1649978784801,MATH 20E,A02,084139,Staff,9,0,30,21
1649978784801,MATH 20E,A03,084140,Staff,15,0,30,15
1649978784801,MATH 20E,A04,084141,Staff,21,0,30,9
1649978790829,MATH 102,A01,084143,Harel; Guershon,13,0,30,17
1649978790829,MATH 102,A02,084144,Harel; Guershon,21,0,30,9
1649978796858,MATH 103B,A01,083456,Staff,0,12,30,30
1649978796858,MATH 103B,A02,083457,Staff,0,12,30,30
1649978802889,MATH 109,A01,084146,Salehi Golsefidy; Alireza,18,0,30,12
1649978802889,MATH 109,A02,084147,Salehi Golsefidy; Alireza,18,0,30,12
1649978808918,MATH 120A,A01,085445,Eggers; John Dietrich,15,0,35,20
1649978808918,MATH 120A,A02,085446,Eggers; John Dietrich,27,0,35,8
1649978814941,MATH 142B,A01,084149,Verstraete; Jacques Allan,0,12,30,30
1649978814941,MATH 142B,A02,084150,Verstraete; Jacques Allan,0,12,30,30
1649978820967,MATH 170A,A01,083459,Nie; Jiawang,1,8,30,29
1649978820967,MATH 170A,A02,083460,Nie; Jiawang,0,7,30,30
1649978820967,MATH 170A,A03,083461,Nie; Jiawang,0,7,30,30
1649978826994,MATH 193B,A01,083463,Staff,1,0,30,29
1649978826994,MATH 193B,A02,083464,Staff,10,0,30,20
1649978826994,MATH 193B,A03,083465,Staff,18,0,30,12
1649978833090,COGS 2,A01,083966,Boyle; Mary E. T.,13,0,30,17
1649978839115,COGS 9,A01,083968,Staff,19,0,60,41
1649978845137,COGS 14B,A01,083970,Staff,13,0,50,37
1649978851160,COGS 17,A01,092679,Staff,56,0,75,19
1649978857199,COGS 100,A01,083972,Staff,0,12,60,60
1649978869248,COGS 101C,A01,083976,Staff,13,0,30,17
1649978875276,COGS 102A,A01,083978,Johnson; Christine M.,14,0,30,16
1649978881303,COGS 107B,A01,083980,Staff,0,6,50,50
1649978887327,COGS 115,A01,083982,Staff,11,0,30,19
1649978893353,COGS 118B,A01,083367,Staff,0,13,40,40
1649978899376,COGS 172,A01,083984,Provenzano; Emily Kara,15,0,30,15
1649978905416,COGS 177,A00,083368,Staff,0,20,30,30
1649978911440,COGS 186,A01,083986,Staff,21,0,40,19
1649978917469,COGS 187A,A01,083988,Boyle; Mary E. T.,20,0,60,40
1649978923496,CSE 8A,A50,084003,Miranda; Gregory Joseph,0,5,15,15
1649978929525,CSE 11,A01,084005,Miranda; Gregory Joseph,0,15,55,55
1649978935548,CSE 20,A01,084007,Staff,2,0,20,18
1649978941572,CSE 21,A01,084009,Staff,0,20,50,50
1649978947601,CSE 30,A01,083370,Cao; Yingjun,0,56,40,40
1649978953626,CSE 100,A01,083372,Cao; Yingjun,0,45,40,40
1649978959650,CSE 101,A01,084011,Staff,1,55,40,39
1649978965673,CSE 141,A01,083374,Eldon; John,0,58,75,75
1649978971696,CSE 141L,A01,083376,Eldon; John,0,64,75,75
1649978977718,CSE 175,A01,084013,Kumar; Rakesh,22,0,25,3
1649978983745,CSE 190,A00,092508,Dubnov; Shlomo,20,0,20,0
1649978989782,ECE 5,A01,084049,Morris; Karcher William,13,0,20,7
1649978995811,ECE 100,A01,084051,Baghdadchi; Saharnaz,0,0,20,20
1649978995811,ECE 100,A02,091916,Baghdadchi; Saharnaz,14,0,20,6
1649979001837,ECE 101,A01,084053,Baghdadchi; Saharnaz,2,0,37,35
1649979001837,ECE 101,A02,084054,Baghdadchi; Saharnaz,31,0,37,6
1649979007862,ECE 107,A01,083390,Staff,27,0,40,13
1649979013892,ECE 148,A01,084056,Silberman; Jack,8,0,12,4
1649979019914,ECE 180,A00,083391,Abi Samra; Nicholas Camill,25,0,30,5
1649979019914,ECE 180,B00,083392,Abi Samra; Nicholas Camill,21,0,30,9
1649979025954,MATH 10B,A01,084110,Staff,1,0,30,29
1649979025954,MATH 10B,A02,084111,Staff,27,0,30,3
1649979025954,MATH 10B,A03,084112,Staff,26,0,30,4
1649979031982,MATH 10C,A01,083443,Staff,0,3,30,30
1649979031982,MATH 10C,A02,083444,Staff,0,2,30,30
1649979031982,MATH 10C,B01,084114,Staff,22,0,30,8
1649979031982,MATH 10C,B02,084115,Staff,28,0,30,2
1649979038004,MATH 18,A01,084117,Harel; Guershon,22,0,30,8
1649979038004,MATH 18,A02,084119,Harel; Guershon,28,0,30,2
1649979038004,MATH 18,A03,084120,Harel; Guershon,30,0,30,0
1649979038004,MATH 18,A04,084121,Harel; Guershon,29,0,30,1
1649979044028,MATH 20B,A01,084124,Um; Ko Woon,27,0,35,8
1649979044028,MATH 20B,B01,084126,Um; Ko Woon,28,0,35,7
1649979050057,MATH 20C,A01,083446,Hammock; Frances H,9,0,30,21
1649979050057,MATH 20C,A02,083447,Hammock; Frances H,26,0,30,4
1649979050057,MATH 20C,A03,083448,Hammock; Frances H,27,0,30,3
1649979050057,MATH 20C,A04,083449,Hammock; Frances H,29,0,30,1
1649979050057,MATH 20C,B01,083451,Hammock; Frances H,15,0,30,15
1649979050057,MATH 20C,B02,083452,Hammock; Frances H,23,0,30,7
1649979050057,MATH 20C,B03,083453,Hammock; Frances H,25,0,30,5
1649979050057,MATH 20C,B04,083454,Hammock; Frances H,28,0,30,2
1649979056173,MATH 20D,A01,084128,Staff,19,0,30,11
1649979056173,MATH 20D,A02,084129,Staff,30,0,30,0
1649979056173,MATH 20D,A03,084130,Staff,27,0,30,3
1649979056173,MATH 20D,B01,084133,Staff,8,0,30,22
1649979056173,MATH 20D,B02,084134,Staff,24,0,30,6
1649979056173,MATH 20D,B03,084135,Staff,28,0,30,2
1649979062199,MATH 20E,A01,084138,Staff,16,0,30,14
1649979062199,MATH 20E,A02,084139,Staff,9,0,30,21
1649979062199,MATH 20E,A03,084140,Staff,15,0,30,15
1649979062199,MATH 20E,A04,084141,Staff,21,0,30,9
1649979068230,MATH 102,A01,084143,Harel; Guershon,13,0,30,17
1649979068230,MATH 102,A02,084144,Harel; Guershon,21,0,30,9
1649979074258,MATH 103B,A01,083456,Staff,0,12,30,30
1649979074258,MATH 103B,A02,083457,Staff,0,12,30,30
1649979080281,MATH 109,A01,084146,Salehi Golsefidy; Alireza,18,0,30,12
1649979080281,MATH 109,A02,084147,Salehi Golsefidy; Alireza,18,0,30,12
1649979086312,MATH 120A,A01,085445,Eggers; John Dietrich,15,0,35,20
1649979086312,MATH 120A,A02,085446,Eggers; John Dietrich,27,0,35,8
1649979092335,MATH 142B,A01,084149,Verstraete; Jacques Allan,0,12,30,30
1649979092335,MATH 142B,A02,084150,Verstraete; Jacques Allan,0,12,30,30
1649979098368,MATH 170A,A01,083459,Nie; Jiawang,1,8,30,29
1649979098368,MATH 170A,A02,083460,Nie; Jiawang,0,7,30,30
1649979098368,MATH 170A,A03,083461,Nie; Jiawang,0,7,30,30
1649979104391,MATH 193B,A01,083463,Staff,1,0,30,29
1649979104391,MATH 193B,A02,083464,Staff,10,0,30,20
1649979104391,MATH 193B,A03,083465,Staff,18,0,30,12
1649979110444,COGS 2,A01,083966,Boyle; Mary E. T.,13,0,30,17
1649979116466,COGS 9,A01,083968,Staff,19,0,60,41
1649979122488,COGS 14B,A01,083970,Staff,13,0,50,37
1649979128516,COGS 17,A01,092679,Staff,56,0,75,19
1649979134539,COGS 100,A01,083972,Staff,0,12,60,60
1649979146660,COGS 101C,A01,083976,Staff,13,0,30,17
1649979152685,COGS 102A,A01,083978,Johnson; Christine M.,14,0,30,16
1649979158711,COGS 107B,A01,083980,Staff,0,6,50,50
1649979164737,COGS 115,A01,083982,Staff,11,0,30,19
1649979170758,COGS 118B,A01,083367,Staff,0,13,40,40
1649979176784,COGS 172,A01,083984,Provenzano; Emily Kara,15,0,30,15
1649979182807,COGS 177,A00,083368,Staff,0,20,30,30
1649979196338,COGS 186,A01,083986,Staff,21,0,40,19
1649979202364,COGS 187A,A01,083988,Boyle; Mary E. T.,20,0,60,40
1649979208387,CSE 8A,A50,084003,Miranda; Gregory Joseph,0,5,15,15
1649979214413,CSE 11,A01,084005,Miranda; Gregory Joseph,0,15,55,55
1649979220435,CSE 20,A01,084007,Staff,2,0,20,18
1649979226461,CSE 21,A01,084009,Staff,0,20,50,50
1649979232492,CSE 30,A01,083370,Cao; Yingjun,0,56,40,40
1649979238518,CSE 100,A01,083372,Cao; Yingjun,0,45,40,40
1649979244552,CSE 101,A01,084011,Staff,1,55,40,39
1649979250580,CSE 141,A01,083374,Eldon; John,0,58,75,75
1649979256670,CSE 141L,A01,083376,Eldon; John,0,64,75,75
1649979262698,CSE 175,A01,084013,Kumar; Rakesh,22,0,25,3
1649979268722,CSE 190,A00,092508,Dubnov; Shlomo,20,0,20,0
1649979274747,ECE 5,A01,084049,Morris; Karcher William,13,0,20,7
1649979280770,ECE 100,A01,084051,Baghdadchi; Saharnaz,0,0,20,20
1649979280770,ECE 100,A02,091916,Baghdadchi; Saharnaz,14,0,20,6
1649979286793,ECE 101,A01,084053,Baghdadchi; Saharnaz,2,0,37,35
1649979286793,ECE 101,A02,084054,Baghdadchi; Saharnaz,31,0,37,6
1649979292821,ECE 107,A01,083390,Staff,27,0,40,13
1649979298843,ECE 148,A01,084056,Silberman; Jack,8,0,12,4
1649979304869,ECE 180,A00,083391,Abi Samra; Nicholas Camill,25,0,30,5
1649979304869,ECE 180,B00,083392,Abi Samra; Nicholas Camill,21,0,30,9
1649979310897,MATH 10B,A01,084110,Staff,1,0,30,29
1649979310897,MATH 10B,A02,084111,Staff,27,0,30,3
1649979310897,MATH 10B,A03,084112,Staff,26,0,30,4
1649979316920,MATH 10C,A01,083443,Staff,0,3,30,30
1649979316920,MATH 10C,A02,083444,Staff,0,2,30,30
1649979316920,MATH 10C,B01,084114,Staff,22,0,30,8
1649979316920,MATH 10C,B02,084115,Staff,28,0,30,2
1649979322942,MATH 18,A01,084117,Harel; Guershon,22,0,30,8
1649979322942,MATH 18,A02,084119,Harel; Guershon,28,0,30,2
1649979322942,MATH 18,A03,084120,Harel; Guershon,30,0,30,0
1649979322942,MATH 18,A04,084121,Harel; Guershon,29,0,30,1
1649979328968,MATH 20B,A01,084124,Um; Ko Woon,26,0,35,9
1649979328968,MATH 20B,B01,084126,Um; Ko Woon,28,0,35,7
1649979334991,MATH 20C,A01,083446,Hammock; Frances H,9,0,30,21
1649979334991,MATH 20C,A02,083447,Hammock; Frances H,25,0,30,5
1649979334991,MATH 20C,A03,083448,Hammock; Frances H,27,0,30,3
1649979334991,MATH 20C,A04,083449,Hammock; Frances H,29,0,30,1
1649979334991,MATH 20C,B01,083451,Hammock; Frances H,15,0,30,15
1649979334991,MATH 20C,B02,083452,Hammock; Frances H,23,0,30,7
1649979334991,MATH 20C,B03,083453,Hammock; Frances H,25,0,30,5
1649979334991,MATH 20C,B04,083454,Hammock; Frances H,28,0,30,2
1649979341016,MATH 20D,A01,084128,Staff,19,0,30,11
1649979341016,MATH 20D,A02,084129,Staff,30,0,30,0
1649979341016,MATH 20D,A03,084130,Staff,27,0,30,3
1649979341016,MATH 20D,B01,084133,Staff,8,0,30,22
1649979341016,MATH 20D,B02,084134,Staff,24,0,30,6
1649979341016,MATH 20D,B03,084135,Staff,28,0,30,2
1649979347052,MATH 20E,A01,084138,Staff,16,0,30,14
1649979347052,MATH 20E,A02,084139,Staff,9,0,30,21
1649979347052,MATH 20E,A03,084140,Staff,15,0,30,15
1649979347052,MATH 20E,A04,084141,Staff,21,0,30,9
1649979353074,MATH 102,A01,084143,Harel; Guershon,13,0,30,17
1649979353074,MATH 102,A02,084144,Harel; Guershon,21,0,30,9
1649979359097,MATH 103B,A01,083456,Staff,0,12,30,30
1649979359097,MATH 103B,A02,083457,Staff,0,12,30,30
1649979365136,MATH 109,A01,084146,Salehi Golsefidy; Alireza,18,0,30,12
1649979365136,MATH 109,A02,084147,Salehi Golsefidy; Alireza,18,0,30,12
1649979371160,MATH 120A,A01,085445,Eggers; John Dietrich,15,0,35,20
1649979371160,MATH 120A,A02,085446,Eggers; John Dietrich,27,0,35,8
1649979377181,MATH 142B,A01,084149,Verstraete; Jacques Allan,0,12,30,30
1649979377181,MATH 142B,A02,084150,Verstraete; Jacques Allan,0,12,30,30
1649979383206,MATH 170A,A01,083459,Nie; Jiawang,1,8,30,29
1649979383206,MATH 170A,A02,083460,Nie; Jiawang,0,7,30,30
1649979383206,MATH 170A,A03,083461,Nie; Jiawang,0,7,30,30
1649979389239,MATH 193B,A01,083463,Staff,1,0,30,29
1649979389239,MATH 193B,A02,083464,Staff,10,0,30,20
1649979389239,MATH 193B,A03,083465,Staff,18,0,30,12
1649979395290,COGS 2,A01,083966,Boyle; Mary E. T.,13,0,30,17
1649979401315,COGS 9,A01,083968,Staff,19,0,60,41
1649979407338,COGS 14B,A01,083970,Staff,13,0,50,37
1649979413362,COGS 17,A01,092679,Staff,56,0,75,19
1649979419385,COGS 100,A01,083972,Staff,0,13,60,60
1649979431436,COGS 101C,A01,083976,Staff,13,0,30,17
1649979437464,COGS 102A,A01,083978,Johnson; Christine M.,14,0,30,16
1649979443504,COGS 107B,A01,083980,Staff,0,6,50,50
1649979449527,COGS 115,A01,083982,Staff,11,0,30,19
1649979455552,COGS 118B,A01,083367,Staff,0,13,40,40
1649979461576,COGS 172,A01,083984,Provenzano; Emily Kara,15,0,30,15
1649979467605,COGS 177,A00,083368,Staff,0,21,30,30
1649979473628,COGS 186,A01,083986,Staff,21,0,40,19
1649979479658,COGS 187A,A01,083988,Boyle; Mary E. T.,20,0,60,40
1649979485681,CSE 8A,A50,084003,Miranda; Gregory Joseph,0,5,15,15
1649979491708,CSE 11,A01,084005,Miranda; Gregory Joseph,0,15,55,55
1649979497731,CSE 20,A01,084007,Staff,2,0,20,18
1649979503754,CSE 21,A01,084009,Staff,0,20,50,50
1649979509786,CSE 30,A01,083370,Cao; Yingjun,0,56,40,40
1649979515813,CSE 100,A01,083372,Cao; Yingjun,0,45,40,40
1649979521841,CSE 101,A01,084011,Staff,1,55,40,39
1649979527869,CSE 141,A01,083374,Eldon; John,0,58,75,75
1649979533893,CSE 141L,A01,083376,Eldon; John,0,64,75,75
1649979539915,CSE 175,A01,084013,Kumar; Rakesh,22,0,25,3
1649979545938,CSE 190,A00,092508,Dubnov; Shlomo,20,0,20,0
1649979551963,ECE 5,A01,084049,Morris; Karcher William,13,0,20,7
1649979557989,ECE 100,A01,084051,Baghdadchi; Saharnaz,0,0,20,20
1649979557989,ECE 100,A02,091916,Baghdadchi; Saharnaz,14,0,20,6
1649979564011,ECE 101,A01,084053,Baghdadchi; Saharnaz,2,0,37,35
1649979564011,ECE 101,A02,084054,Baghdadchi; Saharnaz,31,0,37,6
1649979570038,ECE 107,A01,083390,Staff,27,0,40,13
1649979576077,ECE 148,A01,084056,Silberman; Jack,8,0,12,4
1649979582103,ECE 180,A00,083391,Abi Samra; Nicholas Camill,25,0,30,5
1649979582103,ECE 180,B00,083392,Abi Samra; Nicholas Camill,21,0,30,9
1649979588134,MATH 10B,A01,084110,Staff,1,0,30,29
1649979588134,MATH 10B,A02,084111,Staff,27,0,30,3
1649979588134,MATH 10B,A03,084112,Staff,26,0,30,4
1649979594161,MATH 10C,A01,083443,Staff,0,3,30,30
1649979594161,MATH 10C,A02,083444,Staff,0,2,30,30
1649979594161,MATH 10C,B01,084114,Staff,22,0,30,8
1649979594161,MATH 10C,B02,084115,Staff,28,0,30,2
1649979600191,MATH 18,A01,084117,Harel; Guershon,22,0,30,8
1649979600191,MATH 18,A02,084119,Harel; Guershon,28,0,30,2
1649979600191,MATH 18,A03,084120,Harel; Guershon,30,0,30,0
1649979600191,MATH 18,A04,084121,Harel; Guershon,29,0,30,1
1649979606233,MATH 20B,A01,084124,Um; Ko Woon,26,0,35,9
1649979606233,MATH 20B,B01,084126,Um; Ko Woon,28,0,35,7
1649979612259,MATH 20C,A01,083446,Hammock; Frances H,9,0,30,21
1649979612259,MATH 20C,A02,083447,Hammock; Frances H,25,0,30,5
1649979612259,MATH 20C,A03,083448,Hammock; Frances H,27,0,30,3
1649979612259,MATH 20C,A04,083449,Hammock; Frances H,29,0,30,1
1649979612259,MATH 20C,B01,083451,Hammock; Frances H,15,0,30,15
1649979612259,MATH 20C,B02,083452,Hammock; Frances H,23,0,30,7
1649979612259,MATH 20C,B03,083453,Hammock; Frances H,25,0,30,5
1649979612259,MATH 20C,B04,083454,Hammock; Frances H,28,0,30,2
1649979618283,MATH 20D,A01,084128,Staff,19,0,30,11
1649979618283,MATH 20D,A02,084129,Staff,30,0,30,0
1649979618283,MATH 20D,A03,084130,Staff,27,0,30,3
1649979618283,MATH 20D,B01,084133,Staff,8,0,30,22
1649979618283,MATH 20D,B02,084134,Staff,24,0,30,6
1649979618283,MATH 20D,B03,084135,Staff,28,0,30,2
1649979624307,MATH 20E,A01,084138,Staff,16,0,30,14
1649979624307,MATH 20E,A02,084139,Staff,9,0,30,21
1649979624307,MATH 20E,A03,084140,Staff,15,0,30,15
1649979624307,MATH 20E,A04,084141,Staff,21,0,30,9
1649979630338,MATH 102,A01,084143,Harel; Guershon,13,0,30,17
1649979630338,MATH 102,A02,084144,Harel; Guershon,21,0,30,9
1649979636363,MATH 103B,A01,083456,Staff,0,12,30,30
1649979636363,MATH 103B,A02,083457,Staff,0,12,30,30
1649979642386,MATH 109,A01,084146,Salehi Golsefidy; Alireza,18,0,30,12
1649979642386,MATH 109,A02,084147,Salehi Golsefidy; Alireza,18,0,30,12
1649979648412,MATH 120A,A01,085445,Eggers; John Dietrich,15,0,35,20
1649979648412,MATH 120A,A02,085446,Eggers; John Dietrich,27,0,35,8
1649979654436,MATH 142B,A01,084149,Verstraete; Jacques Allan,0,12,30,30
1649979654436,MATH 142B,A02,084150,Verstraete; Jacques Allan,0,12,30,30
1649979660555,MATH 170A,A01,083459,Nie; Jiawang,1,8,30,29
1649979660555,MATH 170A,A02,083460,Nie; Jiawang,0,7,30,30
1649979660555,MATH 170A,A03,083461,Nie; Jiawang,0,7,30,30
1649979666578,MATH 193B,A01,083463,Staff,1,0,30,29
1649979666578,MATH 193B,A02,083464,Staff,10,0,30,20
1649979666578,MATH 193B,A03,083465,Staff,18,0,30,12
1649979672634,COGS 2,A01,083966,Boyle; Mary E. T.,12,0,30,18
1649979678656,COGS 9,A01,083968,Staff,19,0,60,41
1649979684679,COGS 14B,A01,083970,Staff,13,0,50,37
1649979690706,COGS 17,A01,092679,Staff,56,0,75,19
1649979696743,COGS 100,A01,083972,Staff,0,13,60,60
1649979708793,COGS 101C,A01,083976,Staff,13,0,30,17
1649979714820,COGS 102A,A01,083978,Johnson; Christine M.,14,0,30,16
1649979720846,COGS 107B,A01,083980,Staff,0,6,50,50
1649979726869,COGS 115,A01,083982,Staff,11,0,30,19
1649979732900,COGS 118B,A01,083367,Staff,0,13,40,40
1649979738924,COGS 172,A01,083984,Provenzano; Emily Kara,15,0,30,15
1649979744948,COGS 177,A00,083368,Staff,0,21,30,30
1649979750971,COGS 186,A01,083986,Staff,21,0,40,19
1649979756997,COGS 187A,A01,083988,Boyle; Mary E. T.,20,0,60,40
1649979763026,CSE 8A,A50,084003,Miranda; Gregory Joseph,0,5,15,15
1649979769069,CSE 11,A01,084005,Miranda; Gregory Joseph,0,15,55,55
1649979775093,CSE 20,A01,084007,Staff,2,0,20,18
1649979781119,CSE 21,A01,084009,Staff,0,20,50,50
1649979787142,CSE 30,A01,083370,Cao; Yingjun,0,56,40,40
1649979793165,CSE 100,A01,083372,Cao; Yingjun,0,45,40,40
1649979799187,CSE 101,A01,084011,Staff,1,55,40,39
1649979805214,CSE 141,A01,083374,Eldon; John,0,58,75,75
1649979811239,CSE 141L,A01,083376,Eldon; John,0,64,75,75
1649979817262,CSE 175,A01,084013,Kumar; Rakesh,22,0,25,3
1649979823285,CSE 190,A00,092508,Dubnov; Shlomo,20,0,20,0
1649979829311,ECE 5,A01,084049,Morris; Karcher William,13,0,20,7
1649979835346,ECE 100,A01,084051,Baghdadchi; Saharnaz,0,0,20,20
1649979835346,ECE 100,A02,091916,Baghdadchi; Saharnaz,14,0,20,6
1649979841372,ECE 101,A01,084053,Baghdadchi; Saharnaz,2,0,37,35
1649979841372,ECE 101,A02,084054,Baghdadchi; Saharnaz,31,0,37,6
1649979847400,ECE 107,A01,083390,Staff,27,0,40,13
1649979853430,ECE 148,A01,084056,Silberman; Jack,8,0,12,4
1649979859454,ECE 180,A00,083391,Abi Samra; Nicholas Camill,25,0,30,5
1649979859454,ECE 180,B00,083392,Abi Samra; Nicholas Camill,21,0,30,9
1649979865479,MATH 10B,A01,084110,Staff,1,0,30,29
1649979865479,MATH 10B,A02,084111,Staff,27,0,30,3
1649979865479,MATH 10B,A03,084112,Staff,26,0,30,4
1649979871507,MATH 10C,A01,083443,Staff,0,3,30,30
1649979871507,MATH 10C,A02,083444,Staff,0,3,30,30
1649979871507,MATH 10C,B01,084114,Staff,22,0,30,8
1649979871507,MATH 10C,B02,084115,Staff,28,0,30,2
1649979877529,MATH 18,A01,084117,Harel; Guershon,21,0,30,9
1649979877529,MATH 18,A02,084119,Harel; Guershon,28,0,30,2
1649979877529,MATH 18,A03,084120,Harel; Guershon,30,0,30,0
1649979877529,MATH 18,A04,084121,Harel; Guershon,29,0,30,1
1649979883557,MATH 20B,A01,084124,Um; Ko Woon,26,0,35,9
1649979883557,MATH 20B,B01,084126,Um; Ko Woon,28,0,35,7
1649979889585,MATH 20C,A01,083446,Hammock; Frances H,9,0,30,21
1649979889585,MATH 20C,A02,083447,Hammock; Frances H,25,0,30,5
1649979889585,MATH 20C,A03,083448,Hammock; Frances H,27,0,30,3
1649979889585,MATH 20C,A04,083449,Hammock; Frances H,29,0,30,1
1649979889585,MATH 20C,B01,083451,Hammock; Frances H,15,0,30,15
1649979889585,MATH 20C,B02,083452,Hammock; Frances H,23,0,30,7
1649979889585,MATH 20C,B03,083453,Hammock; Frances H,24,0,30,6
1649979889585,MATH 20C,B04,083454,Hammock; Frances H,28,0,30,2
1649979895608,MATH 20D,A01,084128,Staff,18,0,30,12
1649979895608,MATH 20D,A02,084129,Staff,30,0,30,0
1649979895608,MATH 20D,A03,084130,Staff,27,0,30,3
1649979895608,MATH 20D,B01,084133,Staff,8,0,30,22
1649979895608,MATH 20D,B02,084134,Staff,24,0,30,6
1649979895608,MATH 20D,B03,084135,Staff,28,0,30,2
1649979901640,MATH 20E,A01,084138,Staff,16,0,30,14
1649979901640,MATH 20E,A02,084139,Staff,9,0,30,21
1649979901640,MATH 20E,A03,084140,Staff,15,0,30,15
1649979901640,MATH 20E,A04,084141,Staff,21,0,30,9
1649979907669,MATH 102,A01,084143,Harel; Guershon,13,0,30,17
1649979907669,MATH 102,A02,084144,Harel; Guershon,21,0,30,9
1649979913703,MATH 103B,A01,083456,Staff,0,12,30,30
1649979913703,MATH 103B,A02,083457,Staff,0,12,30,30
1649979919726,MATH 109,A01,084146,Salehi Golsefidy; Alireza,18,0,30,12
1649979919726,MATH 109,A02,084147,Salehi Golsefidy; Alireza,18,0,30,12
1649979925751,MATH 120A,A01,085445,Eggers; John Dietrich,15,0,35,20
1649979925751,MATH 120A,A02,085446,Eggers; John Dietrich,27,0,35,8
1649979931787,MATH 142B,A01,084149,Verstraete; Jacques Allan,0,12,30,30
1649979931787,MATH 142B,A02,084150,Verstraete; Jacques Allan,0,12,30,30
1649979937817,MATH 170A,A01,083459,Nie; Jiawang,1,8,30,29
1649979937817,MATH 170A,A02,083460,Nie; Jiawang,0,7,30,30
1649979937817,MATH 170A,A03,083461,Nie; Jiawang,0,7,30,30
1649979943846,MATH 193B,A01,083463,Staff,1,0,30,29
1649979943846,MATH 193B,A02,083464,Staff,10,0,30,20
1649979943846,MATH 193B,A03,083465,Staff,18,0,30,12
1649979949906,COGS 2,A01,083966,Boyle; Mary E. T.,12,0,30,18
1649979955933,COGS 9,A01,083968,Staff,19,0,60,41
1649979961960,COGS 14B,A01,083970,Staff,13,0,50,37
1649979967983,COGS 17,A01,092679,Staff,56,0,75,19
1649979974008,COGS 100,A01,083972,Staff,0,13,60,60
1649979986065,COGS 101C,A01,083976,Staff,13,0,30,17
1649979992088,COGS 102A,A01,083978,Johnson; Christine M.,14,0,30,16
1649979998116,COGS 107B,A01,083980,Staff,0,6,50,50
1649980004141,COGS 115,A01,083982,Staff,11,0,30,19
1649980010166,COGS 118B,A01,083367,Staff,0,13,40,40
1649980016191,COGS 172,A01,083984,Provenzano; Emily Kara,15,0,30,15
1649980022219,COGS 177,A00,083368,Staff,0,21,30,30
1649980028245,COGS 186,A01,083986,Staff,21,0,40,19
1649980034269,COGS 187A,A01,083988,Boyle; Mary E. T.,20,0,60,40
1649980040292,CSE 8A,A50,084003,Miranda; Gregory Joseph,0,5,15,15
1649980046326,CSE 11,A01,084005,Miranda; Gregory Joseph,0,15,55,55
1649980052349,CSE 20,A01,084007,Staff,2,0,20,18
1649980058374,CSE 21,A01,084009,Staff,0,20,50,50
1649980064399,CSE 30,A01,083370,Cao; Yingjun,0,57,40,40
1649980070421,CSE 100,A01,083372,Cao; Yingjun,0,45,40,40
1649980076445,CSE 101,A01,084011,Staff,1,55,40,39
1649980082480,CSE 141,A01,083374,Eldon; John,0,58,75,75
1649980088508,CSE 141L,A01,083376,Eldon; John,0,64,75,75
1649980094536,CSE 175,A01,084013,Kumar; Rakesh,22,0,25,3
1649980100559,CSE 190,A00,092508,Dubnov; Shlomo,20,0,20,0
1649980106583,ECE 5,A01,084049,Morris; Karcher William,13,0,20,7
1649980112613,ECE 100,A01,084051,Baghdadchi; Saharnaz,0,0,20,20
1649980112613,ECE 100,A02,091916,Baghdadchi; Saharnaz,14,0,20,6
1649980118640,ECE 101,A01,084053,Baghdadchi; Saharnaz,2,0,37,35
1649980118640,ECE 101,A02,084054,Baghdadchi; Saharnaz,31,0,37,6
1649980124664,ECE 107,A01,083390,Staff,27,0,40,13
1649980130691,ECE 148,A01,084056,Silberman; Jack,8,0,12,4
1649980136714,ECE 180,A00,083391,Abi Samra; Nicholas Camill,25,0,30,5
1649980136714,ECE 180,B00,083392,Abi Samra; Nicholas Camill,21,0,30,9
1649980142738,MATH 10B,A01,084110,Staff,1,0,30,29
1649980142738,MATH 10B,A02,084111,Staff,27,0,30,3
1649980142738,MATH 10B,A03,084112,Staff,26,0,30,4
1649980148768,MATH 10C,A01,083443,Staff,0,3,30,30
1649980148768,MATH 10C,A02,083444,Staff,0,3,30,30
1649980148768,MATH 10C,B01,084114,Staff,22,0,30,8
1649980148768,MATH 10C,B02,084115,Staff,28,0,30,2
1649980154793,MATH 18,A01,084117,Harel; Guershon,21,0,30,9
1649980154793,MATH 18,A02,084119,Harel; Guershon,28,0,30,2
1649980154793,MATH 18,A03,084120,Harel; Guershon,30,0,30,0
1649980154793,MATH 18,A04,084121,Harel; Guershon,29,0,30,1
1649980160817,MATH 20B,A01,084124,Um; Ko Woon,26,0,35,9
1649980160817,MATH 20B,B01,084126,Um; Ko Woon,28,0,35,7
1649980166844,MATH 20C,A01,083446,Hammock; Frances H,9,0,30,21
1649980166844,MATH 20C,A02,083447,Hammock; Frances H,25,0,30,5
1649980166844,MATH 20C,A03,083448,Hammock; Frances H,27,0,30,3
1649980166844,MATH 20C,A04,083449,Hammock; Frances H,29,0,30,1
1649980166844,MATH 20C,B01,083451,Hammock; Frances H,15,0,30,15
1649980166844,MATH 20C,B02,083452,Hammock; Frances H,23,0,30,7
1649980166844,MATH 20C,B03,083453,Hammock; Frances H,24,0,30,6
1649980166844,MATH 20C,B04,083454,Hammock; Frances H,28,0,30,2
1649980172885,MATH 20D,A01,084128,Staff,18,0,30,12
1649980172885,MATH 20D,A02,084129,Staff,30,0,30,0
1649980172885,MATH 20D,A03,084130,Staff,27,0,30,3
1649980172885,MATH 20D,B01,084133,Staff,8,0,30,22
1649980172885,MATH 20D,B02,084134,Staff,24,0,30,6
1649980172885,MATH 20D,B03,084135,Staff,28,0,30,2
1649980178908,MATH 20E,A01,084138,Staff,16,0,30,14
1649980178908,MATH 20E,A02,084139,Staff,9,0,30,21
1649980178908,MATH 20E,A03,084140,Staff,15,0,30,15
1649980178908,MATH 20E,A04,084141,Staff,21,0,30,9
1649980184931,MATH 102,A01,084143,Harel; Guershon,13,0,30,17
1649980184931,MATH 102,A02,084144,Harel; Guershon,21,0,30,9
1649980190955,MATH 103B,A01,083456,Staff,0,12,30,30
1649980190955,MATH 103B,A02,083457,Staff,0,12,30,30
1649980196981,MATH 109,A01,084146,Salehi Golsefidy; Alireza,18,0,30,12
1649980196981,MATH 109,A02,084147,Salehi Golsefidy; Alireza,18,0,30,12
1649980203015,MATH 120A,A01,085445,Eggers; John Dietrich,15,0,35,20
1649980203015,MATH 120A,A02,085446,Eggers; John Dietrich,27,0,35,8
1649980209041,MATH 142B,A01,084149,Verstraete; Jacques Allan,0,12,30,30
1649980209041,MATH 142B,A02,084150,Verstraete; Jacques Allan,0,12,30,30
1649980215069,MATH 170A,A01,083459,Nie; Jiawang,1,8,30,29
1649980215069,MATH 170A,A02,083460,Nie; Jiawang,0,7,30,30
1649980215069,MATH 170A,A03,083461,Nie; Jiawang,0,7,30,30
1649980221093,MATH 193B,A01,083463,Staff,1,0,30,29
1649980221093,MATH 193B,A02,083464,Staff,10,0,30,20
1649980221093,MATH 193B,A03,083465,Staff,18,0,30,12
1649980227154,COGS 2,A01,083966,Boyle; Mary E. T.,11,0,30,19
1649980233187,COGS 9,A01,083968,Staff,19,0,60,41
1649980239223,COGS 14B,A01,083970,Staff,13,0,50,37
1649980245255,COGS 17,A01,092679,Staff,56,0,75,19
1649980251381,COGS 100,A01,083972,Staff,0,13,60,60
1649980263446,COGS 101C,A01,083976,Staff,13,0,30,17
1649980269489,COGS 102A,A01,083978,Johnson; Christine M.,14,0,30,16
1649980275516,COGS 107B,A01,083980,Staff,0,6,50,50
1649980281562,COGS 115,A01,083982,Staff,11,0,30,19
1649980287590,COGS 118B,A01,083367,Staff,0,13,40,40
1649980293622,COGS 172,A01,083984,Provenzano; Emily Kara,15,0,30,15
1649980299645,COGS 177,A00,083368,Staff,0,21,30,30
1649980305670,COGS 186,A01,083986,Staff,21,0,40,19
1649980311696,COGS 187A,A01,083988,Boyle; Mary E. T.,20,0,60,40
1649980317720,CSE 8A,A50,084003,Miranda; Gregory Joseph,0,5,15,15
1649980323748,CSE 11,A01,084005,Miranda; Gregory Joseph,0,15,55,55
1649980329773,CSE 20,A01,084007,Staff,1,0,20,19
1649980335799,CSE 21,A01,084009,Staff,0,20,50,50
1649980341824,CSE 30,A01,083370,Cao; Yingjun,0,58,40,40
1649980347848,CSE 100,A01,083372,Cao; Yingjun,0,45,40,40
1649980353880,CSE 101,A01,084011,Staff,1,55,40,39
1649980359907,CSE 141,A01,083374,Eldon; John,0,58,75,75
1649980365932,CSE 141L,A01,083376,Eldon; John,0,64,75,75
1649980371959,CSE 175,A01,084013,Kumar; Rakesh,22,0,25,3
1649980377980,CSE 190,A00,092508,Dubnov; Shlomo,20,0,20,0
1649980384023,ECE 5,A01,084049,Morris; Karcher William,13,0,20,7
1649980390046,ECE 100,A01,084051,Baghdadchi; Saharnaz,0,0,20,20
1649980390046,ECE 100,A02,091916,Baghdadchi; Saharnaz,14,0,20,6
1649980396081,ECE 101,A01,084053,Baghdadchi; Saharnaz,2,0,37,35
1649980396081,ECE 101,A02,084054,Baghdadchi; Saharnaz,31,0,37,6
1649980402107,ECE 107,A01,083390,Staff,27,0,40,13
1649980408130,ECE 148,A01,084056,Silberman; Jack,8,0,12,4
1649980414163,ECE 180,A00,083391,Abi Samra; Nicholas Camill,25,0,30,5
1649980414163,ECE 180,B00,083392,Abi Samra; Nicholas Camill,21,0,30,9
1649980420188,MATH 10B,A01,084110,Staff,1,0,30,29
1649980420188,MATH 10B,A02,084111,Staff,27,0,30,3
1649980420188,MATH 10B,A03,084112,Staff,26,0,30,4
1649980426225,MATH 10C,A01,083443,Staff,1,3,30,29
1649980426225,MATH 10C,A02,083444,Staff,1,3,30,29
1649980426225,MATH 10C,B01,084114,Staff,22,0,30,8
1649980426225,MATH 10C,B02,084115,Staff,28,0,30,2
1649980432248,MATH 18,A01,084117,Harel; Guershon,21,0,30,9
1649980432248,MATH 18,A02,084119,Harel; Guershon,28,0,30,2
1649980432248,MATH 18,A03,084120,Harel; Guershon,30,0,30,0
1649980432248,MATH 18,A04,084121,Harel; Guershon,29,0,30,1
1649980438278,MATH 20B,A01,084124,Um; Ko Woon,26,0,35,9
1649980438278,MATH 20B,B01,084126,Um; Ko Woon,28,0,35,7
1649980444304,MATH 20C,A01,083446,Hammock; Frances H,8,0,30,22
1649980444304,MATH 20C,A02,083447,Hammock; Frances H,25,0,30,5
1649980444304,MATH 20C,A03,083448,Hammock; Frances H,27,0,30,3
1649980444304,MATH 20C,A04,083449,Hammock; Frances H,29,0,30,1
1649980444304,MATH 20C,B01,083451,Hammock; Frances H,15,0,30,15
1649980444304,MATH 20C,B02,083452,Hammock; Frances H,23,0,30,7
1649980444304,MATH 20C,B03,083453,Hammock; Frances H,24,0,30,6
1649980444304,MATH 20C,B04,083454,Hammock; Frances H,28,0,30,2
1649980450328,MATH 20D,A01,084128,Staff,18,0,30,12
1649980450328,MATH 20D,A02,084129,Staff,29,0,30,1
1649980450328,MATH 20D,A03,084130,Staff,27,0,30,3
1649980450328,MATH 20D,B01,084133,Staff,8,0,30,22
1649980450328,MATH 20D,B02,084134,Staff,24,0,30,6
1649980450328,MATH 20D,B03,084135,Staff,28,0,30,2
1649980456356,MATH 20E,A01,084138,Staff,16,0,30,14
1649980456356,MATH 20E,A02,084139,Staff,9,0,30,21
1649980456356,MATH 20E,A03,084140,Staff,15,0,30,15
1649980456356,MATH 20E,A04,084141,Staff,21,0,30,9
1649980462379,MATH 102,A01,084143,Harel; Guershon,13,0,30,17
1649980462379,MATH 102,A02,084144,Harel; Guershon,21,0,30,9
1649980468403,MATH 103B,A01,083456,Staff,0,12,30,30
1649980468403,MATH 103B,A02,083457,Staff,0,12,30,30
1649980474437,MATH 109,A01,084146,Salehi Golsefidy; Alireza,18,0,30,12
1649980474437,MATH 109,A02,084147,Salehi Golsefidy; Alireza,17,0,30,13
1649980480461,MATH 120A,A01,085445,Eggers; John Dietrich,15,0,35,20
1649980480461,MATH 120A,A02,085446,Eggers; John Dietrich,27,0,35,8
1649980486488,MATH 142B,A01,084149,Verstraete; Jacques Allan,0,12,30,30
1649980486488,MATH 142B,A02,084150,Verstraete; Jacques Allan,0,12,30,30
1649980492512,MATH 170A,A01,083459,Nie; Jiawang,1,8,30,29
1649980492512,MATH 170A,A02,083460,Nie; Jiawang,0,7,30,30
1649980492512,MATH 170A,A03,083461,Nie; Jiawang,0,7,30,30
1649980498555,MATH 193B,A01,083463,Staff,1,0,30,29
1649980498555,MATH 193B,A02,083464,Staff,10,0,30,20
1649980498555,MATH 193B,A03,083465,Staff,18,0,30,12
1649980504608,COGS 2,A01,083966,Boyle; Mary E. T.,11,0,30,19
1649980510630,COGS 9,A01,083968,Staff,19,0,60,41
1649980516667,COGS 14B,A01,083970,Staff,13,0,50,37
1649980522693,COGS 17,A01,092679,Staff,56,0,75,19
1649980528716,COGS 100,A01,083972,Staff,0,13,60,60
1649980540771,COGS 101C,A01,083976,Staff,13,0,30,17
1649980546796,COGS 102A,A01,083978,Johnson; Christine M.,14,0,30,16
1649980552825,COGS 107B,A01,083980,Staff,0,6,50,50
1649980558848,COGS 115,A01,083982,Staff,11,0,30,19
1649980564870,COGS 118B,A01,083367,Staff,0,13,40,40
1649980570910,COGS 172,A01,083984,Provenzano; Emily Kara,15,0,30,15
1649980576934,COGS 177,A00,083368,Staff,0,21,30,30
1649980582958,COGS 186,A01,083986,Staff,21,0,40,19
1649980588988,COGS 187A,A01,083988,Boyle; Mary E. T.,20,0,60,40
1649980595010,CSE 8A,A50,084003,Miranda; Gregory Joseph,0,6,15,15
1649980601041,CSE 11,A01,084005,Miranda; Gregory Joseph,0,16,55,55
1649980607072,CSE 20,A01,084007,Staff,1,0,20,19
1649980613098,CSE 21,A01,084009,Staff,0,20,50,50
1649980619123,CSE 30,A01,083370,Cao; Yingjun,0,58,40,40
1649980625145,CSE 100,A01,083372,Cao; Yingjun,0,45,40,40
1649980631184,CSE 101,A01,084011,Staff,1,55,40,39
1649980637209,CSE 141,A01,083374,Eldon; John,0,58,75,75
1649980643240,CSE 141L,A01,083376,Eldon; John,0,64,75,75
1649980649263,CSE 175,A01,084013,Kumar; Rakesh,22,0,25,3
1649980655286,CSE 190,A00,092508,Dubnov; Shlomo,20,0,20,0
1649980661308,ECE 5,A01,084049,Morris; Karcher William,13,0,20,7
1649980667332,ECE 100,A01,084051,Baghdadchi; Saharnaz,0,0,20,20
1649980667332,ECE 100,A02,091916,Baghdadchi; Saharnaz,14,0,20,6
1649980673358,ECE 101,A01,084053,Baghdadchi; Saharnaz,2,0,37,35
1649980673358,ECE 101,A02,084054,Baghdadchi; Saharnaz,31,0,37,6
1649980679384,ECE 107,A01,083390,Staff,27,0,40,13
1649980685409,ECE 148,A01,084056,Silberman; Jack,8,0,12,4
1649980691430,ECE 180,A00,083391,Abi Samra; Nicholas Camill,25,0,30,5
1649980691430,ECE 180,B00,083392,Abi Samra; Nicholas Camill,21,0,30,9
1649980697454,MATH 10B,A01,084110,Staff,1,0,30,29
1649980697454,MATH 10B,A02,084111,Staff,27,0,30,3
1649980697454,MATH 10B,A03,084112,Staff,26,0,30,4
1649980703477,MATH 10C,A01,083443,Staff,1,3,30,29
1649980703477,MATH 10C,A02,083444,Staff,1,3,30,29
1649980703477,MATH 10C,B01,084114,Staff,22,0,30,8
1649980703477,MATH 10C,B02,084115,Staff,28,0,30,2
1649980709507,MATH 18,A01,084117,Harel; Guershon,21,0,30,9
1649980709507,MATH 18,A02,084119,Harel; Guershon,28,0,30,2
1649980709507,MATH 18,A03,084120,Harel; Guershon,30,0,30,0
1649980709507,MATH 18,A04,084121,Harel; Guershon,29,0,30,1
1649980715533,MATH 20B,A01,084124,Um; Ko Woon,26,0,35,9
1649980715533,MATH 20B,B01,084126,Um; Ko Woon,28,0,35,7
1649980721566,MATH 20C,A01,083446,Hammock; Frances H,8,0,30,22
1649980721566,MATH 20C,A02,083447,Hammock; Frances H,24,0,30,6
1649980721566,MATH 20C,A03,083448,Hammock; Frances H,27,0,30,3
1649980721566,MATH 20C,A04,083449,Hammock; Frances H,29,0,30,1
1649980721566,MATH 20C,B01,083451,Hammock; Frances H,15,0,30,15
1649980721566,MATH 20C,B02,083452,Hammock; Frances H,23,0,30,7
1649980721566,MATH 20C,B03,083453,Hammock; Frances H,24,0,30,6
1649980721566,MATH 20C,B04,083454,Hammock; Frances H,28,0,30,2
1649980727592,MATH 20D,A01,084128,Staff,18,0,30,12
1649980727592,MATH 20D,A02,084129,Staff,30,0,30,0
1649980727592,MATH 20D,A03,084130,Staff,27,0,30,3
1649980727592,MATH 20D,B01,084133,Staff,8,0,30,22
1649980727592,MATH 20D,B02,084134,Staff,24,0,30,6
1649980727592,MATH 20D,B03,084135,Staff,28,0,30,2
1649980733619,MATH 20E,A01,084138,Staff,16,0,30,14
1649980733619,MATH 20E,A02,084139,Staff,9,0,30,21
1649980733619,MATH 20E,A03,084140,Staff,15,0,30,15
1649980733619,MATH 20E,A04,084141,Staff,21,0,30,9
1649980739646,MATH 102,A01,084143,Harel; Guershon,13,0,30,17
1649980739646,MATH 102,A02,084144,Harel; Guershon,21,0,30,9
1649980745680,MATH 103B,A01,083456,Staff,0,12,30,30
1649980745680,MATH 103B,A02,083457,Staff,0,12,30,30
1649980751710,MATH 109,A01,084146,Salehi Golsefidy; Alireza,18,0,30,12
1649980751710,MATH 109,A02,084147,Salehi Golsefidy; Alireza,17,0,30,13
1649980757738,MATH 120A,A01,085445,Eggers; John Dietrich,15,0,35,20
1649980757738,MATH 120A,A02,085446,Eggers; John Dietrich,27,0,35,8
1649980763776,MATH 142B,A01,084149,Verstraete; Jacques Allan,0,12,30,30
1649980763776,MATH 142B,A02,084150,Verstraete; Jacques Allan,0,12,30,30
1649980769810,MATH 170A,A01,083459,Nie; Jiawang,1,8,30,29
1649980769810,MATH 170A,A02,083460,Nie; Jiawang,0,7,30,30
1649980769810,MATH 170A,A03,083461,Nie; Jiawang,0,7,30,30
1649980775831,MATH 193B,A01,083463,Staff,1,0,30,29
1649980775831,MATH 193B,A02,083464,Staff,10,0,30,20
1649980775831,MATH 193B,A03,083465,Staff,18,0,30,12
1649980781881,COGS 2,A01,083966,Boyle; Mary E. T.,11,0,30,19
1649980787904,COGS 9,A01,083968,Staff,19,0,60,41
1649980793944,COGS 14B,A01,083970,Staff,13,0,50,37
1649980799970,COGS 17,A01,092679,Staff,56,0,75,19
1649980805997,COGS 100,A01,083972,Staff,0,14,60,60
1649980818055,COGS 101C,A01,083976,Staff,13,0,30,17
1649980824079,COGS 102A,A01,083978,Johnson; Christine M.,14,0,30,16
1649980830101,COGS 107B,A01,083980,Staff,0,6,50,50
1649980836136,COGS 115,A01,083982,Staff,11,0,30,19
1649980842161,COGS 118B,A01,083367,Staff,0,13,40,40
1649980848255,COGS 172,A01,083984,Provenzano; Emily Kara,15,0,30,15
1649980854290,COGS 177,A00,083368,Staff,0,21,30,30
1649980860316,COGS 186,A01,083986,Staff,21,0,40,19
1649980866365,COGS 187A,A01,083988,Boyle; Mary E. T.,20,0,60,40
1649980872393,CSE 8A,A50,084003,Miranda; Gregory Joseph,0,6,15,15
1649980878442,CSE 11,A01,084005,Miranda; Gregory Joseph,0,16,55,55
1649980884466,CSE 20,A01,084007,Staff,1,0,20,19
1649980890494,CSE 21,A01,084009,Staff,0,20,50,50
1649980896546,CSE 30,A01,083370,Cao; Yingjun,0,58,40,40
1649980902569,CSE 100,A01,083372,Cao; Yingjun,0,45,40,40
1649980908598,CSE 101,A01,084011,Staff,1,55,40,39
1649980914625,CSE 141,A01,083374,Eldon; John,0,58,75,75
1649980920651,CSE 141L,A01,083376,Eldon; John,0,64,75,75
1649980926678,CSE 175,A01,084013,Kumar; Rakesh,22,0,25,3
1649980932702,CSE 190,A00,092508,Dubnov; Shlomo,20,0,20,0
1649980938724,ECE 5,A01,084049,Morris; Karcher William,13,0,20,7
1649980944760,ECE 100,A01,084051,Baghdadchi; Saharnaz,0,0,20,20
1649980944760,ECE 100,A02,091916,Baghdadchi; Saharnaz,14,0,20,6
1649980950801,ECE 101,A01,084053,Baghdadchi; Saharnaz,2,0,37,35
1649980950801,ECE 101,A02,084054,Baghdadchi; Saharnaz,31,0,37,6
1649980956829,ECE 107,A01,083390,Staff,27,0,40,13
1649980962865,ECE 148,A01,084056,Silberman; Jack,8,0,12,4
1649980968888,ECE 180,A00,083391,Abi Samra; Nicholas Camill,25,0,30,5
1649980968888,ECE 180,B00,083392,Abi Samra; Nicholas Camill,21,0,30,9
1649980974911,MATH 10B,A01,084110,Staff,1,0,30,29
1649980974911,MATH 10B,A02,084111,Staff,27,0,30,3
1649980974911,MATH 10B,A03,084112,Staff,26,0,30,4
1649980980934,MATH 10C,A01,083443,Staff,1,3,30,29
1649980980934,MATH 10C,A02,083444,Staff,1,3,30,29
1649980980934,MATH 10C,B01,084114,Staff,22,0,30,8
1649980980934,MATH 10C,B02,084115,Staff,27,0,30,3
1649980986958,MATH 18,A01,084117,Harel; Guershon,21,0,30,9
1649980986958,MATH 18,A02,084119,Harel; Guershon,28,0,30,2
1649980986958,MATH 18,A03,084120,Harel; Guershon,30,0,30,0
1649980986958,MATH 18,A04,084121,Harel; Guershon,29,0,30,1
1649980992980,MATH 20B,A01,084124,Um; Ko Woon,26,0,35,9
1649980992980,MATH 20B,B01,084126,Um; Ko Woon,28,0,35,7
1649980999018,MATH 20C,A01,083446,Hammock; Frances H,6,0,30,24
1649980999018,MATH 20C,A02,083447,Hammock; Frances H,24,0,30,6
1649980999018,MATH 20C,A03,083448,Hammock; Frances H,27,0,30,3
1649980999018,MATH 20C,A04,083449,Hammock; Frances H,29,0,30,1
1649980999018,MATH 20C,B01,083451,Hammock; Frances H,15,0,30,15
1649980999018,MATH 20C,B02,083452,Hammock; Frances H,23,0,30,7
1649980999018,MATH 20C,B03,083453,Hammock; Frances H,24,0,30,6
1649980999018,MATH 20C,B04,083454,Hammock; Frances H,28,0,30,2
1649981005042,MATH 20D,A01,084128,Staff,18,0,30,12
1649981005042,MATH 20D,A02,084129,Staff,30,0,30,0
1649981005042,MATH 20D,A03,084130,Staff,27,0,30,3
1649981005042,MATH 20D,B01,084133,Staff,8,0,30,22
1649981005042,MATH 20D,B02,084134,Staff,24,0,30,6
1649981005042,MATH 20D,B03,084135,Staff,28,0,30,2
1649981011068,MATH 20E,A01,084138,Staff,16,0,30,14
1649981011068,MATH 20E,A02,084139,Staff,8,0,30,22
1649981011068,MATH 20E,A03,084140,Staff,15,0,30,15
1649981011068,MATH 20E,A04,084141,Staff,21,0,30,9
1649981017106,MATH 102,A01,084143,Harel; Guershon,13,0,30,17
1649981017106,MATH 102,A02,084144,Harel; Guershon,21,0,30,9
1649981023129,MATH 103B,A01,083456,Staff,0,12,30,30
1649981023129,MATH 103B,A02,083457,Staff,0,12,30,30
1649981029150,MATH 109,A01,084146,Salehi Golsefidy; Alireza,18,0,30,12
1649981029150,MATH 109,A02,084147,Salehi Golsefidy; Alireza,17,0,30,13
1649981035185,MATH 120A,A01,085445,Eggers; John Dietrich,15,0,35,20
1649981035185,MATH 120A,A02,085446,Eggers; John Dietrich,27,0,35,8
1649981041219,MATH 142B,A01,084149,Verstraete; Jacques Allan,0,12,30,30
1649981041219,MATH 142B,A02,084150,Verstraete; Jacques Allan,0,12,30,30
1649981047253,MATH 170A,A01,083459,Nie; Jiawang,1,8,30,29
1649981047253,MATH 170A,A02,083460,Nie; Jiawang,0,7,30,30
1649981047253,MATH 170A,A03,083461,Nie; Jiawang,0,7,30,30
1649981053281,MATH 193B,A01,083463,Staff,1,0,30,29
1649981053281,MATH 193B,A02,083464,Staff,10,0,30,20
1649981053281,MATH 193B,A03,083465,Staff,18,0,30,12
1649981059332,COGS 2,A01,083966,Boyle; Mary E. T.,11,0,30,19
1649981065355,COGS 9,A01,083968,Staff,19,0,60,41
1649981071381,COGS 14B,A01,083970,Staff,13,0,50,37
1649981077405,COGS 17,A01,092679,Staff,56,0,75,19
1649981083427,COGS 100,A01,083972,Staff,0,14,60,60
1649981095511,COGS 101C,A01,083976,Staff,13,0,30,17
1649981101540,COGS 102A,A01,083978,Johnson; Christine M.,14,0,30,16
1649981107563,COGS 107B,A01,083980,Staff,0,6,50,50
1649981113588,COGS 115,A01,083982,Staff,11,0,30,19
1649981119635,COGS 118B,A01,083367,Staff,0,13,40,40
1649981125676,COGS 172,A01,083984,Provenzano; Emily Kara,15,0,30,15
1649981131698,COGS 177,A00,083368,Staff,0,21,30,30
1649981137722,COGS 186,A01,083986,Staff,21,0,40,19
1649981143745,COGS 187A,A01,083988,Boyle; Mary E. T.,20,0,60,40
1649981149772,CSE 8A,A50,084003,Miranda; Gregory Joseph,0,6,15,15
1649981155805,CSE 11,A01,084005,Miranda; Gregory Joseph,0,16,55,55
1649981161830,CSE 20,A01,084007,Staff,0,0,20,20
1649981167854,CSE 21,A01,084009,Staff,0,20,50,50
1649981173876,CSE 30,A01,083370,Cao; Yingjun,0,58,40,40
1649981179900,CSE 100,A01,083372,Cao; Yingjun,0,45,40,40
1649981185927,CSE 101,A01,084011,Staff,1,55,40,39
1649981191958,CSE 141,A01,083374,Eldon; John,0,59,75,75
1649981197991,CSE 141L,A01,083376,Eldon; John,0,65,75,75
1649981204019,CSE 175,A01,084013,Kumar; Rakesh,22,0,25,3
1649981210045,CSE 190,A00,092508,Dubnov; Shlomo,20,0,20,0
1649981216071,ECE 5,A01,084049,Morris; Karcher William,13,0,20,7
1649981222094,ECE 100,A01,084051,Baghdadchi; Saharnaz,0,0,20,20
1649981222094,ECE 100,A02,091916,Baghdadchi; Saharnaz,14,0,20,6
1649981228118,ECE 101,A01,084053,Baghdadchi; Saharnaz,2,0,37,35
1649981228118,ECE 101,A02,084054,Baghdadchi; Saharnaz,31,0,37,6
1649981234149,ECE 107,A01,083390,Staff,27,0,40,13
1649981240172,ECE 148,A01,084056,Silberman; Jack,8,0,12,4
1649981246205,ECE 180,A00,083391,Abi Samra; Nicholas Camill,25,0,30,5
1649981246205,ECE 180,B00,083392,Abi Samra; Nicholas Camill,21,0,30,9
1649981252233,MATH 10B,A01,084110,Staff,1,0,30,29
1649981252233,MATH 10B,A02,084111,Staff,26,0,30,4
1649981252233,MATH 10B,A03,084112,Staff,26,0,30,4
1649981258258,MATH 10C,A01,083443,Staff,1,3,30,29
1649981258258,MATH 10C,A02,083444,Staff,1,3,30,29
1649981258258,MATH 10C,B01,084114,Staff,22,0,30,8
1649981258258,MATH 10C,B02,084115,Staff,27,0,30,3
1649981264282,MATH 18,A01,084117,Harel; Guershon,21,0,30,9
1649981264282,MATH 18,A02,084119,Harel; Guershon,28,0,30,2
1649981264282,MATH 18,A03,084120,Harel; Guershon,30,0,30,0
1649981264282,MATH 18,A04,084121,Harel; Guershon,29,0,30,1
1649981270311,MATH 20B,A01,084124,Um; Ko Woon,26,0,35,9
1649981270311,MATH 20B,B01,084126,Um; Ko Woon,28,0,35,7
1649981276339,MATH 20C,A01,083446,Hammock; Frances H,6,0,30,24
1649981276339,MATH 20C,A02,083447,Hammock; Frances H,25,0,30,5
1649981276339,MATH 20C,A03,083448,Hammock; Frances H,27,0,30,3
1649981276339,MATH 20C,A04,083449,Hammock; Frances H,29,0,30,1
1649981276339,MATH 20C,B01,083451,Hammock; Frances H,14,0,30,16
1649981276339,MATH 20C,B02,083452,Hammock; Frances H,23,0,30,7
1649981276339,MATH 20C,B03,083453,Hammock; Frances H,24,0,30,6
1649981276339,MATH 20C,B04,083454,Hammock; Frances H,28,0,30,2
1649981282363,MATH 20D,A01,084128,Staff,18,0,30,12
1649981282363,MATH 20D,A02,084129,Staff,30,0,30,0
1649981282363,MATH 20D,A03,084130,Staff,27,0,30,3
1649981282363,MATH 20D,B01,084133,Staff,8,0,30,22
1649981282363,MATH 20D,B02,084134,Staff,24,0,30,6
1649981282363,MATH 20D,B03,084135,Staff,28,0,30,2
1649981288387,MATH 20E,A01,084138,Staff,16,0,30,14
1649981288387,MATH 20E,A02,084139,Staff,8,0,30,22
1649981288387,MATH 20E,A03,084140,Staff,15,0,30,15
1649981288387,MATH 20E,A04,084141,Staff,21,0,30,9
1649981294415,MATH 102,A01,084143,Harel; Guershon,13,0,30,17
1649981294415,MATH 102,A02,084144,Harel; Guershon,21,0,30,9
1649981300438,MATH 103B,A01,083456,Staff,0,12,30,30
1649981300438,MATH 103B,A02,083457,Staff,0,12,30,30
1649981306460,MATH 109,A01,084146,Salehi Golsefidy; Alireza,18,0,30,12
1649981306460,MATH 109,A02,084147,Salehi Golsefidy; Alireza,17,0,30,13
1649981312486,MATH 120A,A01,085445,Eggers; John Dietrich,15,0,35,20
1649981312486,MATH 120A,A02,085446,Eggers; John Dietrich,27,0,35,8
1649981318515,MATH 142B,A01,084149,Verstraete; Jacques Allan,0,12,30,30
1649981318515,MATH 142B,A02,084150,Verstraete; Jacques Allan,0,12,30,30
1649981324549,MATH 170A,A01,083459,Nie; Jiawang,1,8,30,29
1649981324549,MATH 170A,A02,083460,Nie; Jiawang,0,6,30,30
1649981324549,MATH 170A,A03,083461,Nie; Jiawang,0,7,30,30
1649981330580,MATH 193B,A01,083463,Staff,1,0,30,29
1649981330580,MATH 193B,A02,083464,Staff,10,0,30,20
1649981330580,MATH 193B,A03,083465,Staff,18,0,30,12
1649981336632,COGS 2,A01,083966,Boyle; Mary E. T.,10,0,30,20
1649981342655,COGS 9,A01,083968,Staff,18,0,60,42
1649981348684,COGS 14B,A01,083970,Staff,13,0,50,37
1649981354713,COGS 17,A01,092679,Staff,56,0,75,19
1649981360735,COGS 100,A01,083972,Staff,0,14,60,60
1649981372794,COGS 101C,A01,083976,Staff,13,0,30,17
1649981378833,COGS 102A,A01,083978,Johnson; Christine M.,14,0,30,16
1649981384861,COGS 107B,A01,083980,Staff,0,6,50,50
1649981390900,COGS 115,A01,083982,Staff,11,0,30,19
1649981396922,COGS 118B,A01,083367,Staff,0,13,40,40
1649981402952,COGS 172,A01,083984,Provenzano; Emily Kara,15,0,30,15
1649981408979,COGS 177,A00,083368,Staff,0,21,30,30
1649981415008,COGS 186,A01,083986,Staff,21,0,40,19
1649981421034,COGS 187A,A01,083988,Boyle; Mary E. T.,20,0,60,40
1649981427060,CSE 8A,A50,084003,Miranda; Gregory Joseph,0,6,15,15
1649981433082,CSE 11,A01,084005,Miranda; Gregory Joseph,0,16,55,55
1649981439106,CSE 20,A01,084007,Staff,0,0,20,20
1649981445228,CSE 21,A01,084009,Staff,0,20,50,50
1649981451252,CSE 30,A01,083370,Cao; Yingjun,0,58,40,40
1649981457279,CSE 100,A01,083372,Cao; Yingjun,0,45,40,40
1649981463302,CSE 101,A01,084011,Staff,1,55,40,39
1649981469325,CSE 141,A01,083374,Eldon; John,0,59,75,75
1649981475363,CSE 141L,A01,083376,Eldon; John,0,65,75,75
1649981481391,CSE 175,A01,084013,Kumar; Rakesh,22,0,25,3
1649981487413,CSE 190,A00,092508,Dubnov; Shlomo,20,0,20,0
1649981493450,ECE 5,A01,084049,Morris; Karcher William,13,0,20,7
1649981499476,ECE 100,A01,084051,Baghdadchi; Saharnaz,0,0,20,20
1649981499476,ECE 100,A02,091916,Baghdadchi; Saharnaz,14,0,20,6
1649981505503,ECE 101,A01,084053,Baghdadchi; Saharnaz,2,0,37,35
1649981505503,ECE 101,A02,084054,Baghdadchi; Saharnaz,31,0,37,6
1649981511542,ECE 107,A01,083390,Staff,27,0,40,13
1649981517568,ECE 148,A01,084056,Silberman; Jack,8,0,12,4
1649981523591,ECE 180,A00,083391,Abi Samra; Nicholas Camill,25,0,30,5
1649981523591,ECE 180,B00,083392,Abi Samra; Nicholas Camill,21,0,30,9
1649981529619,MATH 10B,A01,084110,Staff,1,0,30,29
1649981529619,MATH 10B,A02,084111,Staff,26,0,30,4
1649981529619,MATH 10B,A03,084112,Staff,26,0,30,4
1649981535643,MATH 10C,A01,083443,Staff,1,4,30,29
1649981535643,MATH 10C,A02,083444,Staff,1,3,30,29
1649981535643,MATH 10C,B01,084114,Staff,22,0,30,8
1649981535643,MATH 10C,B02,084115,Staff,27,0,30,3
1649981541667,MATH 18,A01,084117,Harel; Guershon,21,0,30,9
1649981541667,MATH 18,A02,084119,Harel; Guershon,28,0,30,2
1649981541667,MATH 18,A03,084120,Harel; Guershon,30,0,30,0
1649981541667,MATH 18,A04,084121,Harel; Guershon,29,0,30,1
1649981547698,MATH 20B,A01,084124,Um; Ko Woon,26,0,35,9
1649981547698,MATH 20B,B01,084126,Um; Ko Woon,28,0,35,7
1649981553734,MATH 20C,A01,083446,Hammock; Frances H,5,0,30,25
1649981553734,MATH 20C,A02,083447,Hammock; Frances H,25,0,30,5
1649981553734,MATH 20C,A03,083448,Hammock; Frances H,27,0,30,3
1649981553734,MATH 20C,A04,083449,Hammock; Frances H,29,0,30,1
1649981553734,MATH 20C,B01,083451,Hammock; Frances H,13,0,30,17
1649981553734,MATH 20C,B02,083452,Hammock; Frances H,23,0,30,7
1649981553734,MATH 20C,B03,083453,Hammock; Frances H,24,0,30,6
1649981553734,MATH 20C,B04,083454,Hammock; Frances H,27,0,30,3
1649981559768,MATH 20D,A01,084128,Staff,18,0,30,12
1649981559768,MATH 20D,A02,084129,Staff,30,0,30,0
1649981559768,MATH 20D,A03,084130,Staff,27,0,30,3
1649981559768,MATH 20D,B01,084133,Staff,8,0,30,22
1649981559768,MATH 20D,B02,084134,Staff,24,0,30,6
1649981559768,MATH 20D,B03,084135,Staff,28,0,30,2
1649981565794,MATH 20E,A01,084138,Staff,16,0,30,14
1649981565794,MATH 20E,A02,084139,Staff,7,0,30,23
1649981565794,MATH 20E,A03,084140,Staff,15,0,30,15
1649981565794,MATH 20E,A04,084141,Staff,21,0,30,9
1649981571829,MATH 102,A01,084143,Harel; Guershon,13,0,30,17
1649981571829,MATH 102,A02,084144,Harel; Guershon,21,0,30,9
1649981577857,MATH 103B,A01,083456,Staff,0,12,30,30
1649981577857,MATH 103B,A02,083457,Staff,0,12,30,30
1649981583881,MATH 109,A01,084146,Salehi Golsefidy; Alireza,18,0,30,12
1649981583881,MATH 109,A02,084147,Salehi Golsefidy; Alireza,17,0,30,13
1649981589905,MATH 120A,A01,085445,Eggers; John Dietrich,15,0,35,20
1649981589905,MATH 120A,A02,085446,Eggers; John Dietrich,27,0,35,8
1649981595927,MATH 142B,A01,084149,Verstraete; Jacques Allan,0,12,30,30
1649981595927,MATH 142B,A02,084150,Verstraete; Jacques Allan,0,12,30,30
1649981601951,MATH 170A,A01,083459,Nie; Jiawang,1,8,30,29
1649981601951,MATH 170A,A02,083460,Nie; Jiawang,0,7,30,30
1649981601951,MATH 170A,A03,083461,Nie; Jiawang,0,7,30,30
1649981608002,MATH 193B,A01,083463,Staff,1,0,30,29
1649981608002,MATH 193B,A02,083464,Staff,10,0,30,20
1649981608002,MATH 193B,A03,083465,Staff,18,0,30,12
1649981614053,COGS 2,A01,083966,Boyle; Mary E. T.,10,0,30,20
1649981620077,COGS 9,A01,083968,Staff,18,0,60,42
1649981626117,COGS 14B,A01,083970,Staff,13,0,50,37
1649981632141,COGS 17,A01,092679,Staff,56,0,75,19
1649981638164,COGS 100,A01,083972,Staff,0,14,60,60
1649981650212,COGS 101C,A01,083976,Staff,13,0,30,17
1649981656236,COGS 102A,A01,083978,Johnson; Christine M.,14,0,30,16
1649981662263,COGS 107B,A01,083980,Staff,0,6,50,50
1649981668288,COGS 115,A01,083982,Staff,11,0,30,19
1649981674312,COGS 118B,A01,083367,Staff,0,13,40,40
1649981680335,COGS 172,A01,083984,Provenzano; Emily Kara,15,0,30,15
1649981686362,COGS 177,A00,083368,Staff,0,21,30,30
1649981692389,COGS 186,A01,083986,Staff,21,0,40,19
1649981698417,COGS 187A,A01,083988,Boyle; Mary E. T.,20,0,60,40
1649981704440,CSE 8A,A50,084003,Miranda; Gregory Joseph,0,6,15,15
1649981710463,CSE 11,A01,084005,Miranda; Gregory Joseph,0,16,55,55
1649981716490,CSE 20,A01,084007,Staff,0,0,20,20
1649981722528,CSE 21,A01,084009,Staff,0,20,50,50
1649981728553,CSE 30,A01,083370,Cao; Yingjun,0,58,40,40
1649981734582,CSE 100,A01,083372,Cao; Yingjun,0,45,40,40
1649981740614,CSE 101,A01,084011,Staff,1,55,40,39
1649981746638,CSE 141,A01,083374,Eldon; John,0,59,75,75
1649981752662,CSE 141L,A01,083376,Eldon; John,0,65,75,75
1649981758684,CSE 175,A01,084013,Kumar; Rakesh,22,0,25,3
1649981764716,CSE 190,A00,092508,Dubnov; Shlomo,20,0,20,0
1649981770741,ECE 5,A01,084049,Morris; Karcher William,13,0,20,7
1649981776776,ECE 100,A01,084051,Baghdadchi; Saharnaz,0,0,20,20
1649981776776,ECE 100,A02,091916,Baghdadchi; Saharnaz,14,0,20,6
1649981782803,ECE 101,A01,084053,Baghdadchi; Saharnaz,2,0,37,35
1649981782803,ECE 101,A02,084054,Baghdadchi; Saharnaz,31,0,37,6
1649981788827,ECE 107,A01,083390,Staff,27,0,40,13
1649981794849,ECE 148,A01,084056,Silberman; Jack,8,0,12,4
1649981800873,ECE 180,A00,083391,Abi Samra; Nicholas Camill,25,0,30,5
1649981800873,ECE 180,B00,083392,Abi Samra; Nicholas Camill,21,0,30,9
1649981806900,MATH 10B,A01,084110,Staff,1,0,30,29
1649981806900,MATH 10B,A02,084111,Staff,26,0,30,4
1649981806900,MATH 10B,A03,084112,Staff,26,0,30,4
1649981812937,MATH 10C,A01,083443,Staff,1,4,30,29
1649981812937,MATH 10C,A02,083444,Staff,1,3,30,29
1649981812937,MATH 10C,B01,084114,Staff,22,0,30,8
1649981812937,MATH 10C,B02,084115,Staff,27,0,30,3
1649981818959,MATH 18,A01,084117,Harel; Guershon,21,0,30,9
1649981818959,MATH 18,A02,084119,Harel; Guershon,28,0,30,2
1649981818959,MATH 18,A03,084120,Harel; Guershon,30,0,30,0
1649981818959,MATH 18,A04,084121,Harel; Guershon,29,0,30,1
1649981824988,MATH 20B,A01,084124,Um; Ko Woon,26,0,35,9
1649981824988,MATH 20B,B01,084126,Um; Ko Woon,28,0,35,7
1649981831022,MATH 20C,A01,083446,Hammock; Frances H,5,0,30,25
1649981831022,MATH 20C,A02,083447,Hammock; Frances H,25,0,30,5
1649981831022,MATH 20C,A03,083448,Hammock; Frances H,27,0,30,3
1649981831022,MATH 20C,A04,083449,Hammock; Frances H,29,0,30,1
1649981831022,MATH 20C,B01,083451,Hammock; Frances H,13,0,30,17
1649981831022,MATH 20C,B02,083452,Hammock; Frances H,23,0,30,7
1649981831022,MATH 20C,B03,083453,Hammock; Frances H,24,0,30,6
1649981831022,MATH 20C,B04,083454,Hammock; Frances H,27,0,30,3
1649981837047,MATH 20D,A01,084128,Staff,18,0,30,12
1649981837047,MATH 20D,A02,084129,Staff,30,0,30,0
1649981837047,MATH 20D,A03,084130,Staff,27,0,30,3
1649981837047,MATH 20D,B01,084133,Staff,7,0,30,23
1649981837047,MATH 20D,B02,084134,Staff,24,0,30,6
1649981837047,MATH 20D,B03,084135,Staff,28,0,30,2
1649981843091,MATH 20E,A01,084138,Staff,16,0,30,14
1649981843091,MATH 20E,A02,084139,Staff,7,0,30,23
1649981843091,MATH 20E,A03,084140,Staff,15,0,30,15
1649981843091,MATH 20E,A04,084141,Staff,21,0,30,9
1649981849124,MATH 102,A01,084143,Harel; Guershon,13,0,30,17
1649981849124,MATH 102,A02,084144,Harel; Guershon,21,0,30,9
1649981855152,MATH 103B,A01,083456,Staff,0,12,30,30
1649981855152,MATH 103B,A02,083457,Staff,0,12,30,30
1649981861187,MATH 109,A01,084146,Salehi Golsefidy; Alireza,18,0,30,12
1649981861187,MATH 109,A02,084147,Salehi Golsefidy; Alireza,17,0,30,13
1649981867222,MATH 120A,A01,085445,Eggers; John Dietrich,15,0,35,20
1649981867222,MATH 120A,A02,085446,Eggers; John Dietrich,27,0,35,8
1649981873246,MATH 142B,A01,084149,Verstraete; Jacques Allan,0,12,30,30
1649981873246,MATH 142B,A02,084150,Verstraete; Jacques Allan,0,12,30,30
1649981879285,MATH 170A,A01,083459,Nie; Jiawang,1,8,30,29
1649981879285,MATH 170A,A02,083460,Nie; Jiawang,0,6,30,30
1649981879285,MATH 170A,A03,083461,Nie; Jiawang,0,7,30,30
1649981885320,MATH 193B,A01,083463,Staff,1,0,30,29
1649981885320,MATH 193B,A02,083464,Staff,10,0,30,20
1649981885320,MATH 193B,A03,083465,Staff,18,0,30,12
1649981891401,COGS 2,A01,083966,Boyle; Mary E. T.,10,0,30,20
1649981897425,COGS 9,A01,083968,Staff,18,0,60,42
1649981903455,COGS 14B,A01,083970,Staff,13,0,50,37
1649981909481,COGS 17,A01,092679,Staff,56,0,75,19
1649981915503,COGS 100,A01,083972,Staff,0,14,60,60
1649981927554,COGS 101C,A01,083976,Staff,13,0,30,17
1649981933581,COGS 102A,A01,083978,Johnson; Christine M.,13,0,30,17
1649981939603,COGS 107B,A01,083980,Staff,0,6,50,50
1649981945628,COGS 115,A01,083982,Staff,11,0,30,19
1649981951676,COGS 118B,A01,083367,Staff,0,13,40,40
1649981957702,COGS 172,A01,083984,Provenzano; Emily Kara,15,0,30,15
1649981963730,COGS 177,A00,083368,Staff,0,21,30,30
1649981969753,COGS 186,A01,083986,Staff,21,0,40,19
1649981975777,COGS 187A,A01,083988,Boyle; Mary E. T.,20,0,60,40
1649981981799,CSE 8A,A50,084003,Miranda; Gregory Joseph,0,6,15,15
1649981987822,CSE 11,A01,084005,Miranda; Gregory Joseph,0,16,55,55
1649981993849,CSE 20,A01,084007,Staff,0,0,20,20
1649981999882,CSE 21,A01,084009,Staff,0,20,50,50
1649982005905,CSE 30,A01,083370,Cao; Yingjun,0,58,40,40
1649982011929,CSE 100,A01,083372,Cao; Yingjun,0,45,40,40
1649982017950,CSE 101,A01,084011,Staff,1,55,40,39
1649982023978,CSE 141,A01,083374,Eldon; John,0,59,75,75
1649982030012,CSE 141L,A01,083376,Eldon; John,0,65,75,75
1649982036042,CSE 175,A01,084013,Kumar; Rakesh,22,0,25,3
1649982042156,CSE 190,A00,092508,Dubnov; Shlomo,20,0,20,0
1649982048185,ECE 5,A01,084049,Morris; Karcher William,13,0,20,7
1649982054208,ECE 100,A01,084051,Baghdadchi; Saharnaz,0,0,20,20
1649982054208,ECE 100,A02,091916,Baghdadchi; Saharnaz,14,0,20,6
1649982060232,ECE 101,A01,084053,Baghdadchi; Saharnaz,2,0,37,35
1649982060232,ECE 101,A02,084054,Baghdadchi; Saharnaz,31,0,37,6
1649982066259,ECE 107,A01,083390,Staff,27,0,40,13
1649982072282,ECE 148,A01,084056,Silberman; Jack,8,0,12,4
1649982078321,ECE 180,A00,083391,Abi Samra; Nicholas Camill,25,0,30,5
1649982078321,ECE 180,B00,083392,Abi Samra; Nicholas Camill,21,0,30,9
1649982084355,MATH 10B,A01,084110,Staff,1,0,30,29
1649982084355,MATH 10B,A02,084111,Staff,26,0,30,4
1649982084355,MATH 10B,A03,084112,Staff,26,0,30,4
1649982090379,MATH 10C,A01,083443,Staff,1,4,30,29
1649982090379,MATH 10C,A02,083444,Staff,1,3,30,29
1649982090379,MATH 10C,B01,084114,Staff,22,0,30,8
1649982090379,MATH 10C,B02,084115,Staff,27,0,30,3
1649982096406,MATH 18,A01,084117,Harel; Guershon,21,0,30,9
1649982096406,MATH 18,A02,084119,Harel; Guershon,28,0,30,2
1649982096406,MATH 18,A03,084120,Harel; Guershon,30,0,30,0
1649982096406,MATH 18,A04,084121,Harel; Guershon,29,0,30,1
1649982102434,MATH 20B,A01,084124,Um; Ko Woon,26,0,35,9
1649982102434,MATH 20B,B01,084126,Um; Ko Woon,28,0,35,7
1649982108470,MATH 20C,A01,083446,Hammock; Frances H,5,0,30,25
1649982108470,MATH 20C,A02,083447,Hammock; Frances H,25,0,30,5
1649982108470,MATH 20C,A03,083448,Hammock; Frances H,27,0,30,3
1649982108470,MATH 20C,A04,083449,Hammock; Frances H,29,0,30,1
1649982108470,MATH 20C,B01,083451,Hammock; Frances H,13,0,30,17
1649982108470,MATH 20C,B02,083452,Hammock; Frances H,23,0,30,7
1649982108470,MATH 20C,B03,083453,Hammock; Frances H,24,0,30,6
1649982108470,MATH 20C,B04,083454,Hammock; Frances H,27,0,30,3
1649982114492,MATH 20D,A01,084128,Staff,18,0,30,12
1649982114492,MATH 20D,A02,084129,Staff,30,0,30,0
1649982114492,MATH 20D,A03,084130,Staff,27,0,30,3
1649982114492,MATH 20D,B01,084133,Staff,7,0,30,23
1649982114492,MATH 20D,B02,084134,Staff,24,0,30,6
1649982114492,MATH 20D,B03,084135,Staff,28,0,30,2
1649982120520,MATH 20E,A01,084138,Staff,16,0,30,14
1649982120520,MATH 20E,A02,084139,Staff,7,0,30,23
1649982120520,MATH 20E,A03,084140,Staff,15,0,30,15
1649982120520,MATH 20E,A04,084141,Staff,21,0,30,9
1649982126548,MATH 102,A01,084143,Harel; Guershon,13,0,30,17
1649982126548,MATH 102,A02,084144,Harel; Guershon,21,0,30,9
1649982132573,MATH 103B,A01,083456,Staff,0,12,30,30
1649982132573,MATH 103B,A02,083457,Staff,0,12,30,30
1649982138596,MATH 109,A01,084146,Salehi Golsefidy; Alireza,18,0,30,12
1649982138596,MATH 109,A02,084147,Salehi Golsefidy; Alireza,17,0,30,13
1649982144619,MATH 120A,A01,085445,Eggers; John Dietrich,15,0,35,20
1649982144619,MATH 120A,A02,085446,Eggers; John Dietrich,27,0,35,8
1649982150644,MATH 142B,A01,084149,Verstraete; Jacques Allan,0,12,30,30
1649982150644,MATH 142B,A02,084150,Verstraete; Jacques Allan,0,12,30,30
1649982156667,MATH 170A,A01,083459,Nie; Jiawang,1,8,30,29
1649982156667,MATH 170A,A02,083460,Nie; Jiawang,0,6,30,30
1649982156667,MATH 170A,A03,083461,Nie; Jiawang,0,7,30,30
1649982162690,MATH 193B,A01,083463,Staff,1,0,30,29
1649982162690,MATH 193B,A02,083464,Staff,10,0,30,20
1649982162690,MATH 193B,A03,083465,Staff,18,0,30,12
1649982168767,COGS 2,A01,083966,Boyle; Mary E. T.,10,0,30,20
1649982174801,COGS 9,A01,083968,Staff,18,0,60,42
1649982180826,COGS 14B,A01,083970,Staff,13,0,50,37
1649982186862,COGS 17,A01,092679,Staff,56,0,75,19
1649982192896,COGS 100,A01,083972,Staff,0,15,60,60
1649982204947,COGS 101C,A01,083976,Staff,13,0,30,17
1649982210981,COGS 102A,A01,083978,Johnson; Christine M.,13,0,30,17
1649982217016,COGS 107B,A01,083980,Staff,0,6,50,50
1649982223040,COGS 115,A01,083982,Staff,11,0,30,19
1649982229065,COGS 118B,A01,083367,Staff,0,13,40,40
1649982235087,COGS 172,A01,083984,Provenzano; Emily Kara,15,0,30,15
1649982241113,COGS 177,A00,083368,Staff,0,21,30,30
1649982247141,COGS 186,A01,083986,Staff,21,0,40,19
1649982253166,COGS 187A,A01,083988,Boyle; Mary E. T.,20,0,60,40
1649982259193,CSE 8A,A50,084003,Miranda; Gregory Joseph,0,6,15,15
1649982265230,CSE 11,A01,084005,Miranda; Gregory Joseph,0,16,55,55
1649982271255,CSE 20,A01,084007,Staff,0,0,20,20
1649982277297,CSE 21,A01,084009,Staff,0,20,50,50
1649982283321,CSE 30,A01,083370,Cao; Yingjun,0,59,40,40
1649982289343,CSE 100,A01,083372,Cao; Yingjun,0,45,40,40
1649982295367,CSE 101,A01,084011,Staff,1,55,40,39
1649982301391,CSE 141,A01,083374,Eldon; John,0,59,75,75
1649982307415,CSE 141L,A01,083376,Eldon; John,0,65,75,75
1649982313439,CSE 175,A01,084013,Kumar; Rakesh,22,0,25,3
1649982319463,CSE 190,A00,092508,Dubnov; Shlomo,20,0,20,0
1649982325487,ECE 5,A01,084049,Morris; Karcher William,13,0,20,7
1649982331511,ECE 100,A01,084051,Baghdadchi; Saharnaz,0,0,20,20
1649982331511,ECE 100,A02,091916,Baghdadchi; Saharnaz,14,0,20,6
1649982337537,ECE 101,A01,084053,Baghdadchi; Saharnaz,2,0,37,35
1649982337537,ECE 101,A02,084054,Baghdadchi; Saharnaz,31,0,37,6
1649982343579,ECE 107,A01,083390,Staff,27,0,40,13
1649982349606,ECE 148,A01,084056,Silberman; Jack,8,0,12,4
1649982355632,ECE 180,A00,083391,Abi Samra; Nicholas Camill,25,0,30,5
1649982355632,ECE 180,B00,083392,Abi Samra; Nicholas Camill,21,0,30,9
1649982361659,MATH 10B,A01,084110,Staff,1,0,30,29
1649982361659,MATH 10B,A02,084111,Staff,26,0,30,4
1649982361659,MATH 10B,A03,084112,Staff,26,0,30,4
1649982367688,MATH 10C,A01,083443,Staff,1,5,30,29
1649982367688,MATH 10C,A02,083444,Staff,1,4,30,29
1649982367688,MATH 10C,B01,084114,Staff,22,0,30,8
1649982367688,MATH 10C,B02,084115,Staff,26,0,30,4
1649982373716,MATH 18,A01,084117,Harel; Guershon,21,0,30,9
1649982373716,MATH 18,A02,084119,Harel; Guershon,28,0,30,2
1649982373716,MATH 18,A03,084120,Harel; Guershon,30,0,30,0
1649982373716,MATH 18,A04,084121,Harel; Guershon,29,0,30,1
1649982379754,MATH 20B,A01,084124,Um; Ko Woon,25,0,35,10
1649982379754,MATH 20B,B01,084126,Um; Ko Woon,28,0,35,7
1649982385784,MATH 20C,A01,083446,Hammock; Frances H,4,0,30,26
1649982385784,MATH 20C,A02,083447,Hammock; Frances H,25,0,30,5
1649982385784,MATH 20C,A03,083448,Hammock; Frances H,27,0,30,3
1649982385784,MATH 20C,A04,083449,Hammock; Frances H,29,0,30,1
1649982385784,MATH 20C,B01,083451,Hammock; Frances H,12,0,30,18
1649982385784,MATH 20C,B02,083452,Hammock; Frances H,23,0,30,7
1649982385784,MATH 20C,B03,083453,Hammock; Frances H,24,0,30,6
1649982385784,MATH 20C,B04,083454,Hammock; Frances H,27,0,30,3
1649982391846,MATH 20D,A01,084128,Staff,18,0,30,12
1649982391846,MATH 20D,A02,084129,Staff,30,0,30,0
1649982391846,MATH 20D,A03,084130,Staff,27,0,30,3
1649982391846,MATH 20D,B01,084133,Staff,7,0,30,23
1649982391846,MATH 20D,B02,084134,Staff,24,0,30,6
1649982391846,MATH 20D,B03,084135,Staff,28,0,30,2
1649982397870,MATH 20E,A01,084138,Staff,16,0,30,14
1649982397870,MATH 20E,A02,084139,Staff,7,0,30,23
1649982397870,MATH 20E,A03,084140,Staff,15,0,30,15
1649982397870,MATH 20E,A04,084141,Staff,21,0,30,9
1649982403896,MATH 102,A01,084143,Harel; Guershon,13,0,30,17
1649982403896,MATH 102,A02,084144,Harel; Guershon,21,0,30,9
1649982409923,MATH 103B,A01,083456,Staff,0,12,30,30
1649982409923,MATH 103B,A02,083457,Staff,0,12,30,30
1649982415946,MATH 109,A01,084146,Salehi Golsefidy; Alireza,18,0,30,12
1649982415946,MATH 109,A02,084147,Salehi Golsefidy; Alireza,17,0,30,13
1649982421973,MATH 120A,A01,085445,Eggers; John Dietrich,15,0,35,20
1649982421973,MATH 120A,A02,085446,Eggers; John Dietrich,27,0,35,8
1649982427999,MATH 142B,A01,084149,Verstraete; Jacques Allan,0,12,30,30
1649982427999,MATH 142B,A02,084150,Verstraete; Jacques Allan,0,12,30,30
1649982434036,MATH 170A,A01,083459,Nie; Jiawang,1,8,30,29
1649982434036,MATH 170A,A02,083460,Nie; Jiawang,0,7,30,30
1649982434036,MATH 170A,A03,083461,Nie; Jiawang,0,7,30,30
1649982440061,MATH 193B,A01,083463,Staff,1,0,30,29
1649982440061,MATH 193B,A02,083464,Staff,9,0,30,21
1649982440061,MATH 193B,A03,083465,Staff,18,0,30,12
1649982446116,COGS 2,A01,083966,Boyle; Mary E. T.,10,0,30,20
1649982452141,COGS 9,A01,083968,Staff,17,0,60,43
1649982458165,COGS 14B,A01,083970,Staff,13,0,50,37
1649982464186,COGS 17,A01,092679,Staff,56,0,75,19
1649982470213,COGS 100,A01,083972,Staff,0,15,60,60
1649982482289,COGS 101C,A01,083976,Staff,13,0,30,17
1649982488322,COGS 102A,A01,083978,Johnson; Christine M.,13,0,30,17
1649982494346,COGS 107B,A01,083980,Staff,0,6,50,50
1649982500368,COGS 115,A01,083982,Staff,11,0,30,19
1649982506393,COGS 118B,A01,083367,Staff,0,13,40,40
1649982512416,COGS 172,A01,083984,Provenzano; Emily Kara,15,0,30,15
1649982518442,COGS 177,A00,083368,Staff,0,21,30,30
1649982524465,COGS 186,A01,083986,Staff,21,0,40,19
1649982530490,COGS 187A,A01,083988,Boyle; Mary E. T.,20,0,60,40
1649982536515,CSE 8A,A50,084003,Miranda; Gregory Joseph,0,6,15,15
1649982542538,CSE 11,A01,084005,Miranda; Gregory Joseph,0,16,55,55
1649982548565,CSE 20,A01,084007,Staff,0,0,20,20
1649982554591,CSE 21,A01,084009,Staff,0,20,50,50
1649982560617,CSE 30,A01,083370,Cao; Yingjun,0,60,40,40
1649982566643,CSE 100,A01,083372,Cao; Yingjun,0,46,40,40
1649982572677,CSE 101,A01,084011,Staff,1,55,40,39
1649982578704,CSE 141,A01,083374,Eldon; John,0,59,75,75
1649982584730,CSE 141L,A01,083376,Eldon; John,0,65,75,75
1649982590758,CSE 175,A01,084013,Kumar; Rakesh,22,0,25,3
1649982596788,CSE 190,A00,092508,Dubnov; Shlomo,20,0,20,0
1649982602812,ECE 5,A01,084049,Morris; Karcher William,13,0,20,7
1649982608842,ECE 100,A01,084051,Baghdadchi; Saharnaz,0,0,20,20
1649982608842,ECE 100,A02,091916,Baghdadchi; Saharnaz,14,0,20,6
1649982614868,ECE 101,A01,084053,Baghdadchi; Saharnaz,2,0,37,35
1649982614868,ECE 101,A02,084054,Baghdadchi; Saharnaz,31,0,37,6
1649982620892,ECE 107,A01,083390,Staff,27,0,40,13
1649982626920,ECE 148,A01,084056,Silberman; Jack,8,0,12,4
1649982633065,ECE 180,A00,083391,Abi Samra; Nicholas Camill,25,0,30,5
1649982633065,ECE 180,B00,083392,Abi Samra; Nicholas Camill,21,0,30,9
1649982639088,MATH 10B,A01,084110,Staff,1,0,30,29
1649982639088,MATH 10B,A02,084111,Staff,26,0,30,4
1649982639088,MATH 10B,A03,084112,Staff,26,0,30,4
1649982645111,MATH 10C,A01,083443,Staff,1,5,30,29
1649982645111,MATH 10C,A02,083444,Staff,1,4,30,29
1649982645111,MATH 10C,B01,084114,Staff,22,0,30,8
1649982645111,MATH 10C,B02,084115,Staff,26,0,30,4
1649982651138,MATH 18,A01,084117,Harel; Guershon,21,0,30,9
1649982651138,MATH 18,A02,084119,Harel; Guershon,28,0,30,2
1649982651138,MATH 18,A03,084120,Harel; Guershon,30,0,30,0
1649982651138,MATH 18,A04,084121,Harel; Guershon,29,0,30,1
1649982657173,MATH 20B,A01,084124,Um; Ko Woon,24,0,35,11
1649982657173,MATH 20B,B01,084126,Um; Ko Woon,28,0,35,7
1649982663195,MATH 20C,A01,083446,Hammock; Frances H,3,0,30,27
1649982663195,MATH 20C,A02,083447,Hammock; Frances H,25,0,30,5
1649982663195,MATH 20C,A03,083448,Hammock; Frances H,27,0,30,3
1649982663195,MATH 20C,A04,083449,Hammock; Frances H,29,0,30,1
1649982663195,MATH 20C,B01,083451,Hammock; Frances H,11,0,30,19
1649982663195,MATH 20C,B02,083452,Hammock; Frances H,23,0,30,7
1649982663195,MATH 20C,B03,083453,Hammock; Frances H,24,0,30,6
1649982663195,MATH 20C,B04,083454,Hammock; Frances H,27,0,30,3
1649982669219,MATH 20D,A01,084128,Staff,18,0,30,12
1649982669219,MATH 20D,A02,084129,Staff,30,0,30,0
1649982669219,MATH 20D,A03,084130,Staff,27,0,30,3
1649982669219,MATH 20D,B01,084133,Staff,7,0,30,23
1649982669219,MATH 20D,B02,084134,Staff,24,0,30,6
1649982669219,MATH 20D,B03,084135,Staff,28,0,30,2
1649982675243,MATH 20E,A01,084138,Staff,16,0,30,14
1649982675243,MATH 20E,A02,084139,Staff,7,0,30,23
1649982675243,MATH 20E,A03,084140,Staff,15,0,30,15
1649982675243,MATH 20E,A04,084141,Staff,21,0,30,9
1649982681269,MATH 102,A01,084143,Harel; Guershon,13,0,30,17
1649982681269,MATH 102,A02,084144,Harel; Guershon,21,0,30,9
1649982687311,MATH 103B,A01,083456,Staff,0,12,30,30
1649982687311,MATH 103B,A02,083457,Staff,0,12,30,30
1649982693337,MATH 109,A01,084146,Salehi Golsefidy; Alireza,18,0,30,12
1649982693337,MATH 109,A02,084147,Salehi Golsefidy; Alireza,17,0,30,13
1649982699366,MATH 120A,A01,085445,Eggers; John Dietrich,14,0,35,21
1649982699366,MATH 120A,A02,085446,Eggers; John Dietrich,27,0,35,8
1649982705389,MATH 142B,A01,084149,Verstraete; Jacques Allan,0,12,30,30
1649982705389,MATH 142B,A02,084150,Verstraete; Jacques Allan,0,12,30,30
1649982711420,MATH 170A,A01,083459,Nie; Jiawang,1,8,30,29
1649982711420,MATH 170A,A02,083460,Nie; Jiawang,0,6,30,30
1649982711420,MATH 170A,A03,083461,Nie; Jiawang,0,7,30,30
1649982717451,MATH 193B,A01,083463,Staff,1,0,30,29
1649982717451,MATH 193B,A02,083464,Staff,9,0,30,21
1649982717451,MATH 193B,A03,083465,Staff,18,0,30,12
1649982723555,COGS 2,A01,083966,Boyle; Mary E. T.,9,0,30,21
1649982729588,COGS 9,A01,083968,Staff,18,0,60,42
1649982735614,COGS 14B,A01,083970,Staff,13,0,50,37
1649982741638,COGS 17,A01,092679,Staff,56,0,75,19
1649982747665,COGS 100,A01,083972,Staff,0,15,60,60
1649982759719,COGS 101C,A01,083976,Staff,13,0,30,17
1649982765746,COGS 102A,A01,083978,Johnson; Christine M.,13,0,30,17
1649982771773,COGS 107B,A01,083980,Staff,0,6,50,50
1649982777796,COGS 115,A01,083982,Staff,11,0,30,19
1649982783827,COGS 118B,A01,083367,Staff,0,13,40,40
1649982789854,COGS 172,A01,083984,Provenzano; Emily Kara,15,0,30,15
1649982795880,COGS 177,A00,083368,Staff,0,21,30,30
1649982801906,COGS 186,A01,083986,Staff,21,0,40,19
1649982807932,COGS 187A,A01,083988,Boyle; Mary E. T.,20,0,60,40
1649982813956,CSE 8A,A50,084003,Miranda; Gregory Joseph,0,6,15,15
1649982819990,CSE 11,A01,084005,Miranda; Gregory Joseph,0,16,55,55
1649982826015,CSE 20,A01,084007,Staff,0,0,20,20
1649982832043,CSE 21,A01,084009,Staff,0,20,50,50
1649982838070,CSE 30,A01,083370,Cao; Yingjun,0,60,40,40
1649982844094,CSE 100,A01,083372,Cao; Yingjun,0,46,40,40
1649982850122,CSE 101,A01,084011,Staff,1,55,40,39
1649982856149,CSE 141,A01,083374,Eldon; John,0,59,75,75
1649982862177,CSE 141L,A01,083376,Eldon; John,0,65,75,75
1649982868204,CSE 175,A01,084013,Kumar; Rakesh,22,0,25,3
1649982874230,CSE 190,A00,092508,Dubnov; Shlomo,20,0,20,0
1649982880253,ECE 5,A01,084049,Morris; Karcher William,13,0,20,7
1649982886276,ECE 100,A01,084051,Baghdadchi; Saharnaz,0,0,20,20
1649982886276,ECE 100,A02,091916,Baghdadchi; Saharnaz,14,0,20,6
1649982892304,ECE 101,A01,084053,Baghdadchi; Saharnaz,2,0,37,35
1649982892304,ECE 101,A02,084054,Baghdadchi; Saharnaz,31,0,37,6
1649982898327,ECE 107,A01,083390,Staff,27,0,40,13
1649982904355,ECE 148,A01,084056,Silberman; Jack,8,0,12,4
1649982910378,ECE 180,A00,083391,Abi Samra; Nicholas Camill,25,0,30,5
1649982910378,ECE 180,B00,083392,Abi Samra; Nicholas Camill,21,0,30,9
1649982916402,MATH 10B,A01,084110,Staff,1,0,30,29
1649982916402,MATH 10B,A02,084111,Staff,26,0,30,4
1649982916402,MATH 10B,A03,084112,Staff,26,0,30,4
1649982922436,MATH 10C,A01,083443,Staff,1,5,30,29
1649982922436,MATH 10C,A02,083444,Staff,1,4,30,29
1649982922436,MATH 10C,B01,084114,Staff,21,0,30,9
1649982922436,MATH 10C,B02,084115,Staff,26,0,30,4
1649982928463,MATH 18,A01,084117,Harel; Guershon,20,0,30,10
1649982928463,MATH 18,A02,084119,Harel; Guershon,28,0,30,2
1649982928463,MATH 18,A03,084120,Harel; Guershon,30,0,30,0
1649982928463,MATH 18,A04,084121,Harel; Guershon,29,0,30,1
1649982934486,MATH 20B,A01,084124,Um; Ko Woon,24,0,35,11
1649982934486,MATH 20B,B01,084126,Um; Ko Woon,28,0,35,7
1649982940515,MATH 20C,A01,083446,Hammock; Frances H,3,0,30,27
1649982940515,MATH 20C,A02,083447,Hammock; Frances H,25,0,30,5
1649982940515,MATH 20C,A03,083448,Hammock; Frances H,27,0,30,3
1649982940515,MATH 20C,A04,083449,Hammock; Frances H,29,0,30,1
1649982940515,MATH 20C,B01,083451,Hammock; Frances H,11,0,30,19
1649982940515,MATH 20C,B02,083452,Hammock; Frances H,23,0,30,7
1649982940515,MATH 20C,B03,083453,Hammock; Frances H,24,0,30,6
1649982940515,MATH 20C,B04,083454,Hammock; Frances H,27,0,30,3
1649982946544,MATH 20D,A01,084128,Staff,18,0,30,12
1649982946544,MATH 20D,A02,084129,Staff,30,0,30,0
1649982946544,MATH 20D,A03,084130,Staff,27,0,30,3
1649982946544,MATH 20D,B01,084133,Staff,6,0,30,24
1649982946544,MATH 20D,B02,084134,Staff,24,0,30,6
1649982946544,MATH 20D,B03,084135,Staff,28,0,30,2
1649982952567,MATH 20E,A01,084138,Staff,16,0,30,14
1649982952567,MATH 20E,A02,084139,Staff,7,0,30,23
1649982952567,MATH 20E,A03,084140,Staff,15,0,30,15
1649982952567,MATH 20E,A04,084141,Staff,20,0,30,10
1649982958591,MATH 102,A01,084143,Harel; Guershon,13,0,30,17
1649982958591,MATH 102,A02,084144,Harel; Guershon,21,0,30,9
1649982964618,MATH 103B,A01,083456,Staff,0,12,30,30
1649982964618,MATH 103B,A02,083457,Staff,0,12,30,30
1649982970650,MATH 109,A01,084146,Salehi Golsefidy; Alireza,18,0,30,12
1649982970650,MATH 109,A02,084147,Salehi Golsefidy; Alireza,17,0,30,13
1649982976674,MATH 120A,A01,085445,Eggers; John Dietrich,14,0,35,21
1649982976674,MATH 120A,A02,085446,Eggers; John Dietrich,27,0,35,8
1649982982701,MATH 142B,A01,084149,Verstraete; Jacques Allan,0,12,30,30
1649982982701,MATH 142B,A02,084150,Verstraete; Jacques Allan,0,12,30,30
1649982988728,MATH 170A,A01,083459,Nie; Jiawang,1,8,30,29
1649982988728,MATH 170A,A02,083460,Nie; Jiawang,0,6,30,30
1649982988728,MATH 170A,A03,083461,Nie; Jiawang,0,7,30,30
1649982994752,MATH 193B,A01,083463,Staff,1,0,30,29
1649982994752,MATH 193B,A02,083464,Staff,9,0,30,21
1649982994752,MATH 193B,A03,083465,Staff,18,0,30,12
1649983000801,COGS 2,A01,083966,Boyle; Mary E. T.,8,0,30,22
1649983006831,COGS 9,A01,083968,Staff,18,0,60,42
1649983012860,COGS 14B,A01,083970,Staff,13,0,50,37
1649983018884,COGS 17,A01,092679,Staff,56,0,75,19
1649983024908,COGS 100,A01,083972,Staff,0,15,60,60
1649983036957,COGS 101C,A01,083976,Staff,13,0,30,17
1649983042984,COGS 102A,A01,083978,Johnson; Christine M.,13,0,30,17
1649983049007,COGS 107B,A01,083980,Staff,0,6,50,50
1649983055029,COGS 115,A01,083982,Staff,11,0,30,19
1649983061056,COGS 118B,A01,083367,Staff,0,13,40,40
1649983067092,COGS 172,A01,083984,Provenzano; Emily Kara,15,0,30,15
1649983073114,COGS 177,A00,083368,Staff,0,21,30,30
1649983079138,COGS 186,A01,083986,Staff,21,0,40,19
1649983085162,COGS 187A,A01,083988,Boyle; Mary E. T.,20,0,60,40
1649983091186,CSE 8A,A50,084003,Miranda; Gregory Joseph,0,7,15,15
1649983097220,CSE 11,A01,084005,Miranda; Gregory Joseph,0,16,55,55
1649983103247,CSE 20,A01,084007,Staff,0,0,20,20
1649983109277,CSE 21,A01,084009,Staff,0,20,50,50
1649983115311,CSE 30,A01,083370,Cao; Yingjun,0,60,40,40
1649983121338,CSE 100,A01,083372,Cao; Yingjun,0,46,40,40
1649983127367,CSE 101,A01,084011,Staff,1,55,40,39
1649983133391,CSE 141,A01,083374,Eldon; John,0,59,75,75
1649983139421,CSE 141L,A01,083376,Eldon; John,0,65,75,75
1649983145448,CSE 175,A01,084013,Kumar; Rakesh,22,0,25,3
1649983151472,CSE 190,A00,092508,Dubnov; Shlomo,20,0,20,0
1649983157498,ECE 5,A01,084049,Morris; Karcher William,13,0,20,7
1649983163546,ECE 100,A01,084051,Baghdadchi; Saharnaz,0,0,20,20
1649983163546,ECE 100,A02,091916,Baghdadchi; Saharnaz,14,0,20,6
1649983169575,ECE 101,A01,084053,Baghdadchi; Saharnaz,2,0,37,35
1649983169575,ECE 101,A02,084054,Baghdadchi; Saharnaz,31,0,37,6
1649983175600,ECE 107,A01,083390,Staff,27,0,40,13
1649983181622,ECE 148,A01,084056,Silberman; Jack,8,0,12,4
1649983187649,ECE 180,A00,083391,Abi Samra; Nicholas Camill,25,0,30,5
1649983187649,ECE 180,B00,083392,Abi Samra; Nicholas Camill,21,0,30,9
1649983193673,MATH 10B,A01,084110,Staff,1,0,30,29
1649983193673,MATH 10B,A02,084111,Staff,26,0,30,4
1649983193673,MATH 10B,A03,084112,Staff,26,0,30,4
1649983199700,MATH 10C,A01,083443,Staff,1,5,30,29
1649983199700,MATH 10C,A02,083444,Staff,1,4,30,29
1649983199700,MATH 10C,B01,084114,Staff,21,0,30,9
1649983199700,MATH 10C,B02,084115,Staff,26,0,30,4
1649983205734,MATH 18,A01,084117,Harel; Guershon,19,0,30,11
1649983205734,MATH 18,A02,084119,Harel; Guershon,28,0,30,2
1649983205734,MATH 18,A03,084120,Harel; Guershon,30,0,30,0
1649983205734,MATH 18,A04,084121,Harel; Guershon,29,0,30,1
1649983211762,MATH 20B,A01,084124,Um; Ko Woon,24,0,35,11
1649983211762,MATH 20B,B01,084126,Um; Ko Woon,28,0,35,7
1649983217792,MATH 20C,A01,083446,Hammock; Frances H,3,0,30,27
1649983217792,MATH 20C,A02,083447,Hammock; Frances H,25,0,30,5
1649983217792,MATH 20C,A03,083448,Hammock; Frances H,27,0,30,3
1649983217792,MATH 20C,A04,083449,Hammock; Frances H,29,0,30,1
1649983217792,MATH 20C,B01,083451,Hammock; Frances H,11,0,30,19
1649983217792,MATH 20C,B02,083452,Hammock; Frances H,23,0,30,7
1649983217792,MATH 20C,B03,083453,Hammock; Frances H,24,0,30,6
1649983217792,MATH 20C,B04,083454,Hammock; Frances H,27,0,30,3
1649983223831,MATH 20D,A01,084128,Staff,18,0,30,12
1649983223831,MATH 20D,A02,084129,Staff,30,0,30,0
1649983223831,MATH 20D,A03,084130,Staff,27,0,30,3
1649983223831,MATH 20D,B01,084133,Staff,6,0,30,24
1649983223831,MATH 20D,B02,084134,Staff,24,0,30,6
1649983223831,MATH 20D,B03,084135,Staff,28,0,30,2
1649983229951,MATH 20E,A01,084138,Staff,16,0,30,14
1649983229951,MATH 20E,A02,084139,Staff,7,0,30,23
1649983229951,MATH 20E,A03,084140,Staff,15,0,30,15
1649983229951,MATH 20E,A04,084141,Staff,20,0,30,10
1649983236002,MATH 102,A01,084143,Harel; Guershon,13,0,30,17
1649983236002,MATH 102,A02,084144,Harel; Guershon,21,0,30,9
1649983242033,MATH 103B,A01,083456,Staff,0,12,30,30
1649983242033,MATH 103B,A02,083457,Staff,0,12,30,30
1649983248056,MATH 109,A01,084146,Salehi Golsefidy; Alireza,18,0,30,12
1649983248056,MATH 109,A02,084147,Salehi Golsefidy; Alireza,17,0,30,13
1649983254081,MATH 120A,A01,085445,Eggers; John Dietrich,14,0,35,21
1649983254081,MATH 120A,A02,085446,Eggers; John Dietrich,27,0,35,8
1649983260108,MATH 142B,A01,084149,Verstraete; Jacques Allan,0,12,30,30
1649983260108,MATH 142B,A02,084150,Verstraete; Jacques Allan,0,12,30,30
1649983266129,MATH 170A,A01,083459,Nie; Jiawang,1,8,30,29
1649983266129,MATH 170A,A02,083460,Nie; Jiawang,0,6,30,30
1649983266129,MATH 170A,A03,083461,Nie; Jiawang,0,7,30,30
1649983272155,MATH 193B,A01,083463,Staff,1,0,30,29
1649983272155,MATH 193B,A02,083464,Staff,9,0,30,21
1649983272155,MATH 193B,A03,083465,Staff,18,0,30,12
1649983278222,COGS 2,A01,083966,Boyle; Mary E. T.,8,0,30,22
1649983284244,COGS 9,A01,083968,Staff,18,0,60,42
1649983290267,COGS 14B,A01,083970,Staff,13,0,50,37
1649983296302,COGS 17,A01,092679,Staff,56,0,75,19
1649983302326,COGS 100,A01,083972,Staff,0,15,60,60
1649983314373,COGS 101C,A01,083976,Staff,13,0,30,17
1649983320419,COGS 102A,A01,083978,Johnson; Christine M.,14,0,30,16
1649983326441,COGS 107B,A01,083980,Staff,0,6,50,50
1649983332466,COGS 115,A01,083982,Staff,11,0,30,19
1649983338498,COGS 118B,A01,083367,Staff,0,13,40,40
1649983344529,COGS 172,A01,083984,Provenzano; Emily Kara,15,0,30,15
1649983350566,COGS 177,A00,083368,Staff,0,21,30,30
1649983356592,COGS 186,A01,083986,Staff,21,0,40,19
1649983362616,COGS 187A,A01,083988,Boyle; Mary E. T.,20,0,60,40
1649983368639,CSE 8A,A50,084003,Miranda; Gregory Joseph,0,7,15,15
1649983374666,CSE 11,A01,084005,Miranda; Gregory Joseph,0,16,55,55
1649983380702,CSE 20,A01,084007,Staff,0,0,20,20
1649983386734,CSE 21,A01,084009,Staff,0,20,50,50
1649983392777,CSE 30,A01,083370,Cao; Yingjun,0,60,40,40
1649983398809,CSE 100,A01,083372,Cao; Yingjun,0,45,40,40
1649983404831,CSE 101,A01,084011,Staff,1,55,40,39
1649983410862,CSE 141,A01,083374,Eldon; John,0,61,75,75
1649983416885,CSE 141L,A01,083376,Eldon; John,0,67,75,75
1649983422908,CSE 175,A01,084013,Kumar; Rakesh,22,0,25,3
1649983428957,CSE 190,A00,092508,Dubnov; Shlomo,20,0,20,0
1649983434980,ECE 5,A01,084049,Morris; Karcher William,13,0,20,7
1649983441007,ECE 100,A01,084051,Baghdadchi; Saharnaz,0,0,20,20
1649983441007,ECE 100,A02,091916,Baghdadchi; Saharnaz,14,0,20,6
1649983447029,ECE 101,A01,084053,Baghdadchi; Saharnaz,2,0,37,35
1649983447029,ECE 101,A02,084054,Baghdadchi; Saharnaz,31,0,37,6
1649983453054,ECE 107,A01,083390,Staff,27,0,40,13
1649983459089,ECE 148,A01,084056,Silberman; Jack,8,0,12,4
1649983465115,ECE 180,A00,083391,Abi Samra; Nicholas Camill,25,0,30,5
1649983465115,ECE 180,B00,083392,Abi Samra; Nicholas Camill,21,0,30,9
1649983471139,MATH 10B,A01,084110,Staff,0,0,30,30
1649983471139,MATH 10B,A02,084111,Staff,26,0,30,4
1649983471139,MATH 10B,A03,084112,Staff,26,0,30,4
1649983477173,MATH 10C,A01,083443,Staff,1,5,30,29
1649983477173,MATH 10C,A02,083444,Staff,1,5,30,29
1649983477173,MATH 10C,B01,084114,Staff,21,0,30,9
1649983477173,MATH 10C,B02,084115,Staff,26,0,30,4
1649983483196,MATH 18,A01,084117,Harel; Guershon,19,0,30,11
1649983483196,MATH 18,A02,084119,Harel; Guershon,28,0,30,2
1649983483196,MATH 18,A03,084120,Harel; Guershon,30,0,30,0
1649983483196,MATH 18,A04,084121,Harel; Guershon,29,0,30,1
1649983489219,MATH 20B,A01,084124,Um; Ko Woon,24,0,35,11
1649983489219,MATH 20B,B01,084126,Um; Ko Woon,28,0,35,7
1649983495249,MATH 20C,A01,083446,Hammock; Frances H,3,0,30,27
1649983495249,MATH 20C,A02,083447,Hammock; Frances H,25,0,30,5
1649983495249,MATH 20C,A03,083448,Hammock; Frances H,27,0,30,3
1649983495249,MATH 20C,A04,083449,Hammock; Frances H,29,0,30,1
1649983495249,MATH 20C,B01,083451,Hammock; Frances H,11,0,30,19
1649983495249,MATH 20C,B02,083452,Hammock; Frances H,22,0,30,8
1649983495249,MATH 20C,B03,083453,Hammock; Frances H,24,0,30,6
1649983495249,MATH 20C,B04,083454,Hammock; Frances H,27,0,30,3
1649983501274,MATH 20D,A01,084128,Staff,18,0,30,12
1649983501274,MATH 20D,A02,084129,Staff,30,0,30,0
1649983501274,MATH 20D,A03,084130,Staff,27,0,30,3
1649983501274,MATH 20D,B01,084133,Staff,5,0,30,25
1649983501274,MATH 20D,B02,084134,Staff,24,0,30,6
1649983501274,MATH 20D,B03,084135,Staff,28,0,30,2
1649983507317,MATH 20E,A01,084138,Staff,15,0,30,15
1649983507317,MATH 20E,A02,084139,Staff,7,0,30,23
1649983507317,MATH 20E,A03,084140,Staff,15,0,30,15
1649983507317,MATH 20E,A04,084141,Staff,20,0,30,10
1649983513350,MATH 102,A01,084143,Harel; Guershon,13,0,30,17
1649983513350,MATH 102,A02,084144,Harel; Guershon,21,0,30,9
1649983519375,MATH 103B,A01,083456,Staff,0,12,30,30
1649983519375,MATH 103B,A02,083457,Staff,0,12,30,30
1649983525398,MATH 109,A01,084146,Salehi Golsefidy; Alireza,18,0,30,12
1649983525398,MATH 109,A02,084147,Salehi Golsefidy; Alireza,17,0,30,13
1649983531427,MATH 120A,A01,085445,Eggers; John Dietrich,14,0,35,21
1649983531427,MATH 120A,A02,085446,Eggers; John Dietrich,27,0,35,8
1649983537450,MATH 142B,A01,084149,Verstraete; Jacques Allan,0,12,30,30
1649983537450,MATH 142B,A02,084150,Verstraete; Jacques Allan,0,12,30,30
1649983543477,MATH 170A,A01,083459,Nie; Jiawang,1,8,30,29
1649983543477,MATH 170A,A02,083460,Nie; Jiawang,0,6,30,30
1649983543477,MATH 170A,A03,083461,Nie; Jiawang,0,7,30,30
1649983549512,MATH 193B,A01,083463,Staff,1,0,30,29
1649983549512,MATH 193B,A02,083464,Staff,9,0,30,21
1649983549512,MATH 193B,A03,083465,Staff,18,0,30,12
1649983555574,COGS 2,A01,083966,Boyle; Mary E. T.,8,0,30,22
1649983561601,COGS 9,A01,083968,Staff,18,0,60,42
1649983567640,COGS 14B,A01,083970,Staff,13,0,50,37
1649983573677,COGS 17,A01,092679,Staff,56,0,75,19
1649983579716,COGS 100,A01,083972,Staff,0,15,60,60
1649983591771,COGS 101C,A01,083976,Staff,13,0,30,17
1649983597794,COGS 102A,A01,083978,Johnson; Christine M.,14,0,30,16
1649983603824,COGS 107B,A01,083980,Staff,0,6,50,50
1649983609849,COGS 115,A01,083982,Staff,11,0,30,19
1649983615874,COGS 118B,A01,083367,Staff,0,13,40,40
1649983621897,COGS 172,A01,083984,Provenzano; Emily Kara,15,0,30,15
1649983627927,COGS 177,A00,083368,Staff,0,21,30,30
1649983633953,COGS 186,A01,083986,Staff,21,0,40,19
1649983639980,COGS 187A,A01,083988,Boyle; Mary E. T.,19,0,60,41
1649983646004,CSE 8A,A50,084003,Miranda; Gregory Joseph,0,7,15,15
1649983652029,CSE 11,A01,084005,Miranda; Gregory Joseph,0,16,55,55
1649983658054,CSE 20,A01,084007,Staff,0,0,20,20
1649983664076,CSE 21,A01,084009,Staff,0,20,50,50
1649983670101,CSE 30,A01,083370,Cao; Yingjun,0,60,40,40
1649983676123,CSE 100,A01,083372,Cao; Yingjun,0,45,40,40
1649983682148,CSE 101,A01,084011,Staff,1,55,40,39
1649983688182,CSE 141,A01,083374,Eldon; John,0,61,75,75
1649983694204,CSE 141L,A01,083376,Eldon; John,0,67,75,75
1649983700229,CSE 175,A01,084013,Kumar; Rakesh,22,0,25,3
1649983706252,CSE 190,A00,092508,Dubnov; Shlomo,20,0,20,0
1649983712274,ECE 5,A01,084049,Morris; Karcher William,13,0,20,7
1649983718298,ECE 100,A01,084051,Baghdadchi; Saharnaz,0,0,20,20
1649983718298,ECE 100,A02,091916,Baghdadchi; Saharnaz,14,0,20,6
1649983724327,ECE 101,A01,084053,Baghdadchi; Saharnaz,2,0,37,35
1649983724327,ECE 101,A02,084054,Baghdadchi; Saharnaz,31,0,37,6
1649983730361,ECE 107,A01,083390,Staff,27,0,40,13
1649983736386,ECE 148,A01,084056,Silberman; Jack,8,0,12,4
1649983742416,ECE 180,A00,083391,Abi Samra; Nicholas Camill,25,0,30,5
1649983742416,ECE 180,B00,083392,Abi Samra; Nicholas Camill,21,0,30,9
1649983748450,MATH 10B,A01,084110,Staff,0,0,30,30
1649983748450,MATH 10B,A02,084111,Staff,26,0,30,4
1649983748450,MATH 10B,A03,084112,Staff,26,0,30,4
1649983754477,MATH 10C,A01,083443,Staff,1,6,30,29
1649983754477,MATH 10C,A02,083444,Staff,1,5,30,29
1649983754477,MATH 10C,B01,084114,Staff,21,0,30,9
1649983754477,MATH 10C,B02,084115,Staff,26,0,30,4
1649983760514,MATH 18,A01,084117,Harel; Guershon,19,0,30,11
1649983760514,MATH 18,A02,084119,Harel; Guershon,28,0,30,2
1649983760514,MATH 18,A03,084120,Harel; Guershon,30,0,30,0
1649983760514,MATH 18,A04,084121,Harel; Guershon,29,0,30,1
1649983766538,MATH 20B,A01,084124,Um; Ko Woon,24,0,35,11
1649983766538,MATH 20B,B01,084126,Um; Ko Woon,28,0,35,7
1649983772563,MATH 20C,A01,083446,Hammock; Frances H,3,0,30,27
1649983772563,MATH 20C,A02,083447,Hammock; Frances H,25,0,30,5
1649983772563,MATH 20C,A03,083448,Hammock; Frances H,27,0,30,3
1649983772563,MATH 20C,A04,083449,Hammock; Frances H,29,0,30,1
1649983772563,MATH 20C,B01,083451,Hammock; Frances H,11,0,30,19
1649983772563,MATH 20C,B02,083452,Hammock; Frances H,22,0,30,8
1649983772563,MATH 20C,B03,083453,Hammock; Frances H,24,0,30,6
1649983772563,MATH 20C,B04,083454,Hammock; Frances H,27,0,30,3
1649983778596,MATH 20D,A01,084128,Staff,18,0,30,12
1649983778596,MATH 20D,A02,084129,Staff,30,0,30,0
1649983778596,MATH 20D,A03,084130,Staff,27,0,30,3
1649983778596,MATH 20D,B01,084133,Staff,5,0,30,25
1649983778596,MATH 20D,B02,084134,Staff,24,0,30,6
1649983778596,MATH 20D,B03,084135,Staff,28,0,30,2
1649983784621,MATH 20E,A01,084138,Staff,15,0,30,15
1649983784621,MATH 20E,A02,084139,Staff,7,0,30,23
1649983784621,MATH 20E,A03,084140,Staff,15,0,30,15
1649983784621,MATH 20E,A04,084141,Staff,20,0,30,10
1649983790658,MATH 102,A01,084143,Harel; Guershon,13,0,30,17
1649983790658,MATH 102,A02,084144,Harel; Guershon,21,0,30,9
1649983796688,MATH 103B,A01,083456,Staff,0,12,30,30
1649983796688,MATH 103B,A02,083457,Staff,0,12,30,30
1649983802712,MATH 109,A01,084146,Salehi Golsefidy; Alireza,18,0,30,12
1649983802712,MATH 109,A02,084147,Salehi Golsefidy; Alireza,17,0,30,13
1649983808747,MATH 120A,A01,085445,Eggers; John Dietrich,14,0,35,21
1649983808747,MATH 120A,A02,085446,Eggers; John Dietrich,27,0,35,8
1649983814777,MATH 142B,A01,084149,Verstraete; Jacques Allan,0,12,30,30
1649983814777,MATH 142B,A02,084150,Verstraete; Jacques Allan,0,12,30,30
1649983820801,MATH 170A,A01,083459,Nie; Jiawang,1,8,30,29
1649983820801,MATH 170A,A02,083460,Nie; Jiawang,0,6,30,30
1649983820801,MATH 170A,A03,083461,Nie; Jiawang,0,7,30,30
1649983826921,MATH 193B,A01,083463,Staff,1,0,30,29
1649983826921,MATH 193B,A02,083464,Staff,9,0,30,21
1649983826921,MATH 193B,A03,083465,Staff,18,0,30,12
1649983832979,COGS 2,A01,083966,Boyle; Mary E. T.,8,0,30,22
1649983839002,COGS 9,A01,083968,Staff,18,0,60,42
1649983845028,COGS 14B,A01,083970,Staff,13,0,50,37
1649983851052,COGS 17,A01,092679,Staff,56,0,75,19
1649983857075,COGS 100,A01,083972,Staff,0,15,60,60
1649983869129,COGS 101C,A01,083976,Staff,13,0,30,17
1649983875152,COGS 102A,A01,083978,Johnson; Christine M.,14,0,30,16
1649983881176,COGS 107B,A01,083980,Staff,0,6,50,50
1649983887198,COGS 115,A01,083982,Staff,11,0,30,19
1649983893226,COGS 118B,A01,083367,Staff,0,13,40,40
1649983899259,COGS 172,A01,083984,Provenzano; Emily Kara,15,0,30,15
1649983905286,COGS 177,A00,083368,Staff,0,21,30,30
1649983911334,COGS 186,A01,083986,Staff,21,0,40,19
1649983917357,COGS 187A,A01,083988,Boyle; Mary E. T.,19,0,60,41
1649983923385,CSE 8A,A50,084003,Miranda; Gregory Joseph,0,7,15,15
1649983929411,CSE 11,A01,084005,Miranda; Gregory Joseph,0,17,55,55
1649983935438,CSE 20,A01,084007,Staff,0,0,20,20
1649983941460,CSE 21,A01,084009,Staff,0,20,50,50
1649983947484,CSE 30,A01,083370,Cao; Yingjun,0,60,40,40
1649983953512,CSE 100,A01,083372,Cao; Yingjun,0,45,40,40
1649983959539,CSE 101,A01,084011,Staff,1,55,40,39
1649983965570,CSE 141,A01,083374,Eldon; John,0,61,75,75
1649983971593,CSE 141L,A01,083376,Eldon; John,0,67,75,75
1649983977615,CSE 175,A01,084013,Kumar; Rakesh,22,0,25,3
1649983983638,CSE 190,A00,092508,Dubnov; Shlomo,20,0,20,0
1649983989667,ECE 5,A01,084049,Morris; Karcher William,13,0,20,7
1649983995691,ECE 100,A01,084051,Baghdadchi; Saharnaz,0,0,20,20
1649983995691,ECE 100,A02,091916,Baghdadchi; Saharnaz,14,0,20,6
1649984001721,ECE 101,A01,084053,Baghdadchi; Saharnaz,2,0,37,35
1649984001721,ECE 101,A02,084054,Baghdadchi; Saharnaz,31,0,37,6
1649984007746,ECE 107,A01,083390,Staff,27,0,40,13
1649984013779,ECE 148,A01,084056,Silberman; Jack,8,0,12,4
1649984019803,ECE 180,A00,083391,Abi Samra; Nicholas Camill,25,0,30,5
1649984019803,ECE 180,B00,083392,Abi Samra; Nicholas Camill,21,0,30,9
1649984025830,MATH 10B,A01,084110,Staff,0,0,30,30
1649984025830,MATH 10B,A02,084111,Staff,26,0,30,4
1649984025830,MATH 10B,A03,084112,Staff,26,0,30,4
1649984031857,MATH 10C,A01,083443,Staff,1,7,30,29
1649984031857,MATH 10C,A02,083444,Staff,1,7,30,29
1649984031857,MATH 10C,B01,084114,Staff,21,0,30,9
1649984031857,MATH 10C,B02,084115,Staff,26,0,30,4
1649984037889,MATH 18,A01,084117,Harel; Guershon,19,0,30,11
1649984037889,MATH 18,A02,084119,Harel; Guershon,28,0,30,2
1649984037889,MATH 18,A03,084120,Harel; Guershon,30,0,30,0
1649984037889,MATH 18,A04,084121,Harel; Guershon,29,0,30,1
1649984043913,MATH 20B,A01,084124,Um; Ko Woon,24,0,35,11
1649984043913,MATH 20B,B01,084126,Um; Ko Woon,28,0,35,7
1649984049940,MATH 20C,A01,083446,Hammock; Frances H,3,0,30,27
1649984049940,MATH 20C,A02,083447,Hammock; Frances H,25,0,30,5
1649984049940,MATH 20C,A03,083448,Hammock; Frances H,27,0,30,3
1649984049940,MATH 20C,A04,083449,Hammock; Frances H,28,0,30,2
1649984049940,MATH 20C,B01,083451,Hammock; Frances H,10,0,30,20
1649984049940,MATH 20C,B02,083452,Hammock; Frances H,22,0,30,8
1649984049940,MATH 20C,B03,083453,Hammock; Frances H,24,0,30,6
1649984049940,MATH 20C,B04,083454,Hammock; Frances H,27,0,30,3
1649984055963,MATH 20D,A01,084128,Staff,18,0,30,12
1649984055963,MATH 20D,A02,084129,Staff,30,0,30,0
1649984055963,MATH 20D,A03,084130,Staff,27,0,30,3
1649984055963,MATH 20D,B01,084133,Staff,4,0,30,26
1649984055963,MATH 20D,B02,084134,Staff,24,0,30,6
1649984055963,MATH 20D,B03,084135,Staff,28,0,30,2
1649984061986,MATH 20E,A01,084138,Staff,15,0,30,15
1649984061986,MATH 20E,A02,084139,Staff,7,0,30,23
1649984061986,MATH 20E,A03,084140,Staff,15,0,30,15
1649984061986,MATH 20E,A04,084141,Staff,20,0,30,10
1649984068010,MATH 102,A01,084143,Harel; Guershon,13,0,30,17
1649984068010,MATH 102,A02,084144,Harel; Guershon,21,0,30,9
1649984074040,MATH 103B,A01,083456,Staff,0,12,30,30
1649984074040,MATH 103B,A02,083457,Staff,0,12,30,30
1649984080065,MATH 109,A01,084146,Salehi Golsefidy; Alireza,18,0,30,12
1649984080065,MATH 109,A02,084147,Salehi Golsefidy; Alireza,17,0,30,13
1649984086088,MATH 120A,A01,085445,Eggers; John Dietrich,14,0,35,21
1649984086088,MATH 120A,A02,085446,Eggers; John Dietrich,27,0,35,8
1649984092115,MATH 142B,A01,084149,Verstraete; Jacques Allan,0,12,30,30
1649984092115,MATH 142B,A02,084150,Verstraete; Jacques Allan,0,12,30,30
1649984098143,MATH 170A,A01,083459,Nie; Jiawang,1,8,30,29
1649984098143,MATH 170A,A02,083460,Nie; Jiawang,0,6,30,30
1649984098143,MATH 170A,A03,083461,Nie; Jiawang,0,7,30,30
1649984104171,MATH 193B,A01,083463,Staff,1,0,30,29
1649984104171,MATH 193B,A02,083464,Staff,9,0,30,21
1649984104171,MATH 193B,A03,083465,Staff,18,0,30,12
1649984110222,COGS 2,A01,083966,Boyle; Mary E. T.,8,0,30,22
1649984116256,COGS 9,A01,083968,Staff,18,0,60,42
1649984122280,COGS 14B,A01,083970,Staff,13,0,50,37
1649984128313,COGS 17,A01,092679,Staff,56,0,75,19
1649984134337,COGS 100,A01,083972,Staff,0,15,60,60
1649984146389,COGS 101C,A01,083976,Staff,13,0,30,17
1649984152415,COGS 102A,A01,083978,Johnson; Christine M.,14,0,30,16
1649984158447,COGS 107B,A01,083980,Staff,0,6,50,50
1649984164473,COGS 115,A01,083982,Staff,11,0,30,19
1649984170497,COGS 118B,A01,083367,Staff,0,13,40,40
1649984176527,COGS 172,A01,083984,Provenzano; Emily Kara,15,0,30,15
1649984182550,COGS 177,A00,083368,Staff,0,21,30,30
1649984188582,COGS 186,A01,083986,Staff,21,0,40,19
1649984194611,COGS 187A,A01,083988,Boyle; Mary E. T.,19,0,60,41
1649984200634,CSE 8A,A50,084003,Miranda; Gregory Joseph,0,7,15,15
1649984206669,CSE 11,A01,084005,Miranda; Gregory Joseph,0,17,55,55
1649984212700,CSE 20,A01,084007,Staff,0,0,20,20
1649984218723,CSE 21,A01,084009,Staff,0,21,50,50
1649984224745,CSE 30,A01,083370,Cao; Yingjun,0,60,40,40
1649984230770,CSE 100,A01,083372,Cao; Yingjun,0,45,40,40
1649984236795,CSE 101,A01,084011,Staff,1,55,40,39
1649984242827,CSE 141,A01,083374,Eldon; John,0,61,75,75
1649984248850,CSE 141L,A01,083376,Eldon; John,0,67,75,75
1649984254873,CSE 175,A01,084013,Kumar; Rakesh,22,0,25,3
1649984260901,CSE 190,A00,092508,Dubnov; Shlomo,20,0,20,0
1649984266931,ECE 5,A01,084049,Morris; Karcher William,13,0,20,7
1649984272958,ECE 100,A01,084051,Baghdadchi; Saharnaz,0,0,20,20
1649984272958,ECE 100,A02,091916,Baghdadchi; Saharnaz,14,0,20,6
1649984278982,ECE 101,A01,084053,Baghdadchi; Saharnaz,2,0,37,35
1649984278982,ECE 101,A02,084054,Baghdadchi; Saharnaz,31,0,37,6
1649984285008,ECE 107,A01,083390,Staff,27,0,40,13
1649984291029,ECE 148,A01,084056,Silberman; Jack,8,0,12,4
1649984297053,ECE 180,A00,083391,Abi Samra; Nicholas Camill,25,0,30,5
1649984297053,ECE 180,B00,083392,Abi Samra; Nicholas Camill,21,0,30,9
1649984303079,MATH 10B,A01,084110,Staff,0,0,30,30
1649984303079,MATH 10B,A02,084111,Staff,26,0,30,4
1649984303079,MATH 10B,A03,084112,Staff,26,0,30,4
1649984309107,MATH 10C,A01,083443,Staff,1,7,30,29
1649984309107,MATH 10C,A02,083444,Staff,1,7,30,29
1649984309107,MATH 10C,B01,084114,Staff,21,0,30,9
1649984309107,MATH 10C,B02,084115,Staff,26,0,30,4
1649984315133,MATH 18,A01,084117,Harel; Guershon,19,0,30,11
1649984315133,MATH 18,A02,084119,Harel; Guershon,28,0,30,2
1649984315133,MATH 18,A03,084120,Harel; Guershon,30,0,30,0
1649984315133,MATH 18,A04,084121,Harel; Guershon,29,0,30,1
1649984321161,MATH 20B,A01,084124,Um; Ko Woon,24,0,35,11
1649984321161,MATH 20B,B01,084126,Um; Ko Woon,27,0,35,8
1649984327184,MATH 20C,A01,083446,Hammock; Frances H,3,0,30,27
1649984327184,MATH 20C,A02,083447,Hammock; Frances H,25,0,30,5
1649984327184,MATH 20C,A03,083448,Hammock; Frances H,27,0,30,3
1649984327184,MATH 20C,A04,083449,Hammock; Frances H,28,0,30,2
1649984327184,MATH 20C,B01,083451,Hammock; Frances H,10,0,30,20
1649984327184,MATH 20C,B02,083452,Hammock; Frances H,22,0,30,8
1649984327184,MATH 20C,B03,083453,Hammock; Frances H,24,0,30,6
1649984327184,MATH 20C,B04,083454,Hammock; Frances H,27,0,30,3
1649984333212,MATH 20D,A01,084128,Staff,18,0,30,12
1649984333212,MATH 20D,A02,084129,Staff,30,0,30,0
1649984333212,MATH 20D,A03,084130,Staff,27,0,30,3
1649984333212,MATH 20D,B01,084133,Staff,4,0,30,26
1649984333212,MATH 20D,B02,084134,Staff,24,0,30,6
1649984333212,MATH 20D,B03,084135,Staff,28,0,30,2
1649984339237,MATH 20E,A01,084138,Staff,15,0,30,15
1649984339237,MATH 20E,A02,084139,Staff,7,0,30,23
1649984339237,MATH 20E,A03,084140,Staff,15,0,30,15
1649984339237,MATH 20E,A04,084141,Staff,20,0,30,10
1649984345260,MATH 102,A01,084143,Harel; Guershon,13,0,30,17
1649984345260,MATH 102,A02,084144,Harel; Guershon,21,0,30,9
1649984351285,MATH 103B,A01,083456,Staff,0,12,30,30
1649984351285,MATH 103B,A02,083457,Staff,0,12,30,30
1649984357324,MATH 109,A01,084146,Salehi Golsefidy; Alireza,19,0,30,11
1649984357324,MATH 109,A02,084147,Salehi Golsefidy; Alireza,17,0,30,13
1649984363353,MATH 120A,A01,085445,Eggers; John Dietrich,14,0,35,21
1649984363353,MATH 120A,A02,085446,Eggers; John Dietrich,27,0,35,8
1649984369376,MATH 142B,A01,084149,Verstraete; Jacques Allan,0,12,30,30
1649984369376,MATH 142B,A02,084150,Verstraete; Jacques Allan,0,12,30,30
1649984375413,MATH 170A,A01,083459,Nie; Jiawang,1,8,30,29
1649984375413,MATH 170A,A02,083460,Nie; Jiawang,0,6,30,30
1649984375413,MATH 170A,A03,083461,Nie; Jiawang,0,7,30,30
1649984381448,MATH 193B,A01,083463,Staff,1,0,30,29
1649984381448,MATH 193B,A02,083464,Staff,9,0,30,21
1649984381448,MATH 193B,A03,083465,Staff,18,0,30,12
1649984387502,COGS 2,A01,083966,Boyle; Mary E. T.,8,0,30,22
1649984393529,COGS 9,A01,083968,Staff,18,0,60,42
1649984399550,COGS 14B,A01,083970,Staff,13,0,50,37
1649984405575,COGS 17,A01,092679,Staff,56,0,75,19
1649984411597,COGS 100,A01,083972,Staff,0,15,60,60
1649984423734,COGS 101C,A01,083976,Staff,13,0,30,17
1649984429759,COGS 102A,A01,083978,Johnson; Christine M.,14,0,30,16
1649984435786,COGS 107B,A01,083980,Staff,0,6,50,50
1649984441813,COGS 115,A01,083982,Staff,11,0,30,19
1649984447839,COGS 118B,A01,083367,Staff,0,13,40,40
1649984453874,COGS 172,A01,083984,Provenzano; Emily Kara,15,0,30,15
1649984459900,COGS 177,A00,083368,Staff,0,21,30,30
1649984465923,COGS 186,A01,083986,Staff,21,0,40,19
1649984471947,COGS 187A,A01,083988,Boyle; Mary E. T.,19,0,60,41
1649984477975,CSE 8A,A50,084003,Miranda; Gregory Joseph,0,7,15,15
1649984483998,CSE 11,A01,084005,Miranda; Gregory Joseph,0,17,55,55
1649984490024,CSE 20,A01,084007,Staff,0,0,20,20
1649984496047,CSE 21,A01,084009,Staff,0,21,50,50
1649984502072,CSE 30,A01,083370,Cao; Yingjun,0,60,40,40
1649984508100,CSE 100,A01,083372,Cao; Yingjun,0,45,40,40
1649984514121,CSE 101,A01,084011,Staff,1,55,40,39
1649984520145,CSE 141,A01,083374,Eldon; John,0,62,75,75
1649984526169,CSE 141L,A01,083376,Eldon; John,0,68,75,75
1649984532210,CSE 175,A01,084013,Kumar; Rakesh,22,0,25,3
1649984538232,CSE 190,A00,092508,Dubnov; Shlomo,20,0,20,0
1649984544255,ECE 5,A01,084049,Morris; Karcher William,13,0,20,7
1649984550283,ECE 100,A01,084051,Baghdadchi; Saharnaz,0,0,20,20
1649984550283,ECE 100,A02,091916,Baghdadchi; Saharnaz,14,0,20,6
1649984556316,ECE 101,A01,084053,Baghdadchi; Saharnaz,2,0,37,35
1649984556316,ECE 101,A02,084054,Baghdadchi; Saharnaz,31,0,37,6
1649984562346,ECE 107,A01,083390,Staff,27,0,40,13
1649984568371,ECE 148,A01,084056,Silberman; Jack,8,0,12,4
1649984574399,ECE 180,A00,083391,Abi Samra; Nicholas Camill,25,0,30,5
1649984574399,ECE 180,B00,083392,Abi Samra; Nicholas Camill,21,0,30,9
1649984580421,MATH 10B,A01,084110,Staff,0,0,30,30
1649984580421,MATH 10B,A02,084111,Staff,26,0,30,4
1649984580421,MATH 10B,A03,084112,Staff,26,0,30,4
1649984586444,MATH 10C,A01,083443,Staff,1,7,30,29
1649984586444,MATH 10C,A02,083444,Staff,1,7,30,29
1649984586444,MATH 10C,B01,084114,Staff,21,0,30,9
1649984586444,MATH 10C,B02,084115,Staff,26,0,30,4
1649984592474,MATH 18,A01,084117,Harel; Guershon,19,0,30,11
1649984592474,MATH 18,A02,084119,Harel; Guershon,28,0,30,2
1649984592474,MATH 18,A03,084120,Harel; Guershon,30,0,30,0
1649984592474,MATH 18,A04,084121,Harel; Guershon,29,0,30,1
1649984598497,MATH 20B,A01,084124,Um; Ko Woon,23,0,35,12
1649984598497,MATH 20B,B01,084126,Um; Ko Woon,27,0,35,8
1649984604521,MATH 20C,A01,083446,Hammock; Frances H,3,0,30,27
1649984604521,MATH 20C,A02,083447,Hammock; Frances H,24,0,30,6
1649984604521,MATH 20C,A03,083448,Hammock; Frances H,27,0,30,3
1649984604521,MATH 20C,A04,083449,Hammock; Frances H,28,0,30,2
1649984604521,MATH 20C,B01,083451,Hammock; Frances H,10,0,30,20
1649984604521,MATH 20C,B02,083452,Hammock; Frances H,22,0,30,8
1649984604521,MATH 20C,B03,083453,Hammock; Frances H,24,0,30,6
1649984604521,MATH 20C,B04,083454,Hammock; Frances H,27,0,30,3
1649984610576,MATH 20D,A01,084128,Staff,18,0,30,12
1649984610576,MATH 20D,A02,084129,Staff,30,0,30,0
1649984610576,MATH 20D,A03,084130,Staff,27,0,30,3
1649984610576,MATH 20D,B01,084133,Staff,4,0,30,26
1649984610576,MATH 20D,B02,084134,Staff,24,0,30,6
1649984610576,MATH 20D,B03,084135,Staff,28,0,30,2
1649984616608,MATH 20E,A01,084138,Staff,15,0,30,15
1649984616608,MATH 20E,A02,084139,Staff,7,0,30,23
1649984616608,MATH 20E,A03,084140,Staff,15,0,30,15
1649984616608,MATH 20E,A04,084141,Staff,20,0,30,10
1649984622636,MATH 102,A01,084143,Harel; Guershon,13,0,30,17
1649984622636,MATH 102,A02,084144,Harel; Guershon,21,0,30,9
1649984628660,MATH 103B,A01,083456,Staff,0,12,30,30
1649984628660,MATH 103B,A02,083457,Staff,0,12,30,30
1649984634683,MATH 109,A01,084146,Salehi Golsefidy; Alireza,19,0,30,11
1649984634683,MATH 109,A02,084147,Salehi Golsefidy; Alireza,17,0,30,13
1649984640705,MATH 120A,A01,085445,Eggers; John Dietrich,14,0,35,21
1649984640705,MATH 120A,A02,085446,Eggers; John Dietrich,27,0,35,8
1649984646728,MATH 142B,A01,084149,Verstraete; Jacques Allan,0,12,30,30
1649984646728,MATH 142B,A02,084150,Verstraete; Jacques Allan,0,12,30,30
1649984652755,MATH 170A,A01,083459,Nie; Jiawang,1,8,30,29
1649984652755,MATH 170A,A02,083460,Nie; Jiawang,0,6,30,30
1649984652755,MATH 170A,A03,083461,Nie; Jiawang,0,7,30,30
1649984658782,MATH 193B,A01,083463,Staff,1,0,30,29
1649984658782,MATH 193B,A02,083464,Staff,9,0,30,21
1649984658782,MATH 193B,A03,083465,Staff,18,0,30,12
1649984664848,COGS 2,A01,083966,Boyle; Mary E. T.,8,0,30,22
1649984670871,COGS 9,A01,083968,Staff,17,0,60,43
1649984676895,COGS 14B,A01,083970,Staff,13,0,50,37
1649984682921,COGS 17,A01,092679,Staff,56,0,75,19
1649984688944,COGS 100,A01,083972,Staff,0,15,60,60
1649984701007,COGS 101C,A01,083976,Staff,13,0,30,17
1649984707030,COGS 102A,A01,083978,Johnson; Christine M.,14,0,30,16
1649984713053,COGS 107B,A01,083980,Staff,0,6,50,50
1649984719084,COGS 115,A01,083982,Staff,11,0,30,19
1649984725108,COGS 118B,A01,083367,Staff,0,13,40,40
1649984731131,COGS 172,A01,083984,Provenzano; Emily Kara,15,0,30,15
1649984737155,COGS 177,A00,083368,Staff,0,21,30,30
1649984743182,COGS 186,A01,083986,Staff,21,0,40,19
1649984749209,COGS 187A,A01,083988,Boyle; Mary E. T.,19,0,60,41
1649984755231,CSE 8A,A50,084003,Miranda; Gregory Joseph,0,7,15,15
1649984761256,CSE 11,A01,084005,Miranda; Gregory Joseph,0,17,55,55
1649984767282,CSE 20,A01,084007,Staff,0,0,20,20
1649984773305,CSE 21,A01,084009,Staff,0,21,50,50
1649984779337,CSE 30,A01,083370,Cao; Yingjun,0,60,40,40
1649984785360,CSE 100,A01,083372,Cao; Yingjun,0,45,40,40
1649984791395,CSE 101,A01,084011,Staff,1,55,40,39
1649984797420,CSE 141,A01,083374,Eldon; John,0,62,75,75
1649984803449,CSE 141L,A01,083376,Eldon; John,0,68,75,75
1649984809472,CSE 175,A01,084013,Kumar; Rakesh,22,0,25,3
1649984815496,CSE 190,A00,092508,Dubnov; Shlomo,20,0,20,0
1649984821523,ECE 5,A01,084049,Morris; Karcher William,13,0,20,7
1649984827545,ECE 100,A01,084051,Baghdadchi; Saharnaz,0,0,20,20
1649984827545,ECE 100,A02,091916,Baghdadchi; Saharnaz,14,0,20,6
1649984833568,ECE 101,A01,084053,Baghdadchi; Saharnaz,2,0,37,35
1649984833568,ECE 101,A02,084054,Baghdadchi; Saharnaz,31,0,37,6
1649984839601,ECE 107,A01,083390,Staff,27,0,40,13
1649984845624,ECE 148,A01,084056,Silberman; Jack,8,0,12,4
1649984851659,ECE 180,A00,083391,Abi Samra; Nicholas Camill,25,0,30,5
1649984851659,ECE 180,B00,083392,Abi Samra; Nicholas Camill,21,0,30,9
1649984857686,MATH 10B,A01,084110,Staff,0,0,30,30
1649984857686,MATH 10B,A02,084111,Staff,25,0,30,5
1649984857686,MATH 10B,A03,084112,Staff,26,0,30,4
1649984863727,MATH 10C,A01,083443,Staff,1,7,30,29
1649984863727,MATH 10C,A02,083444,Staff,1,7,30,29
1649984863727,MATH 10C,B01,084114,Staff,21,0,30,9
1649984863727,MATH 10C,B02,084115,Staff,26,0,30,4
1649984869749,MATH 18,A01,084117,Harel; Guershon,19,0,30,11
1649984869749,MATH 18,A02,084119,Harel; Guershon,28,0,30,2
1649984869749,MATH 18,A03,084120,Harel; Guershon,30,0,30,0
1649984869749,MATH 18,A04,084121,Harel; Guershon,29,0,30,1
1649984875776,MATH 20B,A01,084124,Um; Ko Woon,23,0,35,12
1649984875776,MATH 20B,B01,084126,Um; Ko Woon,27,0,35,8
1649984881801,MATH 20C,A01,083446,Hammock; Frances H,3,0,30,27
1649984881801,MATH 20C,A02,083447,Hammock; Frances H,24,0,30,6
1649984881801,MATH 20C,A03,083448,Hammock; Frances H,27,0,30,3
1649984881801,MATH 20C,A04,083449,Hammock; Frances H,28,0,30,2
1649984881801,MATH 20C,B01,083451,Hammock; Frances H,10,0,30,20
1649984881801,MATH 20C,B02,083452,Hammock; Frances H,22,0,30,8
1649984881801,MATH 20C,B03,083453,Hammock; Frances H,24,0,30,6
1649984881801,MATH 20C,B04,083454,Hammock; Frances H,27,0,30,3
1649984887826,MATH 20D,A01,084128,Staff,18,0,30,12
1649984887826,MATH 20D,A02,084129,Staff,30,0,30,0
1649984887826,MATH 20D,A03,084130,Staff,27,0,30,3
1649984887826,MATH 20D,B01,084133,Staff,4,0,30,26
1649984887826,MATH 20D,B02,084134,Staff,24,0,30,6
1649984887826,MATH 20D,B03,084135,Staff,28,0,30,2
1649984893849,MATH 20E,A01,084138,Staff,15,0,30,15
1649984893849,MATH 20E,A02,084139,Staff,7,0,30,23
1649984893849,MATH 20E,A03,084140,Staff,15,0,30,15
1649984893849,MATH 20E,A04,084141,Staff,20,0,30,10
1649984899872,MATH 102,A01,084143,Harel; Guershon,13,0,30,17
1649984899872,MATH 102,A02,084144,Harel; Guershon,21,0,30,9
1649984905895,MATH 103B,A01,083456,Staff,0,12,30,30
1649984905895,MATH 103B,A02,083457,Staff,0,12,30,30
1649984911930,MATH 109,A01,084146,Salehi Golsefidy; Alireza,19,0,30,11
1649984911930,MATH 109,A02,084147,Salehi Golsefidy; Alireza,17,0,30,13
1649984917964,MATH 120A,A01,085445,Eggers; John Dietrich,14,0,35,21
1649984917964,MATH 120A,A02,085446,Eggers; John Dietrich,27,0,35,8
1649984923994,MATH 142B,A01,084149,Verstraete; Jacques Allan,0,12,30,30
1649984923994,MATH 142B,A02,084150,Verstraete; Jacques Allan,0,12,30,30
1649984930017,MATH 170A,A01,083459,Nie; Jiawang,1,8,30,29
1649984930017,MATH 170A,A02,083460,Nie; Jiawang,0,6,30,30
1649984930017,MATH 170A,A03,083461,Nie; Jiawang,0,7,30,30
1649984936042,MATH 193B,A01,083463,Staff,1,0,30,29
1649984936042,MATH 193B,A02,083464,Staff,9,0,30,21
1649984936042,MATH 193B,A03,083465,Staff,18,0,30,12
1649984950853,COGS 2,A01,083966,Boyle; Mary E. T.,8,0,30,22
1649984956874,COGS 9,A01,083968,Staff,17,0,60,43
1649984962901,COGS 14B,A01,083970,Staff,13,0,50,37
1649984968929,COGS 17,A01,092679,Staff,56,0,75,19
1649984974950,COGS 100,A01,083972,Staff,0,15,60,60
1649984987008,COGS 101C,A01,083976,Staff,13,0,30,17
1649984993034,COGS 102A,A01,083978,Johnson; Christine M.,14,0,30,16
1649984999064,COGS 107B,A01,083980,Staff,0,6,50,50
1649985005087,COGS 115,A01,083982,Staff,11,0,30,19
1649985011114,COGS 118B,A01,083367,Staff,0,13,40,40
1649985017142,COGS 172,A01,083984,Provenzano; Emily Kara,15,0,30,15
1649985023274,COGS 177,A00,083368,Staff,0,21,30,30
1649985029297,COGS 186,A01,083986,Staff,21,0,40,19
1649985035320,COGS 187A,A01,083988,Boyle; Mary E. T.,19,0,60,41
1649985041341,CSE 8A,A50,084003,Miranda; Gregory Joseph,0,7,15,15
1649985047365,CSE 11,A01,084005,Miranda; Gregory Joseph,0,17,55,55
1649985053392,CSE 20,A01,084007,Staff,0,0,20,20
1649985059414,CSE 21,A01,084009,Staff,0,21,50,50
1649985065436,CSE 30,A01,083370,Cao; Yingjun,0,60,40,40
1649985071465,CSE 100,A01,083372,Cao; Yingjun,0,45,40,40
1649985077492,CSE 101,A01,084011,Staff,1,55,40,39
1649985083518,CSE 141,A01,083374,Eldon; John,0,62,75,75
1649985089546,CSE 141L,A01,083376,Eldon; John,0,68,75,75
1649985095580,CSE 175,A01,084013,Kumar; Rakesh,22,0,25,3
1649985101605,CSE 190,A00,092508,Dubnov; Shlomo,20,0,20,0
1649985107627,ECE 5,A01,084049,Morris; Karcher William,13,0,20,7
1649985113660,ECE 100,A01,084051,Baghdadchi; Saharnaz,0,0,20,20
1649985113660,ECE 100,A02,091916,Baghdadchi; Saharnaz,14,0,20,6
1649985119690,ECE 101,A01,084053,Baghdadchi; Saharnaz,2,0,37,35
1649985119690,ECE 101,A02,084054,Baghdadchi; Saharnaz,31,0,37,6
1649985125713,ECE 107,A01,083390,Staff,27,0,40,13
1649985131736,ECE 148,A01,084056,Silberman; Jack,8,0,12,4
1649985137775,ECE 180,A00,083391,Abi Samra; Nicholas Camill,25,0,30,5
1649985137775,ECE 180,B00,083392,Abi Samra; Nicholas Camill,21,0,30,9
1649985143810,MATH 10B,A01,084110,Staff,0,0,30,30
1649985143810,MATH 10B,A02,084111,Staff,25,0,30,5
1649985143810,MATH 10B,A03,084112,Staff,25,0,30,5
1649985149834,MATH 10C,A01,083443,Staff,1,9,30,29
1649985149834,MATH 10C,A02,083444,Staff,1,9,30,29
1649985149834,MATH 10C,B01,084114,Staff,21,0,30,9
1649985149834,MATH 10C,B02,084115,Staff,26,0,30,4
1649985155863,MATH 18,A01,084117,Harel; Guershon,19,0,30,11
1649985155863,MATH 18,A02,084119,Harel; Guershon,28,0,30,2
1649985155863,MATH 18,A03,084120,Harel; Guershon,29,0,30,1
1649985155863,MATH 18,A04,084121,Harel; Guershon,29,0,30,1
1649985161889,MATH 20B,A01,084124,Um; Ko Woon,22,0,35,13
1649985161889,MATH 20B,B01,084126,Um; Ko Woon,27,0,35,8
1649985167918,MATH 20C,A01,083446,Hammock; Frances H,3,0,30,27
1649985167918,MATH 20C,A02,083447,Hammock; Frances H,24,0,30,6
1649985167918,MATH 20C,A03,083448,Hammock; Frances H,27,0,30,3
1649985167918,MATH 20C,A04,083449,Hammock; Frances H,28,0,30,2
1649985167918,MATH 20C,B01,083451,Hammock; Frances H,10,0,30,20
1649985167918,MATH 20C,B02,083452,Hammock; Frances H,22,0,30,8
1649985167918,MATH 20C,B03,083453,Hammock; Frances H,24,0,30,6
1649985167918,MATH 20C,B04,083454,Hammock; Frances H,27,0,30,3
1649985173940,MATH 20D,A01,084128,Staff,18,0,30,12
1649985173940,MATH 20D,A02,084129,Staff,30,0,30,0
1649985173940,MATH 20D,A03,084130,Staff,27,0,30,3
1649985173940,MATH 20D,B01,084133,Staff,4,0,30,26
1649985173940,MATH 20D,B02,084134,Staff,24,0,30,6
1649985173940,MATH 20D,B03,084135,Staff,28,0,30,2
1649985179963,MATH 20E,A01,084138,Staff,15,0,30,15
1649985179963,MATH 20E,A02,084139,Staff,7,0,30,23
1649985179963,MATH 20E,A03,084140,Staff,15,0,30,15
1649985179963,MATH 20E,A04,084141,Staff,20,0,30,10
1649985185995,MATH 102,A01,084143,Harel; Guershon,13,0,30,17
1649985185995,MATH 102,A02,084144,Harel; Guershon,21,0,30,9
1649985192018,MATH 103B,A01,083456,Staff,0,12,30,30
1649985192018,MATH 103B,A02,083457,Staff,0,12,30,30
1649985198042,MATH 109,A01,084146,Salehi Golsefidy; Alireza,19,0,30,11
1649985198042,MATH 109,A02,084147,Salehi Golsefidy; Alireza,17,0,30,13
1649985204066,MATH 120A,A01,085445,Eggers; John Dietrich,14,0,35,21
1649985204066,MATH 120A,A02,085446,Eggers; John Dietrich,27,0,35,8
1649985210089,MATH 142B,A01,084149,Verstraete; Jacques Allan,0,12,30,30
1649985210089,MATH 142B,A02,084150,Verstraete; Jacques Allan,0,12,30,30
1649985216114,MATH 170A,A01,083459,Nie; Jiawang,1,8,30,29
1649985216114,MATH 170A,A02,083460,Nie; Jiawang,0,6,30,30
1649985216114,MATH 170A,A03,083461,Nie; Jiawang,0,7,30,30
1649985222137,MATH 193B,A01,083463,Staff,1,0,30,29
1649985222137,MATH 193B,A02,083464,Staff,9,0,30,21
1649985222137,MATH 193B,A03,083465,Staff,18,0,30,12
1649985228212,COGS 2,A01,083966,Boyle; Mary E. T.,8,0,30,22
1649985234238,COGS 9,A01,083968,Staff,17,0,60,43
1649985240290,COGS 14B,A01,083970,Staff,12,0,50,38
1649985246322,COGS 17,A01,092679,Staff,56,0,75,19
1649985252354,COGS 100,A01,083972,Staff,0,15,60,60
1649985264407,COGS 101C,A01,083976,Staff,13,0,30,17
1649985270430,COGS 102A,A01,083978,Johnson; Christine M.,14,0,30,16
1649985276454,COGS 107B,A01,083980,Staff,0,6,50,50
1649985282475,COGS 115,A01,083982,Staff,11,0,30,19
1649985288498,COGS 118B,A01,083367,Staff,0,13,40,40
1649985294522,COGS 172,A01,083984,Provenzano; Emily Kara,15,0,30,15
1649985300549,COGS 177,A00,083368,Staff,0,21,30,30
1649985306574,COGS 186,A01,083986,Staff,21,0,40,19
1649985312596,COGS 187A,A01,083988,Boyle; Mary E. T.,19,0,60,41
1649985318621,CSE 8A,A50,084003,Miranda; Gregory Joseph,0,8,15,15
1649985324657,CSE 11,A01,084005,Miranda; Gregory Joseph,0,17,55,55
1649985330687,CSE 20,A01,084007,Staff,0,1,20,20
1649985336722,CSE 21,A01,084009,Staff,0,21,50,50
1649985342745,CSE 30,A01,083370,Cao; Yingjun,0,60,40,40
1649985348772,CSE 100,A01,083372,Cao; Yingjun,0,45,40,40
1649985354798,CSE 101,A01,084011,Staff,1,55,40,39
1649985360831,CSE 141,A01,083374,Eldon; John,0,62,75,75
1649985366854,CSE 141L,A01,083376,Eldon; John,0,68,75,75
1649985372880,CSE 175,A01,084013,Kumar; Rakesh,22,0,25,3
1649985378908,CSE 190,A00,092508,Dubnov; Shlomo,20,0,20,0
1649985384939,ECE 5,A01,084049,Morris; Karcher William,13,0,20,7
1649985390972,ECE 100,A01,084051,Baghdadchi; Saharnaz,0,0,20,20
1649985390972,ECE 100,A02,091916,Baghdadchi; Saharnaz,14,0,20,6
1649985396995,ECE 101,A01,084053,Baghdadchi; Saharnaz,2,0,37,35
1649985396995,ECE 101,A02,084054,Baghdadchi; Saharnaz,31,0,37,6
1649985403049,ECE 107,A01,083390,Staff,27,0,40,13
1649985409071,ECE 148,A01,084056,Silberman; Jack,8,0,12,4
1649985415105,ECE 180,A00,083391,Abi Samra; Nicholas Camill,25,0,30,5
1649985415105,ECE 180,B00,083392,Abi Samra; Nicholas Camill,21,0,30,9
1649985421134,MATH 10B,A01,084110,Staff,0,0,30,30
1649985421134,MATH 10B,A02,084111,Staff,25,0,30,5
1649985421134,MATH 10B,A03,084112,Staff,25,0,30,5
1649985427159,MATH 10C,A01,083443,Staff,1,10,30,29
1649985427159,MATH 10C,A02,083444,Staff,1,9,30,29
1649985427159,MATH 10C,B01,084114,Staff,21,0,30,9
1649985427159,MATH 10C,B02,084115,Staff,26,0,30,4
1649985433188,MATH 18,A01,084117,Harel; Guershon,19,0,30,11
1649985433188,MATH 18,A02,084119,Harel; Guershon,28,0,30,2
1649985433188,MATH 18,A03,084120,Harel; Guershon,29,0,30,1
1649985433188,MATH 18,A04,084121,Harel; Guershon,29,0,30,1
1649985439228,MATH 20B,A01,084124,Um; Ko Woon,22,0,35,13
1649985439228,MATH 20B,B01,084126,Um; Ko Woon,27,0,35,8
1649985445258,MATH 20C,A01,083446,Hammock; Frances H,3,0,30,27
1649985445258,MATH 20C,A02,083447,Hammock; Frances H,24,0,30,6
1649985445258,MATH 20C,A03,083448,Hammock; Frances H,27,0,30,3
1649985445258,MATH 20C,A04,083449,Hammock; Frances H,28,0,30,2
1649985445258,MATH 20C,B01,083451,Hammock; Frances H,10,0,30,20
1649985445258,MATH 20C,B02,083452,Hammock; Frances H,22,0,30,8
1649985445258,MATH 20C,B03,083453,Hammock; Frances H,24,0,30,6
1649985445258,MATH 20C,B04,083454,Hammock; Frances H,27,0,30,3
1649985451285,MATH 20D,A01,084128,Staff,18,0,30,12
1649985451285,MATH 20D,A02,084129,Staff,30,0,30,0
1649985451285,MATH 20D,A03,084130,Staff,27,0,30,3
1649985451285,MATH 20D,B01,084133,Staff,4,0,30,26
1649985451285,MATH 20D,B02,084134,Staff,24,0,30,6
1649985451285,MATH 20D,B03,084135,Staff,28,0,30,2
1649985457306,MATH 20E,A01,084138,Staff,15,0,30,15
1649985457306,MATH 20E,A02,084139,Staff,7,0,30,23
1649985457306,MATH 20E,A03,084140,Staff,15,0,30,15
1649985457306,MATH 20E,A04,084141,Staff,20,0,30,10
1649985463329,MATH 102,A01,084143,Harel; Guershon,13,0,30,17
1649985463329,MATH 102,A02,084144,Harel; Guershon,21,0,30,9
1649985469368,MATH 103B,A01,083456,Staff,0,12,30,30
1649985469368,MATH 103B,A02,083457,Staff,0,12,30,30
1649985475391,MATH 109,A01,084146,Salehi Golsefidy; Alireza,19,0,30,11
1649985475391,MATH 109,A02,084147,Salehi Golsefidy; Alireza,17,0,30,13
1649985481429,MATH 120A,A01,085445,Eggers; John Dietrich,14,0,35,21
1649985481429,MATH 120A,A02,085446,Eggers; John Dietrich,27,0,35,8
1649985487453,MATH 142B,A01,084149,Verstraete; Jacques Allan,0,12,30,30
1649985487453,MATH 142B,A02,084150,Verstraete; Jacques Allan,0,12,30,30
1649985493481,MATH 170A,A01,083459,Nie; Jiawang,1,8,30,29
1649985493481,MATH 170A,A02,083460,Nie; Jiawang,0,6,30,30
1649985493481,MATH 170A,A03,083461,Nie; Jiawang,0,7,30,30
1649985499505,MATH 193B,A01,083463,Staff,1,0,30,29
1649985499505,MATH 193B,A02,083464,Staff,9,0,30,21
1649985499505,MATH 193B,A03,083465,Staff,18,0,30,12
1649985505554,COGS 2,A01,083966,Boyle; Mary E. T.,8,0,30,22
1649985511580,COGS 9,A01,083968,Staff,17,0,60,43
1649985517612,COGS 14B,A01,083970,Staff,12,0,50,38
1649985523635,COGS 17,A01,092679,Staff,56,0,75,19
1649985529659,COGS 100,A01,083972,Staff,0,15,60,60
1649985541708,COGS 101C,A01,083976,Staff,13,0,30,17
1649985547740,COGS 102A,A01,083978,Johnson; Christine M.,14,0,30,16
1649985553770,COGS 107B,A01,083980,Staff,0,6,50,50
1649985559796,COGS 115,A01,083982,Staff,11,0,30,19
1649985565821,COGS 118B,A01,083367,Staff,0,13,40,40
1649985571846,COGS 172,A01,083984,Provenzano; Emily Kara,15,0,30,15
1649985577871,COGS 177,A00,083368,Staff,0,21,30,30
1649985583896,COGS 186,A01,083986,Staff,21,0,40,19
1649985589921,COGS 187A,A01,083988,Boyle; Mary E. T.,19,0,60,41
1649985595947,CSE 8A,A50,084003,Miranda; Gregory Joseph,0,8,15,15
1649985601971,CSE 11,A01,084005,Miranda; Gregory Joseph,0,17,55,55
1649985607994,CSE 20,A01,084007,Staff,0,1,20,20
1649985614016,CSE 21,A01,084009,Staff,0,21,50,50
1649985620152,CSE 30,A01,083370,Cao; Yingjun,0,60,40,40
1649985626175,CSE 100,A01,083372,Cao; Yingjun,0,45,40,40
1649985632201,CSE 101,A01,084011,Staff,1,55,40,39
1649985638224,CSE 141,A01,083374,Eldon; John,0,62,75,75
1649985644247,CSE 141L,A01,083376,Eldon; John,0,68,75,75
1649985650270,CSE 175,A01,084013,Kumar; Rakesh,22,0,25,3
1649985656296,CSE 190,A00,092508,Dubnov; Shlomo,20,0,20,0
1649985662330,ECE 5,A01,084049,Morris; Karcher William,13,0,20,7
1649985668359,ECE 100,A01,084051,Baghdadchi; Saharnaz,0,0,20,20
1649985668359,ECE 100,A02,091916,Baghdadchi; Saharnaz,14,0,20,6
1649985674387,ECE 101,A01,084053,Baghdadchi; Saharnaz,2,0,37,35
1649985674387,ECE 101,A02,084054,Baghdadchi; Saharnaz,31,0,37,6
1649985680414,ECE 107,A01,083390,Staff,27,0,40,13
1649985686438,ECE 148,A01,084056,Silberman; Jack,8,0,12,4
1649985692473,ECE 180,A00,083391,Abi Samra; Nicholas Camill,25,0,30,5
1649985692473,ECE 180,B00,083392,Abi Samra; Nicholas Camill,21,0,30,9
1649985698514,MATH 10B,A01,084110,Staff,0,0,30,30
1649985698514,MATH 10B,A02,084111,Staff,24,0,30,6
1649985698514,MATH 10B,A03,084112,Staff,25,0,30,5
1649985704538,MATH 10C,A01,083443,Staff,1,10,30,29
1649985704538,MATH 10C,A02,083444,Staff,1,9,30,29
1649985704538,MATH 10C,B01,084114,Staff,21,0,30,9
1649985704538,MATH 10C,B02,084115,Staff,26,0,30,4
1649985710560,MATH 18,A01,084117,Harel; Guershon,19,0,30,11
1649985710560,MATH 18,A02,084119,Harel; Guershon,28,0,30,2
1649985710560,MATH 18,A03,084120,Harel; Guershon,29,0,30,1
1649985710560,MATH 18,A04,084121,Harel; Guershon,29,0,30,1
1649985716583,MATH 20B,A01,084124,Um; Ko Woon,22,0,35,13
1649985716583,MATH 20B,B01,084126,Um; Ko Woon,27,0,35,8
1649985722607,MATH 20C,A01,083446,Hammock; Frances H,2,0,30,28
1649985722607,MATH 20C,A02,083447,Hammock; Frances H,24,0,30,6
1649985722607,MATH 20C,A03,083448,Hammock; Frances H,26,0,30,4
1649985722607,MATH 20C,A04,083449,Hammock; Frances H,28,0,30,2
1649985722607,MATH 20C,B01,083451,Hammock; Frances H,10,0,30,20
1649985722607,MATH 20C,B02,083452,Hammock; Frances H,22,0,30,8
1649985722607,MATH 20C,B03,083453,Hammock; Frances H,24,0,30,6
1649985722607,MATH 20C,B04,083454,Hammock; Frances H,27,0,30,3
1649985728657,MATH 20D,A01,084128,Staff,18,0,30,12
1649985728657,MATH 20D,A02,084129,Staff,30,0,30,0
1649985728657,MATH 20D,A03,084130,Staff,27,0,30,3
1649985728657,MATH 20D,B01,084133,Staff,4,0,30,26
1649985728657,MATH 20D,B02,084134,Staff,24,0,30,6
1649985728657,MATH 20D,B03,084135,Staff,28,0,30,2
1649985734686,MATH 20E,A01,084138,Staff,14,0,30,16
1649985734686,MATH 20E,A02,084139,Staff,7,0,30,23
1649985734686,MATH 20E,A03,084140,Staff,15,0,30,15
1649985734686,MATH 20E,A04,084141,Staff,20,0,30,10
1649985740713,MATH 102,A01,084143,Harel; Guershon,13,0,30,17
1649985740713,MATH 102,A02,084144,Harel; Guershon,21,0,30,9
1649985746735,MATH 103B,A01,083456,Staff,0,12,30,30
1649985746735,MATH 103B,A02,083457,Staff,0,12,30,30
1649985752758,MATH 109,A01,084146,Salehi Golsefidy; Alireza,19,0,30,11
1649985752758,MATH 109,A02,084147,Salehi Golsefidy; Alireza,17,0,30,13
1649985758779,MATH 120A,A01,085445,Eggers; John Dietrich,14,0,35,21
1649985758779,MATH 120A,A02,085446,Eggers; John Dietrich,27,0,35,8
1649985764805,MATH 142B,A01,084149,Verstraete; Jacques Allan,0,12,30,30
1649985764805,MATH 142B,A02,084150,Verstraete; Jacques Allan,0,12,30,30
1649985770831,MATH 170A,A01,083459,Nie; Jiawang,1,8,30,29
1649985770831,MATH 170A,A02,083460,Nie; Jiawang,0,6,30,30
1649985770831,MATH 170A,A03,083461,Nie; Jiawang,0,7,30,30
1649985776856,MATH 193B,A01,083463,Staff,1,0,30,29
1649985776856,MATH 193B,A02,083464,Staff,9,0,30,21
1649985776856,MATH 193B,A03,083465,Staff,18,0,30,12
1649985782916,COGS 2,A01,083966,Boyle; Mary E. T.,8,0,30,22
1649985788937,COGS 9,A01,083968,Staff,17,0,60,43
1649985794962,COGS 14B,A01,083970,Staff,12,0,50,38
1649985800994,COGS 17,A01,092679,Staff,56,0,75,19
1649985807020,COGS 100,A01,083972,Staff,0,15,60,60
1649985819067,COGS 101C,A01,083976,Staff,13,0,30,17
1649985825090,COGS 102A,A01,083978,Johnson; Christine M.,14,0,30,16
1649985831117,COGS 107B,A01,083980,Staff,0,6,50,50
1649985837153,COGS 115,A01,083982,Staff,11,0,30,19
1649985843177,COGS 118B,A01,083367,Staff,0,13,40,40
1649985849203,COGS 172,A01,083984,Provenzano; Emily Kara,15,0,30,15
1649985855227,COGS 177,A00,083368,Staff,0,21,30,30
1649985861253,COGS 186,A01,083986,Staff,21,0,40,19
1649985867277,COGS 187A,A01,083988,Boyle; Mary E. T.,19,0,60,41
1649985873322,CSE 8A,A50,084003,Miranda; Gregory Joseph,0,8,15,15
1649985879344,CSE 11,A01,084005,Miranda; Gregory Joseph,0,17,55,55
1649985885367,CSE 20,A01,084007,Staff,0,1,20,20
1649985891394,CSE 21,A01,084009,Staff,0,21,50,50
1649985897417,CSE 30,A01,083370,Cao; Yingjun,0,60,40,40
1649985903447,CSE 100,A01,083372,Cao; Yingjun,0,45,40,40
1649985909469,CSE 101,A01,084011,Staff,1,55,40,39
1649985915492,CSE 141,A01,083374,Eldon; John,0,62,75,75
1649985921520,CSE 141L,A01,083376,Eldon; John,0,68,75,75
1649985927569,CSE 175,A01,084013,Kumar; Rakesh,22,0,25,3
1649985933595,CSE 190,A00,092508,Dubnov; Shlomo,20,0,20,0
1649985939621,ECE 5,A01,084049,Morris; Karcher William,13,0,20,7
1649985945644,ECE 100,A01,084051,Baghdadchi; Saharnaz,0,0,20,20
1649985945644,ECE 100,A02,091916,Baghdadchi; Saharnaz,14,0,20,6
1649985951667,ECE 101,A01,084053,Baghdadchi; Saharnaz,2,0,37,35
1649985951667,ECE 101,A02,084054,Baghdadchi; Saharnaz,31,0,37,6
1649985957690,ECE 107,A01,083390,Staff,27,0,40,13
1649985963718,ECE 148,A01,084056,Silberman; Jack,8,0,12,4
1649985969749,ECE 180,A00,083391,Abi Samra; Nicholas Camill,25,0,30,5
1649985969749,ECE 180,B00,083392,Abi Samra; Nicholas Camill,21,0,30,9
1649985975772,MATH 10B,A01,084110,Staff,0,0,30,30
1649985975772,MATH 10B,A02,084111,Staff,24,0,30,6
1649985975772,MATH 10B,A03,084112,Staff,25,0,30,5
1649985981796,MATH 10C,A01,083443,Staff,1,10,30,29
1649985981796,MATH 10C,A02,083444,Staff,1,10,30,29
1649985981796,MATH 10C,B01,084114,Staff,21,0,30,9
1649985981796,MATH 10C,B02,084115,Staff,26,0,30,4
1649985987823,MATH 18,A01,084117,Harel; Guershon,19,0,30,11
1649985987823,MATH 18,A02,084119,Harel; Guershon,28,0,30,2
1649985987823,MATH 18,A03,084120,Harel; Guershon,29,0,30,1
1649985987823,MATH 18,A04,084121,Harel; Guershon,29,0,30,1
1649985993845,MATH 20B,A01,084124,Um; Ko Woon,22,0,35,13
1649985993845,MATH 20B,B01,084126,Um; Ko Woon,27,0,35,8
1649985999869,MATH 20C,A01,083446,Hammock; Frances H,2,0,30,28
1649985999869,MATH 20C,A02,083447,Hammock; Frances H,24,0,30,6
1649985999869,MATH 20C,A03,083448,Hammock; Frances H,26,0,30,4
1649985999869,MATH 20C,A04,083449,Hammock; Frances H,28,0,30,2
1649985999869,MATH 20C,B01,083451,Hammock; Frances H,9,0,30,21
1649985999869,MATH 20C,B02,083452,Hammock; Frances H,22,0,30,8
1649985999869,MATH 20C,B03,083453,Hammock; Frances H,24,0,30,6
1649985999869,MATH 20C,B04,083454,Hammock; Frances H,27,0,30,3
1649986005898,MATH 20D,A01,084128,Staff,18,0,30,12
1649986005898,MATH 20D,A02,084129,Staff,30,0,30,0
1649986005898,MATH 20D,A03,084130,Staff,27,0,30,3
1649986005898,MATH 20D,B01,084133,Staff,4,0,30,26
1649986005898,MATH 20D,B02,084134,Staff,24,0,30,6
1649986005898,MATH 20D,B03,084135,Staff,28,0,30,2
1649986011920,MATH 20E,A01,084138,Staff,14,0,30,16
1649986011920,MATH 20E,A02,084139,Staff,7,0,30,23
1649986011920,MATH 20E,A03,084140,Staff,15,0,30,15
1649986011920,MATH 20E,A04,084141,Staff,20,0,30,10
1649986017946,MATH 102,A01,084143,Harel; Guershon,13,0,30,17
1649986017946,MATH 102,A02,084144,Harel; Guershon,21,0,30,9
1649986023972,MATH 103B,A01,083456,Staff,0,12,30,30
1649986023972,MATH 103B,A02,083457,Staff,0,12,30,30
1649986029995,MATH 109,A01,084146,Salehi Golsefidy; Alireza,19,0,30,11
1649986029995,MATH 109,A02,084147,Salehi Golsefidy; Alireza,17,0,30,13
1649986036020,MATH 120A,A01,085445,Eggers; John Dietrich,14,0,35,21
1649986036020,MATH 120A,A02,085446,Eggers; John Dietrich,27,0,35,8
1649986042044,MATH 142B,A01,084149,Verstraete; Jacques Allan,0,12,30,30
1649986042044,MATH 142B,A02,084150,Verstraete; Jacques Allan,0,12,30,30
1649986048075,MATH 170A,A01,083459,Nie; Jiawang,1,8,30,29
1649986048075,MATH 170A,A02,083460,Nie; Jiawang,0,6,30,30
1649986048075,MATH 170A,A03,083461,Nie; Jiawang,0,7,30,30
1649986054100,MATH 193B,A01,083463,Staff,1,0,30,29
1649986054100,MATH 193B,A02,083464,Staff,9,0,30,21
1649986054100,MATH 193B,A03,083465,Staff,18,0,30,12
1649986060180,COGS 2,A01,083966,Boyle; Mary E. T.,9,0,30,21
1649986066206,COGS 9,A01,083968,Staff,17,0,60,43
1649986072232,COGS 14B,A01,083970,Staff,12,0,50,38
1649986078255,COGS 17,A01,092679,Staff,56,0,75,19
1649986084287,COGS 100,A01,083972,Staff,0,15,60,60
1649986096353,COGS 101C,A01,083976,Staff,13,0,30,17
1649986102381,COGS 102A,A01,083978,Johnson; Christine M.,14,0,30,16
1649986108406,COGS 107B,A01,083980,Staff,0,7,50,50
1649986114436,COGS 115,A01,083982,Staff,11,0,30,19
1649986120460,COGS 118B,A01,083367,Staff,0,14,40,40
1649986126487,COGS 172,A01,083984,Provenzano; Emily Kara,15,0,30,15
1649986132514,COGS 177,A00,083368,Staff,0,21,30,30
1649986138536,COGS 186,A01,083986,Staff,21,0,40,19
1649986144566,COGS 187A,A01,083988,Boyle; Mary E. T.,19,0,60,41
1649986150595,CSE 8A,A50,084003,Miranda; Gregory Joseph,0,8,15,15
1649986156619,CSE 11,A01,084005,Miranda; Gregory Joseph,0,18,55,55
1649986162645,CSE 20,A01,084007,Staff,0,1,20,20
1649986168676,CSE 21,A01,084009,Staff,0,22,50,50
1649986174706,CSE 30,A01,083370,Cao; Yingjun,0,60,40,40
1649986180731,CSE 100,A01,083372,Cao; Yingjun,0,45,40,40
1649986186768,CSE 101,A01,084011,Staff,1,55,40,39
1649986192794,CSE 141,A01,083374,Eldon; John,0,62,75,75
1649986198817,CSE 141L,A01,083376,Eldon; John,0,68,75,75
1649986204843,CSE 175,A01,084013,Kumar; Rakesh,22,0,25,3
1649986210870,CSE 190,A00,092508,Dubnov; Shlomo,20,0,20,0
1649986216969,ECE 5,A01,084049,Morris; Karcher William,13,0,20,7
1649986222992,ECE 100,A01,084051,Baghdadchi; Saharnaz,0,0,20,20
1649986222992,ECE 100,A02,091916,Baghdadchi; Saharnaz,14,0,20,6
1649986229018,ECE 101,A01,084053,Baghdadchi; Saharnaz,2,0,37,35
1649986229018,ECE 101,A02,084054,Baghdadchi; Saharnaz,31,0,37,6
1649986235046,ECE 107,A01,083390,Staff,27,0,40,13
1649986241068,ECE 148,A01,084056,Silberman; Jack,8,0,12,4
1649986247092,ECE 180,A00,083391,Abi Samra; Nicholas Camill,25,0,30,5
1649986247092,ECE 180,B00,083392,Abi Samra; Nicholas Camill,21,0,30,9
1649986253121,MATH 10B,A01,084110,Staff,0,0,30,30
1649986253121,MATH 10B,A02,084111,Staff,24,0,30,6
1649986253121,MATH 10B,A03,084112,Staff,25,0,30,5
1649986259159,MATH 10C,A01,083443,Staff,1,10,30,29
1649986259159,MATH 10C,A02,083444,Staff,1,10,30,29
1649986259159,MATH 10C,B01,084114,Staff,21,0,30,9
1649986259159,MATH 10C,B02,084115,Staff,26,0,30,4
1649986265182,MATH 18,A01,084117,Harel; Guershon,19,0,30,11
1649986265182,MATH 18,A02,084119,Harel; Guershon,28,0,30,2
1649986265182,MATH 18,A03,084120,Harel; Guershon,29,0,30,1
1649986265182,MATH 18,A04,084121,Harel; Guershon,29,0,30,1
1649986271209,MATH 20B,A01,084124,Um; Ko Woon,22,0,35,13
1649986271209,MATH 20B,B01,084126,Um; Ko Woon,27,0,35,8
1649986277232,MATH 20C,A01,083446,Hammock; Frances H,2,0,30,28
1649986277232,MATH 20C,A02,083447,Hammock; Frances H,24,0,30,6
1649986277232,MATH 20C,A03,083448,Hammock; Frances H,26,0,30,4
1649986277232,MATH 20C,A04,083449,Hammock; Frances H,28,0,30,2
1649986277232,MATH 20C,B01,083451,Hammock; Frances H,9,0,30,21
1649986277232,MATH 20C,B02,083452,Hammock; Frances H,22,0,30,8
1649986277232,MATH 20C,B03,083453,Hammock; Frances H,24,0,30,6
1649986277232,MATH 20C,B04,083454,Hammock; Frances H,27,0,30,3
1649986283260,MATH 20D,A01,084128,Staff,18,0,30,12
1649986283260,MATH 20D,A02,084129,Staff,30,0,30,0
1649986283260,MATH 20D,A03,084130,Staff,27,0,30,3
1649986283260,MATH 20D,B01,084133,Staff,4,0,30,26
1649986283260,MATH 20D,B02,084134,Staff,24,0,30,6
1649986283260,MATH 20D,B03,084135,Staff,28,0,30,2
1649986289283,MATH 20E,A01,084138,Staff,14,0,30,16
1649986289283,MATH 20E,A02,084139,Staff,7,0,30,23
1649986289283,MATH 20E,A03,084140,Staff,15,0,30,15
1649986289283,MATH 20E,A04,084141,Staff,19,0,30,11
1649986295309,MATH 102,A01,084143,Harel; Guershon,12,0,30,18
1649986295309,MATH 102,A02,084144,Harel; Guershon,21,0,30,9
1649986301338,MATH 103B,A01,083456,Staff,0,12,30,30
1649986301338,MATH 103B,A02,083457,Staff,0,12,30,30
1649986307370,MATH 109,A01,084146,Salehi Golsefidy; Alireza,19,0,30,11
1649986307370,MATH 109,A02,084147,Salehi Golsefidy; Alireza,17,0,30,13
1649986313397,MATH 120A,A01,085445,Eggers; John Dietrich,14,0,35,21
1649986313397,MATH 120A,A02,085446,Eggers; John Dietrich,27,0,35,8
1649986319420,MATH 142B,A01,084149,Verstraete; Jacques Allan,0,12,30,30
1649986319420,MATH 142B,A02,084150,Verstraete; Jacques Allan,0,12,30,30
1649986325451,MATH 170A,A01,083459,Nie; Jiawang,1,8,30,29
1649986325451,MATH 170A,A02,083460,Nie; Jiawang,0,6,30,30
1649986325451,MATH 170A,A03,083461,Nie; Jiawang,0,7,30,30
1649986331473,MATH 193B,A01,083463,Staff,1,0,30,29
1649986331473,MATH 193B,A02,083464,Staff,9,0,30,21
1649986331473,MATH 193B,A03,083465,Staff,18,0,30,12
1649986337525,COGS 2,A01,083966,Boyle; Mary E. T.,9,0,30,21
1649986343547,COGS 9,A01,083968,Staff,17,0,60,43
1649986349571,COGS 14B,A01,083970,Staff,12,0,50,38
1649986355596,COGS 17,A01,092679,Staff,56,0,75,19
1649986361618,COGS 100,A01,083972,Staff,0,15,60,60
1649986373665,COGS 101C,A01,083976,Staff,13,0,30,17
1649986379698,COGS 102A,A01,083978,Johnson; Christine M.,14,0,30,16
1649986385721,COGS 107B,A01,083980,Staff,0,7,50,50
1649986391742,COGS 115,A01,083982,Staff,11,0,30,19
1649986397763,COGS 118B,A01,083367,Staff,0,14,40,40
1649986403789,COGS 172,A01,083984,Provenzano; Emily Kara,15,0,30,15
1649986409821,COGS 177,A00,083368,Staff,0,21,30,30
1649986415843,COGS 186,A01,083986,Staff,21,0,40,19
1649986421864,COGS 187A,A01,083988,Boyle; Mary E. T.,19,0,60,41
1649986427897,CSE 8A,A50,084003,Miranda; Gregory Joseph,0,8,15,15
1649986433920,CSE 11,A01,084005,Miranda; Gregory Joseph,0,18,55,55
1649986439946,CSE 20,A01,084007,Staff,0,1,20,20
1649986445969,CSE 21,A01,084009,Staff,0,22,50,50
1649986451992,CSE 30,A01,083370,Cao; Yingjun,0,60,40,40
1649986458014,CSE 100,A01,083372,Cao; Yingjun,0,45,40,40
1649986464036,CSE 101,A01,084011,Staff,1,55,40,39
1649986470068,CSE 141,A01,083374,Eldon; John,0,62,75,75
1649986476090,CSE 141L,A01,083376,Eldon; John,0,68,75,75
1649986482113,CSE 175,A01,084013,Kumar; Rakesh,22,0,25,3
1649986488138,CSE 190,A00,092508,Dubnov; Shlomo,20,0,20,0
1649986494165,ECE 5,A01,084049,Morris; Karcher William,13,0,20,7
1649986500192,ECE 100,A01,084051,Baghdadchi; Saharnaz,0,0,20,20
1649986500192,ECE 100,A02,091916,Baghdadchi; Saharnaz,14,0,20,6
1649986506217,ECE 101,A01,084053,Baghdadchi; Saharnaz,2,0,37,35
1649986506217,ECE 101,A02,084054,Baghdadchi; Saharnaz,31,0,37,6
1649986512245,ECE 107,A01,083390,Staff,27,0,40,13
1649986518278,ECE 148,A01,084056,Silberman; Jack,8,0,12,4
1649986524305,ECE 180,A00,083391,Abi Samra; Nicholas Camill,25,0,30,5
1649986524305,ECE 180,B00,083392,Abi Samra; Nicholas Camill,21,0,30,9
1649986530332,MATH 10B,A01,084110,Staff,0,0,30,30
1649986530332,MATH 10B,A02,084111,Staff,23,0,30,7
1649986530332,MATH 10B,A03,084112,Staff,25,0,30,5
1649986536362,MATH 10C,A01,083443,Staff,1,11,30,29
1649986536362,MATH 10C,A02,083444,Staff,1,10,30,29
1649986536362,MATH 10C,B01,084114,Staff,21,0,30,9
1649986536362,MATH 10C,B02,084115,Staff,26,0,30,4
1649986542387,MATH 18,A01,084117,Harel; Guershon,19,0,30,11
1649986542387,MATH 18,A02,084119,Harel; Guershon,28,0,30,2
1649986542387,MATH 18,A03,084120,Harel; Guershon,29,0,30,1
1649986542387,MATH 18,A04,084121,Harel; Guershon,29,0,30,1
1649986548412,MATH 20B,A01,084124,Um; Ko Woon,21,0,35,14
1649986548412,MATH 20B,B01,084126,Um; Ko Woon,27,0,35,8
1649986554437,MATH 20C,A01,083446,Hammock; Frances H,1,0,30,29
1649986554437,MATH 20C,A02,083447,Hammock; Frances H,24,0,30,6
1649986554437,MATH 20C,A03,083448,Hammock; Frances H,26,0,30,4
1649986554437,MATH 20C,A04,083449,Hammock; Frances H,28,0,30,2
1649986554437,MATH 20C,B01,083451,Hammock; Frances H,7,0,30,23
1649986554437,MATH 20C,B02,083452,Hammock; Frances H,21,0,30,9
1649986554437,MATH 20C,B03,083453,Hammock; Frances H,24,0,30,6
1649986554437,MATH 20C,B04,083454,Hammock; Frances H,27,0,30,3
1649986560473,MATH 20D,A01,084128,Staff,18,0,30,12
1649986560473,MATH 20D,A02,084129,Staff,29,0,30,1
1649986560473,MATH 20D,A03,084130,Staff,27,0,30,3
1649986560473,MATH 20D,B01,084133,Staff,4,0,30,26
1649986560473,MATH 20D,B02,084134,Staff,24,0,30,6
1649986560473,MATH 20D,B03,084135,Staff,28,0,30,2
1649986566497,MATH 20E,A01,084138,Staff,14,0,30,16
1649986566497,MATH 20E,A02,084139,Staff,7,0,30,23
1649986566497,MATH 20E,A03,084140,Staff,15,0,30,15
1649986566497,MATH 20E,A04,084141,Staff,20,0,30,10
1649986572534,MATH 102,A01,084143,Harel; Guershon,12,0,30,18
1649986572534,MATH 102,A02,084144,Harel; Guershon,21,0,30,9
1649986578557,MATH 103B,A01,083456,Staff,0,12,30,30
1649986578557,MATH 103B,A02,083457,Staff,0,12,30,30
1649986584587,MATH 109,A01,084146,Salehi Golsefidy; Alireza,19,0,30,11
1649986584587,MATH 109,A02,084147,Salehi Golsefidy; Alireza,17,0,30,13
1649986590612,MATH 120A,A01,085445,Eggers; John Dietrich,14,0,35,21
1649986590612,MATH 120A,A02,085446,Eggers; John Dietrich,27,0,35,8
1649986596638,MATH 142B,A01,084149,Verstraete; Jacques Allan,0,12,30,30
1649986596638,MATH 142B,A02,084150,Verstraete; Jacques Allan,0,12,30,30
1649986602663,MATH 170A,A01,083459,Nie; Jiawang,1,8,30,29
1649986602663,MATH 170A,A02,083460,Nie; Jiawang,0,6,30,30
1649986602663,MATH 170A,A03,083461,Nie; Jiawang,0,7,30,30
1649986608701,MATH 193B,A01,083463,Staff,1,0,30,29
1649986608701,MATH 193B,A02,083464,Staff,9,0,30,21
1649986608701,MATH 193B,A03,083465,Staff,18,0,30,12
1649986614756,COGS 2,A01,083966,Boyle; Mary E. T.,9,0,30,21
1649986620779,COGS 9,A01,083968,Staff,17,0,60,43
1649986626805,COGS 14B,A01,083970,Staff,12,0,50,38
1649986632842,COGS 17,A01,092679,Staff,56,0,75,19
1649986638865,COGS 100,A01,083972,Staff,0,15,60,60
1649986650912,COGS 101C,A01,083976,Staff,13,0,30,17
1649986656945,COGS 102A,A01,083978,Johnson; Christine M.,14,0,30,16
1649986662975,COGS 107B,A01,083980,Staff,0,7,50,50
1649986669005,COGS 115,A01,083982,Staff,11,0,30,19
1649986675032,COGS 118B,A01,083367,Staff,0,14,40,40
1649986681054,COGS 172,A01,083984,Provenzano; Emily Kara,15,0,30,15
1649986687078,COGS 177,A00,083368,Staff,0,21,30,30
1649986693101,COGS 186,A01,083986,Staff,21,0,40,19
1649986699130,COGS 187A,A01,083988,Boyle; Mary E. T.,19,0,60,41
1649986705160,CSE 8A,A50,084003,Miranda; Gregory Joseph,0,8,15,15
1649986711181,CSE 11,A01,084005,Miranda; Gregory Joseph,0,18,55,55
1649986717214,CSE 20,A01,084007,Staff,0,1,20,20
1649986723243,CSE 21,A01,084009,Staff,0,22,50,50
1649986729267,CSE 30,A01,083370,Cao; Yingjun,0,60,40,40
1649986735290,CSE 100,A01,083372,Cao; Yingjun,0,45,40,40
1649986741315,CSE 101,A01,084011,Staff,1,55,40,39
1649986747339,CSE 141,A01,083374,Eldon; John,0,62,75,75
1649986753363,CSE 141L,A01,083376,Eldon; John,0,68,75,75
1649986759385,CSE 175,A01,084013,Kumar; Rakesh,22,0,25,3
1649986765407,CSE 190,A00,092508,Dubnov; Shlomo,20,0,20,0
1649986771432,ECE 5,A01,084049,Morris; Karcher William,13,0,20,7
1649986777456,ECE 100,A01,084051,Baghdadchi; Saharnaz,0,0,20,20
1649986777456,ECE 100,A02,091916,Baghdadchi; Saharnaz,14,0,20,6
1649986783478,ECE 101,A01,084053,Baghdadchi; Saharnaz,2,0,37,35
1649986783478,ECE 101,A02,084054,Baghdadchi; Saharnaz,31,0,37,6
1649986789514,ECE 107,A01,083390,Staff,27,0,40,13
1649986795536,ECE 148,A01,084056,Silberman; Jack,8,0,12,4
1649986801567,ECE 180,A00,083391,Abi Samra; Nicholas Camill,25,0,30,5
1649986801567,ECE 180,B00,083392,Abi Samra; Nicholas Camill,21,0,30,9
1649986807593,MATH 10B,A01,084110,Staff,0,0,30,30
1649986807593,MATH 10B,A02,084111,Staff,23,0,30,7
1649986807593,MATH 10B,A03,084112,Staff,25,0,30,5
1649986813712,MATH 10C,A01,083443,Staff,1,11,30,29
1649986813712,MATH 10C,A02,083444,Staff,1,10,30,29
1649986813712,MATH 10C,B01,084114,Staff,21,0,30,9
1649986813712,MATH 10C,B02,084115,Staff,26,0,30,4
1649986819738,MATH 18,A01,084117,Harel; Guershon,19,0,30,11
1649986819738,MATH 18,A02,084119,Harel; Guershon,28,0,30,2
1649986819738,MATH 18,A03,084120,Harel; Guershon,29,0,30,1
1649986819738,MATH 18,A04,084121,Harel; Guershon,29,0,30,1
1649986825762,MATH 20B,A01,084124,Um; Ko Woon,21,0,35,14
1649986825762,MATH 20B,B01,084126,Um; Ko Woon,27,0,35,8
1649986831802,MATH 20C,A01,083446,Hammock; Frances H,1,0,30,29
1649986831802,MATH 20C,A02,083447,Hammock; Frances H,24,0,30,6
1649986831802,MATH 20C,A03,083448,Hammock; Frances H,26,0,30,4
1649986831802,MATH 20C,A04,083449,Hammock; Frances H,28,0,30,2
1649986831802,MATH 20C,B01,083451,Hammock; Frances H,5,0,30,25
1649986831802,MATH 20C,B02,083452,Hammock; Frances H,21,0,30,9
1649986831802,MATH 20C,B03,083453,Hammock; Frances H,24,0,30,6
1649986831802,MATH 20C,B04,083454,Hammock; Frances H,27,0,30,3
1649986837837,MATH 20D,A01,084128,Staff,18,0,30,12
1649986837837,MATH 20D,A02,084129,Staff,29,0,30,1
1649986837837,MATH 20D,A03,084130,Staff,27,0,30,3
1649986837837,MATH 20D,B01,084133,Staff,4,0,30,26
1649986837837,MATH 20D,B02,084134,Staff,24,0,30,6
1649986837837,MATH 20D,B03,084135,Staff,28,0,30,2
1649986843860,MATH 20E,A01,084138,Staff,14,0,30,16
1649986843860,MATH 20E,A02,084139,Staff,7,0,30,23
1649986843860,MATH 20E,A03,084140,Staff,15,0,30,15
1649986843860,MATH 20E,A04,084141,Staff,20,0,30,10
1649986849888,MATH 102,A01,084143,Harel; Guershon,12,0,30,18
1649986849888,MATH 102,A02,084144,Harel; Guershon,21,0,30,9
1649986855913,MATH 103B,A01,083456,Staff,0,12,30,30
1649986855913,MATH 103B,A02,083457,Staff,0,12,30,30
1649986861938,MATH 109,A01,084146,Salehi Golsefidy; Alireza,19,0,30,11
1649986861938,MATH 109,A02,084147,Salehi Golsefidy; Alireza,17,0,30,13
1649986867965,MATH 120A,A01,085445,Eggers; John Dietrich,14,0,35,21
1649986867965,MATH 120A,A02,085446,Eggers; John Dietrich,27,0,35,8
1649986873990,MATH 142B,A01,084149,Verstraete; Jacques Allan,0,12,30,30
1649986873990,MATH 142B,A02,084150,Verstraete; Jacques Allan,0,12,30,30
1649986880017,MATH 170A,A01,083459,Nie; Jiawang,1,8,30,29
1649986880017,MATH 170A,A02,083460,Nie; Jiawang,0,6,30,30
1649986880017,MATH 170A,A03,083461,Nie; Jiawang,0,7,30,30
1649986886043,MATH 193B,A01,083463,Staff,1,0,30,29
1649986886043,MATH 193B,A02,083464,Staff,9,0,30,21
1649986886043,MATH 193B,A03,083465,Staff,18,0,30,12
1649986892096,COGS 2,A01,083966,Boyle; Mary E. T.,9,0,30,21
1649986898126,COGS 9,A01,083968,Staff,17,0,60,43
1649986904149,COGS 14B,A01,083970,Staff,13,0,50,37
1649986910177,COGS 17,A01,092679,Staff,56,0,75,19
1649986916202,COGS 100,A01,083972,Staff,0,15,60,60
1649986928255,COGS 101C,A01,083976,Staff,13,0,30,17
1649986934280,COGS 102A,A01,083978,Johnson; Christine M.,14,0,30,16
1649986940303,COGS 107B,A01,083980,Staff,0,7,50,50
1649986946328,COGS 115,A01,083982,Staff,11,0,30,19
1649986952354,COGS 118B,A01,083367,Staff,0,14,40,40
1649986958378,COGS 172,A01,083984,Provenzano; Emily Kara,15,0,30,15
1649986964401,COGS 177,A00,083368,Staff,0,21,30,30
1649986970427,COGS 186,A01,083986,Staff,21,0,40,19
1649986976450,COGS 187A,A01,083988,Boyle; Mary E. T.,19,0,60,41
1649986982484,CSE 8A,A50,084003,Miranda; Gregory Joseph,0,8,15,15
1649986988508,CSE 11,A01,084005,Miranda; Gregory Joseph,0,18,55,55
1649986994645,CSE 20,A01,084007,Staff,0,1,20,20
1649987000678,CSE 21,A01,084009,Staff,0,22,50,50
1649987006703,CSE 30,A01,083370,Cao; Yingjun,0,60,40,40
1649987012739,CSE 100,A01,083372,Cao; Yingjun,0,45,40,40
1649987018765,CSE 101,A01,084011,Staff,1,55,40,39
1649987024795,CSE 141,A01,083374,Eldon; John,0,62,75,75
1649987030818,CSE 141L,A01,083376,Eldon; John,0,68,75,75
1649987036853,CSE 175,A01,084013,Kumar; Rakesh,22,0,25,3
1649987042879,CSE 190,A00,092508,Dubnov; Shlomo,20,0,20,0
1649987048906,ECE 5,A01,084049,Morris; Karcher William,13,0,20,7
1649987054944,ECE 100,A01,084051,Baghdadchi; Saharnaz,0,0,20,20
1649987054944,ECE 100,A02,091916,Baghdadchi; Saharnaz,14,0,20,6
1649987060971,ECE 101,A01,084053,Baghdadchi; Saharnaz,2,0,37,35
1649987060971,ECE 101,A02,084054,Baghdadchi; Saharnaz,31,0,37,6
1649987066998,ECE 107,A01,083390,Staff,27,0,40,13
1649987073046,ECE 148,A01,084056,Silberman; Jack,8,0,12,4
1649987079070,ECE 180,A00,083391,Abi Samra; Nicholas Camill,25,0,30,5
1649987079070,ECE 180,B00,083392,Abi Samra; Nicholas Camill,21,0,30,9
1649987085098,MATH 10B,A01,084110,Staff,0,0,30,30
1649987085098,MATH 10B,A02,084111,Staff,23,0,30,7
1649987085098,MATH 10B,A03,084112,Staff,25,0,30,5
1649987091130,MATH 10C,A01,083443,Staff,1,11,30,29
1649987091130,MATH 10C,A02,083444,Staff,1,10,30,29
1649987091130,MATH 10C,B01,084114,Staff,21,0,30,9
1649987091130,MATH 10C,B02,084115,Staff,26,0,30,4
1649987097153,MATH 18,A01,084117,Harel; Guershon,19,0,30,11
1649987097153,MATH 18,A02,084119,Harel; Guershon,28,0,30,2
1649987097153,MATH 18,A03,084120,Harel; Guershon,29,0,30,1
1649987097153,MATH 18,A04,084121,Harel; Guershon,29,0,30,1
1649987103187,MATH 20B,A01,084124,Um; Ko Woon,21,0,35,14
1649987103187,MATH 20B,B01,084126,Um; Ko Woon,27,0,35,8
1649987109231,MATH 20C,A01,083446,Hammock; Frances H,1,0,30,29
1649987109231,MATH 20C,A02,083447,Hammock; Frances H,24,0,30,6
1649987109231,MATH 20C,A03,083448,Hammock; Frances H,26,0,30,4
1649987109231,MATH 20C,A04,083449,Hammock; Frances H,27,0,30,3
1649987109231,MATH 20C,B01,083451,Hammock; Frances H,4,0,30,26
1649987109231,MATH 20C,B02,083452,Hammock; Frances H,21,0,30,9
1649987109231,MATH 20C,B03,083453,Hammock; Frances H,24,0,30,6
1649987109231,MATH 20C,B04,083454,Hammock; Frances H,27,0,30,3
1649987115287,MATH 20D,A01,084128,Staff,18,0,30,12
1649987115287,MATH 20D,A02,084129,Staff,29,0,30,1
1649987115287,MATH 20D,A03,084130,Staff,27,0,30,3
1649987115287,MATH 20D,B01,084133,Staff,4,0,30,26
1649987115287,MATH 20D,B02,084134,Staff,24,0,30,6
1649987115287,MATH 20D,B03,084135,Staff,28,0,30,2
1649987121311,MATH 20E,A01,084138,Staff,14,0,30,16
1649987121311,MATH 20E,A02,084139,Staff,7,0,30,23
1649987121311,MATH 20E,A03,084140,Staff,15,0,30,15
1649987121311,MATH 20E,A04,084141,Staff,20,0,30,10
1649987127344,MATH 102,A01,084143,Harel; Guershon,12,0,30,18
1649987127344,MATH 102,A02,084144,Harel; Guershon,21,0,30,9
1649987133376,MATH 103B,A01,083456,Staff,0,12,30,30
1649987133376,MATH 103B,A02,083457,Staff,0,12,30,30
1649987139400,MATH 109,A01,084146,Salehi Golsefidy; Alireza,19,0,30,11
1649987139400,MATH 109,A02,084147,Salehi Golsefidy; Alireza,17,0,30,13
1649987145423,MATH 120A,A01,085445,Eggers; John Dietrich,14,0,35,21
1649987145423,MATH 120A,A02,085446,Eggers; John Dietrich,27,0,35,8
1649987151451,MATH 142B,A01,084149,Verstraete; Jacques Allan,0,12,30,30
1649987151451,MATH 142B,A02,084150,Verstraete; Jacques Allan,0,12,30,30
1649987157482,MATH 170A,A01,083459,Nie; Jiawang,1,8,30,29
1649987157482,MATH 170A,A02,083460,Nie; Jiawang,0,6,30,30
1649987157482,MATH 170A,A03,083461,Nie; Jiawang,0,7,30,30
1649987163514,MATH 193B,A01,083463,Staff,1,0,30,29
1649987163514,MATH 193B,A02,083464,Staff,9,0,30,21
1649987163514,MATH 193B,A03,083465,Staff,18,0,30,12
1649987169577,COGS 2,A01,083966,Boyle; Mary E. T.,9,0,30,21
1649987175621,COGS 9,A01,083968,Staff,17,0,60,43
1649987181653,COGS 14B,A01,083970,Staff,13,0,50,37
1649987187676,COGS 17,A01,092679,Staff,56,0,75,19
1649987193700,COGS 100,A01,083972,Staff,0,15,60,60
1649987205774,COGS 101C,A01,083976,Staff,13,0,30,17
1649987211801,COGS 102A,A01,083978,Johnson; Christine M.,14,0,30,16
1649987217828,COGS 107B,A01,083980,Staff,0,7,50,50
1649987223852,COGS 115,A01,083982,Staff,11,0,30,19
1649987229878,COGS 118B,A01,083367,Staff,0,14,40,40
1649987235927,COGS 172,A01,083984,Provenzano; Emily Kara,15,0,30,15
1649987241966,COGS 177,A00,083368,Staff,0,21,30,30
1649987248005,COGS 186,A01,083986,Staff,21,0,40,19
1649987254041,COGS 187A,A01,083988,Boyle; Mary E. T.,19,0,60,41
1649987260071,CSE 8A,A50,084003,Miranda; Gregory Joseph,0,8,15,15
1649987266102,CSE 11,A01,084005,Miranda; Gregory Joseph,0,18,55,55
1649987272125,CSE 20,A01,084007,Staff,0,1,20,20
1649987278152,CSE 21,A01,084009,Staff,0,22,50,50
1649987284199,CSE 30,A01,083370,Cao; Yingjun,0,60,40,40
1649987290229,CSE 100,A01,083372,Cao; Yingjun,0,45,40,40
1649987296279,CSE 101,A01,084011,Staff,1,55,40,39
1649987302302,CSE 141,A01,083374,Eldon; John,0,62,75,75
1649987308342,CSE 141L,A01,083376,Eldon; John,0,68,75,75
1649987314376,CSE 175,A01,084013,Kumar; Rakesh,22,0,25,3
1649987320409,CSE 190,A00,092508,Dubnov; Shlomo,20,0,20,0
1649987326442,ECE 5,A01,084049,Morris; Karcher William,13,0,20,7
1649987332466,ECE 100,A01,084051,Baghdadchi; Saharnaz,0,0,20,20
1649987332466,ECE 100,A02,091916,Baghdadchi; Saharnaz,14,0,20,6
1649987338491,ECE 101,A01,084053,Baghdadchi; Saharnaz,2,0,37,35
1649987338491,ECE 101,A02,084054,Baghdadchi; Saharnaz,31,0,37,6
1649987344524,ECE 107,A01,083390,Staff,27,0,40,13
1649987350551,ECE 148,A01,084056,Silberman; Jack,8,0,12,4
1649987356578,ECE 180,A00,083391,Abi Samra; Nicholas Camill,25,0,30,5
1649987356578,ECE 180,B00,083392,Abi Samra; Nicholas Camill,21,0,30,9
1649987362611,MATH 10B,A01,084110,Staff,0,0,30,30
1649987362611,MATH 10B,A02,084111,Staff,23,0,30,7
1649987362611,MATH 10B,A03,084112,Staff,25,0,30,5
1649987368648,MATH 10C,A01,083443,Staff,1,11,30,29
1649987368648,MATH 10C,A02,083444,Staff,1,10,30,29
1649987368648,MATH 10C,B01,084114,Staff,21,0,30,9
1649987368648,MATH 10C,B02,084115,Staff,26,0,30,4
1649987374699,MATH 18,A01,084117,Harel; Guershon,19,0,30,11
1649987374699,MATH 18,A02,084119,Harel; Guershon,28,0,30,2
1649987374699,MATH 18,A03,084120,Harel; Guershon,29,0,30,1
1649987374699,MATH 18,A04,084121,Harel; Guershon,29,0,30,1
1649987380721,MATH 20B,A01,084124,Um; Ko Woon,21,0,35,14
1649987380721,MATH 20B,B01,084126,Um; Ko Woon,27,0,35,8
1649987386765,MATH 20C,A01,083446,Hammock; Frances H,1,0,30,29
1649987386765,MATH 20C,A02,083447,Hammock; Frances H,24,0,30,6
1649987386765,MATH 20C,A03,083448,Hammock; Frances H,26,0,30,4
1649987386765,MATH 20C,A04,083449,Hammock; Frances H,27,0,30,3
1649987386765,MATH 20C,B01,083451,Hammock; Frances H,4,0,30,26
1649987386765,MATH 20C,B02,083452,Hammock; Frances H,21,0,30,9
1649987386765,MATH 20C,B03,083453,Hammock; Frances H,24,0,30,6
1649987386765,MATH 20C,B04,083454,Hammock; Frances H,27,0,30,3
1649987392792,MATH 20D,A01,084128,Staff,18,0,30,12
1649987392792,MATH 20D,A02,084129,Staff,29,0,30,1
1649987392792,MATH 20D,A03,084130,Staff,27,0,30,3
1649987392792,MATH 20D,B01,084133,Staff,4,0,30,26
1649987392792,MATH 20D,B02,084134,Staff,24,0,30,6
1649987392792,MATH 20D,B03,084135,Staff,28,0,30,2
1649987398814,MATH 20E,A01,084138,Staff,14,0,30,16
1649987398814,MATH 20E,A02,084139,Staff,7,0,30,23
1649987398814,MATH 20E,A03,084140,Staff,15,0,30,15
1649987398814,MATH 20E,A04,084141,Staff,20,0,30,10
1649987404837,MATH 102,A01,084143,Harel; Guershon,12,0,30,18
1649987404837,MATH 102,A02,084144,Harel; Guershon,21,0,30,9
1649987410996,MATH 103B,A01,083456,Staff,0,12,30,30
1649987410996,MATH 103B,A02,083457,Staff,0,12,30,30
1649987417019,MATH 109,A01,084146,Salehi Golsefidy; Alireza,19,0,30,11
1649987417019,MATH 109,A02,084147,Salehi Golsefidy; Alireza,17,0,30,13
1649987423057,MATH 120A,A01,085445,Eggers; John Dietrich,14,0,35,21
1649987423057,MATH 120A,A02,085446,Eggers; John Dietrich,27,0,35,8
1649987429084,MATH 142B,A01,084149,Verstraete; Jacques Allan,0,12,30,30
1649987429084,MATH 142B,A02,084150,Verstraete; Jacques Allan,0,12,30,30
1649987435119,MATH 170A,A01,083459,Nie; Jiawang,1,8,30,29
1649987435119,MATH 170A,A02,083460,Nie; Jiawang,0,6,30,30
1649987435119,MATH 170A,A03,083461,Nie; Jiawang,0,7,30,30
1649987441162,MATH 193B,A01,083463,Staff,1,0,30,29
1649987441162,MATH 193B,A02,083464,Staff,9,0,30,21
1649987441162,MATH 193B,A03,083465,Staff,18,0,30,12
1649987447252,COGS 2,A01,083966,Boyle; Mary E. T.,9,0,30,21
1649987453279,COGS 9,A01,083968,Staff,17,0,60,43
1649987459321,COGS 14B,A01,083970,Staff,13,0,50,37
1649987465357,COGS 17,A01,092679,Staff,56,0,75,19
1649987471407,COGS 100,A01,083972,Staff,0,15,60,60
1649987483470,COGS 101C,A01,083976,Staff,13,0,30,17
1649987489504,COGS 102A,A01,083978,Johnson; Christine M.,14,0,30,16
1649987495552,COGS 107B,A01,083980,Staff,0,7,50,50
1649987501593,COGS 115,A01,083982,Staff,11,0,30,19
1649987507641,COGS 118B,A01,083367,Staff,0,14,40,40
1649987513692,COGS 172,A01,083984,Provenzano; Emily Kara,15,0,30,15
1649987519724,COGS 177,A00,083368,Staff,0,21,30,30
1649987525768,COGS 186,A01,083986,Staff,21,0,40,19
1649987531791,COGS 187A,A01,083988,Boyle; Mary E. T.,19,0,60,41
1649987537819,CSE 8A,A50,084003,Miranda; Gregory Joseph,0,8,15,15
1649987543856,CSE 11,A01,084005,Miranda; Gregory Joseph,0,18,55,55
1649987549903,CSE 20,A01,084007,Staff,0,1,20,20
1649987555948,CSE 21,A01,084009,Staff,0,22,50,50
1649987561995,CSE 30,A01,083370,Cao; Yingjun,0,60,40,40
1649987568021,CSE 100,A01,083372,Cao; Yingjun,0,45,40,40
1649987574053,CSE 101,A01,084011,Staff,1,55,40,39
1649987580075,CSE 141,A01,083374,Eldon; John,0,62,75,75
1649987586106,CSE 141L,A01,083376,Eldon; John,0,68,75,75
1649987592134,CSE 175,A01,084013,Kumar; Rakesh,22,0,25,3
1649987598158,CSE 190,A00,092508,Dubnov; Shlomo,20,0,20,0
1649987604200,ECE 5,A01,084049,Morris; Karcher William,13,0,20,7
1649987610224,ECE 100,A01,084051,Baghdadchi; Saharnaz,0,0,20,20
1649987610224,ECE 100,A02,091916,Baghdadchi; Saharnaz,14,0,20,6
1649987616262,ECE 101,A01,084053,Baghdadchi; Saharnaz,2,0,37,35
1649987616262,ECE 101,A02,084054,Baghdadchi; Saharnaz,31,0,37,6
1649987622286,ECE 107,A01,083390,Staff,27,0,40,13
1649987628314,ECE 148,A01,084056,Silberman; Jack,8,0,12,4
1649987634343,ECE 180,A00,083391,Abi Samra; Nicholas Camill,25,0,30,5
1649987634343,ECE 180,B00,083392,Abi Samra; Nicholas Camill,21,0,30,9
1649987640366,MATH 10B,A01,084110,Staff,0,0,30,30
1649987640366,MATH 10B,A02,084111,Staff,23,0,30,7
1649987640366,MATH 10B,A03,084112,Staff,24,0,30,6
1649987646390,MATH 10C,A01,083443,Staff,1,11,30,29
1649987646390,MATH 10C,A02,083444,Staff,1,10,30,29
1649987646390,MATH 10C,B01,084114,Staff,21,0,30,9
1649987646390,MATH 10C,B02,084115,Staff,26,0,30,4
1649987652424,MATH 18,A01,084117,Harel; Guershon,18,0,30,12
1649987652424,MATH 18,A02,084119,Harel; Guershon,28,0,30,2
1649987652424,MATH 18,A03,084120,Harel; Guershon,29,0,30,1
1649987652424,MATH 18,A04,084121,Harel; Guershon,29,0,30,1
1649987658466,MATH 20B,A01,084124,Um; Ko Woon,20,0,35,15
1649987658466,MATH 20B,B01,084126,Um; Ko Woon,27,0,35,8
1649987664505,MATH 20C,A01,083446,Hammock; Frances H,1,0,30,29
1649987664505,MATH 20C,A02,083447,Hammock; Frances H,24,0,30,6
1649987664505,MATH 20C,A03,083448,Hammock; Frances H,26,0,30,4
1649987664505,MATH 20C,A04,083449,Hammock; Frances H,26,0,30,4
1649987664505,MATH 20C,B01,083451,Hammock; Frances H,4,0,30,26
1649987664505,MATH 20C,B02,083452,Hammock; Frances H,21,0,30,9
1649987664505,MATH 20C,B03,083453,Hammock; Frances H,24,0,30,6
1649987664505,MATH 20C,B04,083454,Hammock; Frances H,27,0,30,3
1649987670552,MATH 20D,A01,084128,Staff,18,0,30,12
1649987670552,MATH 20D,A02,084129,Staff,29,0,30,1
1649987670552,MATH 20D,A03,084130,Staff,27,0,30,3
1649987670552,MATH 20D,B01,084133,Staff,4,0,30,26
1649987670552,MATH 20D,B02,084134,Staff,24,0,30,6
1649987670552,MATH 20D,B03,084135,Staff,28,0,30,2
1649987676594,MATH 20E,A01,084138,Staff,14,0,30,16
1649987676594,MATH 20E,A02,084139,Staff,7,0,30,23
1649987676594,MATH 20E,A03,084140,Staff,15,0,30,15
1649987676594,MATH 20E,A04,084141,Staff,20,0,30,10
1649987682634,MATH 102,A01,084143,Harel; Guershon,12,0,30,18
1649987682634,MATH 102,A02,084144,Harel; Guershon,21,0,30,9
1649987688668,MATH 103B,A01,083456,Staff,0,12,30,30
1649987688668,MATH 103B,A02,083457,Staff,0,12,30,30
1649987694691,MATH 109,A01,084146,Salehi Golsefidy; Alireza,19,0,30,11
1649987694691,MATH 109,A02,084147,Salehi Golsefidy; Alireza,17,0,30,13
1649987700722,MATH 120A,A01,085445,Eggers; John Dietrich,14,0,35,21
1649987700722,MATH 120A,A02,085446,Eggers; John Dietrich,27,0,35,8
1649987706764,MATH 142B,A01,084149,Verstraete; Jacques Allan,0,12,30,30
1649987706764,MATH 142B,A02,084150,Verstraete; Jacques Allan,0,12,30,30
1649987712787,MATH 170A,A01,083459,Nie; Jiawang,1,8,30,29
1649987712787,MATH 170A,A02,083460,Nie; Jiawang,0,6,30,30
1649987712787,MATH 170A,A03,083461,Nie; Jiawang,0,7,30,30
1649987718814,MATH 193B,A01,083463,Staff,1,0,30,29
1649987718814,MATH 193B,A02,083464,Staff,9,0,30,21
1649987718814,MATH 193B,A03,083465,Staff,18,0,30,12
1649987724902,COGS 2,A01,083966,Boyle; Mary E. T.,9,0,30,21
1649987730966,COGS 9,A01,083968,Staff,17,0,60,43
1649987737002,COGS 14B,A01,083970,Staff,13,0,50,37
1649987743029,COGS 17,A01,092679,Staff,56,0,75,19
1649987749066,COGS 100,A01,083972,Staff,0,15,60,60
1649987761124,COGS 101C,A01,083976,Staff,13,0,30,17
1649987767150,COGS 102A,A01,083978,Johnson; Christine M.,14,0,30,16
1649987773179,COGS 107B,A01,083980,Staff,0,7,50,50
1649987779208,COGS 115,A01,083982,Staff,11,0,30,19
1649987785231,COGS 118B,A01,083367,Staff,0,14,40,40
1649987791273,COGS 172,A01,083984,Provenzano; Emily Kara,15,0,30,15
1649987797309,COGS 177,A00,083368,Staff,0,21,30,30
1649987803331,COGS 186,A01,083986,Staff,21,0,40,19
1649987809368,COGS 187A,A01,083988,Boyle; Mary E. T.,19,0,60,41
1649987815412,CSE 8A,A50,084003,Miranda; Gregory Joseph,0,10,15,15
1649987821455,CSE 11,A01,084005,Miranda; Gregory Joseph,0,19,55,55
1649987827483,CSE 20,A01,084007,Staff,0,1,20,20
1649987833506,CSE 21,A01,084009,Staff,0,22,50,50
1649987839545,CSE 30,A01,083370,Cao; Yingjun,0,60,40,40
1649987845591,CSE 100,A01,083372,Cao; Yingjun,0,45,40,40
1649987851627,CSE 101,A01,084011,Staff,1,55,40,39
1649987857649,CSE 141,A01,083374,Eldon; John,0,62,75,75
1649987863682,CSE 141L,A01,083376,Eldon; John,0,68,75,75
1649987869710,CSE 175,A01,084013,Kumar; Rakesh,22,0,25,3
1649987875735,CSE 190,A00,092508,Dubnov; Shlomo,20,0,20,0
1649987881760,ECE 5,A01,084049,Morris; Karcher William,13,0,20,7
1649987887795,ECE 100,A01,084051,Baghdadchi; Saharnaz,0,0,20,20
1649987887795,ECE 100,A02,091916,Baghdadchi; Saharnaz,14,0,20,6
1649987893823,ECE 101,A01,084053,Baghdadchi; Saharnaz,2,0,37,35
1649987893823,ECE 101,A02,084054,Baghdadchi; Saharnaz,31,0,37,6
1649987899855,ECE 107,A01,083390,Staff,27,0,40,13
1649987905892,ECE 148,A01,084056,Silberman; Jack,8,0,12,4
1649987911931,ECE 180,A00,083391,Abi Samra; Nicholas Camill,25,0,30,5
1649987911931,ECE 180,B00,083392,Abi Samra; Nicholas Camill,21,0,30,9
1649987917971,MATH 10B,A01,084110,Staff,0,0,30,30
1649987917971,MATH 10B,A02,084111,Staff,23,0,30,7
1649987917971,MATH 10B,A03,084112,Staff,24,0,30,6
1649987924005,MATH 10C,A01,083443,Staff,1,12,30,29
1649987924005,MATH 10C,A02,083444,Staff,1,10,30,29
1649987924005,MATH 10C,B01,084114,Staff,21,0,30,9
1649987924005,MATH 10C,B02,084115,Staff,26,0,30,4
1649987930034,MATH 18,A01,084117,Harel; Guershon,18,0,30,12
1649987930034,MATH 18,A02,084119,Harel; Guershon,28,0,30,2
1649987930034,MATH 18,A03,084120,Harel; Guershon,29,0,30,1
1649987930034,MATH 18,A04,084121,Harel; Guershon,29,0,30,1
1649987936082,MATH 20B,A01,084124,Um; Ko Woon,20,0,35,15
1649987936082,MATH 20B,B01,084126,Um; Ko Woon,27,0,35,8
1649987942114,MATH 20C,A01,083446,Hammock; Frances H,1,0,30,29
1649987942114,MATH 20C,A02,083447,Hammock; Frances H,24,0,30,6
1649987942114,MATH 20C,A03,083448,Hammock; Frances H,26,0,30,4
1649987942114,MATH 20C,A04,083449,Hammock; Frances H,26,0,30,4
1649987942114,MATH 20C,B01,083451,Hammock; Frances H,4,0,30,26
1649987942114,MATH 20C,B02,083452,Hammock; Frances H,21,0,30,9
1649987942114,MATH 20C,B03,083453,Hammock; Frances H,24,0,30,6
1649987942114,MATH 20C,B04,083454,Hammock; Frances H,27,0,30,3
1649987948167,MATH 20D,A01,084128,Staff,18,0,30,12
1649987948167,MATH 20D,A02,084129,Staff,29,0,30,1
1649987948167,MATH 20D,A03,084130,Staff,27,0,30,3
1649987948167,MATH 20D,B01,084133,Staff,4,0,30,26
1649987948167,MATH 20D,B02,084134,Staff,24,0,30,6
1649987948167,MATH 20D,B03,084135,Staff,28,0,30,2
1649987954206,MATH 20E,A01,084138,Staff,14,0,30,16
1649987954206,MATH 20E,A02,084139,Staff,7,0,30,23
1649987954206,MATH 20E,A03,084140,Staff,15,0,30,15
1649987954206,MATH 20E,A04,084141,Staff,20,0,30,10
1649987960259,MATH 102,A01,084143,Harel; Guershon,12,0,30,18
1649987960259,MATH 102,A02,084144,Harel; Guershon,20,0,30,10
1649987966285,MATH 103B,A01,083456,Staff,0,12,30,30
1649987966285,MATH 103B,A02,083457,Staff,0,12,30,30
1649987972328,MATH 109,A01,084146,Salehi Golsefidy; Alireza,19,0,30,11
1649987972328,MATH 109,A02,084147,Salehi Golsefidy; Alireza,17,0,30,13
1649987978368,MATH 120A,A01,085445,Eggers; John Dietrich,14,0,35,21
1649987978368,MATH 120A,A02,085446,Eggers; John Dietrich,27,0,35,8
1649987984404,MATH 142B,A01,084149,Verstraete; Jacques Allan,0,12,30,30
1649987984404,MATH 142B,A02,084150,Verstraete; Jacques Allan,0,12,30,30
1649987990427,MATH 170A,A01,083459,Nie; Jiawang,1,8,30,29
1649987990427,MATH 170A,A02,083460,Nie; Jiawang,0,6,30,30
1649987990427,MATH 170A,A03,083461,Nie; Jiawang,0,7,30,30
1649987996464,MATH 193B,A01,083463,Staff,1,0,30,29
1649987996464,MATH 193B,A02,083464,Staff,9,0,30,21
1649987996464,MATH 193B,A03,083465,Staff,18,0,30,12
1649988002635,COGS 2,A01,083966,Boyle; Mary E. T.,9,0,30,21
1649988008662,COGS 9,A01,083968,Staff,17,0,60,43
1649988014685,COGS 14B,A01,083970,Staff,13,0,50,37
1649988020708,COGS 17,A01,092679,Staff,56,0,75,19
1649988026743,COGS 100,A01,083972,Staff,0,15,60,60
1649988038802,COGS 101C,A01,083976,Staff,13,0,30,17
1649988044836,COGS 102A,A01,083978,Johnson; Christine M.,14,0,30,16
1649988050872,COGS 107B,A01,083980,Staff,0,7,50,50
1649988056897,COGS 115,A01,083982,Staff,11,0,30,19
1649988062936,COGS 118B,A01,083367,Staff,0,14,40,40
1649988068968,COGS 172,A01,083984,Provenzano; Emily Kara,15,0,30,15
1649988074992,COGS 177,A00,083368,Staff,0,21,30,30
1649988081028,COGS 186,A01,083986,Staff,21,0,40,19
1649988087060,COGS 187A,A01,083988,Boyle; Mary E. T.,19,0,60,41
1649988093082,CSE 8A,A50,084003,Miranda; Gregory Joseph,0,10,15,15
1649988099117,CSE 11,A01,084005,Miranda; Gregory Joseph,0,19,55,55
1649988105147,CSE 20,A01,084007,Staff,0,1,20,20
1649988111170,CSE 21,A01,084009,Staff,0,22,50,50
1649988117198,CSE 30,A01,083370,Cao; Yingjun,0,60,40,40
1649988123226,CSE 100,A01,083372,Cao; Yingjun,0,45,40,40
1649988129264,CSE 101,A01,084011,Staff,1,55,40,39
1649988135312,CSE 141,A01,083374,Eldon; John,0,62,75,75
1649988141334,CSE 141L,A01,083376,Eldon; John,0,68,75,75
1649988147362,CSE 175,A01,084013,Kumar; Rakesh,22,0,25,3
1649988153392,CSE 190,A00,092508,Dubnov; Shlomo,20,0,20,0
1649988159417,ECE 5,A01,084049,Morris; Karcher William,13,0,20,7
1649988165441,ECE 100,A01,084051,Baghdadchi; Saharnaz,0,0,20,20
1649988165441,ECE 100,A02,091916,Baghdadchi; Saharnaz,14,0,20,6
1649988171465,ECE 101,A01,084053,Baghdadchi; Saharnaz,2,0,37,35
1649988171465,ECE 101,A02,084054,Baghdadchi; Saharnaz,31,0,37,6
1649988177491,ECE 107,A01,083390,Staff,27,0,40,13
1649988183536,ECE 148,A01,084056,Silberman; Jack,8,0,12,4
1649988189564,ECE 180,A00,083391,Abi Samra; Nicholas Camill,25,0,30,5
1649988189564,ECE 180,B00,083392,Abi Samra; Nicholas Camill,21,0,30,9
1649988195594,MATH 10B,A01,084110,Staff,0,0,30,30
1649988195594,MATH 10B,A02,084111,Staff,23,0,30,7
1649988195594,MATH 10B,A03,084112,Staff,24,0,30,6
1649988201625,MATH 10C,A01,083443,Staff,1,12,30,29
1649988201625,MATH 10C,A02,083444,Staff,1,11,30,29
1649988201625,MATH 10C,B01,084114,Staff,21,0,30,9
1649988201625,MATH 10C,B02,084115,Staff,26,0,30,4
1649988207654,MATH 18,A01,084117,Harel; Guershon,18,0,30,12
1649988207654,MATH 18,A02,084119,Harel; Guershon,28,0,30,2
1649988207654,MATH 18,A03,084120,Harel; Guershon,29,0,30,1
1649988207654,MATH 18,A04,084121,Harel; Guershon,29,0,30,1
1649988213676,MATH 20B,A01,084124,Um; Ko Woon,20,0,35,15
1649988213676,MATH 20B,B01,084126,Um; Ko Woon,27,0,35,8
1649988219705,MATH 20C,A01,083446,Hammock; Frances H,1,0,30,29
1649988219705,MATH 20C,A02,083447,Hammock; Frances H,24,0,30,6
1649988219705,MATH 20C,A03,083448,Hammock; Frances H,26,0,30,4
1649988219705,MATH 20C,A04,083449,Hammock; Frances H,26,0,30,4
1649988219705,MATH 20C,B01,083451,Hammock; Frances H,4,0,30,26
1649988219705,MATH 20C,B02,083452,Hammock; Frances H,21,0,30,9
1649988219705,MATH 20C,B03,083453,Hammock; Frances H,23,0,30,7
1649988219705,MATH 20C,B04,083454,Hammock; Frances H,27,0,30,3
1649988225733,MATH 20D,A01,084128,Staff,18,0,30,12
1649988225733,MATH 20D,A02,084129,Staff,29,0,30,1
1649988225733,MATH 20D,A03,084130,Staff,27,0,30,3
1649988225733,MATH 20D,B01,084133,Staff,4,0,30,26
1649988225733,MATH 20D,B02,084134,Staff,24,0,30,6
1649988225733,MATH 20D,B03,084135,Staff,28,0,30,2
1649988231756,MATH 20E,A01,084138,Staff,14,0,30,16
1649988231756,MATH 20E,A02,084139,Staff,6,0,30,24
1649988231756,MATH 20E,A03,084140,Staff,15,0,30,15
1649988231756,MATH 20E,A04,084141,Staff,20,0,30,10
1649988237779,MATH 102,A01,084143,Harel; Guershon,12,0,30,18
1649988237779,MATH 102,A02,084144,Harel; Guershon,20,0,30,10
1649988243803,MATH 103B,A01,083456,Staff,0,12,30,30
1649988243803,MATH 103B,A02,083457,Staff,0,12,30,30
1649988249839,MATH 109,A01,084146,Salehi Golsefidy; Alireza,19,0,30,11
1649988249839,MATH 109,A02,084147,Salehi Golsefidy; Alireza,17,0,30,13
1649988255880,MATH 120A,A01,085445,Eggers; John Dietrich,14,0,35,21
1649988255880,MATH 120A,A02,085446,Eggers; John Dietrich,27,0,35,8
1649988261930,MATH 142B,A01,084149,Verstraete; Jacques Allan,0,12,30,30
1649988261930,MATH 142B,A02,084150,Verstraete; Jacques Allan,0,12,30,30
1649988267959,MATH 170A,A01,083459,Nie; Jiawang,1,8,30,29
1649988267959,MATH 170A,A02,083460,Nie; Jiawang,0,6,30,30
1649988267959,MATH 170A,A03,083461,Nie; Jiawang,0,7,30,30
1649988273985,MATH 193B,A01,083463,Staff,1,0,30,29
1649988273985,MATH 193B,A02,083464,Staff,9,0,30,21
1649988273985,MATH 193B,A03,083465,Staff,18,0,30,12
1649988280074,COGS 2,A01,083966,Boyle; Mary E. T.,9,0,30,21
1649988286107,COGS 9,A01,083968,Staff,16,0,60,44
1649988292129,COGS 14B,A01,083970,Staff,13,0,50,37
1649988298155,COGS 17,A01,092679,Staff,56,0,75,19
1649988304177,COGS 100,A01,083972,Staff,0,15,60,60
1649988316229,COGS 101C,A01,083976,Staff,13,0,30,17
1649988322268,COGS 102A,A01,083978,Johnson; Christine M.,14,0,30,16
1649988328316,COGS 107B,A01,083980,Staff,0,7,50,50
1649988334339,COGS 115,A01,083982,Staff,11,0,30,19
1649988340378,COGS 118B,A01,083367,Staff,0,14,40,40
1649988346437,COGS 172,A01,083984,Provenzano; Emily Kara,15,0,30,15
1649988352459,COGS 177,A00,083368,Staff,0,21,30,30
1649988358484,COGS 186,A01,083986,Staff,21,0,40,19
1649988364505,COGS 187A,A01,083988,Boyle; Mary E. T.,19,0,60,41
1649988370553,CSE 8A,A50,084003,Miranda; Gregory Joseph,0,10,15,15
1649988376577,CSE 11,A01,084005,Miranda; Gregory Joseph,0,19,55,55
1649988382620,CSE 20,A01,084007,Staff,0,1,20,20
1649988388665,CSE 21,A01,084009,Staff,0,22,50,50
1649988394703,CSE 30,A01,083370,Cao; Yingjun,0,60,40,40
1649988400740,CSE 100,A01,083372,Cao; Yingjun,0,45,40,40
1649988406784,CSE 101,A01,084011,Staff,1,55,40,39
1649988412807,CSE 141,A01,083374,Eldon; John,0,62,75,75
1649988418864,CSE 141L,A01,083376,Eldon; John,0,68,75,75
1649988424892,CSE 175,A01,084013,Kumar; Rakesh,22,0,25,3
1649988430940,CSE 190,A00,092508,Dubnov; Shlomo,20,0,20,0
1649988436980,ECE 5,A01,084049,Morris; Karcher William,13,0,20,7
1649988443026,ECE 100,A01,084051,Baghdadchi; Saharnaz,0,0,20,20
1649988443026,ECE 100,A02,091916,Baghdadchi; Saharnaz,14,0,20,6
1649988449072,ECE 101,A01,084053,Baghdadchi; Saharnaz,2,0,37,35
1649988449072,ECE 101,A02,084054,Baghdadchi; Saharnaz,31,0,37,6
1649988455118,ECE 107,A01,083390,Staff,27,0,40,13
1649988461155,ECE 148,A01,084056,Silberman; Jack,8,0,12,4
1649988467178,ECE 180,A00,083391,Abi Samra; Nicholas Camill,25,0,30,5
1649988467178,ECE 180,B00,083392,Abi Samra; Nicholas Camill,21,0,30,9
1649988473204,MATH 10B,A01,084110,Staff,0,0,30,30
1649988473204,MATH 10B,A02,084111,Staff,23,0,30,7
1649988473204,MATH 10B,A03,084112,Staff,24,0,30,6
1649988479238,MATH 10C,A01,083443,Staff,1,12,30,29
1649988479238,MATH 10C,A02,083444,Staff,1,11,30,29
1649988479238,MATH 10C,B01,084114,Staff,21,0,30,9
1649988479238,MATH 10C,B02,084115,Staff,26,0,30,4
1649988485285,MATH 18,A01,084117,Harel; Guershon,18,0,30,12
1649988485285,MATH 18,A02,084119,Harel; Guershon,28,0,30,2
1649988485285,MATH 18,A03,084120,Harel; Guershon,29,0,30,1
1649988485285,MATH 18,A04,084121,Harel; Guershon,29,0,30,1
1649988491323,MATH 20B,A01,084124,Um; Ko Woon,19,0,35,16
1649988491323,MATH 20B,B01,084126,Um; Ko Woon,27,0,35,8
1649988497363,MATH 20C,A01,083446,Hammock; Frances H,1,0,30,29
1649988497363,MATH 20C,A02,083447,Hammock; Frances H,24,0,30,6
1649988497363,MATH 20C,A03,083448,Hammock; Frances H,26,0,30,4
1649988497363,MATH 20C,A04,083449,Hammock; Frances H,26,0,30,4
1649988497363,MATH 20C,B01,083451,Hammock; Frances H,4,0,30,26
1649988497363,MATH 20C,B02,083452,Hammock; Frances H,21,0,30,9
1649988497363,MATH 20C,B03,083453,Hammock; Frances H,23,0,30,7
1649988497363,MATH 20C,B04,083454,Hammock; Frances H,27,0,30,3
1649988503409,MATH 20D,A01,084128,Staff,18,0,30,12
1649988503409,MATH 20D,A02,084129,Staff,29,0,30,1
1649988503409,MATH 20D,A03,084130,Staff,27,0,30,3
1649988503409,MATH 20D,B01,084133,Staff,4,0,30,26
1649988503409,MATH 20D,B02,084134,Staff,24,0,30,6
1649988503409,MATH 20D,B03,084135,Staff,28,0,30,2
1649988509470,MATH 20E,A01,084138,Staff,14,0,30,16
1649988509470,MATH 20E,A02,084139,Staff,7,0,30,23
1649988509470,MATH 20E,A03,084140,Staff,15,0,30,15
1649988509470,MATH 20E,A04,084141,Staff,20,0,30,10
1649988515524,MATH 102,A01,084143,Harel; Guershon,12,0,30,18
1649988515524,MATH 102,A02,084144,Harel; Guershon,20,0,30,10
1649988521565,MATH 103B,A01,083456,Staff,0,12,30,30
1649988521565,MATH 103B,A02,083457,Staff,0,12,30,30
1649988527604,MATH 109,A01,084146,Salehi Golsefidy; Alireza,19,0,30,11
1649988527604,MATH 109,A02,084147,Salehi Golsefidy; Alireza,17,0,30,13
1649988533655,MATH 120A,A01,085445,Eggers; John Dietrich,14,0,35,21
1649988533655,MATH 120A,A02,085446,Eggers; John Dietrich,27,0,35,8
1649988539701,MATH 142B,A01,084149,Verstraete; Jacques Allan,0,12,30,30
1649988539701,MATH 142B,A02,084150,Verstraete; Jacques Allan,0,12,30,30
1649988545745,MATH 170A,A01,083459,Nie; Jiawang,1,8,30,29
1649988545745,MATH 170A,A02,083460,Nie; Jiawang,0,6,30,30
1649988545745,MATH 170A,A03,083461,Nie; Jiawang,0,7,30,30
1649988551797,MATH 193B,A01,083463,Staff,1,0,30,29
1649988551797,MATH 193B,A02,083464,Staff,9,0,30,21
1649988551797,MATH 193B,A03,083465,Staff,18,0,30,12
1649988557894,COGS 2,A01,083966,Boyle; Mary E. T.,9,0,30,21
1649988563919,COGS 9,A01,083968,Staff,16,0,60,44
1649988569960,COGS 14B,A01,083970,Staff,13,0,50,37
1649988575998,COGS 17,A01,092679,Staff,56,0,75,19
1649988582020,COGS 100,A01,083972,Staff,0,15,60,60
1649988594114,COGS 101C,A01,083976,Staff,13,0,30,17
1649988600308,COGS 102A,A01,083978,Johnson; Christine M.,14,0,30,16
1649988606331,COGS 107B,A01,083980,Staff,0,7,50,50
1649988612360,COGS 115,A01,083982,Staff,11,0,30,19
1649988618401,COGS 118B,A01,083367,Staff,0,14,40,40
1649988624430,COGS 172,A01,083984,Provenzano; Emily Kara,15,0,30,15
1649988630484,COGS 177,A00,083368,Staff,0,21,30,30
1649988636529,COGS 186,A01,083986,Staff,21,0,40,19
1649988642564,COGS 187A,A01,083988,Boyle; Mary E. T.,19,0,60,41
1649988648625,CSE 8A,A50,084003,Miranda; Gregory Joseph,0,10,15,15
1649988654673,CSE 11,A01,084005,Miranda; Gregory Joseph,0,18,55,55
1649988660718,CSE 20,A01,084007,Staff,0,2,20,20
1649988666774,CSE 21,A01,084009,Staff,0,22,50,50
1649988672814,CSE 30,A01,083370,Cao; Yingjun,0,60,40,40
1649988678847,CSE 100,A01,083372,Cao; Yingjun,0,45,40,40
1649988684889,CSE 101,A01,084011,Staff,1,55,40,39
1649988690925,CSE 141,A01,083374,Eldon; John,0,62,75,75
1649988696954,CSE 141L,A01,083376,Eldon; John,0,68,75,75
1649988703002,CSE 175,A01,084013,Kumar; Rakesh,22,0,25,3
1649988709043,CSE 190,A00,092508,Dubnov; Shlomo,20,0,20,0
1649988715073,ECE 5,A01,084049,Morris; Karcher William,13,0,20,7
1649988721097,ECE 100,A01,084051,Baghdadchi; Saharnaz,0,0,20,20
1649988721097,ECE 100,A02,091916,Baghdadchi; Saharnaz,14,0,20,6
1649988727146,ECE 101,A01,084053,Baghdadchi; Saharnaz,2,0,37,35
1649988727146,ECE 101,A02,084054,Baghdadchi; Saharnaz,31,0,37,6
1649988733170,ECE 107,A01,083390,Staff,27,0,40,13
1649988739197,ECE 148,A01,084056,Silberman; Jack,8,0,12,4
1649988745226,ECE 180,A00,083391,Abi Samra; Nicholas Camill,25,0,30,5
1649988745226,ECE 180,B00,083392,Abi Samra; Nicholas Camill,21,0,30,9
1649988751276,MATH 10B,A01,084110,Staff,0,0,30,30
1649988751276,MATH 10B,A02,084111,Staff,22,0,30,8
1649988751276,MATH 10B,A03,084112,Staff,24,0,30,6
1649988757298,MATH 10C,A01,083443,Staff,1,12,30,29
1649988757298,MATH 10C,A02,083444,Staff,1,11,30,29
1649988757298,MATH 10C,B01,084114,Staff,21,0,30,9
1649988757298,MATH 10C,B02,084115,Staff,26,0,30,4
1649988763322,MATH 18,A01,084117,Harel; Guershon,18,0,30,12
1649988763322,MATH 18,A02,084119,Harel; Guershon,28,0,30,2
1649988763322,MATH 18,A03,084120,Harel; Guershon,29,0,30,1
1649988763322,MATH 18,A04,084121,Harel; Guershon,29,0,30,1
1649988769346,MATH 20B,A01,084124,Um; Ko Woon,19,0,35,16
1649988769346,MATH 20B,B01,084126,Um; Ko Woon,27,0,35,8
1649988775396,MATH 20C,A01,083446,Hammock; Frances H,0,0,30,30
1649988775396,MATH 20C,A02,083447,Hammock; Frances H,24,0,30,6
1649988775396,MATH 20C,A03,083448,Hammock; Frances H,25,0,30,5
1649988775396,MATH 20C,A04,083449,Hammock; Frances H,26,0,30,4
1649988775396,MATH 20C,B01,083451,Hammock; Frances H,4,0,30,26
1649988775396,MATH 20C,B02,083452,Hammock; Frances H,21,0,30,9
1649988775396,MATH 20C,B03,083453,Hammock; Frances H,23,0,30,7
1649988775396,MATH 20C,B04,083454,Hammock; Frances H,27,0,30,3
1649988781442,MATH 20D,A01,084128,Staff,17,0,30,13
1649988781442,MATH 20D,A02,084129,Staff,29,0,30,1
1649988781442,MATH 20D,A03,084130,Staff,27,0,30,3
1649988781442,MATH 20D,B01,084133,Staff,4,0,30,26
1649988781442,MATH 20D,B02,084134,Staff,24,0,30,6
1649988781442,MATH 20D,B03,084135,Staff,28,0,30,2
1649988787481,MATH 20E,A01,084138,Staff,14,0,30,16
1649988787481,MATH 20E,A02,084139,Staff,7,0,30,23
1649988787481,MATH 20E,A03,084140,Staff,15,0,30,15
1649988787481,MATH 20E,A04,084141,Staff,20,0,30,10
1649988793527,MATH 102,A01,084143,Harel; Guershon,12,0,30,18
1649988793527,MATH 102,A02,084144,Harel; Guershon,20,0,30,10
1649988799561,MATH 103B,A01,083456,Staff,0,12,30,30
1649988799561,MATH 103B,A02,083457,Staff,0,12,30,30
1649988805613,MATH 109,A01,084146,Salehi Golsefidy; Alireza,19,0,30,11
1649988805613,MATH 109,A02,084147,Salehi Golsefidy; Alireza,17,0,30,13
1649988811645,MATH 120A,A01,085445,Eggers; John Dietrich,14,0,35,21
1649988811645,MATH 120A,A02,085446,Eggers; John Dietrich,27,0,35,8
1649988817677,MATH 142B,A01,084149,Verstraete; Jacques Allan,0,12,30,30
1649988817677,MATH 142B,A02,084150,Verstraete; Jacques Allan,0,12,30,30
1649988823714,MATH 170A,A01,083459,Nie; Jiawang,1,8,30,29
1649988823714,MATH 170A,A02,083460,Nie; Jiawang,0,6,30,30
1649988823714,MATH 170A,A03,083461,Nie; Jiawang,0,7,30,30
1649988829736,MATH 193B,A01,083463,Staff,1,0,30,29
1649988829736,MATH 193B,A02,083464,Staff,9,0,30,21
1649988829736,MATH 193B,A03,083465,Staff,18,0,30,12
1649988835832,COGS 2,A01,083966,Boyle; Mary E. T.,10,0,30,20
1649988841855,COGS 9,A01,083968,Staff,16,0,60,44
1649988847903,COGS 14B,A01,083970,Staff,13,0,50,37
1649988853940,COGS 17,A01,092679,Staff,55,0,75,20
1649988859970,COGS 100,A01,083972,Staff,0,15,60,60
1649988872045,COGS 101C,A01,083976,Staff,13,0,30,17
1649988878075,COGS 102A,A01,083978,Johnson; Christine M.,14,0,30,16
1649988884110,COGS 107B,A01,083980,Staff,0,7,50,50
1649988890135,COGS 115,A01,083982,Staff,11,0,30,19
1649988896180,COGS 118B,A01,083367,Staff,0,14,40,40
1649988902210,COGS 172,A01,083984,Provenzano; Emily Kara,15,0,30,15
1649988908232,COGS 177,A00,083368,Staff,0,21,30,30
1649988914284,COGS 186,A01,083986,Staff,21,0,40,19
1649988920307,COGS 187A,A01,083988,Boyle; Mary E. T.,19,0,60,41
1649988926330,CSE 8A,A50,084003,Miranda; Gregory Joseph,0,10,15,15
1649988932370,CSE 11,A01,084005,Miranda; Gregory Joseph,0,18,55,55
1649988938401,CSE 20,A01,084007,Staff,0,2,20,20
1649988944427,CSE 21,A01,084009,Staff,0,23,50,50
1649988950471,CSE 30,A01,083370,Cao; Yingjun,0,60,40,40
1649988956497,CSE 100,A01,083372,Cao; Yingjun,0,45,40,40
1649988962537,CSE 101,A01,084011,Staff,1,55,40,39
1649988968563,CSE 141,A01,083374,Eldon; John,0,62,75,75
1649988974590,CSE 141L,A01,083376,Eldon; John,0,68,75,75
1649988980635,CSE 175,A01,084013,Kumar; Rakesh,22,0,25,3
1649988986666,CSE 190,A00,092508,Dubnov; Shlomo,20,0,20,0
1649988992696,ECE 5,A01,084049,Morris; Karcher William,13,0,20,7
1649988998723,ECE 100,A01,084051,Baghdadchi; Saharnaz,0,0,20,20
1649988998723,ECE 100,A02,091916,Baghdadchi; Saharnaz,14,0,20,6
1649989004752,ECE 101,A01,084053,Baghdadchi; Saharnaz,2,0,37,35
1649989004752,ECE 101,A02,084054,Baghdadchi; Saharnaz,31,0,37,6
1649989010779,ECE 107,A01,083390,Staff,27,0,40,13
1649989016807,ECE 148,A01,084056,Silberman; Jack,8,0,12,4
1649989022852,ECE 180,A00,083391,Abi Samra; Nicholas Camill,25,0,30,5
1649989022852,ECE 180,B00,083392,Abi Samra; Nicholas Camill,21,0,30,9
1649989028891,MATH 10B,A01,084110,Staff,0,0,30,30
1649989028891,MATH 10B,A02,084111,Staff,22,0,30,8
1649989028891,MATH 10B,A03,084112,Staff,24,0,30,6
1649989034925,MATH 10C,A01,083443,Staff,1,12,30,29
1649989034925,MATH 10C,A02,083444,Staff,1,11,30,29
1649989034925,MATH 10C,B01,084114,Staff,21,0,30,9
1649989034925,MATH 10C,B02,084115,Staff,26,0,30,4
1649989040961,MATH 18,A01,084117,Harel; Guershon,18,0,30,12
1649989040961,MATH 18,A02,084119,Harel; Guershon,28,0,30,2
1649989040961,MATH 18,A03,084120,Harel; Guershon,29,0,30,1
1649989040961,MATH 18,A04,084121,Harel; Guershon,29,0,30,1
1649989046985,MATH 20B,A01,084124,Um; Ko Woon,19,0,35,16
1649989046985,MATH 20B,B01,084126,Um; Ko Woon,27,0,35,8
1649989053039,MATH 20C,A01,083446,Hammock; Frances H,0,0,30,30
1649989053039,MATH 20C,A02,083447,Hammock; Frances H,24,0,30,6
1649989053039,MATH 20C,A03,083448,Hammock; Frances H,25,0,30,5
1649989053039,MATH 20C,A04,083449,Hammock; Frances H,25,0,30,5
1649989053039,MATH 20C,B01,083451,Hammock; Frances H,4,0,30,26
1649989053039,MATH 20C,B02,083452,Hammock; Frances H,21,0,30,9
1649989053039,MATH 20C,B03,083453,Hammock; Frances H,23,0,30,7
1649989053039,MATH 20C,B04,083454,Hammock; Frances H,27,0,30,3
1649989059066,MATH 20D,A01,084128,Staff,17,0,30,13
1649989059066,MATH 20D,A02,084129,Staff,29,0,30,1
1649989059066,MATH 20D,A03,084130,Staff,27,0,30,3
1649989059066,MATH 20D,B01,084133,Staff,4,0,30,26
1649989059066,MATH 20D,B02,084134,Staff,24,0,30,6
1649989059066,MATH 20D,B03,084135,Staff,28,0,30,2
1649989065098,MATH 20E,A01,084138,Staff,14,0,30,16
1649989065098,MATH 20E,A02,084139,Staff,7,0,30,23
1649989065098,MATH 20E,A03,084140,Staff,15,0,30,15
1649989065098,MATH 20E,A04,084141,Staff,20,0,30,10
1649989071140,MATH 102,A01,084143,Harel; Guershon,12,0,30,18
1649989071140,MATH 102,A02,084144,Harel; Guershon,20,0,30,10
1649989077185,MATH 103B,A01,083456,Staff,0,12,30,30
1649989077185,MATH 103B,A02,083457,Staff,0,12,30,30
1649989083206,MATH 109,A01,084146,Salehi Golsefidy; Alireza,19,0,30,11
1649989083206,MATH 109,A02,084147,Salehi Golsefidy; Alireza,17,0,30,13
1649989089259,MATH 120A,A01,085445,Eggers; John Dietrich,13,0,35,22
1649989089259,MATH 120A,A02,085446,Eggers; John Dietrich,27,0,35,8
1649989095303,MATH 142B,A01,084149,Verstraete; Jacques Allan,0,12,30,30
1649989095303,MATH 142B,A02,084150,Verstraete; Jacques Allan,0,12,30,30
1649989101354,MATH 170A,A01,083459,Nie; Jiawang,1,9,30,29
1649989101354,MATH 170A,A02,083460,Nie; Jiawang,0,6,30,30
1649989101354,MATH 170A,A03,083461,Nie; Jiawang,0,7,30,30
1649989107382,MATH 193B,A01,083463,Staff,1,0,30,29
1649989107382,MATH 193B,A02,083464,Staff,9,0,30,21
1649989107382,MATH 193B,A03,083465,Staff,18,0,30,12
1649989113458,COGS 2,A01,083966,Boyle; Mary E. T.,10,0,30,20
1649989119492,COGS 9,A01,083968,Staff,16,0,60,44
1649989125529,COGS 14B,A01,083970,Staff,13,0,50,37
1649989131552,COGS 17,A01,092679,Staff,55,0,75,20
1649989137591,COGS 100,A01,083972,Staff,0,15,60,60
1649989149673,COGS 101C,A01,083976,Staff,13,0,30,17
1649989155707,COGS 102A,A01,083978,Johnson; Christine M.,14,0,30,16
1649989161736,COGS 107B,A01,083980,Staff,0,7,50,50
1649989167775,COGS 115,A01,083982,Staff,11,0,30,19
1649989173809,COGS 118B,A01,083367,Staff,0,14,40,40
1649989179833,COGS 172,A01,083984,Provenzano; Emily Kara,15,0,30,15
1649989185875,COGS 177,A00,083368,Staff,0,21,30,30
1649989191912,COGS 186,A01,083986,Staff,21,0,40,19
1649989198050,COGS 187A,A01,083988,Boyle; Mary E. T.,19,0,60,41
1649989204082,CSE 8A,A50,084003,Miranda; Gregory Joseph,0,10,15,15
1649989210112,CSE 11,A01,084005,Miranda; Gregory Joseph,0,18,55,55
1649989216159,CSE 20,A01,084007,Staff,0,2,20,20
1649989222219,CSE 21,A01,084009,Staff,0,23,50,50
1649989228283,CSE 30,A01,083370,Cao; Yingjun,0,60,40,40
1649989234322,CSE 100,A01,083372,Cao; Yingjun,0,45,40,40
1649989240371,CSE 101,A01,084011,Staff,1,55,40,39
1649989246419,CSE 141,A01,083374,Eldon; John,0,62,75,75
1649989252456,CSE 141L,A01,083376,Eldon; John,0,68,75,75
1649989258487,CSE 175,A01,084013,Kumar; Rakesh,22,0,25,3
1649989264534,CSE 190,A00,092508,Dubnov; Shlomo,20,0,20,0
1649989270580,ECE 5,A01,084049,Morris; Karcher William,13,0,20,7
1649989276625,ECE 100,A01,084051,Baghdadchi; Saharnaz,0,0,20,20
1649989276625,ECE 100,A02,091916,Baghdadchi; Saharnaz,14,0,20,6
1649989282688,ECE 101,A01,084053,Baghdadchi; Saharnaz,2,0,37,35
1649989282688,ECE 101,A02,084054,Baghdadchi; Saharnaz,31,0,37,6
1649989288744,ECE 107,A01,083390,Staff,27,0,40,13
1649989294778,ECE 148,A01,084056,Silberman; Jack,8,0,12,4
1649989300818,ECE 180,A00,083391,Abi Samra; Nicholas Camill,25,0,30,5
1649989300818,ECE 180,B00,083392,Abi Samra; Nicholas Camill,21,0,30,9
1649989306858,MATH 10B,A01,084110,Staff,0,0,30,30
1649989306858,MATH 10B,A02,084111,Staff,22,0,30,8
1649989306858,MATH 10B,A03,084112,Staff,24,0,30,6
1649989312888,MATH 10C,A01,083443,Staff,1,13,30,29
1649989312888,MATH 10C,A02,083444,Staff,1,12,30,29
1649989312888,MATH 10C,B01,084114,Staff,21,0,30,9
1649989312888,MATH 10C,B02,084115,Staff,26,0,30,4
1649989318920,MATH 18,A01,084117,Harel; Guershon,18,0,30,12
1649989318920,MATH 18,A02,084119,Harel; Guershon,28,0,30,2
1649989318920,MATH 18,A03,084120,Harel; Guershon,29,0,30,1
1649989318920,MATH 18,A04,084121,Harel; Guershon,29,0,30,1
1649989324952,MATH 20B,A01,084124,Um; Ko Woon,19,0,35,16
1649989324952,MATH 20B,B01,084126,Um; Ko Woon,27,0,35,8
1649989330997,MATH 20C,A01,083446,Hammock; Frances H,0,0,30,30
1649989330997,MATH 20C,A02,083447,Hammock; Frances H,24,0,30,6
1649989330997,MATH 20C,A03,083448,Hammock; Frances H,25,0,30,5
1649989330997,MATH 20C,A04,083449,Hammock; Frances H,24,0,30,6
1649989330997,MATH 20C,B01,083451,Hammock; Frances H,4,0,30,26
1649989330997,MATH 20C,B02,083452,Hammock; Frances H,21,0,30,9
1649989330997,MATH 20C,B03,083453,Hammock; Frances H,23,0,30,7
1649989330997,MATH 20C,B04,083454,Hammock; Frances H,27,0,30,3
1649989337020,MATH 20D,A01,084128,Staff,17,0,30,13
1649989337020,MATH 20D,A02,084129,Staff,29,0,30,1
1649989337020,MATH 20D,A03,084130,Staff,27,0,30,3
1649989337020,MATH 20D,B01,084133,Staff,4,0,30,26
1649989337020,MATH 20D,B02,084134,Staff,24,0,30,6
1649989337020,MATH 20D,B03,084135,Staff,28,0,30,2
1649989343042,MATH 20E,A01,084138,Staff,14,0,30,16
1649989343042,MATH 20E,A02,084139,Staff,7,0,30,23
1649989343042,MATH 20E,A03,084140,Staff,15,0,30,15
1649989343042,MATH 20E,A04,084141,Staff,20,0,30,10
1649989349085,MATH 102,A01,084143,Harel; Guershon,12,0,30,18
1649989349085,MATH 102,A02,084144,Harel; Guershon,20,0,30,10
1649989355109,MATH 103B,A01,083456,Staff,0,12,30,30
1649989355109,MATH 103B,A02,083457,Staff,0,12,30,30
1649989361162,MATH 109,A01,084146,Salehi Golsefidy; Alireza,18,0,30,12
1649989361162,MATH 109,A02,084147,Salehi Golsefidy; Alireza,17,0,30,13
1649989367191,MATH 120A,A01,085445,Eggers; John Dietrich,13,0,35,22
1649989367191,MATH 120A,A02,085446,Eggers; John Dietrich,27,0,35,8
1649989373230,MATH 142B,A01,084149,Verstraete; Jacques Allan,0,12,30,30
1649989373230,MATH 142B,A02,084150,Verstraete; Jacques Allan,0,12,30,30
1649989379255,MATH 170A,A01,083459,Nie; Jiawang,1,9,30,29
1649989379255,MATH 170A,A02,083460,Nie; Jiawang,0,6,30,30
1649989379255,MATH 170A,A03,083461,Nie; Jiawang,0,8,30,30
1649989385278,MATH 193B,A01,083463,Staff,1,0,30,29
1649989385278,MATH 193B,A02,083464,Staff,9,0,30,21
1649989385278,MATH 193B,A03,083465,Staff,18,0,30,12
1649989391363,COGS 2,A01,083966,Boyle; Mary E. T.,10,0,30,20
1649989397413,COGS 9,A01,083968,Staff,16,0,60,44
1649989403451,COGS 14B,A01,083970,Staff,13,0,50,37
1649989409477,COGS 17,A01,092679,Staff,55,0,75,20
1649989415521,COGS 100,A01,083972,Staff,0,15,60,60
1649989427599,COGS 101C,A01,083976,Staff,13,0,30,17
1649989433634,COGS 102A,A01,083978,Johnson; Christine M.,14,0,30,16
1649989439666,COGS 107B,A01,083980,Staff,0,7,50,50
1649989445698,COGS 115,A01,083982,Staff,11,0,30,19
1649989451733,COGS 118B,A01,083367,Staff,0,14,40,40
1649989457785,COGS 172,A01,083984,Provenzano; Emily Kara,15,0,30,15
1649989463831,COGS 177,A00,083368,Staff,0,21,30,30
1649989469865,COGS 186,A01,083986,Staff,21,0,40,19
1649989475911,COGS 187A,A01,083988,Boyle; Mary E. T.,19,0,60,41
1649989481940,CSE 8A,A50,084003,Miranda; Gregory Joseph,0,10,15,15
1649989487974,CSE 11,A01,084005,Miranda; Gregory Joseph,0,18,55,55
1649989493997,CSE 20,A01,084007,Staff,0,3,20,20
1649989500038,CSE 21,A01,084009,Staff,0,24,50,50
1649989506071,CSE 30,A01,083370,Cao; Yingjun,0,61,40,40
1649989512109,CSE 100,A01,083372,Cao; Yingjun,0,45,40,40
1649989518132,CSE 101,A01,084011,Staff,1,55,40,39
1649989524156,CSE 141,A01,083374,Eldon; John,0,62,75,75
1649989530216,CSE 141L,A01,083376,Eldon; John,0,68,75,75
1649989536268,CSE 175,A01,084013,Kumar; Rakesh,22,0,25,3
1649989542319,CSE 190,A00,092508,Dubnov; Shlomo,20,0,20,0
1649989548355,ECE 5,A01,084049,Morris; Karcher William,13,0,20,7
1649989554409,ECE 100,A01,084051,Baghdadchi; Saharnaz,0,0,20,20
1649989554409,ECE 100,A02,091916,Baghdadchi; Saharnaz,14,0,20,6
1649989560449,ECE 101,A01,084053,Baghdadchi; Saharnaz,2,0,37,35
1649989560449,ECE 101,A02,084054,Baghdadchi; Saharnaz,31,0,37,6
1649989566494,ECE 107,A01,083390,Staff,27,0,40,13
1649989572539,ECE 148,A01,084056,Silberman; Jack,8,0,12,4
1649989578585,ECE 180,A00,083391,Abi Samra; Nicholas Camill,25,0,30,5
1649989578585,ECE 180,B00,083392,Abi Samra; Nicholas Camill,21,0,30,9
1649989584626,MATH 10B,A01,084110,Staff,0,0,30,30
1649989584626,MATH 10B,A02,084111,Staff,22,0,30,8
1649989584626,MATH 10B,A03,084112,Staff,24,0,30,6
1649989590672,MATH 10C,A01,083443,Staff,1,13,30,29
1649989590672,MATH 10C,A02,083444,Staff,1,12,30,29
1649989590672,MATH 10C,B01,084114,Staff,21,0,30,9
1649989590672,MATH 10C,B02,084115,Staff,25,0,30,5
1649989596701,MATH 18,A01,084117,Harel; Guershon,18,0,30,12
1649989596701,MATH 18,A02,084119,Harel; Guershon,28,0,30,2
1649989596701,MATH 18,A03,084120,Harel; Guershon,29,0,30,1
1649989596701,MATH 18,A04,084121,Harel; Guershon,29,0,30,1
1649989602750,MATH 20B,A01,084124,Um; Ko Woon,19,0,35,16
1649989602750,MATH 20B,B01,084126,Um; Ko Woon,27,0,35,8
1649989608785,MATH 20C,A01,083446,Hammock; Frances H,0,0,30,30
1649989608785,MATH 20C,A02,083447,Hammock; Frances H,24,0,30,6
1649989608785,MATH 20C,A03,083448,Hammock; Frances H,25,0,30,5
1649989608785,MATH 20C,A04,083449,Hammock; Frances H,24,0,30,6
1649989608785,MATH 20C,B01,083451,Hammock; Frances H,4,0,30,26
1649989608785,MATH 20C,B02,083452,Hammock; Frances H,21,0,30,9
1649989608785,MATH 20C,B03,083453,Hammock; Frances H,23,0,30,7
1649989608785,MATH 20C,B04,083454,Hammock; Frances H,27,0,30,3
1649989614813,MATH 20D,A01,084128,Staff,16,0,30,14
1649989614813,MATH 20D,A02,084129,Staff,29,0,30,1
1649989614813,MATH 20D,A03,084130,Staff,27,0,30,3
1649989614813,MATH 20D,B01,084133,Staff,4,0,30,26
1649989614813,MATH 20D,B02,084134,Staff,24,0,30,6
1649989614813,MATH 20D,B03,084135,Staff,28,0,30,2
1649989620851,MATH 20E,A01,084138,Staff,14,0,30,16
1649989620851,MATH 20E,A02,084139,Staff,7,0,30,23
1649989620851,MATH 20E,A03,084140,Staff,15,0,30,15
1649989620851,MATH 20E,A04,084141,Staff,20,0,30,10
1649989626890,MATH 102,A01,084143,Harel; Guershon,12,0,30,18
1649989626890,MATH 102,A02,084144,Harel; Guershon,20,0,30,10
1649989632923,MATH 103B,A01,083456,Staff,0,12,30,30
1649989632923,MATH 103B,A02,083457,Staff,0,12,30,30
1649989638971,MATH 109,A01,084146,Salehi Golsefidy; Alireza,18,0,30,12
1649989638971,MATH 109,A02,084147,Salehi Golsefidy; Alireza,17,0,30,13
1649989644997,MATH 120A,A01,085445,Eggers; John Dietrich,13,0,35,22
1649989644997,MATH 120A,A02,085446,Eggers; John Dietrich,27,0,35,8
1649989651035,MATH 142B,A01,084149,Verstraete; Jacques Allan,0,12,30,30
1649989651035,MATH 142B,A02,084150,Verstraete; Jacques Allan,0,12,30,30
1649989657072,MATH 170A,A01,083459,Nie; Jiawang,1,9,30,29
1649989657072,MATH 170A,A02,083460,Nie; Jiawang,0,6,30,30
1649989657072,MATH 170A,A03,083461,Nie; Jiawang,0,8,30,30
1649989663113,MATH 193B,A01,083463,Staff,1,0,30,29
1649989663113,MATH 193B,A02,083464,Staff,9,0,30,21
1649989663113,MATH 193B,A03,083465,Staff,18,0,30,12
1649989669216,COGS 2,A01,083966,Boyle; Mary E. T.,10,0,30,20
1649989675244,COGS 9,A01,083968,Staff,16,0,60,44
1649989681295,COGS 14B,A01,083970,Staff,13,0,50,37
1649989687341,COGS 17,A01,092679,Staff,54,0,75,21
1649989693401,COGS 100,A01,083972,Staff,0,15,60,60
1649989705455,COGS 101C,A01,083976,Staff,13,0,30,17
1649989711484,COGS 102A,A01,083978,Johnson; Christine M.,14,0,30,16
1649989717506,COGS 107B,A01,083980,Staff,0,7,50,50
1649989723530,COGS 115,A01,083982,Staff,11,0,30,19
1649989729575,COGS 118B,A01,083367,Staff,0,14,40,40
1649989735621,COGS 172,A01,083984,Provenzano; Emily Kara,15,0,30,15
1649989741672,COGS 177,A00,083368,Staff,0,20,30,30
1649989747717,COGS 186,A01,083986,Staff,21,0,40,19
1649989753768,COGS 187A,A01,083988,Boyle; Mary E. T.,19,0,60,41
1649989759800,CSE 8A,A50,084003,Miranda; Gregory Joseph,0,11,15,15
1649989765826,CSE 11,A01,084005,Miranda; Gregory Joseph,0,18,55,55
1649989771855,CSE 20,A01,084007,Staff,0,3,20,20
1649989777879,CSE 21,A01,084009,Staff,0,25,50,50
1649989783926,CSE 30,A01,083370,Cao; Yingjun,0,61,40,40
1649989789974,CSE 100,A01,083372,Cao; Yingjun,0,45,40,40
1649989796106,CSE 101,A01,084011,Staff,1,55,40,39
1649989802141,CSE 141,A01,083374,Eldon; John,0,62,75,75
1649989808189,CSE 141L,A01,083376,Eldon; John,0,68,75,75
1649989814240,CSE 175,A01,084013,Kumar; Rakesh,22,0,25,3
1649989820283,CSE 190,A00,092508,Dubnov; Shlomo,20,0,20,0
1649989826333,ECE 5,A01,084049,Morris; Karcher William,13,0,20,7
1649989832367,ECE 100,A01,084051,Baghdadchi; Saharnaz,0,0,20,20
1649989832367,ECE 100,A02,091916,Baghdadchi; Saharnaz,14,0,20,6
1649989838393,ECE 101,A01,084053,Baghdadchi; Saharnaz,2,0,37,35
1649989838393,ECE 101,A02,084054,Baghdadchi; Saharnaz,31,0,37,6
1649989844423,ECE 107,A01,083390,Staff,27,0,40,13
1649989850460,ECE 148,A01,084056,Silberman; Jack,8,0,12,4
1649989856493,ECE 180,A00,083391,Abi Samra; Nicholas Camill,25,0,30,5
1649989856493,ECE 180,B00,083392,Abi Samra; Nicholas Camill,21,0,30,9
1649989862518,MATH 10B,A01,084110,Staff,0,1,30,30
1649989862518,MATH 10B,A02,084111,Staff,22,0,30,8
1649989862518,MATH 10B,A03,084112,Staff,24,0,30,6
1649989868555,MATH 10C,A01,083443,Staff,1,13,30,29
1649989868555,MATH 10C,A02,083444,Staff,1,12,30,29
1649989868555,MATH 10C,B01,084114,Staff,21,0,30,9
1649989868555,MATH 10C,B02,084115,Staff,25,0,30,5
1649989874582,MATH 18,A01,084117,Harel; Guershon,18,0,30,12
1649989874582,MATH 18,A02,084119,Harel; Guershon,28,0,30,2
1649989874582,MATH 18,A03,084120,Harel; Guershon,29,0,30,1
1649989874582,MATH 18,A04,084121,Harel; Guershon,29,0,30,1
1649989880619,MATH 20B,A01,084124,Um; Ko Woon,19,0,35,16
1649989880619,MATH 20B,B01,084126,Um; Ko Woon,27,0,35,8
1649989886649,MATH 20C,A01,083446,Hammock; Frances H,0,0,30,30
1649989886649,MATH 20C,A02,083447,Hammock; Frances H,24,0,30,6
1649989886649,MATH 20C,A03,083448,Hammock; Frances H,25,0,30,5
1649989886649,MATH 20C,A04,083449,Hammock; Frances H,24,0,30,6
1649989886649,MATH 20C,B01,083451,Hammock; Frances H,3,0,30,27
1649989886649,MATH 20C,B02,083452,Hammock; Frances H,21,0,30,9
1649989886649,MATH 20C,B03,083453,Hammock; Frances H,23,0,30,7
1649989886649,MATH 20C,B04,083454,Hammock; Frances H,26,0,30,4
1649989892685,MATH 20D,A01,084128,Staff,16,0,30,14
1649989892685,MATH 20D,A02,084129,Staff,29,0,30,1
1649989892685,MATH 20D,A03,084130,Staff,27,0,30,3
1649989892685,MATH 20D,B01,084133,Staff,4,0,30,26
1649989892685,MATH 20D,B02,084134,Staff,24,0,30,6
1649989892685,MATH 20D,B03,084135,Staff,28,0,30,2
1649989898715,MATH 20E,A01,084138,Staff,14,0,30,16
1649989898715,MATH 20E,A02,084139,Staff,7,0,30,23
1649989898715,MATH 20E,A03,084140,Staff,15,0,30,15
1649989898715,MATH 20E,A04,084141,Staff,20,0,30,10
1649989904755,MATH 102,A01,084143,Harel; Guershon,12,0,30,18
1649989904755,MATH 102,A02,084144,Harel; Guershon,20,0,30,10
1649989910786,MATH 103B,A01,083456,Staff,0,12,30,30
1649989910786,MATH 103B,A02,083457,Staff,0,12,30,30
1649989916823,MATH 109,A01,084146,Salehi Golsefidy; Alireza,18,0,30,12
1649989916823,MATH 109,A02,084147,Salehi Golsefidy; Alireza,17,0,30,13
1649989922868,MATH 120A,A01,085445,Eggers; John Dietrich,13,0,35,22
1649989922868,MATH 120A,A02,085446,Eggers; John Dietrich,27,0,35,8
1649989928903,MATH 142B,A01,084149,Verstraete; Jacques Allan,0,12,30,30
1649989928903,MATH 142B,A02,084150,Verstraete; Jacques Allan,0,12,30,30
1649989934946,MATH 170A,A01,083459,Nie; Jiawang,1,9,30,29
1649989934946,MATH 170A,A02,083460,Nie; Jiawang,0,6,30,30
1649989934946,MATH 170A,A03,083461,Nie; Jiawang,0,8,30,30
1649989940991,MATH 193B,A01,083463,Staff,1,0,30,29
1649989940991,MATH 193B,A02,083464,Staff,9,0,30,21
1649989940991,MATH 193B,A03,083465,Staff,18,0,30,12
1649989947072,COGS 2,A01,083966,Boyle; Mary E. T.,10,0,30,20
1649989953112,COGS 9,A01,083968,Staff,15,0,60,45
1649989959140,COGS 14B,A01,083970,Staff,12,0,50,38
1649989965172,COGS 17,A01,092679,Staff,54,0,75,21
1649989971210,COGS 100,A01,083972,Staff,0,15,60,60
1649989983278,COGS 101C,A01,083976,Staff,13,0,30,17
1649989989316,COGS 102A,A01,083978,Johnson; Christine M.,14,0,30,16
1649989995358,COGS 107B,A01,083980,Staff,0,7,50,50
1649990001380,COGS 115,A01,083982,Staff,11,0,30,19
1649990007430,COGS 118B,A01,083367,Staff,0,14,40,40
1649990013453,COGS 172,A01,083984,Provenzano; Emily Kara,15,0,30,15
1649990019488,COGS 177,A00,083368,Staff,0,20,30,30
1649990025537,COGS 186,A01,083986,Staff,21,0,40,19
1649990031575,COGS 187A,A01,083988,Boyle; Mary E. T.,19,0,60,41
1649990037610,CSE 8A,A50,084003,Miranda; Gregory Joseph,0,11,15,15
1649990043657,CSE 11,A01,084005,Miranda; Gregory Joseph,0,18,55,55
1649990049681,CSE 20,A01,084007,Staff,0,3,20,20
1649990055710,CSE 21,A01,084009,Staff,0,25,50,50
1649990061753,CSE 30,A01,083370,Cao; Yingjun,0,61,40,40
1649990067802,CSE 100,A01,083372,Cao; Yingjun,0,45,40,40
1649990073839,CSE 101,A01,084011,Staff,1,55,40,39
1649990079869,CSE 141,A01,083374,Eldon; John,0,62,75,75
1649990085918,CSE 141L,A01,083376,Eldon; John,0,68,75,75
1649990091959,CSE 175,A01,084013,Kumar; Rakesh,22,0,25,3
1649990097990,CSE 190,A00,092508,Dubnov; Shlomo,20,0,20,0
1649990104012,ECE 5,A01,084049,Morris; Karcher William,13,0,20,7
1649990110057,ECE 100,A01,084051,Baghdadchi; Saharnaz,0,0,20,20
1649990110057,ECE 100,A02,091916,Baghdadchi; Saharnaz,14,0,20,6
1649990116106,ECE 101,A01,084053,Baghdadchi; Saharnaz,2,0,37,35
1649990116106,ECE 101,A02,084054,Baghdadchi; Saharnaz,31,0,37,6
1649990122142,ECE 107,A01,083390,Staff,27,0,40,13
1649990128187,ECE 148,A01,084056,Silberman; Jack,8,0,12,4
1649990134222,ECE 180,A00,083391,Abi Samra; Nicholas Camill,25,0,30,5
1649990134222,ECE 180,B00,083392,Abi Samra; Nicholas Camill,21,0,30,9
1649990140245,MATH 10B,A01,084110,Staff,0,1,30,30
1649990140245,MATH 10B,A02,084111,Staff,22,0,30,8
1649990140245,MATH 10B,A03,084112,Staff,24,0,30,6
1649990146300,MATH 10C,A01,083443,Staff,1,12,30,29
1649990146300,MATH 10C,A02,083444,Staff,1,12,30,29
1649990146300,MATH 10C,B01,084114,Staff,20,0,30,10
1649990146300,MATH 10C,B02,084115,Staff,25,0,30,5
1649990152336,MATH 18,A01,084117,Harel; Guershon,18,0,30,12
1649990152336,MATH 18,A02,084119,Harel; Guershon,28,0,30,2
1649990152336,MATH 18,A03,084120,Harel; Guershon,29,0,30,1
1649990152336,MATH 18,A04,084121,Harel; Guershon,29,0,30,1
1649990158371,MATH 20B,A01,084124,Um; Ko Woon,19,0,35,16
1649990158371,MATH 20B,B01,084126,Um; Ko Woon,27,0,35,8
1649990164414,MATH 20C,A01,083446,Hammock; Frances H,0,0,30,30
1649990164414,MATH 20C,A02,083447,Hammock; Frances H,24,0,30,6
1649990164414,MATH 20C,A03,083448,Hammock; Frances H,25,0,30,5
1649990164414,MATH 20C,A04,083449,Hammock; Frances H,24,0,30,6
1649990164414,MATH 20C,B01,083451,Hammock; Frances H,2,0,30,28
1649990164414,MATH 20C,B02,083452,Hammock; Frances H,21,0,30,9
1649990164414,MATH 20C,B03,083453,Hammock; Frances H,23,0,30,7
1649990164414,MATH 20C,B04,083454,Hammock; Frances H,26,0,30,4
1649990170449,MATH 20D,A01,084128,Staff,16,0,30,14
1649990170449,MATH 20D,A02,084129,Staff,29,0,30,1
1649990170449,MATH 20D,A03,084130,Staff,27,0,30,3
1649990170449,MATH 20D,B01,084133,Staff,4,0,30,26
1649990170449,MATH 20D,B02,084134,Staff,24,0,30,6
1649990170449,MATH 20D,B03,084135,Staff,28,0,30,2
1649990176495,MATH 20E,A01,084138,Staff,14,0,30,16
1649990176495,MATH 20E,A02,084139,Staff,7,0,30,23
1649990176495,MATH 20E,A03,084140,Staff,15,0,30,15
1649990176495,MATH 20E,A04,084141,Staff,20,0,30,10
1649990182546,MATH 102,A01,084143,Harel; Guershon,12,0,30,18
1649990182546,MATH 102,A02,084144,Harel; Guershon,20,0,30,10
1649990188585,MATH 103B,A01,083456,Staff,0,12,30,30
1649990188585,MATH 103B,A02,083457,Staff,0,12,30,30
1649990194607,MATH 109,A01,084146,Salehi Golsefidy; Alireza,18,0,30,12
1649990194607,MATH 109,A02,084147,Salehi Golsefidy; Alireza,17,0,30,13
1649990200639,MATH 120A,A01,085445,Eggers; John Dietrich,13,0,35,22
1649990200639,MATH 120A,A02,085446,Eggers; John Dietrich,27,0,35,8
1649990206689,MATH 142B,A01,084149,Verstraete; Jacques Allan,0,12,30,30
1649990206689,MATH 142B,A02,084150,Verstraete; Jacques Allan,0,12,30,30
1649990212713,MATH 170A,A01,083459,Nie; Jiawang,1,9,30,29
1649990212713,MATH 170A,A02,083460,Nie; Jiawang,0,6,30,30
1649990212713,MATH 170A,A03,083461,Nie; Jiawang,0,8,30,30
1649990218738,MATH 193B,A01,083463,Staff,1,0,30,29
1649990218738,MATH 193B,A02,083464,Staff,9,0,30,21
1649990218738,MATH 193B,A03,083465,Staff,18,0,30,12
1649990224800,COGS 2,A01,083966,Boyle; Mary E. T.,10,0,30,20
1649990230845,COGS 9,A01,083968,Staff,15,0,60,45
1649990236871,COGS 14B,A01,083970,Staff,12,0,50,38
1649990242894,COGS 17,A01,092679,Staff,53,0,75,22
1649990248920,COGS 100,A01,083972,Staff,0,15,60,60
1649990260968,COGS 101C,A01,083976,Staff,13,0,30,17
1649990267012,COGS 102A,A01,083978,Johnson; Christine M.,14,0,30,16
1649990273036,COGS 107B,A01,083980,Staff,0,7,50,50
1649990279070,COGS 115,A01,083982,Staff,11,0,30,19
1649990285103,COGS 118B,A01,083367,Staff,0,14,40,40
1649990291143,COGS 172,A01,083984,Provenzano; Emily Kara,15,0,30,15
1649990297192,COGS 177,A00,083368,Staff,0,20,30,30
1649990303219,COGS 186,A01,083986,Staff,21,0,40,19
1649990309267,COGS 187A,A01,083988,Boyle; Mary E. T.,19,0,60,41
1649990315303,CSE 8A,A50,084003,Miranda; Gregory Joseph,0,11,15,15
1649990321325,CSE 11,A01,084005,Miranda; Gregory Joseph,0,18,55,55
1649990327360,CSE 20,A01,084007,Staff,0,3,20,20
1649990333408,CSE 21,A01,084009,Staff,0,26,50,50
1649990339442,CSE 30,A01,083370,Cao; Yingjun,0,61,40,40
1649990345483,CSE 100,A01,083372,Cao; Yingjun,0,45,40,40
1649990351533,CSE 101,A01,084011,Staff,1,55,40,39
1649990357560,CSE 141,A01,083374,Eldon; John,0,62,75,75
1649990363596,CSE 141L,A01,083376,Eldon; John,0,68,75,75
1649990369648,CSE 175,A01,084013,Kumar; Rakesh,22,0,25,3
1649990375690,CSE 190,A00,092508,Dubnov; Shlomo,20,0,20,0
1649990381724,ECE 5,A01,084049,Morris; Karcher William,13,0,20,7
1649990387757,ECE 100,A01,084051,Baghdadchi; Saharnaz,0,0,20,20
1649990387757,ECE 100,A02,091916,Baghdadchi; Saharnaz,14,0,20,6
1649990393907,ECE 101,A01,084053,Baghdadchi; Saharnaz,2,0,37,35
1649990393907,ECE 101,A02,084054,Baghdadchi; Saharnaz,31,0,37,6
1649990399943,ECE 107,A01,083390,Staff,27,0,40,13
1649990405968,ECE 148,A01,084056,Silberman; Jack,8,0,12,4
1649990412003,ECE 180,A00,083391,Abi Samra; Nicholas Camill,25,0,30,5
1649990412003,ECE 180,B00,083392,Abi Samra; Nicholas Camill,21,0,30,9
1649990418026,MATH 10B,A01,084110,Staff,0,1,30,30
1649990418026,MATH 10B,A02,084111,Staff,22,0,30,8
1649990418026,MATH 10B,A03,084112,Staff,24,0,30,6
1649990424077,MATH 10C,A01,083443,Staff,1,12,30,29
1649990424077,MATH 10C,A02,083444,Staff,1,13,30,29
1649990424077,MATH 10C,B01,084114,Staff,20,0,30,10
1649990424077,MATH 10C,B02,084115,Staff,26,0,30,4
1649990430113,MATH 18,A01,084117,Harel; Guershon,18,0,30,12
1649990430113,MATH 18,A02,084119,Harel; Guershon,28,0,30,2
1649990430113,MATH 18,A03,084120,Harel; Guershon,29,0,30,1
1649990430113,MATH 18,A04,084121,Harel; Guershon,29,0,30,1
1649990436153,MATH 20B,A01,084124,Um; Ko Woon,19,0,35,16
1649990436153,MATH 20B,B01,084126,Um; Ko Woon,27,0,35,8
1649990442175,MATH 20C,A01,083446,Hammock; Frances H,0,0,30,30
1649990442175,MATH 20C,A02,083447,Hammock; Frances H,24,0,30,6
1649990442175,MATH 20C,A03,083448,Hammock; Frances H,25,0,30,5
1649990442175,MATH 20C,A04,083449,Hammock; Frances H,24,0,30,6
1649990442175,MATH 20C,B01,083451,Hammock; Frances H,2,0,30,28
1649990442175,MATH 20C,B02,083452,Hammock; Frances H,21,0,30,9
1649990442175,MATH 20C,B03,083453,Hammock; Frances H,23,0,30,7
1649990442175,MATH 20C,B04,083454,Hammock; Frances H,26,0,30,4
1649990448205,MATH 20D,A01,084128,Staff,16,0,30,14
1649990448205,MATH 20D,A02,084129,Staff,29,0,30,1
1649990448205,MATH 20D,A03,084130,Staff,27,0,30,3
1649990448205,MATH 20D,B01,084133,Staff,4,0,30,26
1649990448205,MATH 20D,B02,084134,Staff,24,0,30,6
1649990448205,MATH 20D,B03,084135,Staff,28,0,30,2
1649990454231,MATH 20E,A01,084138,Staff,14,0,30,16
1649990454231,MATH 20E,A02,084139,Staff,7,0,30,23
1649990454231,MATH 20E,A03,084140,Staff,15,0,30,15
1649990454231,MATH 20E,A04,084141,Staff,20,0,30,10
1649990460263,MATH 102,A01,084143,Harel; Guershon,12,0,30,18
1649990460263,MATH 102,A02,084144,Harel; Guershon,20,0,30,10
1649990466305,MATH 103B,A01,083456,Staff,0,12,30,30
1649990466305,MATH 103B,A02,083457,Staff,0,12,30,30
1649990472338,MATH 109,A01,084146,Salehi Golsefidy; Alireza,18,0,30,12
1649990472338,MATH 109,A02,084147,Salehi Golsefidy; Alireza,17,0,30,13
1649990478380,MATH 120A,A01,085445,Eggers; John Dietrich,13,0,35,22
1649990478380,MATH 120A,A02,085446,Eggers; John Dietrich,27,0,35,8
1649990484410,MATH 142B,A01,084149,Verstraete; Jacques Allan,0,12,30,30
1649990484410,MATH 142B,A02,084150,Verstraete; Jacques Allan,0,12,30,30
1649990490452,MATH 170A,A01,083459,Nie; Jiawang,1,9,30,29
1649990490452,MATH 170A,A02,083460,Nie; Jiawang,0,6,30,30
1649990490452,MATH 170A,A03,083461,Nie; Jiawang,0,8,30,30
1649990496489,MATH 193B,A01,083463,Staff,1,0,30,29
1649990496489,MATH 193B,A02,083464,Staff,9,0,30,21
1649990496489,MATH 193B,A03,083465,Staff,18,0,30,12
1649990502540,COGS 2,A01,083966,Boyle; Mary E. T.,10,0,30,20
1649990508588,COGS 9,A01,083968,Staff,15,0,60,45
1649990514631,COGS 14B,A01,083970,Staff,12,0,50,38
1649990520672,COGS 17,A01,092679,Staff,53,0,75,22
1649990526706,COGS 100,A01,083972,Staff,0,15,60,60
1649990538752,COGS 101C,A01,083976,Staff,13,0,30,17
1649990544787,COGS 102A,A01,083978,Johnson; Christine M.,14,0,30,16
1649990550832,COGS 107B,A01,083980,Staff,0,7,50,50
1649990556863,COGS 115,A01,083982,Staff,11,0,30,19
1649990562900,COGS 118B,A01,083367,Staff,0,14,40,40
1649990568944,COGS 172,A01,083984,Provenzano; Emily Kara,15,0,30,15
1649990574978,COGS 177,A00,083368,Staff,0,20,30,30
1649990581013,COGS 186,A01,083986,Staff,21,0,40,19
1649990587056,COGS 187A,A01,083988,Boyle; Mary E. T.,19,0,60,41
1649990593112,CSE 8A,A50,084003,Miranda; Gregory Joseph,0,12,15,15
1649990599151,CSE 11,A01,084005,Miranda; Gregory Joseph,0,18,55,55
1649990605185,CSE 20,A01,084007,Staff,0,3,20,20
1649990611220,CSE 21,A01,084009,Staff,0,26,50,50
1649990617263,CSE 30,A01,083370,Cao; Yingjun,0,61,40,40
1649990623306,CSE 100,A01,083372,Cao; Yingjun,0,45,40,40
1649990629352,CSE 101,A01,084011,Staff,1,55,40,39
1649990635385,CSE 141,A01,083374,Eldon; John,0,62,75,75
1649990641434,CSE 141L,A01,083376,Eldon; John,0,68,75,75
1649990647483,CSE 175,A01,084013,Kumar; Rakesh,22,0,25,3
1649990653528,CSE 190,A00,092508,Dubnov; Shlomo,20,0,20,0
1649990659576,ECE 5,A01,084049,Morris; Karcher William,13,0,20,7
1649990665615,ECE 100,A01,084051,Baghdadchi; Saharnaz,0,0,20,20
1649990665615,ECE 100,A02,091916,Baghdadchi; Saharnaz,14,0,20,6
1649990671670,ECE 101,A01,084053,Baghdadchi; Saharnaz,1,0,37,36
1649990671670,ECE 101,A02,084054,Baghdadchi; Saharnaz,31,0,37,6
1649990677723,ECE 107,A01,083390,Staff,27,0,40,13
1649990683750,ECE 148,A01,084056,Silberman; Jack,8,0,12,4
1649990689775,ECE 180,A00,083391,Abi Samra; Nicholas Camill,25,0,30,5
1649990689775,ECE 180,B00,083392,Abi Samra; Nicholas Camill,21,0,30,9
1649990695811,MATH 10B,A01,084110,Staff,0,1,30,30
1649990695811,MATH 10B,A02,084111,Staff,22,0,30,8
1649990695811,MATH 10B,A03,084112,Staff,24,0,30,6
1649990701852,MATH 10C,A01,083443,Staff,1,12,30,29
1649990701852,MATH 10C,A02,083444,Staff,1,13,30,29
1649990701852,MATH 10C,B01,084114,Staff,20,0,30,10
1649990701852,MATH 10C,B02,084115,Staff,26,0,30,4
1649990707881,MATH 18,A01,084117,Harel; Guershon,17,0,30,13
1649990707881,MATH 18,A02,084119,Harel; Guershon,28,0,30,2
1649990707881,MATH 18,A03,084120,Harel; Guershon,29,0,30,1
1649990707881,MATH 18,A04,084121,Harel; Guershon,29,0,30,1
1649990713933,MATH 20B,A01,084124,Um; Ko Woon,19,0,35,16
1649990713933,MATH 20B,B01,084126,Um; Ko Woon,26,0,35,9
1649990719956,MATH 20C,A01,083446,Hammock; Frances H,0,0,30,30
1649990719956,MATH 20C,A02,083447,Hammock; Frances H,22,0,30,8
1649990719956,MATH 20C,A03,083448,Hammock; Frances H,25,0,30,5
1649990719956,MATH 20C,A04,083449,Hammock; Frances H,24,0,30,6
1649990719956,MATH 20C,B01,083451,Hammock; Frances H,2,0,30,28
1649990719956,MATH 20C,B02,083452,Hammock; Frances H,21,0,30,9
1649990719956,MATH 20C,B03,083453,Hammock; Frances H,23,0,30,7
1649990719956,MATH 20C,B04,083454,Hammock; Frances H,26,0,30,4
1649990725980,MATH 20D,A01,084128,Staff,16,0,30,14
1649990725980,MATH 20D,A02,084129,Staff,29,0,30,1
1649990725980,MATH 20D,A03,084130,Staff,27,0,30,3
1649990725980,MATH 20D,B01,084133,Staff,4,0,30,26
1649990725980,MATH 20D,B02,084134,Staff,24,0,30,6
1649990725980,MATH 20D,B03,084135,Staff,28,0,30,2
1649990732023,MATH 20E,A01,084138,Staff,14,0,30,16
1649990732023,MATH 20E,A02,084139,Staff,7,0,30,23
1649990732023,MATH 20E,A03,084140,Staff,15,0,30,15
1649990732023,MATH 20E,A04,084141,Staff,20,0,30,10
1649990738070,MATH 102,A01,084143,Harel; Guershon,12,0,30,18
1649990738070,MATH 102,A02,084144,Harel; Guershon,20,0,30,10
1649990744095,MATH 103B,A01,083456,Staff,0,12,30,30
1649990744095,MATH 103B,A02,083457,Staff,0,12,30,30
1649990750122,MATH 109,A01,084146,Salehi Golsefidy; Alireza,18,0,30,12
1649990750122,MATH 109,A02,084147,Salehi Golsefidy; Alireza,17,0,30,13
1649990756173,MATH 120A,A01,085445,Eggers; John Dietrich,13,0,35,22
1649990756173,MATH 120A,A02,085446,Eggers; John Dietrich,27,0,35,8
1649990762208,MATH 142B,A01,084149,Verstraete; Jacques Allan,0,12,30,30
1649990762208,MATH 142B,A02,084150,Verstraete; Jacques Allan,0,12,30,30
1649990768232,MATH 170A,A01,083459,Nie; Jiawang,1,9,30,29
1649990768232,MATH 170A,A02,083460,Nie; Jiawang,0,6,30,30
1649990768232,MATH 170A,A03,083461,Nie; Jiawang,0,8,30,30
1649990774288,MATH 193B,A01,083463,Staff,1,0,30,29
1649990774288,MATH 193B,A02,083464,Staff,9,0,30,21
1649990774288,MATH 193B,A03,083465,Staff,18,0,30,12
1649990780350,COGS 2,A01,083966,Boyle; Mary E. T.,10,0,30,20
1649990786403,COGS 9,A01,083968,Staff,15,0,60,45
1649990792447,COGS 14B,A01,083970,Staff,11,0,50,39
1649990798490,COGS 17,A01,092679,Staff,53,0,75,22
1649990804526,COGS 100,A01,083972,Staff,0,15,60,60
1649990816606,COGS 101C,A01,083976,Staff,13,0,30,17
1649990822629,COGS 102A,A01,083978,Johnson; Christine M.,14,0,30,16
1649990828674,COGS 107B,A01,083980,Staff,0,7,50,50
1649990834718,COGS 115,A01,083982,Staff,11,0,30,19
1649990840748,COGS 118B,A01,083367,Staff,0,14,40,40
1649990846785,COGS 172,A01,083984,Provenzano; Emily Kara,15,0,30,15
1649990852837,COGS 177,A00,083368,Staff,0,20,30,30
1649990858879,COGS 186,A01,083986,Staff,21,0,40,19
1649990864909,COGS 187A,A01,083988,Boyle; Mary E. T.,19,0,60,41
1649990870951,CSE 8A,A50,084003,Miranda; Gregory Joseph,0,12,15,15
1649990876994,CSE 11,A01,084005,Miranda; Gregory Joseph,0,18,55,55
1649990883030,CSE 20,A01,084007,Staff,0,3,20,20
1649990889061,CSE 21,A01,084009,Staff,0,26,50,50
1649990895092,CSE 30,A01,083370,Cao; Yingjun,0,61,40,40
1649990901118,CSE 100,A01,083372,Cao; Yingjun,0,45,40,40
1649990907161,CSE 101,A01,084011,Staff,1,55,40,39
1649990913220,CSE 141,A01,083374,Eldon; John,0,62,75,75
1649990919255,CSE 141L,A01,083376,Eldon; John,0,68,75,75
1649990925284,CSE 175,A01,084013,Kumar; Rakesh,22,0,25,3
1649990931306,CSE 190,A00,092508,Dubnov; Shlomo,20,0,20,0
1649990937328,ECE 5,A01,084049,Morris; Karcher William,13,0,20,7
1649990943354,ECE 100,A01,084051,Baghdadchi; Saharnaz,0,0,20,20
1649990943354,ECE 100,A02,091916,Baghdadchi; Saharnaz,14,0,20,6
1649990949393,ECE 101,A01,084053,Baghdadchi; Saharnaz,1,0,37,36
1649990949393,ECE 101,A02,084054,Baghdadchi; Saharnaz,31,0,37,6
1649990955434,ECE 107,A01,083390,Staff,27,0,40,13
1649990961481,ECE 148,A01,084056,Silberman; Jack,8,0,12,4
1649990967525,ECE 180,A00,083391,Abi Samra; Nicholas Camill,25,0,30,5
1649990967525,ECE 180,B00,083392,Abi Samra; Nicholas Camill,21,0,30,9
1649990973552,MATH 10B,A01,084110,Staff,0,1,30,30
1649990973552,MATH 10B,A02,084111,Staff,22,0,30,8
1649990973552,MATH 10B,A03,084112,Staff,24,0,30,6
1649990979601,MATH 10C,A01,083443,Staff,1,12,30,29
1649990979601,MATH 10C,A02,083444,Staff,1,13,30,29
1649990979601,MATH 10C,B01,084114,Staff,20,0,30,10
1649990979601,MATH 10C,B02,084115,Staff,26,0,30,4
1649990985638,MATH 18,A01,084117,Harel; Guershon,17,0,30,13
1649990985638,MATH 18,A02,084119,Harel; Guershon,28,0,30,2
1649990985638,MATH 18,A03,084120,Harel; Guershon,29,0,30,1
1649990985638,MATH 18,A04,084121,Harel; Guershon,29,0,30,1
1649990991788,MATH 20B,A01,084124,Um; Ko Woon,18,0,35,17
1649990991788,MATH 20B,B01,084126,Um; Ko Woon,26,0,35,9
1649990997831,MATH 20C,A01,083446,Hammock; Frances H,0,0,30,30
1649990997831,MATH 20C,A02,083447,Hammock; Frances H,22,0,30,8
1649990997831,MATH 20C,A03,083448,Hammock; Frances H,25,0,30,5
1649990997831,MATH 20C,A04,083449,Hammock; Frances H,24,0,30,6
1649990997831,MATH 20C,B01,083451,Hammock; Frances H,2,0,30,28
1649990997831,MATH 20C,B02,083452,Hammock; Frances H,21,0,30,9
1649990997831,MATH 20C,B03,083453,Hammock; Frances H,23,0,30,7
1649990997831,MATH 20C,B04,083454,Hammock; Frances H,25,0,30,5
1649991003888,MATH 20D,A01,084128,Staff,16,0,30,14
1649991003888,MATH 20D,A02,084129,Staff,29,0,30,1
1649991003888,MATH 20D,A03,084130,Staff,27,0,30,3
1649991003888,MATH 20D,B01,084133,Staff,4,0,30,26
1649991003888,MATH 20D,B02,084134,Staff,24,0,30,6
1649991003888,MATH 20D,B03,084135,Staff,28,0,30,2
1649991009912,MATH 20E,A01,084138,Staff,14,0,30,16
1649991009912,MATH 20E,A02,084139,Staff,7,0,30,23
1649991009912,MATH 20E,A03,084140,Staff,15,0,30,15
1649991009912,MATH 20E,A04,084141,Staff,20,0,30,10
1649991015961,MATH 102,A01,084143,Harel; Guershon,12,0,30,18
1649991015961,MATH 102,A02,084144,Harel; Guershon,20,0,30,10
1649991021986,MATH 103B,A01,083456,Staff,0,12,30,30
1649991021986,MATH 103B,A02,083457,Staff,0,12,30,30
1649991028021,MATH 109,A01,084146,Salehi Golsefidy; Alireza,18,0,30,12
1649991028021,MATH 109,A02,084147,Salehi Golsefidy; Alireza,17,0,30,13
1649991034070,MATH 120A,A01,085445,Eggers; John Dietrich,13,0,35,22
1649991034070,MATH 120A,A02,085446,Eggers; John Dietrich,27,0,35,8
1649991040092,MATH 142B,A01,084149,Verstraete; Jacques Allan,0,12,30,30
1649991040092,MATH 142B,A02,084150,Verstraete; Jacques Allan,0,12,30,30
1649991046125,MATH 170A,A01,083459,Nie; Jiawang,1,9,30,29
1649991046125,MATH 170A,A02,083460,Nie; Jiawang,0,6,30,30
1649991046125,MATH 170A,A03,083461,Nie; Jiawang,0,8,30,30
1649991052150,MATH 193B,A01,083463,Staff,1,0,30,29
1649991052150,MATH 193B,A02,083464,Staff,9,0,30,21
1649991052150,MATH 193B,A03,083465,Staff,18,0,30,12
1649991058230,COGS 2,A01,083966,Boyle; Mary E. T.,10,0,30,20
1649991064265,COGS 9,A01,083968,Staff,15,0,60,45
1649991070288,COGS 14B,A01,083970,Staff,11,0,50,39
1649991083809,COGS 17,A01,092679,Staff,53,0,75,22
1649991089832,COGS 100,A01,083972,Staff,0,15,60,60
1649991101909,COGS 101C,A01,083976,Staff,13,0,30,17
1649991107952,COGS 102A,A01,083978,Johnson; Christine M.,14,0,30,16
1649991113986,COGS 107B,A01,083980,Staff,0,7,50,50
1649991120008,COGS 115,A01,083982,Staff,11,0,30,19
1649991126052,COGS 118B,A01,083367,Staff,0,14,40,40
1649991132075,COGS 172,A01,083984,Provenzano; Emily Kara,15,0,30,15
1649991138098,COGS 177,A00,083368,Staff,0,20,30,30
1649991144148,COGS 186,A01,083986,Staff,21,0,40,19
1649991150186,COGS 187A,A01,083988,Boyle; Mary E. T.,19,0,60,41
1649991156225,CSE 8A,A50,084003,Miranda; Gregory Joseph,0,12,15,15
1649991162258,CSE 11,A01,084005,Miranda; Gregory Joseph,0,18,55,55
1649991168309,CSE 20,A01,084007,Staff,0,3,20,20
1649991174335,CSE 21,A01,084009,Staff,0,26,50,50
1649991180357,CSE 30,A01,083370,Cao; Yingjun,0,61,40,40
1649991186380,CSE 100,A01,083372,Cao; Yingjun,0,45,40,40
1649991192406,CSE 101,A01,084011,Staff,1,55,40,39
1649991198447,CSE 141,A01,083374,Eldon; John,0,62,75,75
1649991204483,CSE 141L,A01,083376,Eldon; John,0,68,75,75
1649991210525,CSE 175,A01,084013,Kumar; Rakesh,22,0,25,3
1649991216563,CSE 190,A00,092508,Dubnov; Shlomo,20,0,20,0
1649991222588,ECE 5,A01,084049,Morris; Karcher William,13,0,20,7
1649991228628,ECE 100,A01,084051,Baghdadchi; Saharnaz,0,0,20,20
1649991228628,ECE 100,A02,091916,Baghdadchi; Saharnaz,14,0,20,6
1649991234655,ECE 101,A01,084053,Baghdadchi; Saharnaz,1,0,37,36
1649991234655,ECE 101,A02,084054,Baghdadchi; Saharnaz,31,0,37,6
1649991240678,ECE 107,A01,083390,Staff,27,0,40,13
1649991246723,ECE 148,A01,084056,Silberman; Jack,8,0,12,4
1649991252778,ECE 180,A00,083391,Abi Samra; Nicholas Camill,25,0,30,5
1649991252778,ECE 180,B00,083392,Abi Samra; Nicholas Camill,21,0,30,9
1649991258816,MATH 10B,A01,084110,Staff,0,1,30,30
1649991258816,MATH 10B,A02,084111,Staff,22,0,30,8
1649991258816,MATH 10B,A03,084112,Staff,24,0,30,6
1649991264856,MATH 10C,A01,083443,Staff,1,12,30,29
1649991264856,MATH 10C,A02,083444,Staff,1,13,30,29
1649991264856,MATH 10C,B01,084114,Staff,20,0,30,10
1649991264856,MATH 10C,B02,084115,Staff,26,0,30,4
1649991270883,MATH 18,A01,084117,Harel; Guershon,17,0,30,13
1649991270883,MATH 18,A02,084119,Harel; Guershon,28,0,30,2
1649991270883,MATH 18,A03,084120,Harel; Guershon,29,0,30,1
1649991270883,MATH 18,A04,084121,Harel; Guershon,29,0,30,1
1649991276929,MATH 20B,A01,084124,Um; Ko Woon,18,0,35,17
1649991276929,MATH 20B,B01,084126,Um; Ko Woon,26,0,35,9
1649991282971,MATH 20C,A01,083446,Hammock; Frances H,0,0,30,30
1649991282971,MATH 20C,A02,083447,Hammock; Frances H,22,0,30,8
1649991282971,MATH 20C,A03,083448,Hammock; Frances H,25,0,30,5
1649991282971,MATH 20C,A04,083449,Hammock; Frances H,23,0,30,7
1649991282971,MATH 20C,B01,083451,Hammock; Frances H,2,0,30,28
1649991282971,MATH 20C,B02,083452,Hammock; Frances H,21,0,30,9
1649991282971,MATH 20C,B03,083453,Hammock; Frances H,23,0,30,7
1649991282971,MATH 20C,B04,083454,Hammock; Frances H,25,0,30,5
1649991288998,MATH 20D,A01,084128,Staff,15,0,30,15
1649991288998,MATH 20D,A02,084129,Staff,29,0,30,1
1649991288998,MATH 20D,A03,084130,Staff,27,0,30,3
1649991288998,MATH 20D,B01,084133,Staff,4,0,30,26
1649991288998,MATH 20D,B02,084134,Staff,24,0,30,6
1649991288998,MATH 20D,B03,084135,Staff,28,0,30,2
1649991295026,MATH 20E,A01,084138,Staff,14,0,30,16
1649991295026,MATH 20E,A02,084139,Staff,7,0,30,23
1649991295026,MATH 20E,A03,084140,Staff,15,0,30,15
1649991295026,MATH 20E,A04,084141,Staff,20,0,30,10
1649991301055,MATH 102,A01,084143,Harel; Guershon,12,0,30,18
1649991301055,MATH 102,A02,084144,Harel; Guershon,20,0,30,10
1649991307084,MATH 103B,A01,083456,Staff,0,12,30,30
1649991307084,MATH 103B,A02,083457,Staff,0,12,30,30
1649991313117,MATH 109,A01,084146,Salehi Golsefidy; Alireza,18,0,30,12
1649991313117,MATH 109,A02,084147,Salehi Golsefidy; Alireza,17,0,30,13
1649991319139,MATH 120A,A01,085445,Eggers; John Dietrich,13,0,35,22
1649991319139,MATH 120A,A02,085446,Eggers; John Dietrich,27,0,35,8
1649991325174,MATH 142B,A01,084149,Verstraete; Jacques Allan,0,12,30,30
1649991325174,MATH 142B,A02,084150,Verstraete; Jacques Allan,0,12,30,30
1649991331210,MATH 170A,A01,083459,Nie; Jiawang,1,9,30,29
1649991331210,MATH 170A,A02,083460,Nie; Jiawang,0,6,30,30
1649991331210,MATH 170A,A03,083461,Nie; Jiawang,0,8,30,30
1649991337266,MATH 193B,A01,083463,Staff,1,0,30,29
1649991337266,MATH 193B,A02,083464,Staff,9,0,30,21
1649991337266,MATH 193B,A03,083465,Staff,18,0,30,12
1649991343332,COGS 2,A01,083966,Boyle; Mary E. T.,10,0,30,20
1649991349381,COGS 9,A01,083968,Staff,15,0,60,45
1649991355425,COGS 14B,A01,083970,Staff,11,0,50,39
1649991361453,COGS 17,A01,092679,Staff,53,0,75,22
1649991367489,COGS 100,A01,083972,Staff,0,15,60,60
1649991379570,COGS 101C,A01,083976,Staff,13,0,30,17
1649991385612,COGS 102A,A01,083978,Johnson; Christine M.,14,0,30,16
1649991391644,COGS 107B,A01,083980,Staff,0,7,50,50
1649991397667,COGS 115,A01,083982,Staff,11,0,30,19
1649991403708,COGS 118B,A01,083367,Staff,0,14,40,40
1649991409754,COGS 172,A01,083984,Provenzano; Emily Kara,15,0,30,15
1649991415786,COGS 177,A00,083368,Staff,0,20,30,30
1649991421819,COGS 186,A01,083986,Staff,21,0,40,19
1649991427859,COGS 187A,A01,083988,Boyle; Mary E. T.,19,0,60,41
1649991433908,CSE 8A,A50,084003,Miranda; Gregory Joseph,0,12,15,15
1649991439963,CSE 11,A01,084005,Miranda; Gregory Joseph,0,18,55,55
1649991446009,CSE 20,A01,084007,Staff,0,3,20,20
1649991452058,CSE 21,A01,084009,Staff,0,26,50,50
1649991458082,CSE 30,A01,083370,Cao; Yingjun,0,61,40,40
1649991464114,CSE 100,A01,083372,Cao; Yingjun,0,45,40,40
1649991470149,CSE 101,A01,084011,Staff,1,55,40,39
1649991476191,CSE 141,A01,083374,Eldon; John,0,62,75,75
1649991482216,CSE 141L,A01,083376,Eldon; John,0,68,75,75
1649991488261,CSE 175,A01,084013,Kumar; Rakesh,22,0,25,3
1649991494312,CSE 190,A00,092508,Dubnov; Shlomo,20,0,20,0
1649991500351,ECE 5,A01,084049,Morris; Karcher William,13,0,20,7
1649991506381,ECE 100,A01,084051,Baghdadchi; Saharnaz,0,0,20,20
1649991506381,ECE 100,A02,091916,Baghdadchi; Saharnaz,14,0,20,6
1649991512412,ECE 101,A01,084053,Baghdadchi; Saharnaz,1,0,37,36
1649991512412,ECE 101,A02,084054,Baghdadchi; Saharnaz,31,0,37,6
1649991518444,ECE 107,A01,083390,Staff,27,0,40,13
1649991524471,ECE 148,A01,084056,Silberman; Jack,8,0,12,4
1649991530504,ECE 180,A00,083391,Abi Samra; Nicholas Camill,25,0,30,5
1649991530504,ECE 180,B00,083392,Abi Samra; Nicholas Camill,21,0,30,9
1649991536538,MATH 10B,A01,084110,Staff,0,1,30,30
1649991536538,MATH 10B,A02,084111,Staff,22,0,30,8
1649991536538,MATH 10B,A03,084112,Staff,24,0,30,6
1649991542584,MATH 10C,A01,083443,Staff,1,12,30,29
1649991542584,MATH 10C,A02,083444,Staff,1,13,30,29
1649991542584,MATH 10C,B01,084114,Staff,20,0,30,10
1649991542584,MATH 10C,B02,084115,Staff,26,0,30,4
1649991548608,MATH 18,A01,084117,Harel; Guershon,17,0,30,13
1649991548608,MATH 18,A02,084119,Harel; Guershon,28,0,30,2
1649991548608,MATH 18,A03,084120,Harel; Guershon,29,0,30,1
1649991548608,MATH 18,A04,084121,Harel; Guershon,29,0,30,1
1649991554670,MATH 20B,A01,084124,Um; Ko Woon,18,0,35,17
1649991554670,MATH 20B,B01,084126,Um; Ko Woon,26,0,35,9
1649991560708,MATH 20C,A01,083446,Hammock; Frances H,0,0,30,30
1649991560708,MATH 20C,A02,083447,Hammock; Frances H,22,0,30,8
1649991560708,MATH 20C,A03,083448,Hammock; Frances H,24,0,30,6
1649991560708,MATH 20C,A04,083449,Hammock; Frances H,23,0,30,7
1649991560708,MATH 20C,B01,083451,Hammock; Frances H,2,0,30,28
1649991560708,MATH 20C,B02,083452,Hammock; Frances H,21,0,30,9
1649991560708,MATH 20C,B03,083453,Hammock; Frances H,23,0,30,7
1649991560708,MATH 20C,B04,083454,Hammock; Frances H,25,0,30,5
1649991566759,MATH 20D,A01,084128,Staff,15,0,30,15
1649991566759,MATH 20D,A02,084129,Staff,29,0,30,1
1649991566759,MATH 20D,A03,084130,Staff,27,0,30,3
1649991566759,MATH 20D,B01,084133,Staff,4,0,30,26
1649991566759,MATH 20D,B02,084134,Staff,24,0,30,6
1649991566759,MATH 20D,B03,084135,Staff,28,0,30,2
1649991572797,MATH 20E,A01,084138,Staff,14,0,30,16
1649991572797,MATH 20E,A02,084139,Staff,7,0,30,23
1649991572797,MATH 20E,A03,084140,Staff,15,0,30,15
1649991572797,MATH 20E,A04,084141,Staff,20,0,30,10
1649991578839,MATH 102,A01,084143,Harel; Guershon,12,0,30,18
1649991578839,MATH 102,A02,084144,Harel; Guershon,20,0,30,10
1649991584899,MATH 103B,A01,083456,Staff,0,12,30,30
1649991584899,MATH 103B,A02,083457,Staff,0,12,30,30
1649991590922,MATH 109,A01,084146,Salehi Golsefidy; Alireza,18,0,30,12
1649991590922,MATH 109,A02,084147,Salehi Golsefidy; Alireza,17,0,30,13
1649991597077,MATH 120A,A01,085445,Eggers; John Dietrich,13,0,35,22
1649991597077,MATH 120A,A02,085446,Eggers; John Dietrich,27,0,35,8
1649991603124,MATH 142B,A01,084149,Verstraete; Jacques Allan,0,12,30,30
1649991603124,MATH 142B,A02,084150,Verstraete; Jacques Allan,0,12,30,30
1649991609172,MATH 170A,A01,083459,Nie; Jiawang,1,9,30,29
1649991609172,MATH 170A,A02,083460,Nie; Jiawang,0,6,30,30
1649991609172,MATH 170A,A03,083461,Nie; Jiawang,0,8,30,30
1649991615222,MATH 193B,A01,083463,Staff,1,0,30,29
1649991615222,MATH 193B,A02,083464,Staff,9,0,30,21
1649991615222,MATH 193B,A03,083465,Staff,18,0,30,12
1649991621337,COGS 2,A01,083966,Boyle; Mary E. T.,10,0,30,20
1649991627384,COGS 9,A01,083968,Staff,15,0,60,45
1649991633441,COGS 14B,A01,083970,Staff,11,0,50,39
1649991639493,COGS 17,A01,092679,Staff,53,0,75,22
1649991645533,COGS 100,A01,083972,Staff,0,15,60,60
1649991657618,COGS 101C,A01,083976,Staff,13,0,30,17
1649991663660,COGS 102A,A01,083978,Johnson; Christine M.,14,0,30,16
1649991669713,COGS 107B,A01,083980,Staff,0,7,50,50
1649991675762,COGS 115,A01,083982,Staff,11,0,30,19
1649991681822,COGS 118B,A01,083367,Staff,0,14,40,40
1649991687869,COGS 172,A01,083984,Provenzano; Emily Kara,15,0,30,15
1649991693905,COGS 177,A00,083368,Staff,0,20,30,30
1649991699935,COGS 186,A01,083986,Staff,21,0,40,19
1649991705970,COGS 187A,A01,083988,Boyle; Mary E. T.,19,0,60,41
1649991712005,CSE 8A,A50,084003,Miranda; Gregory Joseph,0,12,15,15
1649991718062,CSE 11,A01,084005,Miranda; Gregory Joseph,0,18,55,55
1649991724124,CSE 20,A01,084007,Staff,0,3,20,20
1649991730174,CSE 21,A01,084009,Staff,0,26,50,50
1649991736198,CSE 30,A01,083370,Cao; Yingjun,0,61,40,40
1649991742251,CSE 100,A01,083372,Cao; Yingjun,0,45,40,40
1649991748311,CSE 101,A01,084011,Staff,1,55,40,39
1649991754361,CSE 141,A01,083374,Eldon; John,0,62,75,75
1649991760407,CSE 141L,A01,083376,Eldon; John,0,68,75,75
1649991766446,CSE 175,A01,084013,Kumar; Rakesh,22,0,25,3
1649991772480,CSE 190,A00,092508,Dubnov; Shlomo,20,0,20,0
1649991778517,ECE 5,A01,084049,Morris; Karcher William,13,0,20,7
1649991784565,ECE 100,A01,084051,Baghdadchi; Saharnaz,0,0,20,20
1649991784565,ECE 100,A02,091916,Baghdadchi; Saharnaz,14,0,20,6
1649991790601,ECE 101,A01,084053,Baghdadchi; Saharnaz,1,0,37,36
1649991790601,ECE 101,A02,084054,Baghdadchi; Saharnaz,31,0,37,6
1649991796659,ECE 107,A01,083390,Staff,27,0,40,13
1649991802709,ECE 148,A01,084056,Silberman; Jack,8,0,12,4
1649991808766,ECE 180,A00,083391,Abi Samra; Nicholas Camill,25,0,30,5
1649991808766,ECE 180,B00,083392,Abi Samra; Nicholas Camill,21,0,30,9
1649991814804,MATH 10B,A01,084110,Staff,0,1,30,30
1649991814804,MATH 10B,A02,084111,Staff,21,0,30,9
1649991814804,MATH 10B,A03,084112,Staff,24,0,30,6
1649991820843,MATH 10C,A01,083443,Staff,1,13,30,29
1649991820843,MATH 10C,A02,083444,Staff,1,13,30,29
1649991820843,MATH 10C,B01,084114,Staff,20,0,30,10
1649991820843,MATH 10C,B02,084115,Staff,25,0,30,5
1649991826884,MATH 18,A01,084117,Harel; Guershon,16,0,30,14
1649991826884,MATH 18,A02,084119,Harel; Guershon,28,0,30,2
1649991826884,MATH 18,A03,084120,Harel; Guershon,29,0,30,1
1649991826884,MATH 18,A04,084121,Harel; Guershon,29,0,30,1
1649991832916,MATH 20B,A01,084124,Um; Ko Woon,18,0,35,17
1649991832916,MATH 20B,B01,084126,Um; Ko Woon,26,0,35,9
1649991838968,MATH 20C,A01,083446,Hammock; Frances H,0,0,30,30
1649991838968,MATH 20C,A02,083447,Hammock; Frances H,22,0,30,8
1649991838968,MATH 20C,A03,083448,Hammock; Frances H,24,0,30,6
1649991838968,MATH 20C,A04,083449,Hammock; Frances H,23,0,30,7
1649991838968,MATH 20C,B01,083451,Hammock; Frances H,2,0,30,28
1649991838968,MATH 20C,B02,083452,Hammock; Frances H,21,0,30,9
1649991838968,MATH 20C,B03,083453,Hammock; Frances H,23,0,30,7
1649991838968,MATH 20C,B04,083454,Hammock; Frances H,25,0,30,5
1649991845002,MATH 20D,A01,084128,Staff,15,0,30,15
1649991845002,MATH 20D,A02,084129,Staff,29,0,30,1
1649991845002,MATH 20D,A03,084130,Staff,27,0,30,3
1649991845002,MATH 20D,B01,084133,Staff,4,0,30,26
1649991845002,MATH 20D,B02,084134,Staff,24,0,30,6
1649991845002,MATH 20D,B03,084135,Staff,28,0,30,2
1649991851038,MATH 20E,A01,084138,Staff,14,0,30,16
1649991851038,MATH 20E,A02,084139,Staff,7,0,30,23
1649991851038,MATH 20E,A03,084140,Staff,15,0,30,15
1649991851038,MATH 20E,A04,084141,Staff,20,0,30,10
1649991857080,MATH 102,A01,084143,Harel; Guershon,12,0,30,18
1649991857080,MATH 102,A02,084144,Harel; Guershon,20,0,30,10
1649991863140,MATH 103B,A01,083456,Staff,0,12,30,30
1649991863140,MATH 103B,A02,083457,Staff,0,12,30,30
1649991869179,MATH 109,A01,084146,Salehi Golsefidy; Alireza,18,0,30,12
1649991869179,MATH 109,A02,084147,Salehi Golsefidy; Alireza,17,0,30,13
1649991875201,MATH 120A,A01,085445,Eggers; John Dietrich,13,0,35,22
1649991875201,MATH 120A,A02,085446,Eggers; John Dietrich,27,0,35,8
1649991881238,MATH 142B,A01,084149,Verstraete; Jacques Allan,0,12,30,30
1649991881238,MATH 142B,A02,084150,Verstraete; Jacques Allan,0,12,30,30
1649991887292,MATH 170A,A01,083459,Nie; Jiawang,1,9,30,29
1649991887292,MATH 170A,A02,083460,Nie; Jiawang,0,6,30,30
1649991887292,MATH 170A,A03,083461,Nie; Jiawang,0,8,30,30
1649991893350,MATH 193B,A01,083463,Staff,1,0,30,29
1649991893350,MATH 193B,A02,083464,Staff,9,0,30,21
1649991893350,MATH 193B,A03,083465,Staff,18,0,30,12
1649991899453,COGS 2,A01,083966,Boyle; Mary E. T.,10,0,30,20
1649991905504,COGS 9,A01,083968,Staff,15,0,60,45
1649991911550,COGS 14B,A01,083970,Staff,11,0,50,39
1649991917586,COGS 17,A01,092679,Staff,53,0,75,22
1649991923635,COGS 100,A01,083972,Staff,0,15,60,60
1649991935700,COGS 101C,A01,083976,Staff,13,0,30,17
1649991941742,COGS 102A,A01,083978,Johnson; Christine M.,14,0,30,16
1649991947768,COGS 107B,A01,083980,Staff,0,7,50,50
1649991953813,COGS 115,A01,083982,Staff,11,0,30,19
1649991959862,COGS 118B,A01,083367,Staff,0,14,40,40
1649991965918,COGS 172,A01,083984,Provenzano; Emily Kara,15,0,30,15
1649991971977,COGS 177,A00,083368,Staff,0,20,30,30
1649991978001,COGS 186,A01,083986,Staff,21,0,40,19
1649991984043,COGS 187A,A01,083988,Boyle; Mary E. T.,19,0,60,41
1649991990074,CSE 8A,A50,084003,Miranda; Gregory Joseph,0,12,15,15
1649991996121,CSE 11,A01,084005,Miranda; Gregory Joseph,0,18,55,55
1649992002153,CSE 20,A01,084007,Staff,0,3,20,20
1649992008215,CSE 21,A01,084009,Staff,0,26,50,50
1649992014280,CSE 30,A01,083370,Cao; Yingjun,0,62,40,40
1649992020353,CSE 100,A01,083372,Cao; Yingjun,0,45,40,40
1649992026415,CSE 101,A01,084011,Staff,1,55,40,39
1649992032469,CSE 141,A01,083374,Eldon; John,0,62,75,75
1649992038502,CSE 141L,A01,083376,Eldon; John,0,68,75,75
1649992044551,CSE 175,A01,084013,Kumar; Rakesh,22,0,25,3
1649992050595,CSE 190,A00,092508,Dubnov; Shlomo,20,0,20,0
1649992056618,ECE 5,A01,084049,Morris; Karcher William,13,0,20,7
1649992062645,ECE 100,A01,084051,Baghdadchi; Saharnaz,0,0,20,20
1649992062645,ECE 100,A02,091916,Baghdadchi; Saharnaz,14,0,20,6
1649992068704,ECE 101,A01,084053,Baghdadchi; Saharnaz,1,0,37,36
1649992068704,ECE 101,A02,084054,Baghdadchi; Saharnaz,31,0,37,6
1649992074754,ECE 107,A01,083390,Staff,27,0,40,13
1649992080792,ECE 148,A01,084056,Silberman; Jack,8,0,12,4
1649992086847,ECE 180,A00,083391,Abi Samra; Nicholas Camill,25,0,30,5
1649992086847,ECE 180,B00,083392,Abi Samra; Nicholas Camill,21,0,30,9
1649992092901,MATH 10B,A01,084110,Staff,0,1,30,30
1649992092901,MATH 10B,A02,084111,Staff,21,0,30,9
1649992092901,MATH 10B,A03,084112,Staff,24,0,30,6
1649992098956,MATH 10C,A01,083443,Staff,1,13,30,29
1649992098956,MATH 10C,A02,083444,Staff,1,14,30,29
1649992098956,MATH 10C,B01,084114,Staff,20,0,30,10
1649992098956,MATH 10C,B02,084115,Staff,25,0,30,5
1649992105024,MATH 18,A01,084117,Harel; Guershon,16,0,30,14
1649992105024,MATH 18,A02,084119,Harel; Guershon,28,0,30,2
1649992105024,MATH 18,A03,084120,Harel; Guershon,29,0,30,1
1649992105024,MATH 18,A04,084121,Harel; Guershon,29,0,30,1
1649992111062,MATH 20B,A01,084124,Um; Ko Woon,18,0,35,17
1649992111062,MATH 20B,B01,084126,Um; Ko Woon,26,0,35,9
1649992117119,MATH 20C,A01,083446,Hammock; Frances H,0,0,30,30
1649992117119,MATH 20C,A02,083447,Hammock; Frances H,21,0,30,9
1649992117119,MATH 20C,A03,083448,Hammock; Frances H,24,0,30,6
1649992117119,MATH 20C,A04,083449,Hammock; Frances H,23,0,30,7
1649992117119,MATH 20C,B01,083451,Hammock; Frances H,2,0,30,28
1649992117119,MATH 20C,B02,083452,Hammock; Frances H,21,0,30,9
1649992117119,MATH 20C,B03,083453,Hammock; Frances H,23,0,30,7
1649992117119,MATH 20C,B04,083454,Hammock; Frances H,25,0,30,5
1649992123144,MATH 20D,A01,084128,Staff,15,0,30,15
1649992123144,MATH 20D,A02,084129,Staff,29,0,30,1
1649992123144,MATH 20D,A03,084130,Staff,27,0,30,3
1649992123144,MATH 20D,B01,084133,Staff,4,0,30,26
1649992123144,MATH 20D,B02,084134,Staff,24,0,30,6
1649992123144,MATH 20D,B03,084135,Staff,28,0,30,2
1649992129173,MATH 20E,A01,084138,Staff,14,0,30,16
1649992129173,MATH 20E,A02,084139,Staff,7,0,30,23
1649992129173,MATH 20E,A03,084140,Staff,15,0,30,15
1649992129173,MATH 20E,A04,084141,Staff,20,0,30,10
1649992135209,MATH 102,A01,084143,Harel; Guershon,12,0,30,18
1649992135209,MATH 102,A02,084144,Harel; Guershon,20,0,30,10
1649992141232,MATH 103B,A01,083456,Staff,0,12,30,30
1649992141232,MATH 103B,A02,083457,Staff,0,12,30,30
1649992147275,MATH 109,A01,084146,Salehi Golsefidy; Alireza,18,0,30,12
1649992147275,MATH 109,A02,084147,Salehi Golsefidy; Alireza,17,0,30,13
1649992153340,MATH 120A,A01,085445,Eggers; John Dietrich,13,0,35,22
1649992153340,MATH 120A,A02,085446,Eggers; John Dietrich,27,0,35,8
1649992159383,MATH 142B,A01,084149,Verstraete; Jacques Allan,0,12,30,30
1649992159383,MATH 142B,A02,084150,Verstraete; Jacques Allan,0,12,30,30
1649992165412,MATH 170A,A01,083459,Nie; Jiawang,1,9,30,29
1649992165412,MATH 170A,A02,083460,Nie; Jiawang,0,6,30,30
1649992165412,MATH 170A,A03,083461,Nie; Jiawang,0,8,30,30
1649992171467,MATH 193B,A01,083463,Staff,1,0,30,29
1649992171467,MATH 193B,A02,083464,Staff,9,0,30,21
1649992171467,MATH 193B,A03,083465,Staff,18,0,30,12
1649992177540,COGS 2,A01,083966,Boyle; Mary E. T.,10,0,30,20
1649992183597,COGS 9,A01,083968,Staff,15,0,60,45
1649992189737,COGS 14B,A01,083970,Staff,11,0,50,39
1649992195778,COGS 17,A01,092679,Staff,53,0,75,22
1649992201831,COGS 100,A01,083972,Staff,0,15,60,60
1649992213918,COGS 101C,A01,083976,Staff,13,0,30,17
1649992219943,COGS 102A,A01,083978,Johnson; Christine M.,14,0,30,16
1649992225973,COGS 107B,A01,083980,Staff,0,7,50,50
1649992232004,COGS 115,A01,083982,Staff,11,0,30,19
1649992238044,COGS 118B,A01,083367,Staff,0,14,40,40
1649992244069,COGS 172,A01,083984,Provenzano; Emily Kara,15,0,30,15
1649992250117,COGS 177,A00,083368,Staff,0,20,30,30
1649992256145,COGS 186,A01,083986,Staff,21,0,40,19
1649992262170,COGS 187A,A01,083988,Boyle; Mary E. T.,19,0,60,41
1649992268214,CSE 8A,A50,084003,Miranda; Gregory Joseph,0,12,15,15
1649992274270,CSE 11,A01,084005,Miranda; Gregory Joseph,0,18,55,55
1649992280308,CSE 20,A01,084007,Staff,0,3,20,20
1649992286338,CSE 21,A01,084009,Staff,0,27,50,50
1649992292367,CSE 30,A01,083370,Cao; Yingjun,0,61,40,40
1649992298414,CSE 100,A01,083372,Cao; Yingjun,0,45,40,40
1649992304443,CSE 101,A01,084011,Staff,1,55,40,39
1649992310494,CSE 141,A01,083374,Eldon; John,0,62,75,75
1649992316544,CSE 141L,A01,083376,Eldon; John,0,68,75,75
1649992322595,CSE 175,A01,084013,Kumar; Rakesh,22,0,25,3
1649992328647,CSE 190,A00,092508,Dubnov; Shlomo,20,0,20,0
1649992334675,ECE 5,A01,084049,Morris; Karcher William,13,0,20,7
1649992340710,ECE 100,A01,084051,Baghdadchi; Saharnaz,0,0,20,20
1649992340710,ECE 100,A02,091916,Baghdadchi; Saharnaz,14,0,20,6
1649992346733,ECE 101,A01,084053,Baghdadchi; Saharnaz,1,0,37,36
1649992346733,ECE 101,A02,084054,Baghdadchi; Saharnaz,31,0,37,6
1649992352762,ECE 107,A01,083390,Staff,27,0,40,13
1649992358810,ECE 148,A01,084056,Silberman; Jack,8,0,12,4
1649992364834,ECE 180,A00,083391,Abi Samra; Nicholas Camill,25,0,30,5
1649992364834,ECE 180,B00,083392,Abi Samra; Nicholas Camill,21,0,30,9
1649992370894,MATH 10B,A01,084110,Staff,0,1,30,30
1649992370894,MATH 10B,A02,084111,Staff,21,0,30,9
1649992370894,MATH 10B,A03,084112,Staff,24,0,30,6
1649992376921,MATH 10C,A01,083443,Staff,1,13,30,29
1649992376921,MATH 10C,A02,083444,Staff,1,14,30,29
1649992376921,MATH 10C,B01,084114,Staff,20,0,30,10
1649992376921,MATH 10C,B02,084115,Staff,25,0,30,5
1649992382957,MATH 18,A01,084117,Harel; Guershon,16,0,30,14
1649992382957,MATH 18,A02,084119,Harel; Guershon,28,0,30,2
1649992382957,MATH 18,A03,084120,Harel; Guershon,29,0,30,1
1649992382957,MATH 18,A04,084121,Harel; Guershon,29,0,30,1
1649992388991,MATH 20B,A01,084124,Um; Ko Woon,18,0,35,17
1649992388991,MATH 20B,B01,084126,Um; Ko Woon,26,0,35,9
1649992395043,MATH 20C,A01,083446,Hammock; Frances H,0,0,30,30
1649992395043,MATH 20C,A02,083447,Hammock; Frances H,21,0,30,9
1649992395043,MATH 20C,A03,083448,Hammock; Frances H,24,0,30,6
1649992395043,MATH 20C,A04,083449,Hammock; Frances H,23,0,30,7
1649992395043,MATH 20C,B01,083451,Hammock; Frances H,2,0,30,28
1649992395043,MATH 20C,B02,083452,Hammock; Frances H,21,0,30,9
1649992395043,MATH 20C,B03,083453,Hammock; Frances H,23,0,30,7
1649992395043,MATH 20C,B04,083454,Hammock; Frances H,25,0,30,5
1649992401100,MATH 20D,A01,084128,Staff,15,0,30,15
1649992401100,MATH 20D,A02,084129,Staff,29,0,30,1
1649992401100,MATH 20D,A03,084130,Staff,27,0,30,3
1649992401100,MATH 20D,B01,084133,Staff,4,0,30,26
1649992401100,MATH 20D,B02,084134,Staff,24,0,30,6
1649992401100,MATH 20D,B03,084135,Staff,28,0,30,2
1649992407122,MATH 20E,A01,084138,Staff,14,0,30,16
1649992407122,MATH 20E,A02,084139,Staff,7,0,30,23
1649992407122,MATH 20E,A03,084140,Staff,15,0,30,15
1649992407122,MATH 20E,A04,084141,Staff,20,0,30,10
1649992413183,MATH 102,A01,084143,Harel; Guershon,12,0,30,18
1649992413183,MATH 102,A02,084144,Harel; Guershon,20,0,30,10
1649992419216,MATH 103B,A01,083456,Staff,0,12,30,30
1649992419216,MATH 103B,A02,083457,Staff,0,12,30,30
1649992425254,MATH 109,A01,084146,Salehi Golsefidy; Alireza,18,0,30,12
1649992425254,MATH 109,A02,084147,Salehi Golsefidy; Alireza,17,0,30,13
1649992431278,MATH 120A,A01,085445,Eggers; John Dietrich,13,0,35,22
1649992431278,MATH 120A,A02,085446,Eggers; John Dietrich,27,0,35,8
1649992437305,MATH 142B,A01,084149,Verstraete; Jacques Allan,0,12,30,30
1649992437305,MATH 142B,A02,084150,Verstraete; Jacques Allan,0,12,30,30
1649992443329,MATH 170A,A01,083459,Nie; Jiawang,1,9,30,29
1649992443329,MATH 170A,A02,083460,Nie; Jiawang,0,6,30,30
1649992443329,MATH 170A,A03,083461,Nie; Jiawang,0,8,30,30
1649992449361,MATH 193B,A01,083463,Staff,1,0,30,29
1649992449361,MATH 193B,A02,083464,Staff,9,0,30,21
1649992449361,MATH 193B,A03,083465,Staff,18,0,30,12
1649992455488,COGS 2,A01,083966,Boyle; Mary E. T.,10,0,30,20
1649992461517,COGS 9,A01,083968,Staff,15,0,60,45
1649992467563,COGS 14B,A01,083970,Staff,11,0,50,39
1649992473598,COGS 17,A01,092679,Staff,53,0,75,22
1649992479642,COGS 100,A01,083972,Staff,0,15,60,60
1649992491715,COGS 101C,A01,083976,Staff,13,0,30,17
1649992497737,COGS 102A,A01,083978,Johnson; Christine M.,14,0,30,16
1649992503796,COGS 107B,A01,083980,Staff,0,7,50,50
1649992509825,COGS 115,A01,083982,Staff,11,0,30,19
1649992515883,COGS 118B,A01,083367,Staff,0,14,40,40
1649992521910,COGS 172,A01,083984,Provenzano; Emily Kara,15,0,30,15
1649992527936,COGS 177,A00,083368,Staff,0,20,30,30
1649992533981,COGS 186,A01,083986,Staff,21,0,40,19
1649992540014,COGS 187A,A01,083988,Boyle; Mary E. T.,19,0,60,41
1649992546064,CSE 8A,A50,084003,Miranda; Gregory Joseph,0,12,15,15
1649992552119,CSE 11,A01,084005,Miranda; Gregory Joseph,0,18,55,55
1649992558174,CSE 20,A01,084007,Staff,0,3,20,20
1649992564222,CSE 21,A01,084009,Staff,0,27,50,50
1649992570261,CSE 30,A01,083370,Cao; Yingjun,0,61,40,40
1649992576299,CSE 100,A01,083372,Cao; Yingjun,0,45,40,40
1649992582324,CSE 101,A01,084011,Staff,1,55,40,39
1649992588390,CSE 141,A01,083374,Eldon; John,0,62,75,75
1649992594431,CSE 141L,A01,083376,Eldon; John,0,68,75,75
1649992600474,CSE 175,A01,084013,Kumar; Rakesh,22,0,25,3
1649992606505,CSE 190,A00,092508,Dubnov; Shlomo,20,0,20,0
1649992612548,ECE 5,A01,084049,Morris; Karcher William,13,0,20,7
1649992618583,ECE 100,A01,084051,Baghdadchi; Saharnaz,0,0,20,20
1649992618583,ECE 100,A02,091916,Baghdadchi; Saharnaz,14,0,20,6
1649992624624,ECE 101,A01,084053,Baghdadchi; Saharnaz,1,0,37,36
1649992624624,ECE 101,A02,084054,Baghdadchi; Saharnaz,31,0,37,6
1649992630662,ECE 107,A01,083390,Staff,27,0,40,13
1649992636710,ECE 148,A01,084056,Silberman; Jack,8,0,12,4
1649992642738,ECE 180,A00,083391,Abi Samra; Nicholas Camill,25,0,30,5
1649992642738,ECE 180,B00,083392,Abi Samra; Nicholas Camill,21,0,30,9
1649992648774,MATH 10B,A01,084110,Staff,0,1,30,30
1649992648774,MATH 10B,A02,084111,Staff,21,0,30,9
1649992648774,MATH 10B,A03,084112,Staff,24,0,30,6
1649992654828,MATH 10C,A01,083443,Staff,1,13,30,29
1649992654828,MATH 10C,A02,083444,Staff,1,14,30,29
1649992654828,MATH 10C,B01,084114,Staff,20,0,30,10
1649992654828,MATH 10C,B02,084115,Staff,25,0,30,5
1649992660885,MATH 18,A01,084117,Harel; Guershon,16,0,30,14
1649992660885,MATH 18,A02,084119,Harel; Guershon,28,0,30,2
1649992660885,MATH 18,A03,084120,Harel; Guershon,29,0,30,1
1649992660885,MATH 18,A04,084121,Harel; Guershon,29,0,30,1
1649992666916,MATH 20B,A01,084124,Um; Ko Woon,18,0,35,17
1649992666916,MATH 20B,B01,084126,Um; Ko Woon,26,0,35,9
1649992672958,MATH 20C,A01,083446,Hammock; Frances H,0,0,30,30
1649992672958,MATH 20C,A02,083447,Hammock; Frances H,21,0,30,9
1649992672958,MATH 20C,A03,083448,Hammock; Frances H,24,0,30,6
1649992672958,MATH 20C,A04,083449,Hammock; Frances H,23,0,30,7
1649992672958,MATH 20C,B01,083451,Hammock; Frances H,2,0,30,28
1649992672958,MATH 20C,B02,083452,Hammock; Frances H,21,0,30,9
1649992672958,MATH 20C,B03,083453,Hammock; Frances H,23,0,30,7
1649992672958,MATH 20C,B04,083454,Hammock; Frances H,25,0,30,5
1649992678984,MATH 20D,A01,084128,Staff,15,0,30,15
1649992678984,MATH 20D,A02,084129,Staff,29,0,30,1
1649992678984,MATH 20D,A03,084130,Staff,27,0,30,3
1649992678984,MATH 20D,B01,084133,Staff,4,0,30,26
1649992678984,MATH 20D,B02,084134,Staff,24,0,30,6
1649992678984,MATH 20D,B03,084135,Staff,28,0,30,2
1649992685011,MATH 20E,A01,084138,Staff,14,0,30,16
1649992685011,MATH 20E,A02,084139,Staff,7,0,30,23
1649992685011,MATH 20E,A03,084140,Staff,15,0,30,15
1649992685011,MATH 20E,A04,084141,Staff,20,0,30,10
1649992691056,MATH 102,A01,084143,Harel; Guershon,12,0,30,18
1649992691056,MATH 102,A02,084144,Harel; Guershon,20,0,30,10
1649992697096,MATH 103B,A01,083456,Staff,0,12,30,30
1649992697096,MATH 103B,A02,083457,Staff,0,12,30,30
1649992703138,MATH 109,A01,084146,Salehi Golsefidy; Alireza,18,0,30,12
1649992703138,MATH 109,A02,084147,Salehi Golsefidy; Alireza,17,0,30,13
1649992709165,MATH 120A,A01,085445,Eggers; John Dietrich,13,0,35,22
1649992709165,MATH 120A,A02,085446,Eggers; John Dietrich,27,0,35,8
1649992715209,MATH 142B,A01,084149,Verstraete; Jacques Allan,0,12,30,30
1649992715209,MATH 142B,A02,084150,Verstraete; Jacques Allan,0,12,30,30
1649992721243,MATH 170A,A01,083459,Nie; Jiawang,1,9,30,29
1649992721243,MATH 170A,A02,083460,Nie; Jiawang,0,6,30,30
1649992721243,MATH 170A,A03,083461,Nie; Jiawang,0,8,30,30
1649992727285,MATH 193B,A01,083463,Staff,1,0,30,29
1649992727285,MATH 193B,A02,083464,Staff,9,0,30,21
1649992727285,MATH 193B,A03,083465,Staff,18,0,30,12
1649992733376,COGS 2,A01,083966,Boyle; Mary E. T.,10,0,30,20
1649992739402,COGS 9,A01,083968,Staff,15,0,60,45
1649992745438,COGS 14B,A01,083970,Staff,11,0,50,39
1649992751493,COGS 17,A01,092679,Staff,52,0,75,23
1649992757521,COGS 100,A01,083972,Staff,0,15,60,60
1649992769577,COGS 101C,A01,083976,Staff,13,0,30,17
1649992775605,COGS 102A,A01,083978,Johnson; Christine M.,14,0,30,16
1649992781653,COGS 107B,A01,083980,Staff,0,7,50,50
1649992787788,COGS 115,A01,083982,Staff,11,0,30,19
1649992793814,COGS 118B,A01,083367,Staff,0,14,40,40
1649992799836,COGS 172,A01,083984,Provenzano; Emily Kara,15,0,30,15
1649992805869,COGS 177,A00,083368,Staff,0,20,30,30
1649992811909,COGS 186,A01,083986,Staff,21,0,40,19
1649992817935,COGS 187A,A01,083988,Boyle; Mary E. T.,19,0,60,41
1649992823973,CSE 8A,A50,084003,Miranda; Gregory Joseph,0,12,15,15
1649992829995,CSE 11,A01,084005,Miranda; Gregory Joseph,0,19,55,55
1649992836055,CSE 20,A01,084007,Staff,0,3,20,20
1649992842099,CSE 21,A01,084009,Staff,0,27,50,50
1649992848134,CSE 30,A01,083370,Cao; Yingjun,0,61,40,40
1649992854164,CSE 100,A01,083372,Cao; Yingjun,0,45,40,40
1649992860199,CSE 101,A01,084011,Staff,1,55,40,39
1649992866220,CSE 141,A01,083374,Eldon; John,0,62,75,75
1649992872267,CSE 141L,A01,083376,Eldon; John,0,68,75,75
1649992878293,CSE 175,A01,084013,Kumar; Rakesh,22,0,25,3
1649992884337,CSE 190,A00,092508,Dubnov; Shlomo,20,0,20,0
1649992890377,ECE 5,A01,084049,Morris; Karcher William,13,0,20,7
1649992896400,ECE 100,A01,084051,Baghdadchi; Saharnaz,0,0,20,20
1649992896400,ECE 100,A02,091916,Baghdadchi; Saharnaz,14,0,20,6
1649992902439,ECE 101,A01,084053,Baghdadchi; Saharnaz,1,0,37,36
1649992902439,ECE 101,A02,084054,Baghdadchi; Saharnaz,31,0,37,6
1649992908482,ECE 107,A01,083390,Staff,27,0,40,13
1649992914504,ECE 148,A01,084056,Silberman; Jack,8,0,12,4
1649992920538,ECE 180,A00,083391,Abi Samra; Nicholas Camill,25,0,30,5
1649992920538,ECE 180,B00,083392,Abi Samra; Nicholas Camill,21,0,30,9
1649992926569,MATH 10B,A01,084110,Staff,0,1,30,30
1649992926569,MATH 10B,A02,084111,Staff,21,0,30,9
1649992926569,MATH 10B,A03,084112,Staff,24,0,30,6
1649992932604,MATH 10C,A01,083443,Staff,1,13,30,29
1649992932604,MATH 10C,A02,083444,Staff,1,14,30,29
1649992932604,MATH 10C,B01,084114,Staff,20,0,30,10
1649992932604,MATH 10C,B02,084115,Staff,25,0,30,5
1649992938647,MATH 18,A01,084117,Harel; Guershon,16,0,30,14
1649992938647,MATH 18,A02,084119,Harel; Guershon,28,0,30,2
1649992938647,MATH 18,A03,084120,Harel; Guershon,29,0,30,1
1649992938647,MATH 18,A04,084121,Harel; Guershon,29,0,30,1
1649992944688,MATH 20B,A01,084124,Um; Ko Woon,18,0,35,17
1649992944688,MATH 20B,B01,084126,Um; Ko Woon,26,0,35,9
1649992950723,MATH 20C,A01,083446,Hammock; Frances H,0,0,30,30
1649992950723,MATH 20C,A02,083447,Hammock; Frances H,21,0,30,9
1649992950723,MATH 20C,A03,083448,Hammock; Frances H,24,0,30,6
1649992950723,MATH 20C,A04,083449,Hammock; Frances H,23,0,30,7
1649992950723,MATH 20C,B01,083451,Hammock; Frances H,2,0,30,28
1649992950723,MATH 20C,B02,083452,Hammock; Frances H,21,0,30,9
1649992950723,MATH 20C,B03,083453,Hammock; Frances H,23,0,30,7
1649992950723,MATH 20C,B04,083454,Hammock; Frances H,25,0,30,5
1649992956764,MATH 20D,A01,084128,Staff,15,0,30,15
1649992956764,MATH 20D,A02,084129,Staff,29,0,30,1
1649992956764,MATH 20D,A03,084130,Staff,27,0,30,3
1649992956764,MATH 20D,B01,084133,Staff,4,0,30,26
1649992956764,MATH 20D,B02,084134,Staff,24,0,30,6
1649992956764,MATH 20D,B03,084135,Staff,28,0,30,2
1649992962816,MATH 20E,A01,084138,Staff,14,0,30,16
1649992962816,MATH 20E,A02,084139,Staff,7,0,30,23
1649992962816,MATH 20E,A03,084140,Staff,15,0,30,15
1649992962816,MATH 20E,A04,084141,Staff,20,0,30,10
1649992968840,MATH 102,A01,084143,Harel; Guershon,12,0,30,18
1649992968840,MATH 102,A02,084144,Harel; Guershon,20,0,30,10
1649992974864,MATH 103B,A01,083456,Staff,0,12,30,30
1649992974864,MATH 103B,A02,083457,Staff,0,12,30,30
1649992980896,MATH 109,A01,084146,Salehi Golsefidy; Alireza,18,0,30,12
1649992980896,MATH 109,A02,084147,Salehi Golsefidy; Alireza,17,0,30,13
1649992986930,MATH 120A,A01,085445,Eggers; John Dietrich,13,0,35,22
1649992986930,MATH 120A,A02,085446,Eggers; John Dietrich,27,0,35,8
1649992992978,MATH 142B,A01,084149,Verstraete; Jacques Allan,0,12,30,30
1649992992978,MATH 142B,A02,084150,Verstraete; Jacques Allan,0,12,30,30
1649992999017,MATH 170A,A01,083459,Nie; Jiawang,1,9,30,29
1649992999017,MATH 170A,A02,083460,Nie; Jiawang,0,6,30,30
1649992999017,MATH 170A,A03,083461,Nie; Jiawang,0,8,30,30
1649993005046,MATH 193B,A01,083463,Staff,1,0,30,29
1649993005046,MATH 193B,A02,083464,Staff,9,0,30,21
1649993005046,MATH 193B,A03,083465,Staff,18,0,30,12
1649993011103,COGS 2,A01,083966,Boyle; Mary E. T.,10,0,30,20
1649993017148,COGS 9,A01,083968,Staff,15,0,60,45
1649993023178,COGS 14B,A01,083970,Staff,11,0,50,39
1649993029224,COGS 17,A01,092679,Staff,52,0,75,23
1649993035253,COGS 100,A01,083972,Staff,0,15,60,60
1649993047314,COGS 101C,A01,083976,Staff,13,0,30,17
1649993053363,COGS 102A,A01,083978,Johnson; Christine M.,14,0,30,16
1649993059392,COGS 107B,A01,083980,Staff,0,7,50,50
1649993065426,COGS 115,A01,083982,Staff,11,0,30,19
1649993071468,COGS 118B,A01,083367,Staff,0,14,40,40
1649993077498,COGS 172,A01,083984,Provenzano; Emily Kara,15,0,30,15
1649993083525,COGS 177,A00,083368,Staff,0,20,30,30
1649993089548,COGS 186,A01,083986,Staff,21,0,40,19
1649993095604,COGS 187A,A01,083988,Boyle; Mary E. T.,19,0,60,41
1649993101628,CSE 8A,A50,084003,Miranda; Gregory Joseph,0,12,15,15
1649993107691,CSE 11,A01,084005,Miranda; Gregory Joseph,0,19,55,55
1649993113713,CSE 20,A01,084007,Staff,0,3,20,20
1649993119742,CSE 21,A01,084009,Staff,0,27,50,50
1649993125766,CSE 30,A01,083370,Cao; Yingjun,0,61,40,40
1649993131792,CSE 100,A01,083372,Cao; Yingjun,0,45,40,40
1649993137823,CSE 101,A01,084011,Staff,1,55,40,39
1649993143862,CSE 141,A01,083374,Eldon; John,0,62,75,75
1649993149909,CSE 141L,A01,083376,Eldon; John,0,68,75,75
1649993155932,CSE 175,A01,084013,Kumar; Rakesh,22,0,25,3
1649993161970,CSE 190,A00,092508,Dubnov; Shlomo,20,0,20,0
1649993167997,ECE 5,A01,084049,Morris; Karcher William,13,0,20,7
1649993174040,ECE 100,A01,084051,Baghdadchi; Saharnaz,0,0,20,20
1649993174040,ECE 100,A02,091916,Baghdadchi; Saharnaz,14,0,20,6
1649993180071,ECE 101,A01,084053,Baghdadchi; Saharnaz,1,0,37,36
1649993180071,ECE 101,A02,084054,Baghdadchi; Saharnaz,31,0,37,6
1649993186098,ECE 107,A01,083390,Staff,27,0,40,13
1649993192122,ECE 148,A01,084056,Silberman; Jack,8,0,12,4
1649993198146,ECE 180,A00,083391,Abi Samra; Nicholas Camill,25,0,30,5
1649993198146,ECE 180,B00,083392,Abi Samra; Nicholas Camill,21,0,30,9
1649993204197,MATH 10B,A01,084110,Staff,0,1,30,30
1649993204197,MATH 10B,A02,084111,Staff,21,0,30,9
1649993204197,MATH 10B,A03,084112,Staff,24,0,30,6
1649993210225,MATH 10C,A01,083443,Staff,1,13,30,29
1649993210225,MATH 10C,A02,083444,Staff,1,14,30,29
1649993210225,MATH 10C,B01,084114,Staff,19,0,30,11
1649993210225,MATH 10C,B02,084115,Staff,25,0,30,5
1649993216263,MATH 18,A01,084117,Harel; Guershon,16,0,30,14
1649993216263,MATH 18,A02,084119,Harel; Guershon,28,0,30,2
1649993216263,MATH 18,A03,084120,Harel; Guershon,29,0,30,1
1649993216263,MATH 18,A04,084121,Harel; Guershon,29,0,30,1
1649993222300,MATH 20B,A01,084124,Um; Ko Woon,17,0,35,18
1649993222300,MATH 20B,B01,084126,Um; Ko Woon,26,0,35,9
1649993228334,MATH 20C,A01,083446,Hammock; Frances H,0,0,30,30
1649993228334,MATH 20C,A02,083447,Hammock; Frances H,21,0,30,9
1649993228334,MATH 20C,A03,083448,Hammock; Frances H,23,0,30,7
1649993228334,MATH 20C,A04,083449,Hammock; Frances H,23,0,30,7
1649993228334,MATH 20C,B01,083451,Hammock; Frances H,2,0,30,28
1649993228334,MATH 20C,B02,083452,Hammock; Frances H,21,0,30,9
1649993228334,MATH 20C,B03,083453,Hammock; Frances H,23,0,30,7
1649993228334,MATH 20C,B04,083454,Hammock; Frances H,25,0,30,5
1649993234359,MATH 20D,A01,084128,Staff,14,0,30,16
1649993234359,MATH 20D,A02,084129,Staff,29,0,30,1
1649993234359,MATH 20D,A03,084130,Staff,27,0,30,3
1649993234359,MATH 20D,B01,084133,Staff,4,0,30,26
1649993234359,MATH 20D,B02,084134,Staff,24,0,30,6
1649993234359,MATH 20D,B03,084135,Staff,28,0,30,2
1649993240398,MATH 20E,A01,084138,Staff,14,0,30,16
1649993240398,MATH 20E,A02,084139,Staff,7,0,30,23
1649993240398,MATH 20E,A03,084140,Staff,15,0,30,15
1649993240398,MATH 20E,A04,084141,Staff,20,0,30,10
1649993246441,MATH 102,A01,084143,Harel; Guershon,12,0,30,18
1649993246441,MATH 102,A02,084144,Harel; Guershon,20,0,30,10
1649993252491,MATH 103B,A01,083456,Staff,0,12,30,30
1649993252491,MATH 103B,A02,083457,Staff,0,12,30,30
1649993258525,MATH 109,A01,084146,Salehi Golsefidy; Alireza,18,0,30,12
1649993258525,MATH 109,A02,084147,Salehi Golsefidy; Alireza,17,0,30,13
1649993264560,MATH 120A,A01,085445,Eggers; John Dietrich,13,0,35,22
1649993264560,MATH 120A,A02,085446,Eggers; John Dietrich,27,0,35,8
1649993270603,MATH 142B,A01,084149,Verstraete; Jacques Allan,0,12,30,30
1649993270603,MATH 142B,A02,084150,Verstraete; Jacques Allan,0,12,30,30
1649993276627,MATH 170A,A01,083459,Nie; Jiawang,1,9,30,29
1649993276627,MATH 170A,A02,083460,Nie; Jiawang,0,6,30,30
1649993276627,MATH 170A,A03,083461,Nie; Jiawang,0,8,30,30
1649993282655,MATH 193B,A01,083463,Staff,1,0,30,29
1649993282655,MATH 193B,A02,083464,Staff,9,0,30,21
1649993282655,MATH 193B,A03,083465,Staff,18,0,30,12
1649993288746,COGS 2,A01,083966,Boyle; Mary E. T.,10,0,30,20
1649993294802,COGS 9,A01,083968,Staff,15,0,60,45
1649993300854,COGS 14B,A01,083970,Staff,11,0,50,39
1649993306875,COGS 17,A01,092679,Staff,52,0,75,23
1649993312898,COGS 100,A01,083972,Staff,0,15,60,60
1649993324980,COGS 101C,A01,083976,Staff,13,0,30,17
1649993331027,COGS 102A,A01,083978,Johnson; Christine M.,14,0,30,16
1649993337050,COGS 107B,A01,083980,Staff,0,7,50,50
1649993343079,COGS 115,A01,083982,Staff,11,0,30,19
1649993349102,COGS 118B,A01,083367,Staff,0,14,40,40
1649993355124,COGS 172,A01,083984,Provenzano; Emily Kara,15,0,30,15
1649993361161,COGS 177,A00,083368,Staff,0,20,30,30
1649993367182,COGS 186,A01,083986,Staff,21,0,40,19
1649993373216,COGS 187A,A01,083988,Boyle; Mary E. T.,19,0,60,41
1649993379259,CSE 8A,A50,084003,Miranda; Gregory Joseph,0,12,15,15
1649993385377,CSE 11,A01,084005,Miranda; Gregory Joseph,0,19,55,55
1649993391405,CSE 20,A01,084007,Staff,0,3,20,20
1649993397453,CSE 21,A01,084009,Staff,0,27,50,50
1649993403478,CSE 30,A01,083370,Cao; Yingjun,0,61,40,40
1649993409503,CSE 100,A01,083372,Cao; Yingjun,0,45,40,40
1649993415534,CSE 101,A01,084011,Staff,1,55,40,39
1649993421562,CSE 141,A01,083374,Eldon; John,0,62,75,75
1649993427612,CSE 141L,A01,083376,Eldon; John,0,68,75,75
1649993433639,CSE 175,A01,084013,Kumar; Rakesh,22,0,25,3
1649993439667,CSE 190,A00,092508,Dubnov; Shlomo,20,0,20,0
1649993445693,ECE 5,A01,084049,Morris; Karcher William,13,0,20,7
1649993451722,ECE 100,A01,084051,Baghdadchi; Saharnaz,0,0,20,20
1649993451722,ECE 100,A02,091916,Baghdadchi; Saharnaz,14,0,20,6
1649993457757,ECE 101,A01,084053,Baghdadchi; Saharnaz,1,0,37,36
1649993457757,ECE 101,A02,084054,Baghdadchi; Saharnaz,31,0,37,6
1649993463781,ECE 107,A01,083390,Staff,27,0,40,13
1649993469814,ECE 148,A01,084056,Silberman; Jack,8,0,12,4
1649993475842,ECE 180,A00,083391,Abi Samra; Nicholas Camill,25,0,30,5
1649993475842,ECE 180,B00,083392,Abi Samra; Nicholas Camill,21,0,30,9
1649993481869,MATH 10B,A01,084110,Staff,0,1,30,30
1649993481869,MATH 10B,A02,084111,Staff,21,0,30,9
1649993481869,MATH 10B,A03,084112,Staff,24,0,30,6
1649993487914,MATH 10C,A01,083443,Staff,1,13,30,29
1649993487914,MATH 10C,A02,083444,Staff,1,14,30,29
1649993487914,MATH 10C,B01,084114,Staff,19,0,30,11
1649993487914,MATH 10C,B02,084115,Staff,25,0,30,5
1649993493963,MATH 18,A01,084117,Harel; Guershon,16,0,30,14
1649993493963,MATH 18,A02,084119,Harel; Guershon,28,0,30,2
1649993493963,MATH 18,A03,084120,Harel; Guershon,29,0,30,1
1649993493963,MATH 18,A04,084121,Harel; Guershon,29,0,30,1
1649993499991,MATH 20B,A01,084124,Um; Ko Woon,17,0,35,18
1649993499991,MATH 20B,B01,084126,Um; Ko Woon,26,0,35,9
1649993506038,MATH 20C,A01,083446,Hammock; Frances H,0,0,30,30
1649993506038,MATH 20C,A02,083447,Hammock; Frances H,21,0,30,9
1649993506038,MATH 20C,A03,083448,Hammock; Frances H,23,0,30,7
1649993506038,MATH 20C,A04,083449,Hammock; Frances H,23,0,30,7
1649993506038,MATH 20C,B01,083451,Hammock; Frances H,1,0,30,29
1649993506038,MATH 20C,B02,083452,Hammock; Frances H,21,0,30,9
1649993506038,MATH 20C,B03,083453,Hammock; Frances H,23,0,30,7
1649993506038,MATH 20C,B04,083454,Hammock; Frances H,25,0,30,5
1649993512076,MATH 20D,A01,084128,Staff,14,0,30,16
1649993512076,MATH 20D,A02,084129,Staff,29,0,30,1
1649993512076,MATH 20D,A03,084130,Staff,27,0,30,3
1649993512076,MATH 20D,B01,084133,Staff,4,0,30,26
1649993512076,MATH 20D,B02,084134,Staff,24,0,30,6
1649993512076,MATH 20D,B03,084135,Staff,28,0,30,2
1649993518101,MATH 20E,A01,084138,Staff,14,0,30,16
1649993518101,MATH 20E,A02,084139,Staff,7,0,30,23
1649993518101,MATH 20E,A03,084140,Staff,15,0,30,15
1649993518101,MATH 20E,A04,084141,Staff,20,0,30,10
1649993524141,MATH 102,A01,084143,Harel; Guershon,12,0,30,18
1649993524141,MATH 102,A02,084144,Harel; Guershon,20,0,30,10
1649993530168,MATH 103B,A01,083456,Staff,0,12,30,30
1649993530168,MATH 103B,A02,083457,Staff,0,12,30,30
1649993536208,MATH 109,A01,084146,Salehi Golsefidy; Alireza,18,0,30,12
1649993536208,MATH 109,A02,084147,Salehi Golsefidy; Alireza,16,0,30,14
1649993542237,MATH 120A,A01,085445,Eggers; John Dietrich,13,0,35,22
1649993542237,MATH 120A,A02,085446,Eggers; John Dietrich,27,0,35,8
1649993548272,MATH 142B,A01,084149,Verstraete; Jacques Allan,0,12,30,30
1649993548272,MATH 142B,A02,084150,Verstraete; Jacques Allan,0,12,30,30
1649993554326,MATH 170A,A01,083459,Nie; Jiawang,1,9,30,29
1649993554326,MATH 170A,A02,083460,Nie; Jiawang,0,6,30,30
1649993554326,MATH 170A,A03,083461,Nie; Jiawang,0,8,30,30
1649993560374,MATH 193B,A01,083463,Staff,1,0,30,29
1649993560374,MATH 193B,A02,083464,Staff,9,0,30,21
1649993560374,MATH 193B,A03,083465,Staff,18,0,30,12
1649993566433,COGS 2,A01,083966,Boyle; Mary E. T.,10,0,30,20
1649993572481,COGS 9,A01,083968,Staff,15,0,60,45
1649993578511,COGS 14B,A01,083970,Staff,11,0,50,39
1649993584557,COGS 17,A01,092679,Staff,52,0,75,23
1649993590592,COGS 100,A01,083972,Staff,0,15,60,60
1649993602657,COGS 101C,A01,083976,Staff,13,0,30,17
1649993608712,COGS 102A,A01,083978,Johnson; Christine M.,14,0,30,16
1649993614734,COGS 107B,A01,083980,Staff,0,7,50,50
1649993620757,COGS 115,A01,083982,Staff,11,0,30,19
1649993626780,COGS 118B,A01,083367,Staff,0,14,40,40
1649993632803,COGS 172,A01,083984,Provenzano; Emily Kara,15,0,30,15
1649993638835,COGS 177,A00,083368,Staff,0,20,30,30
1649993644882,COGS 186,A01,083986,Staff,21,0,40,19
1649993650909,COGS 187A,A01,083988,Boyle; Mary E. T.,19,0,60,41
1649993656944,CSE 8A,A50,084003,Miranda; Gregory Joseph,0,12,15,15
1649993662992,CSE 11,A01,084005,Miranda; Gregory Joseph,0,19,55,55
1649993669021,CSE 20,A01,084007,Staff,0,3,20,20
1649993675054,CSE 21,A01,084009,Staff,0,27,50,50
1649993681085,CSE 30,A01,083370,Cao; Yingjun,0,61,40,40
1649993687131,CSE 100,A01,083372,Cao; Yingjun,0,45,40,40
1649993693161,CSE 101,A01,084011,Staff,1,55,40,39
1649993699193,CSE 141,A01,083374,Eldon; John,0,63,75,75
1649993705216,CSE 141L,A01,083376,Eldon; John,0,69,75,75
1649993711255,CSE 175,A01,084013,Kumar; Rakesh,22,0,25,3
1649993717290,CSE 190,A00,092508,Dubnov; Shlomo,20,0,20,0
1649993723319,ECE 5,A01,084049,Morris; Karcher William,13,0,20,7
1649993729343,ECE 100,A01,084051,Baghdadchi; Saharnaz,0,0,20,20
1649993729343,ECE 100,A02,091916,Baghdadchi; Saharnaz,14,0,20,6
1649993735403,ECE 101,A01,084053,Baghdadchi; Saharnaz,1,0,37,36
1649993735403,ECE 101,A02,084054,Baghdadchi; Saharnaz,31,0,37,6
1649993741434,ECE 107,A01,083390,Staff,27,0,40,13
1649993747488,ECE 148,A01,084056,Silberman; Jack,8,0,12,4
1649993753514,ECE 180,A00,083391,Abi Samra; Nicholas Camill,25,0,30,5
1649993753514,ECE 180,B00,083392,Abi Samra; Nicholas Camill,21,0,30,9
1649993759543,MATH 10B,A01,084110,Staff,0,0,30,30
1649993759543,MATH 10B,A02,084111,Staff,20,0,30,10
1649993759543,MATH 10B,A03,084112,Staff,24,0,30,6
1649993765579,MATH 10C,A01,083443,Staff,1,13,30,29
1649993765579,MATH 10C,A02,083444,Staff,1,14,30,29
1649993765579,MATH 10C,B01,084114,Staff,19,0,30,11
1649993765579,MATH 10C,B02,084115,Staff,25,0,30,5
1649993771605,MATH 18,A01,084117,Harel; Guershon,16,0,30,14
1649993771605,MATH 18,A02,084119,Harel; Guershon,28,0,30,2
1649993771605,MATH 18,A03,084120,Harel; Guershon,29,0,30,1
1649993771605,MATH 18,A04,084121,Harel; Guershon,29,0,30,1
1649993777647,MATH 20B,A01,084124,Um; Ko Woon,17,0,35,18
1649993777647,MATH 20B,B01,084126,Um; Ko Woon,26,0,35,9
1649993783685,MATH 20C,A01,083446,Hammock; Frances H,0,0,30,30
1649993783685,MATH 20C,A02,083447,Hammock; Frances H,21,0,30,9
1649993783685,MATH 20C,A03,083448,Hammock; Frances H,23,0,30,7
1649993783685,MATH 20C,A04,083449,Hammock; Frances H,23,0,30,7
1649993783685,MATH 20C,B01,083451,Hammock; Frances H,1,0,30,29
1649993783685,MATH 20C,B02,083452,Hammock; Frances H,21,0,30,9
1649993783685,MATH 20C,B03,083453,Hammock; Frances H,23,0,30,7
1649993783685,MATH 20C,B04,083454,Hammock; Frances H,25,0,30,5
1649993789714,MATH 20D,A01,084128,Staff,14,0,30,16
1649993789714,MATH 20D,A02,084129,Staff,29,0,30,1
1649993789714,MATH 20D,A03,084130,Staff,27,0,30,3
1649993789714,MATH 20D,B01,084133,Staff,4,0,30,26
1649993789714,MATH 20D,B02,084134,Staff,24,0,30,6
1649993789714,MATH 20D,B03,084135,Staff,28,0,30,2
1649993795746,MATH 20E,A01,084138,Staff,14,0,30,16
1649993795746,MATH 20E,A02,084139,Staff,7,0,30,23
1649993795746,MATH 20E,A03,084140,Staff,15,0,30,15
1649993795746,MATH 20E,A04,084141,Staff,20,0,30,10
1649993801793,MATH 102,A01,084143,Harel; Guershon,12,0,30,18
1649993801793,MATH 102,A02,084144,Harel; Guershon,20,0,30,10
1649993807839,MATH 103B,A01,083456,Staff,0,12,30,30
1649993807839,MATH 103B,A02,083457,Staff,0,12,30,30
1649993813896,MATH 109,A01,084146,Salehi Golsefidy; Alireza,18,0,30,12
1649993813896,MATH 109,A02,084147,Salehi Golsefidy; Alireza,16,0,30,14
1649993819924,MATH 120A,A01,085445,Eggers; John Dietrich,13,0,35,22
1649993819924,MATH 120A,A02,085446,Eggers; John Dietrich,27,0,35,8
1649993825961,MATH 142B,A01,084149,Verstraete; Jacques Allan,0,12,30,30
1649993825961,MATH 142B,A02,084150,Verstraete; Jacques Allan,0,12,30,30
1649993831984,MATH 170A,A01,083459,Nie; Jiawang,1,9,30,29
1649993831984,MATH 170A,A02,083460,Nie; Jiawang,0,6,30,30
1649993831984,MATH 170A,A03,083461,Nie; Jiawang,0,8,30,30
1649993838018,MATH 193B,A01,083463,Staff,1,0,30,29
1649993838018,MATH 193B,A02,083464,Staff,9,0,30,21
1649993838018,MATH 193B,A03,083465,Staff,18,0,30,12
1649993844118,COGS 2,A01,083966,Boyle; Mary E. T.,10,0,30,20
1649993850156,COGS 9,A01,083968,Staff,15,0,60,45
1649993856182,COGS 14B,A01,083970,Staff,11,0,50,39
1649993862206,COGS 17,A01,092679,Staff,52,0,75,23
1649993868257,COGS 100,A01,083972,Staff,0,15,60,60
1649993880303,COGS 101C,A01,083976,Staff,13,0,30,17
1649993886339,COGS 102A,A01,083978,Johnson; Christine M.,14,0,30,16
1649993892366,COGS 107B,A01,083980,Staff,0,7,50,50
1649993898402,COGS 115,A01,083982,Staff,11,0,30,19
1649993904425,COGS 118B,A01,083367,Staff,0,14,40,40
1649993910475,COGS 172,A01,083984,Provenzano; Emily Kara,15,0,30,15
1649993916501,COGS 177,A00,083368,Staff,0,20,30,30
1649993922539,COGS 186,A01,083986,Staff,21,0,40,19
1649993928572,COGS 187A,A01,083988,Boyle; Mary E. T.,19,0,60,41
1649993934628,CSE 8A,A50,084003,Miranda; Gregory Joseph,0,12,15,15
1649993940653,CSE 11,A01,084005,Miranda; Gregory Joseph,0,19,55,55
1649993946683,CSE 20,A01,084007,Staff,0,3,20,20
1649993952713,CSE 21,A01,084009,Staff,0,27,50,50
1649993958735,CSE 30,A01,083370,Cao; Yingjun,0,61,40,40
1649993964779,CSE 100,A01,083372,Cao; Yingjun,0,45,40,40
1649993970825,CSE 101,A01,084011,Staff,1,55,40,39
1649993976948,CSE 141,A01,083374,Eldon; John,0,63,75,75
1649993983002,CSE 141L,A01,083376,Eldon; John,0,69,75,75
1649993989041,CSE 175,A01,084013,Kumar; Rakesh,22,0,25,3
1649993995072,CSE 190,A00,092508,Dubnov; Shlomo,20,0,20,0
1649994001125,ECE 5,A01,084049,Morris; Karcher William,13,0,20,7
1649994007177,ECE 100,A01,084051,Baghdadchi; Saharnaz,0,0,20,20
1649994007177,ECE 100,A02,091916,Baghdadchi; Saharnaz,14,0,20,6
1649994013225,ECE 101,A01,084053,Baghdadchi; Saharnaz,1,0,37,36
1649994013225,ECE 101,A02,084054,Baghdadchi; Saharnaz,31,0,37,6
1649994019266,ECE 107,A01,083390,Staff,27,0,40,13
1649994025300,ECE 148,A01,084056,Silberman; Jack,8,0,12,4
1649994031351,ECE 180,A00,083391,Abi Samra; Nicholas Camill,25,0,30,5
1649994031351,ECE 180,B00,083392,Abi Samra; Nicholas Camill,21,0,30,9
1649994037378,MATH 10B,A01,084110,Staff,0,0,30,30
1649994037378,MATH 10B,A02,084111,Staff,20,0,30,10
1649994037378,MATH 10B,A03,084112,Staff,24,0,30,6
1649994043401,MATH 10C,A01,083443,Staff,1,13,30,29
1649994043401,MATH 10C,A02,083444,Staff,1,14,30,29
1649994043401,MATH 10C,B01,084114,Staff,19,0,30,11
1649994043401,MATH 10C,B02,084115,Staff,25,0,30,5
1649994049459,MATH 18,A01,084117,Harel; Guershon,16,0,30,14
1649994049459,MATH 18,A02,084119,Harel; Guershon,28,0,30,2
1649994049459,MATH 18,A03,084120,Harel; Guershon,29,0,30,1
1649994049459,MATH 18,A04,084121,Harel; Guershon,29,0,30,1
1649994055484,MATH 20B,A01,084124,Um; Ko Woon,17,0,35,18
1649994055484,MATH 20B,B01,084126,Um; Ko Woon,26,0,35,9
1649994061529,MATH 20C,A01,083446,Hammock; Frances H,0,0,30,30
1649994061529,MATH 20C,A02,083447,Hammock; Frances H,20,0,30,10
1649994061529,MATH 20C,A03,083448,Hammock; Frances H,23,0,30,7
1649994061529,MATH 20C,A04,083449,Hammock; Frances H,23,0,30,7
1649994061529,MATH 20C,B01,083451,Hammock; Frances H,1,0,30,29
1649994061529,MATH 20C,B02,083452,Hammock; Frances H,21,0,30,9
1649994061529,MATH 20C,B03,083453,Hammock; Frances H,23,0,30,7
1649994061529,MATH 20C,B04,083454,Hammock; Frances H,25,0,30,5
1649994067572,MATH 20D,A01,084128,Staff,14,0,30,16
1649994067572,MATH 20D,A02,084129,Staff,29,0,30,1
1649994067572,MATH 20D,A03,084130,Staff,27,0,30,3
1649994067572,MATH 20D,B01,084133,Staff,4,0,30,26
1649994067572,MATH 20D,B02,084134,Staff,24,0,30,6
1649994067572,MATH 20D,B03,084135,Staff,28,0,30,2
1649994073611,MATH 20E,A01,084138,Staff,14,0,30,16
1649994073611,MATH 20E,A02,084139,Staff,7,0,30,23
1649994073611,MATH 20E,A03,084140,Staff,15,0,30,15
1649994073611,MATH 20E,A04,084141,Staff,20,0,30,10
1649994079660,MATH 102,A01,084143,Harel; Guershon,12,0,30,18
1649994079660,MATH 102,A02,084144,Harel; Guershon,20,0,30,10
1649994085682,MATH 103B,A01,083456,Staff,0,12,30,30
1649994085682,MATH 103B,A02,083457,Staff,0,12,30,30
1649994091733,MATH 109,A01,084146,Salehi Golsefidy; Alireza,18,0,30,12
1649994091733,MATH 109,A02,084147,Salehi Golsefidy; Alireza,16,0,30,14
1649994097755,MATH 120A,A01,085445,Eggers; John Dietrich,13,0,35,22
1649994097755,MATH 120A,A02,085446,Eggers; John Dietrich,27,0,35,8
1649994103777,MATH 142B,A01,084149,Verstraete; Jacques Allan,0,12,30,30
1649994103777,MATH 142B,A02,084150,Verstraete; Jacques Allan,0,12,30,30
1649994109825,MATH 170A,A01,083459,Nie; Jiawang,1,9,30,29
1649994109825,MATH 170A,A02,083460,Nie; Jiawang,0,6,30,30
1649994109825,MATH 170A,A03,083461,Nie; Jiawang,0,8,30,30
1649994115847,MATH 193B,A01,083463,Staff,1,0,30,29
1649994115847,MATH 193B,A02,083464,Staff,9,0,30,21
1649994115847,MATH 193B,A03,083465,Staff,18,0,30,12
1649994121933,COGS 2,A01,083966,Boyle; Mary E. T.,10,0,30,20
1649994127959,COGS 9,A01,083968,Staff,15,0,60,45
1649994134002,COGS 14B,A01,083970,Staff,11,0,50,39
1649994140033,COGS 17,A01,092679,Staff,52,0,75,23
1649994146072,COGS 100,A01,083972,Staff,0,15,60,60
1649994158118,COGS 101C,A01,083976,Staff,13,0,30,17
1649994164144,COGS 102A,A01,083978,Johnson; Christine M.,14,0,30,16
1649994170167,COGS 107B,A01,083980,Staff,0,7,50,50
1649994176194,COGS 115,A01,083982,Staff,11,0,30,19
1649994182228,COGS 118B,A01,083367,Staff,0,14,40,40
1649994188251,COGS 172,A01,083984,Provenzano; Emily Kara,15,0,30,15
1649994194274,COGS 177,A00,083368,Staff,0,20,30,30
1649994200318,COGS 186,A01,083986,Staff,21,0,40,19
1649994206356,COGS 187A,A01,083988,Boyle; Mary E. T.,19,0,60,41
1649994212399,CSE 8A,A50,084003,Miranda; Gregory Joseph,0,12,15,15
1649994218445,CSE 11,A01,084005,Miranda; Gregory Joseph,0,19,55,55
1649994224479,CSE 20,A01,084007,Staff,0,3,20,20
1649994230524,CSE 21,A01,084009,Staff,0,27,50,50
1649994236575,CSE 30,A01,083370,Cao; Yingjun,0,61,40,40
1649994242608,CSE 100,A01,083372,Cao; Yingjun,0,45,40,40
1649994248630,CSE 101,A01,084011,Staff,1,55,40,39
1649994254662,CSE 141,A01,083374,Eldon; John,0,63,75,75
1649994260685,CSE 141L,A01,083376,Eldon; John,0,69,75,75
1649994266721,CSE 175,A01,084013,Kumar; Rakesh,22,0,25,3
1649994272762,CSE 190,A00,092508,Dubnov; Shlomo,20,0,20,0
1649994278785,ECE 5,A01,084049,Morris; Karcher William,13,0,20,7
1649994284829,ECE 100,A01,084051,Baghdadchi; Saharnaz,0,0,20,20
1649994284829,ECE 100,A02,091916,Baghdadchi; Saharnaz,14,0,20,6
1649994290851,ECE 101,A01,084053,Baghdadchi; Saharnaz,1,0,37,36
1649994290851,ECE 101,A02,084054,Baghdadchi; Saharnaz,31,0,37,6
1649994296882,ECE 107,A01,083390,Staff,27,0,40,13
1649994302905,ECE 148,A01,084056,Silberman; Jack,8,0,12,4
1649994308939,ECE 180,A00,083391,Abi Samra; Nicholas Camill,25,0,30,5
1649994308939,ECE 180,B00,083392,Abi Samra; Nicholas Camill,21,0,30,9
1649994314967,MATH 10B,A01,084110,Staff,0,0,30,30
1649994314967,MATH 10B,A02,084111,Staff,20,0,30,10
1649994314967,MATH 10B,A03,084112,Staff,24,0,30,6
1649994321012,MATH 10C,A01,083443,Staff,1,13,30,29
1649994321012,MATH 10C,A02,083444,Staff,1,14,30,29
1649994321012,MATH 10C,B01,084114,Staff,19,0,30,11
1649994321012,MATH 10C,B02,084115,Staff,25,0,30,5
1649994327034,MATH 18,A01,084117,Harel; Guershon,16,0,30,14
1649994327034,MATH 18,A02,084119,Harel; Guershon,28,0,30,2
1649994327034,MATH 18,A03,084120,Harel; Guershon,29,0,30,1
1649994327034,MATH 18,A04,084121,Harel; Guershon,29,0,30,1
1649994333094,MATH 20B,A01,084124,Um; Ko Woon,17,0,35,18
1649994333094,MATH 20B,B01,084126,Um; Ko Woon,26,0,35,9
1649994339127,MATH 20C,A01,083446,Hammock; Frances H,0,0,30,30
1649994339127,MATH 20C,A02,083447,Hammock; Frances H,20,0,30,10
1649994339127,MATH 20C,A03,083448,Hammock; Frances H,23,0,30,7
1649994339127,MATH 20C,A04,083449,Hammock; Frances H,23,0,30,7
1649994339127,MATH 20C,B01,083451,Hammock; Frances H,1,0,30,29
1649994339127,MATH 20C,B02,083452,Hammock; Frances H,21,0,30,9
1649994339127,MATH 20C,B03,083453,Hammock; Frances H,23,0,30,7
1649994339127,MATH 20C,B04,083454,Hammock; Frances H,25,0,30,5
1649994345160,MATH 20D,A01,084128,Staff,14,0,30,16
1649994345160,MATH 20D,A02,084129,Staff,29,0,30,1
1649994345160,MATH 20D,A03,084130,Staff,27,0,30,3
1649994345160,MATH 20D,B01,084133,Staff,4,0,30,26
1649994345160,MATH 20D,B02,084134,Staff,24,0,30,6
1649994345160,MATH 20D,B03,084135,Staff,28,0,30,2
1649994351207,MATH 20E,A01,084138,Staff,14,0,30,16
1649994351207,MATH 20E,A02,084139,Staff,7,0,30,23
1649994351207,MATH 20E,A03,084140,Staff,15,0,30,15
1649994351207,MATH 20E,A04,084141,Staff,20,0,30,10
1649994357232,MATH 102,A01,084143,Harel; Guershon,12,0,30,18
1649994357232,MATH 102,A02,084144,Harel; Guershon,20,0,30,10
1649994363273,MATH 103B,A01,083456,Staff,0,12,30,30
1649994363273,MATH 103B,A02,083457,Staff,0,12,30,30
1649994369319,MATH 109,A01,084146,Salehi Golsefidy; Alireza,18,0,30,12
1649994369319,MATH 109,A02,084147,Salehi Golsefidy; Alireza,16,0,30,14
1649994375354,MATH 120A,A01,085445,Eggers; John Dietrich,13,0,35,22
1649994375354,MATH 120A,A02,085446,Eggers; John Dietrich,27,0,35,8
1649994381391,MATH 142B,A01,084149,Verstraete; Jacques Allan,0,12,30,30
1649994381391,MATH 142B,A02,084150,Verstraete; Jacques Allan,0,12,30,30
1649994387435,MATH 170A,A01,083459,Nie; Jiawang,1,9,30,29
1649994387435,MATH 170A,A02,083460,Nie; Jiawang,0,6,30,30
1649994387435,MATH 170A,A03,083461,Nie; Jiawang,0,9,30,30
1649994393461,MATH 193B,A01,083463,Staff,1,0,30,29
1649994393461,MATH 193B,A02,083464,Staff,9,0,30,21
1649994393461,MATH 193B,A03,083465,Staff,18,0,30,12
1649994399547,COGS 2,A01,083966,Boyle; Mary E. T.,10,0,30,20
1649994405570,COGS 9,A01,083968,Staff,15,0,60,45
1649994411593,COGS 14B,A01,083970,Staff,11,0,50,39
1649994417614,COGS 17,A01,092679,Staff,52,0,75,23
1649994423652,COGS 100,A01,083972,Staff,0,15,60,60
1649994435714,COGS 101C,A01,083976,Staff,13,0,30,17
1649994441746,COGS 102A,A01,083978,Johnson; Christine M.,14,0,30,16
1649994447768,COGS 107B,A01,083980,Staff,0,7,50,50
1649994453791,COGS 115,A01,083982,Staff,11,0,30,19
1649994459815,COGS 118B,A01,083367,Staff,0,14,40,40
1649994465870,COGS 172,A01,083984,Provenzano; Emily Kara,15,0,30,15
1649994471905,COGS 177,A00,083368,Staff,0,20,30,30
1649994477929,COGS 186,A01,083986,Staff,21,0,40,19
1649994483954,COGS 187A,A01,083988,Boyle; Mary E. T.,19,0,60,41
1649994489976,CSE 8A,A50,084003,Miranda; Gregory Joseph,0,12,15,15
1649994496103,CSE 11,A01,084005,Miranda; Gregory Joseph,0,19,55,55
1649994502153,CSE 20,A01,084007,Staff,0,3,20,20
1649994508176,CSE 21,A01,084009,Staff,0,27,50,50
1649994514203,CSE 30,A01,083370,Cao; Yingjun,0,62,40,40
1649994520225,CSE 100,A01,083372,Cao; Yingjun,0,45,40,40
1649994526260,CSE 101,A01,084011,Staff,1,55,40,39
1649994532288,CSE 141,A01,083374,Eldon; John,0,63,75,75
1649994538329,CSE 141L,A01,083376,Eldon; John,0,69,75,75
1649994544352,CSE 175,A01,084013,Kumar; Rakesh,22,0,25,3
1649994550397,CSE 190,A00,092508,Dubnov; Shlomo,20,0,20,0
1649994556436,ECE 5,A01,084049,Morris; Karcher William,13,0,20,7
1649994562465,ECE 100,A01,084051,Baghdadchi; Saharnaz,0,0,20,20
1649994562465,ECE 100,A02,091916,Baghdadchi; Saharnaz,14,0,20,6
1649994568504,ECE 101,A01,084053,Baghdadchi; Saharnaz,1,0,37,36
1649994568504,ECE 101,A02,084054,Baghdadchi; Saharnaz,31,0,37,6
1649994574627,ECE 107,A01,083390,Staff,27,0,40,13
1649994580650,ECE 148,A01,084056,Silberman; Jack,8,0,12,4
1649994586677,ECE 180,A00,083391,Abi Samra; Nicholas Camill,25,0,30,5
1649994586677,ECE 180,B00,083392,Abi Samra; Nicholas Camill,21,0,30,9
1649994592704,MATH 10B,A01,084110,Staff,0,0,30,30
1649994592704,MATH 10B,A02,084111,Staff,20,0,30,10
1649994592704,MATH 10B,A03,084112,Staff,24,0,30,6
1649994598752,MATH 10C,A01,083443,Staff,1,13,30,29
1649994598752,MATH 10C,A02,083444,Staff,1,14,30,29
1649994598752,MATH 10C,B01,084114,Staff,19,0,30,11
1649994598752,MATH 10C,B02,084115,Staff,25,0,30,5
1649994604801,MATH 18,A01,084117,Harel; Guershon,16,0,30,14
1649994604801,MATH 18,A02,084119,Harel; Guershon,28,0,30,2
1649994604801,MATH 18,A03,084120,Harel; Guershon,29,0,30,1
1649994604801,MATH 18,A04,084121,Harel; Guershon,29,0,30,1
1649994610827,MATH 20B,A01,084124,Um; Ko Woon,16,0,35,19
1649994610827,MATH 20B,B01,084126,Um; Ko Woon,26,0,35,9
1649994616860,MATH 20C,A01,083446,Hammock; Frances H,0,0,30,30
1649994616860,MATH 20C,A02,083447,Hammock; Frances H,20,0,30,10
1649994616860,MATH 20C,A03,083448,Hammock; Frances H,23,0,30,7
1649994616860,MATH 20C,A04,083449,Hammock; Frances H,23,0,30,7
1649994616860,MATH 20C,B01,083451,Hammock; Frances H,1,0,30,29
1649994616860,MATH 20C,B02,083452,Hammock; Frances H,21,0,30,9
1649994616860,MATH 20C,B03,083453,Hammock; Frances H,23,0,30,7
1649994616860,MATH 20C,B04,083454,Hammock; Frances H,25,0,30,5
1649994622906,MATH 20D,A01,084128,Staff,14,0,30,16
1649994622906,MATH 20D,A02,084129,Staff,29,0,30,1
1649994622906,MATH 20D,A03,084130,Staff,27,0,30,3
1649994622906,MATH 20D,B01,084133,Staff,4,0,30,26
1649994622906,MATH 20D,B02,084134,Staff,24,0,30,6
1649994622906,MATH 20D,B03,084135,Staff,28,0,30,2
1649994628932,MATH 20E,A01,084138,Staff,14,0,30,16
1649994628932,MATH 20E,A02,084139,Staff,7,0,30,23
1649994628932,MATH 20E,A03,084140,Staff,15,0,30,15
1649994628932,MATH 20E,A04,084141,Staff,20,0,30,10
1649994634969,MATH 102,A01,084143,Harel; Guershon,12,0,30,18
1649994634969,MATH 102,A02,084144,Harel; Guershon,20,0,30,10
1649994640995,MATH 103B,A01,083456,Staff,0,12,30,30
1649994640995,MATH 103B,A02,083457,Staff,0,12,30,30
1649994647046,MATH 109,A01,084146,Salehi Golsefidy; Alireza,18,0,30,12
1649994647046,MATH 109,A02,084147,Salehi Golsefidy; Alireza,16,0,30,14
1649994653084,MATH 120A,A01,085445,Eggers; John Dietrich,13,0,35,22
1649994653084,MATH 120A,A02,085446,Eggers; John Dietrich,27,0,35,8
1649994659106,MATH 142B,A01,084149,Verstraete; Jacques Allan,0,12,30,30
1649994659106,MATH 142B,A02,084150,Verstraete; Jacques Allan,0,12,30,30
1649994665155,MATH 170A,A01,083459,Nie; Jiawang,1,10,30,29
1649994665155,MATH 170A,A02,083460,Nie; Jiawang,0,6,30,30
1649994665155,MATH 170A,A03,083461,Nie; Jiawang,0,9,30,30
1649994671181,MATH 193B,A01,083463,Staff,1,0,30,29
1649994671181,MATH 193B,A02,083464,Staff,9,0,30,21
1649994671181,MATH 193B,A03,083465,Staff,18,0,30,12
1649994677279,COGS 2,A01,083966,Boyle; Mary E. T.,10,0,30,20
1649994683319,COGS 9,A01,083968,Staff,15,0,60,45
1649994689351,COGS 14B,A01,083970,Staff,11,0,50,39
1649994695387,COGS 17,A01,092679,Staff,52,0,75,23
1649994701413,COGS 100,A01,083972,Staff,0,15,60,60
1649994713488,COGS 101C,A01,083976,Staff,13,0,30,17
1649994719512,COGS 102A,A01,083978,Johnson; Christine M.,14,0,30,16
1649994725539,COGS 107B,A01,083980,Staff,0,7,50,50
1649994731565,COGS 115,A01,083982,Staff,11,0,30,19
1649994737603,COGS 118B,A01,083367,Staff,0,14,40,40
1649994743637,COGS 172,A01,083984,Provenzano; Emily Kara,15,0,30,15
1649994749681,COGS 177,A00,083368,Staff,0,20,30,30
1649994755705,COGS 186,A01,083986,Staff,21,0,40,19
1649994761730,COGS 187A,A01,083988,Boyle; Mary E. T.,19,0,60,41
1649994767783,CSE 8A,A50,084003,Miranda; Gregory Joseph,0,12,15,15
1649994773804,CSE 11,A01,084005,Miranda; Gregory Joseph,0,19,55,55
1649994779835,CSE 20,A01,084007,Staff,0,3,20,20
1649994785894,CSE 21,A01,084009,Staff,0,27,50,50
1649994791925,CSE 30,A01,083370,Cao; Yingjun,0,62,40,40
1649994797981,CSE 100,A01,083372,Cao; Yingjun,0,45,40,40
1649994804022,CSE 101,A01,084011,Staff,1,55,40,39
1649994810046,CSE 141,A01,083374,Eldon; John,0,63,75,75
1649994816079,CSE 141L,A01,083376,Eldon; John,0,69,75,75
1649994822117,CSE 175,A01,084013,Kumar; Rakesh,22,0,25,3
1649994828140,CSE 190,A00,092508,Dubnov; Shlomo,20,0,20,0
1649994834162,ECE 5,A01,084049,Morris; Karcher William,13,0,20,7
1649994840188,ECE 100,A01,084051,Baghdadchi; Saharnaz,0,0,20,20
1649994840188,ECE 100,A02,091916,Baghdadchi; Saharnaz,14,0,20,6
1649994846236,ECE 101,A01,084053,Baghdadchi; Saharnaz,1,0,37,36
1649994846236,ECE 101,A02,084054,Baghdadchi; Saharnaz,31,0,37,6
1649994852270,ECE 107,A01,083390,Staff,27,0,40,13
1649994858291,ECE 148,A01,084056,Silberman; Jack,8,0,12,4
1649994864339,ECE 180,A00,083391,Abi Samra; Nicholas Camill,25,0,30,5
1649994864339,ECE 180,B00,083392,Abi Samra; Nicholas Camill,21,0,30,9
1649994870368,MATH 10B,A01,084110,Staff,0,0,30,30
1649994870368,MATH 10B,A02,084111,Staff,20,0,30,10
1649994870368,MATH 10B,A03,084112,Staff,24,0,30,6
1649994876395,MATH 10C,A01,083443,Staff,1,13,30,29
1649994876395,MATH 10C,A02,083444,Staff,1,14,30,29
1649994876395,MATH 10C,B01,084114,Staff,19,0,30,11
1649994876395,MATH 10C,B02,084115,Staff,25,0,30,5
1649994882444,MATH 18,A01,084117,Harel; Guershon,16,0,30,14
1649994882444,MATH 18,A02,084119,Harel; Guershon,28,0,30,2
1649994882444,MATH 18,A03,084120,Harel; Guershon,29,0,30,1
1649994882444,MATH 18,A04,084121,Harel; Guershon,29,0,30,1
1649994888494,MATH 20B,A01,084124,Um; Ko Woon,16,0,35,19
1649994888494,MATH 20B,B01,084126,Um; Ko Woon,26,0,35,9
1649994894535,MATH 20C,A01,083446,Hammock; Frances H,0,0,30,30
1649994894535,MATH 20C,A02,083447,Hammock; Frances H,20,0,30,10
1649994894535,MATH 20C,A03,083448,Hammock; Frances H,23,0,30,7
1649994894535,MATH 20C,A04,083449,Hammock; Frances H,22,0,30,8
1649994894535,MATH 20C,B01,083451,Hammock; Frances H,0,0,30,30
1649994894535,MATH 20C,B02,083452,Hammock; Frances H,21,0,30,9
1649994894535,MATH 20C,B03,083453,Hammock; Frances H,23,0,30,7
1649994894535,MATH 20C,B04,083454,Hammock; Frances H,25,0,30,5
1649994900596,MATH 20D,A01,084128,Staff,14,0,30,16
1649994900596,MATH 20D,A02,084129,Staff,29,0,30,1
1649994900596,MATH 20D,A03,084130,Staff,27,0,30,3
1649994900596,MATH 20D,B01,084133,Staff,4,0,30,26
1649994900596,MATH 20D,B02,084134,Staff,24,0,30,6
1649994900596,MATH 20D,B03,084135,Staff,28,0,30,2
1649994906623,MATH 20E,A01,084138,Staff,14,0,30,16
1649994906623,MATH 20E,A02,084139,Staff,7,0,30,23
1649994906623,MATH 20E,A03,084140,Staff,15,0,30,15
1649994906623,MATH 20E,A04,084141,Staff,20,0,30,10
1649994912647,MATH 102,A01,084143,Harel; Guershon,12,0,30,18
1649994912647,MATH 102,A02,084144,Harel; Guershon,20,0,30,10
1649994918672,MATH 103B,A01,083456,Staff,0,12,30,30
1649994918672,MATH 103B,A02,083457,Staff,0,12,30,30
1649994924707,MATH 109,A01,084146,Salehi Golsefidy; Alireza,18,0,30,12
1649994924707,MATH 109,A02,084147,Salehi Golsefidy; Alireza,16,0,30,14
1649994930730,MATH 120A,A01,085445,Eggers; John Dietrich,13,0,35,22
1649994930730,MATH 120A,A02,085446,Eggers; John Dietrich,27,0,35,8
1649994936774,MATH 142B,A01,084149,Verstraete; Jacques Allan,0,12,30,30
1649994936774,MATH 142B,A02,084150,Verstraete; Jacques Allan,0,12,30,30
1649994942817,MATH 170A,A01,083459,Nie; Jiawang,1,10,30,29
1649994942817,MATH 170A,A02,083460,Nie; Jiawang,0,6,30,30
1649994942817,MATH 170A,A03,083461,Nie; Jiawang,0,9,30,30
1649994948840,MATH 193B,A01,083463,Staff,1,0,30,29
1649994948840,MATH 193B,A02,083464,Staff,9,0,30,21
1649994948840,MATH 193B,A03,083465,Staff,18,0,30,12
1649994954903,COGS 2,A01,083966,Boyle; Mary E. T.,10,0,30,20
1649994960933,COGS 9,A01,083968,Staff,15,0,60,45
1649994966991,COGS 14B,A01,083970,Staff,11,0,50,39
1649994973036,COGS 17,A01,092679,Staff,52,0,75,23
1649994979063,COGS 100,A01,083972,Staff,0,15,60,60
1649994991151,COGS 101C,A01,083976,Staff,13,0,30,17
1649994997174,COGS 102A,A01,083978,Johnson; Christine M.,14,0,30,16
1649995003210,COGS 107B,A01,083980,Staff,0,7,50,50
1649995009238,COGS 115,A01,083982,Staff,11,0,30,19
1649995015281,COGS 118B,A01,083367,Staff,0,14,40,40
1649995021305,COGS 172,A01,083984,Provenzano; Emily Kara,15,0,30,15
1649995027339,COGS 177,A00,083368,Staff,0,20,30,30
1649995033378,COGS 186,A01,083986,Staff,21,0,40,19
1649995039411,COGS 187A,A01,083988,Boyle; Mary E. T.,19,0,60,41
1649995045453,CSE 8A,A50,084003,Miranda; Gregory Joseph,0,12,15,15
1649995051476,CSE 11,A01,084005,Miranda; Gregory Joseph,0,19,55,55
1649995057512,CSE 20,A01,084007,Staff,0,3,20,20
1649995063540,CSE 21,A01,084009,Staff,0,27,50,50
1649995069572,CSE 30,A01,083370,Cao; Yingjun,0,62,40,40
1649995075597,CSE 100,A01,083372,Cao; Yingjun,0,45,40,40
1649995081620,CSE 101,A01,084011,Staff,1,55,40,39
1649995087666,CSE 141,A01,083374,Eldon; John,0,63,75,75
1649995093690,CSE 141L,A01,083376,Eldon; John,0,69,75,75
1649995099721,CSE 175,A01,084013,Kumar; Rakesh,22,0,25,3
1649995105756,CSE 190,A00,092508,Dubnov; Shlomo,20,0,20,0
1649995111799,ECE 5,A01,084049,Morris; Karcher William,13,0,20,7
1649995117831,ECE 100,A01,084051,Baghdadchi; Saharnaz,0,0,20,20
1649995117831,ECE 100,A02,091916,Baghdadchi; Saharnaz,14,0,20,6
1649995123854,ECE 101,A01,084053,Baghdadchi; Saharnaz,1,0,37,36
1649995123854,ECE 101,A02,084054,Baghdadchi; Saharnaz,31,0,37,6
1649995129912,ECE 107,A01,083390,Staff,27,0,40,13
1649995135934,ECE 148,A01,084056,Silberman; Jack,8,0,12,4
1649995141986,ECE 180,A00,083391,Abi Samra; Nicholas Camill,25,0,30,5
1649995141986,ECE 180,B00,083392,Abi Samra; Nicholas Camill,21,0,30,9
1649995148023,MATH 10B,A01,084110,Staff,0,0,30,30
1649995148023,MATH 10B,A02,084111,Staff,20,0,30,10
1649995148023,MATH 10B,A03,084112,Staff,24,0,30,6
1649995154050,MATH 10C,A01,083443,Staff,1,13,30,29
1649995154050,MATH 10C,A02,083444,Staff,1,14,30,29
1649995154050,MATH 10C,B01,084114,Staff,19,0,30,11
1649995154050,MATH 10C,B02,084115,Staff,25,0,30,5
1649995160099,MATH 18,A01,084117,Harel; Guershon,16,0,30,14
1649995160099,MATH 18,A02,084119,Harel; Guershon,28,0,30,2
1649995160099,MATH 18,A03,084120,Harel; Guershon,29,0,30,1
1649995160099,MATH 18,A04,084121,Harel; Guershon,29,0,30,1
1649995166146,MATH 20B,A01,084124,Um; Ko Woon,16,0,35,19
1649995166146,MATH 20B,B01,084126,Um; Ko Woon,26,0,35,9
1649995172267,MATH 20C,A01,083446,Hammock; Frances H,0,0,30,30
1649995172267,MATH 20C,A02,083447,Hammock; Frances H,19,0,30,11
1649995172267,MATH 20C,A03,083448,Hammock; Frances H,23,0,30,7
1649995172267,MATH 20C,A04,083449,Hammock; Frances H,22,0,30,8
1649995172267,MATH 20C,B01,083451,Hammock; Frances H,0,0,30,30
1649995172267,MATH 20C,B02,083452,Hammock; Frances H,21,0,30,9
1649995172267,MATH 20C,B03,083453,Hammock; Frances H,23,0,30,7
1649995172267,MATH 20C,B04,083454,Hammock; Frances H,25,0,30,5
1649995178307,MATH 20D,A01,084128,Staff,14,0,30,16
1649995178307,MATH 20D,A02,084129,Staff,29,0,30,1
1649995178307,MATH 20D,A03,084130,Staff,27,0,30,3
1649995178307,MATH 20D,B01,084133,Staff,4,0,30,26
1649995178307,MATH 20D,B02,084134,Staff,24,0,30,6
1649995178307,MATH 20D,B03,084135,Staff,28,0,30,2
1649995184353,MATH 20E,A01,084138,Staff,14,0,30,16
1649995184353,MATH 20E,A02,084139,Staff,7,0,30,23
1649995184353,MATH 20E,A03,084140,Staff,15,0,30,15
1649995184353,MATH 20E,A04,084141,Staff,20,0,30,10
1649995190377,MATH 102,A01,084143,Harel; Guershon,12,0,30,18
1649995190377,MATH 102,A02,084144,Harel; Guershon,20,0,30,10
1649995196421,MATH 103B,A01,083456,Staff,0,12,30,30
1649995196421,MATH 103B,A02,083457,Staff,0,12,30,30
1649995202446,MATH 109,A01,084146,Salehi Golsefidy; Alireza,18,0,30,12
1649995202446,MATH 109,A02,084147,Salehi Golsefidy; Alireza,16,0,30,14
1649995208487,MATH 120A,A01,085445,Eggers; John Dietrich,13,0,35,22
1649995208487,MATH 120A,A02,085446,Eggers; John Dietrich,27,0,35,8
1649995214519,MATH 142B,A01,084149,Verstraete; Jacques Allan,0,12,30,30
1649995214519,MATH 142B,A02,084150,Verstraete; Jacques Allan,0,12,30,30
1649995220576,MATH 170A,A01,083459,Nie; Jiawang,1,10,30,29
1649995220576,MATH 170A,A02,083460,Nie; Jiawang,0,6,30,30
1649995220576,MATH 170A,A03,083461,Nie; Jiawang,0,9,30,30
1649995226599,MATH 193B,A01,083463,Staff,1,0,30,29
1649995226599,MATH 193B,A02,083464,Staff,9,0,30,21
1649995226599,MATH 193B,A03,083465,Staff,18,0,30,12
1649995232688,COGS 2,A01,083966,Boyle; Mary E. T.,10,0,30,20
1649995238720,COGS 9,A01,083968,Staff,14,0,60,46
1649995244765,COGS 14B,A01,083970,Staff,11,0,50,39
1649995250790,COGS 17,A01,092679,Staff,52,0,75,23
1649995256825,COGS 100,A01,083972,Staff,0,15,60,60
1649995268906,COGS 101C,A01,083976,Staff,13,0,30,17
1649995274930,COGS 102A,A01,083978,Johnson; Christine M.,14,0,30,16
1649995280964,COGS 107B,A01,083980,Staff,0,7,50,50
1649995287022,COGS 115,A01,083982,Staff,11,0,30,19
1649995293045,COGS 118B,A01,083367,Staff,0,14,40,40
1649995299092,COGS 172,A01,083984,Provenzano; Emily Kara,15,0,30,15
1649995305128,COGS 177,A00,083368,Staff,0,20,30,30
1649995311168,COGS 186,A01,083986,Staff,21,0,40,19
1649995317189,COGS 187A,A01,083988,Boyle; Mary E. T.,19,0,60,41
1649995323212,CSE 8A,A50,084003,Miranda; Gregory Joseph,0,12,15,15
1649995329245,CSE 11,A01,084005,Miranda; Gregory Joseph,0,19,55,55
1649995335272,CSE 20,A01,084007,Staff,0,3,20,20
1649995341318,CSE 21,A01,084009,Staff,0,27,50,50
1649995347352,CSE 30,A01,083370,Cao; Yingjun,0,62,40,40
1649995353377,CSE 100,A01,083372,Cao; Yingjun,0,45,40,40
1649995359433,CSE 101,A01,084011,Staff,1,55,40,39
1649995365466,CSE 141,A01,083374,Eldon; John,0,63,75,75
1649995371494,CSE 141L,A01,083376,Eldon; John,0,69,75,75
1649995377517,CSE 175,A01,084013,Kumar; Rakesh,22,0,25,3
1649995383567,CSE 190,A00,092508,Dubnov; Shlomo,20,0,20,0
1649995389591,ECE 5,A01,084049,Morris; Karcher William,13,0,20,7
1649995395625,ECE 100,A01,084051,Baghdadchi; Saharnaz,0,0,20,20
1649995395625,ECE 100,A02,091916,Baghdadchi; Saharnaz,14,0,20,6
1649995401652,ECE 101,A01,084053,Baghdadchi; Saharnaz,1,0,37,36
1649995401652,ECE 101,A02,084054,Baghdadchi; Saharnaz,31,0,37,6
1649995407689,ECE 107,A01,083390,Staff,27,0,40,13
1649995413721,ECE 148,A01,084056,Silberman; Jack,8,0,12,4
1649995419758,ECE 180,A00,083391,Abi Samra; Nicholas Camill,25,0,30,5
1649995419758,ECE 180,B00,083392,Abi Samra; Nicholas Camill,21,0,30,9
1649995425786,MATH 10B,A01,084110,Staff,0,0,30,30
1649995425786,MATH 10B,A02,084111,Staff,20,0,30,10
1649995425786,MATH 10B,A03,084112,Staff,24,0,30,6
1649995431829,MATH 10C,A01,083443,Staff,1,14,30,29
1649995431829,MATH 10C,A02,083444,Staff,1,14,30,29
1649995431829,MATH 10C,B01,084114,Staff,19,0,30,11
1649995431829,MATH 10C,B02,084115,Staff,25,0,30,5
1649995437869,MATH 18,A01,084117,Harel; Guershon,16,0,30,14
1649995437869,MATH 18,A02,084119,Harel; Guershon,28,0,30,2
1649995437869,MATH 18,A03,084120,Harel; Guershon,29,0,30,1
1649995437869,MATH 18,A04,084121,Harel; Guershon,29,0,30,1
1649995443893,MATH 20B,A01,084124,Um; Ko Woon,16,0,35,19
1649995443893,MATH 20B,B01,084126,Um; Ko Woon,26,0,35,9
1649995449930,MATH 20C,A01,083446,Hammock; Frances H,0,0,30,30
1649995449930,MATH 20C,A02,083447,Hammock; Frances H,19,0,30,11
1649995449930,MATH 20C,A03,083448,Hammock; Frances H,23,0,30,7
1649995449930,MATH 20C,A04,083449,Hammock; Frances H,22,0,30,8
1649995449930,MATH 20C,B01,083451,Hammock; Frances H,0,0,30,30
1649995449930,MATH 20C,B02,083452,Hammock; Frances H,21,0,30,9
1649995449930,MATH 20C,B03,083453,Hammock; Frances H,23,0,30,7
1649995449930,MATH 20C,B04,083454,Hammock; Frances H,25,0,30,5
1649995455963,MATH 20D,A01,084128,Staff,14,0,30,16
1649995455963,MATH 20D,A02,084129,Staff,29,0,30,1
1649995455963,MATH 20D,A03,084130,Staff,27,0,30,3
1649995455963,MATH 20D,B01,084133,Staff,4,0,30,26
1649995455963,MATH 20D,B02,084134,Staff,24,0,30,6
1649995455963,MATH 20D,B03,084135,Staff,28,0,30,2
1649995462018,MATH 20E,A01,084138,Staff,14,0,30,16
1649995462018,MATH 20E,A02,084139,Staff,7,0,30,23
1649995462018,MATH 20E,A03,084140,Staff,15,0,30,15
1649995462018,MATH 20E,A04,084141,Staff,20,0,30,10
1649995468041,MATH 102,A01,084143,Harel; Guershon,12,0,30,18
1649995468041,MATH 102,A02,084144,Harel; Guershon,20,0,30,10
1649995474080,MATH 103B,A01,083456,Staff,0,12,30,30
1649995474080,MATH 103B,A02,083457,Staff,0,12,30,30
1649995480108,MATH 109,A01,084146,Salehi Golsefidy; Alireza,18,0,30,12
1649995480108,MATH 109,A02,084147,Salehi Golsefidy; Alireza,16,0,30,14
1649995486147,MATH 120A,A01,085445,Eggers; John Dietrich,13,0,35,22
1649995486147,MATH 120A,A02,085446,Eggers; John Dietrich,27,0,35,8
1649995492182,MATH 142B,A01,084149,Verstraete; Jacques Allan,0,12,30,30
1649995492182,MATH 142B,A02,084150,Verstraete; Jacques Allan,0,12,30,30
1649995498216,MATH 170A,A01,083459,Nie; Jiawang,1,10,30,29
1649995498216,MATH 170A,A02,083460,Nie; Jiawang,0,6,30,30
1649995498216,MATH 170A,A03,083461,Nie; Jiawang,0,9,30,30
1649995504252,MATH 193B,A01,083463,Staff,1,0,30,29
1649995504252,MATH 193B,A02,083464,Staff,9,0,30,21
1649995504252,MATH 193B,A03,083465,Staff,18,0,30,12
1649995510332,COGS 2,A01,083966,Boyle; Mary E. T.,10,0,30,20
1649995516384,COGS 9,A01,083968,Staff,14,0,60,46
1649995522436,COGS 14B,A01,083970,Staff,11,0,50,39
1649995528459,COGS 17,A01,092679,Staff,52,0,75,23
1649995534499,COGS 100,A01,083972,Staff,0,15,60,60
1649995546569,COGS 101C,A01,083976,Staff,13,0,30,17
1649995552592,COGS 102A,A01,083978,Johnson; Christine M.,14,0,30,16
1649995558626,COGS 107B,A01,083980,Staff,0,7,50,50
1649995564649,COGS 115,A01,083982,Staff,11,0,30,19
1649995570672,COGS 118B,A01,083367,Staff,0,14,40,40
1649995576697,COGS 172,A01,083984,Provenzano; Emily Kara,15,0,30,15
1649995582721,COGS 177,A00,083368,Staff,0,20,30,30
1649995588747,COGS 186,A01,083986,Staff,21,0,40,19
1649995594786,COGS 187A,A01,083988,Boyle; Mary E. T.,19,0,60,41
1649995600810,CSE 8A,A50,084003,Miranda; Gregory Joseph,0,12,15,15
1649995606847,CSE 11,A01,084005,Miranda; Gregory Joseph,0,19,55,55
1649995612874,CSE 20,A01,084007,Staff,0,3,20,20
1649995618897,CSE 21,A01,084009,Staff,0,27,50,50
1649995624925,CSE 30,A01,083370,Cao; Yingjun,0,62,40,40
1649995630971,CSE 100,A01,083372,Cao; Yingjun,0,45,40,40
1649995637017,CSE 101,A01,084011,Staff,1,55,40,39
1649995643045,CSE 141,A01,083374,Eldon; John,0,63,75,75
1649995649092,CSE 141L,A01,083376,Eldon; John,0,69,75,75
1649995655155,CSE 175,A01,084013,Kumar; Rakesh,22,0,25,3
1649995661178,CSE 190,A00,092508,Dubnov; Shlomo,20,0,20,0
1649995667203,ECE 5,A01,084049,Morris; Karcher William,13,0,20,7
1649995673230,ECE 100,A01,084051,Baghdadchi; Saharnaz,0,0,20,20
1649995673230,ECE 100,A02,091916,Baghdadchi; Saharnaz,14,0,20,6
1649995679280,ECE 101,A01,084053,Baghdadchi; Saharnaz,1,0,37,36
1649995679280,ECE 101,A02,084054,Baghdadchi; Saharnaz,31,0,37,6
1649995685320,ECE 107,A01,083390,Staff,27,0,40,13
1649995691344,ECE 148,A01,084056,Silberman; Jack,8,0,12,4
1649995697367,ECE 180,A00,083391,Abi Samra; Nicholas Camill,25,0,30,5
1649995697367,ECE 180,B00,083392,Abi Samra; Nicholas Camill,21,0,30,9
1649995703408,MATH 10B,A01,084110,Staff,0,0,30,30
1649995703408,MATH 10B,A02,084111,Staff,20,0,30,10
1649995703408,MATH 10B,A03,084112,Staff,24,0,30,6
1649995709434,MATH 10C,A01,083443,Staff,1,14,30,29
1649995709434,MATH 10C,A02,083444,Staff,1,14,30,29
1649995709434,MATH 10C,B01,084114,Staff,19,0,30,11
1649995709434,MATH 10C,B02,084115,Staff,25,0,30,5
1649995715462,MATH 18,A01,084117,Harel; Guershon,16,0,30,14
1649995715462,MATH 18,A02,084119,Harel; Guershon,28,0,30,2
1649995715462,MATH 18,A03,084120,Harel; Guershon,29,0,30,1
1649995715462,MATH 18,A04,084121,Harel; Guershon,29,0,30,1
1649995721506,MATH 20B,A01,084124,Um; Ko Woon,16,0,35,19
1649995721506,MATH 20B,B01,084126,Um; Ko Woon,26,0,35,9
1649995727528,MATH 20C,A01,083446,Hammock; Frances H,0,0,30,30
1649995727528,MATH 20C,A02,083447,Hammock; Frances H,18,0,30,12
1649995727528,MATH 20C,A03,083448,Hammock; Frances H,23,0,30,7
1649995727528,MATH 20C,A04,083449,Hammock; Frances H,22,0,30,8
1649995727528,MATH 20C,B01,083451,Hammock; Frances H,0,0,30,30
1649995727528,MATH 20C,B02,083452,Hammock; Frances H,21,0,30,9
1649995727528,MATH 20C,B03,083453,Hammock; Frances H,23,0,30,7
1649995727528,MATH 20C,B04,083454,Hammock; Frances H,25,0,30,5
1649995733552,MATH 20D,A01,084128,Staff,14,0,30,16
1649995733552,MATH 20D,A02,084129,Staff,29,0,30,1
1649995733552,MATH 20D,A03,084130,Staff,27,0,30,3
1649995733552,MATH 20D,B01,084133,Staff,4,0,30,26
1649995733552,MATH 20D,B02,084134,Staff,24,0,30,6
1649995733552,MATH 20D,B03,084135,Staff,28,0,30,2
1649995739612,MATH 20E,A01,084138,Staff,14,0,30,16
1649995739612,MATH 20E,A02,084139,Staff,7,0,30,23
1649995739612,MATH 20E,A03,084140,Staff,15,0,30,15
1649995739612,MATH 20E,A04,084141,Staff,20,0,30,10
1649995745656,MATH 102,A01,084143,Harel; Guershon,12,0,30,18
1649995745656,MATH 102,A02,084144,Harel; Guershon,20,0,30,10
1649995751697,MATH 103B,A01,083456,Staff,0,12,30,30
1649995751697,MATH 103B,A02,083457,Staff,0,12,30,30
1649995757724,MATH 109,A01,084146,Salehi Golsefidy; Alireza,18,0,30,12
1649995757724,MATH 109,A02,084147,Salehi Golsefidy; Alireza,16,0,30,14
1649995763772,MATH 120A,A01,085445,Eggers; John Dietrich,13,0,35,22
1649995763772,MATH 120A,A02,085446,Eggers; John Dietrich,27,0,35,8
1649995769919,MATH 142B,A01,084149,Verstraete; Jacques Allan,0,12,30,30
1649995769919,MATH 142B,A02,084150,Verstraete; Jacques Allan,0,12,30,30
1649995775946,MATH 170A,A01,083459,Nie; Jiawang,1,10,30,29
1649995775946,MATH 170A,A02,083460,Nie; Jiawang,0,6,30,30
1649995775946,MATH 170A,A03,083461,Nie; Jiawang,0,9,30,30
1649995781974,MATH 193B,A01,083463,Staff,1,0,30,29
1649995781974,MATH 193B,A02,083464,Staff,9,0,30,21
1649995781974,MATH 193B,A03,083465,Staff,18,0,30,12
1649995788066,COGS 2,A01,083966,Boyle; Mary E. T.,10,0,30,20
1649995794122,COGS 9,A01,083968,Staff,14,0,60,46
1649995800155,COGS 14B,A01,083970,Staff,11,0,50,39
1649995806177,COGS 17,A01,092679,Staff,52,0,75,23
1649995812199,COGS 100,A01,083972,Staff,0,15,60,60
1649995824281,COGS 101C,A01,083976,Staff,13,0,30,17
1649995830304,COGS 102A,A01,083978,Johnson; Christine M.,14,0,30,16
1649995836332,COGS 107B,A01,083980,Staff,0,7,50,50
1649995842354,COGS 115,A01,083982,Staff,11,0,30,19
1649995848387,COGS 118B,A01,083367,Staff,0,14,40,40
1649995854423,COGS 172,A01,083984,Provenzano; Emily Kara,15,0,30,15
1649995860449,COGS 177,A00,083368,Staff,0,20,30,30
1649995866492,COGS 186,A01,083986,Staff,21,0,40,19
1649995872515,COGS 187A,A01,083988,Boyle; Mary E. T.,19,0,60,41
1649995878547,CSE 8A,A50,084003,Miranda; Gregory Joseph,0,12,15,15
1649995884588,CSE 11,A01,084005,Miranda; Gregory Joseph,0,19,55,55
1649995890618,CSE 20,A01,084007,Staff,0,3,20,20
1649995896654,CSE 21,A01,084009,Staff,0,27,50,50
1649995902678,CSE 30,A01,083370,Cao; Yingjun,0,62,40,40
1649995908712,CSE 100,A01,083372,Cao; Yingjun,0,45,40,40
1649995914755,CSE 101,A01,084011,Staff,1,55,40,39
1649995920798,CSE 141,A01,083374,Eldon; John,0,63,75,75
1649995926827,CSE 141L,A01,083376,Eldon; John,0,69,75,75
1649995932849,CSE 175,A01,084013,Kumar; Rakesh,22,0,25,3
1649995938889,CSE 190,A00,092508,Dubnov; Shlomo,20,0,20,0
1649995944913,ECE 5,A01,084049,Morris; Karcher William,13,0,20,7
1649995950947,ECE 100,A01,084051,Baghdadchi; Saharnaz,0,0,20,20
1649995950947,ECE 100,A02,091916,Baghdadchi; Saharnaz,14,0,20,6
1649995956989,ECE 101,A01,084053,Baghdadchi; Saharnaz,1,0,37,36
1649995956989,ECE 101,A02,084054,Baghdadchi; Saharnaz,31,0,37,6
1649995963012,ECE 107,A01,083390,Staff,27,0,40,13
1649995969037,ECE 148,A01,084056,Silberman; Jack,8,0,12,4
1649995975061,ECE 180,A00,083391,Abi Samra; Nicholas Camill,25,0,30,5
1649995975061,ECE 180,B00,083392,Abi Samra; Nicholas Camill,21,0,30,9
1649995981111,MATH 10B,A01,084110,Staff,0,0,30,30
1649995981111,MATH 10B,A02,084111,Staff,20,0,30,10
1649995981111,MATH 10B,A03,084112,Staff,24,0,30,6
1649995987160,MATH 10C,A01,083443,Staff,1,14,30,29
1649995987160,MATH 10C,A02,083444,Staff,1,14,30,29
1649995987160,MATH 10C,B01,084114,Staff,19,0,30,11
1649995987160,MATH 10C,B02,084115,Staff,25,0,30,5
1649995993182,MATH 18,A01,084117,Harel; Guershon,16,0,30,14
1649995993182,MATH 18,A02,084119,Harel; Guershon,28,0,30,2
1649995993182,MATH 18,A03,084120,Harel; Guershon,29,0,30,1
1649995993182,MATH 18,A04,084121,Harel; Guershon,29,0,30,1
1649995999222,MATH 20B,A01,084124,Um; Ko Woon,16,0,35,19
1649995999222,MATH 20B,B01,084126,Um; Ko Woon,26,0,35,9
1649996005260,MATH 20C,A01,083446,Hammock; Frances H,0,0,30,30
1649996005260,MATH 20C,A02,083447,Hammock; Frances H,18,0,30,12
1649996005260,MATH 20C,A03,083448,Hammock; Frances H,22,0,30,8
1649996005260,MATH 20C,A04,083449,Hammock; Frances H,22,0,30,8
1649996005260,MATH 20C,B01,083451,Hammock; Frances H,0,0,30,30
1649996005260,MATH 20C,B02,083452,Hammock; Frances H,21,0,30,9
1649996005260,MATH 20C,B03,083453,Hammock; Frances H,23,0,30,7
1649996005260,MATH 20C,B04,083454,Hammock; Frances H,25,0,30,5
1649996011286,MATH 20D,A01,084128,Staff,14,0,30,16
1649996011286,MATH 20D,A02,084129,Staff,29,0,30,1
1649996011286,MATH 20D,A03,084130,Staff,27,0,30,3
1649996011286,MATH 20D,B01,084133,Staff,4,0,30,26
1649996011286,MATH 20D,B02,084134,Staff,24,0,30,6
1649996011286,MATH 20D,B03,084135,Staff,28,0,30,2
1649996017310,MATH 20E,A01,084138,Staff,14,0,30,16
1649996017310,MATH 20E,A02,084139,Staff,7,0,30,23
1649996017310,MATH 20E,A03,084140,Staff,15,0,30,15
1649996017310,MATH 20E,A04,084141,Staff,20,0,30,10
1649996023358,MATH 102,A01,084143,Harel; Guershon,12,0,30,18
1649996023358,MATH 102,A02,084144,Harel; Guershon,20,0,30,10
1649996029385,MATH 103B,A01,083456,Staff,0,12,30,30
1649996029385,MATH 103B,A02,083457,Staff,0,12,30,30
1649996035409,MATH 109,A01,084146,Salehi Golsefidy; Alireza,18,0,30,12
1649996035409,MATH 109,A02,084147,Salehi Golsefidy; Alireza,16,0,30,14
1649996041431,MATH 120A,A01,085445,Eggers; John Dietrich,13,0,35,22
1649996041431,MATH 120A,A02,085446,Eggers; John Dietrich,27,0,35,8
1649996047469,MATH 142B,A01,084149,Verstraete; Jacques Allan,0,12,30,30
1649996047469,MATH 142B,A02,084150,Verstraete; Jacques Allan,0,12,30,30
1649996053506,MATH 170A,A01,083459,Nie; Jiawang,1,10,30,29
1649996053506,MATH 170A,A02,083460,Nie; Jiawang,0,6,30,30
1649996053506,MATH 170A,A03,083461,Nie; Jiawang,0,9,30,30
1649996059534,MATH 193B,A01,083463,Staff,1,0,30,29
1649996059534,MATH 193B,A02,083464,Staff,9,0,30,21
1649996059534,MATH 193B,A03,083465,Staff,18,0,30,12
1649996065593,COGS 2,A01,083966,Boyle; Mary E. T.,10,0,30,20
1649996071638,COGS 9,A01,083968,Staff,14,0,60,46
1649996077692,COGS 14B,A01,083970,Staff,11,0,50,39
1649996083715,COGS 17,A01,092679,Staff,52,0,75,23
1649996089759,COGS 100,A01,083972,Staff,0,15,60,60
1649996101814,COGS 101C,A01,083976,Staff,13,0,30,17
1649996107858,COGS 102A,A01,083978,Johnson; Christine M.,14,0,30,16
1649996113885,COGS 107B,A01,083980,Staff,0,7,50,50
1649996119908,COGS 115,A01,083982,Staff,11,0,30,19
1649996125931,COGS 118B,A01,083367,Staff,0,14,40,40
1649996131965,COGS 172,A01,083984,Provenzano; Emily Kara,15,0,30,15
1649996137989,COGS 177,A00,083368,Staff,0,20,30,30
1649996144023,COGS 186,A01,083986,Staff,21,0,40,19
1649996150047,COGS 187A,A01,083988,Boyle; Mary E. T.,19,0,60,41
1649996156084,CSE 8A,A50,084003,Miranda; Gregory Joseph,0,12,15,15
1649996162129,CSE 11,A01,084005,Miranda; Gregory Joseph,0,19,55,55
1649996168175,CSE 20,A01,084007,Staff,0,3,20,20
1649996174197,CSE 21,A01,084009,Staff,0,27,50,50
1649996180220,CSE 30,A01,083370,Cao; Yingjun,0,62,40,40
1649996186257,CSE 100,A01,083372,Cao; Yingjun,0,45,40,40
1649996192283,CSE 101,A01,084011,Staff,1,54,40,39
1649996198309,CSE 141,A01,083374,Eldon; John,0,63,75,75
1649996204360,CSE 141L,A01,083376,Eldon; John,0,69,75,75
1649996210383,CSE 175,A01,084013,Kumar; Rakesh,22,0,25,3
1649996216407,CSE 190,A00,092508,Dubnov; Shlomo,20,0,20,0
1649996222434,ECE 5,A01,084049,Morris; Karcher William,13,0,20,7
1649996228465,ECE 100,A01,084051,Baghdadchi; Saharnaz,0,0,20,20
1649996228465,ECE 100,A02,091916,Baghdadchi; Saharnaz,14,0,20,6
1649996234509,ECE 101,A01,084053,Baghdadchi; Saharnaz,1,0,37,36
1649996234509,ECE 101,A02,084054,Baghdadchi; Saharnaz,31,0,37,6
1649996240535,ECE 107,A01,083390,Staff,27,0,40,13
1649996246565,ECE 148,A01,084056,Silberman; Jack,8,0,12,4
1649996252587,ECE 180,A00,083391,Abi Samra; Nicholas Camill,25,0,30,5
1649996252587,ECE 180,B00,083392,Abi Samra; Nicholas Camill,21,0,30,9
1649996258633,MATH 10B,A01,084110,Staff,0,0,30,30
1649996258633,MATH 10B,A02,084111,Staff,20,0,30,10
1649996258633,MATH 10B,A03,084112,Staff,24,0,30,6
1649996264659,MATH 10C,A01,083443,Staff,1,14,30,29
1649996264659,MATH 10C,A02,083444,Staff,1,14,30,29
1649996264659,MATH 10C,B01,084114,Staff,19,0,30,11
1649996264659,MATH 10C,B02,084115,Staff,25,0,30,5
1649996270698,MATH 18,A01,084117,Harel; Guershon,15,0,30,15
1649996270698,MATH 18,A02,084119,Harel; Guershon,28,0,30,2
1649996270698,MATH 18,A03,084120,Harel; Guershon,29,0,30,1
1649996270698,MATH 18,A04,084121,Harel; Guershon,29,0,30,1
1649996276735,MATH 20B,A01,084124,Um; Ko Woon,16,0,35,19
1649996276735,MATH 20B,B01,084126,Um; Ko Woon,26,0,35,9
1649996282776,MATH 20C,A01,083446,Hammock; Frances H,0,0,30,30
1649996282776,MATH 20C,A02,083447,Hammock; Frances H,18,0,30,12
1649996282776,MATH 20C,A03,083448,Hammock; Frances H,22,0,30,8
1649996282776,MATH 20C,A04,083449,Hammock; Frances H,22,0,30,8
1649996282776,MATH 20C,B01,083451,Hammock; Frances H,0,0,30,30
1649996282776,MATH 20C,B02,083452,Hammock; Frances H,21,0,30,9
1649996282776,MATH 20C,B03,083453,Hammock; Frances H,23,0,30,7
1649996282776,MATH 20C,B04,083454,Hammock; Frances H,25,0,30,5
1649996288813,MATH 20D,A01,084128,Staff,14,0,30,16
1649996288813,MATH 20D,A02,084129,Staff,29,0,30,1
1649996288813,MATH 20D,A03,084130,Staff,27,0,30,3
1649996288813,MATH 20D,B01,084133,Staff,4,0,30,26
1649996288813,MATH 20D,B02,084134,Staff,24,0,30,6
1649996288813,MATH 20D,B03,084135,Staff,28,0,30,2
1649996294848,MATH 20E,A01,084138,Staff,14,0,30,16
1649996294848,MATH 20E,A02,084139,Staff,7,0,30,23
1649996294848,MATH 20E,A03,084140,Staff,15,0,30,15
1649996294848,MATH 20E,A04,084141,Staff,20,0,30,10
1649996300877,MATH 102,A01,084143,Harel; Guershon,12,0,30,18
1649996300877,MATH 102,A02,084144,Harel; Guershon,20,0,30,10
1649996306899,MATH 103B,A01,083456,Staff,0,13,30,30
1649996306899,MATH 103B,A02,083457,Staff,0,12,30,30
1649996312923,MATH 109,A01,084146,Salehi Golsefidy; Alireza,18,0,30,12
1649996312923,MATH 109,A02,084147,Salehi Golsefidy; Alireza,16,0,30,14
1649996318957,MATH 120A,A01,085445,Eggers; John Dietrich,13,0,35,22
1649996318957,MATH 120A,A02,085446,Eggers; John Dietrich,27,0,35,8
1649996324990,MATH 142B,A01,084149,Verstraete; Jacques Allan,0,12,30,30
1649996324990,MATH 142B,A02,084150,Verstraete; Jacques Allan,0,12,30,30
1649996331028,MATH 170A,A01,083459,Nie; Jiawang,1,10,30,29
1649996331028,MATH 170A,A02,083460,Nie; Jiawang,0,6,30,30
1649996331028,MATH 170A,A03,083461,Nie; Jiawang,0,9,30,30
1649996337068,MATH 193B,A01,083463,Staff,1,0,30,29
1649996337068,MATH 193B,A02,083464,Staff,9,0,30,21
1649996337068,MATH 193B,A03,083465,Staff,18,0,30,12
1649996343120,COGS 2,A01,083966,Boyle; Mary E. T.,10,0,30,20
1649996349146,COGS 9,A01,083968,Staff,14,0,60,46
1649996355181,COGS 14B,A01,083970,Staff,11,0,50,39
1649996361306,COGS 17,A01,092679,Staff,53,0,75,22
1649996367338,COGS 100,A01,083972,Staff,0,15,60,60
1649996379386,COGS 101C,A01,083976,Staff,13,0,30,17
1649996385418,COGS 102A,A01,083978,Johnson; Christine M.,14,0,30,16
1649996391445,COGS 107B,A01,083980,Staff,0,7,50,50
1649996397475,COGS 115,A01,083982,Staff,11,0,30,19
1649996403510,COGS 118B,A01,083367,Staff,0,14,40,40
1649996409552,COGS 172,A01,083984,Provenzano; Emily Kara,15,0,30,15
1649996415578,COGS 177,A00,083368,Staff,0,20,30,30
1649996421625,COGS 186,A01,083986,Staff,21,0,40,19
1649996427647,COGS 187A,A01,083988,Boyle; Mary E. T.,19,0,60,41
1649996433675,CSE 8A,A50,084003,Miranda; Gregory Joseph,0,12,15,15
1649996439704,CSE 11,A01,084005,Miranda; Gregory Joseph,0,19,55,55
1649996445739,CSE 20,A01,084007,Staff,0,3,20,20
1649996451775,CSE 21,A01,084009,Staff,0,27,50,50
1649996457798,CSE 30,A01,083370,Cao; Yingjun,0,62,40,40
1649996463823,CSE 100,A01,083372,Cao; Yingjun,0,45,40,40
1649996469850,CSE 101,A01,084011,Staff,1,54,40,39
1649996475889,CSE 141,A01,083374,Eldon; John,0,63,75,75
1649996481918,CSE 141L,A01,083376,Eldon; John,0,69,75,75
1649996487969,CSE 175,A01,084013,Kumar; Rakesh,22,0,25,3
1649996493991,CSE 190,A00,092508,Dubnov; Shlomo,20,0,20,0
1649996500027,ECE 5,A01,084049,Morris; Karcher William,13,0,20,7
1649996506050,ECE 100,A01,084051,Baghdadchi; Saharnaz,0,0,20,20
1649996506050,ECE 100,A02,091916,Baghdadchi; Saharnaz,14,0,20,6
1649996512075,ECE 101,A01,084053,Baghdadchi; Saharnaz,1,0,37,36
1649996512075,ECE 101,A02,084054,Baghdadchi; Saharnaz,31,0,37,6
1649996518113,ECE 107,A01,083390,Staff,27,0,40,13
1649996524147,ECE 148,A01,084056,Silberman; Jack,8,0,12,4
1649996530186,ECE 180,A00,083391,Abi Samra; Nicholas Camill,25,0,30,5
1649996530186,ECE 180,B00,083392,Abi Samra; Nicholas Camill,21,0,30,9
1649996536212,MATH 10B,A01,084110,Staff,0,0,30,30
1649996536212,MATH 10B,A02,084111,Staff,20,0,30,10
1649996536212,MATH 10B,A03,084112,Staff,24,0,30,6
1649996542249,MATH 10C,A01,083443,Staff,1,14,30,29
1649996542249,MATH 10C,A02,083444,Staff,1,14,30,29
1649996542249,MATH 10C,B01,084114,Staff,19,0,30,11
1649996542249,MATH 10C,B02,084115,Staff,25,0,30,5
1649996548300,MATH 18,A01,084117,Harel; Guershon,15,0,30,15
1649996548300,MATH 18,A02,084119,Harel; Guershon,28,0,30,2
1649996548300,MATH 18,A03,084120,Harel; Guershon,29,0,30,1
1649996548300,MATH 18,A04,084121,Harel; Guershon,29,0,30,1
1649996554334,MATH 20B,A01,084124,Um; Ko Woon,16,0,35,19
1649996554334,MATH 20B,B01,084126,Um; Ko Woon,26,0,35,9
1649996560365,MATH 20C,A01,083446,Hammock; Frances H,0,0,30,30
1649996560365,MATH 20C,A02,083447,Hammock; Frances H,18,0,30,12
1649996560365,MATH 20C,A03,083448,Hammock; Frances H,22,0,30,8
1649996560365,MATH 20C,A04,083449,Hammock; Frances H,22,0,30,8
1649996560365,MATH 20C,B01,083451,Hammock; Frances H,0,0,30,30
1649996560365,MATH 20C,B02,083452,Hammock; Frances H,21,0,30,9
1649996560365,MATH 20C,B03,083453,Hammock; Frances H,23,0,30,7
1649996560365,MATH 20C,B04,083454,Hammock; Frances H,25,0,30,5
1649996566395,MATH 20D,A01,084128,Staff,14,0,30,16
1649996566395,MATH 20D,A02,084129,Staff,29,0,30,1
1649996566395,MATH 20D,A03,084130,Staff,27,0,30,3
1649996566395,MATH 20D,B01,084133,Staff,4,0,30,26
1649996566395,MATH 20D,B02,084134,Staff,24,0,30,6
1649996566395,MATH 20D,B03,084135,Staff,28,0,30,2
1649996572418,MATH 20E,A01,084138,Staff,14,0,30,16
1649996572418,MATH 20E,A02,084139,Staff,7,0,30,23
1649996572418,MATH 20E,A03,084140,Staff,15,0,30,15
1649996572418,MATH 20E,A04,084141,Staff,20,0,30,10
1649996578441,MATH 102,A01,084143,Harel; Guershon,12,0,30,18
1649996578441,MATH 102,A02,084144,Harel; Guershon,20,0,30,10
1649996584474,MATH 103B,A01,083456,Staff,0,13,30,30
1649996584474,MATH 103B,A02,083457,Staff,0,12,30,30
1649996590502,MATH 109,A01,084146,Salehi Golsefidy; Alireza,18,0,30,12
1649996590502,MATH 109,A02,084147,Salehi Golsefidy; Alireza,16,0,30,14
1649996596550,MATH 120A,A01,085445,Eggers; John Dietrich,13,0,35,22
1649996596550,MATH 120A,A02,085446,Eggers; John Dietrich,27,0,35,8
1649996602573,MATH 142B,A01,084149,Verstraete; Jacques Allan,0,12,30,30
1649996602573,MATH 142B,A02,084150,Verstraete; Jacques Allan,0,12,30,30
1649996608597,MATH 170A,A01,083459,Nie; Jiawang,1,10,30,29
1649996608597,MATH 170A,A02,083460,Nie; Jiawang,0,6,30,30
1649996608597,MATH 170A,A03,083461,Nie; Jiawang,0,9,30,30
1649996614624,MATH 193B,A01,083463,Staff,1,0,30,29
1649996614624,MATH 193B,A02,083464,Staff,9,0,30,21
1649996614624,MATH 193B,A03,083465,Staff,18,0,30,12
1649996620692,COGS 2,A01,083966,Boyle; Mary E. T.,10,0,30,20
1649996626715,COGS 9,A01,083968,Staff,14,0,60,46
1649996632760,COGS 14B,A01,083970,Staff,11,0,50,39
1649996638784,COGS 17,A01,092679,Staff,53,0,75,22
1649996644807,COGS 100,A01,083972,Staff,0,15,60,60
1649996656863,COGS 101C,A01,083976,Staff,13,0,30,17
1649996662904,COGS 102A,A01,083978,Johnson; Christine M.,14,0,30,16
1649996668929,COGS 107B,A01,083980,Staff,0,7,50,50
1649996674951,COGS 115,A01,083982,Staff,11,0,30,19
1649996680983,COGS 118B,A01,083367,Staff,0,14,40,40
1649996687007,COGS 172,A01,083984,Provenzano; Emily Kara,15,0,30,15
1649996693036,COGS 177,A00,083368,Staff,0,20,30,30
1649996699089,COGS 186,A01,083986,Staff,21,0,40,19
1649996705113,COGS 187A,A01,083988,Boyle; Mary E. T.,19,0,60,41
1649996711156,CSE 8A,A50,084003,Miranda; Gregory Joseph,0,12,15,15
1649996717190,CSE 11,A01,084005,Miranda; Gregory Joseph,0,19,55,55
1649996723219,CSE 20,A01,084007,Staff,0,3,20,20
1649996729246,CSE 21,A01,084009,Staff,0,27,50,50
1649996735288,CSE 30,A01,083370,Cao; Yingjun,0,62,40,40
1649996741339,CSE 100,A01,083372,Cao; Yingjun,0,45,40,40
1649996747364,CSE 101,A01,084011,Staff,1,54,40,39
1649996753387,CSE 141,A01,083374,Eldon; John,0,63,75,75
1649996759435,CSE 141L,A01,083376,Eldon; John,0,69,75,75
1649996765468,CSE 175,A01,084013,Kumar; Rakesh,22,0,25,3
1649996771490,CSE 190,A00,092508,Dubnov; Shlomo,20,0,20,0
1649996777528,ECE 5,A01,084049,Morris; Karcher William,13,0,20,7
1649996783567,ECE 100,A01,084051,Baghdadchi; Saharnaz,0,0,20,20
1649996783567,ECE 100,A02,091916,Baghdadchi; Saharnaz,14,0,20,6
1649996789609,ECE 101,A01,084053,Baghdadchi; Saharnaz,1,0,37,36
1649996789609,ECE 101,A02,084054,Baghdadchi; Saharnaz,31,0,37,6
1649996795632,ECE 107,A01,083390,Staff,27,0,40,13
1649996801669,ECE 148,A01,084056,Silberman; Jack,8,0,12,4
1649996807704,ECE 180,A00,083391,Abi Samra; Nicholas Camill,25,0,30,5
1649996807704,ECE 180,B00,083392,Abi Samra; Nicholas Camill,21,0,30,9
1649996813730,MATH 10B,A01,084110,Staff,0,0,30,30
1649996813730,MATH 10B,A02,084111,Staff,20,0,30,10
1649996813730,MATH 10B,A03,084112,Staff,24,0,30,6
1649996819765,MATH 10C,A01,083443,Staff,1,14,30,29
1649996819765,MATH 10C,A02,083444,Staff,1,14,30,29
1649996819765,MATH 10C,B01,084114,Staff,19,0,30,11
1649996819765,MATH 10C,B02,084115,Staff,25,0,30,5
1649996825794,MATH 18,A01,084117,Harel; Guershon,15,0,30,15
1649996825794,MATH 18,A02,084119,Harel; Guershon,28,0,30,2
1649996825794,MATH 18,A03,084120,Harel; Guershon,29,0,30,1
1649996825794,MATH 18,A04,084121,Harel; Guershon,29,0,30,1
1649996831836,MATH 20B,A01,084124,Um; Ko Woon,16,0,35,19
1649996831836,MATH 20B,B01,084126,Um; Ko Woon,26,0,35,9
1649996837876,MATH 20C,A01,083446,Hammock; Frances H,0,0,30,30
1649996837876,MATH 20C,A02,083447,Hammock; Frances H,17,0,30,13
1649996837876,MATH 20C,A03,083448,Hammock; Frances H,22,0,30,8
1649996837876,MATH 20C,A04,083449,Hammock; Frances H,22,0,30,8
1649996837876,MATH 20C,B01,083451,Hammock; Frances H,0,0,30,30
1649996837876,MATH 20C,B02,083452,Hammock; Frances H,21,0,30,9
1649996837876,MATH 20C,B03,083453,Hammock; Frances H,23,0,30,7
1649996837876,MATH 20C,B04,083454,Hammock; Frances H,25,0,30,5
1649996843910,MATH 20D,A01,084128,Staff,14,0,30,16
1649996843910,MATH 20D,A02,084129,Staff,29,0,30,1
1649996843910,MATH 20D,A03,084130,Staff,27,0,30,3
1649996843910,MATH 20D,B01,084133,Staff,4,0,30,26
1649996843910,MATH 20D,B02,084134,Staff,24,0,30,6
1649996843910,MATH 20D,B03,084135,Staff,28,0,30,2
1649996849943,MATH 20E,A01,084138,Staff,14,0,30,16
1649996849943,MATH 20E,A02,084139,Staff,7,0,30,23
1649996849943,MATH 20E,A03,084140,Staff,15,0,30,15
1649996849943,MATH 20E,A04,084141,Staff,20,0,30,10
1649996855965,MATH 102,A01,084143,Harel; Guershon,12,0,30,18
1649996855965,MATH 102,A02,084144,Harel; Guershon,20,0,30,10
1649996862000,MATH 103B,A01,083456,Staff,0,13,30,30
1649996862000,MATH 103B,A02,083457,Staff,0,12,30,30
1649996868022,MATH 109,A01,084146,Salehi Golsefidy; Alireza,18,0,30,12
1649996868022,MATH 109,A02,084147,Salehi Golsefidy; Alireza,16,0,30,14
1649996874064,MATH 120A,A01,085445,Eggers; John Dietrich,13,0,35,22
1649996874064,MATH 120A,A02,085446,Eggers; John Dietrich,27,0,35,8
1649996880095,MATH 142B,A01,084149,Verstraete; Jacques Allan,0,12,30,30
1649996880095,MATH 142B,A02,084150,Verstraete; Jacques Allan,0,12,30,30
1649996886124,MATH 170A,A01,083459,Nie; Jiawang,1,10,30,29
1649996886124,MATH 170A,A02,083460,Nie; Jiawang,0,6,30,30
1649996886124,MATH 170A,A03,083461,Nie; Jiawang,0,9,30,30
1649996892150,MATH 193B,A01,083463,Staff,1,0,30,29
1649996892150,MATH 193B,A02,083464,Staff,9,0,30,21
1649996892150,MATH 193B,A03,083465,Staff,18,0,30,12
1649996898211,COGS 2,A01,083966,Boyle; Mary E. T.,10,0,30,20
1649996904261,COGS 9,A01,083968,Staff,14,0,60,46
1649996910288,COGS 14B,A01,083970,Staff,11,0,50,39
1649996916318,COGS 17,A01,092679,Staff,53,0,75,22
1649996922349,COGS 100,A01,083972,Staff,0,15,60,60
1649996934403,COGS 101C,A01,083976,Staff,13,0,30,17
1649996940448,COGS 102A,A01,083978,Johnson; Christine M.,14,0,30,16
1649996946469,COGS 107B,A01,083980,Staff,0,7,50,50
1649996952497,COGS 115,A01,083982,Staff,11,0,30,19
1649996958599,COGS 118B,A01,083367,Staff,0,14,40,40
1649996964641,COGS 172,A01,083984,Provenzano; Emily Kara,15,0,30,15
1649996970664,COGS 177,A00,083368,Staff,0,20,30,30
1649996976711,COGS 186,A01,083986,Staff,21,0,40,19
1649996982737,COGS 187A,A01,083988,Boyle; Mary E. T.,19,0,60,41
1649996988767,CSE 8A,A50,084003,Miranda; Gregory Joseph,0,12,15,15
1649996994804,CSE 11,A01,084005,Miranda; Gregory Joseph,0,19,55,55
1649997000840,CSE 20,A01,084007,Staff,0,4,20,20
1649997006868,CSE 21,A01,084009,Staff,0,27,50,50
1649997012897,CSE 30,A01,083370,Cao; Yingjun,0,62,40,40
1649997018941,CSE 100,A01,083372,Cao; Yingjun,0,45,40,40
1649997024963,CSE 101,A01,084011,Staff,1,54,40,39
1649997030989,CSE 141,A01,083374,Eldon; John,0,63,75,75
1649997037015,CSE 141L,A01,083376,Eldon; John,0,69,75,75
1649997043054,CSE 175,A01,084013,Kumar; Rakesh,22,0,25,3
1649997049099,CSE 190,A00,092508,Dubnov; Shlomo,20,0,20,0
1649997055127,ECE 5,A01,084049,Morris; Karcher William,13,0,20,7
1649997061153,ECE 100,A01,084051,Baghdadchi; Saharnaz,0,0,20,20
1649997061153,ECE 100,A02,091916,Baghdadchi; Saharnaz,14,0,20,6
1649997067176,ECE 101,A01,084053,Baghdadchi; Saharnaz,1,0,37,36
1649997067176,ECE 101,A02,084054,Baghdadchi; Saharnaz,31,0,37,6
1649997073203,ECE 107,A01,083390,Staff,27,0,40,13
1649997079230,ECE 148,A01,084056,Silberman; Jack,8,0,12,4
1649997085260,ECE 180,A00,083391,Abi Samra; Nicholas Camill,25,0,30,5
1649997085260,ECE 180,B00,083392,Abi Samra; Nicholas Camill,21,0,30,9
1649997091287,MATH 10B,A01,084110,Staff,0,0,30,30
1649997091287,MATH 10B,A02,084111,Staff,20,0,30,10
1649997091287,MATH 10B,A03,084112,Staff,24,0,30,6
1649997097310,MATH 10C,A01,083443,Staff,1,14,30,29
1649997097310,MATH 10C,A02,083444,Staff,1,14,30,29
1649997097310,MATH 10C,B01,084114,Staff,19,0,30,11
1649997097310,MATH 10C,B02,084115,Staff,25,0,30,5
1649997103341,MATH 18,A01,084117,Harel; Guershon,15,0,30,15
1649997103341,MATH 18,A02,084119,Harel; Guershon,28,0,30,2
1649997103341,MATH 18,A03,084120,Harel; Guershon,29,0,30,1
1649997103341,MATH 18,A04,084121,Harel; Guershon,29,0,30,1
1649997109378,MATH 20B,A01,084124,Um; Ko Woon,16,0,35,19
1649997109378,MATH 20B,B01,084126,Um; Ko Woon,26,0,35,9
1649997115403,MATH 20C,A01,083446,Hammock; Frances H,0,0,30,30
1649997115403,MATH 20C,A02,083447,Hammock; Frances H,17,0,30,13
1649997115403,MATH 20C,A03,083448,Hammock; Frances H,22,0,30,8
1649997115403,MATH 20C,A04,083449,Hammock; Frances H,22,0,30,8
1649997115403,MATH 20C,B01,083451,Hammock; Frances H,0,0,30,30
1649997115403,MATH 20C,B02,083452,Hammock; Frances H,21,0,30,9
1649997115403,MATH 20C,B03,083453,Hammock; Frances H,23,0,30,7
1649997115403,MATH 20C,B04,083454,Hammock; Frances H,25,0,30,5
1649997121426,MATH 20D,A01,084128,Staff,14,0,30,16
1649997121426,MATH 20D,A02,084129,Staff,29,0,30,1
1649997121426,MATH 20D,A03,084130,Staff,27,0,30,3
1649997121426,MATH 20D,B01,084133,Staff,4,0,30,26
1649997121426,MATH 20D,B02,084134,Staff,24,0,30,6
1649997121426,MATH 20D,B03,084135,Staff,28,0,30,2
1649997127452,MATH 20E,A01,084138,Staff,14,0,30,16
1649997127452,MATH 20E,A02,084139,Staff,7,0,30,23
1649997127452,MATH 20E,A03,084140,Staff,15,0,30,15
1649997127452,MATH 20E,A04,084141,Staff,20,0,30,10
1649997133479,MATH 102,A01,084143,Harel; Guershon,12,0,30,18
1649997133479,MATH 102,A02,084144,Harel; Guershon,20,0,30,10
1649997139505,MATH 103B,A01,083456,Staff,0,13,30,30
1649997139505,MATH 103B,A02,083457,Staff,0,12,30,30
1649997145528,MATH 109,A01,084146,Salehi Golsefidy; Alireza,18,0,30,12
1649997145528,MATH 109,A02,084147,Salehi Golsefidy; Alireza,16,0,30,14
1649997151563,MATH 120A,A01,085445,Eggers; John Dietrich,13,0,35,22
1649997151563,MATH 120A,A02,085446,Eggers; John Dietrich,27,0,35,8
1649997157587,MATH 142B,A01,084149,Verstraete; Jacques Allan,0,12,30,30
1649997157587,MATH 142B,A02,084150,Verstraete; Jacques Allan,0,12,30,30
1649997163621,MATH 170A,A01,083459,Nie; Jiawang,1,10,30,29
1649997163621,MATH 170A,A02,083460,Nie; Jiawang,0,6,30,30
1649997163621,MATH 170A,A03,083461,Nie; Jiawang,0,9,30,30
1649997169650,MATH 193B,A01,083463,Staff,1,0,30,29
1649997169650,MATH 193B,A02,083464,Staff,9,0,30,21
1649997169650,MATH 193B,A03,083465,Staff,18,0,30,12
1649997175710,COGS 2,A01,083966,Boyle; Mary E. T.,10,0,30,20
1649997181739,COGS 9,A01,083968,Staff,14,0,60,46
1649997187763,COGS 14B,A01,083970,Staff,11,0,50,39
1649997193785,COGS 17,A01,092679,Staff,53,0,75,22
1649997199835,COGS 100,A01,083972,Staff,0,15,60,60
1649997211887,COGS 101C,A01,083976,Staff,13,0,30,17
1649997217912,COGS 102A,A01,083978,Johnson; Christine M.,14,0,30,16
1649997223935,COGS 107B,A01,083980,Staff,0,7,50,50
1649997229975,COGS 115,A01,083982,Staff,11,0,30,19
1649997236014,COGS 118B,A01,083367,Staff,0,14,40,40
1649997242038,COGS 172,A01,083984,Provenzano; Emily Kara,15,0,30,15
1649997248060,COGS 177,A00,083368,Staff,0,20,30,30
1649997254106,COGS 186,A01,083986,Staff,21,0,40,19
1649997260137,COGS 187A,A01,083988,Boyle; Mary E. T.,19,0,60,41
1649997266165,CSE 8A,A50,084003,Miranda; Gregory Joseph,0,12,15,15
1649997272188,CSE 11,A01,084005,Miranda; Gregory Joseph,0,19,55,55
1649997278211,CSE 20,A01,084007,Staff,0,4,20,20
1649997284235,CSE 21,A01,084009,Staff,0,27,50,50
1649997290260,CSE 30,A01,083370,Cao; Yingjun,0,62,40,40
1649997296283,CSE 100,A01,083372,Cao; Yingjun,0,45,40,40
1649997302311,CSE 101,A01,084011,Staff,1,54,40,39
1649997308333,CSE 141,A01,083374,Eldon; John,0,63,75,75
1649997314368,CSE 141L,A01,083376,Eldon; John,0,69,75,75
1649997320390,CSE 175,A01,084013,Kumar; Rakesh,22,0,25,3
1649997326414,CSE 190,A00,092508,Dubnov; Shlomo,20,0,20,0
1649997332453,ECE 5,A01,084049,Morris; Karcher William,13,0,20,7
1649997338484,ECE 100,A01,084051,Baghdadchi; Saharnaz,0,0,20,20
1649997338484,ECE 100,A02,091916,Baghdadchi; Saharnaz,14,0,20,6
1649997344508,ECE 101,A01,084053,Baghdadchi; Saharnaz,1,0,37,36
1649997344508,ECE 101,A02,084054,Baghdadchi; Saharnaz,31,0,37,6
1649997350540,ECE 107,A01,083390,Staff,27,0,40,13
1649997356570,ECE 148,A01,084056,Silberman; Jack,8,0,12,4
1649997362593,ECE 180,A00,083391,Abi Samra; Nicholas Camill,25,0,30,5
1649997362593,ECE 180,B00,083392,Abi Samra; Nicholas Camill,21,0,30,9
1649997368645,MATH 10B,A01,084110,Staff,0,0,30,30
1649997368645,MATH 10B,A02,084111,Staff,20,0,30,10
1649997368645,MATH 10B,A03,084112,Staff,24,0,30,6
1649997374669,MATH 10C,A01,083443,Staff,1,14,30,29
1649997374669,MATH 10C,A02,083444,Staff,1,14,30,29
1649997374669,MATH 10C,B01,084114,Staff,19,0,30,11
1649997374669,MATH 10C,B02,084115,Staff,25,0,30,5
1649997380693,MATH 18,A01,084117,Harel; Guershon,15,0,30,15
1649997380693,MATH 18,A02,084119,Harel; Guershon,28,0,30,2
1649997380693,MATH 18,A03,084120,Harel; Guershon,29,0,30,1
1649997380693,MATH 18,A04,084121,Harel; Guershon,29,0,30,1
1649997386742,MATH 20B,A01,084124,Um; Ko Woon,16,0,35,19
1649997386742,MATH 20B,B01,084126,Um; Ko Woon,26,0,35,9
1649997392789,MATH 20C,A01,083446,Hammock; Frances H,0,0,30,30
1649997392789,MATH 20C,A02,083447,Hammock; Frances H,17,0,30,13
1649997392789,MATH 20C,A03,083448,Hammock; Frances H,22,0,30,8
1649997392789,MATH 20C,A04,083449,Hammock; Frances H,21,0,30,9
1649997392789,MATH 20C,B01,083451,Hammock; Frances H,0,0,30,30
1649997392789,MATH 20C,B02,083452,Hammock; Frances H,21,0,30,9
1649997392789,MATH 20C,B03,083453,Hammock; Frances H,23,0,30,7
1649997392789,MATH 20C,B04,083454,Hammock; Frances H,25,0,30,5
1649997398813,MATH 20D,A01,084128,Staff,14,0,30,16
1649997398813,MATH 20D,A02,084129,Staff,29,0,30,1
1649997398813,MATH 20D,A03,084130,Staff,27,0,30,3
1649997398813,MATH 20D,B01,084133,Staff,4,0,30,26
1649997398813,MATH 20D,B02,084134,Staff,24,0,30,6
1649997398813,MATH 20D,B03,084135,Staff,28,0,30,2
1649997404837,MATH 20E,A01,084138,Staff,14,0,30,16
1649997404837,MATH 20E,A02,084139,Staff,7,0,30,23
1649997404837,MATH 20E,A03,084140,Staff,15,0,30,15
1649997404837,MATH 20E,A04,084141,Staff,20,0,30,10
1649997410880,MATH 102,A01,084143,Harel; Guershon,12,0,30,18
1649997410880,MATH 102,A02,084144,Harel; Guershon,20,0,30,10
1649997416907,MATH 103B,A01,083456,Staff,0,13,30,30
1649997416907,MATH 103B,A02,083457,Staff,0,12,30,30
1649997422931,MATH 109,A01,084146,Salehi Golsefidy; Alireza,18,0,30,12
1649997422931,MATH 109,A02,084147,Salehi Golsefidy; Alireza,16,0,30,14
1649997428955,MATH 120A,A01,085445,Eggers; John Dietrich,13,0,35,22
1649997428955,MATH 120A,A02,085446,Eggers; John Dietrich,27,0,35,8
1649997434978,MATH 142B,A01,084149,Verstraete; Jacques Allan,0,12,30,30
1649997434978,MATH 142B,A02,084150,Verstraete; Jacques Allan,0,12,30,30
1649997441009,MATH 170A,A01,083459,Nie; Jiawang,1,10,30,29
1649997441009,MATH 170A,A02,083460,Nie; Jiawang,0,6,30,30
1649997441009,MATH 170A,A03,083461,Nie; Jiawang,0,9,30,30
1649997447053,MATH 193B,A01,083463,Staff,1,0,30,29
1649997447053,MATH 193B,A02,083464,Staff,9,0,30,21
1649997447053,MATH 193B,A03,083465,Staff,18,0,30,12
1649997453115,COGS 2,A01,083966,Boyle; Mary E. T.,10,0,30,20
1649997459138,COGS 9,A01,083968,Staff,14,0,60,46
1649997465163,COGS 14B,A01,083970,Staff,11,0,50,39
1649997471192,COGS 17,A01,092679,Staff,53,0,75,22
1649997477217,COGS 100,A01,083972,Staff,0,15,60,60
1649997489263,COGS 101C,A01,083976,Staff,13,0,30,17
1649997495287,COGS 102A,A01,083978,Johnson; Christine M.,14,0,30,16
1649997501314,COGS 107B,A01,083980,Staff,0,7,50,50
1649997507360,COGS 115,A01,083982,Staff,11,0,30,19
1649997513382,COGS 118B,A01,083367,Staff,0,14,40,40
1649997519413,COGS 172,A01,083984,Provenzano; Emily Kara,15,0,30,15
1649997525441,COGS 177,A00,083368,Staff,0,20,30,30
1649997531474,COGS 186,A01,083986,Staff,21,0,40,19
1649997537501,COGS 187A,A01,083988,Boyle; Mary E. T.,19,0,60,41
1649997543526,CSE 8A,A50,084003,Miranda; Gregory Joseph,0,12,15,15
1649997549564,CSE 11,A01,084005,Miranda; Gregory Joseph,0,19,55,55
1649997555686,CSE 20,A01,084007,Staff,0,5,20,20
1649997561715,CSE 21,A01,084009,Staff,0,27,50,50
1649997567766,CSE 30,A01,083370,Cao; Yingjun,0,62,40,40
1649997573797,CSE 100,A01,083372,Cao; Yingjun,0,45,40,40
1649997579837,CSE 101,A01,084011,Staff,1,54,40,39
1649997585864,CSE 141,A01,083374,Eldon; John,0,63,75,75
1649997591913,CSE 141L,A01,083376,Eldon; John,0,69,75,75
1649997597939,CSE 175,A01,084013,Kumar; Rakesh,22,0,25,3
1649997603963,CSE 190,A00,092508,Dubnov; Shlomo,20,0,20,0
1649997609986,ECE 5,A01,084049,Morris; Karcher William,13,0,20,7
1649997616024,ECE 100,A01,084051,Baghdadchi; Saharnaz,0,0,20,20
1649997616024,ECE 100,A02,091916,Baghdadchi; Saharnaz,14,0,20,6
1649997622060,ECE 101,A01,084053,Baghdadchi; Saharnaz,1,0,37,36
1649997622060,ECE 101,A02,084054,Baghdadchi; Saharnaz,31,0,37,6
1649997628087,ECE 107,A01,083390,Staff,27,0,40,13
1649997634132,ECE 148,A01,084056,Silberman; Jack,8,0,12,4
1649997640157,ECE 180,A00,083391,Abi Samra; Nicholas Camill,25,0,30,5
1649997640157,ECE 180,B00,083392,Abi Samra; Nicholas Camill,21,0,30,9
1649997646184,MATH 10B,A01,084110,Staff,0,0,30,30
1649997646184,MATH 10B,A02,084111,Staff,20,0,30,10
1649997646184,MATH 10B,A03,084112,Staff,24,0,30,6
1649997652229,MATH 10C,A01,083443,Staff,1,15,30,29
1649997652229,MATH 10C,A02,083444,Staff,1,14,30,29
1649997652229,MATH 10C,B01,084114,Staff,19,0,30,11
1649997652229,MATH 10C,B02,084115,Staff,25,0,30,5
1649997658272,MATH 18,A01,084117,Harel; Guershon,15,0,30,15
1649997658272,MATH 18,A02,084119,Harel; Guershon,28,0,30,2
1649997658272,MATH 18,A03,084120,Harel; Guershon,29,0,30,1
1649997658272,MATH 18,A04,084121,Harel; Guershon,29,0,30,1
1649997664298,MATH 20B,A01,084124,Um; Ko Woon,16,0,35,19
1649997664298,MATH 20B,B01,084126,Um; Ko Woon,26,0,35,9
1649997670323,MATH 20C,A01,083446,Hammock; Frances H,0,0,30,30
1649997670323,MATH 20C,A02,083447,Hammock; Frances H,17,0,30,13
1649997670323,MATH 20C,A03,083448,Hammock; Frances H,22,0,30,8
1649997670323,MATH 20C,A04,083449,Hammock; Frances H,21,0,30,9
1649997670323,MATH 20C,B01,083451,Hammock; Frances H,0,0,30,30
1649997670323,MATH 20C,B02,083452,Hammock; Frances H,21,0,30,9
1649997670323,MATH 20C,B03,083453,Hammock; Frances H,23,0,30,7
1649997670323,MATH 20C,B04,083454,Hammock; Frances H,25,0,30,5
1649997676349,MATH 20D,A01,084128,Staff,14,0,30,16
1649997676349,MATH 20D,A02,084129,Staff,29,0,30,1
1649997676349,MATH 20D,A03,084130,Staff,27,0,30,3
1649997676349,MATH 20D,B01,084133,Staff,4,0,30,26
1649997676349,MATH 20D,B02,084134,Staff,24,0,30,6
1649997676349,MATH 20D,B03,084135,Staff,28,0,30,2
1649997682376,MATH 20E,A01,084138,Staff,14,0,30,16
1649997682376,MATH 20E,A02,084139,Staff,7,0,30,23
1649997682376,MATH 20E,A03,084140,Staff,15,0,30,15
1649997682376,MATH 20E,A04,084141,Staff,20,0,30,10
1649997688403,MATH 102,A01,084143,Harel; Guershon,12,0,30,18
1649997688403,MATH 102,A02,084144,Harel; Guershon,20,0,30,10
1649997694431,MATH 103B,A01,083456,Staff,0,13,30,30
1649997694431,MATH 103B,A02,083457,Staff,0,12,30,30
1649997700459,MATH 109,A01,084146,Salehi Golsefidy; Alireza,18,0,30,12
1649997700459,MATH 109,A02,084147,Salehi Golsefidy; Alireza,16,0,30,14
1649997706482,MATH 120A,A01,085445,Eggers; John Dietrich,13,0,35,22
1649997706482,MATH 120A,A02,085446,Eggers; John Dietrich,27,0,35,8
1649997712509,MATH 142B,A01,084149,Verstraete; Jacques Allan,0,12,30,30
1649997712509,MATH 142B,A02,084150,Verstraete; Jacques Allan,0,12,30,30
1649997718532,MATH 170A,A01,083459,Nie; Jiawang,1,10,30,29
1649997718532,MATH 170A,A02,083460,Nie; Jiawang,0,6,30,30
1649997718532,MATH 170A,A03,083461,Nie; Jiawang,0,9,30,30
1649997724556,MATH 193B,A01,083463,Staff,1,0,30,29
1649997724556,MATH 193B,A02,083464,Staff,9,0,30,21
1649997724556,MATH 193B,A03,083465,Staff,18,0,30,12
1649997730676,COGS 2,A01,083966,Boyle; Mary E. T.,10,0,30,20
1649997736698,COGS 9,A01,083968,Staff,14,0,60,46
1649997742722,COGS 14B,A01,083970,Staff,11,0,50,39
1649997748755,COGS 17,A01,092679,Staff,53,0,75,22
1649997754804,COGS 100,A01,083972,Staff,0,15,60,60
1649997766852,COGS 101C,A01,083976,Staff,13,0,30,17
1649997772876,COGS 102A,A01,083978,Johnson; Christine M.,14,0,30,16
1649997778908,COGS 107B,A01,083980,Staff,0,7,50,50
1649997784943,COGS 115,A01,083982,Staff,11,0,30,19
1649997790973,COGS 118B,A01,083367,Staff,0,14,40,40
1649997797029,COGS 172,A01,083984,Provenzano; Emily Kara,15,0,30,15
1649997803053,COGS 177,A00,083368,Staff,0,20,30,30
1649997816405,COGS 186,A01,083986,Staff,21,0,40,19
1649997822437,COGS 187A,A01,083988,Boyle; Mary E. T.,19,0,60,41
1649997828465,CSE 8A,A50,084003,Miranda; Gregory Joseph,0,12,15,15
1649997834507,CSE 11,A01,084005,Miranda; Gregory Joseph,0,19,55,55
1649997840532,CSE 20,A01,084007,Staff,0,5,20,20
1649997846556,CSE 21,A01,084009,Staff,0,27,50,50
1649997852580,CSE 30,A01,083370,Cao; Yingjun,0,63,40,40
1649997858606,CSE 100,A01,083372,Cao; Yingjun,0,45,40,40
1649997864637,CSE 101,A01,084011,Staff,1,54,40,39
1649997870672,CSE 141,A01,083374,Eldon; John,0,63,75,75
1649997876698,CSE 141L,A01,083376,Eldon; John,0,69,75,75
1649997882737,CSE 175,A01,084013,Kumar; Rakesh,22,0,25,3
1649997888763,CSE 190,A00,092508,Dubnov; Shlomo,20,0,20,0
1649997894786,ECE 5,A01,084049,Morris; Karcher William,13,0,20,7
1649997900817,ECE 100,A01,084051,Baghdadchi; Saharnaz,0,0,20,20
1649997900817,ECE 100,A02,091916,Baghdadchi; Saharnaz,14,0,20,6
1649997906839,ECE 101,A01,084053,Baghdadchi; Saharnaz,1,0,37,36
1649997906839,ECE 101,A02,084054,Baghdadchi; Saharnaz,31,0,37,6
1649997912867,ECE 107,A01,083390,Staff,27,0,40,13
1649997918888,ECE 148,A01,084056,Silberman; Jack,8,0,12,4
1649997924913,ECE 180,A00,083391,Abi Samra; Nicholas Camill,25,0,30,5
1649997924913,ECE 180,B00,083392,Abi Samra; Nicholas Camill,21,0,30,9
1649997930936,MATH 10B,A01,084110,Staff,0,0,30,30
1649997930936,MATH 10B,A02,084111,Staff,20,0,30,10
1649997930936,MATH 10B,A03,084112,Staff,24,0,30,6
1649997936964,MATH 10C,A01,083443,Staff,1,15,30,29
1649997936964,MATH 10C,A02,083444,Staff,1,14,30,29
1649997936964,MATH 10C,B01,084114,Staff,19,0,30,11
1649997936964,MATH 10C,B02,084115,Staff,25,0,30,5
1649997943000,MATH 18,A01,084117,Harel; Guershon,15,0,30,15
1649997943000,MATH 18,A02,084119,Harel; Guershon,28,0,30,2
1649997943000,MATH 18,A03,084120,Harel; Guershon,29,0,30,1
1649997943000,MATH 18,A04,084121,Harel; Guershon,29,0,30,1
1649997949027,MATH 20B,A01,084124,Um; Ko Woon,16,0,35,19
1649997949027,MATH 20B,B01,084126,Um; Ko Woon,26,0,35,9
1649997955069,MATH 20C,A01,083446,Hammock; Frances H,0,0,30,30
1649997955069,MATH 20C,A02,083447,Hammock; Frances H,17,0,30,13
1649997955069,MATH 20C,A03,083448,Hammock; Frances H,22,0,30,8
1649997955069,MATH 20C,A04,083449,Hammock; Frances H,21,0,30,9
1649997955069,MATH 20C,B01,083451,Hammock; Frances H,0,0,30,30
1649997955069,MATH 20C,B02,083452,Hammock; Frances H,21,0,30,9
1649997955069,MATH 20C,B03,083453,Hammock; Frances H,23,0,30,7
1649997955069,MATH 20C,B04,083454,Hammock; Frances H,25,0,30,5
1649997961120,MATH 20D,A01,084128,Staff,14,0,30,16
1649997961120,MATH 20D,A02,084129,Staff,29,0,30,1
1649997961120,MATH 20D,A03,084130,Staff,27,0,30,3
1649997961120,MATH 20D,B01,084133,Staff,4,0,30,26
1649997961120,MATH 20D,B02,084134,Staff,24,0,30,6
1649997961120,MATH 20D,B03,084135,Staff,28,0,30,2
1649997967147,MATH 20E,A01,084138,Staff,14,0,30,16
1649997967147,MATH 20E,A02,084139,Staff,7,0,30,23
1649997967147,MATH 20E,A03,084140,Staff,15,0,30,15
1649997967147,MATH 20E,A04,084141,Staff,20,0,30,10
1649997973189,MATH 102,A01,084143,Harel; Guershon,12,0,30,18
1649997973189,MATH 102,A02,084144,Harel; Guershon,20,0,30,10
1649997979242,MATH 103B,A01,083456,Staff,0,13,30,30
1649997979242,MATH 103B,A02,083457,Staff,0,12,30,30
1649997985266,MATH 109,A01,084146,Salehi Golsefidy; Alireza,18,0,30,12
1649997985266,MATH 109,A02,084147,Salehi Golsefidy; Alireza,16,0,30,14
1649997991301,MATH 120A,A01,085445,Eggers; John Dietrich,13,0,35,22
1649997991301,MATH 120A,A02,085446,Eggers; John Dietrich,27,0,35,8
1649997997325,MATH 142B,A01,084149,Verstraete; Jacques Allan,0,12,30,30
1649997997325,MATH 142B,A02,084150,Verstraete; Jacques Allan,0,12,30,30
1649998003352,MATH 170A,A01,083459,Nie; Jiawang,1,10,30,29
1649998003352,MATH 170A,A02,083460,Nie; Jiawang,0,6,30,30
1649998003352,MATH 170A,A03,083461,Nie; Jiawang,0,9,30,30
1649998009379,MATH 193B,A01,083463,Staff,1,0,30,29
1649998009379,MATH 193B,A02,083464,Staff,9,0,30,21
1649998009379,MATH 193B,A03,083465,Staff,18,0,30,12
1649998015446,COGS 2,A01,083966,Boyle; Mary E. T.,10,0,30,20
1649998021479,COGS 9,A01,083968,Staff,14,0,60,46
1649998027516,COGS 14B,A01,083970,Staff,11,0,50,39
1649998033539,COGS 17,A01,092679,Staff,53,0,75,22
1649998039565,COGS 100,A01,083972,Staff,0,15,60,60
1649998051614,COGS 101C,A01,083976,Staff,13,0,30,17
1649998057639,COGS 102A,A01,083978,Johnson; Christine M.,14,0,30,16
1649998063695,COGS 107B,A01,083980,Staff,0,7,50,50
1649998069719,COGS 115,A01,083982,Staff,11,0,30,19
1649998075742,COGS 118B,A01,083367,Staff,0,14,40,40
1649998081772,COGS 172,A01,083984,Provenzano; Emily Kara,15,0,30,15
1649998087799,COGS 177,A00,083368,Staff,0,20,30,30
1649998093842,COGS 186,A01,083986,Staff,21,0,40,19
1649998099864,COGS 187A,A01,083988,Boyle; Mary E. T.,19,0,60,41
1649998105895,CSE 8A,A50,084003,Miranda; Gregory Joseph,0,12,15,15
1649998111931,CSE 11,A01,084005,Miranda; Gregory Joseph,0,19,55,55
1649998117965,CSE 20,A01,084007,Staff,0,5,20,20
1649998123989,CSE 21,A01,084009,Staff,0,27,50,50
1649998130037,CSE 30,A01,083370,Cao; Yingjun,0,63,40,40
1649998136063,CSE 100,A01,083372,Cao; Yingjun,0,45,40,40
1649998142094,CSE 101,A01,084011,Staff,1,54,40,39
1649998148123,CSE 141,A01,083374,Eldon; John,0,63,75,75
1649998154147,CSE 141L,A01,083376,Eldon; John,0,69,75,75
1649998160263,CSE 175,A01,084013,Kumar; Rakesh,22,0,25,3
1649998166298,CSE 190,A00,092508,Dubnov; Shlomo,20,0,20,0
1649998172344,ECE 5,A01,084049,Morris; Karcher William,13,0,20,7
1649998178379,ECE 100,A01,084051,Baghdadchi; Saharnaz,0,0,20,20
1649998178379,ECE 100,A02,091916,Baghdadchi; Saharnaz,14,0,20,6
1649998184402,ECE 101,A01,084053,Baghdadchi; Saharnaz,1,0,37,36
1649998184402,ECE 101,A02,084054,Baghdadchi; Saharnaz,31,0,37,6
1649998190436,ECE 107,A01,083390,Staff,27,0,40,13
1649998196466,ECE 148,A01,084056,Silberman; Jack,8,0,12,4
1649998202491,ECE 180,A00,083391,Abi Samra; Nicholas Camill,25,0,30,5
1649998202491,ECE 180,B00,083392,Abi Samra; Nicholas Camill,21,0,30,9
1649998208518,MATH 10B,A01,084110,Staff,0,0,30,30
1649998208518,MATH 10B,A02,084111,Staff,20,0,30,10
1649998208518,MATH 10B,A03,084112,Staff,24,0,30,6
1649998214548,MATH 10C,A01,083443,Staff,1,15,30,29
1649998214548,MATH 10C,A02,083444,Staff,1,14,30,29
1649998214548,MATH 10C,B01,084114,Staff,19,0,30,11
1649998214548,MATH 10C,B02,084115,Staff,25,0,30,5
1649998220575,MATH 18,A01,084117,Harel; Guershon,15,0,30,15
1649998220575,MATH 18,A02,084119,Harel; Guershon,28,0,30,2
1649998220575,MATH 18,A03,084120,Harel; Guershon,29,0,30,1
1649998220575,MATH 18,A04,084121,Harel; Guershon,29,0,30,1
1649998226607,MATH 20B,A01,084124,Um; Ko Woon,16,0,35,19
1649998226607,MATH 20B,B01,084126,Um; Ko Woon,26,0,35,9
1649998232660,MATH 20C,A01,083446,Hammock; Frances H,0,0,30,30
1649998232660,MATH 20C,A02,083447,Hammock; Frances H,16,0,30,14
1649998232660,MATH 20C,A03,083448,Hammock; Frances H,22,0,30,8
1649998232660,MATH 20C,A04,083449,Hammock; Frances H,21,0,30,9
1649998232660,MATH 20C,B01,083451,Hammock; Frances H,0,0,30,30
1649998232660,MATH 20C,B02,083452,Hammock; Frances H,21,0,30,9
1649998232660,MATH 20C,B03,083453,Hammock; Frances H,23,0,30,7
1649998232660,MATH 20C,B04,083454,Hammock; Frances H,25,0,30,5
1649998238706,MATH 20D,A01,084128,Staff,14,0,30,16
1649998238706,MATH 20D,A02,084129,Staff,29,0,30,1
1649998238706,MATH 20D,A03,084130,Staff,27,0,30,3
1649998238706,MATH 20D,B01,084133,Staff,4,0,30,26
1649998238706,MATH 20D,B02,084134,Staff,24,0,30,6
1649998238706,MATH 20D,B03,084135,Staff,28,0,30,2
1649998244744,MATH 20E,A01,084138,Staff,14,0,30,16
1649998244744,MATH 20E,A02,084139,Staff,7,0,30,23
1649998244744,MATH 20E,A03,084140,Staff,15,0,30,15
1649998244744,MATH 20E,A04,084141,Staff,20,0,30,10
1649998250772,MATH 102,A01,084143,Harel; Guershon,12,0,30,18
1649998250772,MATH 102,A02,084144,Harel; Guershon,20,0,30,10
1649998256804,MATH 103B,A01,083456,Staff,0,13,30,30
1649998256804,MATH 103B,A02,083457,Staff,0,12,30,30
1649998262834,MATH 109,A01,084146,Salehi Golsefidy; Alireza,18,0,30,12
1649998262834,MATH 109,A02,084147,Salehi Golsefidy; Alireza,16,0,30,14
1649998268862,MATH 120A,A01,085445,Eggers; John Dietrich,13,0,35,22
1649998268862,MATH 120A,A02,085446,Eggers; John Dietrich,27,0,35,8
1649998274885,MATH 142B,A01,084149,Verstraete; Jacques Allan,0,12,30,30
1649998274885,MATH 142B,A02,084150,Verstraete; Jacques Allan,0,12,30,30
1649998280935,MATH 170A,A01,083459,Nie; Jiawang,1,10,30,29
1649998280935,MATH 170A,A02,083460,Nie; Jiawang,0,6,30,30
1649998280935,MATH 170A,A03,083461,Nie; Jiawang,0,9,30,30
1649998286966,MATH 193B,A01,083463,Staff,1,0,30,29
1649998286966,MATH 193B,A02,083464,Staff,9,0,30,21
1649998286966,MATH 193B,A03,083465,Staff,18,0,30,12
1649998293027,COGS 2,A01,083966,Boyle; Mary E. T.,10,0,30,20
1649998299051,COGS 9,A01,083968,Staff,13,0,60,47
1649998305076,COGS 14B,A01,083970,Staff,11,0,50,39
1649998311111,COGS 17,A01,092679,Staff,53,0,75,22
1649998317141,COGS 100,A01,083972,Staff,0,15,60,60
1649998329184,COGS 101C,A01,083976,Staff,13,0,30,17
1649998335221,COGS 102A,A01,083978,Johnson; Christine M.,14,0,30,16
1649998341249,COGS 107B,A01,083980,Staff,0,7,50,50
1649998347273,COGS 115,A01,083982,Staff,11,0,30,19
1649998353295,COGS 118B,A01,083367,Staff,0,14,40,40
1649998359317,COGS 172,A01,083984,Provenzano; Emily Kara,15,0,30,15
1649998365341,COGS 177,A00,083368,Staff,0,20,30,30
1649998371369,COGS 186,A01,083986,Staff,21,0,40,19
1649998377394,COGS 187A,A01,083988,Boyle; Mary E. T.,19,0,60,41
1649998383438,CSE 8A,A50,084003,Miranda; Gregory Joseph,0,13,15,15
1649998389462,CSE 11,A01,084005,Miranda; Gregory Joseph,0,19,55,55
1649998395498,CSE 20,A01,084007,Staff,0,5,20,20
1649998401530,CSE 21,A01,084009,Staff,0,27,50,50
1649998407555,CSE 30,A01,083370,Cao; Yingjun,0,63,40,40
1649998413592,CSE 100,A01,083372,Cao; Yingjun,0,45,40,40
1649998419632,CSE 101,A01,084011,Staff,1,54,40,39
1649998425673,CSE 141,A01,083374,Eldon; John,0,63,75,75
1649998431697,CSE 141L,A01,083376,Eldon; John,0,69,75,75
1649998437724,CSE 175,A01,084013,Kumar; Rakesh,22,0,25,3
1649998443775,CSE 190,A00,092508,Dubnov; Shlomo,20,0,20,0
1649998449798,ECE 5,A01,084049,Morris; Karcher William,13,0,20,7
1649998455821,ECE 100,A01,084051,Baghdadchi; Saharnaz,0,0,20,20
1649998455821,ECE 100,A02,091916,Baghdadchi; Saharnaz,14,0,20,6
1649998461845,ECE 101,A01,084053,Baghdadchi; Saharnaz,1,0,37,36
1649998461845,ECE 101,A02,084054,Baghdadchi; Saharnaz,31,0,37,6
1649998467872,ECE 107,A01,083390,Staff,27,0,40,13
1649998473895,ECE 148,A01,084056,Silberman; Jack,8,0,12,4
1649998479933,ECE 180,A00,083391,Abi Samra; Nicholas Camill,25,0,30,5
1649998479933,ECE 180,B00,083392,Abi Samra; Nicholas Camill,21,0,30,9
1649998485958,MATH 10B,A01,084110,Staff,0,0,30,30
1649998485958,MATH 10B,A02,084111,Staff,20,0,30,10
1649998485958,MATH 10B,A03,084112,Staff,24,0,30,6
1649998491997,MATH 10C,A01,083443,Staff,1,15,30,29
1649998491997,MATH 10C,A02,083444,Staff,1,14,30,29
1649998491997,MATH 10C,B01,084114,Staff,19,0,30,11
1649998491997,MATH 10C,B02,084115,Staff,25,0,30,5
1649998498023,MATH 18,A01,084117,Harel; Guershon,15,0,30,15
1649998498023,MATH 18,A02,084119,Harel; Guershon,28,0,30,2
1649998498023,MATH 18,A03,084120,Harel; Guershon,29,0,30,1
1649998498023,MATH 18,A04,084121,Harel; Guershon,29,0,30,1
1649998504047,MATH 20B,A01,084124,Um; Ko Woon,16,0,35,19
1649998504047,MATH 20B,B01,084126,Um; Ko Woon,26,0,35,9
1649998510075,MATH 20C,A01,083446,Hammock; Frances H,0,0,30,30
1649998510075,MATH 20C,A02,083447,Hammock; Frances H,16,0,30,14
1649998510075,MATH 20C,A03,083448,Hammock; Frances H,22,0,30,8
1649998510075,MATH 20C,A04,083449,Hammock; Frances H,21,0,30,9
1649998510075,MATH 20C,B01,083451,Hammock; Frances H,0,0,30,30
1649998510075,MATH 20C,B02,083452,Hammock; Frances H,21,0,30,9
1649998510075,MATH 20C,B03,083453,Hammock; Frances H,23,0,30,7
1649998510075,MATH 20C,B04,083454,Hammock; Frances H,25,0,30,5
1649998516098,MATH 20D,A01,084128,Staff,14,0,30,16
1649998516098,MATH 20D,A02,084129,Staff,29,0,30,1
1649998516098,MATH 20D,A03,084130,Staff,27,0,30,3
1649998516098,MATH 20D,B01,084133,Staff,4,0,30,26
1649998516098,MATH 20D,B02,084134,Staff,24,0,30,6
1649998516098,MATH 20D,B03,084135,Staff,28,0,30,2
1649998522122,MATH 20E,A01,084138,Staff,14,0,30,16
1649998522122,MATH 20E,A02,084139,Staff,7,0,30,23
1649998522122,MATH 20E,A03,084140,Staff,15,0,30,15
1649998522122,MATH 20E,A04,084141,Staff,20,0,30,10
1649998528146,MATH 102,A01,084143,Harel; Guershon,12,0,30,18
1649998528146,MATH 102,A02,084144,Harel; Guershon,20,0,30,10
1649998534178,MATH 103B,A01,083456,Staff,0,13,30,30
1649998534178,MATH 103B,A02,083457,Staff,0,12,30,30
1649998540223,MATH 109,A01,084146,Salehi Golsefidy; Alireza,18,0,30,12
1649998540223,MATH 109,A02,084147,Salehi Golsefidy; Alireza,16,0,30,14
1649998546247,MATH 120A,A01,085445,Eggers; John Dietrich,13,0,35,22
1649998546247,MATH 120A,A02,085446,Eggers; John Dietrich,27,0,35,8
1649998552272,MATH 142B,A01,084149,Verstraete; Jacques Allan,0,12,30,30
1649998552272,MATH 142B,A02,084150,Verstraete; Jacques Allan,0,12,30,30
1649998558301,MATH 170A,A01,083459,Nie; Jiawang,1,10,30,29
1649998558301,MATH 170A,A02,083460,Nie; Jiawang,0,6,30,30
1649998558301,MATH 170A,A03,083461,Nie; Jiawang,0,9,30,30
1649998564324,MATH 193B,A01,083463,Staff,1,0,30,29
1649998564324,MATH 193B,A02,083464,Staff,9,0,30,21
1649998564324,MATH 193B,A03,083465,Staff,18,0,30,12
1649998570386,COGS 2,A01,083966,Boyle; Mary E. T.,10,0,30,20
1649998576414,COGS 9,A01,083968,Staff,13,0,60,47
1649998582448,COGS 14B,A01,083970,Staff,11,0,50,39
1649998588473,COGS 17,A01,092679,Staff,53,0,75,22
1649998594496,COGS 100,A01,083972,Staff,0,15,60,60
1649998606547,COGS 101C,A01,083976,Staff,13,0,30,17
1649998612578,COGS 102A,A01,083978,Johnson; Christine M.,14,0,30,16
1649998618604,COGS 107B,A01,083980,Staff,0,7,50,50
1649998624630,COGS 115,A01,083982,Staff,11,0,30,19
1649998630656,COGS 118B,A01,083367,Staff,0,14,40,40
1649998636684,COGS 172,A01,083984,Provenzano; Emily Kara,15,0,30,15
1649998642724,COGS 177,A00,083368,Staff,0,20,30,30
1649998648748,COGS 186,A01,083986,Staff,21,0,40,19
1649998654776,COGS 187A,A01,083988,Boyle; Mary E. T.,19,0,60,41
1649998660800,CSE 8A,A50,084003,Miranda; Gregory Joseph,0,13,15,15
1649998666825,CSE 11,A01,084005,Miranda; Gregory Joseph,0,19,55,55
1649998672861,CSE 20,A01,084007,Staff,0,5,20,20
1649998678888,CSE 21,A01,084009,Staff,0,27,50,50
1649998684910,CSE 30,A01,083370,Cao; Yingjun,0,63,40,40
1649998690943,CSE 100,A01,083372,Cao; Yingjun,0,45,40,40
1649998696967,CSE 101,A01,084011,Staff,1,54,40,39
1649998702996,CSE 141,A01,083374,Eldon; John,0,63,75,75
1649998709018,CSE 141L,A01,083376,Eldon; John,0,69,75,75
1649998715056,CSE 175,A01,084013,Kumar; Rakesh,22,0,25,3
1649998721081,CSE 190,A00,092508,Dubnov; Shlomo,20,0,20,0
1649998727103,ECE 5,A01,084049,Morris; Karcher William,13,0,20,7
1649998733139,ECE 100,A01,084051,Baghdadchi; Saharnaz,0,0,20,20
1649998733139,ECE 100,A02,091916,Baghdadchi; Saharnaz,14,0,20,6
1649998739175,ECE 101,A01,084053,Baghdadchi; Saharnaz,1,0,37,36
1649998739175,ECE 101,A02,084054,Baghdadchi; Saharnaz,31,0,37,6
1649998745212,ECE 107,A01,083390,Staff,27,0,40,13
1649998751257,ECE 148,A01,084056,Silberman; Jack,8,0,12,4
1649998757374,ECE 180,A00,083391,Abi Samra; Nicholas Camill,25,0,30,5
1649998757374,ECE 180,B00,083392,Abi Samra; Nicholas Camill,21,0,30,9
1649998763403,MATH 10B,A01,084110,Staff,0,0,30,30
1649998763403,MATH 10B,A02,084111,Staff,20,0,30,10
1649998763403,MATH 10B,A03,084112,Staff,24,0,30,6
1649998769430,MATH 10C,A01,083443,Staff,1,15,30,29
1649998769430,MATH 10C,A02,083444,Staff,1,14,30,29
1649998769430,MATH 10C,B01,084114,Staff,19,0,30,11
1649998769430,MATH 10C,B02,084115,Staff,25,0,30,5
1649998775458,MATH 18,A01,084117,Harel; Guershon,15,0,30,15
1649998775458,MATH 18,A02,084119,Harel; Guershon,28,0,30,2
1649998775458,MATH 18,A03,084120,Harel; Guershon,29,0,30,1
1649998775458,MATH 18,A04,084121,Harel; Guershon,29,0,30,1
1649998781495,MATH 20B,A01,084124,Um; Ko Woon,16,0,35,19
1649998781495,MATH 20B,B01,084126,Um; Ko Woon,26,0,35,9
1649998787520,MATH 20C,A01,083446,Hammock; Frances H,0,0,30,30
1649998787520,MATH 20C,A02,083447,Hammock; Frances H,16,0,30,14
1649998787520,MATH 20C,A03,083448,Hammock; Frances H,22,0,30,8
1649998787520,MATH 20C,A04,083449,Hammock; Frances H,21,0,30,9
1649998787520,MATH 20C,B01,083451,Hammock; Frances H,0,0,30,30
1649998787520,MATH 20C,B02,083452,Hammock; Frances H,21,0,30,9
1649998787520,MATH 20C,B03,083453,Hammock; Frances H,23,0,30,7
1649998787520,MATH 20C,B04,083454,Hammock; Frances H,25,0,30,5
1649998793547,MATH 20D,A01,084128,Staff,14,0,30,16
1649998793547,MATH 20D,A02,084129,Staff,29,0,30,1
1649998793547,MATH 20D,A03,084130,Staff,27,0,30,3
1649998793547,MATH 20D,B01,084133,Staff,4,0,30,26
1649998793547,MATH 20D,B02,084134,Staff,24,0,30,6
1649998793547,MATH 20D,B03,084135,Staff,28,0,30,2
1649998799577,MATH 20E,A01,084138,Staff,14,0,30,16
1649998799577,MATH 20E,A02,084139,Staff,7,0,30,23
1649998799577,MATH 20E,A03,084140,Staff,15,0,30,15
1649998799577,MATH 20E,A04,084141,Staff,20,0,30,10
1649998805602,MATH 102,A01,084143,Harel; Guershon,12,0,30,18
1649998805602,MATH 102,A02,084144,Harel; Guershon,20,0,30,10
1649998811628,MATH 103B,A01,083456,Staff,0,13,30,30
1649998811628,MATH 103B,A02,083457,Staff,0,12,30,30
1649998817650,MATH 109,A01,084146,Salehi Golsefidy; Alireza,18,0,30,12
1649998817650,MATH 109,A02,084147,Salehi Golsefidy; Alireza,16,0,30,14
1649998823678,MATH 120A,A01,085445,Eggers; John Dietrich,12,0,35,23
1649998823678,MATH 120A,A02,085446,Eggers; John Dietrich,27,0,35,8
1649998829701,MATH 142B,A01,084149,Verstraete; Jacques Allan,0,12,30,30
1649998829701,MATH 142B,A02,084150,Verstraete; Jacques Allan,0,12,30,30
1649998835723,MATH 170A,A01,083459,Nie; Jiawang,1,10,30,29
1649998835723,MATH 170A,A02,083460,Nie; Jiawang,0,6,30,30
1649998835723,MATH 170A,A03,083461,Nie; Jiawang,0,9,30,30
1649998841751,MATH 193B,A01,083463,Staff,1,0,30,29
1649998841751,MATH 193B,A02,083464,Staff,9,0,30,21
1649998841751,MATH 193B,A03,083465,Staff,18,0,30,12
1649998847823,COGS 2,A01,083966,Boyle; Mary E. T.,10,0,30,20
1649998853847,COGS 9,A01,083968,Staff,13,0,60,47
1649998859873,COGS 14B,A01,083970,Staff,11,0,50,39
1649998865907,COGS 17,A01,092679,Staff,53,0,75,22
1649998871930,COGS 100,A01,083972,Staff,0,15,60,60
1649998883992,COGS 101C,A01,083976,Staff,13,0,30,17
1649998890017,COGS 102A,A01,083978,Johnson; Christine M.,14,0,30,16
1649998896043,COGS 107B,A01,083980,Staff,0,7,50,50
1649998902075,COGS 115,A01,083982,Staff,11,0,30,19
1649998908099,COGS 118B,A01,083367,Staff,0,14,40,40
1649998914124,COGS 172,A01,083984,Provenzano; Emily Kara,15,0,30,15
1649998920149,COGS 177,A00,083368,Staff,0,20,30,30
1649998926175,COGS 186,A01,083986,Staff,21,0,40,19
1649998932200,COGS 187A,A01,083988,Boyle; Mary E. T.,19,0,60,41
1649998938234,CSE 8A,A50,084003,Miranda; Gregory Joseph,0,13,15,15
1649998944256,CSE 11,A01,084005,Miranda; Gregory Joseph,0,19,55,55
1649998950280,CSE 20,A01,084007,Staff,0,5,20,20
1649998956302,CSE 21,A01,084009,Staff,0,27,50,50
1649998962329,CSE 30,A01,083370,Cao; Yingjun,0,63,40,40
1649998968359,CSE 100,A01,083372,Cao; Yingjun,0,45,40,40
1649998974414,CSE 101,A01,084011,Staff,1,54,40,39
1649998980445,CSE 141,A01,083374,Eldon; John,0,63,75,75
1649998986469,CSE 141L,A01,083376,Eldon; John,0,69,75,75
1649998992496,CSE 175,A01,084013,Kumar; Rakesh,22,0,25,3
1649998998535,CSE 190,A00,092508,Dubnov; Shlomo,20,0,20,0
1649999004557,ECE 5,A01,084049,Morris; Karcher William,13,0,20,7
1649999010581,ECE 100,A01,084051,Baghdadchi; Saharnaz,0,0,20,20
1649999010581,ECE 100,A02,091916,Baghdadchi; Saharnaz,14,0,20,6
1649999016607,ECE 101,A01,084053,Baghdadchi; Saharnaz,1,0,37,36
1649999016607,ECE 101,A02,084054,Baghdadchi; Saharnaz,31,0,37,6
1649999022636,ECE 107,A01,083390,Staff,27,0,40,13
1649999028659,ECE 148,A01,084056,Silberman; Jack,8,0,12,4
1649999034687,ECE 180,A00,083391,Abi Samra; Nicholas Camill,25,0,30,5
1649999034687,ECE 180,B00,083392,Abi Samra; Nicholas Camill,21,0,30,9
1649999040710,MATH 10B,A01,084110,Staff,0,0,30,30
1649999040710,MATH 10B,A02,084111,Staff,20,0,30,10
1649999040710,MATH 10B,A03,084112,Staff,24,0,30,6
1649999046733,MATH 10C,A01,083443,Staff,1,15,30,29
1649999046733,MATH 10C,A02,083444,Staff,1,14,30,29
1649999046733,MATH 10C,B01,084114,Staff,19,0,30,11
1649999046733,MATH 10C,B02,084115,Staff,25,0,30,5
1649999052757,MATH 18,A01,084117,Harel; Guershon,15,0,30,15
1649999052757,MATH 18,A02,084119,Harel; Guershon,28,0,30,2
1649999052757,MATH 18,A03,084120,Harel; Guershon,29,0,30,1
1649999052757,MATH 18,A04,084121,Harel; Guershon,29,0,30,1
1649999058785,MATH 20B,A01,084124,Um; Ko Woon,16,0,35,19
1649999058785,MATH 20B,B01,084126,Um; Ko Woon,26,0,35,9
1649999064814,MATH 20C,A01,083446,Hammock; Frances H,0,0,30,30
1649999064814,MATH 20C,A02,083447,Hammock; Frances H,16,0,30,14
1649999064814,MATH 20C,A03,083448,Hammock; Frances H,22,0,30,8
1649999064814,MATH 20C,A04,083449,Hammock; Frances H,21,0,30,9
1649999064814,MATH 20C,B01,083451,Hammock; Frances H,0,0,30,30
1649999064814,MATH 20C,B02,083452,Hammock; Frances H,21,0,30,9
1649999064814,MATH 20C,B03,083453,Hammock; Frances H,23,0,30,7
1649999064814,MATH 20C,B04,083454,Hammock; Frances H,25,0,30,5
1649999070843,MATH 20D,A01,084128,Staff,14,0,30,16
1649999070843,MATH 20D,A02,084129,Staff,29,0,30,1
1649999070843,MATH 20D,A03,084130,Staff,27,0,30,3
1649999070843,MATH 20D,B01,084133,Staff,4,0,30,26
1649999070843,MATH 20D,B02,084134,Staff,24,0,30,6
1649999070843,MATH 20D,B03,084135,Staff,28,0,30,2
1649999076867,MATH 20E,A01,084138,Staff,14,0,30,16
1649999076867,MATH 20E,A02,084139,Staff,7,0,30,23
1649999076867,MATH 20E,A03,084140,Staff,15,0,30,15
1649999076867,MATH 20E,A04,084141,Staff,20,0,30,10
1649999082894,MATH 102,A01,084143,Harel; Guershon,12,0,30,18
1649999082894,MATH 102,A02,084144,Harel; Guershon,20,0,30,10
1649999088917,MATH 103B,A01,083456,Staff,0,13,30,30
1649999088917,MATH 103B,A02,083457,Staff,0,12,30,30
1649999094943,MATH 109,A01,084146,Salehi Golsefidy; Alireza,18,0,30,12
1649999094943,MATH 109,A02,084147,Salehi Golsefidy; Alireza,16,0,30,14
1649999100970,MATH 120A,A01,085445,Eggers; John Dietrich,12,0,35,23
1649999100970,MATH 120A,A02,085446,Eggers; John Dietrich,27,0,35,8
1649999106994,MATH 142B,A01,084149,Verstraete; Jacques Allan,0,12,30,30
1649999106994,MATH 142B,A02,084150,Verstraete; Jacques Allan,0,12,30,30
1649999113026,MATH 170A,A01,083459,Nie; Jiawang,1,10,30,29
1649999113026,MATH 170A,A02,083460,Nie; Jiawang,0,6,30,30
1649999113026,MATH 170A,A03,083461,Nie; Jiawang,0,9,30,30
1649999119061,MATH 193B,A01,083463,Staff,1,0,30,29
1649999119061,MATH 193B,A02,083464,Staff,9,0,30,21
1649999119061,MATH 193B,A03,083465,Staff,18,0,30,12
1649999125113,COGS 2,A01,083966,Boyle; Mary E. T.,10,0,30,20
1649999131143,COGS 9,A01,083968,Staff,13,0,60,47
1649999137167,COGS 14B,A01,083970,Staff,11,0,50,39
1649999143190,COGS 17,A01,092679,Staff,53,0,75,22
1649999149215,COGS 100,A01,083972,Staff,0,15,60,60
1649999161265,COGS 101C,A01,083976,Staff,13,0,30,17
1649999167290,COGS 102A,A01,083978,Johnson; Christine M.,14,0,30,16
1649999173314,COGS 107B,A01,083980,Staff,0,7,50,50
1649999179336,COGS 115,A01,083982,Staff,11,0,30,19
1649999185359,COGS 118B,A01,083367,Staff,0,14,40,40
1649999191383,COGS 172,A01,083984,Provenzano; Emily Kara,15,0,30,15
1649999197409,COGS 177,A00,083368,Staff,0,20,30,30
1649999203444,COGS 186,A01,083986,Staff,21,0,40,19
1649999209474,COGS 187A,A01,083988,Boyle; Mary E. T.,19,0,60,41
1649999215497,CSE 8A,A50,084003,Miranda; Gregory Joseph,0,13,15,15
1649999221525,CSE 11,A01,084005,Miranda; Gregory Joseph,0,19,55,55
1649999227552,CSE 20,A01,084007,Staff,0,5,20,20
1649999233579,CSE 21,A01,084009,Staff,0,27,50,50
1649999239603,CSE 30,A01,083370,Cao; Yingjun,0,63,40,40
1649999245640,CSE 100,A01,083372,Cao; Yingjun,0,45,40,40
1649999251663,CSE 101,A01,084011,Staff,1,54,40,39
1649999257687,CSE 141,A01,083374,Eldon; John,0,63,75,75
1649999263710,CSE 141L,A01,083376,Eldon; John,0,69,75,75
1649999269732,CSE 175,A01,084013,Kumar; Rakesh,22,0,25,3
1649999275755,CSE 190,A00,092508,Dubnov; Shlomo,20,0,20,0
1649999281781,ECE 5,A01,084049,Morris; Karcher William,13,0,20,7
1649999287808,ECE 100,A01,084051,Baghdadchi; Saharnaz,0,0,20,20
1649999287808,ECE 100,A02,091916,Baghdadchi; Saharnaz,14,0,20,6
1649999293832,ECE 101,A01,084053,Baghdadchi; Saharnaz,0,0,37,37
1649999293832,ECE 101,A02,084054,Baghdadchi; Saharnaz,31,0,37,6
1649999299858,ECE 107,A01,083390,Staff,26,0,40,14
1649999305898,ECE 148,A01,084056,Silberman; Jack,8,0,12,4
1649999311927,ECE 180,A00,083391,Abi Samra; Nicholas Camill,25,0,30,5
1649999311927,ECE 180,B00,083392,Abi Samra; Nicholas Camill,21,0,30,9
1649999317951,MATH 10B,A01,084110,Staff,0,0,30,30
1649999317951,MATH 10B,A02,084111,Staff,20,0,30,10
1649999317951,MATH 10B,A03,084112,Staff,24,0,30,6
1649999323975,MATH 10C,A01,083443,Staff,1,15,30,29
1649999323975,MATH 10C,A02,083444,Staff,1,14,30,29
1649999323975,MATH 10C,B01,084114,Staff,19,0,30,11
1649999323975,MATH 10C,B02,084115,Staff,25,0,30,5
1649999330005,MATH 18,A01,084117,Harel; Guershon,15,0,30,15
1649999330005,MATH 18,A02,084119,Harel; Guershon,28,0,30,2
1649999330005,MATH 18,A03,084120,Harel; Guershon,29,0,30,1
1649999330005,MATH 18,A04,084121,Harel; Guershon,29,0,30,1
1649999336033,MATH 20B,A01,084124,Um; Ko Woon,16,0,35,19
1649999336033,MATH 20B,B01,084126,Um; Ko Woon,26,0,35,9
1649999342058,MATH 20C,A01,083446,Hammock; Frances H,0,0,30,30
1649999342058,MATH 20C,A02,083447,Hammock; Frances H,16,0,30,14
1649999342058,MATH 20C,A03,083448,Hammock; Frances H,22,0,30,8
1649999342058,MATH 20C,A04,083449,Hammock; Frances H,21,0,30,9
1649999342058,MATH 20C,B01,083451,Hammock; Frances H,0,0,30,30
1649999342058,MATH 20C,B02,083452,Hammock; Frances H,20,0,30,10
1649999342058,MATH 20C,B03,083453,Hammock; Frances H,23,0,30,7
1649999342058,MATH 20C,B04,083454,Hammock; Frances H,25,0,30,5
1649999348083,MATH 20D,A01,084128,Staff,14,0,30,16
1649999348083,MATH 20D,A02,084129,Staff,29,0,30,1
1649999348083,MATH 20D,A03,084130,Staff,27,0,30,3
1649999348083,MATH 20D,B01,084133,Staff,4,0,30,26
1649999348083,MATH 20D,B02,084134,Staff,24,0,30,6
1649999348083,MATH 20D,B03,084135,Staff,28,0,30,2
1649999354207,MATH 20E,A01,084138,Staff,14,0,30,16
1649999354207,MATH 20E,A02,084139,Staff,7,0,30,23
1649999354207,MATH 20E,A03,084140,Staff,15,0,30,15
1649999354207,MATH 20E,A04,084141,Staff,20,0,30,10
1649999360242,MATH 102,A01,084143,Harel; Guershon,12,0,30,18
1649999360242,MATH 102,A02,084144,Harel; Guershon,20,0,30,10
1649999366266,MATH 103B,A01,083456,Staff,0,13,30,30
1649999366266,MATH 103B,A02,083457,Staff,0,12,30,30
1649999372293,MATH 109,A01,084146,Salehi Golsefidy; Alireza,18,0,30,12
1649999372293,MATH 109,A02,084147,Salehi Golsefidy; Alireza,16,0,30,14
1649999378316,MATH 120A,A01,085445,Eggers; John Dietrich,12,0,35,23
1649999378316,MATH 120A,A02,085446,Eggers; John Dietrich,27,0,35,8
1649999384343,MATH 142B,A01,084149,Verstraete; Jacques Allan,0,12,30,30
1649999384343,MATH 142B,A02,084150,Verstraete; Jacques Allan,0,12,30,30
1649999390369,MATH 170A,A01,083459,Nie; Jiawang,1,10,30,29
1649999390369,MATH 170A,A02,083460,Nie; Jiawang,0,7,30,30
1649999390369,MATH 170A,A03,083461,Nie; Jiawang,0,9,30,30
1649999396397,MATH 193B,A01,083463,Staff,1,0,30,29
1649999396397,MATH 193B,A02,083464,Staff,9,0,30,21
1649999396397,MATH 193B,A03,083465,Staff,18,0,30,12
1649999402475,COGS 2,A01,083966,Boyle; Mary E. T.,10,0,30,20
1649999408508,COGS 9,A01,083968,Staff,13,0,60,47
1649999414533,COGS 14B,A01,083970,Staff,11,0,50,39
1649999420560,COGS 17,A01,092679,Staff,53,0,75,22
1649999426584,COGS 100,A01,083972,Staff,0,15,60,60
1649999438647,COGS 101C,A01,083976,Staff,13,0,30,17
1649999444673,COGS 102A,A01,083978,Johnson; Christine M.,14,0,30,16
1649999450699,COGS 107B,A01,083980,Staff,0,7,50,50
1649999456729,COGS 115,A01,083982,Staff,11,0,30,19
1649999462753,COGS 118B,A01,083367,Staff,0,14,40,40
1649999468793,COGS 172,A01,083984,Provenzano; Emily Kara,15,0,30,15
1649999474817,COGS 177,A00,083368,Staff,0,20,30,30
1649999480843,COGS 186,A01,083986,Staff,21,0,40,19
1649999486867,COGS 187A,A01,083988,Boyle; Mary E. T.,19,0,60,41
1649999492893,CSE 8A,A50,084003,Miranda; Gregory Joseph,0,13,15,15
1649999498920,CSE 11,A01,084005,Miranda; Gregory Joseph,0,19,55,55
1649999504943,CSE 20,A01,084007,Staff,0,5,20,20
1649999510973,CSE 21,A01,084009,Staff,0,27,50,50
1649999516998,CSE 30,A01,083370,Cao; Yingjun,0,63,40,40
1649999523022,CSE 100,A01,083372,Cao; Yingjun,0,45,40,40
1649999529052,CSE 101,A01,084011,Staff,1,54,40,39
1649999535078,CSE 141,A01,083374,Eldon; John,0,63,75,75
1649999541102,CSE 141L,A01,083376,Eldon; John,0,69,75,75
1649999547146,CSE 175,A01,084013,Kumar; Rakesh,22,0,25,3
1649999553168,CSE 190,A00,092508,Dubnov; Shlomo,20,0,20,0
1649999559194,ECE 5,A01,084049,Morris; Karcher William,13,0,20,7
1649999565220,ECE 100,A01,084051,Baghdadchi; Saharnaz,0,0,20,20
1649999565220,ECE 100,A02,091916,Baghdadchi; Saharnaz,14,0,20,6
1649999571241,ECE 101,A01,084053,Baghdadchi; Saharnaz,0,0,37,37
1649999571241,ECE 101,A02,084054,Baghdadchi; Saharnaz,31,0,37,6
1649999577270,ECE 107,A01,083390,Staff,26,0,40,14
1649999583294,ECE 148,A01,084056,Silberman; Jack,8,0,12,4
1649999589323,ECE 180,A00,083391,Abi Samra; Nicholas Camill,25,0,30,5
1649999589323,ECE 180,B00,083392,Abi Samra; Nicholas Camill,21,0,30,9
1649999595346,MATH 10B,A01,084110,Staff,0,0,30,30
1649999595346,MATH 10B,A02,084111,Staff,20,0,30,10
1649999595346,MATH 10B,A03,084112,Staff,24,0,30,6
1649999601374,MATH 10C,A01,083443,Staff,1,15,30,29
1649999601374,MATH 10C,A02,083444,Staff,1,15,30,29
1649999601374,MATH 10C,B01,084114,Staff,19,0,30,11
1649999601374,MATH 10C,B02,084115,Staff,25,0,30,5
1649999607421,MATH 18,A01,084117,Harel; Guershon,15,0,30,15
1649999607421,MATH 18,A02,084119,Harel; Guershon,28,0,30,2
1649999607421,MATH 18,A03,084120,Harel; Guershon,29,0,30,1
1649999607421,MATH 18,A04,084121,Harel; Guershon,29,0,30,1
1649999613449,MATH 20B,A01,084124,Um; Ko Woon,16,0,35,19
1649999613449,MATH 20B,B01,084126,Um; Ko Woon,26,0,35,9
1649999619479,MATH 20C,A01,083446,Hammock; Frances H,0,0,30,30
1649999619479,MATH 20C,A02,083447,Hammock; Frances H,16,0,30,14
1649999619479,MATH 20C,A03,083448,Hammock; Frances H,22,0,30,8
1649999619479,MATH 20C,A04,083449,Hammock; Frances H,21,0,30,9
1649999619479,MATH 20C,B01,083451,Hammock; Frances H,0,0,30,30
1649999619479,MATH 20C,B02,083452,Hammock; Frances H,20,0,30,10
1649999619479,MATH 20C,B03,083453,Hammock; Frances H,23,0,30,7
1649999619479,MATH 20C,B04,083454,Hammock; Frances H,25,0,30,5
1649999625505,MATH 20D,A01,084128,Staff,14,0,30,16
1649999625505,MATH 20D,A02,084129,Staff,29,0,30,1
1649999625505,MATH 20D,A03,084130,Staff,27,0,30,3
1649999625505,MATH 20D,B01,084133,Staff,4,0,30,26
1649999625505,MATH 20D,B02,084134,Staff,24,0,30,6
1649999625505,MATH 20D,B03,084135,Staff,28,0,30,2
1649999631538,MATH 20E,A01,084138,Staff,14,0,30,16
1649999631538,MATH 20E,A02,084139,Staff,7,0,30,23
1649999631538,MATH 20E,A03,084140,Staff,15,0,30,15
1649999631538,MATH 20E,A04,084141,Staff,20,0,30,10
1649999637563,MATH 102,A01,084143,Harel; Guershon,12,0,30,18
1649999637563,MATH 102,A02,084144,Harel; Guershon,20,0,30,10
1649999643590,MATH 103B,A01,083456,Staff,0,13,30,30
1649999643590,MATH 103B,A02,083457,Staff,0,12,30,30
1649999649615,MATH 109,A01,084146,Salehi Golsefidy; Alireza,18,0,30,12
1649999649615,MATH 109,A02,084147,Salehi Golsefidy; Alireza,16,0,30,14
1649999655638,MATH 120A,A01,085445,Eggers; John Dietrich,12,0,35,23
1649999655638,MATH 120A,A02,085446,Eggers; John Dietrich,27,0,35,8
1649999661669,MATH 142B,A01,084149,Verstraete; Jacques Allan,0,12,30,30
1649999661669,MATH 142B,A02,084150,Verstraete; Jacques Allan,0,12,30,30
1649999667693,MATH 170A,A01,083459,Nie; Jiawang,1,10,30,29
1649999667693,MATH 170A,A02,083460,Nie; Jiawang,0,7,30,30
1649999667693,MATH 170A,A03,083461,Nie; Jiawang,0,9,30,30
1649999673716,MATH 193B,A01,083463,Staff,1,0,30,29
1649999673716,MATH 193B,A02,083464,Staff,9,0,30,21
1649999673716,MATH 193B,A03,083465,Staff,18,0,30,12
1649999679768,COGS 2,A01,083966,Boyle; Mary E. T.,10,0,30,20
1649999685810,COGS 9,A01,083968,Staff,13,0,60,47
1649999691837,COGS 14B,A01,083970,Staff,11,0,50,39
1649999697861,COGS 17,A01,092679,Staff,53,0,75,22
1649999703901,COGS 100,A01,083972,Staff,0,15,60,60
1649999715949,COGS 101C,A01,083976,Staff,13,0,30,17
1649999721976,COGS 102A,A01,083978,Johnson; Christine M.,14,0,30,16
1649999728000,COGS 107B,A01,083980,Staff,0,7,50,50
1649999734023,COGS 115,A01,083982,Staff,11,0,30,19
1649999740047,COGS 118B,A01,083367,Staff,0,14,40,40
1649999746081,COGS 172,A01,083984,Provenzano; Emily Kara,15,0,30,15
1649999752107,COGS 177,A00,083368,Staff,0,20,30,30
1649999758134,COGS 186,A01,083986,Staff,21,0,40,19
1649999764161,COGS 187A,A01,083988,Boyle; Mary E. T.,19,0,60,41
1649999770187,CSE 8A,A50,084003,Miranda; Gregory Joseph,0,13,15,15
1649999776213,CSE 11,A01,084005,Miranda; Gregory Joseph,0,19,55,55
1649999782237,CSE 20,A01,084007,Staff,0,5,20,20
1649999788272,CSE 21,A01,084009,Staff,0,27,50,50
1649999794297,CSE 30,A01,083370,Cao; Yingjun,0,63,40,40
1649999800323,CSE 100,A01,083372,Cao; Yingjun,0,45,40,40
1649999806350,CSE 101,A01,084011,Staff,1,54,40,39
1649999812379,CSE 141,A01,083374,Eldon; John,0,63,75,75
1649999818406,CSE 141L,A01,083376,Eldon; John,0,69,75,75
1649999824432,CSE 175,A01,084013,Kumar; Rakesh,22,0,25,3
1649999830455,CSE 190,A00,092508,Dubnov; Shlomo,20,0,20,0
1649999836479,ECE 5,A01,084049,Morris; Karcher William,13,0,20,7
1649999842503,ECE 100,A01,084051,Baghdadchi; Saharnaz,0,0,20,20
1649999842503,ECE 100,A02,091916,Baghdadchi; Saharnaz,14,0,20,6
1649999848531,ECE 101,A01,084053,Baghdadchi; Saharnaz,0,0,37,37
1649999848531,ECE 101,A02,084054,Baghdadchi; Saharnaz,31,0,37,6
1649999854556,ECE 107,A01,083390,Staff,26,0,40,14
1649999860584,ECE 148,A01,084056,Silberman; Jack,8,0,12,4
1649999866607,ECE 180,A00,083391,Abi Samra; Nicholas Camill,25,0,30,5
1649999866607,ECE 180,B00,083392,Abi Samra; Nicholas Camill,21,0,30,9
1649999872631,MATH 10B,A01,084110,Staff,0,0,30,30
1649999872631,MATH 10B,A02,084111,Staff,20,0,30,10
1649999872631,MATH 10B,A03,084112,Staff,24,0,30,6
1649999878660,MATH 10C,A01,083443,Staff,1,15,30,29
1649999878660,MATH 10C,A02,083444,Staff,1,15,30,29
1649999878660,MATH 10C,B01,084114,Staff,19,0,30,11
1649999878660,MATH 10C,B02,084115,Staff,25,0,30,5
1649999884683,MATH 18,A01,084117,Harel; Guershon,15,0,30,15
1649999884683,MATH 18,A02,084119,Harel; Guershon,28,0,30,2
1649999884683,MATH 18,A03,084120,Harel; Guershon,29,0,30,1
1649999884683,MATH 18,A04,084121,Harel; Guershon,29,0,30,1
1649999890707,MATH 20B,A01,084124,Um; Ko Woon,16,0,35,19
1649999890707,MATH 20B,B01,084126,Um; Ko Woon,26,0,35,9
1649999896732,MATH 20C,A01,083446,Hammock; Frances H,0,0,30,30
1649999896732,MATH 20C,A02,083447,Hammock; Frances H,16,0,30,14
1649999896732,MATH 20C,A03,083448,Hammock; Frances H,21,0,30,9
1649999896732,MATH 20C,A04,083449,Hammock; Frances H,21,0,30,9
1649999896732,MATH 20C,B01,083451,Hammock; Frances H,0,0,30,30
1649999896732,MATH 20C,B02,083452,Hammock; Frances H,20,0,30,10
1649999896732,MATH 20C,B03,083453,Hammock; Frances H,23,0,30,7
1649999896732,MATH 20C,B04,083454,Hammock; Frances H,25,0,30,5
1649999902757,MATH 20D,A01,084128,Staff,14,0,30,16
1649999902757,MATH 20D,A02,084129,Staff,29,0,30,1
1649999902757,MATH 20D,A03,084130,Staff,27,0,30,3
1649999902757,MATH 20D,B01,084133,Staff,4,0,30,26
1649999902757,MATH 20D,B02,084134,Staff,24,0,30,6
1649999902757,MATH 20D,B03,084135,Staff,28,0,30,2
1649999908814,MATH 20E,A01,084138,Staff,14,0,30,16
1649999908814,MATH 20E,A02,084139,Staff,7,0,30,23
1649999908814,MATH 20E,A03,084140,Staff,15,0,30,15
1649999908814,MATH 20E,A04,084141,Staff,20,0,30,10
1649999914839,MATH 102,A01,084143,Harel; Guershon,12,0,30,18
1649999914839,MATH 102,A02,084144,Harel; Guershon,20,0,30,10
1649999920865,MATH 103B,A01,083456,Staff,0,13,30,30
1649999920865,MATH 103B,A02,083457,Staff,0,12,30,30
1649999926904,MATH 109,A01,084146,Salehi Golsefidy; Alireza,18,0,30,12
1649999926904,MATH 109,A02,084147,Salehi Golsefidy; Alireza,16,0,30,14
1649999932939,MATH 120A,A01,085445,Eggers; John Dietrich,12,0,35,23
1649999932939,MATH 120A,A02,085446,Eggers; John Dietrich,27,0,35,8
1649999938963,MATH 142B,A01,084149,Verstraete; Jacques Allan,0,12,30,30
1649999938963,MATH 142B,A02,084150,Verstraete; Jacques Allan,0,12,30,30
1649999944992,MATH 170A,A01,083459,Nie; Jiawang,1,10,30,29
1649999944992,MATH 170A,A02,083460,Nie; Jiawang,0,7,30,30
1649999944992,MATH 170A,A03,083461,Nie; Jiawang,0,9,30,30
1649999951103,MATH 193B,A01,083463,Staff,1,0,30,29
1649999951103,MATH 193B,A02,083464,Staff,9,0,30,21
1649999951103,MATH 193B,A03,083465,Staff,18,0,30,12
1649999957176,COGS 2,A01,083966,Boyle; Mary E. T.,10,0,30,20
1649999963202,COGS 9,A01,083968,Staff,13,0,60,47
1649999969229,COGS 14B,A01,083970,Staff,11,0,50,39
1649999975252,COGS 17,A01,092679,Staff,53,0,75,22
1649999981277,COGS 100,A01,083972,Staff,0,15,60,60
1649999993328,COGS 101C,A01,083976,Staff,13,0,30,17
1649999999359,COGS 102A,A01,083978,Johnson; Christine M.,14,0,30,16
1650000005385,COGS 107B,A01,083980,Staff,0,7,50,50
1650000011409,COGS 115,A01,083982,Staff,11,0,30,19
1650000017440,COGS 118B,A01,083367,Staff,0,14,40,40
1650000023465,COGS 172,A01,083984,Provenzano; Emily Kara,15,0,30,15
1650000029487,COGS 177,A00,083368,Staff,0,20,30,30
1650000035523,COGS 186,A01,083986,Staff,21,0,40,19
1650000041551,COGS 187A,A01,083988,Boyle; Mary E. T.,19,0,60,41
1650000047575,CSE 8A,A50,084003,Miranda; Gregory Joseph,0,13,15,15
1650000053598,CSE 11,A01,084005,Miranda; Gregory Joseph,0,19,55,55
1650000059625,CSE 20,A01,084007,Staff,0,5,20,20
1650000065651,CSE 21,A01,084009,Staff,0,28,50,50
1650000071687,CSE 30,A01,083370,Cao; Yingjun,0,63,40,40
1650000077710,CSE 100,A01,083372,Cao; Yingjun,0,45,40,40
1650000083745,CSE 101,A01,084011,Staff,1,54,40,39
1650000089807,CSE 141,A01,083374,Eldon; John,0,63,75,75
1650000095836,CSE 141L,A01,083376,Eldon; John,0,69,75,75
1650000101859,CSE 175,A01,084013,Kumar; Rakesh,22,0,25,3
1650000107895,CSE 190,A00,092508,Dubnov; Shlomo,20,0,20,0
1650000113918,ECE 5,A01,084049,Morris; Karcher William,13,0,20,7
1650000119951,ECE 100,A01,084051,Baghdadchi; Saharnaz,0,0,20,20
1650000119951,ECE 100,A02,091916,Baghdadchi; Saharnaz,14,0,20,6
1650000125975,ECE 101,A01,084053,Baghdadchi; Saharnaz,0,0,37,37
1650000125975,ECE 101,A02,084054,Baghdadchi; Saharnaz,31,0,37,6
1650000131999,ECE 107,A01,083390,Staff,26,0,40,14
1650000138024,ECE 148,A01,084056,Silberman; Jack,8,0,12,4
1650000144047,ECE 180,A00,083391,Abi Samra; Nicholas Camill,25,0,30,5
1650000144047,ECE 180,B00,083392,Abi Samra; Nicholas Camill,21,0,30,9
1650000150071,MATH 10B,A01,084110,Staff,0,0,30,30
1650000150071,MATH 10B,A02,084111,Staff,20,0,30,10
1650000150071,MATH 10B,A03,084112,Staff,24,0,30,6
1650000156096,MATH 10C,A01,083443,Staff,1,15,30,29
1650000156096,MATH 10C,A02,083444,Staff,1,15,30,29
1650000156096,MATH 10C,B01,084114,Staff,19,0,30,11
1650000156096,MATH 10C,B02,084115,Staff,25,0,30,5
1650000162121,MATH 18,A01,084117,Harel; Guershon,14,0,30,16
1650000162121,MATH 18,A02,084119,Harel; Guershon,28,0,30,2
1650000162121,MATH 18,A03,084120,Harel; Guershon,29,0,30,1
1650000162121,MATH 18,A04,084121,Harel; Guershon,29,0,30,1
1650000168155,MATH 20B,A01,084124,Um; Ko Woon,16,0,35,19
1650000168155,MATH 20B,B01,084126,Um; Ko Woon,26,0,35,9
1650000174188,MATH 20C,A01,083446,Hammock; Frances H,0,0,30,30
1650000174188,MATH 20C,A02,083447,Hammock; Frances H,16,0,30,14
1650000174188,MATH 20C,A03,083448,Hammock; Frances H,21,0,30,9
1650000174188,MATH 20C,A04,083449,Hammock; Frances H,21,0,30,9
1650000174188,MATH 20C,B01,083451,Hammock; Frances H,0,0,30,30
1650000174188,MATH 20C,B02,083452,Hammock; Frances H,20,0,30,10
1650000174188,MATH 20C,B03,083453,Hammock; Frances H,23,0,30,7
1650000174188,MATH 20C,B04,083454,Hammock; Frances H,25,0,30,5
1650000180215,MATH 20D,A01,084128,Staff,14,0,30,16
1650000180215,MATH 20D,A02,084129,Staff,29,0,30,1
1650000180215,MATH 20D,A03,084130,Staff,27,0,30,3
1650000180215,MATH 20D,B01,084133,Staff,3,0,30,27
1650000180215,MATH 20D,B02,084134,Staff,24,0,30,6
1650000180215,MATH 20D,B03,084135,Staff,28,0,30,2
1650000186249,MATH 20E,A01,084138,Staff,14,0,30,16
1650000186249,MATH 20E,A02,084139,Staff,7,0,30,23
1650000186249,MATH 20E,A03,084140,Staff,15,0,30,15
1650000186249,MATH 20E,A04,084141,Staff,20,0,30,10
1650000192276,MATH 102,A01,084143,Harel; Guershon,12,0,30,18
1650000192276,MATH 102,A02,084144,Harel; Guershon,20,0,30,10
1650000198303,MATH 103B,A01,083456,Staff,0,13,30,30
1650000198303,MATH 103B,A02,083457,Staff,0,12,30,30
1650000204328,MATH 109,A01,084146,Salehi Golsefidy; Alireza,18,0,30,12
1650000204328,MATH 109,A02,084147,Salehi Golsefidy; Alireza,16,0,30,14
1650000210351,MATH 120A,A01,085445,Eggers; John Dietrich,12,0,35,23
1650000210351,MATH 120A,A02,085446,Eggers; John Dietrich,27,0,35,8
1650000216373,MATH 142B,A01,084149,Verstraete; Jacques Allan,0,12,30,30
1650000216373,MATH 142B,A02,084150,Verstraete; Jacques Allan,0,12,30,30
1650000222399,MATH 170A,A01,083459,Nie; Jiawang,1,10,30,29
1650000222399,MATH 170A,A02,083460,Nie; Jiawang,0,7,30,30
1650000222399,MATH 170A,A03,083461,Nie; Jiawang,0,9,30,30
1650000228427,MATH 193B,A01,083463,Staff,1,0,30,29
1650000228427,MATH 193B,A02,083464,Staff,9,0,30,21
1650000228427,MATH 193B,A03,083465,Staff,18,0,30,12
1650000234476,COGS 2,A01,083966,Boyle; Mary E. T.,10,0,30,20
1650000240503,COGS 9,A01,083968,Staff,13,0,60,47
1650000246525,COGS 14B,A01,083970,Staff,11,0,50,39
1650000252549,COGS 17,A01,092679,Staff,53,0,75,22
1650000258572,COGS 100,A01,083972,Staff,0,15,60,60
1650000270633,COGS 101C,A01,083976,Staff,13,0,30,17
1650000276656,COGS 102A,A01,083978,Johnson; Christine M.,13,0,30,17
1650000282680,COGS 107B,A01,083980,Staff,0,7,50,50
1650000288707,COGS 115,A01,083982,Staff,11,0,30,19
1650000294731,COGS 118B,A01,083367,Staff,0,14,40,40
1650000300758,COGS 172,A01,083984,Provenzano; Emily Kara,15,0,30,15
1650000306782,COGS 177,A00,083368,Staff,0,20,30,30
1650000312811,COGS 186,A01,083986,Staff,21,0,40,19
1650000318834,COGS 187A,A01,083988,Boyle; Mary E. T.,19,0,60,41
1650000324861,CSE 8A,A50,084003,Miranda; Gregory Joseph,0,13,15,15
1650000330885,CSE 11,A01,084005,Miranda; Gregory Joseph,0,19,55,55
1650000336912,CSE 20,A01,084007,Staff,0,5,20,20
1650000342936,CSE 21,A01,084009,Staff,0,28,50,50
1650000348964,CSE 30,A01,083370,Cao; Yingjun,0,63,40,40
1650000354994,CSE 100,A01,083372,Cao; Yingjun,0,46,40,40
1650000361017,CSE 101,A01,084011,Staff,1,54,40,39
1650000367041,CSE 141,A01,083374,Eldon; John,0,63,75,75
1650000373065,CSE 141L,A01,083376,Eldon; John,0,69,75,75
1650000379088,CSE 175,A01,084013,Kumar; Rakesh,22,0,25,3
1650000385119,CSE 190,A00,092508,Dubnov; Shlomo,20,0,20,0
1650000391152,ECE 5,A01,084049,Morris; Karcher William,13,0,20,7
1650000397176,ECE 100,A01,084051,Baghdadchi; Saharnaz,0,0,20,20
1650000397176,ECE 100,A02,091916,Baghdadchi; Saharnaz,14,0,20,6
1650000403201,ECE 101,A01,084053,Baghdadchi; Saharnaz,0,0,37,37
1650000403201,ECE 101,A02,084054,Baghdadchi; Saharnaz,31,0,37,6
1650000409232,ECE 107,A01,083390,Staff,26,0,40,14
1650000415257,ECE 148,A01,084056,Silberman; Jack,8,0,12,4
1650000421281,ECE 180,A00,083391,Abi Samra; Nicholas Camill,25,0,30,5
1650000421281,ECE 180,B00,083392,Abi Samra; Nicholas Camill,21,0,30,9
1650000427305,MATH 10B,A01,084110,Staff,0,0,30,30
1650000427305,MATH 10B,A02,084111,Staff,20,0,30,10
1650000427305,MATH 10B,A03,084112,Staff,24,0,30,6
1650000433343,MATH 10C,A01,083443,Staff,0,14,30,30
1650000433343,MATH 10C,A02,083444,Staff,0,14,30,30
1650000433343,MATH 10C,B01,084114,Staff,19,0,30,11
1650000433343,MATH 10C,B02,084115,Staff,25,0,30,5
1650000439373,MATH 18,A01,084117,Harel; Guershon,14,0,30,16
1650000439373,MATH 18,A02,084119,Harel; Guershon,28,0,30,2
1650000439373,MATH 18,A03,084120,Harel; Guershon,29,0,30,1
1650000439373,MATH 18,A04,084121,Harel; Guershon,29,0,30,1
1650000445396,MATH 20B,A01,084124,Um; Ko Woon,16,0,35,19
1650000445396,MATH 20B,B01,084126,Um; Ko Woon,26,0,35,9
1650000451440,MATH 20C,A01,083446,Hammock; Frances H,0,0,30,30
1650000451440,MATH 20C,A02,083447,Hammock; Frances H,16,0,30,14
1650000451440,MATH 20C,A03,083448,Hammock; Frances H,20,0,30,10
1650000451440,MATH 20C,A04,083449,Hammock; Frances H,21,0,30,9
1650000451440,MATH 20C,B01,083451,Hammock; Frances H,0,0,30,30
1650000451440,MATH 20C,B02,083452,Hammock; Frances H,20,0,30,10
1650000451440,MATH 20C,B03,083453,Hammock; Frances H,23,0,30,7
1650000451440,MATH 20C,B04,083454,Hammock; Frances H,25,0,30,5
1650000457465,MATH 20D,A01,084128,Staff,14,0,30,16
1650000457465,MATH 20D,A02,084129,Staff,29,0,30,1
1650000457465,MATH 20D,A03,084130,Staff,27,0,30,3
1650000457465,MATH 20D,B01,084133,Staff,3,0,30,27
1650000457465,MATH 20D,B02,084134,Staff,24,0,30,6
1650000457465,MATH 20D,B03,084135,Staff,28,0,30,2
1650000463488,MATH 20E,A01,084138,Staff,14,0,30,16
1650000463488,MATH 20E,A02,084139,Staff,7,0,30,23
1650000463488,MATH 20E,A03,084140,Staff,15,0,30,15
1650000463488,MATH 20E,A04,084141,Staff,20,0,30,10
1650000469511,MATH 102,A01,084143,Harel; Guershon,12,0,30,18
1650000469511,MATH 102,A02,084144,Harel; Guershon,20,0,30,10
1650000475534,MATH 103B,A01,083456,Staff,0,13,30,30
1650000475534,MATH 103B,A02,083457,Staff,0,12,30,30
1650000481560,MATH 109,A01,084146,Salehi Golsefidy; Alireza,18,0,30,12
1650000481560,MATH 109,A02,084147,Salehi Golsefidy; Alireza,16,0,30,14
1650000487583,MATH 120A,A01,085445,Eggers; John Dietrich,12,0,35,23
1650000487583,MATH 120A,A02,085446,Eggers; John Dietrich,27,0,35,8
1650000493607,MATH 142B,A01,084149,Verstraete; Jacques Allan,0,12,30,30
1650000493607,MATH 142B,A02,084150,Verstraete; Jacques Allan,0,12,30,30
1650000499634,MATH 170A,A01,083459,Nie; Jiawang,0,9,30,30
1650000499634,MATH 170A,A02,083460,Nie; Jiawang,0,7,30,30
1650000499634,MATH 170A,A03,083461,Nie; Jiawang,0,9,30,30
1650000505657,MATH 193B,A01,083463,Staff,1,0,30,29
1650000505657,MATH 193B,A02,083464,Staff,9,0,30,21
1650000505657,MATH 193B,A03,083465,Staff,18,0,30,12
1650000511706,COGS 2,A01,083966,Boyle; Mary E. T.,10,0,30,20
1650000517729,COGS 9,A01,083968,Staff,12,0,60,48
1650000523752,COGS 14B,A01,083970,Staff,11,0,50,39
1650000529775,COGS 17,A01,092679,Staff,53,0,75,22
1650000535802,COGS 100,A01,083972,Staff,0,15,60,60
1650000547942,COGS 101C,A01,083976,Staff,13,0,30,17
1650000553964,COGS 102A,A01,083978,Johnson; Christine M.,14,0,30,16
1650000559994,COGS 107B,A01,083980,Staff,0,7,50,50
1650000566023,COGS 115,A01,083982,Staff,11,0,30,19
1650000572047,COGS 118B,A01,083367,Staff,0,14,40,40
1650000578070,COGS 172,A01,083984,Provenzano; Emily Kara,15,0,30,15
1650000584107,COGS 177,A00,083368,Staff,0,20,30,30
1650000590143,COGS 186,A01,083986,Staff,21,0,40,19
1650000596175,COGS 187A,A01,083988,Boyle; Mary E. T.,19,0,60,41
1650000602203,CSE 8A,A50,084003,Miranda; Gregory Joseph,0,13,15,15
1650000608244,CSE 11,A01,084005,Miranda; Gregory Joseph,0,19,55,55
1650000614269,CSE 20,A01,084007,Staff,0,5,20,20
1650000620296,CSE 21,A01,084009,Staff,0,29,50,50
1650000626320,CSE 30,A01,083370,Cao; Yingjun,0,63,40,40
1650000632343,CSE 100,A01,083372,Cao; Yingjun,0,46,40,40
1650000638387,CSE 101,A01,084011,Staff,0,53,40,40
1650000644419,CSE 141,A01,083374,Eldon; John,0,63,75,75
1650000650455,CSE 141L,A01,083376,Eldon; John,0,69,75,75
1650000656479,CSE 175,A01,084013,Kumar; Rakesh,22,0,25,3
1650000662510,CSE 190,A00,092508,Dubnov; Shlomo,20,0,20,0
1650000668535,ECE 5,A01,084049,Morris; Karcher William,13,0,20,7
1650000674559,ECE 100,A01,084051,Baghdadchi; Saharnaz,0,0,20,20
1650000674559,ECE 100,A02,091916,Baghdadchi; Saharnaz,14,0,20,6
1650000680584,ECE 101,A01,084053,Baghdadchi; Saharnaz,0,0,37,37
1650000680584,ECE 101,A02,084054,Baghdadchi; Saharnaz,31,0,37,6
1650000686611,ECE 107,A01,083390,Staff,26,0,40,14
1650000692635,ECE 148,A01,084056,Silberman; Jack,8,0,12,4
1650000698662,ECE 180,A00,083391,Abi Samra; Nicholas Camill,25,0,30,5
1650000698662,ECE 180,B00,083392,Abi Samra; Nicholas Camill,21,0,30,9
1650000704703,MATH 10B,A01,084110,Staff,0,0,30,30
1650000704703,MATH 10B,A02,084111,Staff,20,0,30,10
1650000704703,MATH 10B,A03,084112,Staff,24,0,30,6
1650000710739,MATH 10C,A01,083443,Staff,0,14,30,30
1650000710739,MATH 10C,A02,083444,Staff,0,14,30,30
1650000710739,MATH 10C,B01,084114,Staff,19,0,30,11
1650000710739,MATH 10C,B02,084115,Staff,25,0,30,5
1650000716761,MATH 18,A01,084117,Harel; Guershon,14,0,30,16
1650000716761,MATH 18,A02,084119,Harel; Guershon,28,0,30,2
1650000716761,MATH 18,A03,084120,Harel; Guershon,29,0,30,1
1650000716761,MATH 18,A04,084121,Harel; Guershon,29,0,30,1
1650000722789,MATH 20B,A01,084124,Um; Ko Woon,16,0,35,19
1650000722789,MATH 20B,B01,084126,Um; Ko Woon,26,0,35,9
1650000728820,MATH 20C,A01,083446,Hammock; Frances H,0,0,30,30
1650000728820,MATH 20C,A02,083447,Hammock; Frances H,16,0,30,14
1650000728820,MATH 20C,A03,083448,Hammock; Frances H,20,0,30,10
1650000728820,MATH 20C,A04,083449,Hammock; Frances H,21,0,30,9
1650000728820,MATH 20C,B01,083451,Hammock; Frances H,0,0,30,30
1650000728820,MATH 20C,B02,083452,Hammock; Frances H,20,0,30,10
1650000728820,MATH 20C,B03,083453,Hammock; Frances H,23,0,30,7
1650000728820,MATH 20C,B04,083454,Hammock; Frances H,25,0,30,5
1650000734845,MATH 20D,A01,084128,Staff,14,0,30,16
1650000734845,MATH 20D,A02,084129,Staff,29,0,30,1
1650000734845,MATH 20D,A03,084130,Staff,27,0,30,3
1650000734845,MATH 20D,B01,084133,Staff,3,0,30,27
1650000734845,MATH 20D,B02,084134,Staff,24,0,30,6
1650000734845,MATH 20D,B03,084135,Staff,28,0,30,2
1650000740870,MATH 20E,A01,084138,Staff,14,0,30,16
1650000740870,MATH 20E,A02,084139,Staff,7,0,30,23
1650000740870,MATH 20E,A03,084140,Staff,15,0,30,15
1650000740870,MATH 20E,A04,084141,Staff,20,0,30,10
1650000746897,MATH 102,A01,084143,Harel; Guershon,12,0,30,18
1650000746897,MATH 102,A02,084144,Harel; Guershon,20,0,30,10
1650000752923,MATH 103B,A01,083456,Staff,0,13,30,30
1650000752923,MATH 103B,A02,083457,Staff,0,12,30,30
1650000758964,MATH 109,A01,084146,Salehi Golsefidy; Alireza,18,0,30,12
1650000758964,MATH 109,A02,084147,Salehi Golsefidy; Alireza,16,0,30,14
1650000764993,MATH 120A,A01,085445,Eggers; John Dietrich,12,0,35,23
1650000764993,MATH 120A,A02,085446,Eggers; John Dietrich,27,0,35,8
1650000771015,MATH 142B,A01,084149,Verstraete; Jacques Allan,0,12,30,30
1650000771015,MATH 142B,A02,084150,Verstraete; Jacques Allan,0,12,30,30
1650000777064,MATH 170A,A01,083459,Nie; Jiawang,0,9,30,30
1650000777064,MATH 170A,A02,083460,Nie; Jiawang,0,7,30,30
1650000777064,MATH 170A,A03,083461,Nie; Jiawang,0,9,30,30
1650000783087,MATH 193B,A01,083463,Staff,1,0,30,29
1650000783087,MATH 193B,A02,083464,Staff,9,0,30,21
1650000783087,MATH 193B,A03,083465,Staff,18,0,30,12
1650000789139,COGS 2,A01,083966,Boyle; Mary E. T.,10,0,30,20
1650000795162,COGS 9,A01,083968,Staff,13,0,60,47
1650000801200,COGS 14B,A01,083970,Staff,11,0,50,39
1650000807230,COGS 17,A01,092679,Staff,53,0,75,22
1650000813265,COGS 100,A01,083972,Staff,0,15,60,60
1650000825317,COGS 101C,A01,083976,Staff,13,0,30,17
1650000831342,COGS 102A,A01,083978,Johnson; Christine M.,14,0,30,16
1650000837380,COGS 107B,A01,083980,Staff,0,7,50,50
1650000843403,COGS 115,A01,083982,Staff,11,0,30,19
1650000849426,COGS 118B,A01,083367,Staff,0,14,40,40
1650000855454,COGS 172,A01,083984,Provenzano; Emily Kara,15,0,30,15
1650000861478,COGS 177,A00,083368,Staff,0,20,30,30
1650000867501,COGS 186,A01,083986,Staff,21,0,40,19
1650000873524,COGS 187A,A01,083988,Boyle; Mary E. T.,19,0,60,41
1650000879548,CSE 8A,A50,084003,Miranda; Gregory Joseph,0,13,15,15
1650000885574,CSE 11,A01,084005,Miranda; Gregory Joseph,0,19,55,55
1650000891601,CSE 20,A01,084007,Staff,0,5,20,20
1650000897623,CSE 21,A01,084009,Staff,0,29,50,50
1650000903646,CSE 30,A01,083370,Cao; Yingjun,0,63,40,40
1650000909682,CSE 100,A01,083372,Cao; Yingjun,0,46,40,40
1650000915705,CSE 101,A01,084011,Staff,0,53,40,40
1650000921732,CSE 141,A01,083374,Eldon; John,0,63,75,75
1650000927759,CSE 141L,A01,083376,Eldon; John,0,69,75,75
1650000933800,CSE 175,A01,084013,Kumar; Rakesh,22,0,25,3
1650000939824,CSE 190,A00,092508,Dubnov; Shlomo,20,0,20,0
1650000945847,ECE 5,A01,084049,Morris; Karcher William,13,0,20,7
1650000951873,ECE 100,A01,084051,Baghdadchi; Saharnaz,0,0,20,20
1650000951873,ECE 100,A02,091916,Baghdadchi; Saharnaz,14,0,20,6
1650000957898,ECE 101,A01,084053,Baghdadchi; Saharnaz,0,0,37,37
1650000957898,ECE 101,A02,084054,Baghdadchi; Saharnaz,30,0,37,7
1650000963921,ECE 107,A01,083390,Staff,26,0,40,14
1650000969946,ECE 148,A01,084056,Silberman; Jack,8,0,12,4
1650000975968,ECE 180,A00,083391,Abi Samra; Nicholas Camill,25,0,30,5
1650000975968,ECE 180,B00,083392,Abi Samra; Nicholas Camill,21,0,30,9
1650000981997,MATH 10B,A01,084110,Staff,0,0,30,30
1650000981997,MATH 10B,A02,084111,Staff,20,0,30,10
1650000981997,MATH 10B,A03,084112,Staff,24,0,30,6
1650000988026,MATH 10C,A01,083443,Staff,0,14,30,30
1650000988026,MATH 10C,A02,083444,Staff,0,14,30,30
1650000988026,MATH 10C,B01,084114,Staff,19,0,30,11
1650000988026,MATH 10C,B02,084115,Staff,25,0,30,5
1650000994051,MATH 18,A01,084117,Harel; Guershon,14,0,30,16
1650000994051,MATH 18,A02,084119,Harel; Guershon,28,0,30,2
1650000994051,MATH 18,A03,084120,Harel; Guershon,29,0,30,1
1650000994051,MATH 18,A04,084121,Harel; Guershon,29,0,30,1
1650001000076,MATH 20B,A01,084124,Um; Ko Woon,16,0,35,19
1650001000076,MATH 20B,B01,084126,Um; Ko Woon,26,0,35,9
1650001006098,MATH 20C,A01,083446,Hammock; Frances H,0,0,30,30
1650001006098,MATH 20C,A02,083447,Hammock; Frances H,16,0,30,14
1650001006098,MATH 20C,A03,083448,Hammock; Frances H,20,0,30,10
1650001006098,MATH 20C,A04,083449,Hammock; Frances H,21,0,30,9
1650001006098,MATH 20C,B01,083451,Hammock; Frances H,0,1,30,30
1650001006098,MATH 20C,B02,083452,Hammock; Frances H,20,0,30,10
1650001006098,MATH 20C,B03,083453,Hammock; Frances H,23,0,30,7
1650001006098,MATH 20C,B04,083454,Hammock; Frances H,25,0,30,5
1650001012123,MATH 20D,A01,084128,Staff,14,0,30,16
1650001012123,MATH 20D,A02,084129,Staff,29,0,30,1
1650001012123,MATH 20D,A03,084130,Staff,27,0,30,3
1650001012123,MATH 20D,B01,084133,Staff,3,0,30,27
1650001012123,MATH 20D,B02,084134,Staff,24,0,30,6
1650001012123,MATH 20D,B03,084135,Staff,28,0,30,2
1650001018158,MATH 20E,A01,084138,Staff,14,0,30,16
1650001018158,MATH 20E,A02,084139,Staff,7,0,30,23
1650001018158,MATH 20E,A03,084140,Staff,15,0,30,15
1650001018158,MATH 20E,A04,084141,Staff,20,0,30,10
1650001024201,MATH 102,A01,084143,Harel; Guershon,12,0,30,18
1650001024201,MATH 102,A02,084144,Harel; Guershon,20,0,30,10
1650001030224,MATH 103B,A01,083456,Staff,0,13,30,30
1650001030224,MATH 103B,A02,083457,Staff,0,12,30,30
1650001036255,MATH 109,A01,084146,Salehi Golsefidy; Alireza,18,0,30,12
1650001036255,MATH 109,A02,084147,Salehi Golsefidy; Alireza,16,0,30,14
1650001042289,MATH 120A,A01,085445,Eggers; John Dietrich,12,0,35,23
1650001042289,MATH 120A,A02,085446,Eggers; John Dietrich,27,0,35,8
1650001048320,MATH 142B,A01,084149,Verstraete; Jacques Allan,0,12,30,30
1650001048320,MATH 142B,A02,084150,Verstraete; Jacques Allan,0,12,30,30
1650001054348,MATH 170A,A01,083459,Nie; Jiawang,0,9,30,30
1650001054348,MATH 170A,A02,083460,Nie; Jiawang,0,7,30,30
1650001054348,MATH 170A,A03,083461,Nie; Jiawang,0,9,30,30
1650001060374,MATH 193B,A01,083463,Staff,1,0,30,29
1650001060374,MATH 193B,A02,083464,Staff,9,0,30,21
1650001060374,MATH 193B,A03,083465,Staff,18,0,30,12
1650001066427,COGS 2,A01,083966,Boyle; Mary E. T.,10,0,30,20
1650001072463,COGS 9,A01,083968,Staff,13,0,60,47
1650001078489,COGS 14B,A01,083970,Staff,11,0,50,39
1650001084519,COGS 17,A01,092679,Staff,53,0,75,22
1650001090543,COGS 100,A01,083972,Staff,0,15,60,60
1650001102592,COGS 101C,A01,083976,Staff,13,0,30,17
1650001108624,COGS 102A,A01,083978,Johnson; Christine M.,14,0,30,16
1650001114658,COGS 107B,A01,083980,Staff,0,7,50,50
1650001120681,COGS 115,A01,083982,Staff,11,0,30,19
1650001126703,COGS 118B,A01,083367,Staff,0,14,40,40
1650001132727,COGS 172,A01,083984,Provenzano; Emily Kara,15,0,30,15
1650001138831,COGS 177,A00,083368,Staff,0,20,30,30
1650001144853,COGS 186,A01,083986,Staff,21,0,40,19
1650001150889,COGS 187A,A01,083988,Boyle; Mary E. T.,19,0,60,41
1650001156918,CSE 8A,A50,084003,Miranda; Gregory Joseph,0,13,15,15
1650001162945,CSE 11,A01,084005,Miranda; Gregory Joseph,0,19,55,55
1650001168968,CSE 20,A01,084007,Staff,0,5,20,20
1650001174999,CSE 21,A01,084009,Staff,0,30,50,50
1650001181022,CSE 30,A01,083370,Cao; Yingjun,0,63,40,40
1650001187051,CSE 100,A01,083372,Cao; Yingjun,0,46,40,40
1650001193074,CSE 101,A01,084011,Staff,0,53,40,40
1650001199096,CSE 141,A01,083374,Eldon; John,0,63,75,75
1650001205124,CSE 141L,A01,083376,Eldon; John,0,69,75,75
1650001211150,CSE 175,A01,084013,Kumar; Rakesh,22,0,25,3
1650001217182,CSE 190,A00,092508,Dubnov; Shlomo,20,0,20,0
1650001223216,ECE 5,A01,084049,Morris; Karcher William,13,0,20,7
1650001229239,ECE 100,A01,084051,Baghdadchi; Saharnaz,0,0,20,20
1650001229239,ECE 100,A02,091916,Baghdadchi; Saharnaz,14,0,20,6
1650001235266,ECE 101,A01,084053,Baghdadchi; Saharnaz,0,0,37,37
1650001235266,ECE 101,A02,084054,Baghdadchi; Saharnaz,30,0,37,7
1650001241288,ECE 107,A01,083390,Staff,26,0,40,14
1650001247312,ECE 148,A01,084056,Silberman; Jack,8,0,12,4
1650001253338,ECE 180,A00,083391,Abi Samra; Nicholas Camill,25,0,30,5
1650001253338,ECE 180,B00,083392,Abi Samra; Nicholas Camill,21,0,30,9
1650001259362,MATH 10B,A01,084110,Staff,0,0,30,30
1650001259362,MATH 10B,A02,084111,Staff,20,0,30,10
1650001259362,MATH 10B,A03,084112,Staff,24,0,30,6
1650001265384,MATH 10C,A01,083443,Staff,0,14,30,30
1650001265384,MATH 10C,A02,083444,Staff,0,14,30,30
1650001265384,MATH 10C,B01,084114,Staff,19,0,30,11
1650001265384,MATH 10C,B02,084115,Staff,25,0,30,5
1650001271411,MATH 18,A01,084117,Harel; Guershon,14,0,30,16
1650001271411,MATH 18,A02,084119,Harel; Guershon,28,0,30,2
1650001271411,MATH 18,A03,084120,Harel; Guershon,29,0,30,1
1650001271411,MATH 18,A04,084121,Harel; Guershon,29,0,30,1
1650001277438,MATH 20B,A01,084124,Um; Ko Woon,16,0,35,19
1650001277438,MATH 20B,B01,084126,Um; Ko Woon,26,0,35,9
1650001283492,MATH 20C,A01,083446,Hammock; Frances H,0,0,30,30
1650001283492,MATH 20C,A02,083447,Hammock; Frances H,16,0,30,14
1650001283492,MATH 20C,A03,083448,Hammock; Frances H,20,0,30,10
1650001283492,MATH 20C,A04,083449,Hammock; Frances H,21,0,30,9
1650001283492,MATH 20C,B01,083451,Hammock; Frances H,0,0,30,30
1650001283492,MATH 20C,B02,083452,Hammock; Frances H,20,0,30,10
1650001283492,MATH 20C,B03,083453,Hammock; Frances H,23,0,30,7
1650001283492,MATH 20C,B04,083454,Hammock; Frances H,24,0,30,6
1650001289526,MATH 20D,A01,084128,Staff,14,0,30,16
1650001289526,MATH 20D,A02,084129,Staff,29,0,30,1
1650001289526,MATH 20D,A03,084130,Staff,27,0,30,3
1650001289526,MATH 20D,B01,084133,Staff,3,0,30,27
1650001289526,MATH 20D,B02,084134,Staff,24,0,30,6
1650001289526,MATH 20D,B03,084135,Staff,28,0,30,2
1650001295553,MATH 20E,A01,084138,Staff,14,0,30,16
1650001295553,MATH 20E,A02,084139,Staff,7,0,30,23
1650001295553,MATH 20E,A03,084140,Staff,15,0,30,15
1650001295553,MATH 20E,A04,084141,Staff,20,0,30,10
1650001301578,MATH 102,A01,084143,Harel; Guershon,12,0,30,18
1650001301578,MATH 102,A02,084144,Harel; Guershon,20,0,30,10
1650001307605,MATH 103B,A01,083456,Staff,0,13,30,30
1650001307605,MATH 103B,A02,083457,Staff,0,12,30,30
1650001313628,MATH 109,A01,084146,Salehi Golsefidy; Alireza,18,0,30,12
1650001313628,MATH 109,A02,084147,Salehi Golsefidy; Alireza,16,0,30,14
1650001319651,MATH 120A,A01,085445,Eggers; John Dietrich,12,0,35,23
1650001319651,MATH 120A,A02,085446,Eggers; John Dietrich,27,0,35,8
1650001325678,MATH 142B,A01,084149,Verstraete; Jacques Allan,0,12,30,30
1650001325678,MATH 142B,A02,084150,Verstraete; Jacques Allan,0,12,30,30
1650001331701,MATH 170A,A01,083459,Nie; Jiawang,0,9,30,30
1650001331701,MATH 170A,A02,083460,Nie; Jiawang,0,7,30,30
1650001331701,MATH 170A,A03,083461,Nie; Jiawang,0,9,30,30
1650001337723,MATH 193B,A01,083463,Staff,1,0,30,29
1650001337723,MATH 193B,A02,083464,Staff,9,0,30,21
1650001337723,MATH 193B,A03,083465,Staff,18,0,30,12
1650001343783,COGS 2,A01,083966,Boyle; Mary E. T.,10,0,30,20
1650001349805,COGS 9,A01,083968,Staff,13,0,60,47
1650001355829,COGS 14B,A01,083970,Staff,11,0,50,39
1650001361860,COGS 17,A01,092679,Staff,53,0,75,22
1650001367883,COGS 100,A01,083972,Staff,0,15,60,60
1650001379932,COGS 101C,A01,083976,Staff,13,0,30,17
1650001385955,COGS 102A,A01,083978,Johnson; Christine M.,14,0,30,16
1650001391979,COGS 107B,A01,083980,Staff,0,7,50,50
1650001398002,COGS 115,A01,083982,Staff,11,0,30,19
1650001404027,COGS 118B,A01,083367,Staff,0,14,40,40
1650001410050,COGS 172,A01,083984,Provenzano; Emily Kara,15,0,30,15
1650001416075,COGS 177,A00,083368,Staff,0,20,30,30
1650001422097,COGS 186,A01,083986,Staff,21,0,40,19
1650001428123,COGS 187A,A01,083988,Boyle; Mary E. T.,19,0,60,41
1650001434147,CSE 8A,A50,084003,Miranda; Gregory Joseph,0,13,15,15
1650001440172,CSE 11,A01,084005,Miranda; Gregory Joseph,0,19,55,55
1650001446204,CSE 20,A01,084007,Staff,0,5,20,20
1650001452229,CSE 21,A01,084009,Staff,0,30,50,50
1650001458251,CSE 30,A01,083370,Cao; Yingjun,0,63,40,40
1650001464272,CSE 100,A01,083372,Cao; Yingjun,0,46,40,40
1650001470295,CSE 101,A01,084011,Staff,0,53,40,40
1650001476316,CSE 141,A01,083374,Eldon; John,0,63,75,75
1650001482339,CSE 141L,A01,083376,Eldon; John,0,69,75,75
1650001488376,CSE 175,A01,084013,Kumar; Rakesh,22,0,25,3
1650001494404,CSE 190,A00,092508,Dubnov; Shlomo,20,0,20,0
1650001500427,ECE 5,A01,084049,Morris; Karcher William,13,0,20,7
1650001506453,ECE 100,A01,084051,Baghdadchi; Saharnaz,0,0,20,20
1650001506453,ECE 100,A02,091916,Baghdadchi; Saharnaz,14,0,20,6
1650001512476,ECE 101,A01,084053,Baghdadchi; Saharnaz,0,0,37,37
1650001512476,ECE 101,A02,084054,Baghdadchi; Saharnaz,30,0,37,7
1650001518503,ECE 107,A01,083390,Staff,26,0,40,14
1650001524531,ECE 148,A01,084056,Silberman; Jack,8,0,12,4
1650001530552,ECE 180,A00,083391,Abi Samra; Nicholas Camill,25,0,30,5
1650001530552,ECE 180,B00,083392,Abi Samra; Nicholas Camill,21,0,30,9
1650001536576,MATH 10B,A01,084110,Staff,0,0,30,30
1650001536576,MATH 10B,A02,084111,Staff,20,0,30,10
1650001536576,MATH 10B,A03,084112,Staff,24,0,30,6
1650001542605,MATH 10C,A01,083443,Staff,0,14,30,30
1650001542605,MATH 10C,A02,083444,Staff,0,14,30,30
1650001542605,MATH 10C,B01,084114,Staff,19,0,30,11
1650001542605,MATH 10C,B02,084115,Staff,25,0,30,5
1650001548639,MATH 18,A01,084117,Harel; Guershon,14,0,30,16
1650001548639,MATH 18,A02,084119,Harel; Guershon,28,0,30,2
1650001548639,MATH 18,A03,084120,Harel; Guershon,29,0,30,1
1650001548639,MATH 18,A04,084121,Harel; Guershon,29,0,30,1
1650001554687,MATH 20B,A01,084124,Um; Ko Woon,16,0,35,19
1650001554687,MATH 20B,B01,084126,Um; Ko Woon,26,0,35,9
1650001560711,MATH 20C,A01,083446,Hammock; Frances H,0,0,30,30
1650001560711,MATH 20C,A02,083447,Hammock; Frances H,16,0,30,14
1650001560711,MATH 20C,A03,083448,Hammock; Frances H,20,0,30,10
1650001560711,MATH 20C,A04,083449,Hammock; Frances H,21,0,30,9
1650001560711,MATH 20C,B01,083451,Hammock; Frances H,0,0,30,30
1650001560711,MATH 20C,B02,083452,Hammock; Frances H,20,0,30,10
1650001560711,MATH 20C,B03,083453,Hammock; Frances H,23,0,30,7
1650001560711,MATH 20C,B04,083454,Hammock; Frances H,24,0,30,6
1650001566737,MATH 20D,A01,084128,Staff,14,0,30,16
1650001566737,MATH 20D,A02,084129,Staff,29,0,30,1
1650001566737,MATH 20D,A03,084130,Staff,27,0,30,3
1650001566737,MATH 20D,B01,084133,Staff,3,0,30,27
1650001566737,MATH 20D,B02,084134,Staff,24,0,30,6
1650001566737,MATH 20D,B03,084135,Staff,28,0,30,2
1650001572763,MATH 20E,A01,084138,Staff,14,0,30,16
1650001572763,MATH 20E,A02,084139,Staff,7,0,30,23
1650001572763,MATH 20E,A03,084140,Staff,15,0,30,15
1650001572763,MATH 20E,A04,084141,Staff,20,0,30,10
1650001578795,MATH 102,A01,084143,Harel; Guershon,12,0,30,18
1650001578795,MATH 102,A02,084144,Harel; Guershon,20,0,30,10
1650001584820,MATH 103B,A01,083456,Staff,0,13,30,30
1650001584820,MATH 103B,A02,083457,Staff,0,12,30,30
1650001590845,MATH 109,A01,084146,Salehi Golsefidy; Alireza,18,0,30,12
1650001590845,MATH 109,A02,084147,Salehi Golsefidy; Alireza,16,0,30,14
1650001596867,MATH 120A,A01,085445,Eggers; John Dietrich,12,0,35,23
1650001596867,MATH 120A,A02,085446,Eggers; John Dietrich,27,0,35,8
1650001602890,MATH 142B,A01,084149,Verstraete; Jacques Allan,0,12,30,30
1650001602890,MATH 142B,A02,084150,Verstraete; Jacques Allan,0,12,30,30
1650001608917,MATH 170A,A01,083459,Nie; Jiawang,0,9,30,30
1650001608917,MATH 170A,A02,083460,Nie; Jiawang,0,7,30,30
1650001608917,MATH 170A,A03,083461,Nie; Jiawang,0,9,30,30
1650001614940,MATH 193B,A01,083463,Staff,1,0,30,29
1650001614940,MATH 193B,A02,083464,Staff,9,0,30,21
1650001614940,MATH 193B,A03,083465,Staff,18,0,30,12
1650001620994,COGS 2,A01,083966,Boyle; Mary E. T.,10,0,30,20
1650001627020,COGS 9,A01,083968,Staff,13,0,60,47
1650001633042,COGS 14B,A01,083970,Staff,11,0,50,39
1650001639063,COGS 17,A01,092679,Staff,53,0,75,22
1650001645089,COGS 100,A01,083972,Staff,0,15,60,60
1650001657146,COGS 101C,A01,083976,Staff,13,0,30,17
1650001663197,COGS 102A,A01,083978,Johnson; Christine M.,14,0,30,16
1650001669230,COGS 107B,A01,083980,Staff,0,7,50,50
1650001675252,COGS 115,A01,083982,Staff,11,0,30,19
1650001681274,COGS 118B,A01,083367,Staff,0,14,40,40
1650001687306,COGS 172,A01,083984,Provenzano; Emily Kara,15,0,30,15
1650001693336,COGS 177,A00,083368,Staff,0,20,30,30
1650001699358,COGS 186,A01,083986,Staff,21,0,40,19
1650001705391,COGS 187A,A01,083988,Boyle; Mary E. T.,19,0,60,41
1650001711414,CSE 8A,A50,084003,Miranda; Gregory Joseph,0,13,15,15
1650001717434,CSE 11,A01,084005,Miranda; Gregory Joseph,0,19,55,55
1650001723460,CSE 20,A01,084007,Staff,0,5,20,20
1650001729491,CSE 21,A01,084009,Staff,0,30,50,50
1650001735588,CSE 30,A01,083370,Cao; Yingjun,0,63,40,40
1650001741620,CSE 100,A01,083372,Cao; Yingjun,0,46,40,40
1650001747649,CSE 101,A01,084011,Staff,0,53,40,40
1650001753671,CSE 141,A01,083374,Eldon; John,0,63,75,75
1650001759693,CSE 141L,A01,083376,Eldon; John,0,69,75,75
1650001765715,CSE 175,A01,084013,Kumar; Rakesh,22,0,25,3
1650001771737,CSE 190,A00,092508,Dubnov; Shlomo,20,0,20,0
1650001777760,ECE 5,A01,084049,Morris; Karcher William,13,0,20,7
1650001783788,ECE 100,A01,084051,Baghdadchi; Saharnaz,0,0,20,20
1650001783788,ECE 100,A02,091916,Baghdadchi; Saharnaz,14,0,20,6
1650001789813,ECE 101,A01,084053,Baghdadchi; Saharnaz,0,0,37,37
1650001789813,ECE 101,A02,084054,Baghdadchi; Saharnaz,30,0,37,7
1650001795840,ECE 107,A01,083390,Staff,26,0,40,14
1650001801865,ECE 148,A01,084056,Silberman; Jack,8,0,12,4
1650001807888,ECE 180,A00,083391,Abi Samra; Nicholas Camill,25,0,30,5
1650001807888,ECE 180,B00,083392,Abi Samra; Nicholas Camill,21,0,30,9
1650001813915,MATH 10B,A01,084110,Staff,0,0,30,30
1650001813915,MATH 10B,A02,084111,Staff,20,0,30,10
1650001813915,MATH 10B,A03,084112,Staff,24,0,30,6
1650001819937,MATH 10C,A01,083443,Staff,0,14,30,30
1650001819937,MATH 10C,A02,083444,Staff,0,14,30,30
1650001819937,MATH 10C,B01,084114,Staff,19,0,30,11
1650001819937,MATH 10C,B02,084115,Staff,25,0,30,5
1650001825958,MATH 18,A01,084117,Harel; Guershon,14,0,30,16
1650001825958,MATH 18,A02,084119,Harel; Guershon,28,0,30,2
1650001825958,MATH 18,A03,084120,Harel; Guershon,29,0,30,1
1650001825958,MATH 18,A04,084121,Harel; Guershon,29,0,30,1
1650001831986,MATH 20B,A01,084124,Um; Ko Woon,16,0,35,19
1650001831986,MATH 20B,B01,084126,Um; Ko Woon,26,0,35,9
1650001838010,MATH 20C,A01,083446,Hammock; Frances H,0,0,30,30
1650001838010,MATH 20C,A02,083447,Hammock; Frances H,16,0,30,14
1650001838010,MATH 20C,A03,083448,Hammock; Frances H,20,0,30,10
1650001838010,MATH 20C,A04,083449,Hammock; Frances H,21,0,30,9
1650001838010,MATH 20C,B01,083451,Hammock; Frances H,0,0,30,30
1650001838010,MATH 20C,B02,083452,Hammock; Frances H,20,0,30,10
1650001838010,MATH 20C,B03,083453,Hammock; Frances H,23,0,30,7
1650001838010,MATH 20C,B04,083454,Hammock; Frances H,24,0,30,6
1650001844034,MATH 20D,A01,084128,Staff,14,0,30,16
1650001844034,MATH 20D,A02,084129,Staff,29,0,30,1
1650001844034,MATH 20D,A03,084130,Staff,27,0,30,3
1650001844034,MATH 20D,B01,084133,Staff,3,0,30,27
1650001844034,MATH 20D,B02,084134,Staff,24,0,30,6
1650001844034,MATH 20D,B03,084135,Staff,28,0,30,2
1650001850061,MATH 20E,A01,084138,Staff,14,0,30,16
1650001850061,MATH 20E,A02,084139,Staff,7,0,30,23
1650001850061,MATH 20E,A03,084140,Staff,15,0,30,15
1650001850061,MATH 20E,A04,084141,Staff,20,0,30,10
1650001856086,MATH 102,A01,084143,Harel; Guershon,12,0,30,18
1650001856086,MATH 102,A02,084144,Harel; Guershon,20,0,30,10
1650001862134,MATH 103B,A01,083456,Staff,0,13,30,30
1650001862134,MATH 103B,A02,083457,Staff,0,12,30,30
1650001868156,MATH 109,A01,084146,Salehi Golsefidy; Alireza,18,0,30,12
1650001868156,MATH 109,A02,084147,Salehi Golsefidy; Alireza,16,0,30,14
1650001874183,MATH 120A,A01,085445,Eggers; John Dietrich,12,0,35,23
1650001874183,MATH 120A,A02,085446,Eggers; John Dietrich,27,0,35,8
1650001880206,MATH 142B,A01,084149,Verstraete; Jacques Allan,0,12,30,30
1650001880206,MATH 142B,A02,084150,Verstraete; Jacques Allan,0,12,30,30
1650001886229,MATH 170A,A01,083459,Nie; Jiawang,0,9,30,30
1650001886229,MATH 170A,A02,083460,Nie; Jiawang,0,7,30,30
1650001886229,MATH 170A,A03,083461,Nie; Jiawang,0,9,30,30
1650001892255,MATH 193B,A01,083463,Staff,1,0,30,29
1650001892255,MATH 193B,A02,083464,Staff,9,0,30,21
1650001892255,MATH 193B,A03,083465,Staff,18,0,30,12
1650001898304,COGS 2,A01,083966,Boyle; Mary E. T.,10,0,30,20
1650001904332,COGS 9,A01,083968,Staff,13,0,60,47
1650001910355,COGS 14B,A01,083970,Staff,11,0,50,39
1650001916378,COGS 17,A01,092679,Staff,53,0,75,22
1650001922404,COGS 100,A01,083972,Staff,0,15,60,60
1650001934463,COGS 101C,A01,083976,Staff,13,0,30,17
1650001940490,COGS 102A,A01,083978,Johnson; Christine M.,14,0,30,16
1650001946511,COGS 107B,A01,083980,Staff,0,7,50,50
1650001952533,COGS 115,A01,083982,Staff,11,0,30,19
1650001958558,COGS 118B,A01,083367,Staff,0,14,40,40
1650001964592,COGS 172,A01,083984,Provenzano; Emily Kara,15,0,30,15
1650001970614,COGS 177,A00,083368,Staff,0,20,30,30
1650001976640,COGS 186,A01,083986,Staff,21,0,40,19
1650001982666,COGS 187A,A01,083988,Boyle; Mary E. T.,19,0,60,41
1650001988691,CSE 8A,A50,084003,Miranda; Gregory Joseph,0,13,15,15
1650001994713,CSE 11,A01,084005,Miranda; Gregory Joseph,0,19,55,55
1650002000739,CSE 20,A01,084007,Staff,0,5,20,20
1650002006762,CSE 21,A01,084009,Staff,0,30,50,50
1650002012794,CSE 30,A01,083370,Cao; Yingjun,0,63,40,40
1650002018820,CSE 100,A01,083372,Cao; Yingjun,0,46,40,40
1650002024841,CSE 101,A01,084011,Staff,0,53,40,40
1650002030867,CSE 141,A01,083374,Eldon; John,0,63,75,75
1650002036891,CSE 141L,A01,083376,Eldon; John,0,69,75,75
1650002042914,CSE 175,A01,084013,Kumar; Rakesh,22,0,25,3
1650002048943,CSE 190,A00,092508,Dubnov; Shlomo,20,0,20,0
1650002054966,ECE 5,A01,084049,Morris; Karcher William,13,0,20,7
1650002060990,ECE 100,A01,084051,Baghdadchi; Saharnaz,0,0,20,20
1650002060990,ECE 100,A02,091916,Baghdadchi; Saharnaz,14,0,20,6
1650002067024,ECE 101,A01,084053,Baghdadchi; Saharnaz,0,0,37,37
1650002067024,ECE 101,A02,084054,Baghdadchi; Saharnaz,30,0,37,7
1650002073051,ECE 107,A01,083390,Staff,26,0,40,14
1650002079077,ECE 148,A01,084056,Silberman; Jack,8,0,12,4
1650002085099,ECE 180,A00,083391,Abi Samra; Nicholas Camill,25,0,30,5
1650002085099,ECE 180,B00,083392,Abi Samra; Nicholas Camill,21,0,30,9
1650002091127,MATH 10B,A01,084110,Staff,0,0,30,30
1650002091127,MATH 10B,A02,084111,Staff,19,0,30,11
1650002091127,MATH 10B,A03,084112,Staff,24,0,30,6
1650002097148,MATH 10C,A01,083443,Staff,0,14,30,30
1650002097148,MATH 10C,A02,083444,Staff,0,14,30,30
1650002097148,MATH 10C,B01,084114,Staff,19,0,30,11
1650002097148,MATH 10C,B02,084115,Staff,25,0,30,5
1650002103171,MATH 18,A01,084117,Harel; Guershon,14,0,30,16
1650002103171,MATH 18,A02,084119,Harel; Guershon,28,0,30,2
1650002103171,MATH 18,A03,084120,Harel; Guershon,29,0,30,1
1650002103171,MATH 18,A04,084121,Harel; Guershon,29,0,30,1
1650002109193,MATH 20B,A01,084124,Um; Ko Woon,16,0,35,19
1650002109193,MATH 20B,B01,084126,Um; Ko Woon,26,0,35,9
1650002115220,MATH 20C,A01,083446,Hammock; Frances H,0,0,30,30
1650002115220,MATH 20C,A02,083447,Hammock; Frances H,16,0,30,14
1650002115220,MATH 20C,A03,083448,Hammock; Frances H,20,0,30,10
1650002115220,MATH 20C,A04,083449,Hammock; Frances H,21,0,30,9
1650002115220,MATH 20C,B01,083451,Hammock; Frances H,0,0,30,30
1650002115220,MATH 20C,B02,083452,Hammock; Frances H,19,0,30,11
1650002115220,MATH 20C,B03,083453,Hammock; Frances H,23,0,30,7
1650002115220,MATH 20C,B04,083454,Hammock; Frances H,24,0,30,6
1650002121242,MATH 20D,A01,084128,Staff,14,0,30,16
1650002121242,MATH 20D,A02,084129,Staff,29,0,30,1
1650002121242,MATH 20D,A03,084130,Staff,27,0,30,3
1650002121242,MATH 20D,B01,084133,Staff,3,0,30,27
1650002121242,MATH 20D,B02,084134,Staff,24,0,30,6
1650002121242,MATH 20D,B03,084135,Staff,28,0,30,2
1650002127267,MATH 20E,A01,084138,Staff,14,0,30,16
1650002127267,MATH 20E,A02,084139,Staff,7,0,30,23
1650002127267,MATH 20E,A03,084140,Staff,15,0,30,15
1650002127267,MATH 20E,A04,084141,Staff,20,0,30,10
1650002133305,MATH 102,A01,084143,Harel; Guershon,12,0,30,18
1650002133305,MATH 102,A02,084144,Harel; Guershon,20,0,30,10
1650002139326,MATH 103B,A01,083456,Staff,0,13,30,30
1650002139326,MATH 103B,A02,083457,Staff,0,12,30,30
1650002145353,MATH 109,A01,084146,Salehi Golsefidy; Alireza,18,0,30,12
1650002145353,MATH 109,A02,084147,Salehi Golsefidy; Alireza,16,0,30,14
1650002151375,MATH 120A,A01,085445,Eggers; John Dietrich,12,0,35,23
1650002151375,MATH 120A,A02,085446,Eggers; John Dietrich,27,0,35,8
1650002157398,MATH 142B,A01,084149,Verstraete; Jacques Allan,0,12,30,30
1650002157398,MATH 142B,A02,084150,Verstraete; Jacques Allan,0,12,30,30
1650002163422,MATH 170A,A01,083459,Nie; Jiawang,0,9,30,30
1650002163422,MATH 170A,A02,083460,Nie; Jiawang,0,7,30,30
1650002163422,MATH 170A,A03,083461,Nie; Jiawang,0,9,30,30
1650002169446,MATH 193B,A01,083463,Staff,1,0,30,29
1650002169446,MATH 193B,A02,083464,Staff,9,0,30,21
1650002169446,MATH 193B,A03,083465,Staff,18,0,30,12
1650002175497,COGS 2,A01,083966,Boyle; Mary E. T.,10,0,30,20
1650002181519,COGS 9,A01,083968,Staff,12,0,60,48
1650002187549,COGS 14B,A01,083970,Staff,11,0,50,39
1650002193574,COGS 17,A01,092679,Staff,53,0,75,22
1650002199598,COGS 100,A01,083972,Staff,0,15,60,60
1650002211652,COGS 101C,A01,083976,Staff,13,0,30,17
1650002217682,COGS 102A,A01,083978,Johnson; Christine M.,14,0,30,16
1650002223719,COGS 107B,A01,083980,Staff,0,7,50,50
1650002229742,COGS 115,A01,083982,Staff,11,0,30,19
1650002235781,COGS 118B,A01,083367,Staff,0,14,40,40
1650002241807,COGS 172,A01,083984,Provenzano; Emily Kara,15,0,30,15
1650002247832,COGS 177,A00,083368,Staff,0,20,30,30
1650002253858,COGS 186,A01,083986,Staff,21,0,40,19
1650002259883,COGS 187A,A01,083988,Boyle; Mary E. T.,19,0,60,41
1650002265905,CSE 8A,A50,084003,Miranda; Gregory Joseph,0,13,15,15
1650002271948,CSE 11,A01,084005,Miranda; Gregory Joseph,0,19,55,55
1650002277975,CSE 20,A01,084007,Staff,0,5,20,20
1650002283998,CSE 21,A01,084009,Staff,0,30,50,50
1650002290020,CSE 30,A01,083370,Cao; Yingjun,0,63,40,40
1650002296047,CSE 100,A01,083372,Cao; Yingjun,0,46,40,40
1650002302073,CSE 101,A01,084011,Staff,0,53,40,40
1650002308098,CSE 141,A01,083374,Eldon; John,0,63,75,75
1650002314121,CSE 141L,A01,083376,Eldon; John,0,69,75,75
1650002320150,CSE 175,A01,084013,Kumar; Rakesh,22,0,25,3
1650002326176,CSE 190,A00,092508,Dubnov; Shlomo,20,0,20,0
1650002332274,ECE 5,A01,084049,Morris; Karcher William,13,0,20,7
1650002338297,ECE 100,A01,084051,Baghdadchi; Saharnaz,0,0,20,20
1650002338297,ECE 100,A02,091916,Baghdadchi; Saharnaz,13,0,20,7
1650002344321,ECE 101,A01,084053,Baghdadchi; Saharnaz,0,0,37,37
1650002344321,ECE 101,A02,084054,Baghdadchi; Saharnaz,30,0,37,7
1650002350356,ECE 107,A01,083390,Staff,26,0,40,14
1650002356380,ECE 148,A01,084056,Silberman; Jack,8,0,12,4
1650002362406,ECE 180,A00,083391,Abi Samra; Nicholas Camill,25,0,30,5
1650002362406,ECE 180,B00,083392,Abi Samra; Nicholas Camill,21,0,30,9
1650002368427,MATH 10B,A01,084110,Staff,0,0,30,30
1650002368427,MATH 10B,A02,084111,Staff,19,0,30,11
1650002368427,MATH 10B,A03,084112,Staff,24,0,30,6
1650002374453,MATH 10C,A01,083443,Staff,0,14,30,30
1650002374453,MATH 10C,A02,083444,Staff,0,14,30,30
1650002374453,MATH 10C,B01,084114,Staff,19,0,30,11
1650002374453,MATH 10C,B02,084115,Staff,25,0,30,5
1650002380477,MATH 18,A01,084117,Harel; Guershon,14,0,30,16
1650002380477,MATH 18,A02,084119,Harel; Guershon,28,0,30,2
1650002380477,MATH 18,A03,084120,Harel; Guershon,29,0,30,1
1650002380477,MATH 18,A04,084121,Harel; Guershon,29,0,30,1
1650002386510,MATH 20B,A01,084124,Um; Ko Woon,16,0,35,19
1650002386510,MATH 20B,B01,084126,Um; Ko Woon,26,0,35,9
1650002392545,MATH 20C,A01,083446,Hammock; Frances H,0,0,30,30
1650002392545,MATH 20C,A02,083447,Hammock; Frances H,16,0,30,14
1650002392545,MATH 20C,A03,083448,Hammock; Frances H,20,0,30,10
1650002392545,MATH 20C,A04,083449,Hammock; Frances H,21,0,30,9
1650002392545,MATH 20C,B01,083451,Hammock; Frances H,0,0,30,30
1650002392545,MATH 20C,B02,083452,Hammock; Frances H,19,0,30,11
1650002392545,MATH 20C,B03,083453,Hammock; Frances H,23,0,30,7
1650002392545,MATH 20C,B04,083454,Hammock; Frances H,24,0,30,6
1650002398569,MATH 20D,A01,084128,Staff,14,0,30,16
1650002398569,MATH 20D,A02,084129,Staff,29,0,30,1
1650002398569,MATH 20D,A03,084130,Staff,27,0,30,3
1650002398569,MATH 20D,B01,084133,Staff,3,0,30,27
1650002398569,MATH 20D,B02,084134,Staff,24,0,30,6
1650002398569,MATH 20D,B03,084135,Staff,28,0,30,2
1650002404596,MATH 20E,A01,084138,Staff,13,0,30,17
1650002404596,MATH 20E,A02,084139,Staff,7,0,30,23
1650002404596,MATH 20E,A03,084140,Staff,15,0,30,15
1650002404596,MATH 20E,A04,084141,Staff,20,0,30,10
1650002410618,MATH 102,A01,084143,Harel; Guershon,12,0,30,18
1650002410618,MATH 102,A02,084144,Harel; Guershon,20,0,30,10
1650002416642,MATH 103B,A01,083456,Staff,0,13,30,30
1650002416642,MATH 103B,A02,083457,Staff,0,12,30,30
1650002422663,MATH 109,A01,084146,Salehi Golsefidy; Alireza,18,0,30,12
1650002422663,MATH 109,A02,084147,Salehi Golsefidy; Alireza,16,0,30,14
1650002428685,MATH 120A,A01,085445,Eggers; John Dietrich,12,0,35,23
1650002428685,MATH 120A,A02,085446,Eggers; John Dietrich,27,0,35,8
1650002434709,MATH 142B,A01,084149,Verstraete; Jacques Allan,0,12,30,30
1650002434709,MATH 142B,A02,084150,Verstraete; Jacques Allan,0,12,30,30
1650002440739,MATH 170A,A01,083459,Nie; Jiawang,0,9,30,30
1650002440739,MATH 170A,A02,083460,Nie; Jiawang,0,7,30,30
1650002440739,MATH 170A,A03,083461,Nie; Jiawang,0,9,30,30
1650002446764,MATH 193B,A01,083463,Staff,1,0,30,29
1650002446764,MATH 193B,A02,083464,Staff,9,0,30,21
1650002446764,MATH 193B,A03,083465,Staff,18,0,30,12
1650002452831,COGS 2,A01,083966,Boyle; Mary E. T.,10,0,30,20
1650002458853,COGS 9,A01,083968,Staff,10,0,60,50
1650002464877,COGS 14B,A01,083970,Staff,11,0,50,39
1650002470901,COGS 17,A01,092679,Staff,53,0,75,22
1650002476923,COGS 100,A01,083972,Staff,0,15,60,60
1650002488972,COGS 101C,A01,083976,Staff,13,0,30,17
1650002495001,COGS 102A,A01,083978,Johnson; Christine M.,14,0,30,16
1650002501033,COGS 107B,A01,083980,Staff,0,7,50,50
1650002507062,COGS 115,A01,083982,Staff,11,0,30,19
1650002513086,COGS 118B,A01,083367,Staff,0,14,40,40
1650002519116,COGS 172,A01,083984,Provenzano; Emily Kara,15,0,30,15
1650002525139,COGS 177,A00,083368,Staff,0,20,30,30
1650002531171,COGS 186,A01,083986,Staff,21,0,40,19
1650002537194,COGS 187A,A01,083988,Boyle; Mary E. T.,19,0,60,41
1650002543238,CSE 8A,A50,084003,Miranda; Gregory Joseph,0,13,15,15
1650002549266,CSE 11,A01,084005,Miranda; Gregory Joseph,0,19,55,55
1650002555295,CSE 20,A01,084007,Staff,0,5,20,20
1650002561319,CSE 21,A01,084009,Staff,0,30,50,50
1650002567341,CSE 30,A01,083370,Cao; Yingjun,0,63,40,40
1650002573365,CSE 100,A01,083372,Cao; Yingjun,0,46,40,40
1650002579389,CSE 101,A01,084011,Staff,0,53,40,40
1650002585419,CSE 141,A01,083374,Eldon; John,0,63,75,75
1650002591444,CSE 141L,A01,083376,Eldon; John,0,69,75,75
1650002597471,CSE 175,A01,084013,Kumar; Rakesh,22,0,25,3
1650002603494,CSE 190,A00,092508,Dubnov; Shlomo,20,0,20,0
1650002609522,ECE 5,A01,084049,Morris; Karcher William,13,0,20,7
1650002615555,ECE 100,A01,084051,Baghdadchi; Saharnaz,0,0,20,20
1650002615555,ECE 100,A02,091916,Baghdadchi; Saharnaz,13,0,20,7
1650002621578,ECE 101,A01,084053,Baghdadchi; Saharnaz,0,0,37,37
1650002621578,ECE 101,A02,084054,Baghdadchi; Saharnaz,30,0,37,7
1650002627607,ECE 107,A01,083390,Staff,26,0,40,14
1650002633638,ECE 148,A01,084056,Silberman; Jack,8,0,12,4
1650002639662,ECE 180,A00,083391,Abi Samra; Nicholas Camill,25,0,30,5
1650002639662,ECE 180,B00,083392,Abi Samra; Nicholas Camill,21,0,30,9
1650002645694,MATH 10B,A01,084110,Staff,0,0,30,30
1650002645694,MATH 10B,A02,084111,Staff,19,0,30,11
1650002645694,MATH 10B,A03,084112,Staff,24,0,30,6
1650002651719,MATH 10C,A01,083443,Staff,0,14,30,30
1650002651719,MATH 10C,A02,083444,Staff,0,14,30,30
1650002651719,MATH 10C,B01,084114,Staff,19,0,30,11
1650002651719,MATH 10C,B02,084115,Staff,25,0,30,5
1650002657746,MATH 18,A01,084117,Harel; Guershon,14,0,30,16
1650002657746,MATH 18,A02,084119,Harel; Guershon,28,0,30,2
1650002657746,MATH 18,A03,084120,Harel; Guershon,29,0,30,1
1650002657746,MATH 18,A04,084121,Harel; Guershon,29,0,30,1
1650002663774,MATH 20B,A01,084124,Um; Ko Woon,16,0,35,19
1650002663774,MATH 20B,B01,084126,Um; Ko Woon,26,0,35,9
1650002669799,MATH 20C,A01,083446,Hammock; Frances H,0,0,30,30
1650002669799,MATH 20C,A02,083447,Hammock; Frances H,16,0,30,14
1650002669799,MATH 20C,A03,083448,Hammock; Frances H,20,0,30,10
1650002669799,MATH 20C,A04,083449,Hammock; Frances H,21,0,30,9
1650002669799,MATH 20C,B01,083451,Hammock; Frances H,0,0,30,30
1650002669799,MATH 20C,B02,083452,Hammock; Frances H,19,0,30,11
1650002669799,MATH 20C,B03,083453,Hammock; Frances H,22,0,30,8
1650002669799,MATH 20C,B04,083454,Hammock; Frances H,24,0,30,6
1650002675824,MATH 20D,A01,084128,Staff,14,0,30,16
1650002675824,MATH 20D,A02,084129,Staff,29,0,30,1
1650002675824,MATH 20D,A03,084130,Staff,27,0,30,3
1650002675824,MATH 20D,B01,084133,Staff,3,0,30,27
1650002675824,MATH 20D,B02,084134,Staff,24,0,30,6
1650002675824,MATH 20D,B03,084135,Staff,28,0,30,2
1650002681847,MATH 20E,A01,084138,Staff,13,0,30,17
1650002681847,MATH 20E,A02,084139,Staff,7,0,30,23
1650002681847,MATH 20E,A03,084140,Staff,15,0,30,15
1650002681847,MATH 20E,A04,084141,Staff,20,0,30,10
1650002687877,MATH 102,A01,084143,Harel; Guershon,12,0,30,18
1650002687877,MATH 102,A02,084144,Harel; Guershon,20,0,30,10
1650002693903,MATH 103B,A01,083456,Staff,0,13,30,30
1650002693903,MATH 103B,A02,083457,Staff,0,12,30,30
1650002699930,MATH 109,A01,084146,Salehi Golsefidy; Alireza,18,0,30,12
1650002699930,MATH 109,A02,084147,Salehi Golsefidy; Alireza,16,0,30,14
1650002705953,MATH 120A,A01,085445,Eggers; John Dietrich,12,0,35,23
1650002705953,MATH 120A,A02,085446,Eggers; John Dietrich,27,0,35,8
1650002711977,MATH 142B,A01,084149,Verstraete; Jacques Allan,0,12,30,30
1650002711977,MATH 142B,A02,084150,Verstraete; Jacques Allan,0,12,30,30
1650002718001,MATH 170A,A01,083459,Nie; Jiawang,0,9,30,30
1650002718001,MATH 170A,A02,083460,Nie; Jiawang,0,7,30,30
1650002718001,MATH 170A,A03,083461,Nie; Jiawang,0,9,30,30
1650002724024,MATH 193B,A01,083463,Staff,1,0,30,29
1650002724024,MATH 193B,A02,083464,Staff,9,0,30,21
1650002724024,MATH 193B,A03,083465,Staff,18,0,30,12
1650002730085,COGS 2,A01,083966,Boyle; Mary E. T.,10,0,30,20
1650002736108,COGS 9,A01,083968,Staff,9,0,60,51
1650002742145,COGS 14B,A01,083970,Staff,11,0,50,39
1650002748169,COGS 17,A01,092679,Staff,53,0,75,22
1650002754192,COGS 100,A01,083972,Staff,0,15,60,60
1650002766251,COGS 101C,A01,083976,Staff,13,0,30,17
1650002772275,COGS 102A,A01,083978,Johnson; Christine M.,14,0,30,16
1650002778302,COGS 107B,A01,083980,Staff,0,7,50,50
1650002784327,COGS 115,A01,083982,Staff,11,0,30,19
1650002790349,COGS 118B,A01,083367,Staff,0,14,40,40
1650002796373,COGS 172,A01,083984,Provenzano; Emily Kara,15,0,30,15
1650002802398,COGS 177,A00,083368,Staff,0,20,30,30
1650002808422,COGS 186,A01,083986,Staff,21,0,40,19
1650002814444,COGS 187A,A01,083988,Boyle; Mary E. T.,19,0,60,41
1650002820473,CSE 8A,A50,084003,Miranda; Gregory Joseph,0,13,15,15
1650002826500,CSE 11,A01,084005,Miranda; Gregory Joseph,0,19,55,55
1650002832536,CSE 20,A01,084007,Staff,0,5,20,20
1650002838564,CSE 21,A01,084009,Staff,0,30,50,50
1650002844598,CSE 30,A01,083370,Cao; Yingjun,0,63,40,40
1650002850621,CSE 100,A01,083372,Cao; Yingjun,0,46,40,40
1650002856647,CSE 101,A01,084011,Staff,0,53,40,40
1650002862671,CSE 141,A01,083374,Eldon; John,0,63,75,75
1650002868697,CSE 141L,A01,083376,Eldon; John,0,69,75,75
1650002874721,CSE 175,A01,084013,Kumar; Rakesh,22,0,25,3
1650002880748,CSE 190,A00,092508,Dubnov; Shlomo,20,0,20,0
1650002886772,ECE 5,A01,084049,Morris; Karcher William,13,0,20,7
1650002892794,ECE 100,A01,084051,Baghdadchi; Saharnaz,0,0,20,20
1650002892794,ECE 100,A02,091916,Baghdadchi; Saharnaz,13,0,20,7
1650002898817,ECE 101,A01,084053,Baghdadchi; Saharnaz,0,0,37,37
1650002898817,ECE 101,A02,084054,Baghdadchi; Saharnaz,30,0,37,7
1650002904846,ECE 107,A01,083390,Staff,26,0,40,14
1650002910872,ECE 148,A01,084056,Silberman; Jack,8,0,12,4
1650002916895,ECE 180,A00,083391,Abi Samra; Nicholas Camill,25,0,30,5
1650002916895,ECE 180,B00,083392,Abi Samra; Nicholas Camill,21,0,30,9
1650002922927,MATH 10B,A01,084110,Staff,0,0,30,30
1650002922927,MATH 10B,A02,084111,Staff,19,0,30,11
1650002922927,MATH 10B,A03,084112,Staff,24,0,30,6
1650002929053,MATH 10C,A01,083443,Staff,0,14,30,30
1650002929053,MATH 10C,A02,083444,Staff,0,14,30,30
1650002929053,MATH 10C,B01,084114,Staff,19,0,30,11
1650002929053,MATH 10C,B02,084115,Staff,25,0,30,5
1650002935077,MATH 18,A01,084117,Harel; Guershon,14,0,30,16
1650002935077,MATH 18,A02,084119,Harel; Guershon,28,0,30,2
1650002935077,MATH 18,A03,084120,Harel; Guershon,29,0,30,1
1650002935077,MATH 18,A04,084121,Harel; Guershon,29,0,30,1
1650002941101,MATH 20B,A01,084124,Um; Ko Woon,16,0,35,19
1650002941101,MATH 20B,B01,084126,Um; Ko Woon,26,0,35,9
1650002947134,MATH 20C,A01,083446,Hammock; Frances H,0,0,30,30
1650002947134,MATH 20C,A02,083447,Hammock; Frances H,16,0,30,14
1650002947134,MATH 20C,A03,083448,Hammock; Frances H,20,0,30,10
1650002947134,MATH 20C,A04,083449,Hammock; Frances H,21,0,30,9
1650002947134,MATH 20C,B01,083451,Hammock; Frances H,0,0,30,30
1650002947134,MATH 20C,B02,083452,Hammock; Frances H,19,0,30,11
1650002947134,MATH 20C,B03,083453,Hammock; Frances H,22,0,30,8
1650002947134,MATH 20C,B04,083454,Hammock; Frances H,24,0,30,6
1650002953166,MATH 20D,A01,084128,Staff,14,0,30,16
1650002953166,MATH 20D,A02,084129,Staff,29,0,30,1
1650002953166,MATH 20D,A03,084130,Staff,27,0,30,3
1650002953166,MATH 20D,B01,084133,Staff,3,0,30,27
1650002953166,MATH 20D,B02,084134,Staff,24,0,30,6
1650002953166,MATH 20D,B03,084135,Staff,28,0,30,2
1650002959188,MATH 20E,A01,084138,Staff,13,0,30,17
1650002959188,MATH 20E,A02,084139,Staff,7,0,30,23
1650002959188,MATH 20E,A03,084140,Staff,15,0,30,15
1650002959188,MATH 20E,A04,084141,Staff,20,0,30,10
1650002965212,MATH 102,A01,084143,Harel; Guershon,12,0,30,18
1650002965212,MATH 102,A02,084144,Harel; Guershon,20,0,30,10
1650002971235,MATH 103B,A01,083456,Staff,0,13,30,30
1650002971235,MATH 103B,A02,083457,Staff,0,12,30,30
1650002977260,MATH 109,A01,084146,Salehi Golsefidy; Alireza,18,0,30,12
1650002977260,MATH 109,A02,084147,Salehi Golsefidy; Alireza,16,0,30,14
1650002983286,MATH 120A,A01,085445,Eggers; John Dietrich,12,0,35,23
1650002983286,MATH 120A,A02,085446,Eggers; John Dietrich,27,0,35,8
1650002989316,MATH 142B,A01,084149,Verstraete; Jacques Allan,0,12,30,30
1650002989316,MATH 142B,A02,084150,Verstraete; Jacques Allan,0,12,30,30
1650002995344,MATH 170A,A01,083459,Nie; Jiawang,0,9,30,30
1650002995344,MATH 170A,A02,083460,Nie; Jiawang,0,7,30,30
1650002995344,MATH 170A,A03,083461,Nie; Jiawang,0,9,30,30
1650003001376,MATH 193B,A01,083463,Staff,1,0,30,29
1650003001376,MATH 193B,A02,083464,Staff,9,0,30,21
1650003001376,MATH 193B,A03,083465,Staff,18,0,30,12
1650003007425,COGS 2,A01,083966,Boyle; Mary E. T.,10,0,30,20
1650003013451,COGS 9,A01,083968,Staff,9,0,60,51
1650003019475,COGS 14B,A01,083970,Staff,11,0,50,39
1650003025499,COGS 17,A01,092679,Staff,53,0,75,22
1650003031522,COGS 100,A01,083972,Staff,0,15,60,60
1650003043571,COGS 101C,A01,083976,Staff,13,0,30,17
1650003049596,COGS 102A,A01,083978,Johnson; Christine M.,14,0,30,16
1650003055626,COGS 107B,A01,083980,Staff,0,7,50,50
1650003061648,COGS 115,A01,083982,Staff,11,0,30,19
1650003067675,COGS 118B,A01,083367,Staff,0,14,40,40
1650003073698,COGS 172,A01,083984,Provenzano; Emily Kara,15,0,30,15
1650003079731,COGS 177,A00,083368,Staff,0,20,30,30
1650003085755,COGS 186,A01,083986,Staff,21,0,40,19
1650003091787,COGS 187A,A01,083988,Boyle; Mary E. T.,19,0,60,41
1650003097811,CSE 8A,A50,084003,Miranda; Gregory Joseph,0,13,15,15
1650003103835,CSE 11,A01,084005,Miranda; Gregory Joseph,0,19,55,55
1650003109866,CSE 20,A01,084007,Staff,0,5,20,20
1650003115892,CSE 21,A01,084009,Staff,0,30,50,50
1650003121916,CSE 30,A01,083370,Cao; Yingjun,0,63,40,40
1650003127942,CSE 100,A01,083372,Cao; Yingjun,0,46,40,40
1650003133969,CSE 101,A01,084011,Staff,0,53,40,40
1650003139997,CSE 141,A01,083374,Eldon; John,0,63,75,75
1650003146024,CSE 141L,A01,083376,Eldon; John,0,69,75,75
1650003152047,CSE 175,A01,084013,Kumar; Rakesh,22,0,25,3
1650003158071,CSE 190,A00,092508,Dubnov; Shlomo,20,0,20,0
1650003164101,ECE 5,A01,084049,Morris; Karcher William,13,0,20,7
1650003170124,ECE 100,A01,084051,Baghdadchi; Saharnaz,0,0,20,20
1650003170124,ECE 100,A02,091916,Baghdadchi; Saharnaz,13,0,20,7
1650003176148,ECE 101,A01,084053,Baghdadchi; Saharnaz,0,0,37,37
1650003176148,ECE 101,A02,084054,Baghdadchi; Saharnaz,30,0,37,7
1650003182180,ECE 107,A01,083390,Staff,26,0,40,14
1650003188207,ECE 148,A01,084056,Silberman; Jack,8,0,12,4
1650003194233,ECE 180,A00,083391,Abi Samra; Nicholas Camill,25,0,30,5
1650003194233,ECE 180,B00,083392,Abi Samra; Nicholas Camill,21,0,30,9
1650003200258,MATH 10B,A01,084110,Staff,0,0,30,30
1650003200258,MATH 10B,A02,084111,Staff,19,0,30,11
1650003200258,MATH 10B,A03,084112,Staff,24,0,30,6
1650003206281,MATH 10C,A01,083443,Staff,0,15,30,30
1650003206281,MATH 10C,A02,083444,Staff,0,14,30,30
1650003206281,MATH 10C,B01,084114,Staff,19,0,30,11
1650003206281,MATH 10C,B02,084115,Staff,25,0,30,5
1650003212311,MATH 18,A01,084117,Harel; Guershon,14,0,30,16
1650003212311,MATH 18,A02,084119,Harel; Guershon,28,0,30,2
1650003212311,MATH 18,A03,084120,Harel; Guershon,29,0,30,1
1650003212311,MATH 18,A04,084121,Harel; Guershon,29,0,30,1
1650003218337,MATH 20B,A01,084124,Um; Ko Woon,16,0,35,19
1650003218337,MATH 20B,B01,084126,Um; Ko Woon,26,0,35,9
1650003224366,MATH 20C,A01,083446,Hammock; Frances H,0,0,30,30
1650003224366,MATH 20C,A02,083447,Hammock; Frances H,16,0,30,14
1650003224366,MATH 20C,A03,083448,Hammock; Frances H,20,0,30,10
1650003224366,MATH 20C,A04,083449,Hammock; Frances H,21,0,30,9
1650003224366,MATH 20C,B01,083451,Hammock; Frances H,0,0,30,30
1650003224366,MATH 20C,B02,083452,Hammock; Frances H,19,0,30,11
1650003224366,MATH 20C,B03,083453,Hammock; Frances H,22,0,30,8
1650003224366,MATH 20C,B04,083454,Hammock; Frances H,24,0,30,6
1650003230392,MATH 20D,A01,084128,Staff,14,0,30,16
1650003230392,MATH 20D,A02,084129,Staff,29,0,30,1
1650003230392,MATH 20D,A03,084130,Staff,27,0,30,3
1650003230392,MATH 20D,B01,084133,Staff,3,0,30,27
1650003230392,MATH 20D,B02,084134,Staff,24,0,30,6
1650003230392,MATH 20D,B03,084135,Staff,28,0,30,2
1650003236442,MATH 20E,A01,084138,Staff,13,0,30,17
1650003236442,MATH 20E,A02,084139,Staff,7,0,30,23
1650003236442,MATH 20E,A03,084140,Staff,15,0,30,15
1650003236442,MATH 20E,A04,084141,Staff,20,0,30,10
1650003242465,MATH 102,A01,084143,Harel; Guershon,12,0,30,18
1650003242465,MATH 102,A02,084144,Harel; Guershon,20,0,30,10
1650003248489,MATH 103B,A01,083456,Staff,0,13,30,30
1650003248489,MATH 103B,A02,083457,Staff,0,12,30,30
1650003254522,MATH 109,A01,084146,Salehi Golsefidy; Alireza,18,0,30,12
1650003254522,MATH 109,A02,084147,Salehi Golsefidy; Alireza,16,0,30,14
1650003260552,MATH 120A,A01,085445,Eggers; John Dietrich,12,0,35,23
1650003260552,MATH 120A,A02,085446,Eggers; John Dietrich,27,0,35,8
1650003266576,MATH 142B,A01,084149,Verstraete; Jacques Allan,0,12,30,30
1650003266576,MATH 142B,A02,084150,Verstraete; Jacques Allan,0,12,30,30
1650003272600,MATH 170A,A01,083459,Nie; Jiawang,0,9,30,30
1650003272600,MATH 170A,A02,083460,Nie; Jiawang,0,7,30,30
1650003272600,MATH 170A,A03,083461,Nie; Jiawang,0,9,30,30
1650003278626,MATH 193B,A01,083463,Staff,1,0,30,29
1650003278626,MATH 193B,A02,083464,Staff,9,0,30,21
1650003278626,MATH 193B,A03,083465,Staff,18,0,30,12
1650003284688,COGS 2,A01,083966,Boyle; Mary E. T.,10,0,30,20
1650003290710,COGS 9,A01,083968,Staff,9,0,60,51
1650003296738,COGS 14B,A01,083970,Staff,11,0,50,39
1650003302764,COGS 17,A01,092679,Staff,53,0,75,22
1650003308790,COGS 100,A01,083972,Staff,0,15,60,60
1650003320838,COGS 101C,A01,083976,Staff,13,0,30,17
1650003326872,COGS 102A,A01,083978,Johnson; Christine M.,14,0,30,16
1650003332899,COGS 107B,A01,083980,Staff,0,7,50,50
1650003338928,COGS 115,A01,083982,Staff,11,0,30,19
1650003344949,COGS 118B,A01,083367,Staff,0,14,40,40
1650003350982,COGS 172,A01,083984,Provenzano; Emily Kara,15,0,30,15
1650003357010,COGS 177,A00,083368,Staff,0,20,30,30
1650003363034,COGS 186,A01,083986,Staff,21,0,40,19
1650003369058,COGS 187A,A01,083988,Boyle; Mary E. T.,19,0,60,41
1650003375082,CSE 8A,A50,084003,Miranda; Gregory Joseph,0,13,15,15
1650003381109,CSE 11,A01,084005,Miranda; Gregory Joseph,0,19,55,55
1650003387135,CSE 20,A01,084007,Staff,0,5,20,20
1650003393159,CSE 21,A01,084009,Staff,0,30,50,50
1650003399204,CSE 30,A01,083370,Cao; Yingjun,0,63,40,40
1650003405227,CSE 100,A01,083372,Cao; Yingjun,0,46,40,40
1650003411267,CSE 101,A01,084011,Staff,0,53,40,40
1650003417290,CSE 141,A01,083374,Eldon; John,0,63,75,75
1650003423317,CSE 141L,A01,083376,Eldon; John,0,69,75,75
1650003429343,CSE 175,A01,084013,Kumar; Rakesh,22,0,25,3
1650003435364,CSE 190,A00,092508,Dubnov; Shlomo,20,0,20,0
1650003441403,ECE 5,A01,084049,Morris; Karcher William,13,0,20,7
1650003447431,ECE 100,A01,084051,Baghdadchi; Saharnaz,0,0,20,20
1650003447431,ECE 100,A02,091916,Baghdadchi; Saharnaz,13,0,20,7
1650003453453,ECE 101,A01,084053,Baghdadchi; Saharnaz,0,0,37,37
1650003453453,ECE 101,A02,084054,Baghdadchi; Saharnaz,30,0,37,7
1650003459479,ECE 107,A01,083390,Staff,26,0,40,14
1650003465502,ECE 148,A01,084056,Silberman; Jack,8,0,12,4
1650003471530,ECE 180,A00,083391,Abi Samra; Nicholas Camill,25,0,30,5
1650003471530,ECE 180,B00,083392,Abi Samra; Nicholas Camill,21,0,30,9
1650003477552,MATH 10B,A01,084110,Staff,0,0,30,30
1650003477552,MATH 10B,A02,084111,Staff,19,0,30,11
1650003477552,MATH 10B,A03,084112,Staff,24,0,30,6
1650003483580,MATH 10C,A01,083443,Staff,0,15,30,30
1650003483580,MATH 10C,A02,083444,Staff,0,14,30,30
1650003483580,MATH 10C,B01,084114,Staff,19,0,30,11
1650003483580,MATH 10C,B02,084115,Staff,25,0,30,5
1650003489604,MATH 18,A01,084117,Harel; Guershon,14,0,30,16
1650003489604,MATH 18,A02,084119,Harel; Guershon,28,0,30,2
1650003489604,MATH 18,A03,084120,Harel; Guershon,29,0,30,1
1650003489604,MATH 18,A04,084121,Harel; Guershon,29,0,30,1
1650003495628,MATH 20B,A01,084124,Um; Ko Woon,16,0,35,19
1650003495628,MATH 20B,B01,084126,Um; Ko Woon,26,0,35,9
1650003501683,MATH 20C,A01,083446,Hammock; Frances H,0,0,30,30
1650003501683,MATH 20C,A02,083447,Hammock; Frances H,16,0,30,14
1650003501683,MATH 20C,A03,083448,Hammock; Frances H,20,0,30,10
1650003501683,MATH 20C,A04,083449,Hammock; Frances H,21,0,30,9
1650003501683,MATH 20C,B01,083451,Hammock; Frances H,0,0,30,30
1650003501683,MATH 20C,B02,083452,Hammock; Frances H,19,0,30,11
1650003501683,MATH 20C,B03,083453,Hammock; Frances H,22,0,30,8
1650003501683,MATH 20C,B04,083454,Hammock; Frances H,24,0,30,6
1650003507707,MATH 20D,A01,084128,Staff,14,0,30,16
1650003507707,MATH 20D,A02,084129,Staff,29,0,30,1
1650003507707,MATH 20D,A03,084130,Staff,27,0,30,3
1650003507707,MATH 20D,B01,084133,Staff,3,0,30,27
1650003507707,MATH 20D,B02,084134,Staff,24,0,30,6
1650003507707,MATH 20D,B03,084135,Staff,28,0,30,2
1650003513730,MATH 20E,A01,084138,Staff,13,0,30,17
1650003513730,MATH 20E,A02,084139,Staff,7,0,30,23
1650003513730,MATH 20E,A03,084140,Staff,15,0,30,15
1650003513730,MATH 20E,A04,084141,Staff,20,0,30,10
1650003519754,MATH 102,A01,084143,Harel; Guershon,12,0,30,18
1650003519754,MATH 102,A02,084144,Harel; Guershon,20,0,30,10
1650003525877,MATH 103B,A01,083456,Staff,0,13,30,30
1650003525877,MATH 103B,A02,083457,Staff,0,12,30,30
1650003531905,MATH 109,A01,084146,Salehi Golsefidy; Alireza,18,0,30,12
1650003531905,MATH 109,A02,084147,Salehi Golsefidy; Alireza,16,0,30,14
1650003537939,MATH 120A,A01,085445,Eggers; John Dietrich,12,0,35,23
1650003537939,MATH 120A,A02,085446,Eggers; John Dietrich,27,0,35,8
1650003543965,MATH 142B,A01,084149,Verstraete; Jacques Allan,0,12,30,30
1650003543965,MATH 142B,A02,084150,Verstraete; Jacques Allan,0,12,30,30
1650003549989,MATH 170A,A01,083459,Nie; Jiawang,0,9,30,30
1650003549989,MATH 170A,A02,083460,Nie; Jiawang,0,7,30,30
1650003549989,MATH 170A,A03,083461,Nie; Jiawang,0,9,30,30
1650003556023,MATH 193B,A01,083463,Staff,1,0,30,29
1650003556023,MATH 193B,A02,083464,Staff,9,0,30,21
1650003556023,MATH 193B,A03,083465,Staff,18,0,30,12
1650003562094,COGS 2,A01,083966,Boyle; Mary E. T.,10,0,30,20
1650003568136,COGS 9,A01,083968,Staff,9,0,60,51
1650003574158,COGS 14B,A01,083970,Staff,11,0,50,39
1650003580181,COGS 17,A01,092679,Staff,52,0,75,23
1650003586205,COGS 100,A01,083972,Staff,0,15,60,60
1650003598251,COGS 101C,A01,083976,Staff,12,0,30,18
1650003604278,COGS 102A,A01,083978,Johnson; Christine M.,14,0,30,16
1650003610316,COGS 107B,A01,083980,Staff,0,7,50,50
1650003616340,COGS 115,A01,083982,Staff,11,0,30,19
1650003622366,COGS 118B,A01,083367,Staff,0,14,40,40
1650003628390,COGS 172,A01,083984,Provenzano; Emily Kara,15,0,30,15
1650003634418,COGS 177,A00,083368,Staff,0,20,30,30
1650003640451,COGS 186,A01,083986,Staff,21,0,40,19
1650003646474,COGS 187A,A01,083988,Boyle; Mary E. T.,19,0,60,41
1650003652498,CSE 8A,A50,084003,Miranda; Gregory Joseph,0,13,15,15
1650003658522,CSE 11,A01,084005,Miranda; Gregory Joseph,0,20,55,55
1650003664548,CSE 20,A01,084007,Staff,0,5,20,20
1650003670571,CSE 21,A01,084009,Staff,0,30,50,50
1650003676599,CSE 30,A01,083370,Cao; Yingjun,0,63,40,40
1650003682625,CSE 100,A01,083372,Cao; Yingjun,0,46,40,40
1650003688649,CSE 101,A01,084011,Staff,0,53,40,40
1650003694674,CSE 141,A01,083374,Eldon; John,0,64,75,75
1650003700698,CSE 141L,A01,083376,Eldon; John,0,70,75,75
1650003706725,CSE 175,A01,084013,Kumar; Rakesh,22,0,25,3
1650003712756,CSE 190,A00,092508,Dubnov; Shlomo,20,0,20,0
1650003718779,ECE 5,A01,084049,Morris; Karcher William,13,0,20,7
1650003724808,ECE 100,A01,084051,Baghdadchi; Saharnaz,0,0,20,20
1650003724808,ECE 100,A02,091916,Baghdadchi; Saharnaz,13,0,20,7
1650003730831,ECE 101,A01,084053,Baghdadchi; Saharnaz,0,0,37,37
1650003730831,ECE 101,A02,084054,Baghdadchi; Saharnaz,30,0,37,7
1650003736858,ECE 107,A01,083390,Staff,26,0,40,14
1650003742883,ECE 148,A01,084056,Silberman; Jack,8,0,12,4
1650003748907,ECE 180,A00,083391,Abi Samra; Nicholas Camill,25,0,30,5
1650003748907,ECE 180,B00,083392,Abi Samra; Nicholas Camill,21,0,30,9
1650003754944,MATH 10B,A01,084110,Staff,0,0,30,30
1650003754944,MATH 10B,A02,084111,Staff,19,0,30,11
1650003754944,MATH 10B,A03,084112,Staff,24,0,30,6
1650003760973,MATH 10C,A01,083443,Staff,0,15,30,30
1650003760973,MATH 10C,A02,083444,Staff,0,14,30,30
1650003760973,MATH 10C,B01,084114,Staff,19,0,30,11
1650003760973,MATH 10C,B02,084115,Staff,25,0,30,5
1650003767003,MATH 18,A01,084117,Harel; Guershon,14,0,30,16
1650003767003,MATH 18,A02,084119,Harel; Guershon,28,0,30,2
1650003767003,MATH 18,A03,084120,Harel; Guershon,29,0,30,1
1650003767003,MATH 18,A04,084121,Harel; Guershon,29,0,30,1
1650003773027,MATH 20B,A01,084124,Um; Ko Woon,16,0,35,19
1650003773027,MATH 20B,B01,084126,Um; Ko Woon,26,0,35,9
1650003779056,MATH 20C,A01,083446,Hammock; Frances H,0,0,30,30
1650003779056,MATH 20C,A02,083447,Hammock; Frances H,16,0,30,14
1650003779056,MATH 20C,A03,083448,Hammock; Frances H,20,0,30,10
1650003779056,MATH 20C,A04,083449,Hammock; Frances H,21,0,30,9
1650003779056,MATH 20C,B01,083451,Hammock; Frances H,0,0,30,30
1650003779056,MATH 20C,B02,083452,Hammock; Frances H,19,0,30,11
1650003779056,MATH 20C,B03,083453,Hammock; Frances H,22,0,30,8
1650003779056,MATH 20C,B04,083454,Hammock; Frances H,24,0,30,6
1650003785085,MATH 20D,A01,084128,Staff,14,0,30,16
1650003785085,MATH 20D,A02,084129,Staff,29,0,30,1
1650003785085,MATH 20D,A03,084130,Staff,27,0,30,3
1650003785085,MATH 20D,B01,084133,Staff,3,0,30,27
1650003785085,MATH 20D,B02,084134,Staff,24,0,30,6
1650003785085,MATH 20D,B03,084135,Staff,28,0,30,2
1650003791112,MATH 20E,A01,084138,Staff,13,0,30,17
1650003791112,MATH 20E,A02,084139,Staff,7,0,30,23
1650003791112,MATH 20E,A03,084140,Staff,15,0,30,15
1650003791112,MATH 20E,A04,084141,Staff,20,0,30,10
1650003797145,MATH 102,A01,084143,Harel; Guershon,12,0,30,18
1650003797145,MATH 102,A02,084144,Harel; Guershon,20,0,30,10
1650003803172,MATH 103B,A01,083456,Staff,0,13,30,30
1650003803172,MATH 103B,A02,083457,Staff,0,12,30,30
1650003809203,MATH 109,A01,084146,Salehi Golsefidy; Alireza,18,0,30,12
1650003809203,MATH 109,A02,084147,Salehi Golsefidy; Alireza,16,0,30,14
1650003815226,MATH 120A,A01,085445,Eggers; John Dietrich,12,0,35,23
1650003815226,MATH 120A,A02,085446,Eggers; John Dietrich,27,0,35,8
1650003821253,MATH 142B,A01,084149,Verstraete; Jacques Allan,0,12,30,30
1650003821253,MATH 142B,A02,084150,Verstraete; Jacques Allan,0,12,30,30
1650003827276,MATH 170A,A01,083459,Nie; Jiawang,0,9,30,30
1650003827276,MATH 170A,A02,083460,Nie; Jiawang,0,7,30,30
1650003827276,MATH 170A,A03,083461,Nie; Jiawang,0,9,30,30
1650003833302,MATH 193B,A01,083463,Staff,1,0,30,29
1650003833302,MATH 193B,A02,083464,Staff,9,0,30,21
1650003833302,MATH 193B,A03,083465,Staff,18,0,30,12
1650003839367,COGS 2,A01,083966,Boyle; Mary E. T.,10,0,30,20
1650003845408,COGS 9,A01,083968,Staff,9,0,60,51
1650003851432,COGS 14B,A01,083970,Staff,11,0,50,39
1650003857459,COGS 17,A01,092679,Staff,51,0,75,24
1650003863482,COGS 100,A01,083972,Staff,0,15,60,60
1650003875537,COGS 101C,A01,083976,Staff,12,0,30,18
1650003881566,COGS 102A,A01,083978,Johnson; Christine M.,14,0,30,16
1650003887589,COGS 107B,A01,083980,Staff,0,7,50,50
1650003893619,COGS 115,A01,083982,Staff,11,0,30,19
1650003899645,COGS 118B,A01,083367,Staff,0,14,40,40
1650003905673,COGS 172,A01,083984,Provenzano; Emily Kara,15,0,30,15
1650003911699,COGS 177,A00,083368,Staff,0,20,30,30
1650003917731,COGS 186,A01,083986,Staff,21,0,40,19
1650003923755,COGS 187A,A01,083988,Boyle; Mary E. T.,20,0,60,40
1650003929780,CSE 8A,A50,084003,Miranda; Gregory Joseph,0,13,15,15
1650003935802,CSE 11,A01,084005,Miranda; Gregory Joseph,0,19,55,55
1650003941829,CSE 20,A01,084007,Staff,0,5,20,20
1650003947853,CSE 21,A01,084009,Staff,0,30,50,50
1650003953880,CSE 30,A01,083370,Cao; Yingjun,0,64,40,40
1650003959906,CSE 100,A01,083372,Cao; Yingjun,0,46,40,40
1650003965937,CSE 101,A01,084011,Staff,0,53,40,40
1650003971959,CSE 141,A01,083374,Eldon; John,0,64,75,75
1650003977983,CSE 141L,A01,083376,Eldon; John,0,70,75,75
1650003984006,CSE 175,A01,084013,Kumar; Rakesh,22,0,25,3
1650003990034,CSE 190,A00,092508,Dubnov; Shlomo,20,0,20,0
1650003996061,ECE 5,A01,084049,Morris; Karcher William,13,0,20,7
1650004002086,ECE 100,A01,084051,Baghdadchi; Saharnaz,0,0,20,20
1650004002086,ECE 100,A02,091916,Baghdadchi; Saharnaz,13,0,20,7
1650004008108,ECE 101,A01,084053,Baghdadchi; Saharnaz,0,0,37,37
1650004008108,ECE 101,A02,084054,Baghdadchi; Saharnaz,30,0,37,7
1650004014132,ECE 107,A01,083390,Staff,26,0,40,14
1650004020153,ECE 148,A01,084056,Silberman; Jack,8,0,12,4
1650004026184,ECE 180,A00,083391,Abi Samra; Nicholas Camill,25,0,30,5
1650004026184,ECE 180,B00,083392,Abi Samra; Nicholas Camill,21,0,30,9
1650004032211,MATH 10B,A01,084110,Staff,0,0,30,30
1650004032211,MATH 10B,A02,084111,Staff,19,0,30,11
1650004032211,MATH 10B,A03,084112,Staff,24,0,30,6
1650004038237,MATH 10C,A01,083443,Staff,0,15,30,30
1650004038237,MATH 10C,A02,083444,Staff,0,14,30,30
1650004038237,MATH 10C,B01,084114,Staff,19,0,30,11
1650004038237,MATH 10C,B02,084115,Staff,25,0,30,5
1650004044265,MATH 18,A01,084117,Harel; Guershon,14,0,30,16
1650004044265,MATH 18,A02,084119,Harel; Guershon,28,0,30,2
1650004044265,MATH 18,A03,084120,Harel; Guershon,29,0,30,1
1650004044265,MATH 18,A04,084121,Harel; Guershon,29,0,30,1
1650004050290,MATH 20B,A01,084124,Um; Ko Woon,16,0,35,19
1650004050290,MATH 20B,B01,084126,Um; Ko Woon,26,0,35,9
1650004056315,MATH 20C,A01,083446,Hammock; Frances H,0,0,30,30
1650004056315,MATH 20C,A02,083447,Hammock; Frances H,16,0,30,14
1650004056315,MATH 20C,A03,083448,Hammock; Frances H,20,0,30,10
1650004056315,MATH 20C,A04,083449,Hammock; Frances H,21,0,30,9
1650004056315,MATH 20C,B01,083451,Hammock; Frances H,0,0,30,30
1650004056315,MATH 20C,B02,083452,Hammock; Frances H,19,0,30,11
1650004056315,MATH 20C,B03,083453,Hammock; Frances H,22,0,30,8
1650004056315,MATH 20C,B04,083454,Hammock; Frances H,24,0,30,6
1650004062346,MATH 20D,A01,084128,Staff,14,0,30,16
1650004062346,MATH 20D,A02,084129,Staff,29,0,30,1
1650004062346,MATH 20D,A03,084130,Staff,27,0,30,3
1650004062346,MATH 20D,B01,084133,Staff,3,0,30,27
1650004062346,MATH 20D,B02,084134,Staff,24,0,30,6
1650004062346,MATH 20D,B03,084135,Staff,28,0,30,2
1650004068370,MATH 20E,A01,084138,Staff,13,0,30,17
1650004068370,MATH 20E,A02,084139,Staff,7,0,30,23
1650004068370,MATH 20E,A03,084140,Staff,15,0,30,15
1650004068370,MATH 20E,A04,084141,Staff,20,0,30,10
1650004074394,MATH 102,A01,084143,Harel; Guershon,12,0,30,18
1650004074394,MATH 102,A02,084144,Harel; Guershon,20,0,30,10
1650004080417,MATH 103B,A01,083456,Staff,0,13,30,30
1650004080417,MATH 103B,A02,083457,Staff,0,12,30,30
1650004086444,MATH 109,A01,084146,Salehi Golsefidy; Alireza,18,0,30,12
1650004086444,MATH 109,A02,084147,Salehi Golsefidy; Alireza,16,0,30,14
1650004092468,MATH 120A,A01,085445,Eggers; John Dietrich,12,0,35,23
1650004092468,MATH 120A,A02,085446,Eggers; John Dietrich,27,0,35,8
1650004098505,MATH 142B,A01,084149,Verstraete; Jacques Allan,0,12,30,30
1650004098505,MATH 142B,A02,084150,Verstraete; Jacques Allan,0,12,30,30
1650004104529,MATH 170A,A01,083459,Nie; Jiawang,0,9,30,30
1650004104529,MATH 170A,A02,083460,Nie; Jiawang,0,7,30,30
1650004104529,MATH 170A,A03,083461,Nie; Jiawang,0,9,30,30
1650004110554,MATH 193B,A01,083463,Staff,1,0,30,29
1650004110554,MATH 193B,A02,083464,Staff,9,0,30,21
1650004110554,MATH 193B,A03,083465,Staff,18,0,30,12
1650004116703,COGS 2,A01,083966,Boyle; Mary E. T.,10,0,30,20
1650004122728,COGS 9,A01,083968,Staff,9,0,60,51
1650004128752,COGS 14B,A01,083970,Staff,10,0,50,40
1650004134778,COGS 17,A01,092679,Staff,51,0,75,24
1650004140804,COGS 100,A01,083972,Staff,0,15,60,60
1650004152851,COGS 101C,A01,083976,Staff,12,0,30,18
1650004158875,COGS 102A,A01,083978,Johnson; Christine M.,14,0,30,16
1650004164902,COGS 107B,A01,083980,Staff,0,7,50,50
1650004170926,COGS 115,A01,083982,Staff,11,0,30,19
1650004176951,COGS 118B,A01,083367,Staff,0,14,40,40
1650004182982,COGS 172,A01,083984,Provenzano; Emily Kara,15,0,30,15
1650004189006,COGS 177,A00,083368,Staff,0,20,30,30
1650004195031,COGS 186,A01,083986,Staff,21,0,40,19
1650004201054,COGS 187A,A01,083988,Boyle; Mary E. T.,20,0,60,40
1650004207083,CSE 8A,A50,084003,Miranda; Gregory Joseph,0,13,15,15
1650004213109,CSE 11,A01,084005,Miranda; Gregory Joseph,0,19,55,55
1650004219132,CSE 20,A01,084007,Staff,0,5,20,20
1650004225156,CSE 21,A01,084009,Staff,0,30,50,50
1650004231179,CSE 30,A01,083370,Cao; Yingjun,0,64,40,40
1650004237203,CSE 100,A01,083372,Cao; Yingjun,0,46,40,40
1650004243230,CSE 101,A01,084011,Staff,0,53,40,40
1650004249254,CSE 141,A01,083374,Eldon; John,0,64,75,75
1650004255277,CSE 141L,A01,083376,Eldon; John,0,70,75,75
1650004261300,CSE 175,A01,084013,Kumar; Rakesh,22,0,25,3
1650004267323,CSE 190,A00,092508,Dubnov; Shlomo,20,0,20,0
1650004273347,ECE 5,A01,084049,Morris; Karcher William,13,0,20,7
1650004279379,ECE 100,A01,084051,Baghdadchi; Saharnaz,0,0,20,20
1650004279379,ECE 100,A02,091916,Baghdadchi; Saharnaz,13,0,20,7
1650004285403,ECE 101,A01,084053,Baghdadchi; Saharnaz,0,0,37,37
1650004285403,ECE 101,A02,084054,Baghdadchi; Saharnaz,31,0,37,6
1650004291433,ECE 107,A01,083390,Staff,26,0,40,14
1650004297469,ECE 148,A01,084056,Silberman; Jack,8,0,12,4
1650004303500,ECE 180,A00,083391,Abi Samra; Nicholas Camill,25,0,30,5
1650004303500,ECE 180,B00,083392,Abi Samra; Nicholas Camill,21,0,30,9
1650004309525,MATH 10B,A01,084110,Staff,0,0,30,30
1650004309525,MATH 10B,A02,084111,Staff,19,0,30,11
1650004309525,MATH 10B,A03,084112,Staff,24,0,30,6
1650004315548,MATH 10C,A01,083443,Staff,0,15,30,30
1650004315548,MATH 10C,A02,083444,Staff,0,14,30,30
1650004315548,MATH 10C,B01,084114,Staff,19,0,30,11
1650004315548,MATH 10C,B02,084115,Staff,25,0,30,5
1650004321572,MATH 18,A01,084117,Harel; Guershon,14,0,30,16
1650004321572,MATH 18,A02,084119,Harel; Guershon,28,0,30,2
1650004321572,MATH 18,A03,084120,Harel; Guershon,29,0,30,1
1650004321572,MATH 18,A04,084121,Harel; Guershon,29,0,30,1
1650004327595,MATH 20B,A01,084124,Um; Ko Woon,16,0,35,19
1650004327595,MATH 20B,B01,084126,Um; Ko Woon,26,0,35,9
1650004333625,MATH 20C,A01,083446,Hammock; Frances H,0,0,30,30
1650004333625,MATH 20C,A02,083447,Hammock; Frances H,16,0,30,14
1650004333625,MATH 20C,A03,083448,Hammock; Frances H,20,0,30,10
1650004333625,MATH 20C,A04,083449,Hammock; Frances H,21,0,30,9
1650004333625,MATH 20C,B01,083451,Hammock; Frances H,0,0,30,30
1650004333625,MATH 20C,B02,083452,Hammock; Frances H,19,0,30,11
1650004333625,MATH 20C,B03,083453,Hammock; Frances H,22,0,30,8
1650004333625,MATH 20C,B04,083454,Hammock; Frances H,24,0,30,6
1650004339650,MATH 20D,A01,084128,Staff,14,0,30,16
1650004339650,MATH 20D,A02,084129,Staff,29,0,30,1
1650004339650,MATH 20D,A03,084130,Staff,27,0,30,3
1650004339650,MATH 20D,B01,084133,Staff,3,0,30,27
1650004339650,MATH 20D,B02,084134,Staff,24,0,30,6
1650004339650,MATH 20D,B03,084135,Staff,28,0,30,2
1650004345677,MATH 20E,A01,084138,Staff,13,0,30,17
1650004345677,MATH 20E,A02,084139,Staff,7,0,30,23
1650004345677,MATH 20E,A03,084140,Staff,15,0,30,15
1650004345677,MATH 20E,A04,084141,Staff,20,0,30,10
1650004351700,MATH 102,A01,084143,Harel; Guershon,12,0,30,18
1650004351700,MATH 102,A02,084144,Harel; Guershon,20,0,30,10
1650004357725,MATH 103B,A01,083456,Staff,0,13,30,30
1650004357725,MATH 103B,A02,083457,Staff,0,12,30,30
1650004363754,MATH 109,A01,084146,Salehi Golsefidy; Alireza,18,0,30,12
1650004363754,MATH 109,A02,084147,Salehi Golsefidy; Alireza,16,0,30,14
1650004369777,MATH 120A,A01,085445,Eggers; John Dietrich,12,0,35,23
1650004369777,MATH 120A,A02,085446,Eggers; John Dietrich,27,0,35,8
1650004375810,MATH 142B,A01,084149,Verstraete; Jacques Allan,0,12,30,30
1650004375810,MATH 142B,A02,084150,Verstraete; Jacques Allan,0,12,30,30
1650004381840,MATH 170A,A01,083459,Nie; Jiawang,0,9,30,30
1650004381840,MATH 170A,A02,083460,Nie; Jiawang,0,7,30,30
1650004381840,MATH 170A,A03,083461,Nie; Jiawang,0,9,30,30
1650004387864,MATH 193B,A01,083463,Staff,1,0,30,29
1650004387864,MATH 193B,A02,083464,Staff,9,0,30,21
1650004387864,MATH 193B,A03,083465,Staff,18,0,30,12
1650004393925,COGS 2,A01,083966,Boyle; Mary E. T.,10,0,30,20
1650004399948,COGS 9,A01,083968,Staff,9,0,60,51
1650004405974,COGS 14B,A01,083970,Staff,10,0,50,40
1650004411998,COGS 17,A01,092679,Staff,51,0,75,24
1650004418023,COGS 100,A01,083972,Staff,0,15,60,60
1650004430071,COGS 101C,A01,083976,Staff,12,0,30,18
1650004436104,COGS 102A,A01,083978,Johnson; Christine M.,14,0,30,16
1650004442129,COGS 107B,A01,083980,Staff,0,7,50,50
1650004448156,COGS 115,A01,083982,Staff,11,0,30,19
1650004454183,COGS 118B,A01,083367,Staff,0,14,40,40
1650004460211,COGS 172,A01,083984,Provenzano; Emily Kara,15,0,30,15
1650004466235,COGS 177,A00,083368,Staff,0,20,30,30
1650004472259,COGS 186,A01,083986,Staff,21,0,40,19
1650004478286,COGS 187A,A01,083988,Boyle; Mary E. T.,20,0,60,40
1650004484312,CSE 8A,A50,084003,Miranda; Gregory Joseph,0,13,15,15
1650004490335,CSE 11,A01,084005,Miranda; Gregory Joseph,0,20,55,55
1650004496360,CSE 20,A01,084007,Staff,0,5,20,20
1650004502392,CSE 21,A01,084009,Staff,0,30,50,50
1650004508414,CSE 30,A01,083370,Cao; Yingjun,0,64,40,40
1650004514438,CSE 100,A01,083372,Cao; Yingjun,0,46,40,40
1650004520465,CSE 101,A01,084011,Staff,0,53,40,40
1650004526490,CSE 141,A01,083374,Eldon; John,0,64,75,75
1650004532513,CSE 141L,A01,083376,Eldon; John,0,70,75,75
1650004538546,CSE 175,A01,084013,Kumar; Rakesh,22,0,25,3
1650004544569,CSE 190,A00,092508,Dubnov; Shlomo,20,0,20,0
1650004550596,ECE 5,A01,084049,Morris; Karcher William,13,0,20,7
1650004556622,ECE 100,A01,084051,Baghdadchi; Saharnaz,0,0,20,20
1650004556622,ECE 100,A02,091916,Baghdadchi; Saharnaz,13,0,20,7
1650004562650,ECE 101,A01,084053,Baghdadchi; Saharnaz,0,0,37,37
1650004562650,ECE 101,A02,084054,Baghdadchi; Saharnaz,30,0,37,7
1650004568678,ECE 107,A01,083390,Staff,26,0,40,14
1650004574703,ECE 148,A01,084056,Silberman; Jack,8,0,12,4
1650004580726,ECE 180,A00,083391,Abi Samra; Nicholas Camill,25,0,30,5
1650004580726,ECE 180,B00,083392,Abi Samra; Nicholas Camill,21,0,30,9
1650004586753,MATH 10B,A01,084110,Staff,0,0,30,30
1650004586753,MATH 10B,A02,084111,Staff,19,0,30,11
1650004586753,MATH 10B,A03,084112,Staff,24,0,30,6
1650004592782,MATH 10C,A01,083443,Staff,0,15,30,30
1650004592782,MATH 10C,A02,083444,Staff,0,14,30,30
1650004592782,MATH 10C,B01,084114,Staff,19,0,30,11
1650004592782,MATH 10C,B02,084115,Staff,25,0,30,5
1650004598818,MATH 18,A01,084117,Harel; Guershon,14,0,30,16
1650004598818,MATH 18,A02,084119,Harel; Guershon,28,0,30,2
1650004598818,MATH 18,A03,084120,Harel; Guershon,29,0,30,1
1650004598818,MATH 18,A04,084121,Harel; Guershon,29,0,30,1
1650004604846,MATH 20B,A01,084124,Um; Ko Woon,16,0,35,19
1650004604846,MATH 20B,B01,084126,Um; Ko Woon,26,0,35,9
1650004610878,MATH 20C,A01,083446,Hammock; Frances H,0,0,30,30
1650004610878,MATH 20C,A02,083447,Hammock; Frances H,16,0,30,14
1650004610878,MATH 20C,A03,083448,Hammock; Frances H,20,0,30,10
1650004610878,MATH 20C,A04,083449,Hammock; Frances H,21,0,30,9
1650004610878,MATH 20C,B01,083451,Hammock; Frances H,0,0,30,30
1650004610878,MATH 20C,B02,083452,Hammock; Frances H,19,0,30,11
1650004610878,MATH 20C,B03,083453,Hammock; Frances H,22,0,30,8
1650004610878,MATH 20C,B04,083454,Hammock; Frances H,24,0,30,6
1650004616906,MATH 20D,A01,084128,Staff,14,0,30,16
1650004616906,MATH 20D,A02,084129,Staff,29,0,30,1
1650004616906,MATH 20D,A03,084130,Staff,27,0,30,3
1650004616906,MATH 20D,B01,084133,Staff,3,0,30,27
1650004616906,MATH 20D,B02,084134,Staff,24,0,30,6
1650004616906,MATH 20D,B03,084135,Staff,28,0,30,2
1650004622936,MATH 20E,A01,084138,Staff,13,0,30,17
1650004622936,MATH 20E,A02,084139,Staff,7,0,30,23
1650004622936,MATH 20E,A03,084140,Staff,15,0,30,15
1650004622936,MATH 20E,A04,084141,Staff,20,0,30,10
1650004628959,MATH 102,A01,084143,Harel; Guershon,12,0,30,18
1650004628959,MATH 102,A02,084144,Harel; Guershon,20,0,30,10
1650004634983,MATH 103B,A01,083456,Staff,0,13,30,30
1650004634983,MATH 103B,A02,083457,Staff,0,12,30,30
1650004641005,MATH 109,A01,084146,Salehi Golsefidy; Alireza,18,0,30,12
1650004641005,MATH 109,A02,084147,Salehi Golsefidy; Alireza,16,0,30,14
1650004647034,MATH 120A,A01,085445,Eggers; John Dietrich,12,0,35,23
1650004647034,MATH 120A,A02,085446,Eggers; John Dietrich,27,0,35,8
1650004653074,MATH 142B,A01,084149,Verstraete; Jacques Allan,0,12,30,30
1650004653074,MATH 142B,A02,084150,Verstraete; Jacques Allan,0,12,30,30
1650004659096,MATH 170A,A01,083459,Nie; Jiawang,0,9,30,30
1650004659096,MATH 170A,A02,083460,Nie; Jiawang,0,7,30,30
1650004659096,MATH 170A,A03,083461,Nie; Jiawang,0,9,30,30
1650004665118,MATH 193B,A01,083463,Staff,1,0,30,29
1650004665118,MATH 193B,A02,083464,Staff,9,0,30,21
1650004665118,MATH 193B,A03,083465,Staff,18,0,30,12
1650004671179,COGS 2,A01,083966,Boyle; Mary E. T.,10,0,30,20
1650004677221,COGS 9,A01,083968,Staff,9,0,60,51
1650004683243,COGS 14B,A01,083970,Staff,10,0,50,40
1650004689265,COGS 17,A01,092679,Staff,51,0,75,24
1650004695290,COGS 100,A01,083972,Staff,0,15,60,60
1650004707346,COGS 101C,A01,083976,Staff,12,0,30,18
1650004713463,COGS 102A,A01,083978,Johnson; Christine M.,14,0,30,16
1650004719497,COGS 107B,A01,083980,Staff,0,7,50,50
1650004725520,COGS 115,A01,083982,Staff,11,0,30,19
1650004731547,COGS 118B,A01,083367,Staff,0,14,40,40
1650004737569,COGS 172,A01,083984,Provenzano; Emily Kara,15,0,30,15
1650004743592,COGS 177,A00,083368,Staff,0,20,30,30
1650004749622,COGS 186,A01,083986,Staff,21,0,40,19
1650004755647,COGS 187A,A01,083988,Boyle; Mary E. T.,20,0,60,40
1650004761671,CSE 8A,A50,084003,Miranda; Gregory Joseph,0,13,15,15
1650004767699,CSE 11,A01,084005,Miranda; Gregory Joseph,0,20,55,55
1650004773730,CSE 20,A01,084007,Staff,0,5,20,20
1650004779754,CSE 21,A01,084009,Staff,0,30,50,50
1650004785786,CSE 30,A01,083370,Cao; Yingjun,0,64,40,40
1650004791809,CSE 100,A01,083372,Cao; Yingjun,0,46,40,40
1650004797833,CSE 101,A01,084011,Staff,0,53,40,40
1650004803860,CSE 141,A01,083374,Eldon; John,0,64,75,75
1650004809885,CSE 141L,A01,083376,Eldon; John,0,70,75,75
1650004815908,CSE 175,A01,084013,Kumar; Rakesh,22,0,25,3
1650004821931,CSE 190,A00,092508,Dubnov; Shlomo,20,0,20,0
1650004827954,ECE 5,A01,084049,Morris; Karcher William,13,0,20,7
1650004833981,ECE 100,A01,084051,Baghdadchi; Saharnaz,0,0,20,20
1650004833981,ECE 100,A02,091916,Baghdadchi; Saharnaz,13,0,20,7
1650004840009,ECE 101,A01,084053,Baghdadchi; Saharnaz,0,0,37,37
1650004840009,ECE 101,A02,084054,Baghdadchi; Saharnaz,30,0,37,7
1650004846036,ECE 107,A01,083390,Staff,26,0,40,14
1650004852062,ECE 148,A01,084056,Silberman; Jack,8,0,12,4
1650004858089,ECE 180,A00,083391,Abi Samra; Nicholas Camill,25,0,30,5
1650004858089,ECE 180,B00,083392,Abi Samra; Nicholas Camill,21,0,30,9
1650004864125,MATH 10B,A01,084110,Staff,0,0,30,30
1650004864125,MATH 10B,A02,084111,Staff,19,0,30,11
1650004864125,MATH 10B,A03,084112,Staff,24,0,30,6
1650004870153,MATH 10C,A01,083443,Staff,0,15,30,30
1650004870153,MATH 10C,A02,083444,Staff,0,14,30,30
1650004870153,MATH 10C,B01,084114,Staff,19,0,30,11
1650004870153,MATH 10C,B02,084115,Staff,25,0,30,5
1650004876179,MATH 18,A01,084117,Harel; Guershon,14,0,30,16
1650004876179,MATH 18,A02,084119,Harel; Guershon,28,0,30,2
1650004876179,MATH 18,A03,084120,Harel; Guershon,29,0,30,1
1650004876179,MATH 18,A04,084121,Harel; Guershon,29,0,30,1
1650004882212,MATH 20B,A01,084124,Um; Ko Woon,16,0,35,19
1650004882212,MATH 20B,B01,084126,Um; Ko Woon,25,0,35,10
1650004888238,MATH 20C,A01,083446,Hammock; Frances H,0,0,30,30
1650004888238,MATH 20C,A02,083447,Hammock; Frances H,16,0,30,14
1650004888238,MATH 20C,A03,083448,Hammock; Frances H,20,0,30,10
1650004888238,MATH 20C,A04,083449,Hammock; Frances H,21,0,30,9
1650004888238,MATH 20C,B01,083451,Hammock; Frances H,0,0,30,30
1650004888238,MATH 20C,B02,083452,Hammock; Frances H,19,0,30,11
1650004888238,MATH 20C,B03,083453,Hammock; Frances H,22,0,30,8
1650004888238,MATH 20C,B04,083454,Hammock; Frances H,24,0,30,6
1650004894261,MATH 20D,A01,084128,Staff,14,0,30,16
1650004894261,MATH 20D,A02,084129,Staff,29,0,30,1
1650004894261,MATH 20D,A03,084130,Staff,27,0,30,3
1650004894261,MATH 20D,B01,084133,Staff,3,0,30,27
1650004894261,MATH 20D,B02,084134,Staff,24,0,30,6
1650004894261,MATH 20D,B03,084135,Staff,28,0,30,2
1650004900289,MATH 20E,A01,084138,Staff,13,0,30,17
1650004900289,MATH 20E,A02,084139,Staff,7,0,30,23
1650004900289,MATH 20E,A03,084140,Staff,15,0,30,15
1650004900289,MATH 20E,A04,084141,Staff,20,0,30,10
1650004906318,MATH 102,A01,084143,Harel; Guershon,12,0,30,18
1650004906318,MATH 102,A02,084144,Harel; Guershon,20,0,30,10
1650004912341,MATH 103B,A01,083456,Staff,0,13,30,30
1650004912341,MATH 103B,A02,083457,Staff,0,12,30,30
1650004918372,MATH 109,A01,084146,Salehi Golsefidy; Alireza,18,0,30,12
1650004918372,MATH 109,A02,084147,Salehi Golsefidy; Alireza,16,0,30,14
1650004924402,MATH 120A,A01,085445,Eggers; John Dietrich,11,0,35,24
1650004924402,MATH 120A,A02,085446,Eggers; John Dietrich,27,0,35,8
1650004930426,MATH 142B,A01,084149,Verstraete; Jacques Allan,0,12,30,30
1650004930426,MATH 142B,A02,084150,Verstraete; Jacques Allan,0,12,30,30
1650004936450,MATH 170A,A01,083459,Nie; Jiawang,0,9,30,30
1650004936450,MATH 170A,A02,083460,Nie; Jiawang,0,7,30,30
1650004936450,MATH 170A,A03,083461,Nie; Jiawang,0,9,30,30
1650004942474,MATH 193B,A01,083463,Staff,1,0,30,29
1650004942474,MATH 193B,A02,083464,Staff,9,0,30,21
1650004942474,MATH 193B,A03,083465,Staff,18,0,30,12
1650004948534,COGS 2,A01,083966,Boyle; Mary E. T.,10,0,30,20
1650004954559,COGS 9,A01,083968,Staff,9,0,60,51
1650004960582,COGS 14B,A01,083970,Staff,10,0,50,40
1650004966605,COGS 17,A01,092679,Staff,51,0,75,24
1650004972632,COGS 100,A01,083972,Staff,0,15,60,60
1650004984691,COGS 101C,A01,083976,Staff,12,0,30,18
1650004990715,COGS 102A,A01,083978,Johnson; Christine M.,14,0,30,16
1650004996739,COGS 107B,A01,083980,Staff,0,7,50,50
1650005002761,COGS 115,A01,083982,Staff,11,0,30,19
1650005008793,COGS 118B,A01,083367,Staff,0,14,40,40
1650005014830,COGS 172,A01,083984,Provenzano; Emily Kara,15,0,30,15
1650005020853,COGS 177,A00,083368,Staff,0,20,30,30
1650005026881,COGS 186,A01,083986,Staff,21,0,40,19
1650005032919,COGS 187A,A01,083988,Boyle; Mary E. T.,20,0,60,40
1650005038942,CSE 8A,A50,084003,Miranda; Gregory Joseph,0,13,15,15
1650005044967,CSE 11,A01,084005,Miranda; Gregory Joseph,0,20,55,55
1650005050998,CSE 20,A01,084007,Staff,0,5,20,20
1650005057022,CSE 21,A01,084009,Staff,0,30,50,50
1650005063045,CSE 30,A01,083370,Cao; Yingjun,0,64,40,40
1650005069068,CSE 100,A01,083372,Cao; Yingjun,0,46,40,40
1650005075092,CSE 101,A01,084011,Staff,0,53,40,40
1650005081118,CSE 141,A01,083374,Eldon; John,0,64,75,75
1650005087155,CSE 141L,A01,083376,Eldon; John,0,70,75,75
1650005093182,CSE 175,A01,084013,Kumar; Rakesh,22,0,25,3
1650005099210,CSE 190,A00,092508,Dubnov; Shlomo,20,0,20,0
1650005105234,ECE 5,A01,084049,Morris; Karcher William,13,0,20,7
1650005111262,ECE 100,A01,084051,Baghdadchi; Saharnaz,0,0,20,20
1650005111262,ECE 100,A02,091916,Baghdadchi; Saharnaz,13,0,20,7
1650005117285,ECE 101,A01,084053,Baghdadchi; Saharnaz,0,0,37,37
1650005117285,ECE 101,A02,084054,Baghdadchi; Saharnaz,30,0,37,7
1650005123313,ECE 107,A01,083390,Staff,26,0,40,14
1650005129345,ECE 148,A01,084056,Silberman; Jack,8,0,12,4
1650005135373,ECE 180,A00,083391,Abi Samra; Nicholas Camill,25,0,30,5
1650005135373,ECE 180,B00,083392,Abi Samra; Nicholas Camill,21,0,30,9
1650005141405,MATH 10B,A01,084110,Staff,0,0,30,30
1650005141405,MATH 10B,A02,084111,Staff,19,0,30,11
1650005141405,MATH 10B,A03,084112,Staff,24,0,30,6
1650005147429,MATH 10C,A01,083443,Staff,0,15,30,30
1650005147429,MATH 10C,A02,083444,Staff,0,14,30,30
1650005147429,MATH 10C,B01,084114,Staff,19,0,30,11
1650005147429,MATH 10C,B02,084115,Staff,25,0,30,5
1650005153458,MATH 18,A01,084117,Harel; Guershon,14,0,30,16
1650005153458,MATH 18,A02,084119,Harel; Guershon,28,0,30,2
1650005153458,MATH 18,A03,084120,Harel; Guershon,29,0,30,1
1650005153458,MATH 18,A04,084121,Harel; Guershon,29,0,30,1
1650005159482,MATH 20B,A01,084124,Um; Ko Woon,16,0,35,19
1650005159482,MATH 20B,B01,084126,Um; Ko Woon,24,0,35,11
1650005165509,MATH 20C,A01,083446,Hammock; Frances H,0,0,30,30
1650005165509,MATH 20C,A02,083447,Hammock; Frances H,16,0,30,14
1650005165509,MATH 20C,A03,083448,Hammock; Frances H,20,0,30,10
1650005165509,MATH 20C,A04,083449,Hammock; Frances H,21,0,30,9
1650005165509,MATH 20C,B01,083451,Hammock; Frances H,0,0,30,30
1650005165509,MATH 20C,B02,083452,Hammock; Frances H,19,0,30,11
1650005165509,MATH 20C,B03,083453,Hammock; Frances H,22,0,30,8
1650005165509,MATH 20C,B04,083454,Hammock; Frances H,24,0,30,6
1650005171542,MATH 20D,A01,084128,Staff,14,0,30,16
1650005171542,MATH 20D,A02,084129,Staff,29,0,30,1
1650005171542,MATH 20D,A03,084130,Staff,27,0,30,3
1650005171542,MATH 20D,B01,084133,Staff,3,0,30,27
1650005171542,MATH 20D,B02,084134,Staff,24,0,30,6
1650005171542,MATH 20D,B03,084135,Staff,28,0,30,2
1650005177570,MATH 20E,A01,084138,Staff,13,0,30,17
1650005177570,MATH 20E,A02,084139,Staff,7,0,30,23
1650005177570,MATH 20E,A03,084140,Staff,15,0,30,15
1650005177570,MATH 20E,A04,084141,Staff,20,0,30,10
1650005183595,MATH 102,A01,084143,Harel; Guershon,12,0,30,18
1650005183595,MATH 102,A02,084144,Harel; Guershon,20,0,30,10
1650005189621,MATH 103B,A01,083456,Staff,0,13,30,30
1650005189621,MATH 103B,A02,083457,Staff,0,12,30,30
1650005195645,MATH 109,A01,084146,Salehi Golsefidy; Alireza,18,0,30,12
1650005195645,MATH 109,A02,084147,Salehi Golsefidy; Alireza,16,0,30,14
1650005201668,MATH 120A,A01,085445,Eggers; John Dietrich,11,0,35,24
1650005201668,MATH 120A,A02,085446,Eggers; John Dietrich,27,0,35,8
1650005207692,MATH 142B,A01,084149,Verstraete; Jacques Allan,0,12,30,30
1650005207692,MATH 142B,A02,084150,Verstraete; Jacques Allan,0,12,30,30
1650005213716,MATH 170A,A01,083459,Nie; Jiawang,0,9,30,30
1650005213716,MATH 170A,A02,083460,Nie; Jiawang,0,7,30,30
1650005213716,MATH 170A,A03,083461,Nie; Jiawang,0,9,30,30
1650005219752,MATH 193B,A01,083463,Staff,1,0,30,29
1650005219752,MATH 193B,A02,083464,Staff,9,0,30,21
1650005219752,MATH 193B,A03,083465,Staff,18,0,30,12
1650005225805,COGS 2,A01,083966,Boyle; Mary E. T.,9,0,30,21
1650005231838,COGS 9,A01,083968,Staff,9,0,60,51
1650005237865,COGS 14B,A01,083970,Staff,10,0,50,40
1650005243888,COGS 17,A01,092679,Staff,51,0,75,24
1650005249909,COGS 100,A01,083972,Staff,0,15,60,60
1650005261963,COGS 101C,A01,083976,Staff,12,0,30,18
1650005267990,COGS 102A,A01,083978,Johnson; Christine M.,14,0,30,16
1650005274013,COGS 107B,A01,083980,Staff,0,7,50,50
1650005280038,COGS 115,A01,083982,Staff,10,0,30,20
1650005286063,COGS 118B,A01,083367,Staff,0,14,40,40
1650005292092,COGS 172,A01,083984,Provenzano; Emily Kara,15,0,30,15
1650005298121,COGS 177,A00,083368,Staff,0,20,30,30
1650005304165,COGS 186,A01,083986,Staff,21,0,40,19
1650005310271,COGS 187A,A01,083988,Boyle; Mary E. T.,20,0,60,40
1650005316293,CSE 8A,A50,084003,Miranda; Gregory Joseph,0,13,15,15
1650005322318,CSE 11,A01,084005,Miranda; Gregory Joseph,0,20,55,55
1650005328342,CSE 20,A01,084007,Staff,0,5,20,20
1650005334368,CSE 21,A01,084009,Staff,0,30,50,50
1650005340391,CSE 30,A01,083370,Cao; Yingjun,0,64,40,40
1650005346414,CSE 100,A01,083372,Cao; Yingjun,0,46,40,40
1650005352440,CSE 101,A01,084011,Staff,0,53,40,40
1650005358464,CSE 141,A01,083374,Eldon; John,0,64,75,75
1650005364491,CSE 141L,A01,083376,Eldon; John,0,70,75,75
1650005370516,CSE 175,A01,084013,Kumar; Rakesh,22,0,25,3
1650005376542,CSE 190,A00,092508,Dubnov; Shlomo,20,0,20,0
1650005382566,ECE 5,A01,084049,Morris; Karcher William,13,0,20,7
1650005388593,ECE 100,A01,084051,Baghdadchi; Saharnaz,0,0,20,20
1650005388593,ECE 100,A02,091916,Baghdadchi; Saharnaz,13,0,20,7
1650005394620,ECE 101,A01,084053,Baghdadchi; Saharnaz,0,0,37,37
1650005394620,ECE 101,A02,084054,Baghdadchi; Saharnaz,30,0,37,7
1650005400650,ECE 107,A01,083390,Staff,26,0,40,14
1650005406687,ECE 148,A01,084056,Silberman; Jack,8,0,12,4
1650005412720,ECE 180,A00,083391,Abi Samra; Nicholas Camill,25,0,30,5
1650005412720,ECE 180,B00,083392,Abi Samra; Nicholas Camill,21,0,30,9
1650005418752,MATH 10B,A01,084110,Staff,0,0,30,30
1650005418752,MATH 10B,A02,084111,Staff,19,0,30,11
1650005418752,MATH 10B,A03,084112,Staff,24,0,30,6
1650005424776,MATH 10C,A01,083443,Staff,0,15,30,30
1650005424776,MATH 10C,A02,083444,Staff,0,14,30,30
1650005424776,MATH 10C,B01,084114,Staff,19,0,30,11
1650005424776,MATH 10C,B02,084115,Staff,25,0,30,5
1650005430804,MATH 18,A01,084117,Harel; Guershon,14,0,30,16
1650005430804,MATH 18,A02,084119,Harel; Guershon,28,0,30,2
1650005430804,MATH 18,A03,084120,Harel; Guershon,29,0,30,1
1650005430804,MATH 18,A04,084121,Harel; Guershon,29,0,30,1
1650005436827,MATH 20B,A01,084124,Um; Ko Woon,16,0,35,19
1650005436827,MATH 20B,B01,084126,Um; Ko Woon,24,0,35,11
1650005442868,MATH 20C,A01,083446,Hammock; Frances H,0,0,30,30
1650005442868,MATH 20C,A02,083447,Hammock; Frances H,16,0,30,14
1650005442868,MATH 20C,A03,083448,Hammock; Frances H,20,0,30,10
1650005442868,MATH 20C,A04,083449,Hammock; Frances H,21,0,30,9
1650005442868,MATH 20C,B01,083451,Hammock; Frances H,0,0,30,30
1650005442868,MATH 20C,B02,083452,Hammock; Frances H,19,0,30,11
1650005442868,MATH 20C,B03,083453,Hammock; Frances H,22,0,30,8
1650005442868,MATH 20C,B04,083454,Hammock; Frances H,24,0,30,6
1650005448897,MATH 20D,A01,084128,Staff,14,0,30,16
1650005448897,MATH 20D,A02,084129,Staff,29,0,30,1
1650005448897,MATH 20D,A03,084130,Staff,27,0,30,3
1650005448897,MATH 20D,B01,084133,Staff,3,0,30,27
1650005448897,MATH 20D,B02,084134,Staff,24,0,30,6
1650005448897,MATH 20D,B03,084135,Staff,28,0,30,2
1650005454922,MATH 20E,A01,084138,Staff,13,0,30,17
1650005454922,MATH 20E,A02,084139,Staff,7,0,30,23
1650005454922,MATH 20E,A03,084140,Staff,15,0,30,15
1650005454922,MATH 20E,A04,084141,Staff,20,0,30,10
1650005460947,MATH 102,A01,084143,Harel; Guershon,12,0,30,18
1650005460947,MATH 102,A02,084144,Harel; Guershon,20,0,30,10
1650005466995,MATH 103B,A01,083456,Staff,0,13,30,30
1650005466995,MATH 103B,A02,083457,Staff,0,12,30,30
1650005473029,MATH 109,A01,084146,Salehi Golsefidy; Alireza,18,0,30,12
1650005473029,MATH 109,A02,084147,Salehi Golsefidy; Alireza,16,0,30,14
1650005479055,MATH 120A,A01,085445,Eggers; John Dietrich,10,0,35,25
1650005479055,MATH 120A,A02,085446,Eggers; John Dietrich,27,0,35,8
1650005485084,MATH 142B,A01,084149,Verstraete; Jacques Allan,0,12,30,30
1650005485084,MATH 142B,A02,084150,Verstraete; Jacques Allan,0,12,30,30
1650005491107,MATH 170A,A01,083459,Nie; Jiawang,0,9,30,30
1650005491107,MATH 170A,A02,083460,Nie; Jiawang,0,8,30,30
1650005491107,MATH 170A,A03,083461,Nie; Jiawang,0,9,30,30
1650005497134,MATH 193B,A01,083463,Staff,1,0,30,29
1650005497134,MATH 193B,A02,083464,Staff,9,0,30,21
1650005497134,MATH 193B,A03,083465,Staff,18,0,30,12
1650005503195,COGS 2,A01,083966,Boyle; Mary E. T.,9,0,30,21
1650005509219,COGS 9,A01,083968,Staff,9,0,60,51
1650005515243,COGS 14B,A01,083970,Staff,10,0,50,40
1650005521269,COGS 17,A01,092679,Staff,51,0,75,24
1650005527295,COGS 100,A01,083972,Staff,0,15,60,60
1650005539345,COGS 101C,A01,083976,Staff,12,0,30,18
1650005545371,COGS 102A,A01,083978,Johnson; Christine M.,14,0,30,16
1650005551405,COGS 107B,A01,083980,Staff,0,7,50,50
1650005557430,COGS 115,A01,083982,Staff,10,0,30,20
1650005563453,COGS 118B,A01,083367,Staff,0,14,40,40
1650005569476,COGS 172,A01,083984,Provenzano; Emily Kara,15,0,30,15
1650005575501,COGS 177,A00,083368,Staff,0,20,30,30
1650005581528,COGS 186,A01,083986,Staff,21,0,40,19
1650005587555,COGS 187A,A01,083988,Boyle; Mary E. T.,20,0,60,40
1650005593579,CSE 8A,A50,084003,Miranda; Gregory Joseph,0,13,15,15
1650005599601,CSE 11,A01,084005,Miranda; Gregory Joseph,0,20,55,55
1650005605627,CSE 20,A01,084007,Staff,0,5,20,20
1650005611656,CSE 21,A01,084009,Staff,0,30,50,50
1650005617682,CSE 30,A01,083370,Cao; Yingjun,0,64,40,40
1650005623708,CSE 100,A01,083372,Cao; Yingjun,0,46,40,40
1650005629733,CSE 101,A01,084011,Staff,0,53,40,40
1650005635756,CSE 141,A01,083374,Eldon; John,0,64,75,75
1650005641783,CSE 141L,A01,083376,Eldon; John,0,70,75,75
1650005647807,CSE 175,A01,084013,Kumar; Rakesh,22,0,25,3
1650005653843,CSE 190,A00,092508,Dubnov; Shlomo,20,0,20,0
1650005659867,ECE 5,A01,084049,Morris; Karcher William,13,0,20,7
1650005665894,ECE 100,A01,084051,Baghdadchi; Saharnaz,0,0,20,20
1650005665894,ECE 100,A02,091916,Baghdadchi; Saharnaz,13,0,20,7
1650005671923,ECE 101,A01,084053,Baghdadchi; Saharnaz,0,0,37,37
1650005671923,ECE 101,A02,084054,Baghdadchi; Saharnaz,30,0,37,7
1650005677954,ECE 107,A01,083390,Staff,26,0,40,14
1650005683989,ECE 148,A01,084056,Silberman; Jack,8,0,12,4
1650005690015,ECE 180,A00,083391,Abi Samra; Nicholas Camill,25,0,30,5
1650005690015,ECE 180,B00,083392,Abi Samra; Nicholas Camill,21,0,30,9
1650005696041,MATH 10B,A01,084110,Staff,0,0,30,30
1650005696041,MATH 10B,A02,084111,Staff,19,0,30,11
1650005696041,MATH 10B,A03,084112,Staff,24,0,30,6
1650005702065,MATH 10C,A01,083443,Staff,0,15,30,30
1650005702065,MATH 10C,A02,083444,Staff,0,14,30,30
1650005702065,MATH 10C,B01,084114,Staff,19,0,30,11
1650005702065,MATH 10C,B02,084115,Staff,25,0,30,5
1650005708088,MATH 18,A01,084117,Harel; Guershon,14,0,30,16
1650005708088,MATH 18,A02,084119,Harel; Guershon,28,0,30,2
1650005708088,MATH 18,A03,084120,Harel; Guershon,29,0,30,1
1650005708088,MATH 18,A04,084121,Harel; Guershon,29,0,30,1
1650005714112,MATH 20B,A01,084124,Um; Ko Woon,16,0,35,19
1650005714112,MATH 20B,B01,084126,Um; Ko Woon,24,0,35,11
1650005720138,MATH 20C,A01,083446,Hammock; Frances H,0,0,30,30
1650005720138,MATH 20C,A02,083447,Hammock; Frances H,16,0,30,14
1650005720138,MATH 20C,A03,083448,Hammock; Frances H,20,0,30,10
1650005720138,MATH 20C,A04,083449,Hammock; Frances H,21,0,30,9
1650005720138,MATH 20C,B01,083451,Hammock; Frances H,0,0,30,30
1650005720138,MATH 20C,B02,083452,Hammock; Frances H,19,0,30,11
1650005720138,MATH 20C,B03,083453,Hammock; Frances H,22,0,30,8
1650005720138,MATH 20C,B04,083454,Hammock; Frances H,24,0,30,6
1650005726162,MATH 20D,A01,084128,Staff,14,0,30,16
1650005726162,MATH 20D,A02,084129,Staff,29,0,30,1
1650005726162,MATH 20D,A03,084130,Staff,27,0,30,3
1650005726162,MATH 20D,B01,084133,Staff,3,0,30,27
1650005726162,MATH 20D,B02,084134,Staff,24,0,30,6
1650005726162,MATH 20D,B03,084135,Staff,28,0,30,2
1650005732189,MATH 20E,A01,084138,Staff,13,0,30,17
1650005732189,MATH 20E,A02,084139,Staff,7,0,30,23
1650005732189,MATH 20E,A03,084140,Staff,15,0,30,15
1650005732189,MATH 20E,A04,084141,Staff,20,0,30,10
1650005738212,MATH 102,A01,084143,Harel; Guershon,12,0,30,18
1650005738212,MATH 102,A02,084144,Harel; Guershon,20,0,30,10
1650005744236,MATH 103B,A01,083456,Staff,0,13,30,30
1650005744236,MATH 103B,A02,083457,Staff,0,12,30,30
1650005750259,MATH 109,A01,084146,Salehi Golsefidy; Alireza,18,0,30,12
1650005750259,MATH 109,A02,084147,Salehi Golsefidy; Alireza,16,0,30,14
1650005756286,MATH 120A,A01,085445,Eggers; John Dietrich,10,0,35,25
1650005756286,MATH 120A,A02,085446,Eggers; John Dietrich,27,0,35,8
1650005762311,MATH 142B,A01,084149,Verstraete; Jacques Allan,0,12,30,30
1650005762311,MATH 142B,A02,084150,Verstraete; Jacques Allan,0,12,30,30
1650005768335,MATH 170A,A01,083459,Nie; Jiawang,0,9,30,30
1650005768335,MATH 170A,A02,083460,Nie; Jiawang,0,8,30,30
1650005768335,MATH 170A,A03,083461,Nie; Jiawang,0,9,30,30
1650005774370,MATH 193B,A01,083463,Staff,1,0,30,29
1650005774370,MATH 193B,A02,083464,Staff,9,0,30,21
1650005774370,MATH 193B,A03,083465,Staff,18,0,30,12
1650005780421,COGS 2,A01,083966,Boyle; Mary E. T.,9,0,30,21
1650005786444,COGS 9,A01,083968,Staff,9,0,60,51
1650005792471,COGS 14B,A01,083970,Staff,10,0,50,40
1650005798495,COGS 17,A01,092679,Staff,51,0,75,24
1650005804518,COGS 100,A01,083972,Staff,0,15,60,60
1650005816569,COGS 101C,A01,083976,Staff,12,0,30,18
1650005822591,COGS 102A,A01,083978,Johnson; Christine M.,14,0,30,16
1650005828614,COGS 107B,A01,083980,Staff,0,7,50,50
1650005834640,COGS 115,A01,083982,Staff,10,0,30,20
1650005840666,COGS 118B,A01,083367,Staff,0,15,40,40
1650005846712,COGS 172,A01,083984,Provenzano; Emily Kara,15,0,30,15
1650005852738,COGS 177,A00,083368,Staff,0,20,30,30
1650005858764,COGS 186,A01,083986,Staff,21,0,40,19
1650005864786,COGS 187A,A01,083988,Boyle; Mary E. T.,20,0,60,40
1650005870815,CSE 8A,A50,084003,Miranda; Gregory Joseph,0,13,15,15
1650005876837,CSE 11,A01,084005,Miranda; Gregory Joseph,0,20,55,55
1650005882863,CSE 20,A01,084007,Staff,0,5,20,20
1650005888895,CSE 21,A01,084009,Staff,0,30,50,50
1650005894921,CSE 30,A01,083370,Cao; Yingjun,0,64,40,40
1650005900947,CSE 100,A01,083372,Cao; Yingjun,0,46,40,40
1650005907064,CSE 101,A01,084011,Staff,0,53,40,40
1650005913088,CSE 141,A01,083374,Eldon; John,0,64,75,75
1650005919111,CSE 141L,A01,083376,Eldon; John,0,70,75,75
1650005925136,CSE 175,A01,084013,Kumar; Rakesh,22,0,25,3
1650005931159,CSE 190,A00,092508,Dubnov; Shlomo,20,0,20,0
1650005937181,ECE 5,A01,084049,Morris; Karcher William,13,0,20,7
1650005943205,ECE 100,A01,084051,Baghdadchi; Saharnaz,0,0,20,20
1650005943205,ECE 100,A02,091916,Baghdadchi; Saharnaz,13,0,20,7
1650005949227,ECE 101,A01,084053,Baghdadchi; Saharnaz,0,0,37,37
1650005949227,ECE 101,A02,084054,Baghdadchi; Saharnaz,30,0,37,7
1650005955250,ECE 107,A01,083390,Staff,26,0,40,14
1650005961273,ECE 148,A01,084056,Silberman; Jack,8,0,12,4
1650005967297,ECE 180,A00,083391,Abi Samra; Nicholas Camill,25,0,30,5
1650005967297,ECE 180,B00,083392,Abi Samra; Nicholas Camill,21,0,30,9
1650005973321,MATH 10B,A01,084110,Staff,0,0,30,30
1650005973321,MATH 10B,A02,084111,Staff,19,0,30,11
1650005973321,MATH 10B,A03,084112,Staff,24,0,30,6
1650005979346,MATH 10C,A01,083443,Staff,0,15,30,30
1650005979346,MATH 10C,A02,083444,Staff,0,14,30,30
1650005979346,MATH 10C,B01,084114,Staff,19,0,30,11
1650005979346,MATH 10C,B02,084115,Staff,25,0,30,5
1650005985367,MATH 18,A01,084117,Harel; Guershon,14,0,30,16
1650005985367,MATH 18,A02,084119,Harel; Guershon,28,0,30,2
1650005985367,MATH 18,A03,084120,Harel; Guershon,29,0,30,1
1650005985367,MATH 18,A04,084121,Harel; Guershon,29,0,30,1
1650005991397,MATH 20B,A01,084124,Um; Ko Woon,16,0,35,19
1650005991397,MATH 20B,B01,084126,Um; Ko Woon,24,0,35,11
1650005997422,MATH 20C,A01,083446,Hammock; Frances H,0,0,30,30
1650005997422,MATH 20C,A02,083447,Hammock; Frances H,16,0,30,14
1650005997422,MATH 20C,A03,083448,Hammock; Frances H,20,0,30,10
1650005997422,MATH 20C,A04,083449,Hammock; Frances H,21,0,30,9
1650005997422,MATH 20C,B01,083451,Hammock; Frances H,0,0,30,30
1650005997422,MATH 20C,B02,083452,Hammock; Frances H,19,0,30,11
1650005997422,MATH 20C,B03,083453,Hammock; Frances H,22,0,30,8
1650005997422,MATH 20C,B04,083454,Hammock; Frances H,24,0,30,6
1650006003446,MATH 20D,A01,084128,Staff,14,0,30,16
1650006003446,MATH 20D,A02,084129,Staff,29,0,30,1
1650006003446,MATH 20D,A03,084130,Staff,27,0,30,3
1650006003446,MATH 20D,B01,084133,Staff,3,0,30,27
1650006003446,MATH 20D,B02,084134,Staff,24,0,30,6
1650006003446,MATH 20D,B03,084135,Staff,28,0,30,2
1650006009470,MATH 20E,A01,084138,Staff,13,0,30,17
1650006009470,MATH 20E,A02,084139,Staff,7,0,30,23
1650006009470,MATH 20E,A03,084140,Staff,15,0,30,15
1650006009470,MATH 20E,A04,084141,Staff,20,0,30,10
1650006015498,MATH 102,A01,084143,Harel; Guershon,12,0,30,18
1650006015498,MATH 102,A02,084144,Harel; Guershon,20,0,30,10
1650006021524,MATH 103B,A01,083456,Staff,0,13,30,30
1650006021524,MATH 103B,A02,083457,Staff,0,12,30,30
1650006027548,MATH 109,A01,084146,Salehi Golsefidy; Alireza,18,0,30,12
1650006027548,MATH 109,A02,084147,Salehi Golsefidy; Alireza,16,0,30,14
1650006033591,MATH 120A,A01,085445,Eggers; John Dietrich,10,0,35,25
1650006033591,MATH 120A,A02,085446,Eggers; John Dietrich,27,0,35,8
1650006039625,MATH 142B,A01,084149,Verstraete; Jacques Allan,0,12,30,30
1650006039625,MATH 142B,A02,084150,Verstraete; Jacques Allan,0,12,30,30
1650006045650,MATH 170A,A01,083459,Nie; Jiawang,0,9,30,30
1650006045650,MATH 170A,A02,083460,Nie; Jiawang,0,8,30,30
1650006045650,MATH 170A,A03,083461,Nie; Jiawang,0,9,30,30
1650006051676,MATH 193B,A01,083463,Staff,1,0,30,29
1650006051676,MATH 193B,A02,083464,Staff,9,0,30,21
1650006051676,MATH 193B,A03,083465,Staff,18,0,30,12
1650006057731,COGS 2,A01,083966,Boyle; Mary E. T.,9,0,30,21
1650006063760,COGS 9,A01,083968,Staff,9,0,60,51
1650006069789,COGS 14B,A01,083970,Staff,10,0,50,40
1650006075818,COGS 17,A01,092679,Staff,51,0,75,24
1650006081847,COGS 100,A01,083972,Staff,0,15,60,60
1650006093917,COGS 101C,A01,083976,Staff,12,0,30,18
1650006099944,COGS 102A,A01,083978,Johnson; Christine M.,14,0,30,16
1650006105969,COGS 107B,A01,083980,Staff,0,7,50,50
1650006112005,COGS 115,A01,083982,Staff,10,0,30,20
1650006118036,COGS 118B,A01,083367,Staff,0,15,40,40
1650006124065,COGS 172,A01,083984,Provenzano; Emily Kara,15,0,30,15
1650006130089,COGS 177,A00,083368,Staff,0,20,30,30
1650006136114,COGS 186,A01,083986,Staff,21,0,40,19
1650006142143,COGS 187A,A01,083988,Boyle; Mary E. T.,20,0,60,40
1650006148168,CSE 8A,A50,084003,Miranda; Gregory Joseph,0,13,15,15
1650006154191,CSE 11,A01,084005,Miranda; Gregory Joseph,0,20,55,55
1650006160218,CSE 20,A01,084007,Staff,0,5,20,20
1650006166241,CSE 21,A01,084009,Staff,0,30,50,50
1650006172266,CSE 30,A01,083370,Cao; Yingjun,0,65,40,40
1650006178290,CSE 100,A01,083372,Cao; Yingjun,0,46,40,40
1650006184331,CSE 101,A01,084011,Staff,0,53,40,40
1650006190359,CSE 141,A01,083374,Eldon; John,0,64,75,75
1650006196383,CSE 141L,A01,083376,Eldon; John,0,70,75,75
1650006202410,CSE 175,A01,084013,Kumar; Rakesh,22,0,25,3
1650006208437,CSE 190,A00,092508,Dubnov; Shlomo,20,0,20,0
1650006214459,ECE 5,A01,084049,Morris; Karcher William,13,0,20,7
1650006220491,ECE 100,A01,084051,Baghdadchi; Saharnaz,0,0,20,20
1650006220491,ECE 100,A02,091916,Baghdadchi; Saharnaz,13,0,20,7
1650006226523,ECE 101,A01,084053,Baghdadchi; Saharnaz,0,0,37,37
1650006226523,ECE 101,A02,084054,Baghdadchi; Saharnaz,30,0,37,7
1650006232548,ECE 107,A01,083390,Staff,26,0,40,14
1650006238584,ECE 148,A01,084056,Silberman; Jack,8,0,12,4
1650006244608,ECE 180,A00,083391,Abi Samra; Nicholas Camill,25,0,30,5
1650006244608,ECE 180,B00,083392,Abi Samra; Nicholas Camill,21,0,30,9
1650006250637,MATH 10B,A01,084110,Staff,0,0,30,30
1650006250637,MATH 10B,A02,084111,Staff,19,0,30,11
1650006250637,MATH 10B,A03,084112,Staff,24,0,30,6
1650006256662,MATH 10C,A01,083443,Staff,0,15,30,30
1650006256662,MATH 10C,A02,083444,Staff,0,14,30,30
1650006256662,MATH 10C,B01,084114,Staff,19,0,30,11
1650006256662,MATH 10C,B02,084115,Staff,25,0,30,5
1650006262691,MATH 18,A01,084117,Harel; Guershon,14,0,30,16
1650006262691,MATH 18,A02,084119,Harel; Guershon,28,0,30,2
1650006262691,MATH 18,A03,084120,Harel; Guershon,29,0,30,1
1650006262691,MATH 18,A04,084121,Harel; Guershon,29,0,30,1
1650006268716,MATH 20B,A01,084124,Um; Ko Woon,16,0,35,19
1650006268716,MATH 20B,B01,084126,Um; Ko Woon,24,0,35,11
1650006274748,MATH 20C,A01,083446,Hammock; Frances H,0,0,30,30
1650006274748,MATH 20C,A02,083447,Hammock; Frances H,16,0,30,14
1650006274748,MATH 20C,A03,083448,Hammock; Frances H,20,0,30,10
1650006274748,MATH 20C,A04,083449,Hammock; Frances H,21,0,30,9
1650006274748,MATH 20C,B01,083451,Hammock; Frances H,0,0,30,30
1650006274748,MATH 20C,B02,083452,Hammock; Frances H,19,0,30,11
1650006274748,MATH 20C,B03,083453,Hammock; Frances H,22,0,30,8
1650006274748,MATH 20C,B04,083454,Hammock; Frances H,24,0,30,6
1650006280780,MATH 20D,A01,084128,Staff,14,0,30,16
1650006280780,MATH 20D,A02,084129,Staff,29,0,30,1
1650006280780,MATH 20D,A03,084130,Staff,27,0,30,3
1650006280780,MATH 20D,B01,084133,Staff,3,0,30,27
1650006280780,MATH 20D,B02,084134,Staff,24,0,30,6
1650006280780,MATH 20D,B03,084135,Staff,28,0,30,2
1650006286803,MATH 20E,A01,084138,Staff,13,0,30,17
1650006286803,MATH 20E,A02,084139,Staff,7,0,30,23
1650006286803,MATH 20E,A03,084140,Staff,15,0,30,15
1650006286803,MATH 20E,A04,084141,Staff,20,0,30,10
1650006292828,MATH 102,A01,084143,Harel; Guershon,12,0,30,18
1650006292828,MATH 102,A02,084144,Harel; Guershon,20,0,30,10
1650006298851,MATH 103B,A01,083456,Staff,0,13,30,30
1650006298851,MATH 103B,A02,083457,Staff,0,12,30,30
1650006304874,MATH 109,A01,084146,Salehi Golsefidy; Alireza,18,0,30,12
1650006304874,MATH 109,A02,084147,Salehi Golsefidy; Alireza,16,0,30,14
1650006310897,MATH 120A,A01,085445,Eggers; John Dietrich,10,0,35,25
1650006310897,MATH 120A,A02,085446,Eggers; John Dietrich,27,0,35,8
1650006316927,MATH 142B,A01,084149,Verstraete; Jacques Allan,0,12,30,30
1650006316927,MATH 142B,A02,084150,Verstraete; Jacques Allan,0,12,30,30
1650006322956,MATH 170A,A01,083459,Nie; Jiawang,0,9,30,30
1650006322956,MATH 170A,A02,083460,Nie; Jiawang,0,8,30,30
1650006322956,MATH 170A,A03,083461,Nie; Jiawang,0,9,30,30
1650006328980,MATH 193B,A01,083463,Staff,1,0,30,29
1650006328980,MATH 193B,A02,083464,Staff,9,0,30,21
1650006328980,MATH 193B,A03,083465,Staff,18,0,30,12
1650006335027,COGS 2,A01,083966,Boyle; Mary E. T.,9,0,30,21
1650006341050,COGS 9,A01,083968,Staff,9,0,60,51
1650006347080,COGS 14B,A01,083970,Staff,10,0,50,40
1650006353109,COGS 17,A01,092679,Staff,51,0,75,24
1650006359144,COGS 100,A01,083972,Staff,0,15,60,60
1650006371190,COGS 101C,A01,083976,Staff,12,0,30,18
1650006377218,COGS 102A,A01,083978,Johnson; Christine M.,14,0,30,16
1650006383241,COGS 107B,A01,083980,Staff,0,7,50,50
1650006389266,COGS 115,A01,083982,Staff,10,0,30,20
1650006395292,COGS 118B,A01,083367,Staff,0,15,40,40
1650006401321,COGS 172,A01,083984,Provenzano; Emily Kara,15,0,30,15
1650006407345,COGS 177,A00,083368,Staff,0,20,30,30
1650006413371,COGS 186,A01,083986,Staff,21,0,40,19
1650006419395,COGS 187A,A01,083988,Boyle; Mary E. T.,20,0,60,40
1650006425419,CSE 8A,A50,084003,Miranda; Gregory Joseph,0,13,15,15
1650006431443,CSE 11,A01,084005,Miranda; Gregory Joseph,0,20,55,55
1650006437469,CSE 20,A01,084007,Staff,0,5,20,20
1650006443492,CSE 21,A01,084009,Staff,0,30,50,50
1650006449517,CSE 30,A01,083370,Cao; Yingjun,0,65,40,40
1650006455545,CSE 100,A01,083372,Cao; Yingjun,0,46,40,40
1650006461570,CSE 101,A01,084011,Staff,0,53,40,40
1650006467598,CSE 141,A01,083374,Eldon; John,0,64,75,75
1650006473627,CSE 141L,A01,083376,Eldon; John,0,70,75,75
1650006479656,CSE 175,A01,084013,Kumar; Rakesh,22,0,25,3
1650006485683,CSE 190,A00,092508,Dubnov; Shlomo,20,0,20,0
1650006491723,ECE 5,A01,084049,Morris; Karcher William,13,0,20,7
1650006497748,ECE 100,A01,084051,Baghdadchi; Saharnaz,0,0,20,20
1650006497748,ECE 100,A02,091916,Baghdadchi; Saharnaz,13,0,20,7
1650006503865,ECE 101,A01,084053,Baghdadchi; Saharnaz,0,0,37,37
1650006503865,ECE 101,A02,084054,Baghdadchi; Saharnaz,30,0,37,7
1650006509912,ECE 107,A01,083390,Staff,26,0,40,14
1650006515936,ECE 148,A01,084056,Silberman; Jack,8,0,12,4
1650006529620,ECE 180,A00,083391,Abi Samra; Nicholas Camill,25,0,30,5
1650006529620,ECE 180,B00,083392,Abi Samra; Nicholas Camill,21,0,30,9
1650006535645,MATH 10B,A01,084110,Staff,0,0,30,30
1650006535645,MATH 10B,A02,084111,Staff,19,0,30,11
1650006535645,MATH 10B,A03,084112,Staff,24,0,30,6
1650006541670,MATH 10C,A01,083443,Staff,0,15,30,30
1650006541670,MATH 10C,A02,083444,Staff,0,14,30,30
1650006541670,MATH 10C,B01,084114,Staff,19,0,30,11
1650006541670,MATH 10C,B02,084115,Staff,25,0,30,5
1650006547695,MATH 18,A01,084117,Harel; Guershon,14,0,30,16
1650006547695,MATH 18,A02,084119,Harel; Guershon,28,0,30,2
1650006547695,MATH 18,A03,084120,Harel; Guershon,29,0,30,1
1650006547695,MATH 18,A04,084121,Harel; Guershon,29,0,30,1
1650006553719,MATH 20B,A01,084124,Um; Ko Woon,16,0,35,19
1650006553719,MATH 20B,B01,084126,Um; Ko Woon,24,0,35,11
1650006559753,MATH 20C,A01,083446,Hammock; Frances H,0,0,30,30
1650006559753,MATH 20C,A02,083447,Hammock; Frances H,16,0,30,14
1650006559753,MATH 20C,A03,083448,Hammock; Frances H,20,0,30,10
1650006559753,MATH 20C,A04,083449,Hammock; Frances H,20,0,30,10
1650006559753,MATH 20C,B01,083451,Hammock; Frances H,0,0,30,30
1650006559753,MATH 20C,B02,083452,Hammock; Frances H,19,0,30,11
1650006559753,MATH 20C,B03,083453,Hammock; Frances H,22,0,30,8
1650006559753,MATH 20C,B04,083454,Hammock; Frances H,24,0,30,6
1650006565777,MATH 20D,A01,084128,Staff,14,0,30,16
1650006565777,MATH 20D,A02,084129,Staff,29,0,30,1
1650006565777,MATH 20D,A03,084130,Staff,27,0,30,3
1650006565777,MATH 20D,B01,084133,Staff,3,0,30,27
1650006565777,MATH 20D,B02,084134,Staff,24,0,30,6
1650006565777,MATH 20D,B03,084135,Staff,28,0,30,2
1650006571806,MATH 20E,A01,084138,Staff,13,0,30,17
1650006571806,MATH 20E,A02,084139,Staff,7,0,30,23
1650006571806,MATH 20E,A03,084140,Staff,15,0,30,15
1650006571806,MATH 20E,A04,084141,Staff,20,0,30,10
1650006577830,MATH 102,A01,084143,Harel; Guershon,12,0,30,18
1650006577830,MATH 102,A02,084144,Harel; Guershon,20,0,30,10
1650006583853,MATH 103B,A01,083456,Staff,0,13,30,30
1650006583853,MATH 103B,A02,083457,Staff,0,12,30,30
1650006589877,MATH 109,A01,084146,Salehi Golsefidy; Alireza,18,0,30,12
1650006589877,MATH 109,A02,084147,Salehi Golsefidy; Alireza,16,0,30,14
1650006595905,MATH 120A,A01,085445,Eggers; John Dietrich,10,0,35,25
1650006595905,MATH 120A,A02,085446,Eggers; John Dietrich,27,0,35,8
1650006601928,MATH 142B,A01,084149,Verstraete; Jacques Allan,0,12,30,30
1650006601928,MATH 142B,A02,084150,Verstraete; Jacques Allan,0,12,30,30
1650006607957,MATH 170A,A01,083459,Nie; Jiawang,0,9,30,30
1650006607957,MATH 170A,A02,083460,Nie; Jiawang,0,8,30,30
1650006607957,MATH 170A,A03,083461,Nie; Jiawang,0,9,30,30
1650006613980,MATH 193B,A01,083463,Staff,1,0,30,29
1650006613980,MATH 193B,A02,083464,Staff,9,0,30,21
1650006613980,MATH 193B,A03,083465,Staff,18,0,30,12
1650006620053,COGS 2,A01,083966,Boyle; Mary E. T.,9,0,30,21
1650006626078,COGS 9,A01,083968,Staff,9,0,60,51
1650006632106,COGS 14B,A01,083970,Staff,10,0,50,40
1650006638129,COGS 17,A01,092679,Staff,51,0,75,24
1650006644152,COGS 100,A01,083972,Staff,0,15,60,60
1650006656205,COGS 101C,A01,083976,Staff,12,0,30,18
1650006662233,COGS 102A,A01,083978,Johnson; Christine M.,14,0,30,16
1650006668260,COGS 107B,A01,083980,Staff,0,7,50,50
1650006674284,COGS 115,A01,083982,Staff,10,0,30,20
1650006680307,COGS 118B,A01,083367,Staff,0,15,40,40
1650006686331,COGS 172,A01,083984,Provenzano; Emily Kara,15,0,30,15
1650006692363,COGS 177,A00,083368,Staff,0,20,30,30
1650006698387,COGS 186,A01,083986,Staff,21,0,40,19
1650006704413,COGS 187A,A01,083988,Boyle; Mary E. T.,20,0,60,40
1650006710453,CSE 8A,A50,084003,Miranda; Gregory Joseph,0,13,15,15
1650006716486,CSE 11,A01,084005,Miranda; Gregory Joseph,0,20,55,55
1650006722525,CSE 20,A01,084007,Staff,0,5,20,20
1650006728549,CSE 21,A01,084009,Staff,0,30,50,50
1650006734577,CSE 30,A01,083370,Cao; Yingjun,0,65,40,40
1650006740619,CSE 100,A01,083372,Cao; Yingjun,0,46,40,40
1650006746668,CSE 101,A01,084011,Staff,0,53,40,40
1650006752708,CSE 141,A01,083374,Eldon; John,0,64,75,75
1650006758735,CSE 141L,A01,083376,Eldon; John,0,70,75,75
1650006764770,CSE 175,A01,084013,Kumar; Rakesh,22,0,25,3
1650006770804,CSE 190,A00,092508,Dubnov; Shlomo,20,0,20,0
1650006776828,ECE 5,A01,084049,Morris; Karcher William,13,0,20,7
1650006782872,ECE 100,A01,084051,Baghdadchi; Saharnaz,0,0,20,20
1650006782872,ECE 100,A02,091916,Baghdadchi; Saharnaz,13,0,20,7
1650006788901,ECE 101,A01,084053,Baghdadchi; Saharnaz,0,0,37,37
1650006788901,ECE 101,A02,084054,Baghdadchi; Saharnaz,30,0,37,7
1650006794925,ECE 107,A01,083390,Staff,26,0,40,14
1650006800950,ECE 148,A01,084056,Silberman; Jack,8,0,12,4
1650006806975,ECE 180,A00,083391,Abi Samra; Nicholas Camill,25,0,30,5
1650006806975,ECE 180,B00,083392,Abi Samra; Nicholas Camill,21,0,30,9
1650006813000,MATH 10B,A01,084110,Staff,0,0,30,30
1650006813000,MATH 10B,A02,084111,Staff,19,0,30,11
1650006813000,MATH 10B,A03,084112,Staff,24,0,30,6
1650006819032,MATH 10C,A01,083443,Staff,0,15,30,30
1650006819032,MATH 10C,A02,083444,Staff,0,14,30,30
1650006819032,MATH 10C,B01,084114,Staff,19,0,30,11
1650006819032,MATH 10C,B02,084115,Staff,25,0,30,5
1650006825057,MATH 18,A01,084117,Harel; Guershon,14,0,30,16
1650006825057,MATH 18,A02,084119,Harel; Guershon,28,0,30,2
1650006825057,MATH 18,A03,084120,Harel; Guershon,29,0,30,1
1650006825057,MATH 18,A04,084121,Harel; Guershon,29,0,30,1
1650006831106,MATH 20B,A01,084124,Um; Ko Woon,16,0,35,19
1650006831106,MATH 20B,B01,084126,Um; Ko Woon,24,0,35,11
1650006837133,MATH 20C,A01,083446,Hammock; Frances H,0,0,30,30
1650006837133,MATH 20C,A02,083447,Hammock; Frances H,16,0,30,14
1650006837133,MATH 20C,A03,083448,Hammock; Frances H,20,0,30,10
1650006837133,MATH 20C,A04,083449,Hammock; Frances H,20,0,30,10
1650006837133,MATH 20C,B01,083451,Hammock; Frances H,0,0,30,30
1650006837133,MATH 20C,B02,083452,Hammock; Frances H,19,0,30,11
1650006837133,MATH 20C,B03,083453,Hammock; Frances H,22,0,30,8
1650006837133,MATH 20C,B04,083454,Hammock; Frances H,24,0,30,6
1650006843158,MATH 20D,A01,084128,Staff,14,0,30,16
1650006843158,MATH 20D,A02,084129,Staff,29,0,30,1
1650006843158,MATH 20D,A03,084130,Staff,27,0,30,3
1650006843158,MATH 20D,B01,084133,Staff,3,0,30,27
1650006843158,MATH 20D,B02,084134,Staff,24,0,30,6
1650006843158,MATH 20D,B03,084135,Staff,28,0,30,2
1650006849190,MATH 20E,A01,084138,Staff,13,0,30,17
1650006849190,MATH 20E,A02,084139,Staff,7,0,30,23
1650006849190,MATH 20E,A03,084140,Staff,15,0,30,15
1650006849190,MATH 20E,A04,084141,Staff,20,0,30,10
1650006855219,MATH 102,A01,084143,Harel; Guershon,12,0,30,18
1650006855219,MATH 102,A02,084144,Harel; Guershon,20,0,30,10
1650006861247,MATH 103B,A01,083456,Staff,0,13,30,30
1650006861247,MATH 103B,A02,083457,Staff,0,12,30,30
1650006867275,MATH 109,A01,084146,Salehi Golsefidy; Alireza,18,0,30,12
1650006867275,MATH 109,A02,084147,Salehi Golsefidy; Alireza,16,0,30,14
1650006873300,MATH 120A,A01,085445,Eggers; John Dietrich,10,0,35,25
1650006873300,MATH 120A,A02,085446,Eggers; John Dietrich,27,0,35,8
1650006879324,MATH 142B,A01,084149,Verstraete; Jacques Allan,0,12,30,30
1650006879324,MATH 142B,A02,084150,Verstraete; Jacques Allan,0,12,30,30
1650006885361,MATH 170A,A01,083459,Nie; Jiawang,0,9,30,30
1650006885361,MATH 170A,A02,083460,Nie; Jiawang,0,8,30,30
1650006885361,MATH 170A,A03,083461,Nie; Jiawang,0,9,30,30
1650006891390,MATH 193B,A01,083463,Staff,1,0,30,29
1650006891390,MATH 193B,A02,083464,Staff,9,0,30,21
1650006891390,MATH 193B,A03,083465,Staff,18,0,30,12
1650006897459,COGS 2,A01,083966,Boyle; Mary E. T.,9,0,30,21
1650006903486,COGS 9,A01,083968,Staff,9,0,60,51
1650006909520,COGS 14B,A01,083970,Staff,10,0,50,40
1650006915547,COGS 17,A01,092679,Staff,51,0,75,24
1650006921579,COGS 100,A01,083972,Staff,0,15,60,60
1650006933638,COGS 101C,A01,083976,Staff,12,0,30,18
1650006939667,COGS 102A,A01,083978,Johnson; Christine M.,14,0,30,16
1650006945698,COGS 107B,A01,083980,Staff,0,7,50,50
1650006951723,COGS 115,A01,083982,Staff,10,0,30,20
1650006957745,COGS 118B,A01,083367,Staff,0,15,40,40
1650006963773,COGS 172,A01,083984,Provenzano; Emily Kara,15,0,30,15
1650006969807,COGS 177,A00,083368,Staff,0,20,30,30
1650006975832,COGS 186,A01,083986,Staff,21,0,40,19
1650006981857,COGS 187A,A01,083988,Boyle; Mary E. T.,20,0,60,40
1650006987882,CSE 8A,A50,084003,Miranda; Gregory Joseph,0,13,15,15
1650006993905,CSE 11,A01,084005,Miranda; Gregory Joseph,0,20,55,55
1650006999930,CSE 20,A01,084007,Staff,0,5,20,20
1650007005957,CSE 21,A01,084009,Staff,0,30,50,50
1650007011980,CSE 30,A01,083370,Cao; Yingjun,0,65,40,40
1650007018003,CSE 100,A01,083372,Cao; Yingjun,0,46,40,40
1650007024028,CSE 101,A01,084011,Staff,0,53,40,40
1650007030056,CSE 141,A01,083374,Eldon; John,0,64,75,75
1650007036078,CSE 141L,A01,083376,Eldon; John,0,70,75,75
1650007042108,CSE 175,A01,084013,Kumar; Rakesh,22,0,25,3
1650007048145,CSE 190,A00,092508,Dubnov; Shlomo,20,0,20,0
1650007054174,ECE 5,A01,084049,Morris; Karcher William,13,0,20,7
1650007060214,ECE 100,A01,084051,Baghdadchi; Saharnaz,0,0,20,20
1650007060214,ECE 100,A02,091916,Baghdadchi; Saharnaz,13,0,20,7
1650007066243,ECE 101,A01,084053,Baghdadchi; Saharnaz,0,0,37,37
1650007066243,ECE 101,A02,084054,Baghdadchi; Saharnaz,30,0,37,7
1650007072269,ECE 107,A01,083390,Staff,26,0,40,14
1650007078297,ECE 148,A01,084056,Silberman; Jack,8,0,12,4
1650007084320,ECE 180,A00,083391,Abi Samra; Nicholas Camill,25,0,30,5
1650007084320,ECE 180,B00,083392,Abi Samra; Nicholas Camill,21,0,30,9
1650007090352,MATH 10B,A01,084110,Staff,0,0,30,30
1650007090352,MATH 10B,A02,084111,Staff,19,0,30,11
1650007090352,MATH 10B,A03,084112,Staff,24,0,30,6
1650007096383,MATH 10C,A01,083443,Staff,0,15,30,30
1650007096383,MATH 10C,A02,083444,Staff,0,14,30,30
1650007096383,MATH 10C,B01,084114,Staff,19,0,30,11
1650007096383,MATH 10C,B02,084115,Staff,25,0,30,5
1650007102407,MATH 18,A01,084117,Harel; Guershon,14,0,30,16
1650007102407,MATH 18,A02,084119,Harel; Guershon,28,0,30,2
1650007102407,MATH 18,A03,084120,Harel; Guershon,29,0,30,1
1650007102407,MATH 18,A04,084121,Harel; Guershon,29,0,30,1
1650007108523,MATH 20B,A01,084124,Um; Ko Woon,16,0,35,19
1650007108523,MATH 20B,B01,084126,Um; Ko Woon,24,0,35,11
1650007114556,MATH 20C,A01,083446,Hammock; Frances H,0,0,30,30
1650007114556,MATH 20C,A02,083447,Hammock; Frances H,16,0,30,14
1650007114556,MATH 20C,A03,083448,Hammock; Frances H,20,0,30,10
1650007114556,MATH 20C,A04,083449,Hammock; Frances H,20,0,30,10
1650007114556,MATH 20C,B01,083451,Hammock; Frances H,0,0,30,30
1650007114556,MATH 20C,B02,083452,Hammock; Frances H,19,0,30,11
1650007114556,MATH 20C,B03,083453,Hammock; Frances H,22,0,30,8
1650007114556,MATH 20C,B04,083454,Hammock; Frances H,24,0,30,6
1650007120580,MATH 20D,A01,084128,Staff,14,0,30,16
1650007120580,MATH 20D,A02,084129,Staff,29,0,30,1
1650007120580,MATH 20D,A03,084130,Staff,27,0,30,3
1650007120580,MATH 20D,B01,084133,Staff,3,0,30,27
1650007120580,MATH 20D,B02,084134,Staff,24,0,30,6
1650007120580,MATH 20D,B03,084135,Staff,28,0,30,2
1650007126618,MATH 20E,A01,084138,Staff,13,0,30,17
1650007126618,MATH 20E,A02,084139,Staff,7,0,30,23
1650007126618,MATH 20E,A03,084140,Staff,15,0,30,15
1650007126618,MATH 20E,A04,084141,Staff,20,0,30,10
1650007132642,MATH 102,A01,084143,Harel; Guershon,12,0,30,18
1650007132642,MATH 102,A02,084144,Harel; Guershon,20,0,30,10
1650007138671,MATH 103B,A01,083456,Staff,0,13,30,30
1650007138671,MATH 103B,A02,083457,Staff,0,12,30,30
1650007144703,MATH 109,A01,084146,Salehi Golsefidy; Alireza,18,0,30,12
1650007144703,MATH 109,A02,084147,Salehi Golsefidy; Alireza,16,0,30,14
1650007150728,MATH 120A,A01,085445,Eggers; John Dietrich,10,0,35,25
1650007150728,MATH 120A,A02,085446,Eggers; John Dietrich,27,0,35,8
1650007156755,MATH 142B,A01,084149,Verstraete; Jacques Allan,0,12,30,30
1650007156755,MATH 142B,A02,084150,Verstraete; Jacques Allan,0,12,30,30
1650007162779,MATH 170A,A01,083459,Nie; Jiawang,0,9,30,30
1650007162779,MATH 170A,A02,083460,Nie; Jiawang,0,8,30,30
1650007162779,MATH 170A,A03,083461,Nie; Jiawang,0,9,30,30
1650007168803,MATH 193B,A01,083463,Staff,1,0,30,29
1650007168803,MATH 193B,A02,083464,Staff,9,0,30,21
1650007168803,MATH 193B,A03,083465,Staff,18,0,30,12
1650007174853,COGS 2,A01,083966,Boyle; Mary E. T.,9,0,30,21
1650007180877,COGS 9,A01,083968,Staff,9,0,60,51
1650007186902,COGS 14B,A01,083970,Staff,10,0,50,40
1650007192928,COGS 17,A01,092679,Staff,51,0,75,24
1650007198963,COGS 100,A01,083972,Staff,0,15,60,60
1650007211016,COGS 101C,A01,083976,Staff,12,0,30,18
1650007217038,COGS 102A,A01,083978,Johnson; Christine M.,14,0,30,16
1650007223065,COGS 107B,A01,083980,Staff,0,7,50,50
1650007229089,COGS 115,A01,083982,Staff,10,0,30,20
1650007235114,COGS 118B,A01,083367,Staff,0,15,40,40
1650007241143,COGS 172,A01,083984,Provenzano; Emily Kara,15,0,30,15
1650007247169,COGS 177,A00,083368,Staff,0,20,30,30
1650007253206,COGS 186,A01,083986,Staff,21,0,40,19
1650007259229,COGS 187A,A01,083988,Boyle; Mary E. T.,20,0,60,40
1650007265256,CSE 8A,A50,084003,Miranda; Gregory Joseph,0,13,15,15
1650007271279,CSE 11,A01,084005,Miranda; Gregory Joseph,0,20,55,55
1650007277302,CSE 20,A01,084007,Staff,0,5,20,20
1650007283325,CSE 21,A01,084009,Staff,0,30,50,50
1650007289348,CSE 30,A01,083370,Cao; Yingjun,0,65,40,40
1650007295388,CSE 100,A01,083372,Cao; Yingjun,0,46,40,40
1650007301411,CSE 101,A01,084011,Staff,0,53,40,40
1650007307435,CSE 141,A01,083374,Eldon; John,0,64,75,75
1650007313471,CSE 141L,A01,083376,Eldon; John,0,70,75,75
1650007319497,CSE 175,A01,084013,Kumar; Rakesh,22,0,25,3
1650007325524,CSE 190,A00,092508,Dubnov; Shlomo,20,0,20,0
1650007331550,ECE 5,A01,084049,Morris; Karcher William,13,0,20,7
1650007337579,ECE 100,A01,084051,Baghdadchi; Saharnaz,0,0,20,20
1650007337579,ECE 100,A02,091916,Baghdadchi; Saharnaz,13,0,20,7
1650007343603,ECE 101,A01,084053,Baghdadchi; Saharnaz,0,0,37,37
1650007343603,ECE 101,A02,084054,Baghdadchi; Saharnaz,30,0,37,7
1650007349631,ECE 107,A01,083390,Staff,26,0,40,14
1650007355656,ECE 148,A01,084056,Silberman; Jack,8,0,12,4
1650007361681,ECE 180,A00,083391,Abi Samra; Nicholas Camill,25,0,30,5
1650007361681,ECE 180,B00,083392,Abi Samra; Nicholas Camill,21,0,30,9
1650007367709,MATH 10B,A01,084110,Staff,0,0,30,30
1650007367709,MATH 10B,A02,084111,Staff,19,0,30,11
1650007367709,MATH 10B,A03,084112,Staff,24,0,30,6
1650007373736,MATH 10C,A01,083443,Staff,0,15,30,30
1650007373736,MATH 10C,A02,083444,Staff,0,14,30,30
1650007373736,MATH 10C,B01,084114,Staff,19,0,30,11
1650007373736,MATH 10C,B02,084115,Staff,25,0,30,5
1650007379767,MATH 18,A01,084117,Harel; Guershon,14,0,30,16
1650007379767,MATH 18,A02,084119,Harel; Guershon,28,0,30,2
1650007379767,MATH 18,A03,084120,Harel; Guershon,29,0,30,1
1650007379767,MATH 18,A04,084121,Harel; Guershon,29,0,30,1
1650007385800,MATH 20B,A01,084124,Um; Ko Woon,16,0,35,19
1650007385800,MATH 20B,B01,084126,Um; Ko Woon,24,0,35,11
1650007391831,MATH 20C,A01,083446,Hammock; Frances H,0,0,30,30
1650007391831,MATH 20C,A02,083447,Hammock; Frances H,16,0,30,14
1650007391831,MATH 20C,A03,083448,Hammock; Frances H,20,0,30,10
1650007391831,MATH 20C,A04,083449,Hammock; Frances H,20,0,30,10
1650007391831,MATH 20C,B01,083451,Hammock; Frances H,0,0,30,30
1650007391831,MATH 20C,B02,083452,Hammock; Frances H,19,0,30,11
1650007391831,MATH 20C,B03,083453,Hammock; Frances H,22,0,30,8
1650007391831,MATH 20C,B04,083454,Hammock; Frances H,24,0,30,6
1650007397857,MATH 20D,A01,084128,Staff,14,0,30,16
1650007397857,MATH 20D,A02,084129,Staff,29,0,30,1
1650007397857,MATH 20D,A03,084130,Staff,27,0,30,3
1650007397857,MATH 20D,B01,084133,Staff,3,0,30,27
1650007397857,MATH 20D,B02,084134,Staff,24,0,30,6
1650007397857,MATH 20D,B03,084135,Staff,28,0,30,2
1650007403894,MATH 20E,A01,084138,Staff,13,0,30,17
1650007403894,MATH 20E,A02,084139,Staff,7,0,30,23
1650007403894,MATH 20E,A03,084140,Staff,15,0,30,15
1650007403894,MATH 20E,A04,084141,Staff,20,0,30,10
1650007409918,MATH 102,A01,084143,Harel; Guershon,12,0,30,18
1650007409918,MATH 102,A02,084144,Harel; Guershon,20,0,30,10
1650007415943,MATH 103B,A01,083456,Staff,0,13,30,30
1650007415943,MATH 103B,A02,083457,Staff,0,12,30,30
1650007421968,MATH 109,A01,084146,Salehi Golsefidy; Alireza,18,0,30,12
1650007421968,MATH 109,A02,084147,Salehi Golsefidy; Alireza,16,0,30,14
1650007427993,MATH 120A,A01,085445,Eggers; John Dietrich,10,0,35,25
1650007427993,MATH 120A,A02,085446,Eggers; John Dietrich,27,0,35,8
1650007434021,MATH 142B,A01,084149,Verstraete; Jacques Allan,0,12,30,30
1650007434021,MATH 142B,A02,084150,Verstraete; Jacques Allan,0,12,30,30
1650007440046,MATH 170A,A01,083459,Nie; Jiawang,0,9,30,30
1650007440046,MATH 170A,A02,083460,Nie; Jiawang,0,8,30,30
1650007440046,MATH 170A,A03,083461,Nie; Jiawang,0,9,30,30
1650007446075,MATH 193B,A01,083463,Staff,1,0,30,29
1650007446075,MATH 193B,A02,083464,Staff,9,0,30,21
1650007446075,MATH 193B,A03,083465,Staff,18,0,30,12
1650007452141,COGS 2,A01,083966,Boyle; Mary E. T.,9,0,30,21
1650007458168,COGS 9,A01,083968,Staff,9,0,60,51
1650007464194,COGS 14B,A01,083970,Staff,10,0,50,40
1650007470221,COGS 17,A01,092679,Staff,51,0,75,24
1650007476243,COGS 100,A01,083972,Staff,0,15,60,60
1650007488295,COGS 101C,A01,083976,Staff,12,0,30,18
1650007494323,COGS 102A,A01,083978,Johnson; Christine M.,14,0,30,16
1650007500349,COGS 107B,A01,083980,Staff,0,7,50,50
1650007506372,COGS 115,A01,083982,Staff,10,0,30,20
1650007512395,COGS 118B,A01,083367,Staff,0,15,40,40
1650007518422,COGS 172,A01,083984,Provenzano; Emily Kara,15,0,30,15
1650007524455,COGS 177,A00,083368,Staff,0,20,30,30
1650007530493,COGS 186,A01,083986,Staff,21,0,40,19
1650007536519,COGS 187A,A01,083988,Boyle; Mary E. T.,20,0,60,40
1650007542547,CSE 8A,A50,084003,Miranda; Gregory Joseph,0,13,15,15
1650007548570,CSE 11,A01,084005,Miranda; Gregory Joseph,0,20,55,55
1650007554597,CSE 20,A01,084007,Staff,0,5,20,20
1650007560621,CSE 21,A01,084009,Staff,0,30,50,50
1650007566649,CSE 30,A01,083370,Cao; Yingjun,0,65,40,40
1650007572676,CSE 100,A01,083372,Cao; Yingjun,0,46,40,40
1650007578701,CSE 101,A01,084011,Staff,0,53,40,40
1650007584729,CSE 141,A01,083374,Eldon; John,0,64,75,75
1650007590757,CSE 141L,A01,083376,Eldon; John,0,70,75,75
1650007596784,CSE 175,A01,084013,Kumar; Rakesh,22,0,25,3
1650007602815,CSE 190,A00,092508,Dubnov; Shlomo,20,0,20,0
1650007608844,ECE 5,A01,084049,Morris; Karcher William,13,0,20,7
1650007614868,ECE 100,A01,084051,Baghdadchi; Saharnaz,0,0,20,20
1650007614868,ECE 100,A02,091916,Baghdadchi; Saharnaz,13,0,20,7
1650007620891,ECE 101,A01,084053,Baghdadchi; Saharnaz,0,0,37,37
1650007620891,ECE 101,A02,084054,Baghdadchi; Saharnaz,30,0,37,7
1650007626924,ECE 107,A01,083390,Staff,26,0,40,14
1650007632949,ECE 148,A01,084056,Silberman; Jack,8,0,12,4
1650007638972,ECE 180,A00,083391,Abi Samra; Nicholas Camill,25,0,30,5
1650007638972,ECE 180,B00,083392,Abi Samra; Nicholas Camill,21,0,30,9
1650007645009,MATH 10B,A01,084110,Staff,0,0,30,30
1650007645009,MATH 10B,A02,084111,Staff,18,0,30,12
1650007645009,MATH 10B,A03,084112,Staff,24,0,30,6
1650007651036,MATH 10C,A01,083443,Staff,0,15,30,30
1650007651036,MATH 10C,A02,083444,Staff,0,14,30,30
1650007651036,MATH 10C,B01,084114,Staff,19,0,30,11
1650007651036,MATH 10C,B02,084115,Staff,25,0,30,5
1650007657060,MATH 18,A01,084117,Harel; Guershon,14,0,30,16
1650007657060,MATH 18,A02,084119,Harel; Guershon,28,0,30,2
1650007657060,MATH 18,A03,084120,Harel; Guershon,29,0,30,1
1650007657060,MATH 18,A04,084121,Harel; Guershon,29,0,30,1
1650007663086,MATH 20B,A01,084124,Um; Ko Woon,16,0,35,19
1650007663086,MATH 20B,B01,084126,Um; Ko Woon,24,0,35,11
1650007669111,MATH 20C,A01,083446,Hammock; Frances H,0,0,30,30
1650007669111,MATH 20C,A02,083447,Hammock; Frances H,16,0,30,14
1650007669111,MATH 20C,A03,083448,Hammock; Frances H,20,0,30,10
1650007669111,MATH 20C,A04,083449,Hammock; Frances H,20,0,30,10
1650007669111,MATH 20C,B01,083451,Hammock; Frances H,0,0,30,30
1650007669111,MATH 20C,B02,083452,Hammock; Frances H,19,0,30,11
1650007669111,MATH 20C,B03,083453,Hammock; Frances H,22,0,30,8
1650007669111,MATH 20C,B04,083454,Hammock; Frances H,24,0,30,6
1650007675141,MATH 20D,A01,084128,Staff,14,0,30,16
1650007675141,MATH 20D,A02,084129,Staff,29,0,30,1
1650007675141,MATH 20D,A03,084130,Staff,27,0,30,3
1650007675141,MATH 20D,B01,084133,Staff,3,0,30,27
1650007675141,MATH 20D,B02,084134,Staff,24,0,30,6
1650007675141,MATH 20D,B03,084135,Staff,28,0,30,2
1650007681168,MATH 20E,A01,084138,Staff,13,0,30,17
1650007681168,MATH 20E,A02,084139,Staff,7,0,30,23
1650007681168,MATH 20E,A03,084140,Staff,15,0,30,15
1650007681168,MATH 20E,A04,084141,Staff,20,0,30,10
1650007687192,MATH 102,A01,084143,Harel; Guershon,12,0,30,18
1650007687192,MATH 102,A02,084144,Harel; Guershon,20,0,30,10
1650007693216,MATH 103B,A01,083456,Staff,0,13,30,30
1650007693216,MATH 103B,A02,083457,Staff,0,13,30,30
1650007699241,MATH 109,A01,084146,Salehi Golsefidy; Alireza,18,0,30,12
1650007699241,MATH 109,A02,084147,Salehi Golsefidy; Alireza,15,0,30,15
1650007705335,MATH 120A,A01,085445,Eggers; John Dietrich,10,0,35,25
1650007705335,MATH 120A,A02,085446,Eggers; John Dietrich,27,0,35,8
1650007711360,MATH 142B,A01,084149,Verstraete; Jacques Allan,0,12,30,30
1650007711360,MATH 142B,A02,084150,Verstraete; Jacques Allan,0,12,30,30
1650007717388,MATH 170A,A01,083459,Nie; Jiawang,0,9,30,30
1650007717388,MATH 170A,A02,083460,Nie; Jiawang,0,8,30,30
1650007717388,MATH 170A,A03,083461,Nie; Jiawang,0,9,30,30
1650007723416,MATH 193B,A01,083463,Staff,1,0,30,29
1650007723416,MATH 193B,A02,083464,Staff,9,0,30,21
1650007723416,MATH 193B,A03,083465,Staff,18,0,30,12
1650007729477,COGS 2,A01,083966,Boyle; Mary E. T.,9,0,30,21
1650007735500,COGS 9,A01,083968,Staff,9,0,60,51
1650007741526,COGS 14B,A01,083970,Staff,10,0,50,40
1650007747568,COGS 17,A01,092679,Staff,51,0,75,24
1650007753593,COGS 100,A01,083972,Staff,0,15,60,60
1650007765647,COGS 101C,A01,083976,Staff,12,0,30,18
1650007771672,COGS 102A,A01,083978,Johnson; Christine M.,14,0,30,16
1650007777700,COGS 107B,A01,083980,Staff,0,7,50,50
1650007783725,COGS 115,A01,083982,Staff,10,0,30,20
1650007789749,COGS 118B,A01,083367,Staff,0,15,40,40
1650007795776,COGS 172,A01,083984,Provenzano; Emily Kara,15,0,30,15
1650007801805,COGS 177,A00,083368,Staff,0,20,30,30
1650007807833,COGS 186,A01,083986,Staff,21,0,40,19
1650007813861,COGS 187A,A01,083988,Boyle; Mary E. T.,20,0,60,40
1650007819889,CSE 8A,A50,084003,Miranda; Gregory Joseph,0,13,15,15
1650007825914,CSE 11,A01,084005,Miranda; Gregory Joseph,0,20,55,55
1650007831939,CSE 20,A01,084007,Staff,0,5,20,20
1650007837985,CSE 21,A01,084009,Staff,0,30,50,50
1650007844027,CSE 30,A01,083370,Cao; Yingjun,0,65,40,40
1650007850050,CSE 100,A01,083372,Cao; Yingjun,0,46,40,40
1650007856076,CSE 101,A01,084011,Staff,0,54,40,40
1650007862102,CSE 141,A01,083374,Eldon; John,0,64,75,75
1650007868131,CSE 141L,A01,083376,Eldon; John,0,70,75,75
1650007874159,CSE 175,A01,084013,Kumar; Rakesh,22,0,25,3
1650007880181,CSE 190,A00,092508,Dubnov; Shlomo,20,0,20,0
1650007886210,ECE 5,A01,084049,Morris; Karcher William,13,0,20,7
1650007892234,ECE 100,A01,084051,Baghdadchi; Saharnaz,0,0,20,20
1650007892234,ECE 100,A02,091916,Baghdadchi; Saharnaz,13,0,20,7
1650007898259,ECE 101,A01,084053,Baghdadchi; Saharnaz,0,0,37,37
1650007898259,ECE 101,A02,084054,Baghdadchi; Saharnaz,30,0,37,7
1650007904286,ECE 107,A01,083390,Staff,26,0,40,14
1650007910309,ECE 148,A01,084056,Silberman; Jack,8,0,12,4
1650007916332,ECE 180,A00,083391,Abi Samra; Nicholas Camill,25,0,30,5
1650007916332,ECE 180,B00,083392,Abi Samra; Nicholas Camill,21,0,30,9
1650007922361,MATH 10B,A01,084110,Staff,0,0,30,30
1650007922361,MATH 10B,A02,084111,Staff,18,0,30,12
1650007922361,MATH 10B,A03,084112,Staff,24,0,30,6
1650007928385,MATH 10C,A01,083443,Staff,0,15,30,30
1650007928385,MATH 10C,A02,083444,Staff,0,14,30,30
1650007928385,MATH 10C,B01,084114,Staff,19,0,30,11
1650007928385,MATH 10C,B02,084115,Staff,25,0,30,5
1650007934414,MATH 18,A01,084117,Harel; Guershon,14,0,30,16
1650007934414,MATH 18,A02,084119,Harel; Guershon,28,0,30,2
1650007934414,MATH 18,A03,084120,Harel; Guershon,29,0,30,1
1650007934414,MATH 18,A04,084121,Harel; Guershon,29,0,30,1
1650007940440,MATH 20B,A01,084124,Um; Ko Woon,16,0,35,19
1650007940440,MATH 20B,B01,084126,Um; Ko Woon,24,0,35,11
1650007946470,MATH 20C,A01,083446,Hammock; Frances H,0,0,30,30
1650007946470,MATH 20C,A02,083447,Hammock; Frances H,16,0,30,14
1650007946470,MATH 20C,A03,083448,Hammock; Frances H,20,0,30,10
1650007946470,MATH 20C,A04,083449,Hammock; Frances H,20,0,30,10
1650007946470,MATH 20C,B01,083451,Hammock; Frances H,0,0,30,30
1650007946470,MATH 20C,B02,083452,Hammock; Frances H,19,0,30,11
1650007946470,MATH 20C,B03,083453,Hammock; Frances H,22,0,30,8
1650007946470,MATH 20C,B04,083454,Hammock; Frances H,24,0,30,6
1650007952498,MATH 20D,A01,084128,Staff,14,0,30,16
1650007952498,MATH 20D,A02,084129,Staff,29,0,30,1
1650007952498,MATH 20D,A03,084130,Staff,27,0,30,3
1650007952498,MATH 20D,B01,084133,Staff,3,0,30,27
1650007952498,MATH 20D,B02,084134,Staff,24,0,30,6
1650007952498,MATH 20D,B03,084135,Staff,28,0,30,2
1650007958521,MATH 20E,A01,084138,Staff,13,0,30,17
1650007958521,MATH 20E,A02,084139,Staff,7,0,30,23
1650007958521,MATH 20E,A03,084140,Staff,15,0,30,15
1650007958521,MATH 20E,A04,084141,Staff,20,0,30,10
1650007964548,MATH 102,A01,084143,Harel; Guershon,12,0,30,18
1650007964548,MATH 102,A02,084144,Harel; Guershon,20,0,30,10
1650007970576,MATH 103B,A01,083456,Staff,0,13,30,30
1650007970576,MATH 103B,A02,083457,Staff,0,13,30,30
1650007976601,MATH 109,A01,084146,Salehi Golsefidy; Alireza,18,0,30,12
1650007976601,MATH 109,A02,084147,Salehi Golsefidy; Alireza,15,0,30,15
1650007982625,MATH 120A,A01,085445,Eggers; John Dietrich,10,0,35,25
1650007982625,MATH 120A,A02,085446,Eggers; John Dietrich,27,0,35,8
1650007988660,MATH 142B,A01,084149,Verstraete; Jacques Allan,0,12,30,30
1650007988660,MATH 142B,A02,084150,Verstraete; Jacques Allan,0,12,30,30
1650007994689,MATH 170A,A01,083459,Nie; Jiawang,0,9,30,30
1650007994689,MATH 170A,A02,083460,Nie; Jiawang,0,8,30,30
1650007994689,MATH 170A,A03,083461,Nie; Jiawang,0,9,30,30
1650008000718,MATH 193B,A01,083463,Staff,1,0,30,29
1650008000718,MATH 193B,A02,083464,Staff,9,0,30,21
1650008000718,MATH 193B,A03,083465,Staff,18,0,30,12
1650008006790,COGS 2,A01,083966,Boyle; Mary E. T.,9,0,30,21
1650008012816,COGS 9,A01,083968,Staff,9,0,60,51
1650008018839,COGS 14B,A01,083970,Staff,10,0,50,40
1650008024864,COGS 17,A01,092679,Staff,51,0,75,24
1650008030887,COGS 100,A01,083972,Staff,0,15,60,60
1650008042945,COGS 101C,A01,083976,Staff,12,0,30,18
1650008048983,COGS 102A,A01,083978,Johnson; Christine M.,14,0,30,16
1650008055012,COGS 107B,A01,083980,Staff,0,7,50,50
1650008061038,COGS 115,A01,083982,Staff,10,0,30,20
1650008067064,COGS 118B,A01,083367,Staff,0,15,40,40
1650008073102,COGS 172,A01,083984,Provenzano; Emily Kara,15,0,30,15
1650008079129,COGS 177,A00,083368,Staff,0,20,30,30
1650008085154,COGS 186,A01,083986,Staff,21,0,40,19
1650008091178,COGS 187A,A01,083988,Boyle; Mary E. T.,20,0,60,40
1650008097209,CSE 8A,A50,084003,Miranda; Gregory Joseph,0,13,15,15
1650008103241,CSE 11,A01,084005,Miranda; Gregory Joseph,0,20,55,55
1650008109267,CSE 20,A01,084007,Staff,0,5,20,20
1650008115293,CSE 21,A01,084009,Staff,0,30,50,50
1650008121320,CSE 30,A01,083370,Cao; Yingjun,0,65,40,40
1650008127344,CSE 100,A01,083372,Cao; Yingjun,0,46,40,40
1650008133367,CSE 101,A01,084011,Staff,0,54,40,40
1650008139405,CSE 141,A01,083374,Eldon; John,0,64,75,75
1650008145440,CSE 141L,A01,083376,Eldon; John,0,70,75,75
1650008151469,CSE 175,A01,084013,Kumar; Rakesh,22,0,25,3
1650008157507,CSE 190,A00,092508,Dubnov; Shlomo,20,0,20,0
1650008163538,ECE 5,A01,084049,Morris; Karcher William,13,0,20,7
1650008169577,ECE 100,A01,084051,Baghdadchi; Saharnaz,0,0,20,20
1650008169577,ECE 100,A02,091916,Baghdadchi; Saharnaz,13,0,20,7
1650008175602,ECE 101,A01,084053,Baghdadchi; Saharnaz,0,0,37,37
1650008175602,ECE 101,A02,084054,Baghdadchi; Saharnaz,30,0,37,7
1650008181638,ECE 107,A01,083390,Staff,26,0,40,14
1650008187691,ECE 148,A01,084056,Silberman; Jack,8,0,12,4
1650008193726,ECE 180,A00,083391,Abi Samra; Nicholas Camill,25,0,30,5
1650008193726,ECE 180,B00,083392,Abi Samra; Nicholas Camill,21,0,30,9
1650008199751,MATH 10B,A01,084110,Staff,0,0,30,30
1650008199751,MATH 10B,A02,084111,Staff,18,0,30,12
1650008199751,MATH 10B,A03,084112,Staff,24,0,30,6
1650008205779,MATH 10C,A01,083443,Staff,0,15,30,30
1650008205779,MATH 10C,A02,083444,Staff,0,14,30,30
1650008205779,MATH 10C,B01,084114,Staff,19,0,30,11
1650008205779,MATH 10C,B02,084115,Staff,25,0,30,5
1650008211809,MATH 18,A01,084117,Harel; Guershon,14,0,30,16
1650008211809,MATH 18,A02,084119,Harel; Guershon,28,0,30,2
1650008211809,MATH 18,A03,084120,Harel; Guershon,29,0,30,1
1650008211809,MATH 18,A04,084121,Harel; Guershon,29,0,30,1
1650008217835,MATH 20B,A01,084124,Um; Ko Woon,16,0,35,19
1650008217835,MATH 20B,B01,084126,Um; Ko Woon,24,0,35,11
1650008223861,MATH 20C,A01,083446,Hammock; Frances H,0,0,30,30
1650008223861,MATH 20C,A02,083447,Hammock; Frances H,16,0,30,14
1650008223861,MATH 20C,A03,083448,Hammock; Frances H,20,0,30,10
1650008223861,MATH 20C,A04,083449,Hammock; Frances H,20,0,30,10
1650008223861,MATH 20C,B01,083451,Hammock; Frances H,0,0,30,30
1650008223861,MATH 20C,B02,083452,Hammock; Frances H,19,0,30,11
1650008223861,MATH 20C,B03,083453,Hammock; Frances H,22,0,30,8
1650008223861,MATH 20C,B04,083454,Hammock; Frances H,24,0,30,6
1650008229887,MATH 20D,A01,084128,Staff,14,0,30,16
1650008229887,MATH 20D,A02,084129,Staff,29,0,30,1
1650008229887,MATH 20D,A03,084130,Staff,27,0,30,3
1650008229887,MATH 20D,B01,084133,Staff,3,0,30,27
1650008229887,MATH 20D,B02,084134,Staff,24,0,30,6
1650008229887,MATH 20D,B03,084135,Staff,28,0,30,2
1650008235915,MATH 20E,A01,084138,Staff,13,0,30,17
1650008235915,MATH 20E,A02,084139,Staff,7,0,30,23
1650008235915,MATH 20E,A03,084140,Staff,15,0,30,15
1650008235915,MATH 20E,A04,084141,Staff,20,0,30,10
1650008241944,MATH 102,A01,084143,Harel; Guershon,12,0,30,18
1650008241944,MATH 102,A02,084144,Harel; Guershon,20,0,30,10
1650008247977,MATH 103B,A01,083456,Staff,0,13,30,30
1650008247977,MATH 103B,A02,083457,Staff,0,13,30,30
1650008254003,MATH 109,A01,084146,Salehi Golsefidy; Alireza,18,0,30,12
1650008254003,MATH 109,A02,084147,Salehi Golsefidy; Alireza,15,0,30,15
1650008260027,MATH 120A,A01,085445,Eggers; John Dietrich,10,0,35,25
1650008260027,MATH 120A,A02,085446,Eggers; John Dietrich,27,0,35,8
1650008266051,MATH 142B,A01,084149,Verstraete; Jacques Allan,0,12,30,30
1650008266051,MATH 142B,A02,084150,Verstraete; Jacques Allan,0,12,30,30
1650008272077,MATH 170A,A01,083459,Nie; Jiawang,0,9,30,30
1650008272077,MATH 170A,A02,083460,Nie; Jiawang,0,8,30,30
1650008272077,MATH 170A,A03,083461,Nie; Jiawang,0,9,30,30
1650008278107,MATH 193B,A01,083463,Staff,1,0,30,29
1650008278107,MATH 193B,A02,083464,Staff,9,0,30,21
1650008278107,MATH 193B,A03,083465,Staff,18,0,30,12
1650008284182,COGS 2,A01,083966,Boyle; Mary E. T.,9,0,30,21
1650008290211,COGS 9,A01,083968,Staff,9,0,60,51
1650008296345,COGS 14B,A01,083970,Staff,10,0,50,40
1650008302369,COGS 17,A01,092679,Staff,51,0,75,24
1650008308393,COGS 100,A01,083972,Staff,0,15,60,60
1650008320451,COGS 101C,A01,083976,Staff,12,0,30,18
1650008326475,COGS 102A,A01,083978,Johnson; Christine M.,14,0,30,16
1650008332502,COGS 107B,A01,083980,Staff,0,7,50,50
1650008338531,COGS 115,A01,083982,Staff,10,0,30,20
1650008344558,COGS 118B,A01,083367,Staff,0,15,40,40
1650008350587,COGS 172,A01,083984,Provenzano; Emily Kara,15,0,30,15
1650008356616,COGS 177,A00,083368,Staff,0,20,30,30
1650008362650,COGS 186,A01,083986,Staff,21,0,40,19
1650008368678,COGS 187A,A01,083988,Boyle; Mary E. T.,20,0,60,40
1650008374707,CSE 8A,A50,084003,Miranda; Gregory Joseph,0,13,15,15
1650008380746,CSE 11,A01,084005,Miranda; Gregory Joseph,0,20,55,55
1650008386773,CSE 20,A01,084007,Staff,0,5,20,20
1650008392798,CSE 21,A01,084009,Staff,0,30,50,50
1650008398835,CSE 30,A01,083370,Cao; Yingjun,0,65,40,40
1650008404859,CSE 100,A01,083372,Cao; Yingjun,0,46,40,40
1650008410891,CSE 101,A01,084011,Staff,0,54,40,40
1650008416917,CSE 141,A01,083374,Eldon; John,0,64,75,75
1650008422942,CSE 141L,A01,083376,Eldon; John,0,70,75,75
1650008428972,CSE 175,A01,084013,Kumar; Rakesh,22,0,25,3
1650008435003,CSE 190,A00,092508,Dubnov; Shlomo,20,0,20,0
1650008441040,ECE 5,A01,084049,Morris; Karcher William,13,0,20,7
1650008447082,ECE 100,A01,084051,Baghdadchi; Saharnaz,0,0,20,20
1650008447082,ECE 100,A02,091916,Baghdadchi; Saharnaz,13,0,20,7
1650008453125,ECE 101,A01,084053,Baghdadchi; Saharnaz,0,0,37,37
1650008453125,ECE 101,A02,084054,Baghdadchi; Saharnaz,30,0,37,7
1650008459151,ECE 107,A01,083390,Staff,26,0,40,14
1650008465176,ECE 148,A01,084056,Silberman; Jack,8,0,12,4
1650008471206,ECE 180,A00,083391,Abi Samra; Nicholas Camill,25,0,30,5
1650008471206,ECE 180,B00,083392,Abi Samra; Nicholas Camill,21,0,30,9
1650008477238,MATH 10B,A01,084110,Staff,0,0,30,30
1650008477238,MATH 10B,A02,084111,Staff,18,0,30,12
1650008477238,MATH 10B,A03,084112,Staff,24,0,30,6
1650008483266,MATH 10C,A01,083443,Staff,0,15,30,30
1650008483266,MATH 10C,A02,083444,Staff,0,15,30,30
1650008483266,MATH 10C,B01,084114,Staff,19,0,30,11
1650008483266,MATH 10C,B02,084115,Staff,25,0,30,5
1650008489291,MATH 18,A01,084117,Harel; Guershon,14,0,30,16
1650008489291,MATH 18,A02,084119,Harel; Guershon,28,0,30,2
1650008489291,MATH 18,A03,084120,Harel; Guershon,29,0,30,1
1650008489291,MATH 18,A04,084121,Harel; Guershon,29,0,30,1
1650008495318,MATH 20B,A01,084124,Um; Ko Woon,16,0,35,19
1650008495318,MATH 20B,B01,084126,Um; Ko Woon,24,0,35,11
1650008501351,MATH 20C,A01,083446,Hammock; Frances H,0,0,30,30
1650008501351,MATH 20C,A02,083447,Hammock; Frances H,16,0,30,14
1650008501351,MATH 20C,A03,083448,Hammock; Frances H,20,0,30,10
1650008501351,MATH 20C,A04,083449,Hammock; Frances H,20,0,30,10
1650008501351,MATH 20C,B01,083451,Hammock; Frances H,0,0,30,30
1650008501351,MATH 20C,B02,083452,Hammock; Frances H,19,0,30,11
1650008501351,MATH 20C,B03,083453,Hammock; Frances H,22,0,30,8
1650008501351,MATH 20C,B04,083454,Hammock; Frances H,24,0,30,6
1650008507383,MATH 20D,A01,084128,Staff,14,0,30,16
1650008507383,MATH 20D,A02,084129,Staff,29,0,30,1
1650008507383,MATH 20D,A03,084130,Staff,27,0,30,3
1650008507383,MATH 20D,B01,084133,Staff,3,0,30,27
1650008507383,MATH 20D,B02,084134,Staff,24,0,30,6
1650008507383,MATH 20D,B03,084135,Staff,28,0,30,2
1650008513405,MATH 20E,A01,084138,Staff,13,0,30,17
1650008513405,MATH 20E,A02,084139,Staff,7,0,30,23
1650008513405,MATH 20E,A03,084140,Staff,15,0,30,15
1650008513405,MATH 20E,A04,084141,Staff,20,0,30,10
1650008519430,MATH 102,A01,084143,Harel; Guershon,12,0,30,18
1650008519430,MATH 102,A02,084144,Harel; Guershon,20,0,30,10
1650008525466,MATH 103B,A01,083456,Staff,0,13,30,30
1650008525466,MATH 103B,A02,083457,Staff,0,13,30,30
1650008531492,MATH 109,A01,084146,Salehi Golsefidy; Alireza,18,0,30,12
1650008531492,MATH 109,A02,084147,Salehi Golsefidy; Alireza,15,0,30,15
1650008537516,MATH 120A,A01,085445,Eggers; John Dietrich,10,0,35,25
1650008537516,MATH 120A,A02,085446,Eggers; John Dietrich,27,0,35,8
1650008543541,MATH 142B,A01,084149,Verstraete; Jacques Allan,0,12,30,30
1650008543541,MATH 142B,A02,084150,Verstraete; Jacques Allan,0,12,30,30
1650008549571,MATH 170A,A01,083459,Nie; Jiawang,0,9,30,30
1650008549571,MATH 170A,A02,083460,Nie; Jiawang,0,8,30,30
1650008549571,MATH 170A,A03,083461,Nie; Jiawang,0,9,30,30
1650008555596,MATH 193B,A01,083463,Staff,1,0,30,29
1650008555596,MATH 193B,A02,083464,Staff,9,0,30,21
1650008555596,MATH 193B,A03,083465,Staff,18,0,30,12
1650008561655,COGS 2,A01,083966,Boyle; Mary E. T.,9,0,30,21
1650008567683,COGS 9,A01,083968,Staff,9,0,60,51
1650008573708,COGS 14B,A01,083970,Staff,10,0,50,40
1650008579735,COGS 17,A01,092679,Staff,51,0,75,24
1650008585764,COGS 100,A01,083972,Staff,0,15,60,60
1650008597829,COGS 101C,A01,083976,Staff,12,0,30,18
1650008603854,COGS 102A,A01,083978,Johnson; Christine M.,14,0,30,16
1650008609876,COGS 107B,A01,083980,Staff,0,7,50,50
1650008615906,COGS 115,A01,083982,Staff,10,0,30,20
1650008621932,COGS 118B,A01,083367,Staff,0,15,40,40
1650008627957,COGS 172,A01,083984,Provenzano; Emily Kara,15,0,30,15
1650008633980,COGS 177,A00,083368,Staff,0,20,30,30
1650008640021,COGS 186,A01,083986,Staff,21,0,40,19
1650008646052,COGS 187A,A01,083988,Boyle; Mary E. T.,20,0,60,40
1650008652084,CSE 8A,A50,084003,Miranda; Gregory Joseph,0,13,15,15
1650008658114,CSE 11,A01,084005,Miranda; Gregory Joseph,0,20,55,55
1650008664155,CSE 20,A01,084007,Staff,0,5,20,20
1650008670180,CSE 21,A01,084009,Staff,0,30,50,50
1650008676204,CSE 30,A01,083370,Cao; Yingjun,0,65,40,40
1650008682233,CSE 100,A01,083372,Cao; Yingjun,0,46,40,40
1650008688259,CSE 101,A01,084011,Staff,0,54,40,40
1650008694289,CSE 141,A01,083374,Eldon; John,0,64,75,75
1650008700318,CSE 141L,A01,083376,Eldon; John,0,70,75,75
1650008706344,CSE 175,A01,084013,Kumar; Rakesh,22,0,25,3
1650008712375,CSE 190,A00,092508,Dubnov; Shlomo,20,0,20,0
1650008718409,ECE 5,A01,084049,Morris; Karcher William,13,0,20,7
1650008724441,ECE 100,A01,084051,Baghdadchi; Saharnaz,0,0,20,20
1650008724441,ECE 100,A02,091916,Baghdadchi; Saharnaz,13,0,20,7
1650008730470,ECE 101,A01,084053,Baghdadchi; Saharnaz,0,0,37,37
1650008730470,ECE 101,A02,084054,Baghdadchi; Saharnaz,30,0,37,7
1650008736494,ECE 107,A01,083390,Staff,26,0,40,14
1650008742520,ECE 148,A01,084056,Silberman; Jack,8,0,12,4
1650008748550,ECE 180,A00,083391,Abi Samra; Nicholas Camill,25,0,30,5
1650008748550,ECE 180,B00,083392,Abi Samra; Nicholas Camill,21,0,30,9
1650008754576,MATH 10B,A01,084110,Staff,0,0,30,30
1650008754576,MATH 10B,A02,084111,Staff,18,0,30,12
1650008754576,MATH 10B,A03,084112,Staff,24,0,30,6
1650008760606,MATH 10C,A01,083443,Staff,0,15,30,30
1650008760606,MATH 10C,A02,083444,Staff,0,15,30,30
1650008760606,MATH 10C,B01,084114,Staff,19,0,30,11
1650008760606,MATH 10C,B02,084115,Staff,25,0,30,5
1650008766638,MATH 18,A01,084117,Harel; Guershon,14,0,30,16
1650008766638,MATH 18,A02,084119,Harel; Guershon,28,0,30,2
1650008766638,MATH 18,A03,084120,Harel; Guershon,29,0,30,1
1650008766638,MATH 18,A04,084121,Harel; Guershon,29,0,30,1
1650008772663,MATH 20B,A01,084124,Um; Ko Woon,16,0,35,19
1650008772663,MATH 20B,B01,084126,Um; Ko Woon,24,0,35,11
1650008778690,MATH 20C,A01,083446,Hammock; Frances H,0,0,30,30
1650008778690,MATH 20C,A02,083447,Hammock; Frances H,16,0,30,14
1650008778690,MATH 20C,A03,083448,Hammock; Frances H,20,0,30,10
1650008778690,MATH 20C,A04,083449,Hammock; Frances H,20,0,30,10
1650008778690,MATH 20C,B01,083451,Hammock; Frances H,0,0,30,30
1650008778690,MATH 20C,B02,083452,Hammock; Frances H,19,0,30,11
1650008778690,MATH 20C,B03,083453,Hammock; Frances H,22,0,30,8
1650008778690,MATH 20C,B04,083454,Hammock; Frances H,24,0,30,6
1650008784722,MATH 20D,A01,084128,Staff,14,0,30,16
1650008784722,MATH 20D,A02,084129,Staff,29,0,30,1
1650008784722,MATH 20D,A03,084130,Staff,27,0,30,3
1650008784722,MATH 20D,B01,084133,Staff,3,0,30,27
1650008784722,MATH 20D,B02,084134,Staff,24,0,30,6
1650008784722,MATH 20D,B03,084135,Staff,28,0,30,2
1650008790750,MATH 20E,A01,084138,Staff,13,0,30,17
1650008790750,MATH 20E,A02,084139,Staff,7,0,30,23
1650008790750,MATH 20E,A03,084140,Staff,15,0,30,15
1650008790750,MATH 20E,A04,084141,Staff,20,0,30,10
1650008796776,MATH 102,A01,084143,Harel; Guershon,12,0,30,18
1650008796776,MATH 102,A02,084144,Harel; Guershon,20,0,30,10
1650008802801,MATH 103B,A01,083456,Staff,0,13,30,30
1650008802801,MATH 103B,A02,083457,Staff,0,13,30,30
1650008808832,MATH 109,A01,084146,Salehi Golsefidy; Alireza,18,0,30,12
1650008808832,MATH 109,A02,084147,Salehi Golsefidy; Alireza,15,0,30,15
1650008814857,MATH 120A,A01,085445,Eggers; John Dietrich,10,0,35,25
1650008814857,MATH 120A,A02,085446,Eggers; John Dietrich,27,0,35,8
1650008820883,MATH 142B,A01,084149,Verstraete; Jacques Allan,0,12,30,30
1650008820883,MATH 142B,A02,084150,Verstraete; Jacques Allan,0,12,30,30
1650008826910,MATH 170A,A01,083459,Nie; Jiawang,0,9,30,30
1650008826910,MATH 170A,A02,083460,Nie; Jiawang,0,8,30,30
1650008826910,MATH 170A,A03,083461,Nie; Jiawang,0,9,30,30
1650008832939,MATH 193B,A01,083463,Staff,1,0,30,29
1650008832939,MATH 193B,A02,083464,Staff,9,0,30,21
1650008832939,MATH 193B,A03,083465,Staff,18,0,30,12
1650008839008,COGS 2,A01,083966,Boyle; Mary E. T.,9,0,30,21
1650008845034,COGS 9,A01,083968,Staff,9,0,60,51
1650008851065,COGS 14B,A01,083970,Staff,10,0,50,40
1650008857090,COGS 17,A01,092679,Staff,51,0,75,24
1650008863122,COGS 100,A01,083972,Staff,0,15,60,60
1650008875182,COGS 101C,A01,083976,Staff,12,0,30,18
1650008881207,COGS 102A,A01,083978,Johnson; Christine M.,14,0,30,16
1650008887234,COGS 107B,A01,083980,Staff,0,7,50,50
1650008893346,COGS 115,A01,083982,Staff,10,0,30,20
1650008899373,COGS 118B,A01,083367,Staff,0,15,40,40
1650008905400,COGS 172,A01,083984,Provenzano; Emily Kara,15,0,30,15
1650008911425,COGS 177,A00,083368,Staff,0,20,30,30
1650008917451,COGS 186,A01,083986,Staff,21,0,40,19
1650008923475,COGS 187A,A01,083988,Boyle; Mary E. T.,20,0,60,40
1650008929507,CSE 8A,A50,084003,Miranda; Gregory Joseph,0,13,15,15
1650008935531,CSE 11,A01,084005,Miranda; Gregory Joseph,0,20,55,55
1650008941556,CSE 20,A01,084007,Staff,0,5,20,20
1650008947581,CSE 21,A01,084009,Staff,0,30,50,50
1650008953605,CSE 30,A01,083370,Cao; Yingjun,0,65,40,40
1650008959628,CSE 100,A01,083372,Cao; Yingjun,0,46,40,40
1650008965658,CSE 101,A01,084011,Staff,0,54,40,40
1650008971703,CSE 141,A01,083374,Eldon; John,0,64,75,75
1650008977730,CSE 141L,A01,083376,Eldon; John,0,70,75,75
1650008983763,CSE 175,A01,084013,Kumar; Rakesh,22,0,25,3
1650008989798,CSE 190,A00,092508,Dubnov; Shlomo,20,0,20,0
1650008995831,ECE 5,A01,084049,Morris; Karcher William,13,0,20,7
1650009001859,ECE 100,A01,084051,Baghdadchi; Saharnaz,0,0,20,20
1650009001859,ECE 100,A02,091916,Baghdadchi; Saharnaz,13,0,20,7
1650009007884,ECE 101,A01,084053,Baghdadchi; Saharnaz,0,0,37,37
1650009007884,ECE 101,A02,084054,Baghdadchi; Saharnaz,30,0,37,7
1650009013908,ECE 107,A01,083390,Staff,26,0,40,14
1650009019940,ECE 148,A01,084056,Silberman; Jack,8,0,12,4
1650009025965,ECE 180,A00,083391,Abi Samra; Nicholas Camill,25,0,30,5
1650009025965,ECE 180,B00,083392,Abi Samra; Nicholas Camill,21,0,30,9
1650009031991,MATH 10B,A01,084110,Staff,0,0,30,30
1650009031991,MATH 10B,A02,084111,Staff,18,0,30,12
1650009031991,MATH 10B,A03,084112,Staff,24,0,30,6
1650009038016,MATH 10C,A01,083443,Staff,0,15,30,30
1650009038016,MATH 10C,A02,083444,Staff,0,15,30,30
1650009038016,MATH 10C,B01,084114,Staff,19,0,30,11
1650009038016,MATH 10C,B02,084115,Staff,25,0,30,5
1650009044042,MATH 18,A01,084117,Harel; Guershon,14,0,30,16
1650009044042,MATH 18,A02,084119,Harel; Guershon,28,0,30,2
1650009044042,MATH 18,A03,084120,Harel; Guershon,29,0,30,1
1650009044042,MATH 18,A04,084121,Harel; Guershon,29,0,30,1
1650009050073,MATH 20B,A01,084124,Um; Ko Woon,16,0,35,19
1650009050073,MATH 20B,B01,084126,Um; Ko Woon,24,0,35,11
1650009056104,MATH 20C,A01,083446,Hammock; Frances H,0,0,30,30
1650009056104,MATH 20C,A02,083447,Hammock; Frances H,16,0,30,14
1650009056104,MATH 20C,A03,083448,Hammock; Frances H,20,0,30,10
1650009056104,MATH 20C,A04,083449,Hammock; Frances H,20,0,30,10
1650009056104,MATH 20C,B01,083451,Hammock; Frances H,0,0,30,30
1650009056104,MATH 20C,B02,083452,Hammock; Frances H,19,0,30,11
1650009056104,MATH 20C,B03,083453,Hammock; Frances H,22,0,30,8
1650009056104,MATH 20C,B04,083454,Hammock; Frances H,24,0,30,6
1650009062133,MATH 20D,A01,084128,Staff,14,0,30,16
1650009062133,MATH 20D,A02,084129,Staff,29,0,30,1
1650009062133,MATH 20D,A03,084130,Staff,27,0,30,3
1650009062133,MATH 20D,B01,084133,Staff,3,0,30,27
1650009062133,MATH 20D,B02,084134,Staff,24,0,30,6
1650009062133,MATH 20D,B03,084135,Staff,28,0,30,2
1650009068162,MATH 20E,A01,084138,Staff,13,0,30,17
1650009068162,MATH 20E,A02,084139,Staff,6,0,30,24
1650009068162,MATH 20E,A03,084140,Staff,15,0,30,15
1650009068162,MATH 20E,A04,084141,Staff,20,0,30,10
1650009074190,MATH 102,A01,084143,Harel; Guershon,12,0,30,18
1650009074190,MATH 102,A02,084144,Harel; Guershon,20,0,30,10
1650009080217,MATH 103B,A01,083456,Staff,0,13,30,30
1650009080217,MATH 103B,A02,083457,Staff,0,13,30,30
1650009086247,MATH 109,A01,084146,Salehi Golsefidy; Alireza,18,0,30,12
1650009086247,MATH 109,A02,084147,Salehi Golsefidy; Alireza,15,0,30,15
1650009092271,MATH 120A,A01,085445,Eggers; John Dietrich,10,0,35,25
1650009092271,MATH 120A,A02,085446,Eggers; John Dietrich,27,0,35,8
1650009098297,MATH 142B,A01,084149,Verstraete; Jacques Allan,0,12,30,30
1650009098297,MATH 142B,A02,084150,Verstraete; Jacques Allan,0,12,30,30
1650009104347,MATH 170A,A01,083459,Nie; Jiawang,0,9,30,30
1650009104347,MATH 170A,A02,083460,Nie; Jiawang,0,8,30,30
1650009104347,MATH 170A,A03,083461,Nie; Jiawang,0,9,30,30
1650009110397,MATH 193B,A01,083463,Staff,1,0,30,29
1650009110397,MATH 193B,A02,083464,Staff,9,0,30,21
1650009110397,MATH 193B,A03,083465,Staff,18,0,30,12
1650009116478,COGS 2,A01,083966,Boyle; Mary E. T.,9,0,30,21
1650009122510,COGS 9,A01,083968,Staff,9,0,60,51
1650009128539,COGS 14B,A01,083970,Staff,10,0,50,40
1650009134570,COGS 17,A01,092679,Staff,51,0,75,24
1650009140594,COGS 100,A01,083972,Staff,0,15,60,60
1650009152644,COGS 101C,A01,083976,Staff,12,0,30,18
1650009158673,COGS 102A,A01,083978,Johnson; Christine M.,14,0,30,16
1650009164697,COGS 107B,A01,083980,Staff,0,7,50,50
1650009170727,COGS 115,A01,083982,Staff,10,0,30,20
1650009176751,COGS 118B,A01,083367,Staff,0,15,40,40
1650009182776,COGS 172,A01,083984,Provenzano; Emily Kara,15,0,30,15
1650009188802,COGS 177,A00,083368,Staff,0,20,30,30
1650009194825,COGS 186,A01,083986,Staff,21,0,40,19
1650009200862,COGS 187A,A01,083988,Boyle; Mary E. T.,20,0,60,40
1650009206891,CSE 8A,A50,084003,Miranda; Gregory Joseph,0,13,15,15
1650009212921,CSE 11,A01,084005,Miranda; Gregory Joseph,0,20,55,55
1650009218951,CSE 20,A01,084007,Staff,0,5,20,20
1650009224983,CSE 21,A01,084009,Staff,0,30,50,50
1650009231007,CSE 30,A01,083370,Cao; Yingjun,0,65,40,40
1650009237040,CSE 100,A01,083372,Cao; Yingjun,0,46,40,40
1650009243064,CSE 101,A01,084011,Staff,0,54,40,40
1650009249087,CSE 141,A01,083374,Eldon; John,0,64,75,75
1650009255116,CSE 141L,A01,083376,Eldon; John,0,70,75,75
1650009261140,CSE 175,A01,084013,Kumar; Rakesh,22,0,25,3
1650009267170,CSE 190,A00,092508,Dubnov; Shlomo,20,0,20,0
1650009273199,ECE 5,A01,084049,Morris; Karcher William,13,0,20,7
1650009279223,ECE 100,A01,084051,Baghdadchi; Saharnaz,0,0,20,20
1650009279223,ECE 100,A02,091916,Baghdadchi; Saharnaz,13,0,20,7
1650009285246,ECE 101,A01,084053,Baghdadchi; Saharnaz,0,0,37,37
1650009285246,ECE 101,A02,084054,Baghdadchi; Saharnaz,30,0,37,7
1650009291277,ECE 107,A01,083390,Staff,26,0,40,14
1650009297302,ECE 148,A01,084056,Silberman; Jack,8,0,12,4
1650009303328,ECE 180,A00,083391,Abi Samra; Nicholas Camill,25,0,30,5
1650009303328,ECE 180,B00,083392,Abi Samra; Nicholas Camill,21,0,30,9
1650009309356,MATH 10B,A01,084110,Staff,0,0,30,30
1650009309356,MATH 10B,A02,084111,Staff,18,0,30,12
1650009309356,MATH 10B,A03,084112,Staff,24,0,30,6
1650009315380,MATH 10C,A01,083443,Staff,0,15,30,30
1650009315380,MATH 10C,A02,083444,Staff,0,15,30,30
1650009315380,MATH 10C,B01,084114,Staff,19,0,30,11
1650009315380,MATH 10C,B02,084115,Staff,25,0,30,5
1650009321419,MATH 18,A01,084117,Harel; Guershon,14,0,30,16
1650009321419,MATH 18,A02,084119,Harel; Guershon,28,0,30,2
1650009321419,MATH 18,A03,084120,Harel; Guershon,29,0,30,1
1650009321419,MATH 18,A04,084121,Harel; Guershon,29,0,30,1
1650009327458,MATH 20B,A01,084124,Um; Ko Woon,16,0,35,19
1650009327458,MATH 20B,B01,084126,Um; Ko Woon,24,0,35,11
1650009333490,MATH 20C,A01,083446,Hammock; Frances H,0,0,30,30
1650009333490,MATH 20C,A02,083447,Hammock; Frances H,16,0,30,14
1650009333490,MATH 20C,A03,083448,Hammock; Frances H,20,0,30,10
1650009333490,MATH 20C,A04,083449,Hammock; Frances H,20,0,30,10
1650009333490,MATH 20C,B01,083451,Hammock; Frances H,0,0,30,30
1650009333490,MATH 20C,B02,083452,Hammock; Frances H,19,0,30,11
1650009333490,MATH 20C,B03,083453,Hammock; Frances H,22,0,30,8
1650009333490,MATH 20C,B04,083454,Hammock; Frances H,24,0,30,6
1650009339524,MATH 20D,A01,084128,Staff,14,0,30,16
1650009339524,MATH 20D,A02,084129,Staff,29,0,30,1
1650009339524,MATH 20D,A03,084130,Staff,27,0,30,3
1650009339524,MATH 20D,B01,084133,Staff,3,0,30,27
1650009339524,MATH 20D,B02,084134,Staff,24,0,30,6
1650009339524,MATH 20D,B03,084135,Staff,28,0,30,2
1650009345548,MATH 20E,A01,084138,Staff,13,0,30,17
1650009345548,MATH 20E,A02,084139,Staff,6,0,30,24
1650009345548,MATH 20E,A03,084140,Staff,15,0,30,15
1650009345548,MATH 20E,A04,084141,Staff,20,0,30,10
1650009351573,MATH 102,A01,084143,Harel; Guershon,12,0,30,18
1650009351573,MATH 102,A02,084144,Harel; Guershon,20,0,30,10
1650009357598,MATH 103B,A01,083456,Staff,0,13,30,30
1650009357598,MATH 103B,A02,083457,Staff,0,13,30,30
1650009363624,MATH 109,A01,084146,Salehi Golsefidy; Alireza,18,0,30,12
1650009363624,MATH 109,A02,084147,Salehi Golsefidy; Alireza,15,0,30,15
1650009369649,MATH 120A,A01,085445,Eggers; John Dietrich,10,0,35,25
1650009369649,MATH 120A,A02,085446,Eggers; John Dietrich,27,0,35,8
1650009375673,MATH 142B,A01,084149,Verstraete; Jacques Allan,0,12,30,30
1650009375673,MATH 142B,A02,084150,Verstraete; Jacques Allan,0,12,30,30
1650009381698,MATH 170A,A01,083459,Nie; Jiawang,0,9,30,30
1650009381698,MATH 170A,A02,083460,Nie; Jiawang,0,8,30,30
1650009381698,MATH 170A,A03,083461,Nie; Jiawang,0,9,30,30
1650009387724,MATH 193B,A01,083463,Staff,1,0,30,29
1650009387724,MATH 193B,A02,083464,Staff,9,0,30,21
1650009387724,MATH 193B,A03,083465,Staff,18,0,30,12
1650009393790,COGS 2,A01,083966,Boyle; Mary E. T.,9,0,30,21
1650009399814,COGS 9,A01,083968,Staff,9,0,60,51
1650009405851,COGS 14B,A01,083970,Staff,10,0,50,40
1650009411874,COGS 17,A01,092679,Staff,51,0,75,24
1650009417902,COGS 100,A01,083972,Staff,0,15,60,60
1650009429951,COGS 101C,A01,083976,Staff,12,0,30,18
1650009435979,COGS 102A,A01,083978,Johnson; Christine M.,14,0,30,16
1650009442007,COGS 107B,A01,083980,Staff,0,7,50,50
1650009448030,COGS 115,A01,083982,Staff,10,0,30,20
1650009454062,COGS 118B,A01,083367,Staff,0,15,40,40
1650009460089,COGS 172,A01,083984,Provenzano; Emily Kara,15,0,30,15
1650009466117,COGS 177,A00,083368,Staff,0,20,30,30
1650009472145,COGS 186,A01,083986,Staff,21,0,40,19
1650009478175,COGS 187A,A01,083988,Boyle; Mary E. T.,20,0,60,40
1650009484209,CSE 8A,A50,084003,Miranda; Gregory Joseph,0,13,15,15
1650009490322,CSE 11,A01,084005,Miranda; Gregory Joseph,0,21,55,55
1650009496354,CSE 20,A01,084007,Staff,0,5,20,20
1650009502379,CSE 21,A01,084009,Staff,0,30,50,50
1650009508408,CSE 30,A01,083370,Cao; Yingjun,0,65,40,40
1650009514435,CSE 100,A01,083372,Cao; Yingjun,0,46,40,40
1650009520465,CSE 101,A01,084011,Staff,0,54,40,40
1650009526496,CSE 141,A01,083374,Eldon; John,0,64,75,75
1650009532526,CSE 141L,A01,083376,Eldon; John,0,70,75,75
1650009538551,CSE 175,A01,084013,Kumar; Rakesh,22,0,25,3
1650009544588,CSE 190,A00,092508,Dubnov; Shlomo,20,0,20,0
1650009550627,ECE 5,A01,084049,Morris; Karcher William,13,0,20,7
1650009556672,ECE 100,A01,084051,Baghdadchi; Saharnaz,0,0,20,20
1650009556672,ECE 100,A02,091916,Baghdadchi; Saharnaz,13,0,20,7
1650009562697,ECE 101,A01,084053,Baghdadchi; Saharnaz,0,0,37,37
1650009562697,ECE 101,A02,084054,Baghdadchi; Saharnaz,30,0,37,7
1650009568724,ECE 107,A01,083390,Staff,26,0,40,14
1650009574761,ECE 148,A01,084056,Silberman; Jack,8,0,12,4
1650009580792,ECE 180,A00,083391,Abi Samra; Nicholas Camill,25,0,30,5
1650009580792,ECE 180,B00,083392,Abi Samra; Nicholas Camill,21,0,30,9
1650009586825,MATH 10B,A01,084110,Staff,0,0,30,30
1650009586825,MATH 10B,A02,084111,Staff,18,0,30,12
1650009586825,MATH 10B,A03,084112,Staff,24,0,30,6
1650009592860,MATH 10C,A01,083443,Staff,0,15,30,30
1650009592860,MATH 10C,A02,083444,Staff,0,15,30,30
1650009592860,MATH 10C,B01,084114,Staff,19,0,30,11
1650009592860,MATH 10C,B02,084115,Staff,25,0,30,5
1650009598884,MATH 18,A01,084117,Harel; Guershon,14,0,30,16
1650009598884,MATH 18,A02,084119,Harel; Guershon,28,0,30,2
1650009598884,MATH 18,A03,084120,Harel; Guershon,29,0,30,1
1650009598884,MATH 18,A04,084121,Harel; Guershon,29,0,30,1
1650009604910,MATH 20B,A01,084124,Um; Ko Woon,16,0,35,19
1650009604910,MATH 20B,B01,084126,Um; Ko Woon,24,0,35,11
1650009610943,MATH 20C,A01,083446,Hammock; Frances H,0,0,30,30
1650009610943,MATH 20C,A02,083447,Hammock; Frances H,16,0,30,14
1650009610943,MATH 20C,A03,083448,Hammock; Frances H,20,0,30,10
1650009610943,MATH 20C,A04,083449,Hammock; Frances H,20,0,30,10
1650009610943,MATH 20C,B01,083451,Hammock; Frances H,0,0,30,30
1650009610943,MATH 20C,B02,083452,Hammock; Frances H,19,0,30,11
1650009610943,MATH 20C,B03,083453,Hammock; Frances H,22,0,30,8
1650009610943,MATH 20C,B04,083454,Hammock; Frances H,24,0,30,6
1650009616971,MATH 20D,A01,084128,Staff,14,0,30,16
1650009616971,MATH 20D,A02,084129,Staff,29,0,30,1
1650009616971,MATH 20D,A03,084130,Staff,27,0,30,3
1650009616971,MATH 20D,B01,084133,Staff,3,0,30,27
1650009616971,MATH 20D,B02,084134,Staff,24,0,30,6
1650009616971,MATH 20D,B03,084135,Staff,28,0,30,2
1650009622995,MATH 20E,A01,084138,Staff,13,0,30,17
1650009622995,MATH 20E,A02,084139,Staff,6,0,30,24
1650009622995,MATH 20E,A03,084140,Staff,15,0,30,15
1650009622995,MATH 20E,A04,084141,Staff,20,0,30,10
1650009629029,MATH 102,A01,084143,Harel; Guershon,12,0,30,18
1650009629029,MATH 102,A02,084144,Harel; Guershon,20,0,30,10
1650009635057,MATH 103B,A01,083456,Staff,0,13,30,30
1650009635057,MATH 103B,A02,083457,Staff,0,13,30,30
1650009641089,MATH 109,A01,084146,Salehi Golsefidy; Alireza,18,0,30,12
1650009641089,MATH 109,A02,084147,Salehi Golsefidy; Alireza,15,0,30,15
1650009647120,MATH 120A,A01,085445,Eggers; John Dietrich,10,0,35,25
1650009647120,MATH 120A,A02,085446,Eggers; John Dietrich,27,0,35,8
1650009653169,MATH 142B,A01,084149,Verstraete; Jacques Allan,0,12,30,30
1650009653169,MATH 142B,A02,084150,Verstraete; Jacques Allan,0,12,30,30
1650009659204,MATH 170A,A01,083459,Nie; Jiawang,0,9,30,30
1650009659204,MATH 170A,A02,083460,Nie; Jiawang,0,8,30,30
1650009659204,MATH 170A,A03,083461,Nie; Jiawang,0,9,30,30
1650009665229,MATH 193B,A01,083463,Staff,1,0,30,29
1650009665229,MATH 193B,A02,083464,Staff,9,0,30,21
1650009665229,MATH 193B,A03,083465,Staff,18,0,30,12
1650009671297,COGS 2,A01,083966,Boyle; Mary E. T.,9,0,30,21
1650009677334,COGS 9,A01,083968,Staff,9,0,60,51
1650009683361,COGS 14B,A01,083970,Staff,10,0,50,40
1650009689386,COGS 17,A01,092679,Staff,51,0,75,24
1650009695410,COGS 100,A01,083972,Staff,0,15,60,60
1650009707467,COGS 101C,A01,083976,Staff,12,0,30,18
1650009713492,COGS 102A,A01,083978,Johnson; Christine M.,14,0,30,16
1650009719522,COGS 107B,A01,083980,Staff,0,7,50,50
1650009725550,COGS 115,A01,083982,Staff,10,0,30,20
1650009731579,COGS 118B,A01,083367,Staff,0,15,40,40
1650009737612,COGS 172,A01,083984,Provenzano; Emily Kara,15,0,30,15
1650009743634,COGS 177,A00,083368,Staff,0,20,30,30
1650009749658,COGS 186,A01,083986,Staff,21,0,40,19
1650009755688,COGS 187A,A01,083988,Boyle; Mary E. T.,20,0,60,40
1650009761725,CSE 8A,A50,084003,Miranda; Gregory Joseph,0,13,15,15
1650009767750,CSE 11,A01,084005,Miranda; Gregory Joseph,0,21,55,55
1650009773773,CSE 20,A01,084007,Staff,0,5,20,20
1650009779799,CSE 21,A01,084009,Staff,0,30,50,50
1650009785825,CSE 30,A01,083370,Cao; Yingjun,0,65,40,40
1650009791853,CSE 100,A01,083372,Cao; Yingjun,0,46,40,40
1650009797878,CSE 101,A01,084011,Staff,0,54,40,40
1650009803907,CSE 141,A01,083374,Eldon; John,0,64,75,75
1650009809931,CSE 141L,A01,083376,Eldon; John,0,70,75,75
1650009815959,CSE 175,A01,084013,Kumar; Rakesh,22,0,25,3
1650009821986,CSE 190,A00,092508,Dubnov; Shlomo,20,0,20,0
1650009828022,ECE 5,A01,084049,Morris; Karcher William,13,0,20,7
1650009834047,ECE 100,A01,084051,Baghdadchi; Saharnaz,0,0,20,20
1650009834047,ECE 100,A02,091916,Baghdadchi; Saharnaz,13,0,20,7
1650009840072,ECE 101,A01,084053,Baghdadchi; Saharnaz,0,0,37,37
1650009840072,ECE 101,A02,084054,Baghdadchi; Saharnaz,30,0,37,7
1650009846097,ECE 107,A01,083390,Staff,26,0,40,14
1650009852123,ECE 148,A01,084056,Silberman; Jack,8,0,12,4
1650009858151,ECE 180,A00,083391,Abi Samra; Nicholas Camill,25,0,30,5
1650009858151,ECE 180,B00,083392,Abi Samra; Nicholas Camill,21,0,30,9
1650009864179,MATH 10B,A01,084110,Staff,0,0,30,30
1650009864179,MATH 10B,A02,084111,Staff,18,0,30,12
1650009864179,MATH 10B,A03,084112,Staff,24,0,30,6
1650009870208,MATH 10C,A01,083443,Staff,0,15,30,30
1650009870208,MATH 10C,A02,083444,Staff,0,15,30,30
1650009870208,MATH 10C,B01,084114,Staff,19,0,30,11
1650009870208,MATH 10C,B02,084115,Staff,25,0,30,5
1650009876237,MATH 18,A01,084117,Harel; Guershon,14,0,30,16
1650009876237,MATH 18,A02,084119,Harel; Guershon,28,0,30,2
1650009876237,MATH 18,A03,084120,Harel; Guershon,29,0,30,1
1650009876237,MATH 18,A04,084121,Harel; Guershon,29,0,30,1
1650009882276,MATH 20B,A01,084124,Um; Ko Woon,16,0,35,19
1650009882276,MATH 20B,B01,084126,Um; Ko Woon,24,0,35,11
1650009888309,MATH 20C,A01,083446,Hammock; Frances H,0,0,30,30
1650009888309,MATH 20C,A02,083447,Hammock; Frances H,16,0,30,14
1650009888309,MATH 20C,A03,083448,Hammock; Frances H,20,0,30,10
1650009888309,MATH 20C,A04,083449,Hammock; Frances H,20,0,30,10
1650009888309,MATH 20C,B01,083451,Hammock; Frances H,0,0,30,30
1650009888309,MATH 20C,B02,083452,Hammock; Frances H,19,0,30,11
1650009888309,MATH 20C,B03,083453,Hammock; Frances H,22,0,30,8
1650009888309,MATH 20C,B04,083454,Hammock; Frances H,24,0,30,6
1650009894335,MATH 20D,A01,084128,Staff,14,0,30,16
1650009894335,MATH 20D,A02,084129,Staff,29,0,30,1
1650009894335,MATH 20D,A03,084130,Staff,27,0,30,3
1650009894335,MATH 20D,B01,084133,Staff,3,0,30,27
1650009894335,MATH 20D,B02,084134,Staff,24,0,30,6
1650009894335,MATH 20D,B03,084135,Staff,28,0,30,2
1650009900362,MATH 20E,A01,084138,Staff,13,0,30,17
1650009900362,MATH 20E,A02,084139,Staff,6,0,30,24
1650009900362,MATH 20E,A03,084140,Staff,15,0,30,15
1650009900362,MATH 20E,A04,084141,Staff,20,0,30,10
1650009906390,MATH 102,A01,084143,Harel; Guershon,12,0,30,18
1650009906390,MATH 102,A02,084144,Harel; Guershon,20,0,30,10
1650009912416,MATH 103B,A01,083456,Staff,0,13,30,30
1650009912416,MATH 103B,A02,083457,Staff,0,13,30,30
1650009918441,MATH 109,A01,084146,Salehi Golsefidy; Alireza,18,0,30,12
1650009918441,MATH 109,A02,084147,Salehi Golsefidy; Alireza,15,0,30,15
1650009924480,MATH 120A,A01,085445,Eggers; John Dietrich,10,0,35,25
1650009924480,MATH 120A,A02,085446,Eggers; John Dietrich,27,0,35,8
1650009930505,MATH 142B,A01,084149,Verstraete; Jacques Allan,0,12,30,30
1650009930505,MATH 142B,A02,084150,Verstraete; Jacques Allan,0,12,30,30
1650009936530,MATH 170A,A01,083459,Nie; Jiawang,0,9,30,30
1650009936530,MATH 170A,A02,083460,Nie; Jiawang,0,8,30,30
1650009936530,MATH 170A,A03,083461,Nie; Jiawang,0,9,30,30
1650009942553,MATH 193B,A01,083463,Staff,1,0,30,29
1650009942553,MATH 193B,A02,083464,Staff,9,0,30,21
1650009942553,MATH 193B,A03,083465,Staff,18,0,30,12
1650009948613,COGS 2,A01,083966,Boyle; Mary E. T.,9,0,30,21
1650009954640,COGS 9,A01,083968,Staff,9,0,60,51
1650009960664,COGS 14B,A01,083970,Staff,10,0,50,40
1650009966692,COGS 17,A01,092679,Staff,51,0,75,24
1650009972718,COGS 100,A01,083972,Staff,0,15,60,60
1650009984771,COGS 101C,A01,083976,Staff,12,0,30,18
1650009990802,COGS 102A,A01,083978,Johnson; Christine M.,14,0,30,16
1650009996831,COGS 107B,A01,083980,Staff,0,7,50,50
1650010002859,COGS 115,A01,083982,Staff,10,0,30,20
1650010008887,COGS 118B,A01,083367,Staff,0,15,40,40
1650010014916,COGS 172,A01,083984,Provenzano; Emily Kara,15,0,30,15
1650010020943,COGS 177,A00,083368,Staff,0,20,30,30
1650010026970,COGS 186,A01,083986,Staff,21,0,40,19
1650010032998,COGS 187A,A01,083988,Boyle; Mary E. T.,20,0,60,40
1650010039036,CSE 8A,A50,084003,Miranda; Gregory Joseph,0,13,15,15
1650010045067,CSE 11,A01,084005,Miranda; Gregory Joseph,0,21,55,55
1650010051095,CSE 20,A01,084007,Staff,0,5,20,20
1650010057120,CSE 21,A01,084009,Staff,0,30,50,50
1650010063147,CSE 30,A01,083370,Cao; Yingjun,0,65,40,40
1650010069182,CSE 100,A01,083372,Cao; Yingjun,0,46,40,40
1650010075205,CSE 101,A01,084011,Staff,0,54,40,40
1650010081228,CSE 141,A01,083374,Eldon; John,0,64,75,75
1650010087339,CSE 141L,A01,083376,Eldon; John,0,70,75,75
1650010093370,CSE 175,A01,084013,Kumar; Rakesh,22,0,25,3
1650010099411,CSE 190,A00,092508,Dubnov; Shlomo,20,0,20,0
1650010105436,ECE 5,A01,084049,Morris; Karcher William,13,0,20,7
1650010111460,ECE 100,A01,084051,Baghdadchi; Saharnaz,0,0,20,20
1650010111460,ECE 100,A02,091916,Baghdadchi; Saharnaz,13,0,20,7
1650010117489,ECE 101,A01,084053,Baghdadchi; Saharnaz,0,0,37,37
1650010117489,ECE 101,A02,084054,Baghdadchi; Saharnaz,30,0,37,7
1650010123521,ECE 107,A01,083390,Staff,26,0,40,14
1650010129543,ECE 148,A01,084056,Silberman; Jack,8,0,12,4
1650010135566,ECE 180,A00,083391,Abi Samra; Nicholas Camill,25,0,30,5
1650010135566,ECE 180,B00,083392,Abi Samra; Nicholas Camill,21,0,30,9
1650010141596,MATH 10B,A01,084110,Staff,0,0,30,30
1650010141596,MATH 10B,A02,084111,Staff,18,0,30,12
1650010141596,MATH 10B,A03,084112,Staff,24,0,30,6
1650010147622,MATH 10C,A01,083443,Staff,0,15,30,30
1650010147622,MATH 10C,A02,083444,Staff,0,15,30,30
1650010147622,MATH 10C,B01,084114,Staff,19,0,30,11
1650010147622,MATH 10C,B02,084115,Staff,25,0,30,5
1650010153650,MATH 18,A01,084117,Harel; Guershon,14,0,30,16
1650010153650,MATH 18,A02,084119,Harel; Guershon,28,0,30,2
1650010153650,MATH 18,A03,084120,Harel; Guershon,29,0,30,1
1650010153650,MATH 18,A04,084121,Harel; Guershon,29,0,30,1
1650010159680,MATH 20B,A01,084124,Um; Ko Woon,16,0,35,19
1650010159680,MATH 20B,B01,084126,Um; Ko Woon,24,0,35,11
1650010165711,MATH 20C,A01,083446,Hammock; Frances H,0,0,30,30
1650010165711,MATH 20C,A02,083447,Hammock; Frances H,16,0,30,14
1650010165711,MATH 20C,A03,083448,Hammock; Frances H,20,0,30,10
1650010165711,MATH 20C,A04,083449,Hammock; Frances H,20,0,30,10
1650010165711,MATH 20C,B01,083451,Hammock; Frances H,0,0,30,30
1650010165711,MATH 20C,B02,083452,Hammock; Frances H,19,0,30,11
1650010165711,MATH 20C,B03,083453,Hammock; Frances H,22,0,30,8
1650010165711,MATH 20C,B04,083454,Hammock; Frances H,24,0,30,6
1650010171738,MATH 20D,A01,084128,Staff,14,0,30,16
1650010171738,MATH 20D,A02,084129,Staff,29,0,30,1
1650010171738,MATH 20D,A03,084130,Staff,27,0,30,3
1650010171738,MATH 20D,B01,084133,Staff,3,0,30,27
1650010171738,MATH 20D,B02,084134,Staff,24,0,30,6
1650010171738,MATH 20D,B03,084135,Staff,28,0,30,2
1650010177762,MATH 20E,A01,084138,Staff,13,0,30,17
1650010177762,MATH 20E,A02,084139,Staff,6,0,30,24
1650010177762,MATH 20E,A03,084140,Staff,15,0,30,15
1650010177762,MATH 20E,A04,084141,Staff,20,0,30,10
1650010183789,MATH 102,A01,084143,Harel; Guershon,12,0,30,18
1650010183789,MATH 102,A02,084144,Harel; Guershon,20,0,30,10
1650010189816,MATH 103B,A01,083456,Staff,0,13,30,30
1650010189816,MATH 103B,A02,083457,Staff,0,13,30,30
1650010195839,MATH 109,A01,084146,Salehi Golsefidy; Alireza,18,0,30,12
1650010195839,MATH 109,A02,084147,Salehi Golsefidy; Alireza,15,0,30,15
1650010201870,MATH 120A,A01,085445,Eggers; John Dietrich,10,0,35,25
1650010201870,MATH 120A,A02,085446,Eggers; John Dietrich,27,0,35,8
1650010207899,MATH 142B,A01,084149,Verstraete; Jacques Allan,0,12,30,30
1650010207899,MATH 142B,A02,084150,Verstraete; Jacques Allan,0,12,30,30
1650010213927,MATH 170A,A01,083459,Nie; Jiawang,0,9,30,30
1650010213927,MATH 170A,A02,083460,Nie; Jiawang,0,8,30,30
1650010213927,MATH 170A,A03,083461,Nie; Jiawang,0,9,30,30
1650010219951,MATH 193B,A01,083463,Staff,1,0,30,29
1650010219951,MATH 193B,A02,083464,Staff,9,0,30,21
1650010219951,MATH 193B,A03,083465,Staff,18,0,30,12
1650010226021,COGS 2,A01,083966,Boyle; Mary E. T.,9,0,30,21
1650010232047,COGS 9,A01,083968,Staff,9,0,60,51
1650010238075,COGS 14B,A01,083970,Staff,10,0,50,40
1650010244104,COGS 17,A01,092679,Staff,51,0,75,24
1650010250131,COGS 100,A01,083972,Staff,0,15,60,60
1650010262180,COGS 101C,A01,083976,Staff,12,0,30,18
1650010268208,COGS 102A,A01,083978,Johnson; Christine M.,14,0,30,16
1650010274239,COGS 107B,A01,083980,Staff,0,7,50,50
1650010280267,COGS 115,A01,083982,Staff,10,0,30,20
1650010286305,COGS 118B,A01,083367,Staff,0,15,40,40
1650010292330,COGS 172,A01,083984,Provenzano; Emily Kara,15,0,30,15
1650010298362,COGS 177,A00,083368,Staff,0,20,30,30
1650010304384,COGS 186,A01,083986,Staff,21,0,40,19
1650010310406,COGS 187A,A01,083988,Boyle; Mary E. T.,20,0,60,40
1650010316431,CSE 8A,A50,084003,Miranda; Gregory Joseph,0,13,15,15
1650010322464,CSE 11,A01,084005,Miranda; Gregory Joseph,0,21,55,55
1650010328499,CSE 20,A01,084007,Staff,0,5,20,20
1650010334524,CSE 21,A01,084009,Staff,0,30,50,50
1650010340552,CSE 30,A01,083370,Cao; Yingjun,0,65,40,40
1650010346575,CSE 100,A01,083372,Cao; Yingjun,0,46,40,40
1650010352606,CSE 101,A01,084011,Staff,0,54,40,40
1650010358635,CSE 141,A01,083374,Eldon; John,0,64,75,75
1650010364666,CSE 141L,A01,083376,Eldon; John,0,70,75,75
1650010370695,CSE 175,A01,084013,Kumar; Rakesh,22,0,25,3
1650010376727,CSE 190,A00,092508,Dubnov; Shlomo,20,0,20,0
1650010382762,ECE 5,A01,084049,Morris; Karcher William,13,0,20,7
1650010388792,ECE 100,A01,084051,Baghdadchi; Saharnaz,0,0,20,20
1650010388792,ECE 100,A02,091916,Baghdadchi; Saharnaz,13,0,20,7
1650010394826,ECE 101,A01,084053,Baghdadchi; Saharnaz,0,0,37,37
1650010394826,ECE 101,A02,084054,Baghdadchi; Saharnaz,30,0,37,7
1650010400853,ECE 107,A01,083390,Staff,26,0,40,14
1650010406878,ECE 148,A01,084056,Silberman; Jack,8,0,12,4
1650010412909,ECE 180,A00,083391,Abi Samra; Nicholas Camill,25,0,30,5
1650010412909,ECE 180,B00,083392,Abi Samra; Nicholas Camill,21,0,30,9
1650010418935,MATH 10B,A01,084110,Staff,0,0,30,30
1650010418935,MATH 10B,A02,084111,Staff,18,0,30,12
1650010418935,MATH 10B,A03,084112,Staff,24,0,30,6
1650010424963,MATH 10C,A01,083443,Staff,0,15,30,30
1650010424963,MATH 10C,A02,083444,Staff,0,15,30,30
1650010424963,MATH 10C,B01,084114,Staff,19,0,30,11
1650010424963,MATH 10C,B02,084115,Staff,25,0,30,5
1650010430995,MATH 18,A01,084117,Harel; Guershon,14,0,30,16
1650010430995,MATH 18,A02,084119,Harel; Guershon,28,0,30,2
1650010430995,MATH 18,A03,084120,Harel; Guershon,29,0,30,1
1650010430995,MATH 18,A04,084121,Harel; Guershon,29,0,30,1
1650010437017,MATH 20B,A01,084124,Um; Ko Woon,16,0,35,19
1650010437017,MATH 20B,B01,084126,Um; Ko Woon,24,0,35,11
1650010443052,MATH 20C,A01,083446,Hammock; Frances H,0,0,30,30
1650010443052,MATH 20C,A02,083447,Hammock; Frances H,16,0,30,14
1650010443052,MATH 20C,A03,083448,Hammock; Frances H,20,0,30,10
1650010443052,MATH 20C,A04,083449,Hammock; Frances H,20,0,30,10
1650010443052,MATH 20C,B01,083451,Hammock; Frances H,0,0,30,30
1650010443052,MATH 20C,B02,083452,Hammock; Frances H,19,0,30,11
1650010443052,MATH 20C,B03,083453,Hammock; Frances H,22,0,30,8
1650010443052,MATH 20C,B04,083454,Hammock; Frances H,24,0,30,6
1650010449082,MATH 20D,A01,084128,Staff,14,0,30,16
1650010449082,MATH 20D,A02,084129,Staff,29,0,30,1
1650010449082,MATH 20D,A03,084130,Staff,27,0,30,3
1650010449082,MATH 20D,B01,084133,Staff,3,0,30,27
1650010449082,MATH 20D,B02,084134,Staff,24,0,30,6
1650010449082,MATH 20D,B03,084135,Staff,28,0,30,2
1650010455112,MATH 20E,A01,084138,Staff,13,0,30,17
1650010455112,MATH 20E,A02,084139,Staff,6,0,30,24
1650010455112,MATH 20E,A03,084140,Staff,15,0,30,15
1650010455112,MATH 20E,A04,084141,Staff,20,0,30,10
1650010461136,MATH 102,A01,084143,Harel; Guershon,12,0,30,18
1650010461136,MATH 102,A02,084144,Harel; Guershon,20,0,30,10
1650010467160,MATH 103B,A01,083456,Staff,0,13,30,30
1650010467160,MATH 103B,A02,083457,Staff,0,13,30,30
1650010473183,MATH 109,A01,084146,Salehi Golsefidy; Alireza,18,0,30,12
1650010473183,MATH 109,A02,084147,Salehi Golsefidy; Alireza,15,0,30,15
1650010479210,MATH 120A,A01,085445,Eggers; John Dietrich,10,0,35,25
1650010479210,MATH 120A,A02,085446,Eggers; John Dietrich,27,0,35,8
1650010485244,MATH 142B,A01,084149,Verstraete; Jacques Allan,0,12,30,30
1650010485244,MATH 142B,A02,084150,Verstraete; Jacques Allan,0,12,30,30
1650010491269,MATH 170A,A01,083459,Nie; Jiawang,0,9,30,30
1650010491269,MATH 170A,A02,083460,Nie; Jiawang,0,8,30,30
1650010491269,MATH 170A,A03,083461,Nie; Jiawang,0,9,30,30
1650010497298,MATH 193B,A01,083463,Staff,1,0,30,29
1650010497298,MATH 193B,A02,083464,Staff,9,0,30,21
1650010497298,MATH 193B,A03,083465,Staff,18,0,30,12
1650010503365,COGS 2,A01,083966,Boyle; Mary E. T.,9,0,30,21
1650010509388,COGS 9,A01,083968,Staff,9,0,60,51
1650010515420,COGS 14B,A01,083970,Staff,10,0,50,40
1650010521445,COGS 17,A01,092679,Staff,51,0,75,24
1650010527469,COGS 100,A01,083972,Staff,0,15,60,60
1650010539518,COGS 101C,A01,083976,Staff,12,0,30,18
1650010545545,COGS 102A,A01,083978,Johnson; Christine M.,14,0,30,16
1650010551569,COGS 107B,A01,083980,Staff,0,7,50,50
1650010557595,COGS 115,A01,083982,Staff,10,0,30,20
1650010563619,COGS 118B,A01,083367,Staff,0,15,40,40
1650010569645,COGS 172,A01,083984,Provenzano; Emily Kara,15,0,30,15
1650010575673,COGS 177,A00,083368,Staff,0,20,30,30
1650010581700,COGS 186,A01,083986,Staff,21,0,40,19
1650010587737,COGS 187A,A01,083988,Boyle; Mary E. T.,20,0,60,40
1650010593769,CSE 8A,A50,084003,Miranda; Gregory Joseph,0,13,15,15
1650010599792,CSE 11,A01,084005,Miranda; Gregory Joseph,0,21,55,55
1650010605817,CSE 20,A01,084007,Staff,0,5,20,20
1650010611840,CSE 21,A01,084009,Staff,0,30,50,50
1650010617864,CSE 30,A01,083370,Cao; Yingjun,0,65,40,40
1650010623894,CSE 100,A01,083372,Cao; Yingjun,0,46,40,40
1650010629918,CSE 101,A01,084011,Staff,0,54,40,40
1650010635941,CSE 141,A01,083374,Eldon; John,0,64,75,75
1650010641964,CSE 141L,A01,083376,Eldon; John,0,70,75,75
1650010647996,CSE 175,A01,084013,Kumar; Rakesh,22,0,25,3
1650010654023,CSE 190,A00,092508,Dubnov; Shlomo,20,0,20,0
1650010660055,ECE 5,A01,084049,Morris; Karcher William,13,0,20,7
1650010666089,ECE 100,A01,084051,Baghdadchi; Saharnaz,0,0,20,20
1650010666089,ECE 100,A02,091916,Baghdadchi; Saharnaz,13,0,20,7
1650010672117,ECE 101,A01,084053,Baghdadchi; Saharnaz,0,0,37,37
1650010672117,ECE 101,A02,084054,Baghdadchi; Saharnaz,30,0,37,7
1650010678145,ECE 107,A01,083390,Staff,26,0,40,14
1650010684243,ECE 148,A01,084056,Silberman; Jack,8,0,12,4
1650010690269,ECE 180,A00,083391,Abi Samra; Nicholas Camill,25,0,30,5
1650010690269,ECE 180,B00,083392,Abi Samra; Nicholas Camill,21,0,30,9
1650010696296,MATH 10B,A01,084110,Staff,0,0,30,30
1650010696296,MATH 10B,A02,084111,Staff,18,0,30,12
1650010696296,MATH 10B,A03,084112,Staff,24,0,30,6
1650010702333,MATH 10C,A01,083443,Staff,0,15,30,30
1650010702333,MATH 10C,A02,083444,Staff,0,15,30,30
1650010702333,MATH 10C,B01,084114,Staff,19,0,30,11
1650010702333,MATH 10C,B02,084115,Staff,25,0,30,5
1650010708359,MATH 18,A01,084117,Harel; Guershon,14,0,30,16
1650010708359,MATH 18,A02,084119,Harel; Guershon,28,0,30,2
1650010708359,MATH 18,A03,084120,Harel; Guershon,29,0,30,1
1650010708359,MATH 18,A04,084121,Harel; Guershon,29,0,30,1
1650010714383,MATH 20B,A01,084124,Um; Ko Woon,16,0,35,19
1650010714383,MATH 20B,B01,084126,Um; Ko Woon,24,0,35,11
1650010720420,MATH 20C,A01,083446,Hammock; Frances H,0,0,30,30
1650010720420,MATH 20C,A02,083447,Hammock; Frances H,16,0,30,14
1650010720420,MATH 20C,A03,083448,Hammock; Frances H,20,0,30,10
1650010720420,MATH 20C,A04,083449,Hammock; Frances H,20,0,30,10
1650010720420,MATH 20C,B01,083451,Hammock; Frances H,0,0,30,30
1650010720420,MATH 20C,B02,083452,Hammock; Frances H,19,0,30,11
1650010720420,MATH 20C,B03,083453,Hammock; Frances H,22,0,30,8
1650010720420,MATH 20C,B04,083454,Hammock; Frances H,24,0,30,6
1650010726451,MATH 20D,A01,084128,Staff,14,0,30,16
1650010726451,MATH 20D,A02,084129,Staff,29,0,30,1
1650010726451,MATH 20D,A03,084130,Staff,27,0,30,3
1650010726451,MATH 20D,B01,084133,Staff,3,0,30,27
1650010726451,MATH 20D,B02,084134,Staff,24,0,30,6
1650010726451,MATH 20D,B03,084135,Staff,28,0,30,2
1650010732478,MATH 20E,A01,084138,Staff,13,0,30,17
1650010732478,MATH 20E,A02,084139,Staff,6,0,30,24
1650010732478,MATH 20E,A03,084140,Staff,15,0,30,15
1650010732478,MATH 20E,A04,084141,Staff,20,0,30,10
1650010738507,MATH 102,A01,084143,Harel; Guershon,12,0,30,18
1650010738507,MATH 102,A02,084144,Harel; Guershon,20,0,30,10
1650010744529,MATH 103B,A01,083456,Staff,0,13,30,30
1650010744529,MATH 103B,A02,083457,Staff,0,13,30,30
1650010750564,MATH 109,A01,084146,Salehi Golsefidy; Alireza,18,0,30,12
1650010750564,MATH 109,A02,084147,Salehi Golsefidy; Alireza,15,0,30,15
1650010756589,MATH 120A,A01,085445,Eggers; John Dietrich,10,0,35,25
1650010756589,MATH 120A,A02,085446,Eggers; John Dietrich,27,0,35,8
1650010762619,MATH 142B,A01,084149,Verstraete; Jacques Allan,0,12,30,30
1650010762619,MATH 142B,A02,084150,Verstraete; Jacques Allan,0,12,30,30
1650010768648,MATH 170A,A01,083459,Nie; Jiawang,0,9,30,30
1650010768648,MATH 170A,A02,083460,Nie; Jiawang,0,8,30,30
1650010768648,MATH 170A,A03,083461,Nie; Jiawang,0,9,30,30
1650010774672,MATH 193B,A01,083463,Staff,1,0,30,29
1650010774672,MATH 193B,A02,083464,Staff,9,0,30,21
1650010774672,MATH 193B,A03,083465,Staff,18,0,30,12
1650010780755,COGS 2,A01,083966,Boyle; Mary E. T.,9,0,30,21
1650010786781,COGS 9,A01,083968,Staff,9,0,60,51
1650010792802,COGS 14B,A01,083970,Staff,10,0,50,40
1650010798835,COGS 17,A01,092679,Staff,51,0,75,24
1650010804866,COGS 100,A01,083972,Staff,0,15,60,60
1650010816919,COGS 101C,A01,083976,Staff,12,0,30,18
1650010822945,COGS 102A,A01,083978,Johnson; Christine M.,14,0,30,16
1650010828978,COGS 107B,A01,083980,Staff,0,7,50,50
1650010835004,COGS 115,A01,083982,Staff,10,0,30,20
1650010841028,COGS 118B,A01,083367,Staff,0,15,40,40
1650010847054,COGS 172,A01,083984,Provenzano; Emily Kara,15,0,30,15
1650010853079,COGS 177,A00,083368,Staff,0,20,30,30
1650010859106,COGS 186,A01,083986,Staff,21,0,40,19
1650010865129,COGS 187A,A01,083988,Boyle; Mary E. T.,20,0,60,40
1650010871158,CSE 8A,A50,084003,Miranda; Gregory Joseph,0,13,15,15
1650010877185,CSE 11,A01,084005,Miranda; Gregory Joseph,0,21,55,55
1650010883212,CSE 20,A01,084007,Staff,0,5,20,20
1650010889239,CSE 21,A01,084009,Staff,0,30,50,50
1650010895264,CSE 30,A01,083370,Cao; Yingjun,0,65,40,40
1650010901292,CSE 100,A01,083372,Cao; Yingjun,0,46,40,40
1650010907316,CSE 101,A01,084011,Staff,0,54,40,40
1650010913343,CSE 141,A01,083374,Eldon; John,0,64,75,75
1650010919367,CSE 141L,A01,083376,Eldon; John,0,70,75,75
1650010925401,CSE 175,A01,084013,Kumar; Rakesh,22,0,25,3
1650010931423,CSE 190,A00,092508,Dubnov; Shlomo,20,0,20,0
1650010937447,ECE 5,A01,084049,Morris; Karcher William,13,0,20,7
1650010943471,ECE 100,A01,084051,Baghdadchi; Saharnaz,0,0,20,20
1650010943471,ECE 100,A02,091916,Baghdadchi; Saharnaz,13,0,20,7
1650010949510,ECE 101,A01,084053,Baghdadchi; Saharnaz,0,0,37,37
1650010949510,ECE 101,A02,084054,Baghdadchi; Saharnaz,30,0,37,7
1650010955533,ECE 107,A01,083390,Staff,26,0,40,14
1650010961565,ECE 148,A01,084056,Silberman; Jack,8,0,12,4
1650010967589,ECE 180,A00,083391,Abi Samra; Nicholas Camill,25,0,30,5
1650010967589,ECE 180,B00,083392,Abi Samra; Nicholas Camill,21,0,30,9
1650010973617,MATH 10B,A01,084110,Staff,0,0,30,30
1650010973617,MATH 10B,A02,084111,Staff,18,0,30,12
1650010973617,MATH 10B,A03,084112,Staff,24,0,30,6
1650010979641,MATH 10C,A01,083443,Staff,0,15,30,30
1650010979641,MATH 10C,A02,083444,Staff,0,15,30,30
1650010979641,MATH 10C,B01,084114,Staff,19,0,30,11
1650010979641,MATH 10C,B02,084115,Staff,25,0,30,5
1650010985665,MATH 18,A01,084117,Harel; Guershon,14,0,30,16
1650010985665,MATH 18,A02,084119,Harel; Guershon,28,0,30,2
1650010985665,MATH 18,A03,084120,Harel; Guershon,29,0,30,1
1650010985665,MATH 18,A04,084121,Harel; Guershon,29,0,30,1
1650010991693,MATH 20B,A01,084124,Um; Ko Woon,16,0,35,19
1650010991693,MATH 20B,B01,084126,Um; Ko Woon,24,0,35,11
1650010997722,MATH 20C,A01,083446,Hammock; Frances H,0,0,30,30
1650010997722,MATH 20C,A02,083447,Hammock; Frances H,16,0,30,14
1650010997722,MATH 20C,A03,083448,Hammock; Frances H,20,0,30,10
1650010997722,MATH 20C,A04,083449,Hammock; Frances H,20,0,30,10
1650010997722,MATH 20C,B01,083451,Hammock; Frances H,0,0,30,30
1650010997722,MATH 20C,B02,083452,Hammock; Frances H,19,0,30,11
1650010997722,MATH 20C,B03,083453,Hammock; Frances H,22,0,30,8
1650010997722,MATH 20C,B04,083454,Hammock; Frances H,24,0,30,6
1650011003747,MATH 20D,A01,084128,Staff,14,0,30,16
1650011003747,MATH 20D,A02,084129,Staff,29,0,30,1
1650011003747,MATH 20D,A03,084130,Staff,27,0,30,3
1650011003747,MATH 20D,B01,084133,Staff,3,0,30,27
1650011003747,MATH 20D,B02,084134,Staff,24,0,30,6
1650011003747,MATH 20D,B03,084135,Staff,28,0,30,2
1650011009778,MATH 20E,A01,084138,Staff,13,0,30,17
1650011009778,MATH 20E,A02,084139,Staff,6,0,30,24
1650011009778,MATH 20E,A03,084140,Staff,15,0,30,15
1650011009778,MATH 20E,A04,084141,Staff,20,0,30,10
1650011015803,MATH 102,A01,084143,Harel; Guershon,12,0,30,18
1650011015803,MATH 102,A02,084144,Harel; Guershon,20,0,30,10
1650011021829,MATH 103B,A01,083456,Staff,0,13,30,30
1650011021829,MATH 103B,A02,083457,Staff,0,13,30,30
1650011027853,MATH 109,A01,084146,Salehi Golsefidy; Alireza,18,0,30,12
1650011027853,MATH 109,A02,084147,Salehi Golsefidy; Alireza,15,0,30,15
1650011033879,MATH 120A,A01,085445,Eggers; John Dietrich,10,0,35,25
1650011033879,MATH 120A,A02,085446,Eggers; John Dietrich,27,0,35,8
1650011039904,MATH 142B,A01,084149,Verstraete; Jacques Allan,0,12,30,30
1650011039904,MATH 142B,A02,084150,Verstraete; Jacques Allan,0,12,30,30
1650011045931,MATH 170A,A01,083459,Nie; Jiawang,0,9,30,30
1650011045931,MATH 170A,A02,083460,Nie; Jiawang,0,8,30,30
1650011045931,MATH 170A,A03,083461,Nie; Jiawang,0,9,30,30
1650011051958,MATH 193B,A01,083463,Staff,1,0,30,29
1650011051958,MATH 193B,A02,083464,Staff,9,0,30,21
1650011051958,MATH 193B,A03,083465,Staff,18,0,30,12
1650011058017,COGS 2,A01,083966,Boyle; Mary E. T.,9,0,30,21
1650011064040,COGS 9,A01,083968,Staff,9,0,60,51
1650011070066,COGS 14B,A01,083970,Staff,10,0,50,40
1650011076092,COGS 17,A01,092679,Staff,51,0,75,24
1650011082115,COGS 100,A01,083972,Staff,0,15,60,60
1650011094164,COGS 101C,A01,083976,Staff,12,0,30,18
1650011100201,COGS 102A,A01,083978,Johnson; Christine M.,14,0,30,16
1650011106228,COGS 107B,A01,083980,Staff,0,7,50,50
1650011112254,COGS 115,A01,083982,Staff,10,0,30,20
1650011118303,COGS 118B,A01,083367,Staff,0,15,40,40
1650011124336,COGS 172,A01,083984,Provenzano; Emily Kara,15,0,30,15
1650011130459,COGS 177,A00,083368,Staff,0,20,30,30
1650011136483,COGS 186,A01,083986,Staff,21,0,40,19
1650011142506,COGS 187A,A01,083988,Boyle; Mary E. T.,20,0,60,40
1650011148531,CSE 8A,A50,084003,Miranda; Gregory Joseph,0,13,15,15
1650011154566,CSE 11,A01,084005,Miranda; Gregory Joseph,0,21,55,55
1650011160602,CSE 20,A01,084007,Staff,0,5,20,20
1650011166630,CSE 21,A01,084009,Staff,0,30,50,50
1650011172654,CSE 30,A01,083370,Cao; Yingjun,0,65,40,40
1650011178682,CSE 100,A01,083372,Cao; Yingjun,0,46,40,40
1650011184706,CSE 101,A01,084011,Staff,0,54,40,40
1650011190730,CSE 141,A01,083374,Eldon; John,0,64,75,75
1650011196754,CSE 141L,A01,083376,Eldon; John,0,70,75,75
1650011202777,CSE 175,A01,084013,Kumar; Rakesh,22,0,25,3
1650011208800,CSE 190,A00,092508,Dubnov; Shlomo,20,0,20,0
1650011214825,ECE 5,A01,084049,Morris; Karcher William,13,0,20,7
1650011220849,ECE 100,A01,084051,Baghdadchi; Saharnaz,0,0,20,20
1650011220849,ECE 100,A02,091916,Baghdadchi; Saharnaz,13,0,20,7
1650011226871,ECE 101,A01,084053,Baghdadchi; Saharnaz,0,0,37,37
1650011226871,ECE 101,A02,084054,Baghdadchi; Saharnaz,30,0,37,7
1650011232895,ECE 107,A01,083390,Staff,26,0,40,14
1650011238919,ECE 148,A01,084056,Silberman; Jack,8,0,12,4
1650011244942,ECE 180,A00,083391,Abi Samra; Nicholas Camill,25,0,30,5
1650011244942,ECE 180,B00,083392,Abi Samra; Nicholas Camill,21,0,30,9
1650011250967,MATH 10B,A01,084110,Staff,0,0,30,30
1650011250967,MATH 10B,A02,084111,Staff,18,0,30,12
1650011250967,MATH 10B,A03,084112,Staff,24,0,30,6
1650011256995,MATH 10C,A01,083443,Staff,0,15,30,30
1650011256995,MATH 10C,A02,083444,Staff,0,15,30,30
1650011256995,MATH 10C,B01,084114,Staff,19,0,30,11
1650011256995,MATH 10C,B02,084115,Staff,25,0,30,5
1650011263019,MATH 18,A01,084117,Harel; Guershon,14,0,30,16
1650011263019,MATH 18,A02,084119,Harel; Guershon,28,0,30,2
1650011263019,MATH 18,A03,084120,Harel; Guershon,29,0,30,1
1650011263019,MATH 18,A04,084121,Harel; Guershon,29,0,30,1
1650011269048,MATH 20B,A01,084124,Um; Ko Woon,16,0,35,19
1650011269048,MATH 20B,B01,084126,Um; Ko Woon,24,0,35,11
1650011275079,MATH 20C,A01,083446,Hammock; Frances H,0,0,30,30
1650011275079,MATH 20C,A02,083447,Hammock; Frances H,16,0,30,14
1650011275079,MATH 20C,A03,083448,Hammock; Frances H,20,0,30,10
1650011275079,MATH 20C,A04,083449,Hammock; Frances H,20,0,30,10
1650011275079,MATH 20C,B01,083451,Hammock; Frances H,0,0,30,30
1650011275079,MATH 20C,B02,083452,Hammock; Frances H,19,0,30,11
1650011275079,MATH 20C,B03,083453,Hammock; Frances H,21,0,30,9
1650011275079,MATH 20C,B04,083454,Hammock; Frances H,24,0,30,6
1650011281202,MATH 20D,A01,084128,Staff,14,0,30,16
1650011281202,MATH 20D,A02,084129,Staff,29,0,30,1
1650011281202,MATH 20D,A03,084130,Staff,27,0,30,3
1650011281202,MATH 20D,B01,084133,Staff,3,0,30,27
1650011281202,MATH 20D,B02,084134,Staff,24,0,30,6
1650011281202,MATH 20D,B03,084135,Staff,28,0,30,2
1650011287229,MATH 20E,A01,084138,Staff,13,0,30,17
1650011287229,MATH 20E,A02,084139,Staff,6,0,30,24
1650011287229,MATH 20E,A03,084140,Staff,15,0,30,15
1650011287229,MATH 20E,A04,084141,Staff,20,0,30,10
1650011293257,MATH 102,A01,084143,Harel; Guershon,12,0,30,18
1650011293257,MATH 102,A02,084144,Harel; Guershon,20,0,30,10
1650011299281,MATH 103B,A01,083456,Staff,0,13,30,30
1650011299281,MATH 103B,A02,083457,Staff,0,13,30,30
1650011305308,MATH 109,A01,084146,Salehi Golsefidy; Alireza,18,0,30,12
1650011305308,MATH 109,A02,084147,Salehi Golsefidy; Alireza,15,0,30,15
1650011311336,MATH 120A,A01,085445,Eggers; John Dietrich,10,0,35,25
1650011311336,MATH 120A,A02,085446,Eggers; John Dietrich,27,0,35,8
1650011317362,MATH 142B,A01,084149,Verstraete; Jacques Allan,0,12,30,30
1650011317362,MATH 142B,A02,084150,Verstraete; Jacques Allan,0,12,30,30
1650011323390,MATH 170A,A01,083459,Nie; Jiawang,0,9,30,30
1650011323390,MATH 170A,A02,083460,Nie; Jiawang,0,8,30,30
1650011323390,MATH 170A,A03,083461,Nie; Jiawang,0,9,30,30
1650011329418,MATH 193B,A01,083463,Staff,1,0,30,29
1650011329418,MATH 193B,A02,083464,Staff,9,0,30,21
1650011329418,MATH 193B,A03,083465,Staff,18,0,30,12
1650011335490,COGS 2,A01,083966,Boyle; Mary E. T.,9,0,30,21
1650011341514,COGS 9,A01,083968,Staff,9,0,60,51
1650011347538,COGS 14B,A01,083970,Staff,10,0,50,40
1650011353561,COGS 17,A01,092679,Staff,51,0,75,24
1650011359583,COGS 100,A01,083972,Staff,0,15,60,60
1650011371635,COGS 101C,A01,083976,Staff,12,0,30,18
1650011377673,COGS 102A,A01,083978,Johnson; Christine M.,14,0,30,16
1650011383701,COGS 107B,A01,083980,Staff,0,7,50,50
1650011389732,COGS 115,A01,083982,Staff,10,0,30,20
1650011395755,COGS 118B,A01,083367,Staff,0,15,40,40
1650011401789,COGS 172,A01,083984,Provenzano; Emily Kara,15,0,30,15
1650011407812,COGS 177,A00,083368,Staff,0,20,30,30
1650011413840,COGS 186,A01,083986,Staff,21,0,40,19
1650011419867,COGS 187A,A01,083988,Boyle; Mary E. T.,20,0,60,40
1650011425898,CSE 8A,A50,084003,Miranda; Gregory Joseph,0,13,15,15
1650011431920,CSE 11,A01,084005,Miranda; Gregory Joseph,0,21,55,55
1650011437944,CSE 20,A01,084007,Staff,0,5,20,20
1650011443967,CSE 21,A01,084009,Staff,0,30,50,50
1650011449990,CSE 30,A01,083370,Cao; Yingjun,0,65,40,40
1650011456017,CSE 100,A01,083372,Cao; Yingjun,0,46,40,40
1650011462041,CSE 101,A01,084011,Staff,0,54,40,40
1650011468065,CSE 141,A01,083374,Eldon; John,0,64,75,75
1650011474090,CSE 141L,A01,083376,Eldon; John,0,70,75,75
1650011480118,CSE 175,A01,084013,Kumar; Rakesh,22,0,25,3
1650011486148,CSE 190,A00,092508,Dubnov; Shlomo,20,0,20,0
1650011492173,ECE 5,A01,084049,Morris; Karcher William,13,0,20,7
1650011498200,ECE 100,A01,084051,Baghdadchi; Saharnaz,0,0,20,20
1650011498200,ECE 100,A02,091916,Baghdadchi; Saharnaz,13,0,20,7
1650011504224,ECE 101,A01,084053,Baghdadchi; Saharnaz,0,0,37,37
1650011504224,ECE 101,A02,084054,Baghdadchi; Saharnaz,30,0,37,7
1650011510251,ECE 107,A01,083390,Staff,26,0,40,14
1650011516280,ECE 148,A01,084056,Silberman; Jack,8,0,12,4
1650011522305,ECE 180,A00,083391,Abi Samra; Nicholas Camill,25,0,30,5
1650011522305,ECE 180,B00,083392,Abi Samra; Nicholas Camill,21,0,30,9
1650011528330,MATH 10B,A01,084110,Staff,0,0,30,30
1650011528330,MATH 10B,A02,084111,Staff,18,0,30,12
1650011528330,MATH 10B,A03,084112,Staff,24,0,30,6
1650011534354,MATH 10C,A01,083443,Staff,0,15,30,30
1650011534354,MATH 10C,A02,083444,Staff,0,15,30,30
1650011534354,MATH 10C,B01,084114,Staff,19,0,30,11
1650011534354,MATH 10C,B02,084115,Staff,25,0,30,5
1650011540385,MATH 18,A01,084117,Harel; Guershon,14,0,30,16
1650011540385,MATH 18,A02,084119,Harel; Guershon,28,0,30,2
1650011540385,MATH 18,A03,084120,Harel; Guershon,29,0,30,1
1650011540385,MATH 18,A04,084121,Harel; Guershon,29,0,30,1
1650011546421,MATH 20B,A01,084124,Um; Ko Woon,16,0,35,19
1650011546421,MATH 20B,B01,084126,Um; Ko Woon,24,0,35,11
1650011552450,MATH 20C,A01,083446,Hammock; Frances H,0,0,30,30
1650011552450,MATH 20C,A02,083447,Hammock; Frances H,16,0,30,14
1650011552450,MATH 20C,A03,083448,Hammock; Frances H,20,0,30,10
1650011552450,MATH 20C,A04,083449,Hammock; Frances H,20,0,30,10
1650011552450,MATH 20C,B01,083451,Hammock; Frances H,0,0,30,30
1650011552450,MATH 20C,B02,083452,Hammock; Frances H,19,0,30,11
1650011552450,MATH 20C,B03,083453,Hammock; Frances H,21,0,30,9
1650011552450,MATH 20C,B04,083454,Hammock; Frances H,24,0,30,6
1650011558484,MATH 20D,A01,084128,Staff,14,0,30,16
1650011558484,MATH 20D,A02,084129,Staff,29,0,30,1
1650011558484,MATH 20D,A03,084130,Staff,27,0,30,3
1650011558484,MATH 20D,B01,084133,Staff,3,0,30,27
1650011558484,MATH 20D,B02,084134,Staff,24,0,30,6
1650011558484,MATH 20D,B03,084135,Staff,28,0,30,2
1650011564514,MATH 20E,A01,084138,Staff,13,0,30,17
1650011564514,MATH 20E,A02,084139,Staff,6,0,30,24
1650011564514,MATH 20E,A03,084140,Staff,15,0,30,15
1650011564514,MATH 20E,A04,084141,Staff,20,0,30,10
1650011570543,MATH 102,A01,084143,Harel; Guershon,12,0,30,18
1650011570543,MATH 102,A02,084144,Harel; Guershon,20,0,30,10
1650011576566,MATH 103B,A01,083456,Staff,0,13,30,30
1650011576566,MATH 103B,A02,083457,Staff,0,13,30,30
1650011582591,MATH 109,A01,084146,Salehi Golsefidy; Alireza,18,0,30,12
1650011582591,MATH 109,A02,084147,Salehi Golsefidy; Alireza,15,0,30,15
1650011588620,MATH 120A,A01,085445,Eggers; John Dietrich,10,0,35,25
1650011588620,MATH 120A,A02,085446,Eggers; John Dietrich,27,0,35,8
1650011594645,MATH 142B,A01,084149,Verstraete; Jacques Allan,0,12,30,30
1650011594645,MATH 142B,A02,084150,Verstraete; Jacques Allan,0,12,30,30
1650011600675,MATH 170A,A01,083459,Nie; Jiawang,0,9,30,30
1650011600675,MATH 170A,A02,083460,Nie; Jiawang,0,8,30,30
1650011600675,MATH 170A,A03,083461,Nie; Jiawang,0,9,30,30
1650011606699,MATH 193B,A01,083463,Staff,1,0,30,29
1650011606699,MATH 193B,A02,083464,Staff,9,0,30,21
1650011606699,MATH 193B,A03,083465,Staff,18,0,30,12
1650011612757,COGS 2,A01,083966,Boyle; Mary E. T.,9,0,30,21
1650011618780,COGS 9,A01,083968,Staff,9,0,60,51
1650011624805,COGS 14B,A01,083970,Staff,10,0,50,40
1650011630830,COGS 17,A01,092679,Staff,51,0,75,24
1650011636876,COGS 100,A01,083972,Staff,0,15,60,60
1650011648924,COGS 101C,A01,083976,Staff,12,0,30,18
1650011654948,COGS 102A,A01,083978,Johnson; Christine M.,14,0,30,16
1650011660979,COGS 107B,A01,083980,Staff,0,7,50,50
1650011667006,COGS 115,A01,083982,Staff,10,0,30,20
1650011673030,COGS 118B,A01,083367,Staff,0,15,40,40
1650011679053,COGS 172,A01,083984,Provenzano; Emily Kara,15,0,30,15
1650011685080,COGS 177,A00,083368,Staff,0,20,30,30
1650011691105,COGS 186,A01,083986,Staff,21,0,40,19
1650011697133,COGS 187A,A01,083988,Boyle; Mary E. T.,20,0,60,40
1650011703174,CSE 8A,A50,084003,Miranda; Gregory Joseph,0,13,15,15
1650011709197,CSE 11,A01,084005,Miranda; Gregory Joseph,0,21,55,55
1650011715222,CSE 20,A01,084007,Staff,0,5,20,20
1650011721248,CSE 21,A01,084009,Staff,0,30,50,50
1650011727274,CSE 30,A01,083370,Cao; Yingjun,0,65,40,40
1650011733297,CSE 100,A01,083372,Cao; Yingjun,0,46,40,40
1650011739319,CSE 101,A01,084011,Staff,0,54,40,40
1650011745344,CSE 141,A01,083374,Eldon; John,0,64,75,75
1650011751372,CSE 141L,A01,083376,Eldon; John,0,70,75,75
1650011757399,CSE 175,A01,084013,Kumar; Rakesh,22,0,25,3
1650011763423,CSE 190,A00,092508,Dubnov; Shlomo,20,0,20,0
1650011769447,ECE 5,A01,084049,Morris; Karcher William,13,0,20,7
1650011775472,ECE 100,A01,084051,Baghdadchi; Saharnaz,0,0,20,20
1650011775472,ECE 100,A02,091916,Baghdadchi; Saharnaz,13,0,20,7
1650011781495,ECE 101,A01,084053,Baghdadchi; Saharnaz,0,0,37,37
1650011781495,ECE 101,A02,084054,Baghdadchi; Saharnaz,30,0,37,7
1650011787521,ECE 107,A01,083390,Staff,26,0,40,14
1650011793544,ECE 148,A01,084056,Silberman; Jack,8,0,12,4
1650011799567,ECE 180,A00,083391,Abi Samra; Nicholas Camill,25,0,30,5
1650011799567,ECE 180,B00,083392,Abi Samra; Nicholas Camill,21,0,30,9
1650011805592,MATH 10B,A01,084110,Staff,0,0,30,30
1650011805592,MATH 10B,A02,084111,Staff,18,0,30,12
1650011805592,MATH 10B,A03,084112,Staff,24,0,30,6
1650011811628,MATH 10C,A01,083443,Staff,0,15,30,30
1650011811628,MATH 10C,A02,083444,Staff,0,15,30,30
1650011811628,MATH 10C,B01,084114,Staff,19,0,30,11
1650011811628,MATH 10C,B02,084115,Staff,25,0,30,5
1650011817654,MATH 18,A01,084117,Harel; Guershon,14,0,30,16
1650011817654,MATH 18,A02,084119,Harel; Guershon,28,0,30,2
1650011817654,MATH 18,A03,084120,Harel; Guershon,29,0,30,1
1650011817654,MATH 18,A04,084121,Harel; Guershon,29,0,30,1
1650011823680,MATH 20B,A01,084124,Um; Ko Woon,16,0,35,19
1650011823680,MATH 20B,B01,084126,Um; Ko Woon,24,0,35,11
1650011829703,MATH 20C,A01,083446,Hammock; Frances H,0,0,30,30
1650011829703,MATH 20C,A02,083447,Hammock; Frances H,16,0,30,14
1650011829703,MATH 20C,A03,083448,Hammock; Frances H,20,0,30,10
1650011829703,MATH 20C,A04,083449,Hammock; Frances H,20,0,30,10
1650011829703,MATH 20C,B01,083451,Hammock; Frances H,0,0,30,30
1650011829703,MATH 20C,B02,083452,Hammock; Frances H,19,0,30,11
1650011829703,MATH 20C,B03,083453,Hammock; Frances H,21,0,30,9
1650011829703,MATH 20C,B04,083454,Hammock; Frances H,24,0,30,6
1650011835728,MATH 20D,A01,084128,Staff,14,0,30,16
1650011835728,MATH 20D,A02,084129,Staff,29,0,30,1
1650011835728,MATH 20D,A03,084130,Staff,27,0,30,3
1650011835728,MATH 20D,B01,084133,Staff,3,0,30,27
1650011835728,MATH 20D,B02,084134,Staff,24,0,30,6
1650011835728,MATH 20D,B03,084135,Staff,28,0,30,2
1650011841752,MATH 20E,A01,084138,Staff,13,0,30,17
1650011841752,MATH 20E,A02,084139,Staff,6,0,30,24
1650011841752,MATH 20E,A03,084140,Staff,15,0,30,15
1650011841752,MATH 20E,A04,084141,Staff,20,0,30,10
1650011847779,MATH 102,A01,084143,Harel; Guershon,12,0,30,18
1650011847779,MATH 102,A02,084144,Harel; Guershon,20,0,30,10
1650011853802,MATH 103B,A01,083456,Staff,0,13,30,30
1650011853802,MATH 103B,A02,083457,Staff,0,13,30,30
1650011859826,MATH 109,A01,084146,Salehi Golsefidy; Alireza,18,0,30,12
1650011859826,MATH 109,A02,084147,Salehi Golsefidy; Alireza,15,0,30,15
1650011865856,MATH 120A,A01,085445,Eggers; John Dietrich,10,0,35,25
1650011865856,MATH 120A,A02,085446,Eggers; John Dietrich,27,0,35,8
1650011871883,MATH 142B,A01,084149,Verstraete; Jacques Allan,0,12,30,30
1650011871883,MATH 142B,A02,084150,Verstraete; Jacques Allan,0,12,30,30
1650011878002,MATH 170A,A01,083459,Nie; Jiawang,0,9,30,30
1650011878002,MATH 170A,A02,083460,Nie; Jiawang,0,8,30,30
1650011878002,MATH 170A,A03,083461,Nie; Jiawang,0,9,30,30
1650011884026,MATH 193B,A01,083463,Staff,1,0,30,29
1650011884026,MATH 193B,A02,083464,Staff,9,0,30,21
1650011884026,MATH 193B,A03,083465,Staff,18,0,30,12
1650011890095,COGS 2,A01,083966,Boyle; Mary E. T.,9,0,30,21
1650011896124,COGS 9,A01,083968,Staff,9,0,60,51
1650011902166,COGS 14B,A01,083970,Staff,10,0,50,40
1650011908193,COGS 17,A01,092679,Staff,51,0,75,24
1650011914217,COGS 100,A01,083972,Staff,0,15,60,60
1650011926263,COGS 101C,A01,083976,Staff,12,0,30,18
1650011932291,COGS 102A,A01,083978,Johnson; Christine M.,14,0,30,16
1650011938314,COGS 107B,A01,083980,Staff,0,7,50,50
1650011944341,COGS 115,A01,083982,Staff,10,0,30,20
1650011950366,COGS 118B,A01,083367,Staff,0,15,40,40
1650011956396,COGS 172,A01,083984,Provenzano; Emily Kara,15,0,30,15
1650011962423,COGS 177,A00,083368,Staff,0,20,30,30
1650011968449,COGS 186,A01,083986,Staff,21,0,40,19
1650011974471,COGS 187A,A01,083988,Boyle; Mary E. T.,20,0,60,40
1650011980496,CSE 8A,A50,084003,Miranda; Gregory Joseph,0,13,15,15
1650011986522,CSE 11,A01,084005,Miranda; Gregory Joseph,0,21,55,55
1650011992546,CSE 20,A01,084007,Staff,0,5,20,20
1650011998574,CSE 21,A01,084009,Staff,0,30,50,50
1650012004598,CSE 30,A01,083370,Cao; Yingjun,0,65,40,40
1650012010621,CSE 100,A01,083372,Cao; Yingjun,0,46,40,40
1650012016647,CSE 101,A01,084011,Staff,0,54,40,40
1650012022676,CSE 141,A01,083374,Eldon; John,0,64,75,75
1650012028705,CSE 141L,A01,083376,Eldon; John,0,70,75,75
1650012034731,CSE 175,A01,084013,Kumar; Rakesh,22,0,25,3
1650012040754,CSE 190,A00,092508,Dubnov; Shlomo,20,0,20,0
1650012046779,ECE 5,A01,084049,Morris; Karcher William,13,0,20,7
1650012052806,ECE 100,A01,084051,Baghdadchi; Saharnaz,0,0,20,20
1650012052806,ECE 100,A02,091916,Baghdadchi; Saharnaz,13,0,20,7
1650012058828,ECE 101,A01,084053,Baghdadchi; Saharnaz,0,0,37,37
1650012058828,ECE 101,A02,084054,Baghdadchi; Saharnaz,30,0,37,7
1650012064854,ECE 107,A01,083390,Staff,26,0,40,14
1650012070878,ECE 148,A01,084056,Silberman; Jack,8,0,12,4
1650012076907,ECE 180,A00,083391,Abi Samra; Nicholas Camill,25,0,30,5
1650012076907,ECE 180,B00,083392,Abi Samra; Nicholas Camill,21,0,30,9
1650012082932,MATH 10B,A01,084110,Staff,0,0,30,30
1650012082932,MATH 10B,A02,084111,Staff,18,0,30,12
1650012082932,MATH 10B,A03,084112,Staff,24,0,30,6
1650012088957,MATH 10C,A01,083443,Staff,0,15,30,30
1650012088957,MATH 10C,A02,083444,Staff,0,15,30,30
1650012088957,MATH 10C,B01,084114,Staff,19,0,30,11
1650012088957,MATH 10C,B02,084115,Staff,25,0,30,5
1650012094981,MATH 18,A01,084117,Harel; Guershon,14,0,30,16
1650012094981,MATH 18,A02,084119,Harel; Guershon,28,0,30,2
1650012094981,MATH 18,A03,084120,Harel; Guershon,29,0,30,1
1650012094981,MATH 18,A04,084121,Harel; Guershon,29,0,30,1
1650012101016,MATH 20B,A01,084124,Um; Ko Woon,16,0,35,19
1650012101016,MATH 20B,B01,084126,Um; Ko Woon,24,0,35,11
1650012107042,MATH 20C,A01,083446,Hammock; Frances H,0,0,30,30
1650012107042,MATH 20C,A02,083447,Hammock; Frances H,16,0,30,14
1650012107042,MATH 20C,A03,083448,Hammock; Frances H,20,0,30,10
1650012107042,MATH 20C,A04,083449,Hammock; Frances H,20,0,30,10
1650012107042,MATH 20C,B01,083451,Hammock; Frances H,0,0,30,30
1650012107042,MATH 20C,B02,083452,Hammock; Frances H,19,0,30,11
1650012107042,MATH 20C,B03,083453,Hammock; Frances H,21,0,30,9
1650012107042,MATH 20C,B04,083454,Hammock; Frances H,24,0,30,6
1650012113074,MATH 20D,A01,084128,Staff,14,0,30,16
1650012113074,MATH 20D,A02,084129,Staff,29,0,30,1
1650012113074,MATH 20D,A03,084130,Staff,27,0,30,3
1650012113074,MATH 20D,B01,084133,Staff,3,0,30,27
1650012113074,MATH 20D,B02,084134,Staff,24,0,30,6
1650012113074,MATH 20D,B03,084135,Staff,28,0,30,2
1650012119112,MATH 20E,A01,084138,Staff,14,0,30,16
1650012119112,MATH 20E,A02,084139,Staff,6,0,30,24
1650012119112,MATH 20E,A03,084140,Staff,15,0,30,15
1650012119112,MATH 20E,A04,084141,Staff,20,0,30,10
1650012125144,MATH 102,A01,084143,Harel; Guershon,12,0,30,18
1650012125144,MATH 102,A02,084144,Harel; Guershon,20,0,30,10
1650012131170,MATH 103B,A01,083456,Staff,0,13,30,30
1650012131170,MATH 103B,A02,083457,Staff,0,13,30,30
1650012137196,MATH 109,A01,084146,Salehi Golsefidy; Alireza,18,0,30,12
1650012137196,MATH 109,A02,084147,Salehi Golsefidy; Alireza,15,0,30,15
1650012143223,MATH 120A,A01,085445,Eggers; John Dietrich,10,0,35,25
1650012143223,MATH 120A,A02,085446,Eggers; John Dietrich,27,0,35,8
1650012149253,MATH 142B,A01,084149,Verstraete; Jacques Allan,0,12,30,30
1650012149253,MATH 142B,A02,084150,Verstraete; Jacques Allan,0,12,30,30
1650012155278,MATH 170A,A01,083459,Nie; Jiawang,0,9,30,30
1650012155278,MATH 170A,A02,083460,Nie; Jiawang,0,8,30,30
1650012155278,MATH 170A,A03,083461,Nie; Jiawang,0,9,30,30
1650012161306,MATH 193B,A01,083463,Staff,1,0,30,29
1650012161306,MATH 193B,A02,083464,Staff,9,0,30,21
1650012161306,MATH 193B,A03,083465,Staff,18,0,30,12
1650012167370,COGS 2,A01,083966,Boyle; Mary E. T.,9,0,30,21
1650012173397,COGS 9,A01,083968,Staff,9,0,60,51
1650012179429,COGS 14B,A01,083970,Staff,10,0,50,40
1650012185452,COGS 17,A01,092679,Staff,51,0,75,24
1650012191480,COGS 100,A01,083972,Staff,0,15,60,60
1650012203537,COGS 101C,A01,083976,Staff,12,0,30,18
1650012209562,COGS 102A,A01,083978,Johnson; Christine M.,14,0,30,16
1650012215586,COGS 107B,A01,083980,Staff,0,7,50,50
1650012221613,COGS 115,A01,083982,Staff,10,0,30,20
1650012227639,COGS 118B,A01,083367,Staff,0,15,40,40
1650012233663,COGS 172,A01,083984,Provenzano; Emily Kara,15,0,30,15
1650012239688,COGS 177,A00,083368,Staff,0,20,30,30
1650012245712,COGS 186,A01,083986,Staff,21,0,40,19
1650012251750,COGS 187A,A01,083988,Boyle; Mary E. T.,20,0,60,40
1650012257780,CSE 8A,A50,084003,Miranda; Gregory Joseph,0,13,15,15
1650012263802,CSE 11,A01,084005,Miranda; Gregory Joseph,0,21,55,55
1650012269826,CSE 20,A01,084007,Staff,0,5,20,20
1650012275852,CSE 21,A01,084009,Staff,0,30,50,50
1650012281878,CSE 30,A01,083370,Cao; Yingjun,0,65,40,40
1650012287902,CSE 100,A01,083372,Cao; Yingjun,0,46,40,40
1650012293926,CSE 101,A01,084011,Staff,0,54,40,40
1650012299952,CSE 141,A01,083374,Eldon; John,0,64,75,75
1650012305978,CSE 141L,A01,083376,Eldon; John,0,70,75,75
1650012312001,CSE 175,A01,084013,Kumar; Rakesh,22,0,25,3
1650012318032,CSE 190,A00,092508,Dubnov; Shlomo,20,0,20,0
1650012324062,ECE 5,A01,084049,Morris; Karcher William,13,0,20,7
1650012330092,ECE 100,A01,084051,Baghdadchi; Saharnaz,0,0,20,20
1650012330092,ECE 100,A02,091916,Baghdadchi; Saharnaz,13,0,20,7
1650012336117,ECE 101,A01,084053,Baghdadchi; Saharnaz,0,0,37,37
1650012336117,ECE 101,A02,084054,Baghdadchi; Saharnaz,30,0,37,7
1650012342145,ECE 107,A01,083390,Staff,26,0,40,14
1650012348170,ECE 148,A01,084056,Silberman; Jack,8,0,12,4
1650012354194,ECE 180,A00,083391,Abi Samra; Nicholas Camill,25,0,30,5
1650012354194,ECE 180,B00,083392,Abi Samra; Nicholas Camill,21,0,30,9
1650012360227,MATH 10B,A01,084110,Staff,0,0,30,30
1650012360227,MATH 10B,A02,084111,Staff,18,0,30,12
1650012360227,MATH 10B,A03,084112,Staff,24,0,30,6
1650012366251,MATH 10C,A01,083443,Staff,0,15,30,30
1650012366251,MATH 10C,A02,083444,Staff,0,15,30,30
1650012366251,MATH 10C,B01,084114,Staff,19,0,30,11
1650012366251,MATH 10C,B02,084115,Staff,25,0,30,5
1650012372282,MATH 18,A01,084117,Harel; Guershon,14,0,30,16
1650012372282,MATH 18,A02,084119,Harel; Guershon,28,0,30,2
1650012372282,MATH 18,A03,084120,Harel; Guershon,29,0,30,1
1650012372282,MATH 18,A04,084121,Harel; Guershon,29,0,30,1
1650012378313,MATH 20B,A01,084124,Um; Ko Woon,16,0,35,19
1650012378313,MATH 20B,B01,084126,Um; Ko Woon,24,0,35,11
1650012384348,MATH 20C,A01,083446,Hammock; Frances H,0,0,30,30
1650012384348,MATH 20C,A02,083447,Hammock; Frances H,16,0,30,14
1650012384348,MATH 20C,A03,083448,Hammock; Frances H,20,0,30,10
1650012384348,MATH 20C,A04,083449,Hammock; Frances H,20,0,30,10
1650012384348,MATH 20C,B01,083451,Hammock; Frances H,0,0,30,30
1650012384348,MATH 20C,B02,083452,Hammock; Frances H,19,0,30,11
1650012384348,MATH 20C,B03,083453,Hammock; Frances H,21,0,30,9
1650012384348,MATH 20C,B04,083454,Hammock; Frances H,24,0,30,6
1650012390375,MATH 20D,A01,084128,Staff,14,0,30,16
1650012390375,MATH 20D,A02,084129,Staff,29,0,30,1
1650012390375,MATH 20D,A03,084130,Staff,27,0,30,3
1650012390375,MATH 20D,B01,084133,Staff,3,0,30,27
1650012390375,MATH 20D,B02,084134,Staff,24,0,30,6
1650012390375,MATH 20D,B03,084135,Staff,28,0,30,2
1650012396397,MATH 20E,A01,084138,Staff,14,0,30,16
1650012396397,MATH 20E,A02,084139,Staff,6,0,30,24
1650012396397,MATH 20E,A03,084140,Staff,15,0,30,15
1650012396397,MATH 20E,A04,084141,Staff,20,0,30,10
1650012402431,MATH 102,A01,084143,Harel; Guershon,12,0,30,18
1650012402431,MATH 102,A02,084144,Harel; Guershon,20,0,30,10
1650012408456,MATH 103B,A01,083456,Staff,0,13,30,30
1650012408456,MATH 103B,A02,083457,Staff,0,13,30,30
1650012414487,MATH 109,A01,084146,Salehi Golsefidy; Alireza,18,0,30,12
1650012414487,MATH 109,A02,084147,Salehi Golsefidy; Alireza,15,0,30,15
1650012420512,MATH 120A,A01,085445,Eggers; John Dietrich,10,0,35,25
1650012420512,MATH 120A,A02,085446,Eggers; John Dietrich,27,0,35,8
1650012426538,MATH 142B,A01,084149,Verstraete; Jacques Allan,0,12,30,30
1650012426538,MATH 142B,A02,084150,Verstraete; Jacques Allan,0,12,30,30
1650012432568,MATH 170A,A01,083459,Nie; Jiawang,0,9,30,30
1650012432568,MATH 170A,A02,083460,Nie; Jiawang,0,8,30,30
1650012432568,MATH 170A,A03,083461,Nie; Jiawang,0,9,30,30
1650012438594,MATH 193B,A01,083463,Staff,1,0,30,29
1650012438594,MATH 193B,A02,083464,Staff,9,0,30,21
1650012438594,MATH 193B,A03,083465,Staff,18,0,30,12
1650012444654,COGS 2,A01,083966,Boyle; Mary E. T.,9,0,30,21
1650012450678,COGS 9,A01,083968,Staff,9,0,60,51
1650012456711,COGS 14B,A01,083970,Staff,10,0,50,40
1650012462736,COGS 17,A01,092679,Staff,51,0,75,24
1650012468849,COGS 100,A01,083972,Staff,0,15,60,60
1650012480904,COGS 101C,A01,083976,Staff,12,0,30,18
1650012486929,COGS 102A,A01,083978,Johnson; Christine M.,14,0,30,16
1650012492956,COGS 107B,A01,083980,Staff,0,7,50,50
1650012498983,COGS 115,A01,083982,Staff,10,0,30,20
1650012505007,COGS 118B,A01,083367,Staff,0,15,40,40
1650012511037,COGS 172,A01,083984,Provenzano; Emily Kara,15,0,30,15
1650012517061,COGS 177,A00,083368,Staff,0,20,30,30
1650012523089,COGS 186,A01,083986,Staff,21,0,40,19
1650012529113,COGS 187A,A01,083988,Boyle; Mary E. T.,20,0,60,40
1650012535138,CSE 8A,A50,084003,Miranda; Gregory Joseph,0,13,15,15
1650012541161,CSE 11,A01,084005,Miranda; Gregory Joseph,0,21,55,55
1650012547186,CSE 20,A01,084007,Staff,0,5,20,20
1650012553212,CSE 21,A01,084009,Staff,0,30,50,50
1650012559236,CSE 30,A01,083370,Cao; Yingjun,0,65,40,40
1650012565260,CSE 100,A01,083372,Cao; Yingjun,0,46,40,40
1650012571283,CSE 101,A01,084011,Staff,0,54,40,40
1650012577309,CSE 141,A01,083374,Eldon; John,0,64,75,75
1650012583339,CSE 141L,A01,083376,Eldon; John,0,70,75,75
1650012589363,CSE 175,A01,084013,Kumar; Rakesh,22,0,25,3
1650012595390,CSE 190,A00,092508,Dubnov; Shlomo,20,0,20,0
1650012601420,ECE 5,A01,084049,Morris; Karcher William,13,0,20,7
1650012607443,ECE 100,A01,084051,Baghdadchi; Saharnaz,0,0,20,20
1650012607443,ECE 100,A02,091916,Baghdadchi; Saharnaz,13,0,20,7
1650012613474,ECE 101,A01,084053,Baghdadchi; Saharnaz,0,0,37,37
1650012613474,ECE 101,A02,084054,Baghdadchi; Saharnaz,30,0,37,7
1650012619512,ECE 107,A01,083390,Staff,26,0,40,14
1650012625559,ECE 148,A01,084056,Silberman; Jack,8,0,12,4
1650012631583,ECE 180,A00,083391,Abi Samra; Nicholas Camill,25,0,30,5
1650012631583,ECE 180,B00,083392,Abi Samra; Nicholas Camill,21,0,30,9
1650012637611,MATH 10B,A01,084110,Staff,0,0,30,30
1650012637611,MATH 10B,A02,084111,Staff,18,0,30,12
1650012637611,MATH 10B,A03,084112,Staff,24,0,30,6
1650012643643,MATH 10C,A01,083443,Staff,0,15,30,30
1650012643643,MATH 10C,A02,083444,Staff,0,15,30,30
1650012643643,MATH 10C,B01,084114,Staff,19,0,30,11
1650012643643,MATH 10C,B02,084115,Staff,25,0,30,5
1650012649671,MATH 18,A01,084117,Harel; Guershon,14,0,30,16
1650012649671,MATH 18,A02,084119,Harel; Guershon,28,0,30,2
1650012649671,MATH 18,A03,084120,Harel; Guershon,29,0,30,1
1650012649671,MATH 18,A04,084121,Harel; Guershon,29,0,30,1
1650012655696,MATH 20B,A01,084124,Um; Ko Woon,16,0,35,19
1650012655696,MATH 20B,B01,084126,Um; Ko Woon,24,0,35,11
1650012661750,MATH 20C,A01,083446,Hammock; Frances H,0,0,30,30
1650012661750,MATH 20C,A02,083447,Hammock; Frances H,16,0,30,14
1650012661750,MATH 20C,A03,083448,Hammock; Frances H,20,0,30,10
1650012661750,MATH 20C,A04,083449,Hammock; Frances H,20,0,30,10
1650012661750,MATH 20C,B01,083451,Hammock; Frances H,0,0,30,30
1650012661750,MATH 20C,B02,083452,Hammock; Frances H,19,0,30,11
1650012661750,MATH 20C,B03,083453,Hammock; Frances H,21,0,30,9
1650012661750,MATH 20C,B04,083454,Hammock; Frances H,24,0,30,6
1650012667776,MATH 20D,A01,084128,Staff,14,0,30,16
1650012667776,MATH 20D,A02,084129,Staff,29,0,30,1
1650012667776,MATH 20D,A03,084130,Staff,27,0,30,3
1650012667776,MATH 20D,B01,084133,Staff,3,0,30,27
1650012667776,MATH 20D,B02,084134,Staff,24,0,30,6
1650012667776,MATH 20D,B03,084135,Staff,28,0,30,2
1650012673801,MATH 20E,A01,084138,Staff,14,0,30,16
1650012673801,MATH 20E,A02,084139,Staff,6,0,30,24
1650012673801,MATH 20E,A03,084140,Staff,15,0,30,15
1650012673801,MATH 20E,A04,084141,Staff,20,0,30,10
1650012679827,MATH 102,A01,084143,Harel; Guershon,12,0,30,18
1650012679827,MATH 102,A02,084144,Harel; Guershon,20,0,30,10
1650012685851,MATH 103B,A01,083456,Staff,0,13,30,30
1650012685851,MATH 103B,A02,083457,Staff,0,13,30,30
1650012691880,MATH 109,A01,084146,Salehi Golsefidy; Alireza,18,0,30,12
1650012691880,MATH 109,A02,084147,Salehi Golsefidy; Alireza,15,0,30,15
1650012697909,MATH 120A,A01,085445,Eggers; John Dietrich,10,0,35,25
1650012697909,MATH 120A,A02,085446,Eggers; John Dietrich,27,0,35,8
1650012703934,MATH 142B,A01,084149,Verstraete; Jacques Allan,0,12,30,30
1650012703934,MATH 142B,A02,084150,Verstraete; Jacques Allan,0,12,30,30
1650012709958,MATH 170A,A01,083459,Nie; Jiawang,0,9,30,30
1650012709958,MATH 170A,A02,083460,Nie; Jiawang,0,8,30,30
1650012709958,MATH 170A,A03,083461,Nie; Jiawang,0,9,30,30
1650012715982,MATH 193B,A01,083463,Staff,1,0,30,29
1650012715982,MATH 193B,A02,083464,Staff,9,0,30,21
1650012715982,MATH 193B,A03,083465,Staff,18,0,30,12
1650012722037,COGS 2,A01,083966,Boyle; Mary E. T.,9,0,30,21
1650012728062,COGS 9,A01,083968,Staff,9,0,60,51
1650012734090,COGS 14B,A01,083970,Staff,10,0,50,40
1650012740114,COGS 17,A01,092679,Staff,51,0,75,24
1650012746137,COGS 100,A01,083972,Staff,0,15,60,60
1650012758184,COGS 101C,A01,083976,Staff,12,0,30,18
1650012764207,COGS 102A,A01,083978,Johnson; Christine M.,14,0,30,16
1650012770235,COGS 107B,A01,083980,Staff,0,7,50,50
1650012776257,COGS 115,A01,083982,Staff,10,0,30,20
1650012782281,COGS 118B,A01,083367,Staff,0,15,40,40
1650012788314,COGS 172,A01,083984,Provenzano; Emily Kara,15,0,30,15
1650012794341,COGS 177,A00,083368,Staff,0,20,30,30
1650012800369,COGS 186,A01,083986,Staff,21,0,40,19
1650012806394,COGS 187A,A01,083988,Boyle; Mary E. T.,20,0,60,40
1650012812421,CSE 8A,A50,084003,Miranda; Gregory Joseph,0,13,15,15
1650012818449,CSE 11,A01,084005,Miranda; Gregory Joseph,0,22,55,55
1650012824476,CSE 20,A01,084007,Staff,0,5,20,20
1650012830499,CSE 21,A01,084009,Staff,0,30,50,50
1650012836526,CSE 30,A01,083370,Cao; Yingjun,0,65,40,40
1650012842549,CSE 100,A01,083372,Cao; Yingjun,0,46,40,40
1650012848574,CSE 101,A01,084011,Staff,0,54,40,40
1650012854602,CSE 141,A01,083374,Eldon; John,0,64,75,75
1650012860629,CSE 141L,A01,083376,Eldon; John,0,70,75,75
1650012866656,CSE 175,A01,084013,Kumar; Rakesh,22,0,25,3
1650012872679,CSE 190,A00,092508,Dubnov; Shlomo,20,0,20,0
1650012878703,ECE 5,A01,084049,Morris; Karcher William,13,0,20,7
1650012884728,ECE 100,A01,084051,Baghdadchi; Saharnaz,0,0,20,20
1650012884728,ECE 100,A02,091916,Baghdadchi; Saharnaz,13,0,20,7
1650012890756,ECE 101,A01,084053,Baghdadchi; Saharnaz,0,0,37,37
1650012890756,ECE 101,A02,084054,Baghdadchi; Saharnaz,30,0,37,7
1650012896784,ECE 107,A01,083390,Staff,26,0,40,14
1650012902816,ECE 148,A01,084056,Silberman; Jack,8,0,12,4
1650012908852,ECE 180,A00,083391,Abi Samra; Nicholas Camill,25,0,30,5
1650012908852,ECE 180,B00,083392,Abi Samra; Nicholas Camill,21,0,30,9
1650012914880,MATH 10B,A01,084110,Staff,0,0,30,30
1650012914880,MATH 10B,A02,084111,Staff,18,0,30,12
1650012914880,MATH 10B,A03,084112,Staff,24,0,30,6
1650012920905,MATH 10C,A01,083443,Staff,0,15,30,30
1650012920905,MATH 10C,A02,083444,Staff,0,15,30,30
1650012920905,MATH 10C,B01,084114,Staff,19,0,30,11
1650012920905,MATH 10C,B02,084115,Staff,25,0,30,5
1650012926931,MATH 18,A01,084117,Harel; Guershon,14,0,30,16
1650012926931,MATH 18,A02,084119,Harel; Guershon,28,0,30,2
1650012926931,MATH 18,A03,084120,Harel; Guershon,29,0,30,1
1650012926931,MATH 18,A04,084121,Harel; Guershon,29,0,30,1
1650012932955,MATH 20B,A01,084124,Um; Ko Woon,16,0,35,19
1650012932955,MATH 20B,B01,084126,Um; Ko Woon,24,0,35,11
1650012938987,MATH 20C,A01,083446,Hammock; Frances H,0,0,30,30
1650012938987,MATH 20C,A02,083447,Hammock; Frances H,16,0,30,14
1650012938987,MATH 20C,A03,083448,Hammock; Frances H,20,0,30,10
1650012938987,MATH 20C,A04,083449,Hammock; Frances H,20,0,30,10
1650012938987,MATH 20C,B01,083451,Hammock; Frances H,0,0,30,30
1650012938987,MATH 20C,B02,083452,Hammock; Frances H,19,0,30,11
1650012938987,MATH 20C,B03,083453,Hammock; Frances H,21,0,30,9
1650012938987,MATH 20C,B04,083454,Hammock; Frances H,24,0,30,6
1650012945017,MATH 20D,A01,084128,Staff,14,0,30,16
1650012945017,MATH 20D,A02,084129,Staff,29,0,30,1
1650012945017,MATH 20D,A03,084130,Staff,27,0,30,3
1650012945017,MATH 20D,B01,084133,Staff,3,0,30,27
1650012945017,MATH 20D,B02,084134,Staff,24,0,30,6
1650012945017,MATH 20D,B03,084135,Staff,28,0,30,2
1650012951044,MATH 20E,A01,084138,Staff,14,0,30,16
1650012951044,MATH 20E,A02,084139,Staff,6,0,30,24
1650012951044,MATH 20E,A03,084140,Staff,15,0,30,15
1650012951044,MATH 20E,A04,084141,Staff,20,0,30,10
1650012957066,MATH 102,A01,084143,Harel; Guershon,12,0,30,18
1650012957066,MATH 102,A02,084144,Harel; Guershon,20,0,30,10
1650012963093,MATH 103B,A01,083456,Staff,0,13,30,30
1650012963093,MATH 103B,A02,083457,Staff,0,13,30,30
1650012969118,MATH 109,A01,084146,Salehi Golsefidy; Alireza,18,0,30,12
1650012969118,MATH 109,A02,084147,Salehi Golsefidy; Alireza,15,0,30,15
1650012975141,MATH 120A,A01,085445,Eggers; John Dietrich,10,0,35,25
1650012975141,MATH 120A,A02,085446,Eggers; John Dietrich,27,0,35,8
1650012981168,MATH 142B,A01,084149,Verstraete; Jacques Allan,0,12,30,30
1650012981168,MATH 142B,A02,084150,Verstraete; Jacques Allan,0,12,30,30
1650012987191,MATH 170A,A01,083459,Nie; Jiawang,0,9,30,30
1650012987191,MATH 170A,A02,083460,Nie; Jiawang,0,8,30,30
1650012987191,MATH 170A,A03,083461,Nie; Jiawang,0,9,30,30
1650012993213,MATH 193B,A01,083463,Staff,1,0,30,29
1650012993213,MATH 193B,A02,083464,Staff,9,0,30,21
1650012993213,MATH 193B,A03,083465,Staff,18,0,30,12
1650012999281,COGS 2,A01,083966,Boyle; Mary E. T.,9,0,30,21
1650013005305,COGS 9,A01,083968,Staff,9,0,60,51
1650013011329,COGS 14B,A01,083970,Staff,10,0,50,40
1650013017352,COGS 17,A01,092679,Staff,51,0,75,24
1650013023380,COGS 100,A01,083972,Staff,0,15,60,60
1650013035432,COGS 101C,A01,083976,Staff,12,0,30,18
1650013041466,COGS 102A,A01,083978,Johnson; Christine M.,14,0,30,16
1650013047492,COGS 107B,A01,083980,Staff,0,7,50,50
1650013053516,COGS 115,A01,083982,Staff,10,0,30,20
1650013059542,COGS 118B,A01,083367,Staff,0,15,40,40
1650013065662,COGS 172,A01,083984,Provenzano; Emily Kara,15,0,30,15
1650013071688,COGS 177,A00,083368,Staff,0,20,30,30
1650013077716,COGS 186,A01,083986,Staff,21,0,40,19
1650013083740,COGS 187A,A01,083988,Boyle; Mary E. T.,20,0,60,40
1650013089764,CSE 8A,A50,084003,Miranda; Gregory Joseph,0,13,15,15
1650013095788,CSE 11,A01,084005,Miranda; Gregory Joseph,0,22,55,55
1650013101816,CSE 20,A01,084007,Staff,0,5,20,20
1650013107842,CSE 21,A01,084009,Staff,0,30,50,50
1650013113865,CSE 30,A01,083370,Cao; Yingjun,0,65,40,40
1650013119893,CSE 100,A01,083372,Cao; Yingjun,0,46,40,40
1650013125918,CSE 101,A01,084011,Staff,0,54,40,40
1650013131950,CSE 141,A01,083374,Eldon; John,0,64,75,75
1650013137974,CSE 141L,A01,083376,Eldon; John,0,70,75,75
1650013144010,CSE 175,A01,084013,Kumar; Rakesh,22,0,25,3
1650013150034,CSE 190,A00,092508,Dubnov; Shlomo,20,0,20,0
1650013156059,ECE 5,A01,084049,Morris; Karcher William,13,0,20,7
1650013162084,ECE 100,A01,084051,Baghdadchi; Saharnaz,0,0,20,20
1650013162084,ECE 100,A02,091916,Baghdadchi; Saharnaz,13,0,20,7
1650013168107,ECE 101,A01,084053,Baghdadchi; Saharnaz,0,0,37,37
1650013168107,ECE 101,A02,084054,Baghdadchi; Saharnaz,30,0,37,7
1650013174135,ECE 107,A01,083390,Staff,26,0,40,14
1650013180164,ECE 148,A01,084056,Silberman; Jack,8,0,12,4
1650013186189,ECE 180,A00,083391,Abi Samra; Nicholas Camill,25,0,30,5
1650013186189,ECE 180,B00,083392,Abi Samra; Nicholas Camill,21,0,30,9
1650013192221,MATH 10B,A01,084110,Staff,0,0,30,30
1650013192221,MATH 10B,A02,084111,Staff,18,0,30,12
1650013192221,MATH 10B,A03,084112,Staff,24,0,30,6
1650013198242,MATH 10C,A01,083443,Staff,0,15,30,30
1650013198242,MATH 10C,A02,083444,Staff,0,15,30,30
1650013198242,MATH 10C,B01,084114,Staff,19,0,30,11
1650013198242,MATH 10C,B02,084115,Staff,25,0,30,5
1650013204271,MATH 18,A01,084117,Harel; Guershon,14,0,30,16
1650013204271,MATH 18,A02,084119,Harel; Guershon,28,0,30,2
1650013204271,MATH 18,A03,084120,Harel; Guershon,29,0,30,1
1650013204271,MATH 18,A04,084121,Harel; Guershon,29,0,30,1
1650013210296,MATH 20B,A01,084124,Um; Ko Woon,16,0,35,19
1650013210296,MATH 20B,B01,084126,Um; Ko Woon,24,0,35,11
1650013216321,MATH 20C,A01,083446,Hammock; Frances H,0,0,30,30
1650013216321,MATH 20C,A02,083447,Hammock; Frances H,16,0,30,14
1650013216321,MATH 20C,A03,083448,Hammock; Frances H,20,0,30,10
1650013216321,MATH 20C,A04,083449,Hammock; Frances H,20,0,30,10
1650013216321,MATH 20C,B01,083451,Hammock; Frances H,0,0,30,30
1650013216321,MATH 20C,B02,083452,Hammock; Frances H,19,0,30,11
1650013216321,MATH 20C,B03,083453,Hammock; Frances H,21,0,30,9
1650013216321,MATH 20C,B04,083454,Hammock; Frances H,23,0,30,7
1650013222345,MATH 20D,A01,084128,Staff,14,0,30,16
1650013222345,MATH 20D,A02,084129,Staff,29,0,30,1
1650013222345,MATH 20D,A03,084130,Staff,27,0,30,3
1650013222345,MATH 20D,B01,084133,Staff,3,0,30,27
1650013222345,MATH 20D,B02,084134,Staff,24,0,30,6
1650013222345,MATH 20D,B03,084135,Staff,28,0,30,2
1650013228371,MATH 20E,A01,084138,Staff,14,0,30,16
1650013228371,MATH 20E,A02,084139,Staff,6,0,30,24
1650013228371,MATH 20E,A03,084140,Staff,15,0,30,15
1650013228371,MATH 20E,A04,084141,Staff,20,0,30,10
1650013234395,MATH 102,A01,084143,Harel; Guershon,12,0,30,18
1650013234395,MATH 102,A02,084144,Harel; Guershon,20,0,30,10
1650013240422,MATH 103B,A01,083456,Staff,0,13,30,30
1650013240422,MATH 103B,A02,083457,Staff,0,13,30,30
1650013246446,MATH 109,A01,084146,Salehi Golsefidy; Alireza,18,0,30,12
1650013246446,MATH 109,A02,084147,Salehi Golsefidy; Alireza,15,0,30,15
1650013252470,MATH 120A,A01,085445,Eggers; John Dietrich,10,0,35,25
1650013252470,MATH 120A,A02,085446,Eggers; John Dietrich,27,0,35,8
1650013258499,MATH 142B,A01,084149,Verstraete; Jacques Allan,0,12,30,30
1650013258499,MATH 142B,A02,084150,Verstraete; Jacques Allan,0,12,30,30
1650013264524,MATH 170A,A01,083459,Nie; Jiawang,0,9,30,30
1650013264524,MATH 170A,A02,083460,Nie; Jiawang,0,8,30,30
1650013264524,MATH 170A,A03,083461,Nie; Jiawang,0,9,30,30
1650013270548,MATH 193B,A01,083463,Staff,1,0,30,29
1650013270548,MATH 193B,A02,083464,Staff,9,0,30,21
1650013270548,MATH 193B,A03,083465,Staff,18,0,30,12
1650013276611,COGS 2,A01,083966,Boyle; Mary E. T.,9,0,30,21
1650013282635,COGS 9,A01,083968,Staff,9,0,60,51
1650013288664,COGS 14B,A01,083970,Staff,10,0,50,40
1650013294688,COGS 17,A01,092679,Staff,51,0,75,24
1650013300729,COGS 100,A01,083972,Staff,0,15,60,60
1650013312786,COGS 101C,A01,083976,Staff,12,0,30,18
1650013318811,COGS 102A,A01,083978,Johnson; Christine M.,14,0,30,16
1650013324836,COGS 107B,A01,083980,Staff,0,7,50,50
1650013330864,COGS 115,A01,083982,Staff,10,0,30,20
1650013336893,COGS 118B,A01,083367,Staff,0,15,40,40
1650013342918,COGS 172,A01,083984,Provenzano; Emily Kara,15,0,30,15
1650013348941,COGS 177,A00,083368,Staff,0,20,30,30
1650013354965,COGS 186,A01,083986,Staff,21,0,40,19
1650013360995,COGS 187A,A01,083988,Boyle; Mary E. T.,20,0,60,40
1650013367023,CSE 8A,A50,084003,Miranda; Gregory Joseph,0,13,15,15
1650013373048,CSE 11,A01,084005,Miranda; Gregory Joseph,0,22,55,55
1650013379073,CSE 20,A01,084007,Staff,0,5,20,20
1650013385097,CSE 21,A01,084009,Staff,0,30,50,50
1650013391128,CSE 30,A01,083370,Cao; Yingjun,0,65,40,40
1650013397157,CSE 100,A01,083372,Cao; Yingjun,0,46,40,40
1650013403181,CSE 101,A01,084011,Staff,0,54,40,40
1650013409215,CSE 141,A01,083374,Eldon; John,0,64,75,75
1650013415242,CSE 141L,A01,083376,Eldon; John,0,70,75,75
1650013421267,CSE 175,A01,084013,Kumar; Rakesh,22,0,25,3
1650013427293,CSE 190,A00,092508,Dubnov; Shlomo,20,0,20,0
1650013433321,ECE 5,A01,084049,Morris; Karcher William,13,0,20,7
1650013439350,ECE 100,A01,084051,Baghdadchi; Saharnaz,0,0,20,20
1650013439350,ECE 100,A02,091916,Baghdadchi; Saharnaz,13,0,20,7
1650013445375,ECE 101,A01,084053,Baghdadchi; Saharnaz,0,0,37,37
1650013445375,ECE 101,A02,084054,Baghdadchi; Saharnaz,30,0,37,7
1650013451403,ECE 107,A01,083390,Staff,26,0,40,14
1650013457432,ECE 148,A01,084056,Silberman; Jack,8,0,12,4
1650013463461,ECE 180,A00,083391,Abi Samra; Nicholas Camill,25,0,30,5
1650013463461,ECE 180,B00,083392,Abi Samra; Nicholas Camill,21,0,30,9
1650013469490,MATH 10B,A01,084110,Staff,0,0,30,30
1650013469490,MATH 10B,A02,084111,Staff,18,0,30,12
1650013469490,MATH 10B,A03,084112,Staff,24,0,30,6
1650013475517,MATH 10C,A01,083443,Staff,0,15,30,30
1650013475517,MATH 10C,A02,083444,Staff,0,15,30,30
1650013475517,MATH 10C,B01,084114,Staff,19,0,30,11
1650013475517,MATH 10C,B02,084115,Staff,25,0,30,5
1650013481543,MATH 18,A01,084117,Harel; Guershon,14,0,30,16
1650013481543,MATH 18,A02,084119,Harel; Guershon,28,0,30,2
1650013481543,MATH 18,A03,084120,Harel; Guershon,29,0,30,1
1650013481543,MATH 18,A04,084121,Harel; Guershon,29,0,30,1
1650013487570,MATH 20B,A01,084124,Um; Ko Woon,16,0,35,19
1650013487570,MATH 20B,B01,084126,Um; Ko Woon,24,0,35,11
1650013493594,MATH 20C,A01,083446,Hammock; Frances H,0,0,30,30
1650013493594,MATH 20C,A02,083447,Hammock; Frances H,16,0,30,14
1650013493594,MATH 20C,A03,083448,Hammock; Frances H,20,0,30,10
1650013493594,MATH 20C,A04,083449,Hammock; Frances H,20,0,30,10
1650013493594,MATH 20C,B01,083451,Hammock; Frances H,0,0,30,30
1650013493594,MATH 20C,B02,083452,Hammock; Frances H,19,0,30,11
1650013493594,MATH 20C,B03,083453,Hammock; Frances H,21,0,30,9
1650013493594,MATH 20C,B04,083454,Hammock; Frances H,23,0,30,7
1650013499623,MATH 20D,A01,084128,Staff,14,0,30,16
1650013499623,MATH 20D,A02,084129,Staff,29,0,30,1
1650013499623,MATH 20D,A03,084130,Staff,27,0,30,3
1650013499623,MATH 20D,B01,084133,Staff,3,0,30,27
1650013499623,MATH 20D,B02,084134,Staff,24,0,30,6
1650013499623,MATH 20D,B03,084135,Staff,28,0,30,2
1650013505650,MATH 20E,A01,084138,Staff,14,0,30,16
1650013505650,MATH 20E,A02,084139,Staff,6,0,30,24
1650013505650,MATH 20E,A03,084140,Staff,15,0,30,15
1650013505650,MATH 20E,A04,084141,Staff,20,0,30,10
1650013511675,MATH 102,A01,084143,Harel; Guershon,12,0,30,18
1650013511675,MATH 102,A02,084144,Harel; Guershon,20,0,30,10
1650013517703,MATH 103B,A01,083456,Staff,0,13,30,30
1650013517703,MATH 103B,A02,083457,Staff,0,13,30,30
1650013523729,MATH 109,A01,084146,Salehi Golsefidy; Alireza,18,0,30,12
1650013523729,MATH 109,A02,084147,Salehi Golsefidy; Alireza,15,0,30,15
1650013529760,MATH 120A,A01,085445,Eggers; John Dietrich,10,0,35,25
1650013529760,MATH 120A,A02,085446,Eggers; John Dietrich,27,0,35,8
1650013535786,MATH 142B,A01,084149,Verstraete; Jacques Allan,0,12,30,30
1650013535786,MATH 142B,A02,084150,Verstraete; Jacques Allan,0,12,30,30
1650013541815,MATH 170A,A01,083459,Nie; Jiawang,0,9,30,30
1650013541815,MATH 170A,A02,083460,Nie; Jiawang,0,8,30,30
1650013541815,MATH 170A,A03,083461,Nie; Jiawang,0,9,30,30
1650013547843,MATH 193B,A01,083463,Staff,1,0,30,29
1650013547843,MATH 193B,A02,083464,Staff,9,0,30,21
1650013547843,MATH 193B,A03,083465,Staff,18,0,30,12
1650013553909,COGS 2,A01,083966,Boyle; Mary E. T.,9,0,30,21
1650013559937,COGS 9,A01,083968,Staff,9,0,60,51
1650013565961,COGS 14B,A01,083970,Staff,10,0,50,40
1650013571984,COGS 17,A01,092679,Staff,51,0,75,24
1650013578009,COGS 100,A01,083972,Staff,0,15,60,60
1650013590059,COGS 101C,A01,083976,Staff,12,0,30,18
1650013596084,COGS 102A,A01,083978,Johnson; Christine M.,14,0,30,16
1650013602111,COGS 107B,A01,083980,Staff,0,7,50,50
1650013608134,COGS 115,A01,083982,Staff,10,0,30,20
1650013614157,COGS 118B,A01,083367,Staff,0,15,40,40
1650013620185,COGS 172,A01,083984,Provenzano; Emily Kara,15,0,30,15
1650013626211,COGS 177,A00,083368,Staff,0,20,30,30
1650013632239,COGS 186,A01,083986,Staff,21,0,40,19
1650013638262,COGS 187A,A01,083988,Boyle; Mary E. T.,20,0,60,40
1650013644290,CSE 8A,A50,084003,Miranda; Gregory Joseph,0,13,15,15
1650013650315,CSE 11,A01,084005,Miranda; Gregory Joseph,0,22,55,55
1650013656338,CSE 20,A01,084007,Staff,0,5,20,20
1650013662452,CSE 21,A01,084009,Staff,0,30,50,50
1650013668476,CSE 30,A01,083370,Cao; Yingjun,0,65,40,40
1650013674504,CSE 100,A01,083372,Cao; Yingjun,0,46,40,40
1650013680529,CSE 101,A01,084011,Staff,0,54,40,40
1650013686556,CSE 141,A01,083374,Eldon; John,0,64,75,75
1650013692579,CSE 141L,A01,083376,Eldon; John,0,70,75,75
1650013698608,CSE 175,A01,084013,Kumar; Rakesh,22,0,25,3
1650013704635,CSE 190,A00,092508,Dubnov; Shlomo,20,0,20,0
1650013710662,ECE 5,A01,084049,Morris; Karcher William,13,0,20,7
1650013716695,ECE 100,A01,084051,Baghdadchi; Saharnaz,0,0,20,20
1650013716695,ECE 100,A02,091916,Baghdadchi; Saharnaz,13,0,20,7
1650013722718,ECE 101,A01,084053,Baghdadchi; Saharnaz,0,0,37,37
1650013722718,ECE 101,A02,084054,Baghdadchi; Saharnaz,30,0,37,7
1650013728746,ECE 107,A01,083390,Staff,26,0,40,14
1650013734780,ECE 148,A01,084056,Silberman; Jack,8,0,12,4
1650013740811,ECE 180,A00,083391,Abi Samra; Nicholas Camill,25,0,30,5
1650013740811,ECE 180,B00,083392,Abi Samra; Nicholas Camill,21,0,30,9
1650013746843,MATH 10B,A01,084110,Staff,0,0,30,30
1650013746843,MATH 10B,A02,084111,Staff,18,0,30,12
1650013746843,MATH 10B,A03,084112,Staff,24,0,30,6
1650013752886,MATH 10C,A01,083443,Staff,0,15,30,30
1650013752886,MATH 10C,A02,083444,Staff,0,15,30,30
1650013752886,MATH 10C,B01,084114,Staff,19,0,30,11
1650013752886,MATH 10C,B02,084115,Staff,25,0,30,5
1650013758927,MATH 18,A01,084117,Harel; Guershon,14,0,30,16
1650013758927,MATH 18,A02,084119,Harel; Guershon,28,0,30,2
1650013758927,MATH 18,A03,084120,Harel; Guershon,29,0,30,1
1650013758927,MATH 18,A04,084121,Harel; Guershon,29,0,30,1
1650013764957,MATH 20B,A01,084124,Um; Ko Woon,16,0,35,19
1650013764957,MATH 20B,B01,084126,Um; Ko Woon,24,0,35,11
1650013770989,MATH 20C,A01,083446,Hammock; Frances H,0,0,30,30
1650013770989,MATH 20C,A02,083447,Hammock; Frances H,16,0,30,14
1650013770989,MATH 20C,A03,083448,Hammock; Frances H,20,0,30,10
1650013770989,MATH 20C,A04,083449,Hammock; Frances H,20,0,30,10
1650013770989,MATH 20C,B01,083451,Hammock; Frances H,0,0,30,30
1650013770989,MATH 20C,B02,083452,Hammock; Frances H,19,0,30,11
1650013770989,MATH 20C,B03,083453,Hammock; Frances H,21,0,30,9
1650013770989,MATH 20C,B04,083454,Hammock; Frances H,23,0,30,7
1650013777015,MATH 20D,A01,084128,Staff,14,0,30,16
1650013777015,MATH 20D,A02,084129,Staff,29,0,30,1
1650013777015,MATH 20D,A03,084130,Staff,27,0,30,3
1650013777015,MATH 20D,B01,084133,Staff,3,0,30,27
1650013777015,MATH 20D,B02,084134,Staff,24,0,30,6
1650013777015,MATH 20D,B03,084135,Staff,28,0,30,2
1650013783056,MATH 20E,A01,084138,Staff,14,0,30,16
1650013783056,MATH 20E,A02,084139,Staff,6,0,30,24
1650013783056,MATH 20E,A03,084140,Staff,15,0,30,15
1650013783056,MATH 20E,A04,084141,Staff,20,0,30,10
1650013789086,MATH 102,A01,084143,Harel; Guershon,12,0,30,18
1650013789086,MATH 102,A02,084144,Harel; Guershon,20,0,30,10
1650013795112,MATH 103B,A01,083456,Staff,0,13,30,30
1650013795112,MATH 103B,A02,083457,Staff,0,13,30,30
1650013801141,MATH 109,A01,084146,Salehi Golsefidy; Alireza,18,0,30,12
1650013801141,MATH 109,A02,084147,Salehi Golsefidy; Alireza,15,0,30,15
1650013807168,MATH 120A,A01,085445,Eggers; John Dietrich,10,0,35,25
1650013807168,MATH 120A,A02,085446,Eggers; John Dietrich,27,0,35,8
1650013813193,MATH 142B,A01,084149,Verstraete; Jacques Allan,0,12,30,30
1650013813193,MATH 142B,A02,084150,Verstraete; Jacques Allan,0,12,30,30
1650013819220,MATH 170A,A01,083459,Nie; Jiawang,0,9,30,30
1650013819220,MATH 170A,A02,083460,Nie; Jiawang,0,8,30,30
1650013819220,MATH 170A,A03,083461,Nie; Jiawang,0,9,30,30
1650013825248,MATH 193B,A01,083463,Staff,1,0,30,29
1650013825248,MATH 193B,A02,083464,Staff,9,0,30,21
1650013825248,MATH 193B,A03,083465,Staff,18,0,30,12
1650013831320,COGS 2,A01,083966,Boyle; Mary E. T.,9,0,30,21
1650013837349,COGS 9,A01,083968,Staff,9,0,60,51
1650013843373,COGS 14B,A01,083970,Staff,10,0,50,40
1650013849398,COGS 17,A01,092679,Staff,51,0,75,24
1650013855434,COGS 100,A01,083972,Staff,0,15,60,60
1650013867484,COGS 101C,A01,083976,Staff,12,0,30,18
1650013873508,COGS 102A,A01,083978,Johnson; Christine M.,14,0,30,16
1650013879536,COGS 107B,A01,083980,Staff,0,7,50,50
1650013885561,COGS 115,A01,083982,Staff,10,0,30,20
1650013891586,COGS 118B,A01,083367,Staff,0,15,40,40
1650013897611,COGS 172,A01,083984,Provenzano; Emily Kara,15,0,30,15
1650013903636,COGS 177,A00,083368,Staff,0,20,30,30
1650013909661,COGS 186,A01,083986,Staff,21,0,40,19
1650013915686,COGS 187A,A01,083988,Boyle; Mary E. T.,20,0,60,40
1650013921737,CSE 8A,A50,084003,Miranda; Gregory Joseph,0,13,15,15
1650013927763,CSE 11,A01,084005,Miranda; Gregory Joseph,0,22,55,55
1650013933788,CSE 20,A01,084007,Staff,0,5,20,20
1650013939813,CSE 21,A01,084009,Staff,0,30,50,50
1650013945843,CSE 30,A01,083370,Cao; Yingjun,0,65,40,40
1650013951868,CSE 100,A01,083372,Cao; Yingjun,0,46,40,40
1650013957891,CSE 101,A01,084011,Staff,0,54,40,40
1650013963916,CSE 141,A01,083374,Eldon; John,0,64,75,75
1650013969944,CSE 141L,A01,083376,Eldon; John,0,70,75,75
1650013975969,CSE 175,A01,084013,Kumar; Rakesh,22,0,25,3
1650013981996,CSE 190,A00,092508,Dubnov; Shlomo,20,0,20,0
1650013988021,ECE 5,A01,084049,Morris; Karcher William,13,0,20,7
1650013994054,ECE 100,A01,084051,Baghdadchi; Saharnaz,0,0,20,20
1650013994054,ECE 100,A02,091916,Baghdadchi; Saharnaz,13,0,20,7
1650014000085,ECE 101,A01,084053,Baghdadchi; Saharnaz,0,0,37,37
1650014000085,ECE 101,A02,084054,Baghdadchi; Saharnaz,30,0,37,7
1650014006111,ECE 107,A01,083390,Staff,26,0,40,14
1650014012138,ECE 148,A01,084056,Silberman; Jack,8,0,12,4
1650014018163,ECE 180,A00,083391,Abi Samra; Nicholas Camill,25,0,30,5
1650014018163,ECE 180,B00,083392,Abi Samra; Nicholas Camill,21,0,30,9
1650014024189,MATH 10B,A01,084110,Staff,0,0,30,30
1650014024189,MATH 10B,A02,084111,Staff,18,0,30,12
1650014024189,MATH 10B,A03,084112,Staff,24,0,30,6
1650014030215,MATH 10C,A01,083443,Staff,0,15,30,30
1650014030215,MATH 10C,A02,083444,Staff,0,15,30,30
1650014030215,MATH 10C,B01,084114,Staff,19,0,30,11
1650014030215,MATH 10C,B02,084115,Staff,25,0,30,5
1650014036241,MATH 18,A01,084117,Harel; Guershon,14,0,30,16
1650014036241,MATH 18,A02,084119,Harel; Guershon,28,0,30,2
1650014036241,MATH 18,A03,084120,Harel; Guershon,29,0,30,1
1650014036241,MATH 18,A04,084121,Harel; Guershon,29,0,30,1
1650014042273,MATH 20B,A01,084124,Um; Ko Woon,16,0,35,19
1650014042273,MATH 20B,B01,084126,Um; Ko Woon,24,0,35,11
1650014048298,MATH 20C,A01,083446,Hammock; Frances H,0,0,30,30
1650014048298,MATH 20C,A02,083447,Hammock; Frances H,16,0,30,14
1650014048298,MATH 20C,A03,083448,Hammock; Frances H,20,0,30,10
1650014048298,MATH 20C,A04,083449,Hammock; Frances H,20,0,30,10
1650014048298,MATH 20C,B01,083451,Hammock; Frances H,0,0,30,30
1650014048298,MATH 20C,B02,083452,Hammock; Frances H,19,0,30,11
1650014048298,MATH 20C,B03,083453,Hammock; Frances H,21,0,30,9
1650014048298,MATH 20C,B04,083454,Hammock; Frances H,23,0,30,7
1650014054331,MATH 20D,A01,084128,Staff,14,0,30,16
1650014054331,MATH 20D,A02,084129,Staff,29,0,30,1
1650014054331,MATH 20D,A03,084130,Staff,27,0,30,3
1650014054331,MATH 20D,B01,084133,Staff,3,0,30,27
1650014054331,MATH 20D,B02,084134,Staff,24,0,30,6
1650014054331,MATH 20D,B03,084135,Staff,28,0,30,2
1650014060360,MATH 20E,A01,084138,Staff,14,0,30,16
1650014060360,MATH 20E,A02,084139,Staff,6,0,30,24
1650014060360,MATH 20E,A03,084140,Staff,15,0,30,15
1650014060360,MATH 20E,A04,084141,Staff,20,0,30,10
1650014066390,MATH 102,A01,084143,Harel; Guershon,12,0,30,18
1650014066390,MATH 102,A02,084144,Harel; Guershon,20,0,30,10
1650014072423,MATH 103B,A01,083456,Staff,0,13,30,30
1650014072423,MATH 103B,A02,083457,Staff,0,13,30,30
1650014078447,MATH 109,A01,084146,Salehi Golsefidy; Alireza,18,0,30,12
1650014078447,MATH 109,A02,084147,Salehi Golsefidy; Alireza,15,0,30,15
1650014084473,MATH 120A,A01,085445,Eggers; John Dietrich,10,0,35,25
1650014084473,MATH 120A,A02,085446,Eggers; John Dietrich,27,0,35,8
1650014090498,MATH 142B,A01,084149,Verstraete; Jacques Allan,0,12,30,30
1650014090498,MATH 142B,A02,084150,Verstraete; Jacques Allan,0,12,30,30
1650014096525,MATH 170A,A01,083459,Nie; Jiawang,0,9,30,30
1650014096525,MATH 170A,A02,083460,Nie; Jiawang,0,8,30,30
1650014096525,MATH 170A,A03,083461,Nie; Jiawang,0,9,30,30
1650014102555,MATH 193B,A01,083463,Staff,1,0,30,29
1650014102555,MATH 193B,A02,083464,Staff,9,0,30,21
1650014102555,MATH 193B,A03,083465,Staff,18,0,30,12
1650014108634,COGS 2,A01,083966,Boyle; Mary E. T.,9,0,30,21
1650014114659,COGS 9,A01,083968,Staff,9,0,60,51
1650014120684,COGS 14B,A01,083970,Staff,10,0,50,40
1650014126714,COGS 17,A01,092679,Staff,51,0,75,24
1650014132741,COGS 100,A01,083972,Staff,0,15,60,60
1650014144792,COGS 101C,A01,083976,Staff,12,0,30,18
1650014150827,COGS 102A,A01,083978,Johnson; Christine M.,14,0,30,16
1650014156852,COGS 107B,A01,083980,Staff,0,7,50,50
1650014162895,COGS 115,A01,083982,Staff,10,0,30,20
1650014168933,COGS 118B,A01,083367,Staff,0,15,40,40
1650014174958,COGS 172,A01,083984,Provenzano; Emily Kara,15,0,30,15
1650014180984,COGS 177,A00,083368,Staff,0,20,30,30
1650014187016,COGS 186,A01,083986,Staff,21,0,40,19
1650014193049,COGS 187A,A01,083988,Boyle; Mary E. T.,20,0,60,40
1650014199079,CSE 8A,A50,084003,Miranda; Gregory Joseph,0,13,15,15
1650014205110,CSE 11,A01,084005,Miranda; Gregory Joseph,0,22,55,55
1650014211136,CSE 20,A01,084007,Staff,0,5,20,20
1650014217168,CSE 21,A01,084009,Staff,0,30,50,50
1650014223191,CSE 30,A01,083370,Cao; Yingjun,0,65,40,40
1650014229219,CSE 100,A01,083372,Cao; Yingjun,0,46,40,40
1650014235249,CSE 101,A01,084011,Staff,0,54,40,40
1650014241282,CSE 141,A01,083374,Eldon; John,0,64,75,75
1650014247410,CSE 141L,A01,083376,Eldon; John,0,70,75,75
1650014253435,CSE 175,A01,084013,Kumar; Rakesh,22,0,25,3
1650014259475,CSE 190,A00,092508,Dubnov; Shlomo,20,0,20,0
1650014265507,ECE 5,A01,084049,Morris; Karcher William,13,0,20,7
1650014271533,ECE 100,A01,084051,Baghdadchi; Saharnaz,0,0,20,20
1650014271533,ECE 100,A02,091916,Baghdadchi; Saharnaz,13,0,20,7
1650014277571,ECE 101,A01,084053,Baghdadchi; Saharnaz,0,0,37,37
1650014277571,ECE 101,A02,084054,Baghdadchi; Saharnaz,30,0,37,7
1650014283598,ECE 107,A01,083390,Staff,26,0,40,14
1650014289629,ECE 148,A01,084056,Silberman; Jack,8,0,12,4
1650014295659,ECE 180,A00,083391,Abi Samra; Nicholas Camill,25,0,30,5
1650014295659,ECE 180,B00,083392,Abi Samra; Nicholas Camill,21,0,30,9
1650014301699,MATH 10B,A01,084110,Staff,0,0,30,30
1650014301699,MATH 10B,A02,084111,Staff,18,0,30,12
1650014301699,MATH 10B,A03,084112,Staff,24,0,30,6
1650014307724,MATH 10C,A01,083443,Staff,0,15,30,30
1650014307724,MATH 10C,A02,083444,Staff,0,15,30,30
1650014307724,MATH 10C,B01,084114,Staff,19,0,30,11
1650014307724,MATH 10C,B02,084115,Staff,25,0,30,5
1650014313748,MATH 18,A01,084117,Harel; Guershon,14,0,30,16
1650014313748,MATH 18,A02,084119,Harel; Guershon,28,0,30,2
1650014313748,MATH 18,A03,084120,Harel; Guershon,29,0,30,1
1650014313748,MATH 18,A04,084121,Harel; Guershon,29,0,30,1
1650014319778,MATH 20B,A01,084124,Um; Ko Woon,16,0,35,19
1650014319778,MATH 20B,B01,084126,Um; Ko Woon,24,0,35,11
1650014325814,MATH 20C,A01,083446,Hammock; Frances H,0,0,30,30
1650014325814,MATH 20C,A02,083447,Hammock; Frances H,16,0,30,14
1650014325814,MATH 20C,A03,083448,Hammock; Frances H,19,0,30,11
1650014325814,MATH 20C,A04,083449,Hammock; Frances H,20,0,30,10
1650014325814,MATH 20C,B01,083451,Hammock; Frances H,0,0,30,30
1650014325814,MATH 20C,B02,083452,Hammock; Frances H,19,0,30,11
1650014325814,MATH 20C,B03,083453,Hammock; Frances H,21,0,30,9
1650014325814,MATH 20C,B04,083454,Hammock; Frances H,23,0,30,7
1650014331848,MATH 20D,A01,084128,Staff,14,0,30,16
1650014331848,MATH 20D,A02,084129,Staff,29,0,30,1
1650014331848,MATH 20D,A03,084130,Staff,27,0,30,3
1650014331848,MATH 20D,B01,084133,Staff,3,0,30,27
1650014331848,MATH 20D,B02,084134,Staff,24,0,30,6
1650014331848,MATH 20D,B03,084135,Staff,28,0,30,2
1650014337872,MATH 20E,A01,084138,Staff,14,0,30,16
1650014337872,MATH 20E,A02,084139,Staff,6,0,30,24
1650014337872,MATH 20E,A03,084140,Staff,15,0,30,15
1650014337872,MATH 20E,A04,084141,Staff,20,0,30,10
1650014343908,MATH 102,A01,084143,Harel; Guershon,12,0,30,18
1650014343908,MATH 102,A02,084144,Harel; Guershon,20,0,30,10
1650014349937,MATH 103B,A01,083456,Staff,0,13,30,30
1650014349937,MATH 103B,A02,083457,Staff,0,13,30,30
1650014355968,MATH 109,A01,084146,Salehi Golsefidy; Alireza,18,0,30,12
1650014355968,MATH 109,A02,084147,Salehi Golsefidy; Alireza,15,0,30,15
1650014361998,MATH 120A,A01,085445,Eggers; John Dietrich,10,0,35,25
1650014361998,MATH 120A,A02,085446,Eggers; John Dietrich,27,0,35,8
1650014368024,MATH 142B,A01,084149,Verstraete; Jacques Allan,0,12,30,30
1650014368024,MATH 142B,A02,084150,Verstraete; Jacques Allan,0,12,30,30
1650014374056,MATH 170A,A01,083459,Nie; Jiawang,0,9,30,30
1650014374056,MATH 170A,A02,083460,Nie; Jiawang,0,8,30,30
1650014374056,MATH 170A,A03,083461,Nie; Jiawang,0,9,30,30
1650014380081,MATH 193B,A01,083463,Staff,1,0,30,29
1650014380081,MATH 193B,A02,083464,Staff,9,0,30,21
1650014380081,MATH 193B,A03,083465,Staff,18,0,30,12
1650014386167,COGS 2,A01,083966,Boyle; Mary E. T.,9,0,30,21
1650014392193,COGS 9,A01,083968,Staff,9,0,60,51
1650014398219,COGS 14B,A01,083970,Staff,10,0,50,40
1650014404249,COGS 17,A01,092679,Staff,51,0,75,24
1650014410274,COGS 100,A01,083972,Staff,0,15,60,60
1650014422322,COGS 101C,A01,083976,Staff,12,0,30,18
1650014428346,COGS 102A,A01,083978,Johnson; Christine M.,14,0,30,16
1650014434370,COGS 107B,A01,083980,Staff,0,7,50,50
1650014440396,COGS 115,A01,083982,Staff,10,0,30,20
1650014446425,COGS 118B,A01,083367,Staff,0,15,40,40
1650014452456,COGS 172,A01,083984,Provenzano; Emily Kara,15,0,30,15
1650014458479,COGS 177,A00,083368,Staff,0,20,30,30
1650014464504,COGS 186,A01,083986,Staff,21,0,40,19
1650014470529,COGS 187A,A01,083988,Boyle; Mary E. T.,20,0,60,40
1650014476562,CSE 8A,A50,084003,Miranda; Gregory Joseph,0,13,15,15
1650014482590,CSE 11,A01,084005,Miranda; Gregory Joseph,0,22,55,55
1650014488615,CSE 20,A01,084007,Staff,0,5,20,20
1650014494640,CSE 21,A01,084009,Staff,0,30,50,50
1650014500668,CSE 30,A01,083370,Cao; Yingjun,0,65,40,40
1650014506696,CSE 100,A01,083372,Cao; Yingjun,0,46,40,40
1650014512719,CSE 101,A01,084011,Staff,0,54,40,40
1650014518749,CSE 141,A01,083374,Eldon; John,0,64,75,75
1650014524778,CSE 141L,A01,083376,Eldon; John,0,70,75,75
1650014530809,CSE 175,A01,084013,Kumar; Rakesh,22,0,25,3
1650014536840,CSE 190,A00,092508,Dubnov; Shlomo,20,0,20,0
1650014542871,ECE 5,A01,084049,Morris; Karcher William,13,0,20,7
1650014548904,ECE 100,A01,084051,Baghdadchi; Saharnaz,0,0,20,20
1650014548904,ECE 100,A02,091916,Baghdadchi; Saharnaz,13,0,20,7
1650014554930,ECE 101,A01,084053,Baghdadchi; Saharnaz,0,0,37,37
1650014554930,ECE 101,A02,084054,Baghdadchi; Saharnaz,30,0,37,7
1650014560960,ECE 107,A01,083390,Staff,26,0,40,14
1650014566985,ECE 148,A01,084056,Silberman; Jack,8,0,12,4
1650014573009,ECE 180,A00,083391,Abi Samra; Nicholas Camill,25,0,30,5
1650014573009,ECE 180,B00,083392,Abi Samra; Nicholas Camill,21,0,30,9
1650014579035,MATH 10B,A01,084110,Staff,0,0,30,30
1650014579035,MATH 10B,A02,084111,Staff,18,0,30,12
1650014579035,MATH 10B,A03,084112,Staff,24,0,30,6
1650014585061,MATH 10C,A01,083443,Staff,0,15,30,30
1650014585061,MATH 10C,A02,083444,Staff,0,15,30,30
1650014585061,MATH 10C,B01,084114,Staff,19,0,30,11
1650014585061,MATH 10C,B02,084115,Staff,25,0,30,5
1650014591094,MATH 18,A01,084117,Harel; Guershon,14,0,30,16
1650014591094,MATH 18,A02,084119,Harel; Guershon,28,0,30,2
1650014591094,MATH 18,A03,084120,Harel; Guershon,29,0,30,1
1650014591094,MATH 18,A04,084121,Harel; Guershon,29,0,30,1
1650014597125,MATH 20B,A01,084124,Um; Ko Woon,16,0,35,19
1650014597125,MATH 20B,B01,084126,Um; Ko Woon,24,0,35,11
1650014603158,MATH 20C,A01,083446,Hammock; Frances H,0,0,30,30
1650014603158,MATH 20C,A02,083447,Hammock; Frances H,16,0,30,14
1650014603158,MATH 20C,A03,083448,Hammock; Frances H,19,0,30,11
1650014603158,MATH 20C,A04,083449,Hammock; Frances H,20,0,30,10
1650014603158,MATH 20C,B01,083451,Hammock; Frances H,0,0,30,30
1650014603158,MATH 20C,B02,083452,Hammock; Frances H,19,0,30,11
1650014603158,MATH 20C,B03,083453,Hammock; Frances H,21,0,30,9
1650014603158,MATH 20C,B04,083454,Hammock; Frances H,23,0,30,7
1650014609185,MATH 20D,A01,084128,Staff,14,0,30,16
1650014609185,MATH 20D,A02,084129,Staff,29,0,30,1
1650014609185,MATH 20D,A03,084130,Staff,27,0,30,3
1650014609185,MATH 20D,B01,084133,Staff,3,0,30,27
1650014609185,MATH 20D,B02,084134,Staff,24,0,30,6
1650014609185,MATH 20D,B03,084135,Staff,28,0,30,2
1650014615210,MATH 20E,A01,084138,Staff,14,0,30,16
1650014615210,MATH 20E,A02,084139,Staff,6,0,30,24
1650014615210,MATH 20E,A03,084140,Staff,15,0,30,15
1650014615210,MATH 20E,A04,084141,Staff,20,0,30,10
1650014621243,MATH 102,A01,084143,Harel; Guershon,12,0,30,18
1650014621243,MATH 102,A02,084144,Harel; Guershon,20,0,30,10
1650014627268,MATH 103B,A01,083456,Staff,0,13,30,30
1650014627268,MATH 103B,A02,083457,Staff,0,13,30,30
1650014633296,MATH 109,A01,084146,Salehi Golsefidy; Alireza,18,0,30,12
1650014633296,MATH 109,A02,084147,Salehi Golsefidy; Alireza,15,0,30,15
1650014639327,MATH 120A,A01,085445,Eggers; John Dietrich,10,0,35,25
1650014639327,MATH 120A,A02,085446,Eggers; John Dietrich,27,0,35,8
1650014645356,MATH 142B,A01,084149,Verstraete; Jacques Allan,0,12,30,30
1650014645356,MATH 142B,A02,084150,Verstraete; Jacques Allan,0,12,30,30
1650014651382,MATH 170A,A01,083459,Nie; Jiawang,0,9,30,30
1650014651382,MATH 170A,A02,083460,Nie; Jiawang,0,8,30,30
1650014651382,MATH 170A,A03,083461,Nie; Jiawang,0,9,30,30
1650014657407,MATH 193B,A01,083463,Staff,1,0,30,29
1650014657407,MATH 193B,A02,083464,Staff,9,0,30,21
1650014657407,MATH 193B,A03,083465,Staff,18,0,30,12
1650014663462,COGS 2,A01,083966,Boyle; Mary E. T.,9,0,30,21
1650014669489,COGS 9,A01,083968,Staff,9,0,60,51
1650014675513,COGS 14B,A01,083970,Staff,10,0,50,40
1650014681542,COGS 17,A01,092679,Staff,51,0,75,24
1650014687570,COGS 100,A01,083972,Staff,0,15,60,60
1650014699620,COGS 101C,A01,083976,Staff,12,0,30,18
1650014705650,COGS 102A,A01,083978,Johnson; Christine M.,14,0,30,16
1650014711675,COGS 107B,A01,083980,Staff,0,7,50,50
1650014717701,COGS 115,A01,083982,Staff,10,0,30,20
1650014723735,COGS 118B,A01,083367,Staff,0,15,40,40
1650014729776,COGS 172,A01,083984,Provenzano; Emily Kara,15,0,30,15
1650014735801,COGS 177,A00,083368,Staff,0,20,30,30
1650014741833,COGS 186,A01,083986,Staff,21,0,40,19
1650014747863,COGS 187A,A01,083988,Boyle; Mary E. T.,20,0,60,40
1650014753895,CSE 8A,A50,084003,Miranda; Gregory Joseph,0,13,15,15
1650014759920,CSE 11,A01,084005,Miranda; Gregory Joseph,0,22,55,55
1650014765950,CSE 20,A01,084007,Staff,0,5,20,20
1650014771975,CSE 21,A01,084009,Staff,0,30,50,50
1650014778003,CSE 30,A01,083370,Cao; Yingjun,0,65,40,40
1650014784040,CSE 100,A01,083372,Cao; Yingjun,0,46,40,40
1650014790064,CSE 101,A01,084011,Staff,0,54,40,40
1650014796092,CSE 141,A01,083374,Eldon; John,0,64,75,75
1650014802122,CSE 141L,A01,083376,Eldon; John,0,70,75,75
1650014808153,CSE 175,A01,084013,Kumar; Rakesh,22,0,25,3
1650014814186,CSE 190,A00,092508,Dubnov; Shlomo,20,0,20,0
1650014820221,ECE 5,A01,084049,Morris; Karcher William,13,0,20,7
1650014826262,ECE 100,A01,084051,Baghdadchi; Saharnaz,0,0,20,20
1650014826262,ECE 100,A02,091916,Baghdadchi; Saharnaz,13,0,20,7
1650014832287,ECE 101,A01,084053,Baghdadchi; Saharnaz,0,0,37,37
1650014832287,ECE 101,A02,084054,Baghdadchi; Saharnaz,30,0,37,7
1650014838424,ECE 107,A01,083390,Staff,26,0,40,14
1650014844458,ECE 148,A01,084056,Silberman; Jack,8,0,12,4
1650014850484,ECE 180,A00,083391,Abi Samra; Nicholas Camill,25,0,30,5
1650014850484,ECE 180,B00,083392,Abi Samra; Nicholas Camill,21,0,30,9
1650014856517,MATH 10B,A01,084110,Staff,0,0,30,30
1650014856517,MATH 10B,A02,084111,Staff,18,0,30,12
1650014856517,MATH 10B,A03,084112,Staff,24,0,30,6
1650014862543,MATH 10C,A01,083443,Staff,0,15,30,30
1650014862543,MATH 10C,A02,083444,Staff,0,15,30,30
1650014862543,MATH 10C,B01,084114,Staff,19,0,30,11
1650014862543,MATH 10C,B02,084115,Staff,25,0,30,5
1650014868580,MATH 18,A01,084117,Harel; Guershon,14,0,30,16
1650014868580,MATH 18,A02,084119,Harel; Guershon,28,0,30,2
1650014868580,MATH 18,A03,084120,Harel; Guershon,29,0,30,1
1650014868580,MATH 18,A04,084121,Harel; Guershon,29,0,30,1
1650014874613,MATH 20B,A01,084124,Um; Ko Woon,16,0,35,19
1650014874613,MATH 20B,B01,084126,Um; Ko Woon,24,0,35,11
1650014880646,MATH 20C,A01,083446,Hammock; Frances H,0,0,30,30
1650014880646,MATH 20C,A02,083447,Hammock; Frances H,16,0,30,14
1650014880646,MATH 20C,A03,083448,Hammock; Frances H,19,0,30,11
1650014880646,MATH 20C,A04,083449,Hammock; Frances H,20,0,30,10
1650014880646,MATH 20C,B01,083451,Hammock; Frances H,0,0,30,30
1650014880646,MATH 20C,B02,083452,Hammock; Frances H,19,0,30,11
1650014880646,MATH 20C,B03,083453,Hammock; Frances H,21,0,30,9
1650014880646,MATH 20C,B04,083454,Hammock; Frances H,23,0,30,7
1650014886676,MATH 20D,A01,084128,Staff,14,0,30,16
1650014886676,MATH 20D,A02,084129,Staff,29,0,30,1
1650014886676,MATH 20D,A03,084130,Staff,27,0,30,3
1650014886676,MATH 20D,B01,084133,Staff,3,0,30,27
1650014886676,MATH 20D,B02,084134,Staff,24,0,30,6
1650014886676,MATH 20D,B03,084135,Staff,28,0,30,2
1650014892715,MATH 20E,A01,084138,Staff,14,0,30,16
1650014892715,MATH 20E,A02,084139,Staff,6,0,30,24
1650014892715,MATH 20E,A03,084140,Staff,15,0,30,15
1650014892715,MATH 20E,A04,084141,Staff,20,0,30,10
1650014898746,MATH 102,A01,084143,Harel; Guershon,12,0,30,18
1650014898746,MATH 102,A02,084144,Harel; Guershon,20,0,30,10
1650014904776,MATH 103B,A01,083456,Staff,0,13,30,30
1650014904776,MATH 103B,A02,083457,Staff,0,13,30,30
1650014910809,MATH 109,A01,084146,Salehi Golsefidy; Alireza,18,0,30,12
1650014910809,MATH 109,A02,084147,Salehi Golsefidy; Alireza,15,0,30,15
1650014916834,MATH 120A,A01,085445,Eggers; John Dietrich,10,0,35,25
1650014916834,MATH 120A,A02,085446,Eggers; John Dietrich,27,0,35,8
1650014922860,MATH 142B,A01,084149,Verstraete; Jacques Allan,0,12,30,30
1650014922860,MATH 142B,A02,084150,Verstraete; Jacques Allan,0,12,30,30
1650014928886,MATH 170A,A01,083459,Nie; Jiawang,0,9,30,30
1650014928886,MATH 170A,A02,083460,Nie; Jiawang,0,8,30,30
1650014928886,MATH 170A,A03,083461,Nie; Jiawang,0,9,30,30
1650014934911,MATH 193B,A01,083463,Staff,1,0,30,29
1650014934911,MATH 193B,A02,083464,Staff,9,0,30,21
1650014934911,MATH 193B,A03,083465,Staff,18,0,30,12
1650014940982,COGS 2,A01,083966,Boyle; Mary E. T.,9,0,30,21
1650014947006,COGS 9,A01,083968,Staff,9,0,60,51
1650014953031,COGS 14B,A01,083970,Staff,10,0,50,40
1650014959057,COGS 17,A01,092679,Staff,51,0,75,24
1650014965081,COGS 100,A01,083972,Staff,0,15,60,60
1650014977133,COGS 101C,A01,083976,Staff,12,0,30,18
1650014983165,COGS 102A,A01,083978,Johnson; Christine M.,14,0,30,16
1650014989190,COGS 107B,A01,083980,Staff,0,7,50,50
1650014995229,COGS 115,A01,083982,Staff,10,0,30,20
1650015001257,COGS 118B,A01,083367,Staff,0,15,40,40
1650015007285,COGS 172,A01,083984,Provenzano; Emily Kara,15,0,30,15
1650015013310,COGS 177,A00,083368,Staff,0,20,30,30
1650015019335,COGS 186,A01,083986,Staff,21,0,40,19
1650015025366,COGS 187A,A01,083988,Boyle; Mary E. T.,20,0,60,40
1650015031393,CSE 8A,A50,084003,Miranda; Gregory Joseph,0,13,15,15
1650015037416,CSE 11,A01,084005,Miranda; Gregory Joseph,0,22,55,55
1650015043445,CSE 20,A01,084007,Staff,0,5,20,20
1650015049471,CSE 21,A01,084009,Staff,0,30,50,50
1650015055503,CSE 30,A01,083370,Cao; Yingjun,0,65,40,40
1650015061530,CSE 100,A01,083372,Cao; Yingjun,0,46,40,40
1650015067581,CSE 101,A01,084011,Staff,0,54,40,40
1650015073611,CSE 141,A01,083374,Eldon; John,0,64,75,75
1650015079642,CSE 141L,A01,083376,Eldon; John,0,70,75,75
1650015085672,CSE 175,A01,084013,Kumar; Rakesh,22,0,25,3
1650015091701,CSE 190,A00,092508,Dubnov; Shlomo,20,0,20,0
1650015097735,ECE 5,A01,084049,Morris; Karcher William,13,0,20,7
1650015103762,ECE 100,A01,084051,Baghdadchi; Saharnaz,0,0,20,20
1650015103762,ECE 100,A02,091916,Baghdadchi; Saharnaz,13,0,20,7
1650015109792,ECE 101,A01,084053,Baghdadchi; Saharnaz,0,0,37,37
1650015109792,ECE 101,A02,084054,Baghdadchi; Saharnaz,30,0,37,7
1650015115825,ECE 107,A01,083390,Staff,26,0,40,14
1650015121851,ECE 148,A01,084056,Silberman; Jack,8,0,12,4
1650015127876,ECE 180,A00,083391,Abi Samra; Nicholas Camill,25,0,30,5
1650015127876,ECE 180,B00,083392,Abi Samra; Nicholas Camill,21,0,30,9
1650015133907,MATH 10B,A01,084110,Staff,0,0,30,30
1650015133907,MATH 10B,A02,084111,Staff,18,0,30,12
1650015133907,MATH 10B,A03,084112,Staff,24,0,30,6
1650015139934,MATH 10C,A01,083443,Staff,0,15,30,30
1650015139934,MATH 10C,A02,083444,Staff,0,15,30,30
1650015139934,MATH 10C,B01,084114,Staff,19,0,30,11
1650015139934,MATH 10C,B02,084115,Staff,25,0,30,5
1650015145960,MATH 18,A01,084117,Harel; Guershon,14,0,30,16
1650015145960,MATH 18,A02,084119,Harel; Guershon,28,0,30,2
1650015145960,MATH 18,A03,084120,Harel; Guershon,29,0,30,1
1650015145960,MATH 18,A04,084121,Harel; Guershon,29,0,30,1
1650015151992,MATH 20B,A01,084124,Um; Ko Woon,16,0,35,19
1650015151992,MATH 20B,B01,084126,Um; Ko Woon,24,0,35,11
1650015158019,MATH 20C,A01,083446,Hammock; Frances H,0,0,30,30
1650015158019,MATH 20C,A02,083447,Hammock; Frances H,16,0,30,14
1650015158019,MATH 20C,A03,083448,Hammock; Frances H,19,0,30,11
1650015158019,MATH 20C,A04,083449,Hammock; Frances H,20,0,30,10
1650015158019,MATH 20C,B01,083451,Hammock; Frances H,0,0,30,30
1650015158019,MATH 20C,B02,083452,Hammock; Frances H,19,0,30,11
1650015158019,MATH 20C,B03,083453,Hammock; Frances H,21,0,30,9
1650015158019,MATH 20C,B04,083454,Hammock; Frances H,23,0,30,7
1650015164053,MATH 20D,A01,084128,Staff,14,0,30,16
1650015164053,MATH 20D,A02,084129,Staff,29,0,30,1
1650015164053,MATH 20D,A03,084130,Staff,27,0,30,3
1650015164053,MATH 20D,B01,084133,Staff,3,0,30,27
1650015164053,MATH 20D,B02,084134,Staff,24,0,30,6
1650015164053,MATH 20D,B03,084135,Staff,28,0,30,2
1650015170083,MATH 20E,A01,084138,Staff,14,0,30,16
1650015170083,MATH 20E,A02,084139,Staff,6,0,30,24
1650015170083,MATH 20E,A03,084140,Staff,15,0,30,15
1650015170083,MATH 20E,A04,084141,Staff,20,0,30,10
1650015176109,MATH 102,A01,084143,Harel; Guershon,12,0,30,18
1650015176109,MATH 102,A02,084144,Harel; Guershon,20,0,30,10
1650015182139,MATH 103B,A01,083456,Staff,0,13,30,30
1650015182139,MATH 103B,A02,083457,Staff,0,13,30,30
1650015188164,MATH 109,A01,084146,Salehi Golsefidy; Alireza,18,0,30,12
1650015188164,MATH 109,A02,084147,Salehi Golsefidy; Alireza,15,0,30,15
1650015194187,MATH 120A,A01,085445,Eggers; John Dietrich,10,0,35,25
1650015194187,MATH 120A,A02,085446,Eggers; John Dietrich,27,0,35,8
1650015200212,MATH 142B,A01,084149,Verstraete; Jacques Allan,0,12,30,30
1650015200212,MATH 142B,A02,084150,Verstraete; Jacques Allan,0,12,30,30
1650015206244,MATH 170A,A01,083459,Nie; Jiawang,0,9,30,30
1650015206244,MATH 170A,A02,083460,Nie; Jiawang,0,8,30,30
1650015206244,MATH 170A,A03,083461,Nie; Jiawang,0,9,30,30
1650015212267,MATH 193B,A01,083463,Staff,1,0,30,29
1650015212267,MATH 193B,A02,083464,Staff,9,0,30,21
1650015212267,MATH 193B,A03,083465,Staff,18,0,30,12
1650015218344,COGS 2,A01,083966,Boyle; Mary E. T.,9,0,30,21
1650015224375,COGS 9,A01,083968,Staff,9,0,60,51
1650015230403,COGS 14B,A01,083970,Staff,10,0,50,40
1650015236432,COGS 17,A01,092679,Staff,51,0,75,24
1650015242455,COGS 100,A01,083972,Staff,0,15,60,60
1650015254504,COGS 101C,A01,083976,Staff,12,0,30,18
1650015260530,COGS 102A,A01,083978,Johnson; Christine M.,14,0,30,16
1650015266555,COGS 107B,A01,083980,Staff,0,7,50,50
1650015272579,COGS 115,A01,083982,Staff,10,0,30,20
1650015278607,COGS 118B,A01,083367,Staff,0,15,40,40
1650015284634,COGS 172,A01,083984,Provenzano; Emily Kara,15,0,30,15
1650015290655,COGS 177,A00,083368,Staff,0,20,30,30
1650015296683,COGS 186,A01,083986,Staff,21,0,40,19
1650015302710,COGS 187A,A01,083988,Boyle; Mary E. T.,20,0,60,40
1650015308736,CSE 8A,A50,084003,Miranda; Gregory Joseph,0,13,15,15
1650015314761,CSE 11,A01,084005,Miranda; Gregory Joseph,0,22,55,55
1650015320786,CSE 20,A01,084007,Staff,0,5,20,20
1650015326815,CSE 21,A01,084009,Staff,0,30,50,50
1650015332842,CSE 30,A01,083370,Cao; Yingjun,0,65,40,40
1650015338871,CSE 100,A01,083372,Cao; Yingjun,0,46,40,40
1650015344901,CSE 101,A01,084011,Staff,0,54,40,40
1650015350923,CSE 141,A01,083374,Eldon; John,0,64,75,75
1650015356956,CSE 141L,A01,083376,Eldon; John,0,70,75,75
1650015362988,CSE 175,A01,084013,Kumar; Rakesh,22,0,25,3
1650015369012,CSE 190,A00,092508,Dubnov; Shlomo,20,0,20,0
1650015375052,ECE 5,A01,084049,Morris; Karcher William,13,0,20,7
1650015381080,ECE 100,A01,084051,Baghdadchi; Saharnaz,0,0,20,20
1650015381080,ECE 100,A02,091916,Baghdadchi; Saharnaz,13,0,20,7
1650015387110,ECE 101,A01,084053,Baghdadchi; Saharnaz,0,0,37,37
1650015387110,ECE 101,A02,084054,Baghdadchi; Saharnaz,30,0,37,7
1650015393135,ECE 107,A01,083390,Staff,26,0,40,14
1650015399159,ECE 148,A01,084056,Silberman; Jack,8,0,12,4
1650015405185,ECE 180,A00,083391,Abi Samra; Nicholas Camill,25,0,30,5
1650015405185,ECE 180,B00,083392,Abi Samra; Nicholas Camill,21,0,30,9
1650015411215,MATH 10B,A01,084110,Staff,0,0,30,30
1650015411215,MATH 10B,A02,084111,Staff,18,0,30,12
1650015411215,MATH 10B,A03,084112,Staff,24,0,30,6
1650015417241,MATH 10C,A01,083443,Staff,0,15,30,30
1650015417241,MATH 10C,A02,083444,Staff,0,15,30,30
1650015417241,MATH 10C,B01,084114,Staff,19,0,30,11
1650015417241,MATH 10C,B02,084115,Staff,25,0,30,5
1650015423267,MATH 18,A01,084117,Harel; Guershon,14,0,30,16
1650015423267,MATH 18,A02,084119,Harel; Guershon,28,0,30,2
1650015423267,MATH 18,A03,084120,Harel; Guershon,29,0,30,1
1650015423267,MATH 18,A04,084121,Harel; Guershon,29,0,30,1
1650015429296,MATH 20B,A01,084124,Um; Ko Woon,16,0,35,19
1650015429296,MATH 20B,B01,084126,Um; Ko Woon,24,0,35,11
1650015435410,MATH 20C,A01,083446,Hammock; Frances H,0,0,30,30
1650015435410,MATH 20C,A02,083447,Hammock; Frances H,16,0,30,14
1650015435410,MATH 20C,A03,083448,Hammock; Frances H,19,0,30,11
1650015435410,MATH 20C,A04,083449,Hammock; Frances H,20,0,30,10
1650015435410,MATH 20C,B01,083451,Hammock; Frances H,0,0,30,30
1650015435410,MATH 20C,B02,083452,Hammock; Frances H,19,0,30,11
1650015435410,MATH 20C,B03,083453,Hammock; Frances H,21,0,30,9
1650015435410,MATH 20C,B04,083454,Hammock; Frances H,23,0,30,7
1650015441445,MATH 20D,A01,084128,Staff,14,0,30,16
1650015441445,MATH 20D,A02,084129,Staff,29,0,30,1
1650015441445,MATH 20D,A03,084130,Staff,27,0,30,3
1650015441445,MATH 20D,B01,084133,Staff,3,0,30,27
1650015441445,MATH 20D,B02,084134,Staff,24,0,30,6
1650015441445,MATH 20D,B03,084135,Staff,28,0,30,2
1650015447470,MATH 20E,A01,084138,Staff,14,0,30,16
1650015447470,MATH 20E,A02,084139,Staff,6,0,30,24
1650015447470,MATH 20E,A03,084140,Staff,15,0,30,15
1650015447470,MATH 20E,A04,084141,Staff,20,0,30,10
1650015453508,MATH 102,A01,084143,Harel; Guershon,12,0,30,18
1650015453508,MATH 102,A02,084144,Harel; Guershon,20,0,30,10
1650015459532,MATH 103B,A01,083456,Staff,0,13,30,30
1650015459532,MATH 103B,A02,083457,Staff,0,13,30,30
1650015465558,MATH 109,A01,084146,Salehi Golsefidy; Alireza,18,0,30,12
1650015465558,MATH 109,A02,084147,Salehi Golsefidy; Alireza,15,0,30,15
1650015471581,MATH 120A,A01,085445,Eggers; John Dietrich,10,0,35,25
1650015471581,MATH 120A,A02,085446,Eggers; John Dietrich,27,0,35,8
1650015477613,MATH 142B,A01,084149,Verstraete; Jacques Allan,0,12,30,30
1650015477613,MATH 142B,A02,084150,Verstraete; Jacques Allan,0,12,30,30
1650015483642,MATH 170A,A01,083459,Nie; Jiawang,0,9,30,30
1650015483642,MATH 170A,A02,083460,Nie; Jiawang,0,8,30,30
1650015483642,MATH 170A,A03,083461,Nie; Jiawang,0,9,30,30
1650015489668,MATH 193B,A01,083463,Staff,1,0,30,29
1650015489668,MATH 193B,A02,083464,Staff,9,0,30,21
1650015489668,MATH 193B,A03,083465,Staff,18,0,30,12
1650015495727,COGS 2,A01,083966,Boyle; Mary E. T.,9,0,30,21
1650015501751,COGS 9,A01,083968,Staff,9,0,60,51
1650015507779,COGS 14B,A01,083970,Staff,10,0,50,40
1650015513806,COGS 17,A01,092679,Staff,51,0,75,24
1650015519830,COGS 100,A01,083972,Staff,0,15,60,60
1650015531880,COGS 101C,A01,083976,Staff,12,0,30,18
1650015537911,COGS 102A,A01,083978,Johnson; Christine M.,14,0,30,16
1650015543934,COGS 107B,A01,083980,Staff,0,7,50,50
1650015549964,COGS 115,A01,083982,Staff,10,0,30,20
1650015555994,COGS 118B,A01,083367,Staff,0,15,40,40
1650015562018,COGS 172,A01,083984,Provenzano; Emily Kara,15,0,30,15
1650015568049,COGS 177,A00,083368,Staff,0,20,30,30
1650015574073,COGS 186,A01,083986,Staff,21,0,40,19
1650015580106,COGS 187A,A01,083988,Boyle; Mary E. T.,20,0,60,40
1650015586142,CSE 8A,A50,084003,Miranda; Gregory Joseph,0,13,15,15
1650015592169,CSE 11,A01,084005,Miranda; Gregory Joseph,0,22,55,55
1650015598194,CSE 20,A01,084007,Staff,0,5,20,20
1650015604219,CSE 21,A01,084009,Staff,0,30,50,50
1650015610245,CSE 30,A01,083370,Cao; Yingjun,0,65,40,40
1650015616270,CSE 100,A01,083372,Cao; Yingjun,0,46,40,40
1650015622295,CSE 101,A01,084011,Staff,0,54,40,40
1650015628319,CSE 141,A01,083374,Eldon; John,0,64,75,75
1650015634349,CSE 141L,A01,083376,Eldon; John,0,70,75,75
1650015640379,CSE 175,A01,084013,Kumar; Rakesh,22,0,25,3
1650015646404,CSE 190,A00,092508,Dubnov; Shlomo,20,0,20,0
1650015652436,ECE 5,A01,084049,Morris; Karcher William,13,0,20,7
1650015658471,ECE 100,A01,084051,Baghdadchi; Saharnaz,0,0,20,20
1650015658471,ECE 100,A02,091916,Baghdadchi; Saharnaz,13,0,20,7
1650015664498,ECE 101,A01,084053,Baghdadchi; Saharnaz,0,0,37,37
1650015664498,ECE 101,A02,084054,Baghdadchi; Saharnaz,30,0,37,7
1650015670531,ECE 107,A01,083390,Staff,26,0,40,14
1650015676557,ECE 148,A01,084056,Silberman; Jack,8,0,12,4
1650015682588,ECE 180,A00,083391,Abi Samra; Nicholas Camill,25,0,30,5
1650015682588,ECE 180,B00,083392,Abi Samra; Nicholas Camill,21,0,30,9
1650015688620,MATH 10B,A01,084110,Staff,0,0,30,30
1650015688620,MATH 10B,A02,084111,Staff,18,0,30,12
1650015688620,MATH 10B,A03,084112,Staff,24,0,30,6
1650015694664,MATH 10C,A01,083443,Staff,0,15,30,30
1650015694664,MATH 10C,A02,083444,Staff,0,15,30,30
1650015694664,MATH 10C,B01,084114,Staff,19,0,30,11
1650015694664,MATH 10C,B02,084115,Staff,25,0,30,5
1650015700690,MATH 18,A01,084117,Harel; Guershon,14,0,30,16
1650015700690,MATH 18,A02,084119,Harel; Guershon,28,0,30,2
1650015700690,MATH 18,A03,084120,Harel; Guershon,29,0,30,1
1650015700690,MATH 18,A04,084121,Harel; Guershon,29,0,30,1
1650015706716,MATH 20B,A01,084124,Um; Ko Woon,16,0,35,19
1650015706716,MATH 20B,B01,084126,Um; Ko Woon,24,0,35,11
1650015712748,MATH 20C,A01,083446,Hammock; Frances H,0,0,30,30
1650015712748,MATH 20C,A02,083447,Hammock; Frances H,16,0,30,14
1650015712748,MATH 20C,A03,083448,Hammock; Frances H,19,0,30,11
1650015712748,MATH 20C,A04,083449,Hammock; Frances H,20,0,30,10
1650015712748,MATH 20C,B01,083451,Hammock; Frances H,0,0,30,30
1650015712748,MATH 20C,B02,083452,Hammock; Frances H,19,0,30,11
1650015712748,MATH 20C,B03,083453,Hammock; Frances H,21,0,30,9
1650015712748,MATH 20C,B04,083454,Hammock; Frances H,23,0,30,7
1650015718782,MATH 20D,A01,084128,Staff,14,0,30,16
1650015718782,MATH 20D,A02,084129,Staff,29,0,30,1
1650015718782,MATH 20D,A03,084130,Staff,27,0,30,3
1650015718782,MATH 20D,B01,084133,Staff,3,0,30,27
1650015718782,MATH 20D,B02,084134,Staff,24,0,30,6
1650015718782,MATH 20D,B03,084135,Staff,28,0,30,2
1650015724813,MATH 20E,A01,084138,Staff,14,0,30,16
1650015724813,MATH 20E,A02,084139,Staff,6,0,30,24
1650015724813,MATH 20E,A03,084140,Staff,15,0,30,15
1650015724813,MATH 20E,A04,084141,Staff,20,0,30,10
1650015730857,MATH 102,A01,084143,Harel; Guershon,12,0,30,18
1650015730857,MATH 102,A02,084144,Harel; Guershon,20,0,30,10
1650015736882,MATH 103B,A01,083456,Staff,0,13,30,30
1650015736882,MATH 103B,A02,083457,Staff,0,13,30,30
1650015742914,MATH 109,A01,084146,Salehi Golsefidy; Alireza,18,0,30,12
1650015742914,MATH 109,A02,084147,Salehi Golsefidy; Alireza,15,0,30,15
1650015748945,MATH 120A,A01,085445,Eggers; John Dietrich,10,0,35,25
1650015748945,MATH 120A,A02,085446,Eggers; John Dietrich,27,0,35,8
1650015754977,MATH 142B,A01,084149,Verstraete; Jacques Allan,0,12,30,30
1650015754977,MATH 142B,A02,084150,Verstraete; Jacques Allan,0,12,30,30
1650015761001,MATH 170A,A01,083459,Nie; Jiawang,0,9,30,30
1650015761001,MATH 170A,A02,083460,Nie; Jiawang,0,8,30,30
1650015761001,MATH 170A,A03,083461,Nie; Jiawang,0,9,30,30
1650015767030,MATH 193B,A01,083463,Staff,1,0,30,29
1650015767030,MATH 193B,A02,083464,Staff,9,0,30,21
1650015767030,MATH 193B,A03,083465,Staff,18,0,30,12
1650015773110,COGS 2,A01,083966,Boyle; Mary E. T.,9,0,30,21
1650015779145,COGS 9,A01,083968,Staff,9,0,60,51
1650015785170,COGS 14B,A01,083970,Staff,10,0,50,40
1650015791195,COGS 17,A01,092679,Staff,51,0,75,24
1650015797220,COGS 100,A01,083972,Staff,0,15,60,60
1650015809268,COGS 101C,A01,083976,Staff,12,0,30,18
1650015815299,COGS 102A,A01,083978,Johnson; Christine M.,14,0,30,16
1650015821329,COGS 107B,A01,083980,Staff,0,7,50,50
1650015827353,COGS 115,A01,083982,Staff,10,0,30,20
1650015833381,COGS 118B,A01,083367,Staff,0,15,40,40
1650015839411,COGS 172,A01,083984,Provenzano; Emily Kara,15,0,30,15
1650015845439,COGS 177,A00,083368,Staff,0,20,30,30
1650015851466,COGS 186,A01,083986,Staff,21,0,40,19
1650015857497,COGS 187A,A01,083988,Boyle; Mary E. T.,20,0,60,40
1650015863524,CSE 8A,A50,084003,Miranda; Gregory Joseph,0,13,15,15
1650015869560,CSE 11,A01,084005,Miranda; Gregory Joseph,0,22,55,55
1650015875585,CSE 20,A01,084007,Staff,0,5,20,20
1650015881610,CSE 21,A01,084009,Staff,0,30,50,50
1650015887634,CSE 30,A01,083370,Cao; Yingjun,0,65,40,40
1650015893661,CSE 100,A01,083372,Cao; Yingjun,0,46,40,40
1650015899690,CSE 101,A01,084011,Staff,0,54,40,40
1650015905718,CSE 141,A01,083374,Eldon; John,0,64,75,75
1650015911747,CSE 141L,A01,083376,Eldon; John,0,70,75,75
1650015917776,CSE 175,A01,084013,Kumar; Rakesh,22,0,25,3
1650015923800,CSE 190,A00,092508,Dubnov; Shlomo,20,0,20,0
1650015929837,ECE 5,A01,084049,Morris; Karcher William,13,0,20,7
1650015935864,ECE 100,A01,084051,Baghdadchi; Saharnaz,0,0,20,20
1650015935864,ECE 100,A02,091916,Baghdadchi; Saharnaz,13,0,20,7
1650015941896,ECE 101,A01,084053,Baghdadchi; Saharnaz,0,0,37,37
1650015941896,ECE 101,A02,084054,Baghdadchi; Saharnaz,30,0,37,7
1650015947931,ECE 107,A01,083390,Staff,26,0,40,14
1650015953961,ECE 148,A01,084056,Silberman; Jack,8,0,12,4
1650015959986,ECE 180,A00,083391,Abi Samra; Nicholas Camill,25,0,30,5
1650015959986,ECE 180,B00,083392,Abi Samra; Nicholas Camill,21,0,30,9
1650015966014,MATH 10B,A01,084110,Staff,0,0,30,30
1650015966014,MATH 10B,A02,084111,Staff,18,0,30,12
1650015966014,MATH 10B,A03,084112,Staff,24,0,30,6
1650015972069,MATH 10C,A01,083443,Staff,0,15,30,30
1650015972069,MATH 10C,A02,083444,Staff,0,15,30,30
1650015972069,MATH 10C,B01,084114,Staff,19,0,30,11
1650015972069,MATH 10C,B02,084115,Staff,25,0,30,5
1650015978096,MATH 18,A01,084117,Harel; Guershon,14,0,30,16
1650015978096,MATH 18,A02,084119,Harel; Guershon,28,0,30,2
1650015978096,MATH 18,A03,084120,Harel; Guershon,29,0,30,1
1650015978096,MATH 18,A04,084121,Harel; Guershon,29,0,30,1
1650015984136,MATH 20B,A01,084124,Um; Ko Woon,16,0,35,19
1650015984136,MATH 20B,B01,084126,Um; Ko Woon,24,0,35,11
1650015990161,MATH 20C,A01,083446,Hammock; Frances H,0,0,30,30
1650015990161,MATH 20C,A02,083447,Hammock; Frances H,16,0,30,14
1650015990161,MATH 20C,A03,083448,Hammock; Frances H,19,0,30,11
1650015990161,MATH 20C,A04,083449,Hammock; Frances H,20,0,30,10
1650015990161,MATH 20C,B01,083451,Hammock; Frances H,0,0,30,30
1650015990161,MATH 20C,B02,083452,Hammock; Frances H,19,0,30,11
1650015990161,MATH 20C,B03,083453,Hammock; Frances H,21,0,30,9
1650015990161,MATH 20C,B04,083454,Hammock; Frances H,23,0,30,7
1650015996197,MATH 20D,A01,084128,Staff,14,0,30,16
1650015996197,MATH 20D,A02,084129,Staff,29,0,30,1
1650015996197,MATH 20D,A03,084130,Staff,27,0,30,3
1650015996197,MATH 20D,B01,084133,Staff,3,0,30,27
1650015996197,MATH 20D,B02,084134,Staff,24,0,30,6
1650015996197,MATH 20D,B03,084135,Staff,28,0,30,2
1650016002223,MATH 20E,A01,084138,Staff,14,0,30,16
1650016002223,MATH 20E,A02,084139,Staff,6,0,30,24
1650016002223,MATH 20E,A03,084140,Staff,15,0,30,15
1650016002223,MATH 20E,A04,084141,Staff,20,0,30,10
1650016008247,MATH 102,A01,084143,Harel; Guershon,12,0,30,18
1650016008247,MATH 102,A02,084144,Harel; Guershon,20,0,30,10
1650016014276,MATH 103B,A01,083456,Staff,0,13,30,30
1650016014276,MATH 103B,A02,083457,Staff,0,13,30,30
1650016020301,MATH 109,A01,084146,Salehi Golsefidy; Alireza,18,0,30,12
1650016020301,MATH 109,A02,084147,Salehi Golsefidy; Alireza,15,0,30,15
1650016026327,MATH 120A,A01,085445,Eggers; John Dietrich,10,0,35,25
1650016026327,MATH 120A,A02,085446,Eggers; John Dietrich,27,0,35,8
1650016032429,MATH 142B,A01,084149,Verstraete; Jacques Allan,0,12,30,30
1650016032429,MATH 142B,A02,084150,Verstraete; Jacques Allan,0,12,30,30
1650016038461,MATH 170A,A01,083459,Nie; Jiawang,0,9,30,30
1650016038461,MATH 170A,A02,083460,Nie; Jiawang,0,8,30,30
1650016038461,MATH 170A,A03,083461,Nie; Jiawang,0,9,30,30
1650016044491,MATH 193B,A01,083463,Staff,1,0,30,29
1650016044491,MATH 193B,A02,083464,Staff,9,0,30,21
1650016044491,MATH 193B,A03,083465,Staff,18,0,30,12
1650016050552,COGS 2,A01,083966,Boyle; Mary E. T.,9,0,30,21
1650016056578,COGS 9,A01,083968,Staff,9,0,60,51
1650016062603,COGS 14B,A01,083970,Staff,9,0,50,41
1650016068627,COGS 17,A01,092679,Staff,50,0,75,25
1650016074659,COGS 100,A01,083972,Staff,0,15,60,60
1650016086717,COGS 101C,A01,083976,Staff,12,0,30,18
1650016092740,COGS 102A,A01,083978,Johnson; Christine M.,14,0,30,16
1650016098765,COGS 107B,A01,083980,Staff,0,7,50,50
1650016104788,COGS 115,A01,083982,Staff,10,0,30,20
1650016110814,COGS 118B,A01,083367,Staff,0,15,40,40
1650016116838,COGS 172,A01,083984,Provenzano; Emily Kara,15,0,30,15
1650016122867,COGS 177,A00,083368,Staff,0,20,30,30
1650016128891,COGS 186,A01,083986,Staff,21,0,40,19
1650016134914,COGS 187A,A01,083988,Boyle; Mary E. T.,20,0,60,40
1650016140938,CSE 8A,A50,084003,Miranda; Gregory Joseph,0,13,15,15
1650016146962,CSE 11,A01,084005,Miranda; Gregory Joseph,0,22,55,55
1650016152990,CSE 20,A01,084007,Staff,0,5,20,20
1650016159012,CSE 21,A01,084009,Staff,0,30,50,50
1650016165042,CSE 30,A01,083370,Cao; Yingjun,0,65,40,40
1650016171066,CSE 100,A01,083372,Cao; Yingjun,0,46,40,40
1650016177094,CSE 101,A01,084011,Staff,0,54,40,40
1650016183120,CSE 141,A01,083374,Eldon; John,0,64,75,75
1650016189149,CSE 141L,A01,083376,Eldon; John,0,70,75,75
1650016195219,CSE 175,A01,084013,Kumar; Rakesh,22,0,25,3
1650016201253,CSE 190,A00,092508,Dubnov; Shlomo,20,0,20,0
1650016207281,ECE 5,A01,084049,Morris; Karcher William,13,0,20,7
1650016213305,ECE 100,A01,084051,Baghdadchi; Saharnaz,0,0,20,20
1650016213305,ECE 100,A02,091916,Baghdadchi; Saharnaz,13,0,20,7
1650016219330,ECE 101,A01,084053,Baghdadchi; Saharnaz,0,0,37,37
1650016219330,ECE 101,A02,084054,Baghdadchi; Saharnaz,30,0,37,7
1650016225358,ECE 107,A01,083390,Staff,26,0,40,14
1650016231401,ECE 148,A01,084056,Silberman; Jack,8,0,12,4
1650016237427,ECE 180,A00,083391,Abi Samra; Nicholas Camill,25,0,30,5
1650016237427,ECE 180,B00,083392,Abi Samra; Nicholas Camill,21,0,30,9
1650016243456,MATH 10B,A01,084110,Staff,0,0,30,30
1650016243456,MATH 10B,A02,084111,Staff,18,0,30,12
1650016243456,MATH 10B,A03,084112,Staff,24,0,30,6
1650016249485,MATH 10C,A01,083443,Staff,0,15,30,30
1650016249485,MATH 10C,A02,083444,Staff,0,15,30,30
1650016249485,MATH 10C,B01,084114,Staff,19,0,30,11
1650016249485,MATH 10C,B02,084115,Staff,25,0,30,5
1650016255510,MATH 18,A01,084117,Harel; Guershon,14,0,30,16
1650016255510,MATH 18,A02,084119,Harel; Guershon,28,0,30,2
1650016255510,MATH 18,A03,084120,Harel; Guershon,29,0,30,1
1650016255510,MATH 18,A04,084121,Harel; Guershon,29,0,30,1
1650016261539,MATH 20B,A01,084124,Um; Ko Woon,16,0,35,19
1650016261539,MATH 20B,B01,084126,Um; Ko Woon,24,0,35,11
1650016267572,MATH 20C,A01,083446,Hammock; Frances H,0,0,30,30
1650016267572,MATH 20C,A02,083447,Hammock; Frances H,16,0,30,14
1650016267572,MATH 20C,A03,083448,Hammock; Frances H,19,0,30,11
1650016267572,MATH 20C,A04,083449,Hammock; Frances H,20,0,30,10
1650016267572,MATH 20C,B01,083451,Hammock; Frances H,0,0,30,30
1650016267572,MATH 20C,B02,083452,Hammock; Frances H,19,0,30,11
1650016267572,MATH 20C,B03,083453,Hammock; Frances H,21,0,30,9
1650016267572,MATH 20C,B04,083454,Hammock; Frances H,23,0,30,7
1650016273596,MATH 20D,A01,084128,Staff,14,0,30,16
1650016273596,MATH 20D,A02,084129,Staff,29,0,30,1
1650016273596,MATH 20D,A03,084130,Staff,27,0,30,3
1650016273596,MATH 20D,B01,084133,Staff,3,0,30,27
1650016273596,MATH 20D,B02,084134,Staff,24,0,30,6
1650016273596,MATH 20D,B03,084135,Staff,28,0,30,2
1650016279624,MATH 20E,A01,084138,Staff,14,0,30,16
1650016279624,MATH 20E,A02,084139,Staff,6,0,30,24
1650016279624,MATH 20E,A03,084140,Staff,15,0,30,15
1650016279624,MATH 20E,A04,084141,Staff,20,0,30,10
1650016285652,MATH 102,A01,084143,Harel; Guershon,12,0,30,18
1650016285652,MATH 102,A02,084144,Harel; Guershon,20,0,30,10
1650016291680,MATH 103B,A01,083456,Staff,0,13,30,30
1650016291680,MATH 103B,A02,083457,Staff,0,13,30,30
1650016297710,MATH 109,A01,084146,Salehi Golsefidy; Alireza,18,0,30,12
1650016297710,MATH 109,A02,084147,Salehi Golsefidy; Alireza,15,0,30,15
1650016303734,MATH 120A,A01,085445,Eggers; John Dietrich,10,0,35,25
1650016303734,MATH 120A,A02,085446,Eggers; John Dietrich,27,0,35,8
1650016309759,MATH 142B,A01,084149,Verstraete; Jacques Allan,0,12,30,30
1650016309759,MATH 142B,A02,084150,Verstraete; Jacques Allan,0,12,30,30
1650016315784,MATH 170A,A01,083459,Nie; Jiawang,0,9,30,30
1650016315784,MATH 170A,A02,083460,Nie; Jiawang,0,8,30,30
1650016315784,MATH 170A,A03,083461,Nie; Jiawang,0,9,30,30
1650016321811,MATH 193B,A01,083463,Staff,1,0,30,29
1650016321811,MATH 193B,A02,083464,Staff,9,0,30,21
1650016321811,MATH 193B,A03,083465,Staff,18,0,30,12
1650016327869,COGS 2,A01,083966,Boyle; Mary E. T.,9,0,30,21
1650016333893,COGS 9,A01,083968,Staff,9,0,60,51
1650016339924,COGS 14B,A01,083970,Staff,9,0,50,41
1650016345948,COGS 17,A01,092679,Staff,50,0,75,25
1650016351977,COGS 100,A01,083972,Staff,0,15,60,60
1650016364031,COGS 101C,A01,083976,Staff,12,0,30,18
1650016370055,COGS 102A,A01,083978,Johnson; Christine M.,14,0,30,16
1650016376079,COGS 107B,A01,083980,Staff,0,7,50,50
1650016382102,COGS 115,A01,083982,Staff,10,0,30,20
1650016388125,COGS 118B,A01,083367,Staff,0,15,40,40
1650016394151,COGS 172,A01,083984,Provenzano; Emily Kara,15,0,30,15
1650016400179,COGS 177,A00,083368,Staff,0,20,30,30
1650016406206,COGS 186,A01,083986,Staff,21,0,40,19
1650016412230,COGS 187A,A01,083988,Boyle; Mary E. T.,20,0,60,40
1650016418253,CSE 8A,A50,084003,Miranda; Gregory Joseph,0,13,15,15
1650016424280,CSE 11,A01,084005,Miranda; Gregory Joseph,0,22,55,55
1650016430309,CSE 20,A01,084007,Staff,0,5,20,20
1650016436336,CSE 21,A01,084009,Staff,0,30,50,50
1650016442360,CSE 30,A01,083370,Cao; Yingjun,0,65,40,40
1650016448386,CSE 100,A01,083372,Cao; Yingjun,0,46,40,40
1650016454409,CSE 101,A01,084011,Staff,0,54,40,40
1650016460438,CSE 141,A01,083374,Eldon; John,0,64,75,75
1650016466461,CSE 141L,A01,083376,Eldon; John,0,70,75,75
1650016472484,CSE 175,A01,084013,Kumar; Rakesh,22,0,25,3
1650016478506,CSE 190,A00,092508,Dubnov; Shlomo,20,0,20,0
1650016484556,ECE 5,A01,084049,Morris; Karcher William,13,0,20,7
1650016490585,ECE 100,A01,084051,Baghdadchi; Saharnaz,0,0,20,20
1650016490585,ECE 100,A02,091916,Baghdadchi; Saharnaz,13,0,20,7
1650016496610,ECE 101,A01,084053,Baghdadchi; Saharnaz,0,0,37,37
1650016496610,ECE 101,A02,084054,Baghdadchi; Saharnaz,30,0,37,7
1650016502640,ECE 107,A01,083390,Staff,26,0,40,14
1650016508663,ECE 148,A01,084056,Silberman; Jack,8,0,12,4
1650016514695,ECE 180,A00,083391,Abi Samra; Nicholas Camill,25,0,30,5
1650016514695,ECE 180,B00,083392,Abi Samra; Nicholas Camill,21,0,30,9
1650016520722,MATH 10B,A01,084110,Staff,0,0,30,30
1650016520722,MATH 10B,A02,084111,Staff,18,0,30,12
1650016520722,MATH 10B,A03,084112,Staff,24,0,30,6
1650016526752,MATH 10C,A01,083443,Staff,0,15,30,30
1650016526752,MATH 10C,A02,083444,Staff,0,15,30,30
1650016526752,MATH 10C,B01,084114,Staff,19,0,30,11
1650016526752,MATH 10C,B02,084115,Staff,25,0,30,5
1650016532775,MATH 18,A01,084117,Harel; Guershon,14,0,30,16
1650016532775,MATH 18,A02,084119,Harel; Guershon,28,0,30,2
1650016532775,MATH 18,A03,084120,Harel; Guershon,29,0,30,1
1650016532775,MATH 18,A04,084121,Harel; Guershon,29,0,30,1
1650016538806,MATH 20B,A01,084124,Um; Ko Woon,16,0,35,19
1650016538806,MATH 20B,B01,084126,Um; Ko Woon,24,0,35,11
1650016544838,MATH 20C,A01,083446,Hammock; Frances H,0,0,30,30
1650016544838,MATH 20C,A02,083447,Hammock; Frances H,16,0,30,14
1650016544838,MATH 20C,A03,083448,Hammock; Frances H,19,0,30,11
1650016544838,MATH 20C,A04,083449,Hammock; Frances H,20,0,30,10
1650016544838,MATH 20C,B01,083451,Hammock; Frances H,0,0,30,30
1650016544838,MATH 20C,B02,083452,Hammock; Frances H,19,0,30,11
1650016544838,MATH 20C,B03,083453,Hammock; Frances H,21,0,30,9
1650016544838,MATH 20C,B04,083454,Hammock; Frances H,23,0,30,7
1650016550862,MATH 20D,A01,084128,Staff,14,0,30,16
1650016550862,MATH 20D,A02,084129,Staff,29,0,30,1
1650016550862,MATH 20D,A03,084130,Staff,27,0,30,3
1650016550862,MATH 20D,B01,084133,Staff,3,0,30,27
1650016550862,MATH 20D,B02,084134,Staff,24,0,30,6
1650016550862,MATH 20D,B03,084135,Staff,28,0,30,2
1650016556894,MATH 20E,A01,084138,Staff,14,0,30,16
1650016556894,MATH 20E,A02,084139,Staff,6,0,30,24
1650016556894,MATH 20E,A03,084140,Staff,15,0,30,15
1650016556894,MATH 20E,A04,084141,Staff,20,0,30,10
1650016562923,MATH 102,A01,084143,Harel; Guershon,12,0,30,18
1650016562923,MATH 102,A02,084144,Harel; Guershon,20,0,30,10
1650016568950,MATH 103B,A01,083456,Staff,0,13,30,30
1650016568950,MATH 103B,A02,083457,Staff,0,13,30,30
1650016574975,MATH 109,A01,084146,Salehi Golsefidy; Alireza,18,0,30,12
1650016574975,MATH 109,A02,084147,Salehi Golsefidy; Alireza,15,0,30,15
1650016581006,MATH 120A,A01,085445,Eggers; John Dietrich,10,0,35,25
1650016581006,MATH 120A,A02,085446,Eggers; John Dietrich,27,0,35,8
1650016587034,MATH 142B,A01,084149,Verstraete; Jacques Allan,0,12,30,30
1650016587034,MATH 142B,A02,084150,Verstraete; Jacques Allan,0,12,30,30
1650016593058,MATH 170A,A01,083459,Nie; Jiawang,0,9,30,30
1650016593058,MATH 170A,A02,083460,Nie; Jiawang,0,8,30,30
1650016593058,MATH 170A,A03,083461,Nie; Jiawang,0,9,30,30
1650016599084,MATH 193B,A01,083463,Staff,1,0,30,29
1650016599084,MATH 193B,A02,083464,Staff,9,0,30,21
1650016599084,MATH 193B,A03,083465,Staff,18,0,30,12
1650016605150,COGS 2,A01,083966,Boyle; Mary E. T.,9,0,30,21
1650016611177,COGS 9,A01,083968,Staff,9,0,60,51
1650016617200,COGS 14B,A01,083970,Staff,9,0,50,41
1650016623310,COGS 17,A01,092679,Staff,50,0,75,25
1650016629332,COGS 100,A01,083972,Staff,0,15,60,60
1650016641385,COGS 101C,A01,083976,Staff,12,0,30,18
1650016647418,COGS 102A,A01,083978,Johnson; Christine M.,14,0,30,16
1650016653442,COGS 107B,A01,083980,Staff,0,7,50,50
1650016659468,COGS 115,A01,083982,Staff,10,0,30,20
1650016665494,COGS 118B,A01,083367,Staff,0,15,40,40
1650016671517,COGS 172,A01,083984,Provenzano; Emily Kara,15,0,30,15
1650016677539,COGS 177,A00,083368,Staff,0,20,30,30
1650016683566,COGS 186,A01,083986,Staff,21,0,40,19
1650016689593,COGS 187A,A01,083988,Boyle; Mary E. T.,20,0,60,40
1650016695618,CSE 8A,A50,084003,Miranda; Gregory Joseph,0,13,15,15
1650016701644,CSE 11,A01,084005,Miranda; Gregory Joseph,0,22,55,55
1650016707671,CSE 20,A01,084007,Staff,0,5,20,20
1650016713695,CSE 21,A01,084009,Staff,0,30,50,50
1650016719719,CSE 30,A01,083370,Cao; Yingjun,0,65,40,40
1650016725746,CSE 100,A01,083372,Cao; Yingjun,0,46,40,40
1650016731769,CSE 101,A01,084011,Staff,0,54,40,40
1650016737795,CSE 141,A01,083374,Eldon; John,0,64,75,75
1650016743832,CSE 141L,A01,083376,Eldon; John,0,70,75,75
1650016749858,CSE 175,A01,084013,Kumar; Rakesh,22,0,25,3
1650016755884,CSE 190,A00,092508,Dubnov; Shlomo,20,0,20,0
1650016761916,ECE 5,A01,084049,Morris; Karcher William,13,0,20,7
1650016767938,ECE 100,A01,084051,Baghdadchi; Saharnaz,0,0,20,20
1650016767938,ECE 100,A02,091916,Baghdadchi; Saharnaz,13,0,20,7
1650016773966,ECE 101,A01,084053,Baghdadchi; Saharnaz,0,0,37,37
1650016773966,ECE 101,A02,084054,Baghdadchi; Saharnaz,30,0,37,7
1650016779991,ECE 107,A01,083390,Staff,26,0,40,14
1650016786015,ECE 148,A01,084056,Silberman; Jack,8,0,12,4
1650016792038,ECE 180,A00,083391,Abi Samra; Nicholas Camill,25,0,30,5
1650016792038,ECE 180,B00,083392,Abi Samra; Nicholas Camill,21,0,30,9
1650016798063,MATH 10B,A01,084110,Staff,0,0,30,30
1650016798063,MATH 10B,A02,084111,Staff,18,0,30,12
1650016798063,MATH 10B,A03,084112,Staff,24,0,30,6
1650016804093,MATH 10C,A01,083443,Staff,0,15,30,30
1650016804093,MATH 10C,A02,083444,Staff,0,15,30,30
1650016804093,MATH 10C,B01,084114,Staff,19,0,30,11
1650016804093,MATH 10C,B02,084115,Staff,25,0,30,5
1650016810120,MATH 18,A01,084117,Harel; Guershon,14,0,30,16
1650016810120,MATH 18,A02,084119,Harel; Guershon,28,0,30,2
1650016810120,MATH 18,A03,084120,Harel; Guershon,29,0,30,1
1650016810120,MATH 18,A04,084121,Harel; Guershon,29,0,30,1
1650016816150,MATH 20B,A01,084124,Um; Ko Woon,16,0,35,19
1650016816150,MATH 20B,B01,084126,Um; Ko Woon,24,0,35,11
1650016822175,MATH 20C,A01,083446,Hammock; Frances H,0,0,30,30
1650016822175,MATH 20C,A02,083447,Hammock; Frances H,16,0,30,14
1650016822175,MATH 20C,A03,083448,Hammock; Frances H,19,0,30,11
1650016822175,MATH 20C,A04,083449,Hammock; Frances H,20,0,30,10
1650016822175,MATH 20C,B01,083451,Hammock; Frances H,0,0,30,30
1650016822175,MATH 20C,B02,083452,Hammock; Frances H,19,0,30,11
1650016822175,MATH 20C,B03,083453,Hammock; Frances H,21,0,30,9
1650016822175,MATH 20C,B04,083454,Hammock; Frances H,23,0,30,7
1650016828200,MATH 20D,A01,084128,Staff,14,0,30,16
1650016828200,MATH 20D,A02,084129,Staff,29,0,30,1
1650016828200,MATH 20D,A03,084130,Staff,27,0,30,3
1650016828200,MATH 20D,B01,084133,Staff,3,0,30,27
1650016828200,MATH 20D,B02,084134,Staff,24,0,30,6
1650016828200,MATH 20D,B03,084135,Staff,28,0,30,2
1650016834226,MATH 20E,A01,084138,Staff,14,0,30,16
1650016834226,MATH 20E,A02,084139,Staff,6,0,30,24
1650016834226,MATH 20E,A03,084140,Staff,15,0,30,15
1650016834226,MATH 20E,A04,084141,Staff,20,0,30,10
1650016840249,MATH 102,A01,084143,Harel; Guershon,12,0,30,18
1650016840249,MATH 102,A02,084144,Harel; Guershon,20,0,30,10
1650016846275,MATH 103B,A01,083456,Staff,0,13,30,30
1650016846275,MATH 103B,A02,083457,Staff,0,13,30,30
1650016852300,MATH 109,A01,084146,Salehi Golsefidy; Alireza,18,0,30,12
1650016852300,MATH 109,A02,084147,Salehi Golsefidy; Alireza,15,0,30,15
1650016858328,MATH 120A,A01,085445,Eggers; John Dietrich,10,0,35,25
1650016858328,MATH 120A,A02,085446,Eggers; John Dietrich,27,0,35,8
1650016864360,MATH 142B,A01,084149,Verstraete; Jacques Allan,0,12,30,30
1650016864360,MATH 142B,A02,084150,Verstraete; Jacques Allan,0,12,30,30
1650016870383,MATH 170A,A01,083459,Nie; Jiawang,0,9,30,30
1650016870383,MATH 170A,A02,083460,Nie; Jiawang,0,8,30,30
1650016870383,MATH 170A,A03,083461,Nie; Jiawang,0,9,30,30
1650016876408,MATH 193B,A01,083463,Staff,1,0,30,29
1650016876408,MATH 193B,A02,083464,Staff,9,0,30,21
1650016876408,MATH 193B,A03,083465,Staff,18,0,30,12
1650016882467,COGS 2,A01,083966,Boyle; Mary E. T.,9,0,30,21
1650016888489,COGS 9,A01,083968,Staff,9,0,60,51
1650016894512,COGS 14B,A01,083970,Staff,9,0,50,41
1650016900538,COGS 17,A01,092679,Staff,50,0,75,25
1650016906562,COGS 100,A01,083972,Staff,0,15,60,60
1650016918613,COGS 101C,A01,083976,Staff,12,0,30,18
1650016924636,COGS 102A,A01,083978,Johnson; Christine M.,14,0,30,16
1650016930664,COGS 107B,A01,083980,Staff,0,7,50,50
1650016936696,COGS 115,A01,083982,Staff,10,0,30,20
1650016942724,COGS 118B,A01,083367,Staff,0,15,40,40
1650016948748,COGS 172,A01,083984,Provenzano; Emily Kara,15,0,30,15
1650016954774,COGS 177,A00,083368,Staff,0,20,30,30
1650016960798,COGS 186,A01,083986,Staff,21,0,40,19
1650016966828,COGS 187A,A01,083988,Boyle; Mary E. T.,20,0,60,40
1650016972856,CSE 8A,A50,084003,Miranda; Gregory Joseph,0,13,15,15
1650016978882,CSE 11,A01,084005,Miranda; Gregory Joseph,0,22,55,55
1650016984905,CSE 20,A01,084007,Staff,0,5,20,20
1650016990929,CSE 21,A01,084009,Staff,0,30,50,50
1650016996958,CSE 30,A01,083370,Cao; Yingjun,0,65,40,40
1650017002981,CSE 100,A01,083372,Cao; Yingjun,0,46,40,40
1650017009010,CSE 101,A01,084011,Staff,0,54,40,40
1650017015033,CSE 141,A01,083374,Eldon; John,0,64,75,75
1650017021060,CSE 141L,A01,083376,Eldon; John,0,70,75,75
1650017027087,CSE 175,A01,084013,Kumar; Rakesh,22,0,25,3
1650017033111,CSE 190,A00,092508,Dubnov; Shlomo,20,0,20,0
1650017039134,ECE 5,A01,084049,Morris; Karcher William,13,0,20,7
1650017045159,ECE 100,A01,084051,Baghdadchi; Saharnaz,0,0,20,20
1650017045159,ECE 100,A02,091916,Baghdadchi; Saharnaz,13,0,20,7
1650017051189,ECE 101,A01,084053,Baghdadchi; Saharnaz,0,0,37,37
1650017051189,ECE 101,A02,084054,Baghdadchi; Saharnaz,30,0,37,7
1650017057218,ECE 107,A01,083390,Staff,26,0,40,14
1650017063245,ECE 148,A01,084056,Silberman; Jack,8,0,12,4
1650017069276,ECE 180,A00,083391,Abi Samra; Nicholas Camill,25,0,30,5
1650017069276,ECE 180,B00,083392,Abi Samra; Nicholas Camill,21,0,30,9
1650017075300,MATH 10B,A01,084110,Staff,0,0,30,30
1650017075300,MATH 10B,A02,084111,Staff,18,0,30,12
1650017075300,MATH 10B,A03,084112,Staff,24,0,30,6
1650017081323,MATH 10C,A01,083443,Staff,0,15,30,30
1650017081323,MATH 10C,A02,083444,Staff,0,15,30,30
1650017081323,MATH 10C,B01,084114,Staff,19,0,30,11
1650017081323,MATH 10C,B02,084115,Staff,25,0,30,5
1650017087347,MATH 18,A01,084117,Harel; Guershon,14,0,30,16
1650017087347,MATH 18,A02,084119,Harel; Guershon,28,0,30,2
1650017087347,MATH 18,A03,084120,Harel; Guershon,29,0,30,1
1650017087347,MATH 18,A04,084121,Harel; Guershon,29,0,30,1
1650017093377,MATH 20B,A01,084124,Um; Ko Woon,16,0,35,19
1650017093377,MATH 20B,B01,084126,Um; Ko Woon,24,0,35,11
1650017099399,MATH 20C,A01,083446,Hammock; Frances H,0,0,30,30
1650017099399,MATH 20C,A02,083447,Hammock; Frances H,16,0,30,14
1650017099399,MATH 20C,A03,083448,Hammock; Frances H,19,0,30,11
1650017099399,MATH 20C,A04,083449,Hammock; Frances H,20,0,30,10
1650017099399,MATH 20C,B01,083451,Hammock; Frances H,0,0,30,30
1650017099399,MATH 20C,B02,083452,Hammock; Frances H,19,0,30,11
1650017099399,MATH 20C,B03,083453,Hammock; Frances H,21,0,30,9
1650017099399,MATH 20C,B04,083454,Hammock; Frances H,23,0,30,7
1650017105438,MATH 20D,A01,084128,Staff,14,0,30,16
1650017105438,MATH 20D,A02,084129,Staff,29,0,30,1
1650017105438,MATH 20D,A03,084130,Staff,27,0,30,3
1650017105438,MATH 20D,B01,084133,Staff,3,0,30,27
1650017105438,MATH 20D,B02,084134,Staff,24,0,30,6
1650017105438,MATH 20D,B03,084135,Staff,28,0,30,2
1650017111464,MATH 20E,A01,084138,Staff,14,0,30,16
1650017111464,MATH 20E,A02,084139,Staff,6,0,30,24
1650017111464,MATH 20E,A03,084140,Staff,15,0,30,15
1650017111464,MATH 20E,A04,084141,Staff,20,0,30,10
1650017117491,MATH 102,A01,084143,Harel; Guershon,12,0,30,18
1650017117491,MATH 102,A02,084144,Harel; Guershon,20,0,30,10
1650017123515,MATH 103B,A01,083456,Staff,0,13,30,30
1650017123515,MATH 103B,A02,083457,Staff,0,13,30,30
1650017129540,MATH 109,A01,084146,Salehi Golsefidy; Alireza,18,0,30,12
1650017129540,MATH 109,A02,084147,Salehi Golsefidy; Alireza,15,0,30,15
1650017135569,MATH 120A,A01,085445,Eggers; John Dietrich,10,0,35,25
1650017135569,MATH 120A,A02,085446,Eggers; John Dietrich,27,0,35,8
1650017141594,MATH 142B,A01,084149,Verstraete; Jacques Allan,0,12,30,30
1650017141594,MATH 142B,A02,084150,Verstraete; Jacques Allan,0,12,30,30
1650017147621,MATH 170A,A01,083459,Nie; Jiawang,0,9,30,30
1650017147621,MATH 170A,A02,083460,Nie; Jiawang,0,8,30,30
1650017147621,MATH 170A,A03,083461,Nie; Jiawang,0,9,30,30
1650017153646,MATH 193B,A01,083463,Staff,1,0,30,29
1650017153646,MATH 193B,A02,083464,Staff,9,0,30,21
1650017153646,MATH 193B,A03,083465,Staff,18,0,30,12
1650017159709,COGS 2,A01,083966,Boyle; Mary E. T.,9,0,30,21
1650017165756,COGS 9,A01,083968,Staff,9,0,60,51
1650017171779,COGS 14B,A01,083970,Staff,9,0,50,41
1650017177806,COGS 17,A01,092679,Staff,50,0,75,25
1650017183831,COGS 100,A01,083972,Staff,0,15,60,60
1650017195890,COGS 101C,A01,083976,Staff,12,0,30,18
1650017201916,COGS 102A,A01,083978,Johnson; Christine M.,14,0,30,16
1650017207940,COGS 107B,A01,083980,Staff,0,7,50,50
1650017213968,COGS 115,A01,083982,Staff,10,0,30,20
1650017220085,COGS 118B,A01,083367,Staff,0,15,40,40
1650017226110,COGS 172,A01,083984,Provenzano; Emily Kara,15,0,30,15
1650017232137,COGS 177,A00,083368,Staff,0,20,30,30
1650017238160,COGS 186,A01,083986,Staff,21,0,40,19
1650017244181,COGS 187A,A01,083988,Boyle; Mary E. T.,20,0,60,40
1650017250204,CSE 8A,A50,084003,Miranda; Gregory Joseph,0,13,15,15
1650017256226,CSE 11,A01,084005,Miranda; Gregory Joseph,0,22,55,55
1650017262250,CSE 20,A01,084007,Staff,0,5,20,20
1650017268276,CSE 21,A01,084009,Staff,0,30,50,50
1650017274300,CSE 30,A01,083370,Cao; Yingjun,0,65,40,40
1650017280324,CSE 100,A01,083372,Cao; Yingjun,0,46,40,40
1650017286351,CSE 101,A01,084011,Staff,0,54,40,40
1650017292374,CSE 141,A01,083374,Eldon; John,0,64,75,75
1650017298396,CSE 141L,A01,083376,Eldon; John,0,70,75,75
1650017304419,CSE 175,A01,084013,Kumar; Rakesh,22,0,25,3
1650017310447,CSE 190,A00,092508,Dubnov; Shlomo,20,0,20,0
1650017316474,ECE 5,A01,084049,Morris; Karcher William,13,0,20,7
1650017322497,ECE 100,A01,084051,Baghdadchi; Saharnaz,0,0,20,20
1650017322497,ECE 100,A02,091916,Baghdadchi; Saharnaz,13,0,20,7
1650017328521,ECE 101,A01,084053,Baghdadchi; Saharnaz,0,0,37,37
1650017328521,ECE 101,A02,084054,Baghdadchi; Saharnaz,30,0,37,7
1650017334545,ECE 107,A01,083390,Staff,26,0,40,14
1650017340570,ECE 148,A01,084056,Silberman; Jack,8,0,12,4
1650017346599,ECE 180,A00,083391,Abi Samra; Nicholas Camill,25,0,30,5
1650017346599,ECE 180,B00,083392,Abi Samra; Nicholas Camill,21,0,30,9
1650017352630,MATH 10B,A01,084110,Staff,0,0,30,30
1650017352630,MATH 10B,A02,084111,Staff,18,0,30,12
1650017352630,MATH 10B,A03,084112,Staff,24,0,30,6
1650017358656,MATH 10C,A01,083443,Staff,0,15,30,30
1650017358656,MATH 10C,A02,083444,Staff,0,15,30,30
1650017358656,MATH 10C,B01,084114,Staff,19,0,30,11
1650017358656,MATH 10C,B02,084115,Staff,25,0,30,5
1650017364686,MATH 18,A01,084117,Harel; Guershon,14,0,30,16
1650017364686,MATH 18,A02,084119,Harel; Guershon,28,0,30,2
1650017364686,MATH 18,A03,084120,Harel; Guershon,29,0,30,1
1650017364686,MATH 18,A04,084121,Harel; Guershon,29,0,30,1
1650017370715,MATH 20B,A01,084124,Um; Ko Woon,16,0,35,19
1650017370715,MATH 20B,B01,084126,Um; Ko Woon,24,0,35,11
1650017376746,MATH 20C,A01,083446,Hammock; Frances H,0,0,30,30
1650017376746,MATH 20C,A02,083447,Hammock; Frances H,16,0,30,14
1650017376746,MATH 20C,A03,083448,Hammock; Frances H,19,0,30,11
1650017376746,MATH 20C,A04,083449,Hammock; Frances H,20,0,30,10
1650017376746,MATH 20C,B01,083451,Hammock; Frances H,0,0,30,30
1650017376746,MATH 20C,B02,083452,Hammock; Frances H,19,0,30,11
1650017376746,MATH 20C,B03,083453,Hammock; Frances H,21,0,30,9
1650017376746,MATH 20C,B04,083454,Hammock; Frances H,23,0,30,7
1650017382771,MATH 20D,A01,084128,Staff,14,0,30,16
1650017382771,MATH 20D,A02,084129,Staff,29,0,30,1
1650017382771,MATH 20D,A03,084130,Staff,27,0,30,3
1650017382771,MATH 20D,B01,084133,Staff,3,0,30,27
1650017382771,MATH 20D,B02,084134,Staff,24,0,30,6
1650017382771,MATH 20D,B03,084135,Staff,28,0,30,2
1650017388796,MATH 20E,A01,084138,Staff,14,0,30,16
1650017388796,MATH 20E,A02,084139,Staff,6,0,30,24
1650017388796,MATH 20E,A03,084140,Staff,15,0,30,15
1650017388796,MATH 20E,A04,084141,Staff,20,0,30,10
1650017394826,MATH 102,A01,084143,Harel; Guershon,12,0,30,18
1650017394826,MATH 102,A02,084144,Harel; Guershon,20,0,30,10
1650017400849,MATH 103B,A01,083456,Staff,0,13,30,30
1650017400849,MATH 103B,A02,083457,Staff,0,13,30,30
1650017406876,MATH 109,A01,084146,Salehi Golsefidy; Alireza,18,0,30,12
1650017406876,MATH 109,A02,084147,Salehi Golsefidy; Alireza,15,0,30,15
1650017412905,MATH 120A,A01,085445,Eggers; John Dietrich,10,0,35,25
1650017412905,MATH 120A,A02,085446,Eggers; John Dietrich,27,0,35,8
1650017418933,MATH 142B,A01,084149,Verstraete; Jacques Allan,0,12,30,30
1650017418933,MATH 142B,A02,084150,Verstraete; Jacques Allan,0,12,30,30
1650017424958,MATH 170A,A01,083459,Nie; Jiawang,0,9,30,30
1650017424958,MATH 170A,A02,083460,Nie; Jiawang,0,8,30,30
1650017424958,MATH 170A,A03,083461,Nie; Jiawang,0,9,30,30
1650017430982,MATH 193B,A01,083463,Staff,1,0,30,29
1650017430982,MATH 193B,A02,083464,Staff,9,0,30,21
1650017430982,MATH 193B,A03,083465,Staff,18,0,30,12
1650017437045,COGS 2,A01,083966,Boyle; Mary E. T.,9,0,30,21
1650017443069,COGS 9,A01,083968,Staff,9,0,60,51
1650017449093,COGS 14B,A01,083970,Staff,9,0,50,41
1650017455117,COGS 17,A01,092679,Staff,50,0,75,25
1650017461141,COGS 100,A01,083972,Staff,0,15,60,60
1650017473191,COGS 101C,A01,083976,Staff,12,0,30,18
1650017479219,COGS 102A,A01,083978,Johnson; Christine M.,14,0,30,16
1650017485243,COGS 107B,A01,083980,Staff,0,7,50,50
1650017491269,COGS 115,A01,083982,Staff,10,0,30,20
1650017497297,COGS 118B,A01,083367,Staff,0,15,40,40
1650017503322,COGS 172,A01,083984,Provenzano; Emily Kara,15,0,30,15
1650017509345,COGS 177,A00,083368,Staff,0,20,30,30
1650017515374,COGS 186,A01,083986,Staff,21,0,40,19
1650017521408,COGS 187A,A01,083988,Boyle; Mary E. T.,20,0,60,40
1650017527434,CSE 8A,A50,084003,Miranda; Gregory Joseph,0,13,15,15
1650017533462,CSE 11,A01,084005,Miranda; Gregory Joseph,0,22,55,55
1650017539489,CSE 20,A01,084007,Staff,0,5,20,20
1650017545515,CSE 21,A01,084009,Staff,0,30,50,50
1650017551544,CSE 30,A01,083370,Cao; Yingjun,0,65,40,40
1650017557573,CSE 100,A01,083372,Cao; Yingjun,0,46,40,40
1650017563597,CSE 101,A01,084011,Staff,0,54,40,40
1650017569621,CSE 141,A01,083374,Eldon; John,0,64,75,75
1650017575649,CSE 141L,A01,083376,Eldon; John,0,70,75,75
1650017581674,CSE 175,A01,084013,Kumar; Rakesh,22,0,25,3
1650017587698,CSE 190,A00,092508,Dubnov; Shlomo,20,0,20,0
1650017593721,ECE 5,A01,084049,Morris; Karcher William,13,0,20,7
1650017599746,ECE 100,A01,084051,Baghdadchi; Saharnaz,0,0,20,20
1650017599746,ECE 100,A02,091916,Baghdadchi; Saharnaz,13,0,20,7
1650017605768,ECE 101,A01,084053,Baghdadchi; Saharnaz,0,0,37,37
1650017605768,ECE 101,A02,084054,Baghdadchi; Saharnaz,30,0,37,7
1650017611792,ECE 107,A01,083390,Staff,26,0,40,14
1650017617821,ECE 148,A01,084056,Silberman; Jack,8,0,12,4
1650017623849,ECE 180,A00,083391,Abi Samra; Nicholas Camill,25,0,30,5
1650017623849,ECE 180,B00,083392,Abi Samra; Nicholas Camill,21,0,30,9
1650017629876,MATH 10B,A01,084110,Staff,0,0,30,30
1650017629876,MATH 10B,A02,084111,Staff,18,0,30,12
1650017629876,MATH 10B,A03,084112,Staff,24,0,30,6
1650017635901,MATH 10C,A01,083443,Staff,0,15,30,30
1650017635901,MATH 10C,A02,083444,Staff,0,15,30,30
1650017635901,MATH 10C,B01,084114,Staff,19,0,30,11
1650017635901,MATH 10C,B02,084115,Staff,25,0,30,5
1650017641924,MATH 18,A01,084117,Harel; Guershon,14,0,30,16
1650017641924,MATH 18,A02,084119,Harel; Guershon,28,0,30,2
1650017641924,MATH 18,A03,084120,Harel; Guershon,29,0,30,1
1650017641924,MATH 18,A04,084121,Harel; Guershon,29,0,30,1
1650017647948,MATH 20B,A01,084124,Um; Ko Woon,16,0,35,19
1650017647948,MATH 20B,B01,084126,Um; Ko Woon,24,0,35,11
1650017653974,MATH 20C,A01,083446,Hammock; Frances H,0,0,30,30
1650017653974,MATH 20C,A02,083447,Hammock; Frances H,16,0,30,14
1650017653974,MATH 20C,A03,083448,Hammock; Frances H,19,0,30,11
1650017653974,MATH 20C,A04,083449,Hammock; Frances H,20,0,30,10
1650017653974,MATH 20C,B01,083451,Hammock; Frances H,0,0,30,30
1650017653974,MATH 20C,B02,083452,Hammock; Frances H,19,0,30,11
1650017653974,MATH 20C,B03,083453,Hammock; Frances H,21,0,30,9
1650017653974,MATH 20C,B04,083454,Hammock; Frances H,23,0,30,7
1650017660000,MATH 20D,A01,084128,Staff,14,0,30,16
1650017660000,MATH 20D,A02,084129,Staff,29,0,30,1
1650017660000,MATH 20D,A03,084130,Staff,27,0,30,3
1650017660000,MATH 20D,B01,084133,Staff,3,0,30,27
1650017660000,MATH 20D,B02,084134,Staff,24,0,30,6
1650017660000,MATH 20D,B03,084135,Staff,28,0,30,2
1650017666025,MATH 20E,A01,084138,Staff,14,0,30,16
1650017666025,MATH 20E,A02,084139,Staff,6,0,30,24
1650017666025,MATH 20E,A03,084140,Staff,15,0,30,15
1650017666025,MATH 20E,A04,084141,Staff,20,0,30,10
1650017672048,MATH 102,A01,084143,Harel; Guershon,12,0,30,18
1650017672048,MATH 102,A02,084144,Harel; Guershon,20,0,30,10
1650017678075,MATH 103B,A01,083456,Staff,0,13,30,30
1650017678075,MATH 103B,A02,083457,Staff,0,13,30,30
1650017684103,MATH 109,A01,084146,Salehi Golsefidy; Alireza,18,0,30,12
1650017684103,MATH 109,A02,084147,Salehi Golsefidy; Alireza,15,0,30,15
1650017690131,MATH 120A,A01,085445,Eggers; John Dietrich,10,0,35,25
1650017690131,MATH 120A,A02,085446,Eggers; John Dietrich,27,0,35,8
1650017696156,MATH 142B,A01,084149,Verstraete; Jacques Allan,0,12,30,30
1650017696156,MATH 142B,A02,084150,Verstraete; Jacques Allan,0,12,30,30
1650017702184,MATH 170A,A01,083459,Nie; Jiawang,0,9,30,30
1650017702184,MATH 170A,A02,083460,Nie; Jiawang,0,8,30,30
1650017702184,MATH 170A,A03,083461,Nie; Jiawang,0,9,30,30
1650017708213,MATH 193B,A01,083463,Staff,1,0,30,29
1650017708213,MATH 193B,A02,083464,Staff,9,0,30,21
1650017708213,MATH 193B,A03,083465,Staff,18,0,30,12
1650017714267,COGS 2,A01,083966,Boyle; Mary E. T.,9,0,30,21
1650017720297,COGS 9,A01,083968,Staff,9,0,60,51
1650017726328,COGS 14B,A01,083970,Staff,9,0,50,41
1650017732350,COGS 17,A01,092679,Staff,50,0,75,25
1650017738387,COGS 100,A01,083972,Staff,0,15,60,60
1650017750435,COGS 101C,A01,083976,Staff,12,0,30,18
1650017756463,COGS 102A,A01,083978,Johnson; Christine M.,14,0,30,16
1650017762490,COGS 107B,A01,083980,Staff,0,7,50,50
1650017768515,COGS 115,A01,083982,Staff,10,0,30,20
1650017774538,COGS 118B,A01,083367,Staff,0,15,40,40
1650017780567,COGS 172,A01,083984,Provenzano; Emily Kara,15,0,30,15
1650017786591,COGS 177,A00,083368,Staff,0,20,30,30
1650017792620,COGS 186,A01,083986,Staff,21,0,40,19
1650017798644,COGS 187A,A01,083988,Boyle; Mary E. T.,20,0,60,40
1650017804672,CSE 8A,A50,084003,Miranda; Gregory Joseph,0,13,15,15
1650017810697,CSE 11,A01,084005,Miranda; Gregory Joseph,0,22,55,55
1650017816830,CSE 20,A01,084007,Staff,0,5,20,20
1650017822855,CSE 21,A01,084009,Staff,0,30,50,50
1650017828879,CSE 30,A01,083370,Cao; Yingjun,0,65,40,40
1650017834907,CSE 100,A01,083372,Cao; Yingjun,0,46,40,40
1650017840931,CSE 101,A01,084011,Staff,0,54,40,40
1650017846956,CSE 141,A01,083374,Eldon; John,0,64,75,75
1650017852978,CSE 141L,A01,083376,Eldon; John,0,70,75,75
1650017859006,CSE 175,A01,084013,Kumar; Rakesh,22,0,25,3
1650017865034,CSE 190,A00,092508,Dubnov; Shlomo,20,0,20,0
1650017871057,ECE 5,A01,084049,Morris; Karcher William,13,0,20,7
1650017877086,ECE 100,A01,084051,Baghdadchi; Saharnaz,0,0,20,20
1650017877086,ECE 100,A02,091916,Baghdadchi; Saharnaz,13,0,20,7
1650017883112,ECE 101,A01,084053,Baghdadchi; Saharnaz,0,0,37,37
1650017883112,ECE 101,A02,084054,Baghdadchi; Saharnaz,30,0,37,7
1650017889139,ECE 107,A01,083390,Staff,26,0,40,14
1650017895164,ECE 148,A01,084056,Silberman; Jack,8,0,12,4
1650017901196,ECE 180,A00,083391,Abi Samra; Nicholas Camill,25,0,30,5
1650017901196,ECE 180,B00,083392,Abi Samra; Nicholas Camill,21,0,30,9
1650017907219,MATH 10B,A01,084110,Staff,0,0,30,30
1650017907219,MATH 10B,A02,084111,Staff,18,0,30,12
1650017907219,MATH 10B,A03,084112,Staff,24,0,30,6
1650017913243,MATH 10C,A01,083443,Staff,0,15,30,30
1650017913243,MATH 10C,A02,083444,Staff,0,15,30,30
1650017913243,MATH 10C,B01,084114,Staff,19,0,30,11
1650017913243,MATH 10C,B02,084115,Staff,25,0,30,5
1650017919263,MATH 18,A01,084117,Harel; Guershon,14,0,30,16
1650017919263,MATH 18,A02,084119,Harel; Guershon,28,0,30,2
1650017919263,MATH 18,A03,084120,Harel; Guershon,29,0,30,1
1650017919263,MATH 18,A04,084121,Harel; Guershon,29,0,30,1
1650017925287,MATH 20B,A01,084124,Um; Ko Woon,16,0,35,19
1650017925287,MATH 20B,B01,084126,Um; Ko Woon,24,0,35,11
1650017931314,MATH 20C,A01,083446,Hammock; Frances H,0,0,30,30
1650017931314,MATH 20C,A02,083447,Hammock; Frances H,16,0,30,14
1650017931314,MATH 20C,A03,083448,Hammock; Frances H,19,0,30,11
1650017931314,MATH 20C,A04,083449,Hammock; Frances H,20,0,30,10
1650017931314,MATH 20C,B01,083451,Hammock; Frances H,0,0,30,30
1650017931314,MATH 20C,B02,083452,Hammock; Frances H,19,0,30,11
1650017931314,MATH 20C,B03,083453,Hammock; Frances H,21,0,30,9
1650017931314,MATH 20C,B04,083454,Hammock; Frances H,23,0,30,7
1650017937338,MATH 20D,A01,084128,Staff,14,0,30,16
1650017937338,MATH 20D,A02,084129,Staff,29,0,30,1
1650017937338,MATH 20D,A03,084130,Staff,27,0,30,3
1650017937338,MATH 20D,B01,084133,Staff,3,0,30,27
1650017937338,MATH 20D,B02,084134,Staff,24,0,30,6
1650017937338,MATH 20D,B03,084135,Staff,28,0,30,2
1650017943364,MATH 20E,A01,084138,Staff,14,0,30,16
1650017943364,MATH 20E,A02,084139,Staff,6,0,30,24
1650017943364,MATH 20E,A03,084140,Staff,15,0,30,15
1650017943364,MATH 20E,A04,084141,Staff,20,0,30,10
1650017949388,MATH 102,A01,084143,Harel; Guershon,12,0,30,18
1650017949388,MATH 102,A02,084144,Harel; Guershon,20,0,30,10
1650017955417,MATH 103B,A01,083456,Staff,0,13,30,30
1650017955417,MATH 103B,A02,083457,Staff,0,13,30,30
1650017961441,MATH 109,A01,084146,Salehi Golsefidy; Alireza,18,0,30,12
1650017961441,MATH 109,A02,084147,Salehi Golsefidy; Alireza,15,0,30,15
1650017967464,MATH 120A,A01,085445,Eggers; John Dietrich,10,0,35,25
1650017967464,MATH 120A,A02,085446,Eggers; John Dietrich,27,0,35,8
1650017973493,MATH 142B,A01,084149,Verstraete; Jacques Allan,0,12,30,30
1650017973493,MATH 142B,A02,084150,Verstraete; Jacques Allan,0,12,30,30
1650017979522,MATH 170A,A01,083459,Nie; Jiawang,0,9,30,30
1650017979522,MATH 170A,A02,083460,Nie; Jiawang,0,8,30,30
1650017979522,MATH 170A,A03,083461,Nie; Jiawang,0,9,30,30
1650017985551,MATH 193B,A01,083463,Staff,1,0,30,29
1650017985551,MATH 193B,A02,083464,Staff,9,0,30,21
1650017985551,MATH 193B,A03,083465,Staff,18,0,30,12
1650017991623,COGS 2,A01,083966,Boyle; Mary E. T.,9,0,30,21
1650017997646,COGS 9,A01,083968,Staff,9,0,60,51
1650018003675,COGS 14B,A01,083970,Staff,9,0,50,41
1650018009705,COGS 17,A01,092679,Staff,50,0,75,25
1650018015728,COGS 100,A01,083972,Staff,0,15,60,60
1650018027775,COGS 101C,A01,083976,Staff,12,0,30,18
1650018033800,COGS 102A,A01,083978,Johnson; Christine M.,14,0,30,16
1650018039828,COGS 107B,A01,083980,Staff,0,7,50,50
1650018045851,COGS 115,A01,083982,Staff,10,0,30,20
1650018051875,COGS 118B,A01,083367,Staff,0,15,40,40
1650018057900,COGS 172,A01,083984,Provenzano; Emily Kara,15,0,30,15
1650018063927,COGS 177,A00,083368,Staff,0,20,30,30
1650018069951,COGS 186,A01,083986,Staff,21,0,40,19
1650018075981,COGS 187A,A01,083988,Boyle; Mary E. T.,20,0,60,40
1650018082009,CSE 8A,A50,084003,Miranda; Gregory Joseph,0,13,15,15
1650018088044,CSE 11,A01,084005,Miranda; Gregory Joseph,0,22,55,55
1650018094068,CSE 20,A01,084007,Staff,0,5,20,20
1650018100093,CSE 21,A01,084009,Staff,0,30,50,50
1650018106118,CSE 30,A01,083370,Cao; Yingjun,0,65,40,40
1650018112146,CSE 100,A01,083372,Cao; Yingjun,0,46,40,40
1650018118170,CSE 101,A01,084011,Staff,0,54,40,40
1650018124199,CSE 141,A01,083374,Eldon; John,0,64,75,75
1650018130227,CSE 141L,A01,083376,Eldon; John,0,70,75,75
1650018136255,CSE 175,A01,084013,Kumar; Rakesh,22,0,25,3
1650018142279,CSE 190,A00,092508,Dubnov; Shlomo,20,0,20,0
1650018148307,ECE 5,A01,084049,Morris; Karcher William,13,0,20,7
1650018154335,ECE 100,A01,084051,Baghdadchi; Saharnaz,0,0,20,20
1650018154335,ECE 100,A02,091916,Baghdadchi; Saharnaz,13,0,20,7
1650018160363,ECE 101,A01,084053,Baghdadchi; Saharnaz,0,0,37,37
1650018160363,ECE 101,A02,084054,Baghdadchi; Saharnaz,30,0,37,7
1650018166388,ECE 107,A01,083390,Staff,26,0,40,14
1650018172414,ECE 148,A01,084056,Silberman; Jack,8,0,12,4
1650018178451,ECE 180,A00,083391,Abi Samra; Nicholas Camill,25,0,30,5
1650018178451,ECE 180,B00,083392,Abi Samra; Nicholas Camill,21,0,30,9
1650018184476,MATH 10B,A01,084110,Staff,0,0,30,30
1650018184476,MATH 10B,A02,084111,Staff,18,0,30,12
1650018184476,MATH 10B,A03,084112,Staff,24,0,30,6
1650018190501,MATH 10C,A01,083443,Staff,0,15,30,30
1650018190501,MATH 10C,A02,083444,Staff,0,15,30,30
1650018190501,MATH 10C,B01,084114,Staff,19,0,30,11
1650018190501,MATH 10C,B02,084115,Staff,25,0,30,5
1650018196527,MATH 18,A01,084117,Harel; Guershon,14,0,30,16
1650018196527,MATH 18,A02,084119,Harel; Guershon,28,0,30,2
1650018196527,MATH 18,A03,084120,Harel; Guershon,29,0,30,1
1650018196527,MATH 18,A04,084121,Harel; Guershon,29,0,30,1
1650018202552,MATH 20B,A01,084124,Um; Ko Woon,16,0,35,19
1650018202552,MATH 20B,B01,084126,Um; Ko Woon,24,0,35,11
1650018208576,MATH 20C,A01,083446,Hammock; Frances H,0,0,30,30
1650018208576,MATH 20C,A02,083447,Hammock; Frances H,16,0,30,14
1650018208576,MATH 20C,A03,083448,Hammock; Frances H,19,0,30,11
1650018208576,MATH 20C,A04,083449,Hammock; Frances H,20,0,30,10
1650018208576,MATH 20C,B01,083451,Hammock; Frances H,0,0,30,30
1650018208576,MATH 20C,B02,083452,Hammock; Frances H,19,0,30,11
1650018208576,MATH 20C,B03,083453,Hammock; Frances H,21,0,30,9
1650018208576,MATH 20C,B04,083454,Hammock; Frances H,23,0,30,7
1650018214604,MATH 20D,A01,084128,Staff,14,0,30,16
1650018214604,MATH 20D,A02,084129,Staff,29,0,30,1
1650018214604,MATH 20D,A03,084130,Staff,27,0,30,3
1650018214604,MATH 20D,B01,084133,Staff,3,0,30,27
1650018214604,MATH 20D,B02,084134,Staff,24,0,30,6
1650018214604,MATH 20D,B03,084135,Staff,28,0,30,2
1650018220634,MATH 20E,A01,084138,Staff,14,0,30,16
1650018220634,MATH 20E,A02,084139,Staff,6,0,30,24
1650018220634,MATH 20E,A03,084140,Staff,15,0,30,15
1650018220634,MATH 20E,A04,084141,Staff,20,0,30,10
1650018226658,MATH 102,A01,084143,Harel; Guershon,12,0,30,18
1650018226658,MATH 102,A02,084144,Harel; Guershon,20,0,30,10
1650018232683,MATH 103B,A01,083456,Staff,0,13,30,30
1650018232683,MATH 103B,A02,083457,Staff,0,13,30,30
1650018238708,MATH 109,A01,084146,Salehi Golsefidy; Alireza,18,0,30,12
1650018238708,MATH 109,A02,084147,Salehi Golsefidy; Alireza,15,0,30,15
1650018244733,MATH 120A,A01,085445,Eggers; John Dietrich,10,0,35,25
1650018244733,MATH 120A,A02,085446,Eggers; John Dietrich,27,0,35,8
1650018250758,MATH 142B,A01,084149,Verstraete; Jacques Allan,0,12,30,30
1650018250758,MATH 142B,A02,084150,Verstraete; Jacques Allan,0,12,30,30
1650018256787,MATH 170A,A01,083459,Nie; Jiawang,0,9,30,30
1650018256787,MATH 170A,A02,083460,Nie; Jiawang,0,8,30,30
1650018256787,MATH 170A,A03,083461,Nie; Jiawang,0,9,30,30
1650018262816,MATH 193B,A01,083463,Staff,1,0,30,29
1650018262816,MATH 193B,A02,083464,Staff,9,0,30,21
1650018262816,MATH 193B,A03,083465,Staff,18,0,30,12
1650018268867,COGS 2,A01,083966,Boyle; Mary E. T.,9,0,30,21
1650018274892,COGS 9,A01,083968,Staff,9,0,60,51
1650018280919,COGS 14B,A01,083970,Staff,9,0,50,41
1650018286945,COGS 17,A01,092679,Staff,50,0,75,25
1650018292970,COGS 100,A01,083972,Staff,0,15,60,60
1650018305026,COGS 101C,A01,083976,Staff,12,0,30,18
1650018311061,COGS 102A,A01,083978,Johnson; Christine M.,14,0,30,16
1650018317084,COGS 107B,A01,083980,Staff,0,7,50,50
1650018323108,COGS 115,A01,083982,Staff,10,0,30,20
1650018329135,COGS 118B,A01,083367,Staff,0,15,40,40
1650018335159,COGS 172,A01,083984,Provenzano; Emily Kara,15,0,30,15
1650018341189,COGS 177,A00,083368,Staff,0,20,30,30
1650018347213,COGS 186,A01,083986,Staff,21,0,40,19
1650018353239,COGS 187A,A01,083988,Boyle; Mary E. T.,20,0,60,40
1650018359270,CSE 8A,A50,084003,Miranda; Gregory Joseph,0,13,15,15
1650018365294,CSE 11,A01,084005,Miranda; Gregory Joseph,0,22,55,55
1650018371325,CSE 20,A01,084007,Staff,0,5,20,20
1650018377349,CSE 21,A01,084009,Staff,0,30,50,50
1650018383376,CSE 30,A01,083370,Cao; Yingjun,0,65,40,40
1650018389400,CSE 100,A01,083372,Cao; Yingjun,0,46,40,40
1650018395428,CSE 101,A01,084011,Staff,0,54,40,40
1650018401455,CSE 141,A01,083374,Eldon; John,0,64,75,75
1650018407480,CSE 141L,A01,083376,Eldon; John,0,70,75,75
1650018413595,CSE 175,A01,084013,Kumar; Rakesh,22,0,25,3
1650018419619,CSE 190,A00,092508,Dubnov; Shlomo,20,0,20,0
1650018425643,ECE 5,A01,084049,Morris; Karcher William,13,0,20,7
1650018431667,ECE 100,A01,084051,Baghdadchi; Saharnaz,0,0,20,20
1650018431667,ECE 100,A02,091916,Baghdadchi; Saharnaz,13,0,20,7
1650018437696,ECE 101,A01,084053,Baghdadchi; Saharnaz,0,0,37,37
1650018437696,ECE 101,A02,084054,Baghdadchi; Saharnaz,30,0,37,7
1650018443721,ECE 107,A01,083390,Staff,26,0,40,14
1650018449748,ECE 148,A01,084056,Silberman; Jack,8,0,12,4
1650018455777,ECE 180,A00,083391,Abi Samra; Nicholas Camill,25,0,30,5
1650018455777,ECE 180,B00,083392,Abi Samra; Nicholas Camill,21,0,30,9
1650018461804,MATH 10B,A01,084110,Staff,0,0,30,30
1650018461804,MATH 10B,A02,084111,Staff,18,0,30,12
1650018461804,MATH 10B,A03,084112,Staff,24,0,30,6
1650018467832,MATH 10C,A01,083443,Staff,0,15,30,30
1650018467832,MATH 10C,A02,083444,Staff,0,15,30,30
1650018467832,MATH 10C,B01,084114,Staff,19,0,30,11
1650018467832,MATH 10C,B02,084115,Staff,25,0,30,5
1650018473856,MATH 18,A01,084117,Harel; Guershon,14,0,30,16
1650018473856,MATH 18,A02,084119,Harel; Guershon,28,0,30,2
1650018473856,MATH 18,A03,084120,Harel; Guershon,29,0,30,1
1650018473856,MATH 18,A04,084121,Harel; Guershon,29,0,30,1
1650018479880,MATH 20B,A01,084124,Um; Ko Woon,16,0,35,19
1650018479880,MATH 20B,B01,084126,Um; Ko Woon,24,0,35,11
1650018485905,MATH 20C,A01,083446,Hammock; Frances H,0,0,30,30
1650018485905,MATH 20C,A02,083447,Hammock; Frances H,16,0,30,14
1650018485905,MATH 20C,A03,083448,Hammock; Frances H,19,0,30,11
1650018485905,MATH 20C,A04,083449,Hammock; Frances H,20,0,30,10
1650018485905,MATH 20C,B01,083451,Hammock; Frances H,0,0,30,30
1650018485905,MATH 20C,B02,083452,Hammock; Frances H,19,0,30,11
1650018485905,MATH 20C,B03,083453,Hammock; Frances H,21,0,30,9
1650018485905,MATH 20C,B04,083454,Hammock; Frances H,23,0,30,7
1650018491929,MATH 20D,A01,084128,Staff,14,0,30,16
1650018491929,MATH 20D,A02,084129,Staff,29,0,30,1
1650018491929,MATH 20D,A03,084130,Staff,27,0,30,3
1650018491929,MATH 20D,B01,084133,Staff,3,0,30,27
1650018491929,MATH 20D,B02,084134,Staff,24,0,30,6
1650018491929,MATH 20D,B03,084135,Staff,28,0,30,2
1650018497958,MATH 20E,A01,084138,Staff,14,0,30,16
1650018497958,MATH 20E,A02,084139,Staff,6,0,30,24
1650018497958,MATH 20E,A03,084140,Staff,15,0,30,15
1650018497958,MATH 20E,A04,084141,Staff,20,0,30,10
1650018503986,MATH 102,A01,084143,Harel; Guershon,12,0,30,18
1650018503986,MATH 102,A02,084144,Harel; Guershon,20,0,30,10
1650018510015,MATH 103B,A01,083456,Staff,0,13,30,30
1650018510015,MATH 103B,A02,083457,Staff,0,13,30,30
1650018516041,MATH 109,A01,084146,Salehi Golsefidy; Alireza,18,0,30,12
1650018516041,MATH 109,A02,084147,Salehi Golsefidy; Alireza,15,0,30,15
1650018522065,MATH 120A,A01,085445,Eggers; John Dietrich,10,0,35,25
1650018522065,MATH 120A,A02,085446,Eggers; John Dietrich,27,0,35,8
1650018528088,MATH 142B,A01,084149,Verstraete; Jacques Allan,0,12,30,30
1650018528088,MATH 142B,A02,084150,Verstraete; Jacques Allan,0,12,30,30
1650018534112,MATH 170A,A01,083459,Nie; Jiawang,0,9,30,30
1650018534112,MATH 170A,A02,083460,Nie; Jiawang,0,8,30,30
1650018534112,MATH 170A,A03,083461,Nie; Jiawang,0,9,30,30
1650018540136,MATH 193B,A01,083463,Staff,1,0,30,29
1650018540136,MATH 193B,A02,083464,Staff,9,0,30,21
1650018540136,MATH 193B,A03,083465,Staff,18,0,30,12
1650018546197,COGS 2,A01,083966,Boyle; Mary E. T.,9,0,30,21
1650018552221,COGS 9,A01,083968,Staff,9,0,60,51
1650018558248,COGS 14B,A01,083970,Staff,9,0,50,41
1650018564272,COGS 17,A01,092679,Staff,50,0,75,25
1650018570299,COGS 100,A01,083972,Staff,0,15,60,60
1650018582355,COGS 101C,A01,083976,Staff,12,0,30,18
1650018588381,COGS 102A,A01,083978,Johnson; Christine M.,14,0,30,16
1650018594413,COGS 107B,A01,083980,Staff,0,7,50,50
1650018600436,COGS 115,A01,083982,Staff,10,0,30,20
1650018606460,COGS 118B,A01,083367,Staff,0,15,40,40
1650018612488,COGS 172,A01,083984,Provenzano; Emily Kara,15,0,30,15
1650018618516,COGS 177,A00,083368,Staff,0,20,30,30
1650018624539,COGS 186,A01,083986,Staff,21,0,40,19
1650018630579,COGS 187A,A01,083988,Boyle; Mary E. T.,20,0,60,40
1650018636605,CSE 8A,A50,084003,Miranda; Gregory Joseph,0,13,15,15
1650018642628,CSE 11,A01,084005,Miranda; Gregory Joseph,0,22,55,55
1650018648652,CSE 20,A01,084007,Staff,0,5,20,20
1650018654676,CSE 21,A01,084009,Staff,0,30,50,50
1650018660701,CSE 30,A01,083370,Cao; Yingjun,0,65,40,40
1650018666725,CSE 100,A01,083372,Cao; Yingjun,0,46,40,40
1650018672749,CSE 101,A01,084011,Staff,0,54,40,40
1650018678778,CSE 141,A01,083374,Eldon; John,0,64,75,75
1650018684806,CSE 141L,A01,083376,Eldon; John,0,70,75,75
1650018690833,CSE 175,A01,084013,Kumar; Rakesh,22,0,25,3
1650018696860,CSE 190,A00,092508,Dubnov; Shlomo,20,0,20,0
1650018702887,ECE 5,A01,084049,Morris; Karcher William,13,0,20,7
1650018708916,ECE 100,A01,084051,Baghdadchi; Saharnaz,0,0,20,20
1650018708916,ECE 100,A02,091916,Baghdadchi; Saharnaz,13,0,20,7
1650018714946,ECE 101,A01,084053,Baghdadchi; Saharnaz,0,0,37,37
1650018714946,ECE 101,A02,084054,Baghdadchi; Saharnaz,30,0,37,7
1650018720969,ECE 107,A01,083390,Staff,26,0,40,14
1650018726992,ECE 148,A01,084056,Silberman; Jack,8,0,12,4
1650018733019,ECE 180,A00,083391,Abi Samra; Nicholas Camill,25,0,30,5
1650018733019,ECE 180,B00,083392,Abi Samra; Nicholas Camill,21,0,30,9
1650018739042,MATH 10B,A01,084110,Staff,0,0,30,30
1650018739042,MATH 10B,A02,084111,Staff,18,0,30,12
1650018739042,MATH 10B,A03,084112,Staff,24,0,30,6
1650018745071,MATH 10C,A01,083443,Staff,0,15,30,30
1650018745071,MATH 10C,A02,083444,Staff,0,15,30,30
1650018745071,MATH 10C,B01,084114,Staff,19,0,30,11
1650018745071,MATH 10C,B02,084115,Staff,25,0,30,5
1650018751096,MATH 18,A01,084117,Harel; Guershon,14,0,30,16
1650018751096,MATH 18,A02,084119,Harel; Guershon,28,0,30,2
1650018751096,MATH 18,A03,084120,Harel; Guershon,29,0,30,1
1650018751096,MATH 18,A04,084121,Harel; Guershon,29,0,30,1
1650018757121,MATH 20B,A01,084124,Um; Ko Woon,16,0,35,19
1650018757121,MATH 20B,B01,084126,Um; Ko Woon,24,0,35,11
1650018763146,MATH 20C,A01,083446,Hammock; Frances H,0,0,30,30
1650018763146,MATH 20C,A02,083447,Hammock; Frances H,16,0,30,14
1650018763146,MATH 20C,A03,083448,Hammock; Frances H,19,0,30,11
1650018763146,MATH 20C,A04,083449,Hammock; Frances H,20,0,30,10
1650018763146,MATH 20C,B01,083451,Hammock; Frances H,0,0,30,30
1650018763146,MATH 20C,B02,083452,Hammock; Frances H,19,0,30,11
1650018763146,MATH 20C,B03,083453,Hammock; Frances H,21,0,30,9
1650018763146,MATH 20C,B04,083454,Hammock; Frances H,23,0,30,7
1650018769170,MATH 20D,A01,084128,Staff,14,0,30,16
1650018769170,MATH 20D,A02,084129,Staff,29,0,30,1
1650018769170,MATH 20D,A03,084130,Staff,27,0,30,3
1650018769170,MATH 20D,B01,084133,Staff,3,0,30,27
1650018769170,MATH 20D,B02,084134,Staff,24,0,30,6
1650018769170,MATH 20D,B03,084135,Staff,28,0,30,2
1650018775194,MATH 20E,A01,084138,Staff,14,0,30,16
1650018775194,MATH 20E,A02,084139,Staff,6,0,30,24
1650018775194,MATH 20E,A03,084140,Staff,15,0,30,15
1650018775194,MATH 20E,A04,084141,Staff,20,0,30,10
1650018781224,MATH 102,A01,084143,Harel; Guershon,12,0,30,18
1650018781224,MATH 102,A02,084144,Harel; Guershon,20,0,30,10
1650018787263,MATH 103B,A01,083456,Staff,0,13,30,30
1650018787263,MATH 103B,A02,083457,Staff,0,13,30,30
1650018793296,MATH 109,A01,084146,Salehi Golsefidy; Alireza,18,0,30,12
1650018793296,MATH 109,A02,084147,Salehi Golsefidy; Alireza,15,0,30,15
1650018799321,MATH 120A,A01,085445,Eggers; John Dietrich,10,0,35,25
1650018799321,MATH 120A,A02,085446,Eggers; John Dietrich,27,0,35,8
1650018805345,MATH 142B,A01,084149,Verstraete; Jacques Allan,0,12,30,30
1650018805345,MATH 142B,A02,084150,Verstraete; Jacques Allan,0,12,30,30
1650018811374,MATH 170A,A01,083459,Nie; Jiawang,0,9,30,30
1650018811374,MATH 170A,A02,083460,Nie; Jiawang,0,8,30,30
1650018811374,MATH 170A,A03,083461,Nie; Jiawang,0,9,30,30
1650018817397,MATH 193B,A01,083463,Staff,1,0,30,29
1650018817397,MATH 193B,A02,083464,Staff,9,0,30,21
1650018817397,MATH 193B,A03,083465,Staff,18,0,30,12
1650018823462,COGS 2,A01,083966,Boyle; Mary E. T.,9,0,30,21
1650018829488,COGS 9,A01,083968,Staff,9,0,60,51
1650018835512,COGS 14B,A01,083970,Staff,9,0,50,41
1650018841542,COGS 17,A01,092679,Staff,50,0,75,25
1650018847566,COGS 100,A01,083972,Staff,0,15,60,60
1650018859611,COGS 101C,A01,083976,Staff,12,0,30,18
1650018865636,COGS 102A,A01,083978,Johnson; Christine M.,14,0,30,16
1650018871660,COGS 107B,A01,083980,Staff,0,7,50,50
1650018877687,COGS 115,A01,083982,Staff,10,0,30,20
1650018883718,COGS 118B,A01,083367,Staff,0,15,40,40
1650018889745,COGS 172,A01,083984,Provenzano; Emily Kara,15,0,30,15
1650018895769,COGS 177,A00,083368,Staff,0,20,30,30
1650018901792,COGS 186,A01,083986,Staff,21,0,40,19
1650018907821,COGS 187A,A01,083988,Boyle; Mary E. T.,20,0,60,40
1650018913855,CSE 8A,A50,084003,Miranda; Gregory Joseph,0,13,15,15
1650018919883,CSE 11,A01,084005,Miranda; Gregory Joseph,0,22,55,55
1650018925910,CSE 20,A01,084007,Staff,0,5,20,20
1650018931932,CSE 21,A01,084009,Staff,0,30,50,50
1650018937960,CSE 30,A01,083370,Cao; Yingjun,0,65,40,40
1650018943988,CSE 100,A01,083372,Cao; Yingjun,0,46,40,40
1650018950011,CSE 101,A01,084011,Staff,0,54,40,40
1650018956035,CSE 141,A01,083374,Eldon; John,0,64,75,75
1650018962076,CSE 141L,A01,083376,Eldon; John,0,70,75,75
1650018968100,CSE 175,A01,084013,Kumar; Rakesh,22,0,25,3
1650018974157,CSE 190,A00,092508,Dubnov; Shlomo,20,0,20,0
1650018980189,ECE 5,A01,084049,Morris; Karcher William,13,0,20,7
1650018986214,ECE 100,A01,084051,Baghdadchi; Saharnaz,0,0,20,20
1650018986214,ECE 100,A02,091916,Baghdadchi; Saharnaz,13,0,20,7
1650018992240,ECE 101,A01,084053,Baghdadchi; Saharnaz,0,0,37,37
1650018992240,ECE 101,A02,084054,Baghdadchi; Saharnaz,30,0,37,7
1650018998266,ECE 107,A01,083390,Staff,26,0,40,14
1650019004310,ECE 148,A01,084056,Silberman; Jack,8,0,12,4
1650019010425,ECE 180,A00,083391,Abi Samra; Nicholas Camill,25,0,30,5
1650019010425,ECE 180,B00,083392,Abi Samra; Nicholas Camill,21,0,30,9
1650019016451,MATH 10B,A01,084110,Staff,0,0,30,30
1650019016451,MATH 10B,A02,084111,Staff,18,0,30,12
1650019016451,MATH 10B,A03,084112,Staff,24,0,30,6
1650019022477,MATH 10C,A01,083443,Staff,0,15,30,30
1650019022477,MATH 10C,A02,083444,Staff,0,15,30,30
1650019022477,MATH 10C,B01,084114,Staff,19,0,30,11
1650019022477,MATH 10C,B02,084115,Staff,25,0,30,5
1650019028502,MATH 18,A01,084117,Harel; Guershon,14,0,30,16
1650019028502,MATH 18,A02,084119,Harel; Guershon,28,0,30,2
1650019028502,MATH 18,A03,084120,Harel; Guershon,29,0,30,1
1650019028502,MATH 18,A04,084121,Harel; Guershon,29,0,30,1
1650019034532,MATH 20B,A01,084124,Um; Ko Woon,16,0,35,19
1650019034532,MATH 20B,B01,084126,Um; Ko Woon,24,0,35,11
1650019040566,MATH 20C,A01,083446,Hammock; Frances H,0,0,30,30
1650019040566,MATH 20C,A02,083447,Hammock; Frances H,16,0,30,14
1650019040566,MATH 20C,A03,083448,Hammock; Frances H,19,0,30,11
1650019040566,MATH 20C,A04,083449,Hammock; Frances H,20,0,30,10
1650019040566,MATH 20C,B01,083451,Hammock; Frances H,0,0,30,30
1650019040566,MATH 20C,B02,083452,Hammock; Frances H,19,0,30,11
1650019040566,MATH 20C,B03,083453,Hammock; Frances H,21,0,30,9
1650019040566,MATH 20C,B04,083454,Hammock; Frances H,23,0,30,7
1650019046597,MATH 20D,A01,084128,Staff,14,0,30,16
1650019046597,MATH 20D,A02,084129,Staff,29,0,30,1
1650019046597,MATH 20D,A03,084130,Staff,27,0,30,3
1650019046597,MATH 20D,B01,084133,Staff,3,0,30,27
1650019046597,MATH 20D,B02,084134,Staff,24,0,30,6
1650019046597,MATH 20D,B03,084135,Staff,28,0,30,2
1650019052626,MATH 20E,A01,084138,Staff,14,0,30,16
1650019052626,MATH 20E,A02,084139,Staff,6,0,30,24
1650019052626,MATH 20E,A03,084140,Staff,15,0,30,15
1650019052626,MATH 20E,A04,084141,Staff,20,0,30,10
1650019058651,MATH 102,A01,084143,Harel; Guershon,12,0,30,18
1650019058651,MATH 102,A02,084144,Harel; Guershon,20,0,30,10
1650019064677,MATH 103B,A01,083456,Staff,0,13,30,30
1650019064677,MATH 103B,A02,083457,Staff,0,13,30,30
1650019070700,MATH 109,A01,084146,Salehi Golsefidy; Alireza,18,0,30,12
1650019070700,MATH 109,A02,084147,Salehi Golsefidy; Alireza,15,0,30,15
1650019076734,MATH 120A,A01,085445,Eggers; John Dietrich,10,0,35,25
1650019076734,MATH 120A,A02,085446,Eggers; John Dietrich,27,0,35,8
1650019082762,MATH 142B,A01,084149,Verstraete; Jacques Allan,0,12,30,30
1650019082762,MATH 142B,A02,084150,Verstraete; Jacques Allan,0,12,30,30
1650019088786,MATH 170A,A01,083459,Nie; Jiawang,0,9,30,30
1650019088786,MATH 170A,A02,083460,Nie; Jiawang,0,8,30,30
1650019088786,MATH 170A,A03,083461,Nie; Jiawang,0,9,30,30
1650019094815,MATH 193B,A01,083463,Staff,1,0,30,29
1650019094815,MATH 193B,A02,083464,Staff,9,0,30,21
1650019094815,MATH 193B,A03,083465,Staff,18,0,30,12
1650019100883,COGS 2,A01,083966,Boyle; Mary E. T.,9,0,30,21
1650019106907,COGS 9,A01,083968,Staff,9,0,60,51
1650019112932,COGS 14B,A01,083970,Staff,9,0,50,41
1650019118956,COGS 17,A01,092679,Staff,50,0,75,25
1650019124981,COGS 100,A01,083972,Staff,0,15,60,60
1650019137031,COGS 101C,A01,083976,Staff,12,0,30,18
1650019143057,COGS 102A,A01,083978,Johnson; Christine M.,14,0,30,16
1650019149082,COGS 107B,A01,083980,Staff,0,7,50,50
1650019155119,COGS 115,A01,083982,Staff,10,0,30,20
1650019161144,COGS 118B,A01,083367,Staff,0,15,40,40
1650019167174,COGS 172,A01,083984,Provenzano; Emily Kara,15,0,30,15
1650019173202,COGS 177,A00,083368,Staff,0,20,30,30
1650019179225,COGS 186,A01,083986,Staff,21,0,40,19
1650019185255,COGS 187A,A01,083988,Boyle; Mary E. T.,20,0,60,40
1650019191277,CSE 8A,A50,084003,Miranda; Gregory Joseph,0,13,15,15
1650019197302,CSE 11,A01,084005,Miranda; Gregory Joseph,0,22,55,55
1650019203332,CSE 20,A01,084007,Staff,0,5,20,20
1650019209356,CSE 21,A01,084009,Staff,0,30,50,50
1650019215381,CSE 30,A01,083370,Cao; Yingjun,0,65,40,40
1650019221406,CSE 100,A01,083372,Cao; Yingjun,0,46,40,40
1650019227433,CSE 101,A01,084011,Staff,0,54,40,40
1650019233463,CSE 141,A01,083374,Eldon; John,0,64,75,75
1650019239492,CSE 141L,A01,083376,Eldon; John,0,70,75,75
1650019245517,CSE 175,A01,084013,Kumar; Rakesh,22,0,25,3
1650019251548,CSE 190,A00,092508,Dubnov; Shlomo,20,0,20,0
1650019257583,ECE 5,A01,084049,Morris; Karcher William,13,0,20,7
1650019263609,ECE 100,A01,084051,Baghdadchi; Saharnaz,0,0,20,20
1650019263609,ECE 100,A02,091916,Baghdadchi; Saharnaz,13,0,20,7
1650019269642,ECE 101,A01,084053,Baghdadchi; Saharnaz,0,0,37,37
1650019269642,ECE 101,A02,084054,Baghdadchi; Saharnaz,30,0,37,7
1650019275666,ECE 107,A01,083390,Staff,26,0,40,14
1650019281699,ECE 148,A01,084056,Silberman; Jack,8,0,12,4
1650019287721,ECE 180,A00,083391,Abi Samra; Nicholas Camill,25,0,30,5
1650019287721,ECE 180,B00,083392,Abi Samra; Nicholas Camill,21,0,30,9
1650019293747,MATH 10B,A01,084110,Staff,0,0,30,30
1650019293747,MATH 10B,A02,084111,Staff,18,0,30,12
1650019293747,MATH 10B,A03,084112,Staff,24,0,30,6
1650019299786,MATH 10C,A01,083443,Staff,0,16,30,30
1650019299786,MATH 10C,A02,083444,Staff,0,15,30,30
1650019299786,MATH 10C,B01,084114,Staff,19,0,30,11
1650019299786,MATH 10C,B02,084115,Staff,25,0,30,5
1650019305817,MATH 18,A01,084117,Harel; Guershon,14,0,30,16
1650019305817,MATH 18,A02,084119,Harel; Guershon,28,0,30,2
1650019305817,MATH 18,A03,084120,Harel; Guershon,29,0,30,1
1650019305817,MATH 18,A04,084121,Harel; Guershon,29,0,30,1
1650019311849,MATH 20B,A01,084124,Um; Ko Woon,16,0,35,19
1650019311849,MATH 20B,B01,084126,Um; Ko Woon,24,0,35,11
1650019317877,MATH 20C,A01,083446,Hammock; Frances H,0,0,30,30
1650019317877,MATH 20C,A02,083447,Hammock; Frances H,16,0,30,14
1650019317877,MATH 20C,A03,083448,Hammock; Frances H,19,0,30,11
1650019317877,MATH 20C,A04,083449,Hammock; Frances H,20,0,30,10
1650019317877,MATH 20C,B01,083451,Hammock; Frances H,0,0,30,30
1650019317877,MATH 20C,B02,083452,Hammock; Frances H,19,0,30,11
1650019317877,MATH 20C,B03,083453,Hammock; Frances H,21,0,30,9
1650019317877,MATH 20C,B04,083454,Hammock; Frances H,23,0,30,7
1650019323901,MATH 20D,A01,084128,Staff,14,0,30,16
1650019323901,MATH 20D,A02,084129,Staff,29,0,30,1
1650019323901,MATH 20D,A03,084130,Staff,27,0,30,3
1650019323901,MATH 20D,B01,084133,Staff,3,0,30,27
1650019323901,MATH 20D,B02,084134,Staff,24,0,30,6
1650019323901,MATH 20D,B03,084135,Staff,28,0,30,2
1650019329927,MATH 20E,A01,084138,Staff,14,0,30,16
1650019329927,MATH 20E,A02,084139,Staff,6,0,30,24
1650019329927,MATH 20E,A03,084140,Staff,15,0,30,15
1650019329927,MATH 20E,A04,084141,Staff,20,0,30,10
1650019335957,MATH 102,A01,084143,Harel; Guershon,12,0,30,18
1650019335957,MATH 102,A02,084144,Harel; Guershon,20,0,30,10
1650019341987,MATH 103B,A01,083456,Staff,0,13,30,30
1650019341987,MATH 103B,A02,083457,Staff,0,13,30,30
1650019348013,MATH 109,A01,084146,Salehi Golsefidy; Alireza,18,0,30,12
1650019348013,MATH 109,A02,084147,Salehi Golsefidy; Alireza,15,0,30,15
1650019354044,MATH 120A,A01,085445,Eggers; John Dietrich,10,0,35,25
1650019354044,MATH 120A,A02,085446,Eggers; John Dietrich,27,0,35,8
1650019360068,MATH 142B,A01,084149,Verstraete; Jacques Allan,0,12,30,30
1650019360068,MATH 142B,A02,084150,Verstraete; Jacques Allan,0,12,30,30
1650019366097,MATH 170A,A01,083459,Nie; Jiawang,0,9,30,30
1650019366097,MATH 170A,A02,083460,Nie; Jiawang,0,8,30,30
1650019366097,MATH 170A,A03,083461,Nie; Jiawang,0,9,30,30
1650019372121,MATH 193B,A01,083463,Staff,1,0,30,29
1650019372121,MATH 193B,A02,083464,Staff,9,0,30,21
1650019372121,MATH 193B,A03,083465,Staff,18,0,30,12
1650019378197,COGS 2,A01,083966,Boyle; Mary E. T.,9,0,30,21
1650019384226,COGS 9,A01,083968,Staff,9,0,60,51
1650019390251,COGS 14B,A01,083970,Staff,9,0,50,41
1650019396275,COGS 17,A01,092679,Staff,50,0,75,25
1650019402299,COGS 100,A01,083972,Staff,0,15,60,60
1650019414353,COGS 101C,A01,083976,Staff,12,0,30,18
1650019420383,COGS 102A,A01,083978,Johnson; Christine M.,14,0,30,16
1650019426411,COGS 107B,A01,083980,Staff,0,7,50,50
1650019432435,COGS 115,A01,083982,Staff,10,0,30,20
1650019438463,COGS 118B,A01,083367,Staff,0,15,40,40
1650019444494,COGS 172,A01,083984,Provenzano; Emily Kara,15,0,30,15
1650019450521,COGS 177,A00,083368,Staff,0,20,30,30
1650019456547,COGS 186,A01,083986,Staff,21,0,40,19
1650019462575,COGS 187A,A01,083988,Boyle; Mary E. T.,20,0,60,40
1650019468602,CSE 8A,A50,084003,Miranda; Gregory Joseph,0,13,15,15
1650019474634,CSE 11,A01,084005,Miranda; Gregory Joseph,0,22,55,55
1650019480658,CSE 20,A01,084007,Staff,0,5,20,20
1650019486682,CSE 21,A01,084009,Staff,0,30,50,50
1650019492707,CSE 30,A01,083370,Cao; Yingjun,0,65,40,40
1650019498733,CSE 100,A01,083372,Cao; Yingjun,0,46,40,40
1650019504758,CSE 101,A01,084011,Staff,0,54,40,40
1650019510783,CSE 141,A01,083374,Eldon; John,0,64,75,75
1650019516808,CSE 141L,A01,083376,Eldon; John,0,70,75,75
1650019522834,CSE 175,A01,084013,Kumar; Rakesh,22,0,25,3
1650019528865,CSE 190,A00,092508,Dubnov; Shlomo,20,0,20,0
1650019534890,ECE 5,A01,084049,Morris; Karcher William,13,0,20,7
1650019540917,ECE 100,A01,084051,Baghdadchi; Saharnaz,0,0,20,20
1650019540917,ECE 100,A02,091916,Baghdadchi; Saharnaz,13,0,20,7
1650019546942,ECE 101,A01,084053,Baghdadchi; Saharnaz,0,0,37,37
1650019546942,ECE 101,A02,084054,Baghdadchi; Saharnaz,30,0,37,7
1650019552967,ECE 107,A01,083390,Staff,26,0,40,14
1650019558999,ECE 148,A01,084056,Silberman; Jack,8,0,12,4
1650019565024,ECE 180,A00,083391,Abi Samra; Nicholas Camill,25,0,30,5
1650019565024,ECE 180,B00,083392,Abi Samra; Nicholas Camill,21,0,30,9
1650019571050,MATH 10B,A01,084110,Staff,0,0,30,30
1650019571050,MATH 10B,A02,084111,Staff,18,0,30,12
1650019571050,MATH 10B,A03,084112,Staff,24,0,30,6
1650019577080,MATH 10C,A01,083443,Staff,0,16,30,30
1650019577080,MATH 10C,A02,083444,Staff,0,15,30,30
1650019577080,MATH 10C,B01,084114,Staff,19,0,30,11
1650019577080,MATH 10C,B02,084115,Staff,25,0,30,5
1650019583111,MATH 18,A01,084117,Harel; Guershon,14,0,30,16
1650019583111,MATH 18,A02,084119,Harel; Guershon,28,0,30,2
1650019583111,MATH 18,A03,084120,Harel; Guershon,29,0,30,1
1650019583111,MATH 18,A04,084121,Harel; Guershon,29,0,30,1
1650019589141,MATH 20B,A01,084124,Um; Ko Woon,16,0,35,19
1650019589141,MATH 20B,B01,084126,Um; Ko Woon,24,0,35,11
1650019595179,MATH 20C,A01,083446,Hammock; Frances H,0,0,30,30
1650019595179,MATH 20C,A02,083447,Hammock; Frances H,16,0,30,14
1650019595179,MATH 20C,A03,083448,Hammock; Frances H,19,0,30,11
1650019595179,MATH 20C,A04,083449,Hammock; Frances H,20,0,30,10
1650019595179,MATH 20C,B01,083451,Hammock; Frances H,0,0,30,30
1650019595179,MATH 20C,B02,083452,Hammock; Frances H,19,0,30,11
1650019595179,MATH 20C,B03,083453,Hammock; Frances H,21,0,30,9
1650019595179,MATH 20C,B04,083454,Hammock; Frances H,23,0,30,7
1650019601209,MATH 20D,A01,084128,Staff,14,0,30,16
1650019601209,MATH 20D,A02,084129,Staff,29,0,30,1
1650019601209,MATH 20D,A03,084130,Staff,27,0,30,3
1650019601209,MATH 20D,B01,084133,Staff,3,0,30,27
1650019601209,MATH 20D,B02,084134,Staff,24,0,30,6
1650019601209,MATH 20D,B03,084135,Staff,28,0,30,2
1650019607321,MATH 20E,A01,084138,Staff,14,0,30,16
1650019607321,MATH 20E,A02,084139,Staff,6,0,30,24
1650019607321,MATH 20E,A03,084140,Staff,15,0,30,15
1650019607321,MATH 20E,A04,084141,Staff,20,0,30,10
1650019613350,MATH 102,A01,084143,Harel; Guershon,12,0,30,18
1650019613350,MATH 102,A02,084144,Harel; Guershon,20,0,30,10
1650019619374,MATH 103B,A01,083456,Staff,0,13,30,30
1650019619374,MATH 103B,A02,083457,Staff,0,13,30,30
1650019625400,MATH 109,A01,084146,Salehi Golsefidy; Alireza,18,0,30,12
1650019625400,MATH 109,A02,084147,Salehi Golsefidy; Alireza,15,0,30,15
1650019631429,MATH 120A,A01,085445,Eggers; John Dietrich,10,0,35,25
1650019631429,MATH 120A,A02,085446,Eggers; John Dietrich,27,0,35,8
1650019637455,MATH 142B,A01,084149,Verstraete; Jacques Allan,0,12,30,30
1650019637455,MATH 142B,A02,084150,Verstraete; Jacques Allan,0,12,30,30
1650019643480,MATH 170A,A01,083459,Nie; Jiawang,0,9,30,30
1650019643480,MATH 170A,A02,083460,Nie; Jiawang,0,8,30,30
1650019643480,MATH 170A,A03,083461,Nie; Jiawang,0,9,30,30
1650019649503,MATH 193B,A01,083463,Staff,1,0,30,29
1650019649503,MATH 193B,A02,083464,Staff,9,0,30,21
1650019649503,MATH 193B,A03,083465,Staff,18,0,30,12
1650019655558,COGS 2,A01,083966,Boyle; Mary E. T.,9,0,30,21
1650019661583,COGS 9,A01,083968,Staff,9,0,60,51
1650019667621,COGS 14B,A01,083970,Staff,9,0,50,41
1650019673647,COGS 17,A01,092679,Staff,50,0,75,25
1650019679671,COGS 100,A01,083972,Staff,0,15,60,60
1650019691717,COGS 101C,A01,083976,Staff,12,0,30,18
1650019697759,COGS 102A,A01,083978,Johnson; Christine M.,14,0,30,16
1650019703786,COGS 107B,A01,083980,Staff,0,7,50,50
1650019709809,COGS 115,A01,083982,Staff,10,0,30,20
1650019715833,COGS 118B,A01,083367,Staff,0,15,40,40
1650019721861,COGS 172,A01,083984,Provenzano; Emily Kara,15,0,30,15
1650019727885,COGS 177,A00,083368,Staff,0,20,30,30
1650019733911,COGS 186,A01,083986,Staff,21,0,40,19
1650019739937,COGS 187A,A01,083988,Boyle; Mary E. T.,20,0,60,40
1650019745967,CSE 8A,A50,084003,Miranda; Gregory Joseph,0,13,15,15
1650019751994,CSE 11,A01,084005,Miranda; Gregory Joseph,0,22,55,55
1650019758021,CSE 20,A01,084007,Staff,0,5,20,20
1650019764045,CSE 21,A01,084009,Staff,0,30,50,50
1650019770069,CSE 30,A01,083370,Cao; Yingjun,0,65,40,40
1650019776093,CSE 100,A01,083372,Cao; Yingjun,0,46,40,40
1650019782117,CSE 101,A01,084011,Staff,0,54,40,40
1650019788140,CSE 141,A01,083374,Eldon; John,0,64,75,75
1650019794162,CSE 141L,A01,083376,Eldon; John,0,70,75,75
1650019800193,CSE 175,A01,084013,Kumar; Rakesh,22,0,25,3
1650019806220,CSE 190,A00,092508,Dubnov; Shlomo,20,0,20,0
1650019812250,ECE 5,A01,084049,Morris; Karcher William,13,0,20,7
1650019818277,ECE 100,A01,084051,Baghdadchi; Saharnaz,0,0,20,20
1650019818277,ECE 100,A02,091916,Baghdadchi; Saharnaz,13,0,20,7
1650019824304,ECE 101,A01,084053,Baghdadchi; Saharnaz,0,0,37,37
1650019824304,ECE 101,A02,084054,Baghdadchi; Saharnaz,30,0,37,7
1650019830333,ECE 107,A01,083390,Staff,26,0,40,14
1650019836361,ECE 148,A01,084056,Silberman; Jack,8,0,12,4
1650019842390,ECE 180,A00,083391,Abi Samra; Nicholas Camill,25,0,30,5
1650019842390,ECE 180,B00,083392,Abi Samra; Nicholas Camill,21,0,30,9
1650019848426,MATH 10B,A01,084110,Staff,0,0,30,30
1650019848426,MATH 10B,A02,084111,Staff,18,0,30,12
1650019848426,MATH 10B,A03,084112,Staff,24,0,30,6
1650019854457,MATH 10C,A01,083443,Staff,0,16,30,30
1650019854457,MATH 10C,A02,083444,Staff,0,15,30,30
1650019854457,MATH 10C,B01,084114,Staff,19,0,30,11
1650019854457,MATH 10C,B02,084115,Staff,25,0,30,5
1650019860487,MATH 18,A01,084117,Harel; Guershon,14,0,30,16
1650019860487,MATH 18,A02,084119,Harel; Guershon,28,0,30,2
1650019860487,MATH 18,A03,084120,Harel; Guershon,29,0,30,1
1650019860487,MATH 18,A04,084121,Harel; Guershon,29,0,30,1
1650019866526,MATH 20B,A01,084124,Um; Ko Woon,16,0,35,19
1650019866526,MATH 20B,B01,084126,Um; Ko Woon,24,0,35,11
1650019872558,MATH 20C,A01,083446,Hammock; Frances H,0,0,30,30
1650019872558,MATH 20C,A02,083447,Hammock; Frances H,16,0,30,14
1650019872558,MATH 20C,A03,083448,Hammock; Frances H,19,0,30,11
1650019872558,MATH 20C,A04,083449,Hammock; Frances H,20,0,30,10
1650019872558,MATH 20C,B01,083451,Hammock; Frances H,0,0,30,30
1650019872558,MATH 20C,B02,083452,Hammock; Frances H,19,0,30,11
1650019872558,MATH 20C,B03,083453,Hammock; Frances H,21,0,30,9
1650019872558,MATH 20C,B04,083454,Hammock; Frances H,23,0,30,7
1650019878589,MATH 20D,A01,084128,Staff,14,0,30,16
1650019878589,MATH 20D,A02,084129,Staff,29,0,30,1
1650019878589,MATH 20D,A03,084130,Staff,27,0,30,3
1650019878589,MATH 20D,B01,084133,Staff,3,0,30,27
1650019878589,MATH 20D,B02,084134,Staff,24,0,30,6
1650019878589,MATH 20D,B03,084135,Staff,28,0,30,2
1650019884620,MATH 20E,A01,084138,Staff,14,0,30,16
1650019884620,MATH 20E,A02,084139,Staff,6,0,30,24
1650019884620,MATH 20E,A03,084140,Staff,15,0,30,15
1650019884620,MATH 20E,A04,084141,Staff,20,0,30,10
1650019890646,MATH 102,A01,084143,Harel; Guershon,12,0,30,18
1650019890646,MATH 102,A02,084144,Harel; Guershon,20,0,30,10
1650019896675,MATH 103B,A01,083456,Staff,0,13,30,30
1650019896675,MATH 103B,A02,083457,Staff,0,13,30,30
1650019902699,MATH 109,A01,084146,Salehi Golsefidy; Alireza,18,0,30,12
1650019902699,MATH 109,A02,084147,Salehi Golsefidy; Alireza,15,0,30,15
1650019908725,MATH 120A,A01,085445,Eggers; John Dietrich,10,0,35,25
1650019908725,MATH 120A,A02,085446,Eggers; John Dietrich,27,0,35,8
1650019914749,MATH 142B,A01,084149,Verstraete; Jacques Allan,0,12,30,30
1650019914749,MATH 142B,A02,084150,Verstraete; Jacques Allan,0,12,30,30
1650019920775,MATH 170A,A01,083459,Nie; Jiawang,0,9,30,30
1650019920775,MATH 170A,A02,083460,Nie; Jiawang,0,8,30,30
1650019920775,MATH 170A,A03,083461,Nie; Jiawang,0,9,30,30
1650019926798,MATH 193B,A01,083463,Staff,1,0,30,29
1650019926798,MATH 193B,A02,083464,Staff,9,0,30,21
1650019926798,MATH 193B,A03,083465,Staff,18,0,30,12
1650019932887,COGS 2,A01,083966,Boyle; Mary E. T.,9,0,30,21
1650019938915,COGS 9,A01,083968,Staff,9,0,60,51
1650019944938,COGS 14B,A01,083970,Staff,9,0,50,41
1650019950961,COGS 17,A01,092679,Staff,50,0,75,25
1650019956989,COGS 100,A01,083972,Staff,0,15,60,60
1650019969040,COGS 101C,A01,083976,Staff,12,0,30,18
1650019975070,COGS 102A,A01,083978,Johnson; Christine M.,14,0,30,16
1650019981101,COGS 107B,A01,083980,Staff,0,7,50,50
1650019987125,COGS 115,A01,083982,Staff,10,0,30,20
1650019993149,COGS 118B,A01,083367,Staff,0,15,40,40
1650019999173,COGS 172,A01,083984,Provenzano; Emily Kara,15,0,30,15
1650020005202,COGS 177,A00,083368,Staff,0,20,30,30
1650020011231,COGS 186,A01,083986,Staff,21,0,40,19
1650020017259,COGS 187A,A01,083988,Boyle; Mary E. T.,20,0,60,40
1650020023284,CSE 8A,A50,084003,Miranda; Gregory Joseph,0,13,15,15
1650020029309,CSE 11,A01,084005,Miranda; Gregory Joseph,0,22,55,55
1650020035334,CSE 20,A01,084007,Staff,0,5,20,20
1650020041364,CSE 21,A01,084009,Staff,0,30,50,50
1650020047389,CSE 30,A01,083370,Cao; Yingjun,0,65,40,40
1650020053420,CSE 100,A01,083372,Cao; Yingjun,0,46,40,40
1650020059445,CSE 101,A01,084011,Staff,0,54,40,40
1650020065474,CSE 141,A01,083374,Eldon; John,0,64,75,75
1650020071497,CSE 141L,A01,083376,Eldon; John,0,70,75,75
1650020077528,CSE 175,A01,084013,Kumar; Rakesh,22,0,25,3
1650020083555,CSE 190,A00,092508,Dubnov; Shlomo,20,0,20,0
1650020089581,ECE 5,A01,084049,Morris; Karcher William,13,0,20,7
1650020095614,ECE 100,A01,084051,Baghdadchi; Saharnaz,0,0,20,20
1650020095614,ECE 100,A02,091916,Baghdadchi; Saharnaz,13,0,20,7
1650020101642,ECE 101,A01,084053,Baghdadchi; Saharnaz,0,0,37,37
1650020101642,ECE 101,A02,084054,Baghdadchi; Saharnaz,30,0,37,7
1650020107669,ECE 107,A01,083390,Staff,26,0,40,14
1650020113701,ECE 148,A01,084056,Silberman; Jack,8,0,12,4
1650020119726,ECE 180,A00,083391,Abi Samra; Nicholas Camill,25,0,30,5
1650020119726,ECE 180,B00,083392,Abi Samra; Nicholas Camill,21,0,30,9
1650020125752,MATH 10B,A01,084110,Staff,0,0,30,30
1650020125752,MATH 10B,A02,084111,Staff,18,0,30,12
1650020125752,MATH 10B,A03,084112,Staff,24,0,30,6
1650020131779,MATH 10C,A01,083443,Staff,0,16,30,30
1650020131779,MATH 10C,A02,083444,Staff,0,15,30,30
1650020131779,MATH 10C,B01,084114,Staff,19,0,30,11
1650020131779,MATH 10C,B02,084115,Staff,25,0,30,5
1650020137805,MATH 18,A01,084117,Harel; Guershon,14,0,30,16
1650020137805,MATH 18,A02,084119,Harel; Guershon,28,0,30,2
1650020137805,MATH 18,A03,084120,Harel; Guershon,29,0,30,1
1650020137805,MATH 18,A04,084121,Harel; Guershon,29,0,30,1
1650020143835,MATH 20B,A01,084124,Um; Ko Woon,16,0,35,19
1650020143835,MATH 20B,B01,084126,Um; Ko Woon,24,0,35,11
1650020149872,MATH 20C,A01,083446,Hammock; Frances H,0,0,30,30
1650020149872,MATH 20C,A02,083447,Hammock; Frances H,16,0,30,14
1650020149872,MATH 20C,A03,083448,Hammock; Frances H,19,0,30,11
1650020149872,MATH 20C,A04,083449,Hammock; Frances H,20,0,30,10
1650020149872,MATH 20C,B01,083451,Hammock; Frances H,0,0,30,30
1650020149872,MATH 20C,B02,083452,Hammock; Frances H,19,0,30,11
1650020149872,MATH 20C,B03,083453,Hammock; Frances H,21,0,30,9
1650020149872,MATH 20C,B04,083454,Hammock; Frances H,23,0,30,7
1650020155899,MATH 20D,A01,084128,Staff,14,0,30,16
1650020155899,MATH 20D,A02,084129,Staff,29,0,30,1
1650020155899,MATH 20D,A03,084130,Staff,27,0,30,3
1650020155899,MATH 20D,B01,084133,Staff,3,0,30,27
1650020155899,MATH 20D,B02,084134,Staff,24,0,30,6
1650020155899,MATH 20D,B03,084135,Staff,28,0,30,2
1650020161924,MATH 20E,A01,084138,Staff,14,0,30,16
1650020161924,MATH 20E,A02,084139,Staff,6,0,30,24
1650020161924,MATH 20E,A03,084140,Staff,15,0,30,15
1650020161924,MATH 20E,A04,084141,Staff,20,0,30,10
1650020167955,MATH 102,A01,084143,Harel; Guershon,12,0,30,18
1650020167955,MATH 102,A02,084144,Harel; Guershon,19,0,30,11
1650020173980,MATH 103B,A01,083456,Staff,0,13,30,30
1650020173980,MATH 103B,A02,083457,Staff,0,13,30,30
1650020180004,MATH 109,A01,084146,Salehi Golsefidy; Alireza,18,0,30,12
1650020180004,MATH 109,A02,084147,Salehi Golsefidy; Alireza,15,0,30,15
1650020186046,MATH 120A,A01,085445,Eggers; John Dietrich,10,0,35,25
1650020186046,MATH 120A,A02,085446,Eggers; John Dietrich,27,0,35,8
1650020192075,MATH 142B,A01,084149,Verstraete; Jacques Allan,0,12,30,30
1650020192075,MATH 142B,A02,084150,Verstraete; Jacques Allan,0,12,30,30
1650020198104,MATH 170A,A01,083459,Nie; Jiawang,0,9,30,30
1650020198104,MATH 170A,A02,083460,Nie; Jiawang,0,8,30,30
1650020198104,MATH 170A,A03,083461,Nie; Jiawang,0,9,30,30
1650020204226,MATH 193B,A01,083463,Staff,1,0,30,29
1650020204226,MATH 193B,A02,083464,Staff,9,0,30,21
1650020204226,MATH 193B,A03,083465,Staff,18,0,30,12
1650020210300,COGS 2,A01,083966,Boyle; Mary E. T.,9,0,30,21
1650020216324,COGS 9,A01,083968,Staff,9,0,60,51
1650020222349,COGS 14B,A01,083970,Staff,9,0,50,41
1650020228374,COGS 17,A01,092679,Staff,50,0,75,25
1650020234406,COGS 100,A01,083972,Staff,0,15,60,60
1650020246460,COGS 101C,A01,083976,Staff,12,0,30,18
1650020252485,COGS 102A,A01,083978,Johnson; Christine M.,14,0,30,16
1650020258514,COGS 107B,A01,083980,Staff,0,7,50,50
1650020264537,COGS 115,A01,083982,Staff,10,0,30,20
1650020270561,COGS 118B,A01,083367,Staff,0,15,40,40
1650020276586,COGS 172,A01,083984,Provenzano; Emily Kara,15,0,30,15
1650020282615,COGS 177,A00,083368,Staff,0,20,30,30
1650020288644,COGS 186,A01,083986,Staff,21,0,40,19
1650020294675,COGS 187A,A01,083988,Boyle; Mary E. T.,20,0,60,40
1650020300709,CSE 8A,A50,084003,Miranda; Gregory Joseph,0,13,15,15
1650020306738,CSE 11,A01,084005,Miranda; Gregory Joseph,0,22,55,55
1650020312767,CSE 20,A01,084007,Staff,0,5,20,20
1650020318791,CSE 21,A01,084009,Staff,0,30,50,50
1650020324828,CSE 30,A01,083370,Cao; Yingjun,0,65,40,40
1650020330854,CSE 100,A01,083372,Cao; Yingjun,0,46,40,40
1650020336885,CSE 101,A01,084011,Staff,0,54,40,40
1650020342915,CSE 141,A01,083374,Eldon; John,0,64,75,75
1650020348948,CSE 141L,A01,083376,Eldon; John,0,70,75,75
1650020354975,CSE 175,A01,084013,Kumar; Rakesh,22,0,25,3
1650020361006,CSE 190,A00,092508,Dubnov; Shlomo,20,0,20,0
1650020367033,ECE 5,A01,084049,Morris; Karcher William,13,0,20,7
1650020373082,ECE 100,A01,084051,Baghdadchi; Saharnaz,0,0,20,20
1650020373082,ECE 100,A02,091916,Baghdadchi; Saharnaz,13,0,20,7
1650020379108,ECE 101,A01,084053,Baghdadchi; Saharnaz,0,0,37,37
1650020379108,ECE 101,A02,084054,Baghdadchi; Saharnaz,30,0,37,7
1650020385134,ECE 107,A01,083390,Staff,26,0,40,14
1650020391160,ECE 148,A01,084056,Silberman; Jack,8,0,12,4
1650020397182,ECE 180,A00,083391,Abi Samra; Nicholas Camill,25,0,30,5
1650020397182,ECE 180,B00,083392,Abi Samra; Nicholas Camill,21,0,30,9
1650020403209,MATH 10B,A01,084110,Staff,0,0,30,30
1650020403209,MATH 10B,A02,084111,Staff,18,0,30,12
1650020403209,MATH 10B,A03,084112,Staff,24,0,30,6
1650020409239,MATH 10C,A01,083443,Staff,0,16,30,30
1650020409239,MATH 10C,A02,083444,Staff,0,15,30,30
1650020409239,MATH 10C,B01,084114,Staff,19,0,30,11
1650020409239,MATH 10C,B02,084115,Staff,25,0,30,5
1650020415269,MATH 18,A01,084117,Harel; Guershon,14,0,30,16
1650020415269,MATH 18,A02,084119,Harel; Guershon,28,0,30,2
1650020415269,MATH 18,A03,084120,Harel; Guershon,29,0,30,1
1650020415269,MATH 18,A04,084121,Harel; Guershon,29,0,30,1
1650020421296,MATH 20B,A01,084124,Um; Ko Woon,16,0,35,19
1650020421296,MATH 20B,B01,084126,Um; Ko Woon,24,0,35,11
1650020427344,MATH 20C,A01,083446,Hammock; Frances H,0,0,30,30
1650020427344,MATH 20C,A02,083447,Hammock; Frances H,16,0,30,14
1650020427344,MATH 20C,A03,083448,Hammock; Frances H,19,0,30,11
1650020427344,MATH 20C,A04,083449,Hammock; Frances H,20,0,30,10
1650020427344,MATH 20C,B01,083451,Hammock; Frances H,0,0,30,30
1650020427344,MATH 20C,B02,083452,Hammock; Frances H,19,0,30,11
1650020427344,MATH 20C,B03,083453,Hammock; Frances H,21,0,30,9
1650020427344,MATH 20C,B04,083454,Hammock; Frances H,23,0,30,7
1650020433370,MATH 20D,A01,084128,Staff,14,0,30,16
1650020433370,MATH 20D,A02,084129,Staff,29,0,30,1
1650020433370,MATH 20D,A03,084130,Staff,27,0,30,3
1650020433370,MATH 20D,B01,084133,Staff,3,0,30,27
1650020433370,MATH 20D,B02,084134,Staff,24,0,30,6
1650020433370,MATH 20D,B03,084135,Staff,28,0,30,2
1650020439394,MATH 20E,A01,084138,Staff,14,0,30,16
1650020439394,MATH 20E,A02,084139,Staff,6,0,30,24
1650020439394,MATH 20E,A03,084140,Staff,15,0,30,15
1650020439394,MATH 20E,A04,084141,Staff,20,0,30,10
1650020445418,MATH 102,A01,084143,Harel; Guershon,12,0,30,18
1650020445418,MATH 102,A02,084144,Harel; Guershon,19,0,30,11
1650020451440,MATH 103B,A01,083456,Staff,0,13,30,30
1650020451440,MATH 103B,A02,083457,Staff,0,13,30,30
1650020457467,MATH 109,A01,084146,Salehi Golsefidy; Alireza,18,0,30,12
1650020457467,MATH 109,A02,084147,Salehi Golsefidy; Alireza,15,0,30,15
1650020463495,MATH 120A,A01,085445,Eggers; John Dietrich,10,0,35,25
1650020463495,MATH 120A,A02,085446,Eggers; John Dietrich,27,0,35,8
1650020469526,MATH 142B,A01,084149,Verstraete; Jacques Allan,0,12,30,30
1650020469526,MATH 142B,A02,084150,Verstraete; Jacques Allan,0,12,30,30
1650020475552,MATH 170A,A01,083459,Nie; Jiawang,0,9,30,30
1650020475552,MATH 170A,A02,083460,Nie; Jiawang,0,8,30,30
1650020475552,MATH 170A,A03,083461,Nie; Jiawang,0,9,30,30
1650020481581,MATH 193B,A01,083463,Staff,1,0,30,29
1650020481581,MATH 193B,A02,083464,Staff,9,0,30,21
1650020481581,MATH 193B,A03,083465,Staff,18,0,30,12
1650020487648,COGS 2,A01,083966,Boyle; Mary E. T.,9,0,30,21
1650020493671,COGS 9,A01,083968,Staff,9,0,60,51
1650020499696,COGS 14B,A01,083970,Staff,9,0,50,41
1650020505726,COGS 17,A01,092679,Staff,50,0,75,25
1650020511754,COGS 100,A01,083972,Staff,0,15,60,60
1650020523804,COGS 101C,A01,083976,Staff,12,0,30,18
1650020529834,COGS 102A,A01,083978,Johnson; Christine M.,14,0,30,16
1650020535860,COGS 107B,A01,083980,Staff,0,7,50,50
1650020541884,COGS 115,A01,083982,Staff,10,0,30,20
1650020547909,COGS 118B,A01,083367,Staff,0,15,40,40
1650020553935,COGS 172,A01,083984,Provenzano; Emily Kara,15,0,30,15
1650020559960,COGS 177,A00,083368,Staff,0,20,30,30
1650020565990,COGS 186,A01,083986,Staff,21,0,40,19
1650020572015,COGS 187A,A01,083988,Boyle; Mary E. T.,20,0,60,40
1650020578062,CSE 8A,A50,084003,Miranda; Gregory Joseph,0,13,15,15
1650020584087,CSE 11,A01,084005,Miranda; Gregory Joseph,0,22,55,55
1650020590117,CSE 20,A01,084007,Staff,0,5,20,20
1650020596146,CSE 21,A01,084009,Staff,0,30,50,50
1650020602172,CSE 30,A01,083370,Cao; Yingjun,0,65,40,40
1650020608196,CSE 100,A01,083372,Cao; Yingjun,0,46,40,40
1650020614220,CSE 101,A01,084011,Staff,0,54,40,40
1650020620244,CSE 141,A01,083374,Eldon; John,0,64,75,75
1650020626277,CSE 141L,A01,083376,Eldon; John,0,70,75,75
1650020632309,CSE 175,A01,084013,Kumar; Rakesh,22,0,25,3
1650020638340,CSE 190,A00,092508,Dubnov; Shlomo,20,0,20,0
1650020644365,ECE 5,A01,084049,Morris; Karcher William,13,0,20,7
1650020650399,ECE 100,A01,084051,Baghdadchi; Saharnaz,0,0,20,20
1650020650399,ECE 100,A02,091916,Baghdadchi; Saharnaz,13,0,20,7
1650020656426,ECE 101,A01,084053,Baghdadchi; Saharnaz,0,0,37,37
1650020656426,ECE 101,A02,084054,Baghdadchi; Saharnaz,30,0,37,7
1650020662453,ECE 107,A01,083390,Staff,26,0,40,14
1650020668477,ECE 148,A01,084056,Silberman; Jack,8,0,12,4
1650020674573,ECE 180,A00,083391,Abi Samra; Nicholas Camill,25,0,30,5
1650020674573,ECE 180,B00,083392,Abi Samra; Nicholas Camill,21,0,30,9
1650020680599,MATH 10B,A01,084110,Staff,0,0,30,30
1650020680599,MATH 10B,A02,084111,Staff,18,0,30,12
1650020680599,MATH 10B,A03,084112,Staff,24,0,30,6
1650020686624,MATH 10C,A01,083443,Staff,0,16,30,30
1650020686624,MATH 10C,A02,083444,Staff,0,15,30,30
1650020686624,MATH 10C,B01,084114,Staff,19,0,30,11
1650020686624,MATH 10C,B02,084115,Staff,25,0,30,5
1650020692650,MATH 18,A01,084117,Harel; Guershon,14,0,30,16
1650020692650,MATH 18,A02,084119,Harel; Guershon,28,0,30,2
1650020692650,MATH 18,A03,084120,Harel; Guershon,29,0,30,1
1650020692650,MATH 18,A04,084121,Harel; Guershon,29,0,30,1
1650020698676,MATH 20B,A01,084124,Um; Ko Woon,16,0,35,19
1650020698676,MATH 20B,B01,084126,Um; Ko Woon,24,0,35,11
1650020704711,MATH 20C,A01,083446,Hammock; Frances H,0,0,30,30
1650020704711,MATH 20C,A02,083447,Hammock; Frances H,16,0,30,14
1650020704711,MATH 20C,A03,083448,Hammock; Frances H,19,0,30,11
1650020704711,MATH 20C,A04,083449,Hammock; Frances H,20,0,30,10
1650020704711,MATH 20C,B01,083451,Hammock; Frances H,0,0,30,30
1650020704711,MATH 20C,B02,083452,Hammock; Frances H,19,0,30,11
1650020704711,MATH 20C,B03,083453,Hammock; Frances H,21,0,30,9
1650020704711,MATH 20C,B04,083454,Hammock; Frances H,23,0,30,7
1650020710736,MATH 20D,A01,084128,Staff,14,0,30,16
1650020710736,MATH 20D,A02,084129,Staff,29,0,30,1
1650020710736,MATH 20D,A03,084130,Staff,27,0,30,3
1650020710736,MATH 20D,B01,084133,Staff,3,0,30,27
1650020710736,MATH 20D,B02,084134,Staff,24,0,30,6
1650020710736,MATH 20D,B03,084135,Staff,28,0,30,2
1650020716765,MATH 20E,A01,084138,Staff,14,0,30,16
1650020716765,MATH 20E,A02,084139,Staff,6,0,30,24
1650020716765,MATH 20E,A03,084140,Staff,15,0,30,15
1650020716765,MATH 20E,A04,084141,Staff,20,0,30,10
1650020722793,MATH 102,A01,084143,Harel; Guershon,12,0,30,18
1650020722793,MATH 102,A02,084144,Harel; Guershon,19,0,30,11
1650020728831,MATH 103B,A01,083456,Staff,0,13,30,30
1650020728831,MATH 103B,A02,083457,Staff,0,13,30,30
1650020734861,MATH 109,A01,084146,Salehi Golsefidy; Alireza,18,0,30,12
1650020734861,MATH 109,A02,084147,Salehi Golsefidy; Alireza,15,0,30,15
1650020740886,MATH 120A,A01,085445,Eggers; John Dietrich,10,0,35,25
1650020740886,MATH 120A,A02,085446,Eggers; John Dietrich,27,0,35,8
1650020746914,MATH 142B,A01,084149,Verstraete; Jacques Allan,0,12,30,30
1650020746914,MATH 142B,A02,084150,Verstraete; Jacques Allan,0,12,30,30
1650020752944,MATH 170A,A01,083459,Nie; Jiawang,0,9,30,30
1650020752944,MATH 170A,A02,083460,Nie; Jiawang,0,8,30,30
1650020752944,MATH 170A,A03,083461,Nie; Jiawang,0,9,30,30
1650020758972,MATH 193B,A01,083463,Staff,1,0,30,29
1650020758972,MATH 193B,A02,083464,Staff,9,0,30,21
1650020758972,MATH 193B,A03,083465,Staff,18,0,30,12
1650020765030,COGS 2,A01,083966,Boyle; Mary E. T.,9,0,30,21
1650020771065,COGS 9,A01,083968,Staff,9,0,60,51
1650020777116,COGS 14B,A01,083970,Staff,9,0,50,41
1650020783141,COGS 17,A01,092679,Staff,50,0,75,25
1650020789164,COGS 100,A01,083972,Staff,0,15,60,60
1650020801221,COGS 101C,A01,083976,Staff,12,0,30,18
1650020807249,COGS 102A,A01,083978,Johnson; Christine M.,14,0,30,16
1650020813271,COGS 107B,A01,083980,Staff,0,7,50,50
1650020819299,COGS 115,A01,083982,Staff,10,0,30,20
1650020825323,COGS 118B,A01,083367,Staff,0,15,40,40
1650020831348,COGS 172,A01,083984,Provenzano; Emily Kara,15,0,30,15
1650020837372,COGS 177,A00,083368,Staff,0,20,30,30
1650020843396,COGS 186,A01,083986,Staff,21,0,40,19
1650020849424,COGS 187A,A01,083988,Boyle; Mary E. T.,20,0,60,40
1650020855452,CSE 8A,A50,084003,Miranda; Gregory Joseph,0,13,15,15
1650020861477,CSE 11,A01,084005,Miranda; Gregory Joseph,0,22,55,55
1650020867502,CSE 20,A01,084007,Staff,0,5,20,20
1650020873526,CSE 21,A01,084009,Staff,0,30,50,50
1650020879551,CSE 30,A01,083370,Cao; Yingjun,0,65,40,40
1650020885573,CSE 100,A01,083372,Cao; Yingjun,0,46,40,40
1650020891597,CSE 101,A01,084011,Staff,0,54,40,40
1650020897622,CSE 141,A01,083374,Eldon; John,0,64,75,75
1650020903653,CSE 141L,A01,083376,Eldon; John,0,70,75,75
1650020909683,CSE 175,A01,084013,Kumar; Rakesh,22,0,25,3
1650020915718,CSE 190,A00,092508,Dubnov; Shlomo,20,0,20,0
1650020921749,ECE 5,A01,084049,Morris; Karcher William,13,0,20,7
1650020927775,ECE 100,A01,084051,Baghdadchi; Saharnaz,0,0,20,20
1650020927775,ECE 100,A02,091916,Baghdadchi; Saharnaz,13,0,20,7
1650020933802,ECE 101,A01,084053,Baghdadchi; Saharnaz,0,0,37,37
1650020933802,ECE 101,A02,084054,Baghdadchi; Saharnaz,30,0,37,7
1650020939829,ECE 107,A01,083390,Staff,26,0,40,14
1650020945862,ECE 148,A01,084056,Silberman; Jack,8,0,12,4
1650020951887,ECE 180,A00,083391,Abi Samra; Nicholas Camill,25,0,30,5
1650020951887,ECE 180,B00,083392,Abi Samra; Nicholas Camill,21,0,30,9
1650020957917,MATH 10B,A01,084110,Staff,0,0,30,30
1650020957917,MATH 10B,A02,084111,Staff,18,0,30,12
1650020957917,MATH 10B,A03,084112,Staff,24,0,30,6
1650020963943,MATH 10C,A01,083443,Staff,0,16,30,30
1650020963943,MATH 10C,A02,083444,Staff,0,15,30,30
1650020963943,MATH 10C,B01,084114,Staff,19,0,30,11
1650020963943,MATH 10C,B02,084115,Staff,25,0,30,5
1650020969967,MATH 18,A01,084117,Harel; Guershon,14,0,30,16
1650020969967,MATH 18,A02,084119,Harel; Guershon,28,0,30,2
1650020969967,MATH 18,A03,084120,Harel; Guershon,29,0,30,1
1650020969967,MATH 18,A04,084121,Harel; Guershon,29,0,30,1
1650020975996,MATH 20B,A01,084124,Um; Ko Woon,16,0,35,19
1650020975996,MATH 20B,B01,084126,Um; Ko Woon,24,0,35,11
1650020982036,MATH 20C,A01,083446,Hammock; Frances H,0,0,30,30
1650020982036,MATH 20C,A02,083447,Hammock; Frances H,16,0,30,14
1650020982036,MATH 20C,A03,083448,Hammock; Frances H,19,0,30,11
1650020982036,MATH 20C,A04,083449,Hammock; Frances H,20,0,30,10
1650020982036,MATH 20C,B01,083451,Hammock; Frances H,0,0,30,30
1650020982036,MATH 20C,B02,083452,Hammock; Frances H,19,0,30,11
1650020982036,MATH 20C,B03,083453,Hammock; Frances H,21,0,30,9
1650020982036,MATH 20C,B04,083454,Hammock; Frances H,23,0,30,7
1650020988061,MATH 20D,A01,084128,Staff,14,0,30,16
1650020988061,MATH 20D,A02,084129,Staff,29,0,30,1
1650020988061,MATH 20D,A03,084130,Staff,27,0,30,3
1650020988061,MATH 20D,B01,084133,Staff,3,0,30,27
1650020988061,MATH 20D,B02,084134,Staff,24,0,30,6
1650020988061,MATH 20D,B03,084135,Staff,28,0,30,2
1650020994090,MATH 20E,A01,084138,Staff,14,0,30,16
1650020994090,MATH 20E,A02,084139,Staff,6,0,30,24
1650020994090,MATH 20E,A03,084140,Staff,15,0,30,15
1650020994090,MATH 20E,A04,084141,Staff,20,0,30,10
1650021000116,MATH 102,A01,084143,Harel; Guershon,12,0,30,18
1650021000116,MATH 102,A02,084144,Harel; Guershon,19,0,30,11
1650021006143,MATH 103B,A01,083456,Staff,0,13,30,30
1650021006143,MATH 103B,A02,083457,Staff,0,13,30,30
1650021012167,MATH 109,A01,084146,Salehi Golsefidy; Alireza,18,0,30,12
1650021012167,MATH 109,A02,084147,Salehi Golsefidy; Alireza,15,0,30,15
1650021018195,MATH 120A,A01,085445,Eggers; John Dietrich,10,0,35,25
1650021018195,MATH 120A,A02,085446,Eggers; John Dietrich,27,0,35,8
1650021024224,MATH 142B,A01,084149,Verstraete; Jacques Allan,0,12,30,30
1650021024224,MATH 142B,A02,084150,Verstraete; Jacques Allan,0,12,30,30
1650021030258,MATH 170A,A01,083459,Nie; Jiawang,0,9,30,30
1650021030258,MATH 170A,A02,083460,Nie; Jiawang,0,8,30,30
1650021030258,MATH 170A,A03,083461,Nie; Jiawang,0,9,30,30
1650021036286,MATH 193B,A01,083463,Staff,1,0,30,29
1650021036286,MATH 193B,A02,083464,Staff,9,0,30,21
1650021036286,MATH 193B,A03,083465,Staff,18,0,30,12
1650021042349,COGS 2,A01,083966,Boyle; Mary E. T.,9,0,30,21
1650021048372,COGS 9,A01,083968,Staff,9,0,60,51
1650021054397,COGS 14B,A01,083970,Staff,9,0,50,41
1650021060426,COGS 17,A01,092679,Staff,50,0,75,25
1650021066452,COGS 100,A01,083972,Staff,0,15,60,60
1650021078511,COGS 101C,A01,083976,Staff,12,0,30,18
1650021084536,COGS 102A,A01,083978,Johnson; Christine M.,14,0,30,16
1650021090564,COGS 107B,A01,083980,Staff,0,7,50,50
1650021096587,COGS 115,A01,083982,Staff,10,0,30,20
1650021102610,COGS 118B,A01,083367,Staff,0,15,40,40
1650021108641,COGS 172,A01,083984,Provenzano; Emily Kara,15,0,30,15
1650021114666,COGS 177,A00,083368,Staff,0,20,30,30
1650021120689,COGS 186,A01,083986,Staff,21,0,40,19
1650021126716,COGS 187A,A01,083988,Boyle; Mary E. T.,20,0,60,40
1650021132741,CSE 8A,A50,084003,Miranda; Gregory Joseph,0,13,15,15
1650021138769,CSE 11,A01,084005,Miranda; Gregory Joseph,0,22,55,55
1650021144800,CSE 20,A01,084007,Staff,0,5,20,20
1650021150828,CSE 21,A01,084009,Staff,0,30,50,50
1650021156853,CSE 30,A01,083370,Cao; Yingjun,0,65,40,40
1650021162879,CSE 100,A01,083372,Cao; Yingjun,0,46,40,40
1650021168902,CSE 101,A01,084011,Staff,0,54,40,40
1650021174925,CSE 141,A01,083374,Eldon; John,0,64,75,75
1650021180949,CSE 141L,A01,083376,Eldon; John,0,70,75,75
1650021186973,CSE 175,A01,084013,Kumar; Rakesh,22,0,25,3
1650021192997,CSE 190,A00,092508,Dubnov; Shlomo,20,0,20,0
1650021199033,ECE 5,A01,084049,Morris; Karcher William,13,0,20,7
1650021205067,ECE 100,A01,084051,Baghdadchi; Saharnaz,0,0,20,20
1650021205067,ECE 100,A02,091916,Baghdadchi; Saharnaz,13,0,20,7
1650021211093,ECE 101,A01,084053,Baghdadchi; Saharnaz,0,0,37,37
1650021211093,ECE 101,A02,084054,Baghdadchi; Saharnaz,30,0,37,7
1650021217118,ECE 107,A01,083390,Staff,26,0,40,14
1650021223149,ECE 148,A01,084056,Silberman; Jack,8,0,12,4
1650021229179,ECE 180,A00,083391,Abi Samra; Nicholas Camill,25,0,30,5
1650021229179,ECE 180,B00,083392,Abi Samra; Nicholas Camill,21,0,30,9
1650021235210,MATH 10B,A01,084110,Staff,0,0,30,30
1650021235210,MATH 10B,A02,084111,Staff,18,0,30,12
1650021235210,MATH 10B,A03,084112,Staff,24,0,30,6
1650021241250,MATH 10C,A01,083443,Staff,0,16,30,30
1650021241250,MATH 10C,A02,083444,Staff,0,15,30,30
1650021241250,MATH 10C,B01,084114,Staff,19,0,30,11
1650021241250,MATH 10C,B02,084115,Staff,25,0,30,5
1650021247301,MATH 18,A01,084117,Harel; Guershon,14,0,30,16
1650021247301,MATH 18,A02,084119,Harel; Guershon,28,0,30,2
1650021247301,MATH 18,A03,084120,Harel; Guershon,29,0,30,1
1650021247301,MATH 18,A04,084121,Harel; Guershon,29,0,30,1
1650021253342,MATH 20B,A01,084124,Um; Ko Woon,16,0,35,19
1650021253342,MATH 20B,B01,084126,Um; Ko Woon,24,0,35,11
1650021259375,MATH 20C,A01,083446,Hammock; Frances H,0,0,30,30
1650021259375,MATH 20C,A02,083447,Hammock; Frances H,16,0,30,14
1650021259375,MATH 20C,A03,083448,Hammock; Frances H,19,0,30,11
1650021259375,MATH 20C,A04,083449,Hammock; Frances H,20,0,30,10
1650021259375,MATH 20C,B01,083451,Hammock; Frances H,0,0,30,30
1650021259375,MATH 20C,B02,083452,Hammock; Frances H,19,0,30,11
1650021259375,MATH 20C,B03,083453,Hammock; Frances H,21,0,30,9
1650021259375,MATH 20C,B04,083454,Hammock; Frances H,23,0,30,7
1650021265406,MATH 20D,A01,084128,Staff,14,0,30,16
1650021265406,MATH 20D,A02,084129,Staff,29,0,30,1
1650021265406,MATH 20D,A03,084130,Staff,27,0,30,3
1650021265406,MATH 20D,B01,084133,Staff,3,0,30,27
1650021265406,MATH 20D,B02,084134,Staff,24,0,30,6
1650021265406,MATH 20D,B03,084135,Staff,28,0,30,2
1650021271500,MATH 20E,A01,084138,Staff,14,0,30,16
1650021271500,MATH 20E,A02,084139,Staff,6,0,30,24
1650021271500,MATH 20E,A03,084140,Staff,15,0,30,15
1650021271500,MATH 20E,A04,084141,Staff,20,0,30,10
1650021277525,MATH 102,A01,084143,Harel; Guershon,12,0,30,18
1650021277525,MATH 102,A02,084144,Harel; Guershon,19,0,30,11
1650021283554,MATH 103B,A01,083456,Staff,0,13,30,30
1650021283554,MATH 103B,A02,083457,Staff,0,13,30,30
1650021289580,MATH 109,A01,084146,Salehi Golsefidy; Alireza,18,0,30,12
1650021289580,MATH 109,A02,084147,Salehi Golsefidy; Alireza,15,0,30,15
1650021295614,MATH 120A,A01,085445,Eggers; John Dietrich,10,0,35,25
1650021295614,MATH 120A,A02,085446,Eggers; John Dietrich,27,0,35,8
1650021301637,MATH 142B,A01,084149,Verstraete; Jacques Allan,0,12,30,30
1650021301637,MATH 142B,A02,084150,Verstraete; Jacques Allan,0,12,30,30
1650021307668,MATH 170A,A01,083459,Nie; Jiawang,0,9,30,30
1650021307668,MATH 170A,A02,083460,Nie; Jiawang,0,8,30,30
1650021307668,MATH 170A,A03,083461,Nie; Jiawang,0,9,30,30
1650021313693,MATH 193B,A01,083463,Staff,1,0,30,29
1650021313693,MATH 193B,A02,083464,Staff,9,0,30,21
1650021313693,MATH 193B,A03,083465,Staff,18,0,30,12
1650021319761,COGS 2,A01,083966,Boyle; Mary E. T.,9,0,30,21
1650021325792,COGS 9,A01,083968,Staff,9,0,60,51
1650021331817,COGS 14B,A01,083970,Staff,9,0,50,41
1650021337842,COGS 17,A01,092679,Staff,50,0,75,25
1650021343866,COGS 100,A01,083972,Staff,0,15,60,60
1650021355914,COGS 101C,A01,083976,Staff,12,0,30,18
1650021361946,COGS 102A,A01,083978,Johnson; Christine M.,14,0,30,16
1650021367970,COGS 107B,A01,083980,Staff,0,7,50,50
1650021374011,COGS 115,A01,083982,Staff,10,0,30,20
1650021380039,COGS 118B,A01,083367,Staff,0,15,40,40
1650021386065,COGS 172,A01,083984,Provenzano; Emily Kara,15,0,30,15
1650021392094,COGS 177,A00,083368,Staff,0,20,30,30
1650021398118,COGS 186,A01,083986,Staff,21,0,40,19
1650021404145,COGS 187A,A01,083988,Boyle; Mary E. T.,20,0,60,40
1650021410170,CSE 8A,A50,084003,Miranda; Gregory Joseph,0,13,15,15
1650021416199,CSE 11,A01,084005,Miranda; Gregory Joseph,0,22,55,55
1650021422231,CSE 20,A01,084007,Staff,0,5,20,20
1650021428257,CSE 21,A01,084009,Staff,0,30,50,50
1650021434286,CSE 30,A01,083370,Cao; Yingjun,0,65,40,40
1650021440310,CSE 100,A01,083372,Cao; Yingjun,0,46,40,40
1650021446338,CSE 101,A01,084011,Staff,0,54,40,40
1650021452362,CSE 141,A01,083374,Eldon; John,0,64,75,75
1650021458389,CSE 141L,A01,083376,Eldon; John,0,70,75,75
1650021464413,CSE 175,A01,084013,Kumar; Rakesh,22,0,25,3
1650021470445,CSE 190,A00,092508,Dubnov; Shlomo,20,0,20,0
1650021476470,ECE 5,A01,084049,Morris; Karcher William,13,0,20,7
1650021482495,ECE 100,A01,084051,Baghdadchi; Saharnaz,0,0,20,20
1650021482495,ECE 100,A02,091916,Baghdadchi; Saharnaz,13,0,20,7
1650021488525,ECE 101,A01,084053,Baghdadchi; Saharnaz,0,0,37,37
1650021488525,ECE 101,A02,084054,Baghdadchi; Saharnaz,30,0,37,7
1650021494551,ECE 107,A01,083390,Staff,26,0,40,14
1650021500589,ECE 148,A01,084056,Silberman; Jack,8,0,12,4
